geo_id,year,student_enrollment,female_student_enrollment,male_student_enrollment,num_teachers,st_ratio
ECU-000000,2122,22,8,14,0,
ECU-000001,2122,7,0,7,0,
ECU-000002,2122,11,3,8,0,
ECU-000003,2122,21,9,12,1,21.0
ECU-000004,2122,3613,1947,1666,141,25.624113475177303
ECU-000005,2122,888,462,426,39,22.76923076923077
ECU-000006,2122,26,14,12,0,
ECU-000007,2122,175,78,97,11,15.909090909090908
ECU-000008,2122,108,56,52,5,21.6
ECU-000009,2122,31,12,19,1,31.0
ECU-000010,2122,1707,871,836,71,24.04225352112676
ECU-000011,2122,9,0,9,1,9.0
ECU-000012,2122,42,22,20,2,21.0
ECU-000013,2122,37,10,27,1,37.0
ECU-000014,2122,55,21,34,4,13.75
ECU-000015,2122,5,3,2,1,5.0
ECU-000016,2122,34,16,18,1,34.0
ECU-000017,2122,104,53,51,4,26.0
ECU-000018,2122,48,29,19,2,24.0
ECU-000019,2122,14,9,5,1,14.0
ECU-000020,2122,8,4,4,1,8.0
ECU-000021,2122,43,20,23,2,21.5
ECU-000022,2122,41,18,23,3,13.666666666666666
ECU-000023,2122,8,2,6,1,8.0
ECU-000024,2122,294,148,146,13,22.615384615384617
ECU-000025,2122,63,48,15,9,7.0
ECU-000026,2122,49,19,30,12,4.083333333333333
ECU-000027,2122,273,126,147,21,13.0
ECU-000028,2122,161,70,91,15,10.733333333333333
ECU-000029,2122,22,12,10,2,11.0
ECU-000030,2122,182,97,85,13,14.0
ECU-000031,2122,316,171,145,13,24.307692307692307
ECU-000032,2122,186,85,101,9,20.666666666666668
ECU-000033,2122,82,44,38,6,13.666666666666666
ECU-000034,2122,879,319,560,41,21.4390243902439
ECU-000035,2122,563,319,244,27,20.85185185185185
ECU-000036,2122,1807,1202,605,97,18.628865979381445
ECU-000037,2122,1379,882,497,47,29.340425531914892
ECU-000038,2122,1025,409,616,51,20.098039215686274
ECU-000039,2122,1962,840,1122,93,21.096774193548388
ECU-000040,2122,2086,703,1383,93,22.43010752688172
ECU-000041,2122,436,216,220,26,16.76923076923077
ECU-000042,2122,907,431,476,47,19.29787234042553
ECU-000043,2122,587,276,311,24,24.458333333333332
ECU-000044,2122,975,722,253,40,24.375
ECU-000045,2122,1261,617,644,50,25.22
ECU-000046,2122,977,483,494,49,19.93877551020408
ECU-000047,2122,15,6,9,4,3.75
ECU-000048,2122,18,5,13,6,3.0
ECU-000049,2122,14,2,12,2,7.0
ECU-000050,2122,11,5,6,2,5.5
ECU-000051,2122,7,4,3,1,7.0
ECU-000052,2122,6,4,2,1,6.0
ECU-000053,2122,36,26,10,3,12.0
ECU-000054,2122,296,142,154,18,16.444444444444443
ECU-000055,2122,7,1,6,1,7.0
ECU-000056,2122,1399,674,725,65,21.523076923076925
ECU-000057,2122,144,84,60,7,20.571428571428573
ECU-000058,2122,49,20,29,2,24.5
ECU-000059,2122,11,5,6,1,11.0
ECU-000060,2122,11,5,6,1,11.0
ECU-000061,2122,5,3,2,1,5.0
ECU-000062,2122,157,72,85,11,14.272727272727273
ECU-000063,2122,6,2,4,1,6.0
ECU-000064,2122,8,7,1,1,8.0
ECU-000065,2122,452,230,222,24,18.833333333333332
ECU-000066,2122,17,5,12,1,17.0
ECU-000067,2122,249,126,123,15,16.6
ECU-000068,2122,24,11,13,1,24.0
ECU-000069,2122,22,7,15,1,22.0
ECU-000070,2122,45,12,33,2,22.5
ECU-000071,2122,12,9,3,1,12.0
ECU-000072,2122,76,45,31,5,15.2
ECU-000073,2122,21,7,14,1,21.0
ECU-000074,2122,104,49,55,3,34.666666666666664
ECU-000075,2122,465,238,227,29,16.03448275862069
ECU-000076,2122,652,340,312,31,21.032258064516128
ECU-000077,2122,588,286,302,34,17.294117647058822
ECU-000078,2122,945,424,521,54,17.5
ECU-000079,2122,264,139,125,15,17.6
ECU-000080,2122,150,65,85,6,25.0
ECU-000081,2122,19,6,13,1,19.0
ECU-000082,2122,8,3,5,1,8.0
ECU-000083,2122,11,4,7,1,11.0
ECU-000084,2122,7,5,2,1,7.0
ECU-000085,2122,120,59,61,11,10.909090909090908
ECU-000086,2122,13,5,8,1,13.0
ECU-000087,2122,7,3,4,1,7.0
ECU-000088,2122,13,6,7,1,13.0
ECU-000089,2122,126,64,62,14,9.0
ECU-000090,2122,63,26,37,3,21.0
ECU-000091,2122,8,6,2,1,8.0
ECU-000092,2122,245,105,140,14,17.5
ECU-000093,2122,250,116,134,18,13.88888888888889
ECU-000094,2122,45,22,23,2,22.5
ECU-000095,2122,233,109,124,16,14.5625
ECU-000096,2122,3,0,3,1,3.0
ECU-000097,2122,421,218,203,13,32.38461538461539
ECU-000098,2122,963,452,511,51,18.88235294117647
ECU-000099,2122,479,261,218,30,15.966666666666667
ECU-000100,2122,1056,551,505,65,16.246153846153845
ECU-000101,2122,7,3,4,1,7.0
ECU-000102,2122,30,18,12,2,15.0
ECU-000103,2122,614,308,306,35,17.542857142857144
ECU-000104,2122,980,453,527,53,18.49056603773585
ECU-000105,2122,752,379,373,41,18.341463414634145
ECU-000106,2122,9,6,3,1,9.0
ECU-000107,2122,16,10,6,1,16.0
ECU-000108,2122,328,159,169,20,16.4
ECU-000109,2122,10,4,6,1,10.0
ECU-000110,2122,13,5,8,1,13.0
ECU-000111,2122,14,7,7,1,14.0
ECU-000112,2122,7,4,3,1,7.0
ECU-000113,2122,24,10,14,1,24.0
ECU-000114,2122,97,47,50,10,9.7
ECU-000115,2122,19,8,11,1,19.0
ECU-000116,2122,18,9,9,1,18.0
ECU-000117,2122,15,7,8,1,15.0
ECU-000118,2122,16,9,7,1,16.0
ECU-000119,2122,7,3,4,1,7.0
ECU-000120,2122,4,2,2,1,4.0
ECU-000121,2122,11,5,6,1,11.0
ECU-000122,2122,8,6,2,1,8.0
ECU-000123,2122,24,12,12,2,12.0
ECU-000124,2122,23,5,18,2,11.5
ECU-000125,2122,626,297,329,38,16.473684210526315
ECU-000126,2122,192,89,103,19,10.105263157894736
ECU-000127,2122,6,3,3,1,6.0
ECU-000128,2122,24,15,9,1,24.0
ECU-000129,2122,619,284,335,31,19.967741935483872
ECU-000130,2122,322,163,159,28,11.5
ECU-000131,2122,28,10,18,2,14.0
ECU-000132,2122,901,454,447,42,21.452380952380953
ECU-000133,2122,1989,1031,958,99,20.09090909090909
ECU-000134,2122,23,7,16,2,11.5
ECU-000135,2122,432,217,215,23,18.782608695652176
ECU-000136,2122,1358,700,658,71,19.12676056338028
ECU-000137,2122,26,14,12,2,13.0
ECU-000138,2122,14,7,7,1,14.0
ECU-000139,2122,20,8,12,2,10.0
ECU-000140,2122,124,62,62,10,12.4
ECU-000141,2122,23,7,16,1,23.0
ECU-000142,2122,18,11,7,2,9.0
ECU-000143,2122,421,198,223,29,14.517241379310345
ECU-000144,2122,16,7,9,1,16.0
ECU-000145,2122,39,21,18,3,13.0
ECU-000146,2122,29,14,15,1,29.0
ECU-000147,2122,32,14,18,2,16.0
ECU-000148,2122,31,13,18,2,15.5
ECU-000149,2122,482,256,226,30,16.066666666666666
ECU-000150,2122,17,8,9,1,17.0
ECU-000151,2122,5,5,0,1,5.0
ECU-000152,2122,24,10,14,2,12.0
ECU-000153,2122,47,24,23,3,15.666666666666666
ECU-000154,2122,10,7,3,1,10.0
ECU-000155,2122,188,76,112,17,11.058823529411764
ECU-000156,2122,15,9,6,1,15.0
ECU-000157,2122,230,109,121,16,14.375
ECU-000158,2122,432,225,207,16,27.0
ECU-000159,2122,386,186,200,23,16.782608695652176
ECU-000160,2122,583,268,315,35,16.65714285714286
ECU-000161,2122,302,146,156,18,16.77777777777778
ECU-000162,2122,4,1,3,1,4.0
ECU-000163,2122,16,7,9,1,16.0
ECU-000164,2122,30,13,17,2,15.0
ECU-000165,2122,20,11,9,2,10.0
ECU-000166,2122,110,57,53,2,55.0
ECU-000167,2122,14,3,11,2,7.0
ECU-000168,2122,1174,504,670,57,20.596491228070175
ECU-000169,2122,532,235,297,33,16.12121212121212
ECU-000170,2122,129,74,55,6,21.5
ECU-000171,2122,19,8,11,1,19.0
ECU-000172,2122,483,247,236,19,25.42105263157895
ECU-000173,2122,92,49,43,2,46.0
ECU-000174,2122,343,178,165,16,21.4375
ECU-000175,2122,28,16,12,2,14.0
ECU-000176,2122,47,23,24,2,23.5
ECU-000177,2122,34,11,23,2,17.0
ECU-000178,2122,10,6,4,1,10.0
ECU-000179,2122,161,79,82,8,20.125
ECU-000180,2122,69,32,37,2,34.5
ECU-000181,2122,61,35,26,2,30.5
ECU-000182,2122,26,17,9,1,26.0
ECU-000183,2122,210,105,105,13,16.153846153846153
ECU-000184,2122,97,56,41,3,32.333333333333336
ECU-000185,2122,225,98,127,15,15.0
ECU-000186,2122,172,83,89,11,15.636363636363637
ECU-000187,2122,89,32,57,7,12.714285714285714
ECU-000188,2122,87,48,39,5,17.4
ECU-000189,2122,20,15,5,1,20.0
ECU-000190,2122,55,28,27,2,27.5
ECU-000191,2122,43,20,23,2,21.5
ECU-000192,2122,52,29,23,2,26.0
ECU-000193,2122,73,33,40,3,24.333333333333332
ECU-000194,2122,68,34,34,2,34.0
ECU-000195,2122,16,8,8,1,16.0
ECU-000196,2122,45,25,20,1,45.0
ECU-000197,2122,50,24,26,2,25.0
ECU-000198,2122,24,13,11,1,24.0
ECU-000199,2122,435,217,218,14,31.071428571428573
ECU-000200,2122,151,80,71,6,25.166666666666668
ECU-000201,2122,42,25,17,1,42.0
ECU-000202,2122,42,24,18,2,21.0
ECU-000203,2122,31,16,15,1,31.0
ECU-000204,2122,292,156,136,16,18.25
ECU-000205,2122,16,10,6,1,16.0
ECU-000206,2122,299,142,157,15,19.933333333333334
ECU-000207,2122,25,13,12,1,25.0
ECU-000208,2122,363,176,187,17,21.352941176470587
ECU-000209,2122,345,170,175,15,23.0
ECU-000210,2122,56,32,24,6,9.333333333333334
ECU-000211,2122,311,157,154,16,19.4375
ECU-000212,2122,100,62,38,8,12.5
ECU-000213,2122,206,99,107,10,20.6
ECU-000214,2122,60,33,27,2,30.0
ECU-000215,2122,26,15,11,1,26.0
ECU-000216,2122,62,31,31,2,31.0
ECU-000217,2122,23,10,13,1,23.0
ECU-000218,2122,87,40,47,2,43.5
ECU-000219,2122,63,28,35,2,31.5
ECU-000220,2122,129,62,67,8,16.125
ECU-000221,2122,14,5,9,1,14.0
ECU-000222,2122,19,13,6,1,19.0
ECU-000223,2122,31,16,15,1,31.0
ECU-000224,2122,41,27,14,2,20.5
ECU-000225,2122,27,12,15,1,27.0
ECU-000226,2122,23,12,11,2,11.5
ECU-000227,2122,32,16,16,2,16.0
ECU-000228,2122,73,33,40,3,24.333333333333332
ECU-000229,2122,49,22,27,5,9.8
ECU-000230,2122,61,28,33,5,12.2
ECU-000231,2122,209,91,118,9,23.22222222222222
ECU-000232,2122,1332,671,661,53,25.132075471698112
ECU-000233,2122,449,220,229,17,26.41176470588235
ECU-000234,2122,123,55,68,4,30.75
ECU-000235,2122,522,282,240,33,15.818181818181818
ECU-000236,2122,77,34,43,10,7.7
ECU-000237,2122,854,433,421,42,20.333333333333332
ECU-000238,2122,183,73,110,15,12.2
ECU-000239,2122,104,53,51,4,26.0
ECU-000240,2122,171,80,91,17,10.058823529411764
ECU-000241,2122,820,421,399,31,26.451612903225808
ECU-000242,2122,1665,1001,664,90,18.5
ECU-000243,2122,194,101,93,8,24.25
ECU-000244,2122,379,195,184,24,15.791666666666666
ECU-000245,2122,1102,523,579,54,20.40740740740741
ECU-000246,2122,1402,732,670,66,21.242424242424242
ECU-000247,2122,125,60,65,4,31.25
ECU-000248,2122,1030,505,525,45,22.88888888888889
ECU-000249,2122,346,168,178,17,20.352941176470587
ECU-000250,2122,807,436,371,33,24.454545454545453
ECU-000251,2122,78,33,45,10,7.8
ECU-000252,2122,863,566,297,49,17.612244897959183
ECU-000253,2122,315,152,163,14,22.5
ECU-000254,2122,478,264,214,28,17.071428571428573
ECU-000255,2122,20,8,12,7,2.857142857142857
ECU-000256,2122,683,335,348,35,19.514285714285716
ECU-000257,2122,1789,896,893,64,27.953125
ECU-000258,2122,751,180,571,47,15.97872340425532
ECU-000259,2122,717,371,346,45,15.933333333333334
ECU-000260,2122,1100,562,538,39,28.205128205128204
ECU-000261,2122,2205,1103,1102,102,21.61764705882353
ECU-000262,2122,1534,825,709,50,30.68
ECU-000263,2122,2320,1267,1053,99,23.434343434343436
ECU-000264,2122,1634,949,685,85,19.223529411764705
ECU-000265,2122,292,133,159,15,19.466666666666665
ECU-000266,2122,588,356,232,20,29.4
ECU-000267,2122,873,423,450,37,23.594594594594593
ECU-000268,2122,1225,561,664,38,32.23684210526316
ECU-000269,2122,272,127,145,24,11.333333333333334
ECU-000270,2122,213,82,131,14,15.214285714285714
ECU-000271,2122,281,132,149,11,25.545454545454547
ECU-000272,2122,609,321,288,20,30.45
ECU-000273,2122,50,26,24,19,2.6315789473684212
ECU-000274,2122,1082,455,627,45,24.044444444444444
ECU-000275,2122,1101,598,503,49,22.46938775510204
ECU-000276,2122,19,8,11,1,19.0
ECU-000277,2122,46,15,31,2,23.0
ECU-000278,2122,21,8,13,1,21.0
ECU-000279,2122,889,426,463,28,31.75
ECU-000280,2122,9,5,4,1,9.0
ECU-000281,2122,34,20,14,1,34.0
ECU-000282,2122,13,9,4,1,13.0
ECU-000283,2122,40,19,21,2,20.0
ECU-000284,2122,41,28,13,1,41.0
ECU-000285,2122,9,6,3,1,9.0
ECU-000286,2122,392,200,192,17,23.058823529411764
ECU-000287,2122,11,4,7,1,11.0
ECU-000288,2122,17,10,7,1,17.0
ECU-000289,2122,12,3,9,1,12.0
ECU-000290,2122,32,11,21,1,32.0
ECU-000291,2122,33,19,14,1,33.0
ECU-000292,2122,259,135,124,16,16.1875
ECU-000293,2122,1102,600,502,51,21.607843137254903
ECU-000294,2122,88,40,48,4,22.0
ECU-000295,2122,8,4,4,1,8.0
ECU-000296,2122,11,5,6,1,11.0
ECU-000297,2122,21,8,13,1,21.0
ECU-000298,2122,26,13,13,1,26.0
ECU-000299,2122,20,9,11,1,20.0
ECU-000300,2122,214,103,111,10,21.4
ECU-000301,2122,333,176,157,14,23.785714285714285
ECU-000302,2122,11,8,3,1,11.0
ECU-000303,2122,49,31,18,2,24.5
ECU-000304,2122,25,12,13,1,25.0
ECU-000305,2122,17,11,6,1,17.0
ECU-000306,2122,23,11,12,1,23.0
ECU-000307,2122,32,16,16,1,32.0
ECU-000308,2122,23,14,9,1,23.0
ECU-000309,2122,915,466,449,42,21.785714285714285
ECU-000310,2122,190,96,94,9,21.11111111111111
ECU-000311,2122,18,8,10,1,18.0
ECU-000312,2122,64,28,36,3,21.333333333333332
ECU-000313,2122,9,5,4,1,9.0
ECU-000314,2122,12,5,7,1,12.0
ECU-000315,2122,11,3,8,1,11.0
ECU-000316,2122,44,20,24,2,22.0
ECU-000317,2122,59,22,37,3,19.666666666666668
ECU-000318,2122,36,23,13,1,36.0
ECU-000319,2122,760,387,373,33,23.03030303030303
ECU-000320,2122,92,53,39,3,30.666666666666668
ECU-000321,2122,152,81,71,6,25.333333333333332
ECU-000322,2122,36,22,14,1,36.0
ECU-000323,2122,204,100,104,8,25.5
ECU-000324,2122,92,40,52,6,15.333333333333334
ECU-000325,2122,76,42,34,3,25.333333333333332
ECU-000326,2122,6,4,2,1,6.0
ECU-000327,2122,14,4,10,1,14.0
ECU-000328,2122,40,19,21,2,20.0
ECU-000329,2122,42,27,15,2,21.0
ECU-000330,2122,569,257,312,25,22.76
ECU-000331,2122,56,25,31,5,11.2
ECU-000332,2122,46,21,25,2,23.0
ECU-000333,2122,82,33,49,2,41.0
ECU-000334,2122,519,260,259,25,20.76
ECU-000335,2122,14,6,8,1,14.0
ECU-000336,2122,797,402,395,25,31.88
ECU-000337,2122,306,158,148,14,21.857142857142858
ECU-000338,2122,2406,1267,1139,113,21.292035398230087
ECU-000339,2122,338,181,157,14,24.142857142857142
ECU-000340,2122,429,206,223,14,30.642857142857142
ECU-000341,2122,162,87,75,28,5.785714285714286
ECU-000342,2122,163,85,78,11,14.818181818181818
ECU-000343,2122,2227,1121,1106,84,26.511904761904763
ECU-000344,2122,1348,514,834,54,24.962962962962962
ECU-000345,2122,97,39,58,6,16.166666666666668
ECU-000346,2122,2718,1391,1327,117,23.23076923076923
ECU-000347,2122,149,75,74,5,29.8
ECU-000348,2122,1574,830,744,64,24.59375
ECU-000349,2122,303,136,167,14,21.642857142857142
ECU-000350,2122,1231,362,869,71,17.338028169014084
ECU-000351,2122,616,318,298,33,18.666666666666668
ECU-000352,2122,196,104,92,10,19.6
ECU-000353,2122,560,269,291,20,28.0
ECU-000354,2122,388,134,254,37,10.486486486486486
ECU-000355,2122,250,123,127,12,20.833333333333332
ECU-000356,2122,1179,655,524,51,23.11764705882353
ECU-000357,2122,775,368,407,23,33.69565217391305
ECU-000358,2122,951,483,468,36,26.416666666666668
ECU-000359,2122,71,39,32,5,14.2
ECU-000360,2122,743,385,358,38,19.55263157894737
ECU-000361,2122,351,160,191,15,23.4
ECU-000362,2122,984,524,460,33,29.818181818181817
ECU-000363,2122,117,53,64,21,5.571428571428571
ECU-000364,2122,594,281,313,29,20.482758620689655
ECU-000365,2122,348,163,185,20,17.4
ECU-000366,2122,855,409,446,45,19.0
ECU-000367,2122,483,276,207,26,18.576923076923077
ECU-000368,2122,20,13,7,1,20.0
ECU-000369,2122,10,5,5,1,10.0
ECU-000370,2122,12,7,5,1,12.0
ECU-000371,2122,10,7,3,1,10.0
ECU-000372,2122,264,131,133,10,26.4
ECU-000373,2122,4,2,2,1,4.0
ECU-000374,2122,1157,630,527,47,24.617021276595743
ECU-000375,2122,44,25,19,1,44.0
ECU-000376,2122,472,251,221,19,24.842105263157894
ECU-000377,2122,14,6,8,1,14.0
ECU-000378,2122,290,149,141,17,17.058823529411764
ECU-000379,2122,16,5,11,1,16.0
ECU-000380,2122,11,5,6,1,11.0
ECU-000381,2122,17,7,10,1,17.0
ECU-000382,2122,25,8,17,1,25.0
ECU-000383,2122,531,270,261,14,37.92857142857143
ECU-000384,2122,13,3,10,1,13.0
ECU-000385,2122,55,25,30,1,55.0
ECU-000386,2122,36,22,14,2,18.0
ECU-000387,2122,13,6,7,1,13.0
ECU-000388,2122,1067,598,469,40,26.675
ECU-000389,2122,432,234,198,30,14.4
ECU-000390,2122,1537,852,685,40,38.425
ECU-000391,2122,29,12,17,1,29.0
ECU-000392,2122,26,11,15,2,13.0
ECU-000393,2122,41,19,22,1,41.0
ECU-000394,2122,24,10,14,1,24.0
ECU-000395,2122,170,70,100,7,24.285714285714285
ECU-000396,2122,438,244,194,18,24.333333333333332
ECU-000397,2122,256,131,125,16,16.0
ECU-000398,2122,17,6,11,1,17.0
ECU-000399,2122,315,173,142,10,31.5
ECU-000400,2122,16,7,9,1,16.0
ECU-000401,2122,45,18,27,3,15.0
ECU-000402,2122,804,396,408,32,25.125
ECU-000403,2122,94,48,46,4,23.5
ECU-000404,2122,225,127,98,11,20.454545454545453
ECU-000405,2122,19,7,12,1,19.0
ECU-000406,2122,367,190,177,14,26.214285714285715
ECU-000407,2122,8,3,5,1,8.0
ECU-000408,2122,22,7,15,1,22.0
ECU-000409,2122,238,111,127,11,21.636363636363637
ECU-000410,2122,260,128,132,10,26.0
ECU-000411,2122,14,8,6,1,14.0
ECU-000412,2122,141,79,62,7,20.142857142857142
ECU-000413,2122,415,205,210,19,21.842105263157894
ECU-000414,2122,31,9,22,1,31.0
ECU-000415,2122,22,8,14,1,22.0
ECU-000416,2122,38,19,19,2,19.0
ECU-000417,2122,285,136,149,12,23.75
ECU-000418,2122,35,15,20,2,17.5
ECU-000419,2122,37,18,19,1,37.0
ECU-000420,2122,37,19,18,1,37.0
ECU-000421,2122,9,4,5,1,9.0
ECU-000422,2122,42,18,24,1,42.0
ECU-000423,2122,374,202,172,23,16.26086956521739
ECU-000424,2122,27,12,15,1,27.0
ECU-000425,2122,87,53,34,10,8.7
ECU-000426,2122,22,16,6,1,22.0
ECU-000427,2122,11,5,6,1,11.0
ECU-000428,2122,11,6,5,1,11.0
ECU-000429,2122,15,6,9,1,15.0
ECU-000430,2122,11,5,6,1,11.0
ECU-000431,2122,523,306,217,19,27.526315789473685
ECU-000432,2122,1252,627,625,42,29.80952380952381
ECU-000433,2122,441,221,220,16,27.5625
ECU-000434,2122,478,240,238,25,19.12
ECU-000435,2122,586,307,279,13,45.07692307692308
ECU-000436,2122,42,21,21,2,21.0
ECU-000437,2122,417,217,200,15,27.8
ECU-000438,2122,149,79,70,7,21.285714285714285
ECU-000439,2122,162,71,91,8,20.25
ECU-000440,2122,41,15,26,2,20.5
ECU-000441,2122,54,28,26,2,27.0
ECU-000442,2122,12,7,5,1,12.0
ECU-000443,2122,73,34,39,2,36.5
ECU-000444,2122,63,31,32,2,31.5
ECU-000445,2122,215,107,108,9,23.88888888888889
ECU-000446,2122,48,32,16,1,48.0
ECU-000447,2122,16,12,4,1,16.0
ECU-000448,2122,63,37,26,2,31.5
ECU-000449,2122,224,107,117,11,20.363636363636363
ECU-000450,2122,14,4,10,1,14.0
ECU-000451,2122,8,5,3,1,8.0
ECU-000452,2122,47,22,25,2,23.5
ECU-000453,2122,9,6,3,1,9.0
ECU-000454,2122,604,318,286,24,25.166666666666668
ECU-000455,2122,166,85,81,6,27.666666666666668
ECU-000456,2122,81,41,40,3,27.0
ECU-000457,2122,87,44,43,3,29.0
ECU-000458,2122,15,4,11,1,15.0
ECU-000459,2122,29,11,18,1,29.0
ECU-000460,2122,28,10,18,1,28.0
ECU-000461,2122,30,13,17,1,30.0
ECU-000462,2122,9,5,4,1,9.0
ECU-000463,2122,332,165,167,10,33.2
ECU-000464,2122,43,17,26,2,21.5
ECU-000465,2122,126,68,58,8,15.75
ECU-000466,2122,311,153,158,10,31.1
ECU-000467,2122,154,82,72,5,30.8
ECU-000468,2122,6,3,3,1,6.0
ECU-000469,2122,14,5,9,1,14.0
ECU-000470,2122,57,24,33,1,57.0
ECU-000471,2122,18,7,11,1,18.0
ECU-000472,2122,14,5,9,1,14.0
ECU-000473,2122,259,166,93,9,28.77777777777778
ECU-000474,2122,574,304,270,25,22.96
ECU-000475,2122,107,55,52,3,35.666666666666664
ECU-000476,2122,28,15,13,1,28.0
ECU-000477,2122,203,104,99,9,22.555555555555557
ECU-000478,2122,1338,691,647,58,23.06896551724138
ECU-000479,2122,300,190,110,9,33.333333333333336
ECU-000480,2122,46,23,23,2,23.0
ECU-000481,2122,35,17,18,1,35.0
ECU-000482,2122,500,262,238,17,29.41176470588235
ECU-000483,2122,14,9,5,1,14.0
ECU-000484,2122,20,9,11,1,20.0
ECU-000485,2122,26,18,8,1,26.0
ECU-000486,2122,222,146,76,11,20.181818181818183
ECU-000487,2122,14,8,6,1,14.0
ECU-000488,2122,17,6,11,1,17.0
ECU-000489,2122,488,252,236,14,34.857142857142854
ECU-000490,2122,9,5,4,1,9.0
ECU-000491,2122,68,33,35,2,34.0
ECU-000492,2122,22,10,12,1,22.0
ECU-000493,2122,358,193,165,22,16.272727272727273
ECU-000494,2122,30,13,17,1,30.0
ECU-000495,2122,10,2,8,1,10.0
ECU-000496,2122,14,8,6,1,14.0
ECU-000497,2122,19,7,12,1,19.0
ECU-000498,2122,106,51,55,10,10.6
ECU-000499,2122,13,7,6,1,13.0
ECU-000500,2122,15,8,7,1,15.0
ECU-000501,2122,8,5,3,1,8.0
ECU-000502,2122,53,27,26,2,26.5
ECU-000503,2122,35,19,16,1,35.0
ECU-000504,2122,248,121,127,11,22.545454545454547
ECU-000505,2122,166,82,84,20,8.3
ECU-000506,2122,30,13,17,1,30.0
ECU-000507,2122,14,7,7,1,14.0
ECU-000508,2122,20,12,8,1,20.0
ECU-000509,2122,21,9,12,1,21.0
ECU-000510,2122,17,6,11,1,17.0
ECU-000511,2122,886,447,439,34,26.058823529411764
ECU-000512,2122,21,13,8,1,21.0
ECU-000513,2122,3,1,2,1,3.0
ECU-000514,2122,31,13,18,1,31.0
ECU-000515,2122,16,6,10,1,16.0
ECU-000516,2122,53,25,28,2,26.5
ECU-000517,2122,568,289,279,19,29.894736842105264
ECU-000518,2122,15,6,9,1,15.0
ECU-000519,2122,23,12,11,1,23.0
ECU-000520,2122,16,11,5,1,16.0
ECU-000521,2122,1461,746,715,47,31.085106382978722
ECU-000522,2122,1313,620,693,48,27.354166666666668
ECU-000523,2122,44,26,18,2,22.0
ECU-000524,2122,15,8,7,1,15.0
ECU-000525,2122,15,5,10,1,15.0
ECU-000526,2122,42,20,22,2,21.0
ECU-000527,2122,131,53,78,13,10.076923076923077
ECU-000528,2122,12,6,6,1,12.0
ECU-000529,2122,46,25,21,2,23.0
ECU-000530,2122,29,11,18,1,29.0
ECU-000531,2122,60,27,33,2,30.0
ECU-000532,2122,16,5,11,1,16.0
ECU-000533,2122,26,9,17,1,26.0
ECU-000534,2122,63,28,35,2,31.5
ECU-000535,2122,21,11,10,1,21.0
ECU-000536,2122,19,5,14,1,19.0
ECU-000537,2122,24,11,13,1,24.0
ECU-000538,2122,17,12,5,1,17.0
ECU-000539,2122,234,112,122,7,33.42857142857143
ECU-000540,2122,22,9,13,1,22.0
ECU-000541,2122,827,446,381,39,21.205128205128204
ECU-000542,2122,441,190,251,18,24.5
ECU-000543,2122,52,25,27,3,17.333333333333332
ECU-000544,2122,129,59,70,6,21.5
ECU-000545,2122,187,97,90,11,17.0
ECU-000546,2122,442,202,240,18,24.555555555555557
ECU-000547,2122,12,4,8,1,12.0
ECU-000548,2122,1836,943,893,62,29.612903225806452
ECU-000549,2122,1807,948,859,54,33.46296296296296
ECU-000550,2122,18,9,9,1,18.0
ECU-000551,2122,182,87,95,14,13.0
ECU-000552,2122,250,130,120,13,19.23076923076923
ECU-000553,2122,25,15,10,1,25.0
ECU-000554,2122,28,14,14,1,28.0
ECU-000555,2122,12,5,7,1,12.0
ECU-000556,2122,96,45,51,3,32.0
ECU-000557,2122,384,190,194,17,22.58823529411765
ECU-000558,2122,1726,894,832,87,19.839080459770116
ECU-000559,2122,17,8,9,1,17.0
ECU-000560,2122,28,14,14,1,28.0
ECU-000561,2122,389,178,211,11,35.36363636363637
ECU-000562,2122,26,11,15,1,26.0
ECU-000563,2122,11,5,6,1,11.0
ECU-000564,2122,24,12,12,1,24.0
ECU-000565,2122,28,14,14,1,28.0
ECU-000566,2122,487,214,273,13,37.46153846153846
ECU-000567,2122,145,66,79,6,24.166666666666668
ECU-000568,2122,13,3,10,1,13.0
ECU-000569,2122,326,184,142,13,25.076923076923077
ECU-000570,2122,15,9,6,1,15.0
ECU-000571,2122,9,2,7,1,9.0
ECU-000572,2122,17,8,9,1,17.0
ECU-000573,2122,14,12,2,1,14.0
ECU-000574,2122,22,15,7,1,22.0
ECU-000575,2122,30,10,20,1,30.0
ECU-000576,2122,14,4,10,1,14.0
ECU-000577,2122,430,218,212,16,26.875
ECU-000578,2122,49,24,25,2,24.5
ECU-000579,2122,31,15,16,1,31.0
ECU-000580,2122,598,296,302,24,24.916666666666668
ECU-000581,2122,15,8,7,1,15.0
ECU-000582,2122,41,15,26,1,41.0
ECU-000583,2122,12,4,8,1,12.0
ECU-000584,2122,40,20,20,2,20.0
ECU-000585,2122,22,12,10,1,22.0
ECU-000586,2122,17,5,12,1,17.0
ECU-000587,2122,14,8,6,1,14.0
ECU-000588,2122,32,20,12,1,32.0
ECU-000589,2122,15,6,9,1,15.0
ECU-000590,2122,300,162,138,22,13.636363636363637
ECU-000591,2122,27,14,13,1,27.0
ECU-000592,2122,11,5,6,1,11.0
ECU-000593,2122,22,9,13,1,22.0
ECU-000594,2122,245,135,110,12,20.416666666666668
ECU-000595,2122,77,34,43,4,19.25
ECU-000596,2122,37,15,22,1,37.0
ECU-000597,2122,35,15,20,1,35.0
ECU-000598,2122,19,8,11,1,19.0
ECU-000599,2122,21,12,9,1,21.0
ECU-000600,2122,11,6,5,1,11.0
ECU-000601,2122,15,8,7,1,15.0
ECU-000602,2122,9,4,5,1,9.0
ECU-000603,2122,196,88,108,8,24.5
ECU-000604,2122,16,5,11,1,16.0
ECU-000605,2122,22,11,11,1,22.0
ECU-000606,2122,61,28,33,2,30.5
ECU-000607,2122,29,15,14,1,29.0
ECU-000608,2122,239,120,119,13,18.384615384615383
ECU-000609,2122,21,12,9,1,21.0
ECU-000610,2122,17,7,10,1,17.0
ECU-000611,2122,49,25,24,2,24.5
ECU-000612,2122,33,13,20,1,33.0
ECU-000613,2122,8,2,6,1,8.0
ECU-000614,2122,307,148,159,8,38.375
ECU-000615,2122,69,29,40,4,17.25
ECU-000616,2122,17,7,10,1,17.0
ECU-000617,2122,550,300,250,15,36.666666666666664
ECU-000618,2122,192,88,104,10,19.2
ECU-000619,2122,846,443,403,26,32.53846153846154
ECU-000620,2122,19,9,10,1,19.0
ECU-000621,2122,13,7,6,1,13.0
ECU-000622,2122,238,109,129,7,34.0
ECU-000623,2122,46,23,23,2,23.0
ECU-000624,2122,34,20,14,1,34.0
ECU-000625,2122,6,1,5,1,6.0
ECU-000626,2122,8,3,5,1,8.0
ECU-000627,2122,28,9,19,1,28.0
ECU-000628,2122,14,3,11,1,14.0
ECU-000629,2122,333,171,162,9,37.0
ECU-000630,2122,27,15,12,1,27.0
ECU-000631,2122,30,17,13,1,30.0
ECU-000632,2122,25,13,12,1,25.0
ECU-000633,2122,28,15,13,1,28.0
ECU-000634,2122,29,14,15,1,29.0
ECU-000635,2122,47,23,24,2,23.5
ECU-000636,2122,1004,467,537,39,25.743589743589745
ECU-000637,2122,276,141,135,15,18.4
ECU-000638,2122,47,26,21,2,23.5
ECU-000639,2122,8,2,6,1,8.0
ECU-000640,2122,10,4,6,1,10.0
ECU-000641,2122,72,41,31,2,36.0
ECU-000642,2122,164,82,82,14,11.714285714285714
ECU-000643,2122,19,7,12,1,19.0
ECU-000644,2122,15,7,8,1,15.0
ECU-000645,2122,826,422,404,31,26.64516129032258
ECU-000646,2122,720,393,327,17,42.35294117647059
ECU-000647,2122,12,8,4,1,12.0
ECU-000648,2122,204,99,105,9,22.666666666666668
ECU-000649,2122,46,22,24,2,23.0
ECU-000650,2122,16,8,8,1,16.0
ECU-000651,2122,197,96,101,8,24.625
ECU-000652,2122,408,198,210,19,21.473684210526315
ECU-000653,2122,9,5,4,1,9.0
ECU-000654,2122,18,6,12,1,18.0
ECU-000655,2122,17,8,9,1,17.0
ECU-000656,2122,23,9,14,1,23.0
ECU-000657,2122,13,7,6,1,13.0
ECU-000658,2122,9,4,5,1,9.0
ECU-000659,2122,12,3,9,1,12.0
ECU-000660,2122,9,6,3,1,9.0
ECU-000661,2122,19,11,8,1,19.0
ECU-000662,2122,55,35,20,2,27.5
ECU-000663,2122,1349,668,681,43,31.372093023255815
ECU-000664,2122,9,6,3,1,9.0
ECU-000665,2122,19,10,9,1,19.0
ECU-000666,2122,15,6,9,1,15.0
ECU-000667,2122,39,22,17,2,19.5
ECU-000668,2122,17,10,7,1,17.0
ECU-000669,2122,12,3,9,1,12.0
ECU-000670,2122,12,8,4,1,12.0
ECU-000671,2122,35,11,24,1,35.0
ECU-000672,2122,176,120,56,8,22.0
ECU-000673,2122,499,245,254,21,23.761904761904763
ECU-000674,2122,481,244,237,18,26.72222222222222
ECU-000675,2122,591,288,303,21,28.142857142857142
ECU-000676,2122,27,13,14,1,27.0
ECU-000677,2122,15,11,4,1,15.0
ECU-000678,2122,24,9,15,1,24.0
ECU-000679,2122,22,12,10,1,22.0
ECU-000680,2122,36,18,18,1,36.0
ECU-000681,2122,433,238,195,15,28.866666666666667
ECU-000682,2122,19,5,14,1,19.0
ECU-000683,2122,181,101,80,6,30.166666666666668
ECU-000684,2122,63,23,40,2,31.5
ECU-000685,2122,41,20,21,2,20.5
ECU-000686,2122,43,28,15,4,10.75
ECU-000687,2122,9,1,8,1,9.0
ECU-000688,2122,1030,501,529,37,27.83783783783784
ECU-000689,2122,96,37,59,4,24.0
ECU-000690,2122,21,13,8,1,21.0
ECU-000691,2122,16,10,6,1,16.0
ECU-000692,2122,4,2,2,1,4.0
ECU-000693,2122,154,69,85,6,25.666666666666668
ECU-000694,2122,283,142,141,12,23.583333333333332
ECU-000695,2122,47,25,22,2,23.5
ECU-000696,2122,1251,660,591,37,33.810810810810814
ECU-000697,2122,209,111,98,14,14.928571428571429
ECU-000698,2122,693,331,362,27,25.666666666666668
ECU-000699,2122,109,57,52,9,12.11111111111111
ECU-000700,2122,8,4,4,1,8.0
ECU-000701,2122,8,4,4,1,8.0
ECU-000702,2122,33,16,17,1,33.0
ECU-000703,2122,22,12,10,1,22.0
ECU-000704,2122,22,8,14,1,22.0
ECU-000705,2122,709,394,315,25,28.36
ECU-000706,2122,154,79,75,9,17.11111111111111
ECU-000707,2122,149,74,75,7,21.285714285714285
ECU-000708,2122,28,11,17,1,28.0
ECU-000709,2122,149,69,80,8,18.625
ECU-000710,2122,11,4,7,1,11.0
ECU-000711,2122,28,13,15,1,28.0
ECU-000712,2122,21,8,13,1,21.0
ECU-000713,2122,21,7,14,1,21.0
ECU-000714,2122,832,420,412,37,22.486486486486488
ECU-000715,2122,118,49,69,17,6.9411764705882355
ECU-000716,2122,1402,821,581,61,22.983606557377048
ECU-000717,2122,184,93,91,13,14.153846153846153
ECU-000718,2122,1176,618,558,49,24.0
ECU-000719,2122,463,212,251,23,20.130434782608695
ECU-000720,2122,129,58,71,8,16.125
ECU-000721,2122,1212,733,479,57,21.263157894736842
ECU-000722,2122,875,499,376,37,23.64864864864865
ECU-000723,2122,1032,520,512,42,24.571428571428573
ECU-000724,2122,356,192,164,21,16.952380952380953
ECU-000725,2122,134,60,74,7,19.142857142857142
ECU-000726,2122,514,273,241,22,23.363636363636363
ECU-000727,2122,77,45,32,6,12.833333333333334
ECU-000728,2122,51,30,21,2,25.5
ECU-000729,2122,114,59,55,8,14.25
ECU-000730,2122,38,19,19,2,19.0
ECU-000731,2122,187,89,98,12,15.583333333333334
ECU-000732,2122,200,92,108,10,20.0
ECU-000733,2122,14,5,9,1,14.0
ECU-000734,2122,39,23,16,2,19.5
ECU-000735,2122,43,21,22,2,21.5
ECU-000736,2122,22,5,17,1,22.0
ECU-000737,2122,13,8,5,1,13.0
ECU-000738,2122,136,72,64,12,11.333333333333334
ECU-000739,2122,26,16,10,1,26.0
ECU-000740,2122,5,3,2,1,5.0
ECU-000741,2122,7,3,4,1,7.0
ECU-000742,2122,31,10,21,2,15.5
ECU-000743,2122,154,86,68,7,22.0
ECU-000744,2122,93,42,51,5,18.6
ECU-000745,2122,19,9,10,1,19.0
ECU-000746,2122,17,4,13,1,17.0
ECU-000747,2122,46,28,18,2,23.0
ECU-000748,2122,70,26,44,3,23.333333333333332
ECU-000749,2122,216,110,106,14,15.428571428571429
ECU-000750,2122,113,53,60,10,11.3
ECU-000751,2122,37,20,17,2,18.5
ECU-000752,2122,374,181,193,27,13.851851851851851
ECU-000753,2122,16,7,9,1,16.0
ECU-000754,2122,58,21,37,3,19.333333333333332
ECU-000755,2122,251,114,137,11,22.818181818181817
ECU-000756,2122,25,5,20,2,12.5
ECU-000757,2122,19,7,12,1,19.0
ECU-000758,2122,480,257,223,27,17.77777777777778
ECU-000759,2122,12,5,7,1,12.0
ECU-000760,2122,207,87,120,14,14.785714285714286
ECU-000761,2122,23,11,12,1,23.0
ECU-000762,2122,310,175,135,12,25.833333333333332
ECU-000763,2122,359,184,175,15,23.933333333333334
ECU-000764,2122,157,57,100,10,15.7
ECU-000765,2122,1268,608,660,47,26.97872340425532
ECU-000766,2122,677,355,322,32,21.15625
ECU-000767,2122,1973,1063,910,76,25.960526315789473
ECU-000768,2122,1937,951,986,78,24.833333333333332
ECU-000769,2122,17,7,10,1,17.0
ECU-000770,2122,403,232,171,30,13.433333333333334
ECU-000771,2122,26,16,10,1,26.0
ECU-000772,2122,133,76,57,6,22.166666666666668
ECU-000773,2122,17,6,11,2,8.5
ECU-000774,2122,472,243,229,18,26.22222222222222
ECU-000775,2122,23,12,11,1,23.0
ECU-000776,2122,15,7,8,1,15.0
ECU-000777,2122,17,8,9,1,17.0
ECU-000778,2122,33,16,17,1,33.0
ECU-000779,2122,187,91,96,14,13.357142857142858
ECU-000780,2122,1056,508,548,42,25.142857142857142
ECU-000781,2122,21,10,11,1,21.0
ECU-000782,2122,576,280,296,26,22.153846153846153
ECU-000783,2122,16,11,5,1,16.0
ECU-000784,2122,850,410,440,29,29.310344827586206
ECU-000785,2122,131,62,69,10,13.1
ECU-000786,2122,44,20,24,1,44.0
ECU-000787,2122,117,71,46,3,39.0
ECU-000788,2122,39,22,17,1,39.0
ECU-000789,2122,37,15,22,1,37.0
ECU-000790,2122,12,4,8,1,12.0
ECU-000791,2122,408,200,208,21,19.428571428571427
ECU-000792,2122,612,309,303,21,29.142857142857142
ECU-000793,2122,14,9,5,1,14.0
ECU-000794,2122,107,55,52,4,26.75
ECU-000795,2122,44,29,15,2,22.0
ECU-000796,2122,9,4,5,2,4.5
ECU-000797,2122,222,113,109,11,20.181818181818183
ECU-000798,2122,187,83,104,8,23.375
ECU-000799,2122,390,202,188,14,27.857142857142858
ECU-000800,2122,221,97,124,11,20.09090909090909
ECU-000801,2122,25,12,13,1,25.0
ECU-000802,2122,521,241,280,25,20.84
ECU-000803,2122,306,156,150,13,23.53846153846154
ECU-000804,2122,614,306,308,27,22.74074074074074
ECU-000805,2122,336,204,132,18,18.666666666666668
ECU-000806,2122,81,35,46,8,10.125
ECU-000807,2122,11,5,6,1,11.0
ECU-000808,2122,10,5,5,1,10.0
ECU-000809,2122,1570,897,673,73,21.506849315068493
ECU-000810,2122,61,33,28,3,20.333333333333332
ECU-000811,2122,110,43,67,5,22.0
ECU-000812,2122,226,124,102,13,17.384615384615383
ECU-000813,2122,15,7,8,1,15.0
ECU-000814,2122,26,11,15,2,13.0
ECU-000815,2122,713,383,330,30,23.766666666666666
ECU-000816,2122,16,9,7,1,16.0
ECU-000817,2122,74,32,42,4,18.5
ECU-000818,2122,42,25,17,2,21.0
ECU-000819,2122,132,73,59,9,14.666666666666666
ECU-000820,2122,32,19,13,2,16.0
ECU-000821,2122,136,65,71,8,17.0
ECU-000822,2122,16,7,9,1,16.0
ECU-000823,2122,12,8,4,1,12.0
ECU-000824,2122,533,273,260,24,22.208333333333332
ECU-000825,2122,137,70,67,10,13.7
ECU-000826,2122,32,18,14,1,32.0
ECU-000827,2122,18,5,13,1,18.0
ECU-000828,2122,32,21,11,1,32.0
ECU-000829,2122,84,43,41,2,42.0
ECU-000830,2122,12,4,8,1,12.0
ECU-000831,2122,57,18,39,2,28.5
ECU-000832,2122,16,9,7,1,16.0
ECU-000833,2122,13,7,6,1,13.0
ECU-000834,2122,42,18,24,2,21.0
ECU-000835,2122,22,13,9,1,22.0
ECU-000836,2122,213,123,90,12,17.75
ECU-000837,2122,84,46,38,3,28.0
ECU-000838,2122,29,12,17,1,29.0
ECU-000839,2122,185,86,99,10,18.5
ECU-000840,2122,1079,547,532,42,25.69047619047619
ECU-000841,2122,31,13,18,1,31.0
ECU-000842,2122,17,11,6,1,17.0
ECU-000843,2122,18,9,9,2,9.0
ECU-000844,2122,17,6,11,1,17.0
ECU-000845,2122,18,8,10,1,18.0
ECU-000846,2122,7,4,3,1,7.0
ECU-000847,2122,34,15,19,3,11.333333333333334
ECU-000848,2122,24,8,16,1,24.0
ECU-000849,2122,49,23,26,3,16.333333333333332
ECU-000850,2122,32,14,18,1,32.0
ECU-000851,2122,1031,539,492,44,23.431818181818183
ECU-000852,2122,40,16,24,2,20.0
ECU-000853,2122,17,12,5,1,17.0
ECU-000854,2122,775,393,382,38,20.394736842105264
ECU-000855,2122,1085,617,468,50,21.7
ECU-000856,2122,16,8,8,1,16.0
ECU-000857,2122,31,10,21,1,31.0
ECU-000858,2122,22,12,10,1,22.0
ECU-000859,2122,20,5,15,1,20.0
ECU-000860,2122,25,12,13,1,25.0
ECU-000861,2122,10,5,5,1,10.0
ECU-000862,2122,1287,615,672,51,25.235294117647058
ECU-000863,2122,15,6,9,1,15.0
ECU-000864,2122,15,6,9,1,15.0
ECU-000865,2122,4,0,4,1,4.0
ECU-000866,2122,14,7,7,1,14.0
ECU-000867,2122,56,31,25,2,28.0
ECU-000868,2122,13,5,8,1,13.0
ECU-000869,2122,5,4,1,1,5.0
ECU-000870,2122,10,4,6,1,10.0
ECU-000871,2122,8,5,3,1,8.0
ECU-000872,2122,12,6,6,1,12.0
ECU-000873,2122,28,9,19,2,14.0
ECU-000874,2122,27,14,13,1,27.0
ECU-000875,2122,17,9,8,1,17.0
ECU-000876,2122,13,3,10,1,13.0
ECU-000877,2122,56,31,25,8,7.0
ECU-000878,2122,68,34,34,2,34.0
ECU-000879,2122,13,7,6,1,13.0
ECU-000880,2122,14,5,9,1,14.0
ECU-000881,2122,1068,462,606,52,20.53846153846154
ECU-000882,2122,19,12,7,1,19.0
ECU-000883,2122,25,13,12,1,25.0
ECU-000884,2122,637,338,299,28,22.75
ECU-000885,2122,13,0,13,1,13.0
ECU-000886,2122,8,3,5,1,8.0
ECU-000887,2122,501,226,275,19,26.36842105263158
ECU-000888,2122,9,5,4,1,9.0
ECU-000889,2122,33,12,21,8,4.125
ECU-000890,2122,132,56,76,23,5.739130434782608
ECU-000891,2122,14,9,5,1,14.0
ECU-000892,2122,21,5,16,1,21.0
ECU-000893,2122,13,7,6,1,13.0
ECU-000894,2122,41,24,17,1,41.0
ECU-000895,2122,26,13,13,1,26.0
ECU-000896,2122,19,10,9,1,19.0
ECU-000897,2122,12,6,6,1,12.0
ECU-000898,2122,19,10,9,1,19.0
ECU-000899,2122,17,4,13,1,17.0
ECU-000900,2122,3,3,0,1,3.0
ECU-000901,2122,19,10,9,1,19.0
ECU-000902,2122,262,127,135,14,18.714285714285715
ECU-000903,2122,165,71,94,6,27.5
ECU-000904,2122,9,6,3,1,9.0
ECU-000905,2122,11,6,5,1,11.0
ECU-000906,2122,20,10,10,1,20.0
ECU-000907,2122,11,4,7,1,11.0
ECU-000908,2122,9,5,4,1,9.0
ECU-000909,2122,7,2,5,1,7.0
ECU-000910,2122,10,3,7,1,10.0
ECU-000911,2122,6,2,4,1,6.0
ECU-000912,2122,20,13,7,1,20.0
ECU-000913,2122,21,6,15,1,21.0
ECU-000914,2122,13,5,8,1,13.0
ECU-000915,2122,7,1,6,1,7.0
ECU-000916,2122,26,12,14,1,26.0
ECU-000917,2122,24,9,15,1,24.0
ECU-000918,2122,17,7,10,1,17.0
ECU-000919,2122,22,10,12,1,22.0
ECU-000920,2122,19,10,9,1,19.0
ECU-000921,2122,10,5,5,1,10.0
ECU-000922,2122,39,23,16,1,39.0
ECU-000923,2122,40,19,21,1,40.0
ECU-000924,2122,35,13,22,1,35.0
ECU-000925,2122,7,2,5,1,7.0
ECU-000926,2122,15,7,8,1,15.0
ECU-000927,2122,18,5,13,1,18.0
ECU-000928,2122,26,13,13,1,26.0
ECU-000929,2122,151,73,78,8,18.875
ECU-000930,2122,25,8,17,1,25.0
ECU-000931,2122,8,6,2,1,8.0
ECU-000932,2122,64,27,37,2,32.0
ECU-000933,2122,14,5,9,1,14.0
ECU-000934,2122,10,4,6,1,10.0
ECU-000935,2122,19,12,7,1,19.0
ECU-000936,2122,16,5,11,1,16.0
ECU-000937,2122,16,10,6,1,16.0
ECU-000938,2122,27,13,14,1,27.0
ECU-000939,2122,61,26,35,7,8.714285714285714
ECU-000940,2122,35,16,19,1,35.0
ECU-000941,2122,20,12,8,3,6.666666666666667
ECU-000942,2122,16,9,7,1,16.0
ECU-000943,2122,41,23,18,1,41.0
ECU-000944,2122,6,5,1,4,1.5
ECU-000945,2122,14,6,8,1,14.0
ECU-000946,2122,25,14,11,1,25.0
ECU-000947,2122,78,27,51,4,19.5
ECU-000948,2122,56,32,24,2,28.0
ECU-000949,2122,7,4,3,1,7.0
ECU-000950,2122,25,14,11,1,25.0
ECU-000951,2122,15,4,11,1,15.0
ECU-000952,2122,17,10,7,1,17.0
ECU-000953,2122,39,16,23,1,39.0
ECU-000954,2122,12,7,5,1,12.0
ECU-000955,2122,14,4,10,1,14.0
ECU-000956,2122,16,9,7,1,16.0
ECU-000957,2122,312,160,152,22,14.181818181818182
ECU-000958,2122,465,244,221,18,25.833333333333332
ECU-000959,2122,25,12,13,1,25.0
ECU-000960,2122,133,69,64,15,8.866666666666667
ECU-000961,2122,1039,570,469,43,24.162790697674417
ECU-000962,2122,150,64,86,12,12.5
ECU-000963,2122,42,16,26,3,14.0
ECU-000964,2122,1355,715,640,59,22.966101694915253
ECU-000965,2122,453,247,206,22,20.59090909090909
ECU-000966,2122,470,221,249,16,29.375
ECU-000967,2122,536,261,275,23,23.304347826086957
ECU-000968,2122,135,59,76,12,11.25
ECU-000969,2122,2,0,2,1,2.0
ECU-000970,2122,44,20,24,1,44.0
ECU-000971,2122,5,4,1,1,5.0
ECU-000972,2122,52,22,30,7,7.428571428571429
ECU-000973,2122,92,51,41,9,10.222222222222221
ECU-000974,2122,98,49,49,6,16.333333333333332
ECU-000975,2122,61,34,27,2,30.5
ECU-000976,2122,18,13,5,1,18.0
ECU-000977,2122,66,33,33,3,22.0
ECU-000978,2122,137,68,69,7,19.571428571428573
ECU-000979,2122,34,13,21,2,17.0
ECU-000980,2122,234,120,114,14,16.714285714285715
ECU-000981,2122,120,57,63,14,8.571428571428571
ECU-000982,2122,32,12,20,2,16.0
ECU-000983,2122,190,95,95,15,12.666666666666666
ECU-000984,2122,280,141,139,18,15.555555555555555
ECU-000985,2122,27,11,16,2,13.5
ECU-000986,2122,59,31,28,4,14.75
ECU-000987,2122,47,22,25,3,15.666666666666666
ECU-000988,2122,9,3,6,1,9.0
ECU-000989,2122,47,24,23,3,15.666666666666666
ECU-000990,2122,39,16,23,2,19.5
ECU-000991,2122,20,10,10,1,20.0
ECU-000992,2122,930,444,486,48,19.375
ECU-000993,2122,388,207,181,17,22.823529411764707
ECU-000994,2122,92,46,46,7,13.142857142857142
ECU-000995,2122,107,59,48,8,13.375
ECU-000996,2122,190,88,102,13,14.615384615384615
ECU-000997,2122,391,200,191,23,17.0
ECU-000998,2122,679,330,349,33,20.575757575757574
ECU-000999,2122,705,340,365,34,20.735294117647058
ECU-001000,2122,59,22,37,11,5.363636363636363
ECU-001001,2122,92,44,48,10,9.2
ECU-001002,2122,73,27,46,13,5.615384615384615
ECU-001003,2122,899,519,380,47,19.127659574468087
ECU-001004,2122,7,2,5,1,7.0
ECU-001005,2122,30,16,14,2,15.0
ECU-001006,2122,72,32,40,7,10.285714285714286
ECU-001007,2122,19,8,11,2,9.5
ECU-001008,2122,51,26,25,2,25.5
ECU-001009,2122,13,4,9,1,13.0
ECU-001010,2122,21,12,9,1,21.0
ECU-001011,2122,15,8,7,1,15.0
ECU-001012,2122,157,71,86,15,10.466666666666667
ECU-001013,2122,446,222,224,21,21.238095238095237
ECU-001014,2122,275,124,151,15,18.333333333333332
ECU-001015,2122,82,44,38,6,13.666666666666666
ECU-001016,2122,166,82,84,13,12.76923076923077
ECU-001017,2122,395,195,200,21,18.80952380952381
ECU-001018,2122,383,199,184,29,13.206896551724139
ECU-001019,2122,88,43,45,6,14.666666666666666
ECU-001020,2122,8,4,4,1,8.0
ECU-001021,2122,143,56,87,10,14.3
ECU-001022,2122,100,36,64,9,11.11111111111111
ECU-001023,2122,54,33,21,5,10.8
ECU-001024,2122,13,6,7,1,13.0
ECU-001025,2122,587,287,300,36,16.305555555555557
ECU-001026,2122,447,226,221,28,15.964285714285714
ECU-001027,2122,1004,504,500,39,25.743589743589745
ECU-001028,2122,623,187,436,32,19.46875
ECU-001029,2122,187,88,99,16,11.6875
ECU-001030,2122,1226,635,591,60,20.433333333333334
ECU-001031,2122,188,85,103,14,13.428571428571429
ECU-001032,2122,218,108,110,9,24.22222222222222
ECU-001033,2122,439,223,216,29,15.137931034482758
ECU-001034,2122,56,28,28,7,8.0
ECU-001035,2122,11,8,3,1,11.0
ECU-001036,2122,204,173,31,16,12.75
ECU-001037,2122,31,9,22,3,10.333333333333334
ECU-001038,2122,628,292,336,36,17.444444444444443
ECU-001039,2122,158,88,70,8,19.75
ECU-001040,2122,1440,879,561,58,24.82758620689655
ECU-001041,2122,223,113,110,17,13.117647058823529
ECU-001042,2122,195,84,111,14,13.928571428571429
ECU-001043,2122,1886,587,1299,115,16.4
ECU-001044,2122,133,72,61,9,14.777777777777779
ECU-001045,2122,132,59,73,37,3.5675675675675675
ECU-001046,2122,11,6,5,6,1.8333333333333333
ECU-001047,2122,44,29,15,11,4.0
ECU-001048,2122,531,297,234,24,22.125
ECU-001049,2122,433,391,42,24,18.041666666666668
ECU-001050,2122,357,144,213,19,18.789473684210527
ECU-001051,2122,962,368,594,47,20.46808510638298
ECU-001052,2122,1211,643,568,55,22.01818181818182
ECU-001053,2122,412,173,239,9,45.77777777777778
ECU-001054,2122,999,631,368,40,24.975
ECU-001055,2122,881,399,482,45,19.57777777777778
ECU-001056,2122,110,43,67,8,13.75
ECU-001057,2122,350,141,209,20,17.5
ECU-001058,2122,1764,731,1033,79,22.329113924050635
ECU-001059,2122,1685,759,926,65,25.923076923076923
ECU-001060,2122,885,443,442,39,22.692307692307693
ECU-001061,2122,1130,526,604,58,19.482758620689655
ECU-001062,2122,1709,622,1087,67,25.507462686567163
ECU-001063,2122,1002,490,512,63,15.904761904761905
ECU-001064,2122,706,354,352,55,12.836363636363636
ECU-001065,2122,998,998,0,50,19.96
ECU-001066,2122,382,146,236,21,18.19047619047619
ECU-001067,2122,671,235,436,36,18.63888888888889
ECU-001068,2122,495,223,272,30,16.5
ECU-001069,2122,929,901,28,53,17.528301886792452
ECU-001070,2122,231,115,116,15,15.4
ECU-001071,2122,212,72,140,10,21.2
ECU-001072,2122,232,103,129,13,17.846153846153847
ECU-001073,2122,501,254,247,29,17.275862068965516
ECU-001074,2122,3704,1582,2122,153,24.209150326797385
ECU-001075,2122,4347,2740,1607,146,29.773972602739725
ECU-001076,2122,1176,570,606,46,25.565217391304348
ECU-001077,2122,349,311,38,34,10.264705882352942
ECU-001078,2122,1822,956,866,96,18.979166666666668
ECU-001079,2122,265,143,122,19,13.947368421052632
ECU-001080,2122,1329,561,768,54,24.61111111111111
ECU-001081,2122,93,37,56,11,8.454545454545455
ECU-001082,2122,1867,916,951,77,24.246753246753247
ECU-001083,2122,877,395,482,44,19.931818181818183
ECU-001084,2122,198,0,198,20,9.9
ECU-001085,2122,63,27,36,6,10.5
ECU-001086,2122,572,258,314,39,14.666666666666666
ECU-001087,2122,259,125,134,15,17.266666666666666
ECU-001088,2122,106,53,53,6,17.666666666666668
ECU-001089,2122,8,3,5,1,8.0
ECU-001090,2122,6,2,4,1,6.0
ECU-001091,2122,181,94,87,14,12.928571428571429
ECU-001092,2122,193,102,91,10,19.3
ECU-001093,2122,332,155,177,27,12.296296296296296
ECU-001094,2122,125,47,78,13,9.615384615384615
ECU-001095,2122,650,324,326,43,15.116279069767442
ECU-001096,2122,30,12,18,1,30.0
ECU-001097,2122,499,233,266,34,14.676470588235293
ECU-001098,2122,501,252,249,34,14.735294117647058
ECU-001099,2122,11,4,7,1,11.0
ECU-001100,2122,388,184,204,21,18.476190476190474
ECU-001101,2122,199,94,105,16,12.4375
ECU-001102,2122,964,502,462,54,17.85185185185185
ECU-001103,2122,974,493,481,33,29.515151515151516
ECU-001104,2122,1104,562,542,52,21.23076923076923
ECU-001105,2122,1751,905,846,62,28.241935483870968
ECU-001106,2122,878,424,454,31,28.322580645161292
ECU-001107,2122,143,76,67,10,14.3
ECU-001108,2122,688,362,326,32,21.5
ECU-001109,2122,1978,874,1104,88,22.477272727272727
ECU-001110,2122,190,88,102,8,23.75
ECU-001111,2122,881,398,483,37,23.81081081081081
ECU-001112,2122,2707,1594,1113,110,24.60909090909091
ECU-001113,2122,331,178,153,20,16.55
ECU-001114,2122,551,244,307,30,18.366666666666667
ECU-001115,2122,94,50,44,11,8.545454545454545
ECU-001116,2122,616,277,339,37,16.64864864864865
ECU-001117,2122,1461,706,755,59,24.76271186440678
ECU-001118,2122,391,196,195,24,16.291666666666668
ECU-001119,2122,541,270,271,31,17.451612903225808
ECU-001120,2122,1097,564,533,48,22.854166666666668
ECU-001121,2122,708,355,353,42,16.857142857142858
ECU-001122,2122,1273,572,701,60,21.216666666666665
ECU-001123,2122,295,137,158,16,18.4375
ECU-001124,2122,916,447,469,38,24.105263157894736
ECU-001125,2122,17,8,9,1,17.0
ECU-001126,2122,5,2,3,1,5.0
ECU-001127,2122,9,4,5,1,9.0
ECU-001128,2122,655,331,324,27,24.25925925925926
ECU-001129,2122,14,6,8,1,14.0
ECU-001130,2122,21,15,6,1,21.0
ECU-001131,2122,16,6,10,1,16.0
ECU-001132,2122,9,5,4,1,9.0
ECU-001133,2122,8,6,2,1,8.0
ECU-001134,2122,61,24,37,3,20.333333333333332
ECU-001135,2122,481,254,227,28,17.178571428571427
ECU-001136,2122,23,15,8,1,23.0
ECU-001137,2122,18,10,8,1,18.0
ECU-001138,2122,15,6,9,1,15.0
ECU-001139,2122,9,6,3,1,9.0
ECU-001140,2122,16,8,8,1,16.0
ECU-001141,2122,9,3,6,1,9.0
ECU-001142,2122,17,7,10,1,17.0
ECU-001143,2122,28,8,20,1,28.0
ECU-001144,2122,24,10,14,1,24.0
ECU-001145,2122,182,76,106,10,18.2
ECU-001146,2122,1285,622,663,52,24.71153846153846
ECU-001147,2122,4,3,1,1,4.0
ECU-001148,2122,23,8,15,1,23.0
ECU-001149,2122,567,296,271,29,19.551724137931036
ECU-001150,2122,132,81,51,7,18.857142857142858
ECU-001151,2122,11,3,8,1,11.0
ECU-001152,2122,17,9,8,1,17.0
ECU-001153,2122,6,1,5,1,6.0
ECU-001154,2122,17,9,8,1,17.0
ECU-001155,2122,216,112,104,13,16.615384615384617
ECU-001156,2122,27,17,10,1,27.0
ECU-001157,2122,584,285,299,29,20.137931034482758
ECU-001158,2122,106,52,54,10,10.6
ECU-001159,2122,84,42,42,5,16.8
ECU-001160,2122,27,15,12,1,27.0
ECU-001161,2122,25,15,10,1,25.0
ECU-001162,2122,12,5,7,1,12.0
ECU-001163,2122,43,24,19,2,21.5
ECU-001164,2122,166,84,82,12,13.833333333333334
ECU-001165,2122,10,5,5,1,10.0
ECU-001166,2122,10,2,8,1,10.0
ECU-001167,2122,30,18,12,1,30.0
ECU-001168,2122,11,3,8,1,11.0
ECU-001169,2122,455,223,232,28,16.25
ECU-001170,2122,9,5,4,1,9.0
ECU-001171,2122,715,358,357,36,19.86111111111111
ECU-001172,2122,729,366,363,39,18.692307692307693
ECU-001173,2122,339,162,177,19,17.842105263157894
ECU-001174,2122,17,9,8,1,17.0
ECU-001175,2122,17,11,6,1,17.0
ECU-001176,2122,17,7,10,1,17.0
ECU-001177,2122,22,8,14,1,22.0
ECU-001178,2122,10,5,5,1,10.0
ECU-001179,2122,11,6,5,1,11.0
ECU-001180,2122,1140,866,274,54,21.11111111111111
ECU-001181,2122,356,148,208,19,18.736842105263158
ECU-001182,2122,2523,1413,1110,85,29.68235294117647
ECU-001183,2122,1861,878,983,73,25.493150684931507
ECU-001184,2122,199,94,105,17,11.705882352941176
ECU-001185,2122,719,341,378,33,21.78787878787879
ECU-001186,2122,2949,1615,1334,98,30.091836734693878
ECU-001187,2122,3187,1356,1831,118,27.008474576271187
ECU-001188,2122,199,95,104,18,11.055555555555555
ECU-001189,2122,258,108,150,16,16.125
ECU-001190,2122,45,17,28,5,9.0
ECU-001191,2122,1207,593,614,56,21.553571428571427
ECU-001192,2122,192,86,106,12,16.0
ECU-001193,2122,294,93,201,18,16.333333333333332
ECU-001194,2122,1217,583,634,53,22.962264150943398
ECU-001195,2122,126,53,73,7,18.0
ECU-001196,2122,704,326,378,39,18.05128205128205
ECU-001197,2122,1922,1050,872,74,25.972972972972972
ECU-001198,2122,2358,1278,1080,93,25.35483870967742
ECU-001199,2122,18,1,17,11,1.6363636363636365
ECU-001200,2122,559,276,283,28,19.964285714285715
ECU-001201,2122,2305,1114,1191,97,23.762886597938145
ECU-001202,2122,270,135,135,14,19.285714285714285
ECU-001203,2122,646,327,319,31,20.838709677419356
ECU-001204,2122,2,2,0,1,2.0
ECU-001205,2122,20,12,8,1,20.0
ECU-001206,2122,19,7,12,1,19.0
ECU-001207,2122,22,13,9,1,22.0
ECU-001208,2122,24,10,14,1,24.0
ECU-001209,2122,294,138,156,17,17.294117647058822
ECU-001210,2122,12,6,6,1,12.0
ECU-001211,2122,22,17,5,4,5.5
ECU-001212,2122,186,103,83,13,14.307692307692308
ECU-001213,2122,18,8,10,1,18.0
ECU-001214,2122,5,3,2,1,5.0
ECU-001215,2122,11,9,2,1,11.0
ECU-001216,2122,287,149,138,16,17.9375
ECU-001217,2122,2218,1167,1051,84,26.404761904761905
ECU-001218,2122,79,43,36,5,15.8
ECU-001219,2122,253,118,135,18,14.055555555555555
ECU-001220,2122,13,6,7,1,13.0
ECU-001221,2122,160,86,74,17,9.411764705882353
ECU-001222,2122,7,4,3,1,7.0
ECU-001223,2122,732,324,408,36,20.333333333333332
ECU-001224,2122,1303,731,572,73,17.84931506849315
ECU-001225,2122,131,57,74,10,13.1
ECU-001226,2122,439,213,226,22,19.954545454545453
ECU-001227,2122,295,151,144,23,12.826086956521738
ECU-001228,2122,16,6,10,1,16.0
ECU-001229,2122,27,17,10,2,13.5
ECU-001230,2122,221,111,110,16,13.8125
ECU-001231,2122,90,48,42,3,30.0
ECU-001232,2122,502,233,269,24,20.916666666666668
ECU-001233,2122,130,58,72,7,18.571428571428573
ECU-001234,2122,284,141,143,13,21.846153846153847
ECU-001235,2122,32,15,17,2,16.0
ECU-001236,2122,294,139,155,20,14.7
ECU-001237,2122,66,20,46,6,11.0
ECU-001238,2122,299,116,183,10,29.9
ECU-001239,2122,585,292,293,32,18.28125
ECU-001240,2122,253,89,164,17,14.882352941176471
ECU-001241,2122,521,254,267,32,16.28125
ECU-001242,2122,16,11,5,1,16.0
ECU-001243,2122,186,80,106,7,26.571428571428573
ECU-001244,2122,72,40,32,3,24.0
ECU-001245,2122,63,32,31,5,12.6
ECU-001246,2122,5,1,4,1,5.0
ECU-001247,2122,28,14,14,2,14.0
ECU-001248,2122,19,8,11,5,3.8
ECU-001249,2122,103,47,56,7,14.714285714285714
ECU-001250,2122,88,41,47,19,4.631578947368421
ECU-001251,2122,51,27,24,5,10.2
ECU-001252,2122,21,13,8,1,21.0
ECU-001253,2122,25,14,11,3,8.333333333333334
ECU-001254,2122,28,15,13,2,14.0
ECU-001255,2122,39,19,20,6,6.5
ECU-001256,2122,63,27,36,4,15.75
ECU-001257,2122,42,17,25,7,6.0
ECU-001258,2122,52,27,25,7,7.428571428571429
ECU-001259,2122,115,55,60,13,8.846153846153847
ECU-001260,2122,21,9,12,2,10.5
ECU-001261,2122,243,114,129,8,30.375
ECU-001262,2122,99,36,63,12,8.25
ECU-001263,2122,28,16,12,3,9.333333333333334
ECU-001264,2122,20,12,8,5,4.0
ECU-001265,2122,209,84,125,9,23.22222222222222
ECU-001266,2122,8,2,6,2,4.0
ECU-001267,2122,34,14,20,8,4.25
ECU-001268,2122,100,44,56,11,9.090909090909092
ECU-001269,2122,587,209,378,23,25.52173913043478
ECU-001270,2122,12,5,7,1,12.0
ECU-001271,2122,1042,532,510,50,20.84
ECU-001272,2122,127,65,62,9,14.11111111111111
ECU-001273,2122,107,46,61,7,15.285714285714286
ECU-001274,2122,6,2,4,1,6.0
ECU-001275,2122,6,2,4,1,6.0
ECU-001276,2122,12,5,7,1,12.0
ECU-001277,2122,45,22,23,2,22.5
ECU-001278,2122,231,124,107,16,14.4375
ECU-001279,2122,10,5,5,1,10.0
ECU-001280,2122,4,3,1,1,4.0
ECU-001281,2122,7,3,4,1,7.0
ECU-001282,2122,29,13,16,1,29.0
ECU-001283,2122,76,36,40,3,25.333333333333332
ECU-001284,2122,51,20,31,2,25.5
ECU-001285,2122,22,11,11,1,22.0
ECU-001286,2122,47,21,26,2,23.5
ECU-001287,2122,140,71,69,8,17.5
ECU-001288,2122,262,148,114,21,12.476190476190476
ECU-001289,2122,5,3,2,1,5.0
ECU-001290,2122,27,15,12,1,27.0
ECU-001291,2122,134,63,71,6,22.333333333333332
ECU-001292,2122,17,9,8,1,17.0
ECU-001293,2122,82,39,43,3,27.333333333333332
ECU-001294,2122,23,16,7,1,23.0
ECU-001295,2122,122,65,57,10,12.2
ECU-001296,2122,185,89,96,10,18.5
ECU-001297,2122,60,30,30,2,30.0
ECU-001298,2122,4,1,3,1,4.0
ECU-001299,2122,9,3,6,1,9.0
ECU-001300,2122,13,8,5,1,13.0
ECU-001301,2122,10,5,5,1,10.0
ECU-001302,2122,22,9,13,1,22.0
ECU-001303,2122,5,2,3,1,5.0
ECU-001304,2122,145,64,81,13,11.153846153846153
ECU-001305,2122,24,11,13,2,12.0
ECU-001306,2122,8,3,5,1,8.0
ECU-001307,2122,13,4,9,1,13.0
ECU-001308,2122,31,12,19,2,15.5
ECU-001309,2122,45,21,24,2,22.5
ECU-001310,2122,18,8,10,1,18.0
ECU-001311,2122,7,2,5,1,7.0
ECU-001312,2122,26,12,14,2,13.0
ECU-001313,2122,10,4,6,1,10.0
ECU-001314,2122,25,15,10,1,25.0
ECU-001315,2122,30,19,11,1,30.0
ECU-001316,2122,5,3,2,1,5.0
ECU-001317,2122,56,29,27,3,18.666666666666668
ECU-001318,2122,59,25,34,3,19.666666666666668
ECU-001319,2122,38,17,21,1,38.0
ECU-001320,2122,125,52,73,8,15.625
ECU-001321,2122,22,15,7,1,22.0
ECU-001322,2122,9,6,3,1,9.0
ECU-001323,2122,9,6,3,1,9.0
ECU-001324,2122,20,8,12,1,20.0
ECU-001325,2122,7,5,2,1,7.0
ECU-001326,2122,18,6,12,1,18.0
ECU-001327,2122,79,37,42,5,15.8
ECU-001328,2122,94,48,46,6,15.666666666666666
ECU-001329,2122,176,88,88,9,19.555555555555557
ECU-001330,2122,605,277,328,27,22.40740740740741
ECU-001331,2122,87,48,39,6,14.5
ECU-001332,2122,37,20,17,1,37.0
ECU-001333,2122,55,34,21,2,27.5
ECU-001334,2122,548,258,290,27,20.296296296296298
ECU-001335,2122,55,29,26,4,13.75
ECU-001336,2122,14,6,8,1,14.0
ECU-001337,2122,48,33,15,1,48.0
ECU-001338,2122,53,32,21,8,6.625
ECU-001339,2122,15,8,7,1,15.0
ECU-001340,2122,9,5,4,1,9.0
ECU-001341,2122,19,8,11,1,19.0
ECU-001342,2122,18,10,8,1,18.0
ECU-001343,2122,17,5,12,1,17.0
ECU-001344,2122,19,8,11,1,19.0
ECU-001345,2122,50,26,24,3,16.666666666666668
ECU-001346,2122,25,13,12,1,25.0
ECU-001347,2122,177,84,93,12,14.75
ECU-001348,2122,28,14,14,1,28.0
ECU-001349,2122,26,9,17,1,26.0
ECU-001350,2122,19,10,9,1,19.0
ECU-001351,2122,16,10,6,1,16.0
ECU-001352,2122,6,3,3,1,6.0
ECU-001353,2122,19,9,10,1,19.0
ECU-001354,2122,22,13,9,1,22.0
ECU-001355,2122,63,33,30,3,21.0
ECU-001356,2122,47,20,27,2,23.5
ECU-001357,2122,7,4,3,1,7.0
ECU-001358,2122,44,21,23,2,22.0
ECU-001359,2122,23,11,12,1,23.0
ECU-001360,2122,61,27,34,2,30.5
ECU-001361,2122,41,20,21,3,13.666666666666666
ECU-001362,2122,51,26,25,2,25.5
ECU-001363,2122,15,5,10,1,15.0
ECU-001364,2122,43,18,25,2,21.5
ECU-001365,2122,12,6,6,1,12.0
ECU-001366,2122,53,32,21,5,10.6
ECU-001367,2122,14,8,6,1,14.0
ECU-001368,2122,6,4,2,1,6.0
ECU-001369,2122,10,4,6,2,5.0
ECU-001370,2122,179,81,98,12,14.916666666666666
ECU-001371,2122,14,7,7,1,14.0
ECU-001372,2122,77,36,41,3,25.666666666666668
ECU-001373,2122,9,3,6,1,9.0
ECU-001374,2122,13,6,7,1,13.0
ECU-001375,2122,15,8,7,1,15.0
ECU-001376,2122,5,3,2,1,5.0
ECU-001377,2122,13,8,5,1,13.0
ECU-001378,2122,18,12,6,1,18.0
ECU-001379,2122,24,14,10,1,24.0
ECU-001380,2122,23,15,8,1,23.0
ECU-001381,2122,11,6,5,1,11.0
ECU-001382,2122,10,6,4,1,10.0
ECU-001383,2122,14,5,9,1,14.0
ECU-001384,2122,433,236,197,20,21.65
ECU-001385,2122,5,1,4,1,5.0
ECU-001386,2122,5,2,3,1,5.0
ECU-001387,2122,24,15,9,1,24.0
ECU-001388,2122,57,2,55,7,8.142857142857142
ECU-001389,2122,89,29,60,9,9.88888888888889
ECU-001390,2122,14,10,4,3,4.666666666666667
ECU-001391,2122,435,244,191,23,18.91304347826087
ECU-001392,2122,127,63,64,8,15.875
ECU-001393,2122,33,8,25,5,6.6
ECU-001394,2122,381,192,189,20,19.05
ECU-001395,2122,523,258,265,17,30.764705882352942
ECU-001396,2122,212,104,108,14,15.142857142857142
ECU-001397,2122,230,94,136,13,17.692307692307693
ECU-001398,2122,66,30,36,15,4.4
ECU-001399,2122,26,14,12,1,26.0
ECU-001400,2122,19,11,8,1,19.0
ECU-001401,2122,11,6,5,1,11.0
ECU-001402,2122,47,18,29,2,23.5
ECU-001403,2122,25,10,15,1,25.0
ECU-001404,2122,17,9,8,1,17.0
ECU-001405,2122,268,124,144,13,20.615384615384617
ECU-001406,2122,12,7,5,1,12.0
ECU-001407,2122,10,6,4,1,10.0
ECU-001408,2122,175,85,90,16,10.9375
ECU-001409,2122,20,10,10,1,20.0
ECU-001410,2122,140,81,59,10,14.0
ECU-001411,2122,44,15,29,4,11.0
ECU-001412,2122,44,18,26,5,8.8
ECU-001413,2122,10,3,7,1,10.0
ECU-001414,2122,17,5,12,1,17.0
ECU-001415,2122,1453,789,664,56,25.946428571428573
ECU-001416,2122,34,13,21,2,17.0
ECU-001417,2122,268,123,145,11,24.363636363636363
ECU-001418,2122,1480,723,757,62,23.870967741935484
ECU-001419,2122,69,40,29,4,17.25
ECU-001420,2122,25,12,13,1,25.0
ECU-001421,2122,5,2,3,1,5.0
ECU-001422,2122,567,298,269,27,21.0
ECU-001423,2122,61,25,36,5,12.2
ECU-001424,2122,180,92,88,8,22.5
ECU-001425,2122,545,309,236,23,23.695652173913043
ECU-001426,2122,1066,539,527,44,24.227272727272727
ECU-001427,2122,987,523,464,47,21.0
ECU-001428,2122,3779,1963,1816,140,26.992857142857144
ECU-001429,2122,1512,796,716,59,25.627118644067796
ECU-001430,2122,357,187,170,17,21.0
ECU-001431,2122,182,103,79,16,11.375
ECU-001432,2122,373,196,177,19,19.63157894736842
ECU-001433,2122,1003,479,524,39,25.71794871794872
ECU-001434,2122,722,329,393,30,24.066666666666666
ECU-001435,2122,283,142,141,18,15.722222222222221
ECU-001436,2122,89,41,48,4,22.25
ECU-001437,2122,324,142,182,14,23.142857142857142
ECU-001438,2122,16,8,8,1,16.0
ECU-001439,2122,11,6,5,1,11.0
ECU-001440,2122,9,5,4,1,9.0
ECU-001441,2122,6,2,4,1,6.0
ECU-001442,2122,22,8,14,3,7.333333333333333
ECU-001443,2122,7,2,5,1,7.0
ECU-001444,2122,12,6,6,1,12.0
ECU-001445,2122,527,289,238,30,17.566666666666666
ECU-001446,2122,18,12,6,1,18.0
ECU-001447,2122,5,4,1,1,5.0
ECU-001448,2122,10,5,5,1,10.0
ECU-001449,2122,8,6,2,1,8.0
ECU-001450,2122,27,13,14,1,27.0
ECU-001451,2122,52,25,27,4,13.0
ECU-001452,2122,15,6,9,1,15.0
ECU-001453,2122,9,4,5,1,9.0
ECU-001454,2122,17,9,8,1,17.0
ECU-001455,2122,18,7,11,1,18.0
ECU-001456,2122,20,9,11,3,6.666666666666667
ECU-001457,2122,13,3,10,1,13.0
ECU-001458,2122,4,2,2,1,4.0
ECU-001459,2122,7,4,3,1,7.0
ECU-001460,2122,46,25,21,4,11.5
ECU-001461,2122,9,5,4,1,9.0
ECU-001462,2122,2,2,0,1,2.0
ECU-001463,2122,207,96,111,10,20.7
ECU-001464,2122,15,10,5,1,15.0
ECU-001465,2122,10,5,5,1,10.0
ECU-001466,2122,10,3,7,1,10.0
ECU-001467,2122,14,9,5,1,14.0
ECU-001468,2122,29,14,15,1,29.0
ECU-001469,2122,5,0,5,1,5.0
ECU-001470,2122,10,4,6,1,10.0
ECU-001471,2122,51,20,31,2,25.5
ECU-001472,2122,17,10,7,1,17.0
ECU-001473,2122,6,4,2,1,6.0
ECU-001474,2122,22,13,9,1,22.0
ECU-001475,2122,144,60,84,8,18.0
ECU-001476,2122,10,8,2,1,10.0
ECU-001477,2122,491,266,225,24,20.458333333333332
ECU-001478,2122,14,6,8,1,14.0
ECU-001479,2122,120,67,53,7,17.142857142857142
ECU-001480,2122,29,10,19,1,29.0
ECU-001481,2122,12,5,7,1,12.0
ECU-001482,2122,18,10,8,1,18.0
ECU-001483,2122,25,13,12,1,25.0
ECU-001484,2122,20,10,10,1,20.0
ECU-001485,2122,8,2,6,1,8.0
ECU-001486,2122,722,375,347,35,20.62857142857143
ECU-001487,2122,6,4,2,1,6.0
ECU-001488,2122,167,86,81,10,16.7
ECU-001489,2122,14,3,11,1,14.0
ECU-001490,2122,29,15,14,2,14.5
ECU-001491,2122,16,9,7,1,16.0
ECU-001492,2122,9,5,4,1,9.0
ECU-001493,2122,10,6,4,1,10.0
ECU-001494,2122,22,9,13,1,22.0
ECU-001495,2122,19,8,11,1,19.0
ECU-001496,2122,7,2,5,1,7.0
ECU-001497,2122,4,2,2,1,4.0
ECU-001498,2122,22,13,9,1,22.0
ECU-001499,2122,15,6,9,1,15.0
ECU-001500,2122,12,7,5,1,12.0
ECU-001501,2122,9,2,7,1,9.0
ECU-001502,2122,11,7,4,1,11.0
ECU-001503,2122,14,7,7,1,14.0
ECU-001504,2122,10,6,4,1,10.0
ECU-001505,2122,10,6,4,1,10.0
ECU-001506,2122,15,7,8,1,15.0
ECU-001507,2122,10,4,6,1,10.0
ECU-001508,2122,127,58,69,8,15.875
ECU-001509,2122,5,3,2,1,5.0
ECU-001510,2122,6,2,4,1,6.0
ECU-001511,2122,15,9,6,1,15.0
ECU-001512,2122,18,6,12,1,18.0
ECU-001513,2122,222,107,115,12,18.5
ECU-001514,2122,142,70,72,7,20.285714285714285
ECU-001515,2122,17,7,10,1,17.0
ECU-001516,2122,22,13,9,1,22.0
ECU-001517,2122,8,2,6,1,8.0
ECU-001518,2122,310,125,185,14,22.142857142857142
ECU-001519,2122,145,80,65,8,18.125
ECU-001520,2122,244,119,125,17,14.352941176470589
ECU-001521,2122,15,8,7,2,7.5
ECU-001522,2122,18,10,8,1,18.0
ECU-001523,2122,1065,536,529,45,23.666666666666668
ECU-001524,2122,3,0,3,1,3.0
ECU-001525,2122,16,9,7,1,16.0
ECU-001526,2122,12,9,3,1,12.0
ECU-001527,2122,14,5,9,1,14.0
ECU-001528,2122,5,0,5,1,5.0
ECU-001529,2122,5,2,3,1,5.0
ECU-001530,2122,400,157,243,22,18.181818181818183
ECU-001531,2122,10,7,3,1,10.0
ECU-001532,2122,16,4,12,1,16.0
ECU-001533,2122,11,3,8,1,11.0
ECU-001534,2122,18,10,8,1,18.0
ECU-001535,2122,10,5,5,1,10.0
ECU-001536,2122,215,99,116,10,21.5
ECU-001537,2122,35,11,24,2,17.5
ECU-001538,2122,11,7,4,1,11.0
ECU-001539,2122,6,4,2,1,6.0
ECU-001540,2122,13,8,5,1,13.0
ECU-001541,2122,48,21,27,2,24.0
ECU-001542,2122,7,2,5,1,7.0
ECU-001543,2122,510,272,238,28,18.214285714285715
ECU-001544,2122,207,108,99,10,20.7
ECU-001545,2122,223,111,112,15,14.866666666666667
ECU-001546,2122,18,10,8,1,18.0
ECU-001547,2122,11,6,5,1,11.0
ECU-001548,2122,1524,747,777,63,24.19047619047619
ECU-001549,2122,12,4,8,1,12.0
ECU-001550,2122,57,20,37,4,14.25
ECU-001551,2122,184,78,106,15,12.266666666666667
ECU-001552,2122,56,19,37,3,18.666666666666668
ECU-001553,2122,405,214,191,18,22.5
ECU-001554,2122,1128,576,552,48,23.5
ECU-001555,2122,6,1,5,1,6.0
ECU-001556,2122,11,7,4,1,11.0
ECU-001557,2122,470,234,236,23,20.434782608695652
ECU-001558,2122,10,3,7,1,10.0
ECU-001559,2122,26,12,14,1,26.0
ECU-001560,2122,39,24,15,1,39.0
ECU-001561,2122,52,23,29,6,8.666666666666666
ECU-001562,2122,36,12,24,2,18.0
ECU-001563,2122,10,4,6,1,10.0
ECU-001564,2122,12,5,7,1,12.0
ECU-001565,2122,22,12,10,2,11.0
ECU-001566,2122,8,4,4,1,8.0
ECU-001567,2122,114,63,51,7,16.285714285714285
ECU-001568,2122,13,6,7,1,13.0
ECU-001569,2122,6,2,4,1,6.0
ECU-001570,2122,3,3,0,1,3.0
ECU-001571,2122,101,47,54,8,12.625
ECU-001572,2122,23,17,6,1,23.0
ECU-001573,2122,73,36,37,4,18.25
ECU-001574,2122,159,70,89,8,19.875
ECU-001575,2122,211,109,102,12,17.583333333333332
ECU-001576,2122,38,21,17,2,19.0
ECU-001577,2122,202,107,95,12,16.833333333333332
ECU-001578,2122,118,48,70,8,14.75
ECU-001579,2122,168,79,89,14,12.0
ECU-001580,2122,36,16,20,1,36.0
ECU-001581,2122,180,96,84,11,16.363636363636363
ECU-001582,2122,32,11,21,1,32.0
ECU-001583,2122,27,15,12,1,27.0
ECU-001584,2122,178,88,90,8,22.25
ECU-001585,2122,1668,905,763,76,21.94736842105263
ECU-001586,2122,322,168,154,14,23.0
ECU-001587,2122,60,23,37,3,20.0
ECU-001588,2122,31,14,17,1,31.0
ECU-001589,2122,46,26,20,2,23.0
ECU-001590,2122,21,15,6,1,21.0
ECU-001591,2122,319,154,165,15,21.266666666666666
ECU-001592,2122,405,214,191,16,25.3125
ECU-001593,2122,75,33,42,6,12.5
ECU-001594,2122,243,128,115,10,24.3
ECU-001595,2122,30,14,16,1,30.0
ECU-001596,2122,7,4,3,1,7.0
ECU-001597,2122,45,28,17,2,22.5
ECU-001598,2122,752,382,370,30,25.066666666666666
ECU-001599,2122,117,52,65,4,29.25
ECU-001600,2122,1779,873,906,72,24.708333333333332
ECU-001601,2122,1388,826,562,59,23.52542372881356
ECU-001602,2122,784,412,372,39,20.102564102564102
ECU-001603,2122,347,169,178,13,26.692307692307693
ECU-001604,2122,132,65,67,6,22.0
ECU-001605,2122,35,21,14,1,35.0
ECU-001606,2122,82,45,37,5,16.4
ECU-001607,2122,19,9,10,1,19.0
ECU-001608,2122,272,158,114,11,24.727272727272727
ECU-001609,2122,17,9,8,1,17.0
ECU-001610,2122,278,131,147,11,25.272727272727273
ECU-001611,2122,215,104,111,8,26.875
ECU-001612,2122,39,11,28,1,39.0
ECU-001613,2122,163,84,79,7,23.285714285714285
ECU-001614,2122,443,214,229,22,20.136363636363637
ECU-001615,2122,57,35,22,4,14.25
ECU-001616,2122,190,99,91,11,17.272727272727273
ECU-001617,2122,35,18,17,2,17.5
ECU-001618,2122,20,7,13,1,20.0
ECU-001619,2122,922,513,409,36,25.61111111111111
ECU-001620,2122,593,250,343,32,18.53125
ECU-001621,2122,87,42,45,6,14.5
ECU-001622,2122,107,62,45,6,17.833333333333332
ECU-001623,2122,40,23,17,1,40.0
ECU-001624,2122,14,8,6,1,14.0
ECU-001625,2122,255,133,122,16,15.9375
ECU-001626,2122,12,6,6,1,12.0
ECU-001627,2122,22,9,13,1,22.0
ECU-001628,2122,7,2,5,1,7.0
ECU-001629,2122,292,153,139,20,14.6
ECU-001630,2122,16,8,8,1,16.0
ECU-001631,2122,12,6,6,1,12.0
ECU-001632,2122,6,2,4,1,6.0
ECU-001633,2122,42,18,24,2,21.0
ECU-001634,2122,7,1,6,1,7.0
ECU-001635,2122,161,71,90,14,11.5
ECU-001636,2122,6,3,3,1,6.0
ECU-001637,2122,92,46,46,8,11.5
ECU-001638,2122,1562,811,751,64,24.40625
ECU-001639,2122,9,2,7,1,9.0
ECU-001640,2122,6,4,2,1,6.0
ECU-001641,2122,25,12,13,1,25.0
ECU-001642,2122,575,287,288,24,23.958333333333332
ECU-001643,2122,23,12,11,1,23.0
ECU-001644,2122,17,5,12,1,17.0
ECU-001645,2122,22,10,12,1,22.0
ECU-001646,2122,79,24,55,9,8.777777777777779
ECU-001647,2122,210,98,112,17,12.352941176470589
ECU-001648,2122,14,9,5,1,14.0
ECU-001649,2122,4,2,2,1,4.0
ECU-001650,2122,13,6,7,1,13.0
ECU-001651,2122,552,264,288,22,25.09090909090909
ECU-001652,2122,134,71,63,11,12.181818181818182
ECU-001653,2122,50,19,31,4,12.5
ECU-001654,2122,45,23,22,3,15.0
ECU-001655,2122,1,1,0,1,1.0
ECU-001656,2122,13,6,7,1,13.0
ECU-001657,2122,8,2,6,1,8.0
ECU-001658,2122,11,6,5,1,11.0
ECU-001659,2122,4,2,2,1,4.0
ECU-001660,2122,219,107,112,12,18.25
ECU-001661,2122,7,4,3,1,7.0
ECU-001662,2122,33,13,20,2,16.5
ECU-001663,2122,145,71,74,9,16.11111111111111
ECU-001664,2122,15,8,7,1,15.0
ECU-001665,2122,6,4,2,1,6.0
ECU-001666,2122,45,19,26,2,22.5
ECU-001667,2122,19,10,9,1,19.0
ECU-001668,2122,32,11,21,2,16.0
ECU-001669,2122,317,129,188,16,19.8125
ECU-001670,2122,128,57,71,9,14.222222222222221
ECU-001671,2122,15,8,7,1,15.0
ECU-001672,2122,12,5,7,1,12.0
ECU-001673,2122,6,2,4,1,6.0
ECU-001674,2122,7,4,3,1,7.0
ECU-001675,2122,4,2,2,1,4.0
ECU-001676,2122,329,173,156,23,14.304347826086957
ECU-001677,2122,24,13,11,5,4.8
ECU-001678,2122,27,11,16,3,9.0
ECU-001679,2122,46,28,18,11,4.181818181818182
ECU-001680,2122,706,230,476,25,28.24
ECU-001681,2122,65,32,33,8,8.125
ECU-001682,2122,17,8,9,3,5.666666666666667
ECU-001683,2122,67,30,37,5,13.4
ECU-001684,2122,81,29,52,3,27.0
ECU-001685,2122,46,19,27,5,9.2
ECU-001686,2122,269,0,269,10,26.9
ECU-001687,2122,104,46,58,6,17.333333333333332
ECU-001688,2122,568,266,302,34,16.705882352941178
ECU-001689,2122,336,171,165,24,14.0
ECU-001690,2122,589,339,250,29,20.310344827586206
ECU-001691,2122,344,173,171,30,11.466666666666667
ECU-001692,2122,1281,666,615,47,27.25531914893617
ECU-001693,2122,74,30,44,12,6.166666666666667
ECU-001694,2122,12,6,6,2,6.0
ECU-001695,2122,21,17,4,3,7.0
ECU-001696,2122,57,25,32,2,28.5
ECU-001697,2122,21,11,10,1,21.0
ECU-001698,2122,71,43,28,8,8.875
ECU-001699,2122,188,98,90,13,14.461538461538462
ECU-001700,2122,512,267,245,21,24.38095238095238
ECU-001701,2122,11,4,7,1,11.0
ECU-001702,2122,211,103,108,18,11.722222222222221
ECU-001703,2122,338,165,173,20,16.9
ECU-001704,2122,89,40,49,7,12.714285714285714
ECU-001705,2122,47,28,19,2,23.5
ECU-001706,2122,31,12,19,2,15.5
ECU-001707,2122,187,99,88,16,11.6875
ECU-001708,2122,17,8,9,1,17.0
ECU-001709,2122,41,20,21,2,20.5
ECU-001710,2122,16,10,6,1,16.0
ECU-001711,2122,8,4,4,1,8.0
ECU-001712,2122,31,20,11,2,15.5
ECU-001713,2122,21,10,11,1,21.0
ECU-001714,2122,7,4,3,1,7.0
ECU-001715,2122,26,13,13,1,26.0
ECU-001716,2122,21,10,11,1,21.0
ECU-001717,2122,388,188,200,20,19.4
ECU-001718,2122,56,27,29,4,14.0
ECU-001719,2122,57,24,33,5,11.4
ECU-001720,2122,40,16,24,2,20.0
ECU-001721,2122,10,3,7,1,10.0
ECU-001722,2122,20,8,12,1,20.0
ECU-001723,2122,18,8,10,1,18.0
ECU-001724,2122,9,6,3,1,9.0
ECU-001725,2122,112,59,53,7,16.0
ECU-001726,2122,11,5,6,1,11.0
ECU-001727,2122,8,5,3,1,8.0
ECU-001728,2122,22,13,9,1,22.0
ECU-001729,2122,7,5,2,1,7.0
ECU-001730,2122,36,15,21,1,36.0
ECU-001731,2122,14,6,8,1,14.0
ECU-001732,2122,32,17,15,2,16.0
ECU-001733,2122,131,76,55,9,14.555555555555555
ECU-001734,2122,300,144,156,27,11.11111111111111
ECU-001735,2122,90,45,45,10,9.0
ECU-001736,2122,24,14,10,1,24.0
ECU-001737,2122,27,11,16,2,13.5
ECU-001738,2122,12,6,6,1,12.0
ECU-001739,2122,245,106,139,21,11.666666666666666
ECU-001740,2122,13,7,6,1,13.0
ECU-001741,2122,12,6,6,1,12.0
ECU-001742,2122,17,7,10,2,8.5
ECU-001743,2122,11,8,3,1,11.0
ECU-001744,2122,44,24,20,2,22.0
ECU-001745,2122,17,11,6,1,17.0
ECU-001746,2122,172,83,89,16,10.75
ECU-001747,2122,113,46,67,15,7.533333333333333
ECU-001748,2122,59,28,31,3,19.666666666666668
ECU-001749,2122,10,7,3,1,10.0
ECU-001750,2122,40,17,23,2,20.0
ECU-001751,2122,15,7,8,1,15.0
ECU-001752,2122,32,15,17,2,16.0
ECU-001753,2122,3,1,2,1,3.0
ECU-001754,2122,92,43,49,8,11.5
ECU-001755,2122,29,17,12,2,14.5
ECU-001756,2122,10,6,4,1,10.0
ECU-001757,2122,46,18,28,3,15.333333333333334
ECU-001758,2122,12,6,6,1,12.0
ECU-001759,2122,10,4,6,1,10.0
ECU-001760,2122,29,16,13,2,14.5
ECU-001761,2122,169,78,91,13,13.0
ECU-001762,2122,27,15,12,1,27.0
ECU-001763,2122,38,23,15,2,19.0
ECU-001764,2122,52,23,29,3,17.333333333333332
ECU-001765,2122,21,11,10,2,10.5
ECU-001766,2122,239,117,122,19,12.578947368421053
ECU-001767,2122,61,34,27,3,20.333333333333332
ECU-001768,2122,317,170,147,19,16.68421052631579
ECU-001769,2122,54,25,29,3,18.0
ECU-001770,2122,144,85,59,12,12.0
ECU-001771,2122,18,5,13,1,18.0
ECU-001772,2122,316,165,151,21,15.047619047619047
ECU-001773,2122,81,46,35,7,11.571428571428571
ECU-001774,2122,11,6,5,1,11.0
ECU-001775,2122,12,6,6,1,12.0
ECU-001776,2122,32,17,15,2,16.0
ECU-001777,2122,227,116,111,21,10.80952380952381
ECU-001778,2122,218,106,112,17,12.823529411764707
ECU-001779,2122,30,12,18,2,15.0
ECU-001780,2122,46,24,22,3,15.333333333333334
ECU-001781,2122,93,45,48,8,11.625
ECU-001782,2122,40,21,19,2,20.0
ECU-001783,2122,28,20,8,1,28.0
ECU-001784,2122,31,9,22,2,15.5
ECU-001785,2122,59,25,34,3,19.666666666666668
ECU-001786,2122,9,7,2,1,9.0
ECU-001787,2122,19,14,5,2,9.5
ECU-001788,2122,8,4,4,1,8.0
ECU-001789,2122,143,62,81,12,11.916666666666666
ECU-001790,2122,363,173,190,24,15.125
ECU-001791,2122,19,10,9,2,9.5
ECU-001792,2122,20,12,8,2,10.0
ECU-001793,2122,92,40,52,5,18.4
ECU-001794,2122,17,12,5,2,8.5
ECU-001795,2122,23,9,14,2,11.5
ECU-001796,2122,4,2,2,1,4.0
ECU-001797,2122,143,69,74,14,10.214285714285714
ECU-001798,2122,33,20,13,1,33.0
ECU-001799,2122,31,17,14,2,15.5
ECU-001800,2122,220,115,105,12,18.333333333333332
ECU-001801,2122,534,260,274,30,17.8
ECU-001802,2122,50,26,24,3,16.666666666666668
ECU-001803,2122,179,80,99,14,12.785714285714286
ECU-001804,2122,74,24,50,11,6.7272727272727275
ECU-001805,2122,131,65,66,10,13.1
ECU-001806,2122,368,199,169,21,17.523809523809526
ECU-001807,2122,433,202,231,30,14.433333333333334
ECU-001808,2122,14,10,4,1,14.0
ECU-001809,2122,12,6,6,1,12.0
ECU-001810,2122,9,6,3,1,9.0
ECU-001811,2122,43,23,20,3,14.333333333333334
ECU-001812,2122,85,38,47,8,10.625
ECU-001813,2122,24,12,12,1,24.0
ECU-001814,2122,1016,392,624,44,23.09090909090909
ECU-001815,2122,42,20,22,2,21.0
ECU-001816,2122,135,67,68,11,12.272727272727273
ECU-001817,2122,2252,1121,1131,117,19.247863247863247
ECU-001818,2122,1817,900,917,97,18.7319587628866
ECU-001819,2122,1465,820,645,72,20.34722222222222
ECU-001820,2122,11,8,3,1,11.0
ECU-001821,2122,27,13,14,1,27.0
ECU-001822,2122,273,130,143,18,15.166666666666666
ECU-001823,2122,1533,738,795,67,22.880597014925375
ECU-001824,2122,1876,935,941,84,22.333333333333332
ECU-001825,2122,1493,679,814,84,17.773809523809526
ECU-001826,2122,432,203,229,23,18.782608695652176
ECU-001827,2122,99,44,55,24,4.125
ECU-001828,2122,300,157,143,18,16.666666666666668
ECU-001829,2122,669,337,332,38,17.605263157894736
ECU-001830,2122,76,39,37,4,19.0
ECU-001831,2122,22,12,10,1,22.0
ECU-001832,2122,18,10,8,1,18.0
ECU-001833,2122,22,13,9,1,22.0
ECU-001834,2122,18,7,11,1,18.0
ECU-001835,2122,21,9,12,1,21.0
ECU-001836,2122,42,26,16,3,14.0
ECU-001837,2122,357,186,171,28,12.75
ECU-001838,2122,7,3,4,1,7.0
ECU-001839,2122,20,14,6,1,20.0
ECU-001840,2122,22,11,11,1,22.0
ECU-001841,2122,26,18,8,2,13.0
ECU-001842,2122,11,5,6,1,11.0
ECU-001843,2122,132,68,64,13,10.153846153846153
ECU-001844,2122,7,5,2,1,7.0
ECU-001845,2122,12,6,6,1,12.0
ECU-001846,2122,20,11,9,1,20.0
ECU-001847,2122,47,23,24,4,11.75
ECU-001848,2122,18,6,12,1,18.0
ECU-001849,2122,155,71,84,10,15.5
ECU-001850,2122,6,6,0,1,6.0
ECU-001851,2122,17,10,7,1,17.0
ECU-001852,2122,13,8,5,1,13.0
ECU-001853,2122,256,133,123,16,16.0
ECU-001854,2122,116,66,50,14,8.285714285714286
ECU-001855,2122,37,19,18,2,18.5
ECU-001856,2122,195,100,95,18,10.833333333333334
ECU-001857,2122,12,6,6,1,12.0
ECU-001858,2122,36,23,13,2,18.0
ECU-001859,2122,503,259,244,30,16.766666666666666
ECU-001860,2122,11,4,7,1,11.0
ECU-001861,2122,7,4,3,1,7.0
ECU-001862,2122,21,13,8,2,10.5
ECU-001863,2122,10,6,4,1,10.0
ECU-001864,2122,64,30,34,3,21.333333333333332
ECU-001865,2122,965,435,530,46,20.97826086956522
ECU-001866,2122,24,7,17,1,24.0
ECU-001867,2122,5,3,2,1,5.0
ECU-001868,2122,15,9,6,1,15.0
ECU-001869,2122,24,13,11,1,24.0
ECU-001870,2122,74,34,40,4,18.5
ECU-001871,2122,56,30,26,3,18.666666666666668
ECU-001872,2122,420,238,182,29,14.482758620689655
ECU-001873,2122,2437,1164,1273,108,22.564814814814813
ECU-001874,2122,1589,950,639,76,20.907894736842106
ECU-001875,2122,120,54,66,13,9.23076923076923
ECU-001876,2122,249,134,115,15,16.6
ECU-001877,2122,23,15,8,2,11.5
ECU-001878,2122,37,20,17,3,12.333333333333334
ECU-001879,2122,117,55,62,8,14.625
ECU-001880,2122,34,22,12,3,11.333333333333334
ECU-001881,2122,30,15,15,2,15.0
ECU-001882,2122,9,6,3,1,9.0
ECU-001883,2122,12,3,9,1,12.0
ECU-001884,2122,8,4,4,1,8.0
ECU-001885,2122,50,27,23,3,16.666666666666668
ECU-001886,2122,38,20,18,2,19.0
ECU-001887,2122,909,456,453,55,16.527272727272727
ECU-001888,2122,57,28,29,3,19.0
ECU-001889,2122,129,66,63,9,14.333333333333334
ECU-001890,2122,75,42,33,7,10.714285714285714
ECU-001891,2122,106,50,56,7,15.142857142857142
ECU-001892,2122,27,13,14,2,13.5
ECU-001893,2122,30,13,17,5,6.0
ECU-001894,2122,518,271,247,33,15.696969696969697
ECU-001895,2122,695,332,363,72,9.652777777777779
ECU-001896,2122,504,251,253,33,15.272727272727273
ECU-001897,2122,26,9,17,3,8.666666666666666
ECU-001898,2122,8,2,6,2,4.0
ECU-001899,2122,18,7,11,3,6.0
ECU-001900,2122,167,81,86,16,10.4375
ECU-001901,2122,9,3,6,1,9.0
ECU-001902,2122,25,14,11,3,8.333333333333334
ECU-001903,2122,39,19,20,4,9.75
ECU-001904,2122,614,307,307,44,13.954545454545455
ECU-001905,2122,63,28,35,3,21.0
ECU-001906,2122,54,28,26,7,7.714285714285714
ECU-001907,2122,78,37,41,11,7.090909090909091
ECU-001908,2122,789,398,391,61,12.934426229508198
ECU-001909,2122,190,103,87,15,12.666666666666666
ECU-001910,2122,81,38,43,5,16.2
ECU-001911,2122,12,6,6,1,12.0
ECU-001912,2122,14,8,6,1,14.0
ECU-001913,2122,153,69,84,13,11.76923076923077
ECU-001914,2122,662,338,324,32,20.6875
ECU-001915,2122,20,7,13,1,20.0
ECU-001916,2122,8,6,2,1,8.0
ECU-001917,2122,31,20,11,2,15.5
ECU-001918,2122,32,14,18,2,16.0
ECU-001919,2122,10,8,2,1,10.0
ECU-001920,2122,15,10,5,1,15.0
ECU-001921,2122,124,61,63,5,24.8
ECU-001922,2122,19,8,11,1,19.0
ECU-001923,2122,61,16,45,8,7.625
ECU-001924,2122,11,3,8,1,11.0
ECU-001925,2122,5,1,4,1,5.0
ECU-001926,2122,12,6,6,1,12.0
ECU-001927,2122,10,5,5,1,10.0
ECU-001928,2122,948,411,537,68,13.941176470588236
ECU-001929,2122,12,6,6,2,6.0
ECU-001930,2122,291,133,158,16,18.1875
ECU-001931,2122,20,14,6,2,10.0
ECU-001932,2122,187,99,88,13,14.384615384615385
ECU-001933,2122,31,15,16,2,15.5
ECU-001934,2122,46,23,23,6,7.666666666666667
ECU-001935,2122,7,3,4,1,7.0
ECU-001936,2122,9,1,8,1,9.0
ECU-001937,2122,490,237,253,31,15.806451612903226
ECU-001938,2122,2,1,1,1,2.0
ECU-001939,2122,38,20,18,2,19.0
ECU-001940,2122,11,4,7,1,11.0
ECU-001941,2122,39,16,23,3,13.0
ECU-001942,2122,65,35,30,5,13.0
ECU-001943,2122,22,9,13,1,22.0
ECU-001944,2122,218,110,108,14,15.571428571428571
ECU-001945,2122,207,110,97,14,14.785714285714286
ECU-001946,2122,34,22,12,2,17.0
ECU-001947,2122,35,15,20,3,11.666666666666666
ECU-001948,2122,26,11,15,1,26.0
ECU-001949,2122,91,43,48,8,11.375
ECU-001950,2122,25,13,12,1,25.0
ECU-001951,2122,38,18,20,3,12.666666666666666
ECU-001952,2122,26,22,4,1,26.0
ECU-001953,2122,27,16,11,1,27.0
ECU-001954,2122,21,12,9,1,21.0
ECU-001955,2122,20,17,3,1,20.0
ECU-001956,2122,25,20,5,1,25.0
ECU-001957,2122,25,16,9,1,25.0
ECU-001958,2122,70,25,45,3,23.333333333333332
ECU-001959,2122,19,8,11,4,4.75
ECU-001960,2122,46,21,25,2,23.0
ECU-001961,2122,55,27,28,4,13.75
ECU-001962,2122,226,111,115,19,11.894736842105264
ECU-001963,2122,37,18,19,3,12.333333333333334
ECU-001964,2122,12,4,8,1,12.0
ECU-001965,2122,14,6,8,1,14.0
ECU-001966,2122,22,14,8,1,22.0
ECU-001967,2122,20,15,5,1,20.0
ECU-001968,2122,52,21,31,15,3.466666666666667
ECU-001969,2122,1082,552,530,48,22.541666666666668
ECU-001970,2122,271,147,124,26,10.423076923076923
ECU-001971,2122,144,80,64,6,24.0
ECU-001972,2122,38,21,17,4,9.5
ECU-001973,2122,126,65,61,9,14.0
ECU-001974,2122,30,13,17,1,30.0
ECU-001975,2122,6,4,2,1,6.0
ECU-001976,2122,117,52,65,8,14.625
ECU-001977,2122,14,9,5,3,4.666666666666667
ECU-001978,2122,17,7,10,2,8.5
ECU-001979,2122,28,15,13,3,9.333333333333334
ECU-001980,2122,48,21,27,5,9.6
ECU-001981,2122,213,111,102,19,11.210526315789474
ECU-001982,2122,42,21,21,5,8.4
ECU-001983,2122,14,7,7,3,4.666666666666667
ECU-001984,2122,45,26,19,5,9.0
ECU-001985,2122,4,2,2,1,4.0
ECU-001986,2122,22,11,11,2,11.0
ECU-001987,2122,203,95,108,16,12.6875
ECU-001988,2122,304,148,156,19,16.0
ECU-001989,2122,304,157,147,18,16.88888888888889
ECU-001990,2122,147,66,81,16,9.1875
ECU-001991,2122,230,132,98,18,12.777777777777779
ECU-001992,2122,12,5,7,2,6.0
ECU-001993,2122,307,155,152,20,15.35
ECU-001994,2122,209,97,112,17,12.294117647058824
ECU-001995,2122,349,165,184,21,16.61904761904762
ECU-001996,2122,91,49,42,6,15.166666666666666
ECU-001997,2122,70,33,37,3,23.333333333333332
ECU-001998,2122,51,27,24,4,12.75
ECU-001999,2122,190,100,90,18,10.555555555555555
ECU-002000,2122,59,32,27,7,8.428571428571429
ECU-002001,2122,46,29,17,3,15.333333333333334
ECU-002002,2122,96,44,52,8,12.0
ECU-002003,2122,20,8,12,2,10.0
ECU-002004,2122,70,38,32,8,8.75
ECU-002005,2122,119,58,61,7,17.0
ECU-002006,2122,79,33,46,5,15.8
ECU-002007,2122,274,128,146,19,14.421052631578947
ECU-002008,2122,83,43,40,5,16.6
ECU-002009,2122,21,12,9,2,10.5
ECU-002010,2122,267,131,136,17,15.705882352941176
ECU-002011,2122,481,234,247,22,21.863636363636363
ECU-002012,2122,423,187,236,21,20.142857142857142
ECU-002013,2122,459,243,216,26,17.653846153846153
ECU-002014,2122,70,32,38,9,7.777777777777778
ECU-002015,2122,103,50,53,10,10.3
ECU-002016,2122,1604,777,827,50,32.08
ECU-002017,2122,263,129,134,14,18.785714285714285
ECU-002018,2122,2406,1198,1208,84,28.642857142857142
ECU-002019,2122,1122,519,603,48,23.375
ECU-002020,2122,139,77,62,17,8.176470588235293
ECU-002021,2122,1637,819,818,63,25.984126984126984
ECU-002022,2122,392,195,197,21,18.666666666666668
ECU-002023,2122,1088,491,597,59,18.440677966101696
ECU-002024,2122,1011,466,545,45,22.466666666666665
ECU-002025,2122,138,70,68,8,17.25
ECU-002026,2122,31,13,18,7,4.428571428571429
ECU-002027,2122,89,33,56,10,8.9
ECU-002028,2122,5,1,4,6,0.8333333333333334
ECU-002029,2122,498,230,268,27,18.444444444444443
ECU-002030,2122,193,69,124,19,10.157894736842104
ECU-002031,2122,354,164,190,21,16.857142857142858
ECU-002032,2122,1567,734,833,55,28.490909090909092
ECU-002033,2122,151,61,90,21,7.190476190476191
ECU-002034,2122,673,340,333,26,25.884615384615383
ECU-002035,2122,1608,783,825,52,30.923076923076923
ECU-002036,2122,121,68,53,13,9.307692307692308
ECU-002037,2122,15,4,11,3,5.0
ECU-002038,2122,307,156,151,15,20.466666666666665
ECU-002039,2122,1127,562,565,62,18.177419354838708
ECU-002040,2122,936,461,475,35,26.742857142857144
ECU-002041,2122,42,16,26,6,7.0
ECU-002042,2122,533,271,262,25,21.32
ECU-002043,2122,1541,765,776,57,27.035087719298247
ECU-002044,2122,92,45,47,16,5.75
ECU-002045,2122,1604,878,726,69,23.246376811594203
ECU-002046,2122,943,463,480,34,27.735294117647058
ECU-002047,2122,107,57,50,7,15.285714285714286
ECU-002048,2122,45,23,22,4,11.25
ECU-002049,2122,186,93,93,8,23.25
ECU-002050,2122,1087,506,581,47,23.127659574468087
ECU-002051,2122,238,126,112,13,18.307692307692307
ECU-002052,2122,16,6,10,2,8.0
ECU-002053,2122,167,75,92,14,11.928571428571429
ECU-002054,2122,274,138,136,18,15.222222222222221
ECU-002055,2122,856,424,432,37,23.135135135135137
ECU-002056,2122,347,170,177,13,26.692307692307693
ECU-002057,2122,489,252,237,25,19.56
ECU-002058,2122,117,60,57,9,13.0
ECU-002059,2122,513,261,252,24,21.375
ECU-002060,2122,84,39,45,6,14.0
ECU-002061,2122,484,235,249,24,20.166666666666668
ECU-002062,2122,109,51,58,9,12.11111111111111
ECU-002063,2122,708,396,312,30,23.6
ECU-002064,2122,472,238,234,32,14.75
ECU-002065,2122,2316,1287,1029,83,27.903614457831324
ECU-002066,2122,62,30,32,4,15.5
ECU-002067,2122,298,131,167,24,12.416666666666666
ECU-002068,2122,1609,849,760,64,25.140625
ECU-002069,2122,1450,699,751,62,23.387096774193548
ECU-002070,2122,82,39,43,7,11.714285714285714
ECU-002071,2122,27,13,14,3,9.0
ECU-002072,2122,519,274,245,29,17.896551724137932
ECU-002073,2122,74,27,47,8,9.25
ECU-002074,2122,14,3,11,2,7.0
ECU-002075,2122,27,10,17,2,13.5
ECU-002076,2122,9,3,6,1,9.0
ECU-002077,2122,115,54,61,8,14.375
ECU-002078,2122,21,11,10,1,21.0
ECU-002079,2122,303,142,161,18,16.833333333333332
ECU-002080,2122,1666,764,902,72,23.13888888888889
ECU-002081,2122,167,81,86,9,18.555555555555557
ECU-002082,2122,1892,898,994,84,22.523809523809526
ECU-002083,2122,65,38,27,5,13.0
ECU-002084,2122,28,14,14,2,14.0
ECU-002085,2122,93,42,51,9,10.333333333333334
ECU-002086,2122,395,171,224,21,18.80952380952381
ECU-002087,2122,45,21,24,5,9.0
ECU-002088,2122,22,7,15,3,7.333333333333333
ECU-002089,2122,11,6,5,1,11.0
ECU-002090,2122,277,138,139,14,19.785714285714285
ECU-002091,2122,500,228,272,24,20.833333333333332
ECU-002092,2122,534,258,276,29,18.413793103448278
ECU-002093,2122,151,79,72,12,12.583333333333334
ECU-002094,2122,13,7,6,1,13.0
ECU-002095,2122,10,5,5,1,10.0
ECU-002096,2122,37,17,20,2,18.5
ECU-002097,2122,15,8,7,1,15.0
ECU-002098,2122,3,2,1,1,3.0
ECU-002099,2122,37,12,25,2,18.5
ECU-002100,2122,6,3,3,1,6.0
ECU-002101,2122,26,16,10,2,13.0
ECU-002102,2122,5,1,4,1,5.0
ECU-002103,2122,715,343,372,34,21.029411764705884
ECU-002104,2122,6,3,3,1,6.0
ECU-002105,2122,32,12,20,1,32.0
ECU-002106,2122,12,8,4,1,12.0
ECU-002107,2122,844,430,414,34,24.823529411764707
ECU-002108,2122,151,71,80,9,16.77777777777778
ECU-002109,2122,108,54,54,8,13.5
ECU-002110,2122,50,31,19,6,8.333333333333334
ECU-002111,2122,1837,773,1064,72,25.51388888888889
ECU-002112,2122,1496,747,749,61,24.524590163934427
ECU-002113,2122,254,122,132,22,11.545454545454545
ECU-002114,2122,176,92,84,14,12.571428571428571
ECU-002115,2122,1065,543,522,50,21.3
ECU-002116,2122,1325,621,704,49,27.040816326530614
ECU-002117,2122,2032,998,1034,78,26.05128205128205
ECU-002118,2122,280,147,133,14,20.0
ECU-002119,2122,666,336,330,27,24.666666666666668
ECU-002120,2122,440,220,220,24,18.333333333333332
ECU-002121,2122,55,21,34,4,13.75
ECU-002122,2122,191,98,93,13,14.692307692307692
ECU-002123,2122,579,275,304,29,19.96551724137931
ECU-002124,2122,48,29,19,4,12.0
ECU-002125,2122,516,247,269,21,24.571428571428573
ECU-002126,2122,544,258,286,27,20.14814814814815
ECU-002127,2122,19,11,8,3,6.333333333333333
ECU-002128,2122,20,9,11,2,10.0
ECU-002129,2122,18,13,5,2,9.0
ECU-002130,2122,202,98,104,18,11.222222222222221
ECU-002131,2122,186,77,109,12,15.5
ECU-002132,2122,70,31,39,8,8.75
ECU-002133,2122,984,499,485,43,22.88372093023256
ECU-002134,2122,32,20,12,2,16.0
ECU-002135,2122,625,313,312,28,22.321428571428573
ECU-002136,2122,67,28,39,12,5.583333333333333
ECU-002137,2122,1936,917,1019,76,25.473684210526315
ECU-002138,2122,93,50,43,8,11.625
ECU-002139,2122,156,87,69,15,10.4
ECU-002140,2122,1701,856,845,66,25.772727272727273
ECU-002141,2122,45,16,29,8,5.625
ECU-002142,2122,15,5,10,1,15.0
ECU-002143,2122,1147,595,552,42,27.30952380952381
ECU-002144,2122,2411,1245,1166,96,25.114583333333332
ECU-002145,2122,253,120,133,13,19.46153846153846
ECU-002146,2122,1241,632,609,77,16.116883116883116
ECU-002147,2122,352,169,183,16,22.0
ECU-002148,2122,7,3,4,2,3.5
ECU-002149,2122,205,97,108,24,8.541666666666666
ECU-002150,2122,105,55,50,8,13.125
ECU-002151,2122,303,139,164,19,15.947368421052632
ECU-002152,2122,103,53,50,6,17.166666666666668
ECU-002153,2122,207,112,95,9,23.0
ECU-002154,2122,3127,1567,1560,112,27.919642857142858
ECU-002155,2122,508,286,222,35,14.514285714285714
ECU-002156,2122,485,233,252,19,25.526315789473685
ECU-002157,2122,365,172,193,17,21.470588235294116
ECU-002158,2122,595,318,277,35,17.0
ECU-002159,2122,1806,824,982,80,22.575
ECU-002160,2122,614,333,281,30,20.466666666666665
ECU-002161,2122,62,24,38,11,5.636363636363637
ECU-002162,2122,193,83,110,19,10.157894736842104
ECU-002163,2122,100,47,53,9,11.11111111111111
ECU-002164,2122,196,88,108,9,21.77777777777778
ECU-002165,2122,59,25,34,16,3.6875
ECU-002166,2122,1553,949,604,69,22.507246376811594
ECU-002167,2122,418,204,214,46,9.08695652173913
ECU-002168,2122,150,78,72,9,16.666666666666668
ECU-002169,2122,63,33,30,5,12.6
ECU-002170,2122,15,7,8,2,7.5
ECU-002171,2122,1719,841,878,84,20.464285714285715
ECU-002172,2122,71,36,35,3,23.666666666666668
ECU-002173,2122,352,164,188,15,23.466666666666665
ECU-002174,2122,6,1,5,1,6.0
ECU-002175,2122,72,40,32,5,14.4
ECU-002176,2122,44,22,22,2,22.0
ECU-002177,2122,260,131,129,20,13.0
ECU-002178,2122,17,7,10,1,17.0
ECU-002179,2122,34,17,17,2,17.0
ECU-002180,2122,28,17,11,1,28.0
ECU-002181,2122,150,59,91,10,15.0
ECU-002182,2122,13,3,10,1,13.0
ECU-002183,2122,10,5,5,1,10.0
ECU-002184,2122,10,6,4,1,10.0
ECU-002185,2122,10,9,1,1,10.0
ECU-002186,2122,16,8,8,1,16.0
ECU-002187,2122,12,8,4,1,12.0
ECU-002188,2122,370,186,184,19,19.473684210526315
ECU-002189,2122,646,327,319,32,20.1875
ECU-002190,2122,336,166,170,21,16.0
ECU-002191,2122,62,29,33,3,20.666666666666668
ECU-002192,2122,20,12,8,1,20.0
ECU-002193,2122,75,29,46,3,25.0
ECU-002194,2122,8,3,5,1,8.0
ECU-002195,2122,6,4,2,1,6.0
ECU-002196,2122,62,23,39,3,20.666666666666668
ECU-002197,2122,17,10,7,1,17.0
ECU-002198,2122,24,8,16,1,24.0
ECU-002199,2122,10,7,3,1,10.0
ECU-002200,2122,51,25,26,2,25.5
ECU-002201,2122,9,4,5,1,9.0
ECU-002202,2122,158,82,76,9,17.555555555555557
ECU-002203,2122,335,177,158,20,16.75
ECU-002204,2122,12,6,6,1,12.0
ECU-002205,2122,781,393,388,38,20.55263157894737
ECU-002206,2122,10,3,7,1,10.0
ECU-002207,2122,53,30,23,3,17.666666666666668
ECU-002208,2122,29,14,15,1,29.0
ECU-002209,2122,11,6,5,1,11.0
ECU-002210,2122,1926,957,969,87,22.137931034482758
ECU-002211,2122,29,10,19,1,29.0
ECU-002212,2122,19,6,13,1,19.0
ECU-002213,2122,50,23,27,3,16.666666666666668
ECU-002214,2122,20,11,9,1,20.0
ECU-002215,2122,102,53,49,5,20.4
ECU-002216,2122,18,8,10,1,18.0
ECU-002217,2122,27,9,18,1,27.0
ECU-002218,2122,20,9,11,1,20.0
ECU-002219,2122,438,200,238,22,19.90909090909091
ECU-002220,2122,551,276,275,29,19.0
ECU-002221,2122,10,7,3,1,10.0
ECU-002222,2122,1118,553,565,53,21.09433962264151
ECU-002223,2122,25,15,10,1,25.0
ECU-002224,2122,24,12,12,1,24.0
ECU-002225,2122,5,4,1,1,5.0
ECU-002226,2122,18,6,12,2,9.0
ECU-002227,2122,39,17,22,2,19.5
ECU-002228,2122,16,7,9,1,16.0
ECU-002229,2122,82,41,41,4,20.5
ECU-002230,2122,10,6,4,1,10.0
ECU-002231,2122,11,3,8,1,11.0
ECU-002232,2122,26,17,9,2,13.0
ECU-002233,2122,26,9,17,1,26.0
ECU-002234,2122,48,25,23,3,16.0
ECU-002235,2122,15,11,4,1,15.0
ECU-002236,2122,13,5,8,1,13.0
ECU-002237,2122,12,9,3,1,12.0
ECU-002238,2122,12,3,9,1,12.0
ECU-002239,2122,417,194,223,23,18.130434782608695
ECU-002240,2122,23,10,13,1,23.0
ECU-002241,2122,44,21,23,2,22.0
ECU-002242,2122,35,21,14,2,17.5
ECU-002243,2122,13,6,7,1,13.0
ECU-002244,2122,47,27,20,2,23.5
ECU-002245,2122,19,7,12,1,19.0
ECU-002246,2122,34,14,20,2,17.0
ECU-002247,2122,11,6,5,1,11.0
ECU-002248,2122,56,26,30,2,28.0
ECU-002249,2122,1877,931,946,89,21.089887640449437
ECU-002250,2122,33,16,17,2,16.5
ECU-002251,2122,321,174,147,24,13.375
ECU-002252,2122,13,7,6,1,13.0
ECU-002253,2122,239,112,127,15,15.933333333333334
ECU-002254,2122,35,21,14,2,17.5
ECU-002255,2122,39,19,20,2,19.5
ECU-002256,2122,22,12,10,1,22.0
ECU-002257,2122,623,288,335,34,18.323529411764707
ECU-002258,2122,44,27,17,2,22.0
ECU-002259,2122,16,9,7,1,16.0
ECU-002260,2122,16,6,10,1,16.0
ECU-002261,2122,20,10,10,1,20.0
ECU-002262,2122,7,2,5,1,7.0
ECU-002263,2122,17,8,9,1,17.0
ECU-002264,2122,11,9,2,1,11.0
ECU-002265,2122,21,12,9,1,21.0
ECU-002266,2122,18,12,6,1,18.0
ECU-002267,2122,1138,546,592,51,22.313725490196077
ECU-002268,2122,214,92,122,20,10.7
ECU-002269,2122,24,12,12,2,12.0
ECU-002270,2122,24,15,9,5,4.8
ECU-002271,2122,426,266,160,19,22.42105263157895
ECU-002272,2122,49,27,22,3,16.333333333333332
ECU-002273,2122,6,3,3,1,6.0
ECU-002274,2122,18,8,10,1,18.0
ECU-002275,2122,11,3,8,1,11.0
ECU-002276,2122,10,4,6,1,10.0
ECU-002277,2122,22,10,12,5,4.4
ECU-002278,2122,138,58,80,9,15.333333333333334
ECU-002279,2122,254,134,120,25,10.16
ECU-002280,2122,21,8,13,5,4.2
ECU-002281,2122,210,96,114,19,11.052631578947368
ECU-002282,2122,27,9,18,4,6.75
ECU-002283,2122,606,292,314,29,20.896551724137932
ECU-002284,2122,1470,650,820,60,24.5
ECU-002285,2122,284,140,144,22,12.909090909090908
ECU-002286,2122,14,4,10,3,4.666666666666667
ECU-002287,2122,53,25,28,3,17.666666666666668
ECU-002288,2122,43,19,24,3,14.333333333333334
ECU-002289,2122,42,26,16,4,10.5
ECU-002290,2122,16,9,7,2,8.0
ECU-002291,2122,48,24,24,3,16.0
ECU-002292,2122,26,16,10,2,13.0
ECU-002293,2122,55,31,24,3,18.333333333333332
ECU-002294,2122,244,131,113,14,17.428571428571427
ECU-002295,2122,73,38,35,6,12.166666666666666
ECU-002296,2122,71,28,43,10,7.1
ECU-002297,2122,170,78,92,11,15.454545454545455
ECU-002298,2122,5,3,2,1,5.0
ECU-002299,2122,89,34,55,9,9.88888888888889
ECU-002300,2122,40,22,18,3,13.333333333333334
ECU-002301,2122,170,71,99,8,21.25
ECU-002302,2122,12,7,5,1,12.0
ECU-002303,2122,17,6,11,1,17.0
ECU-002304,2122,6,3,3,1,6.0
ECU-002305,2122,461,228,233,16,28.8125
ECU-002306,2122,39,16,23,7,5.571428571428571
ECU-002307,2122,34,18,16,6,5.666666666666667
ECU-002308,2122,191,89,102,12,15.916666666666666
ECU-002309,2122,820,338,482,51,16.07843137254902
ECU-002310,2122,10,3,7,2,5.0
ECU-002311,2122,378,174,204,24,15.75
ECU-002312,2122,968,521,447,39,24.82051282051282
ECU-002313,2122,1548,815,733,73,21.205479452054796
ECU-002314,2122,6,1,5,1,6.0
ECU-002315,2122,603,310,293,29,20.79310344827586
ECU-002316,2122,29,13,16,6,4.833333333333333
ECU-002317,2122,58,21,37,2,29.0
ECU-002318,2122,20,9,11,3,6.666666666666667
ECU-002319,2122,78,20,58,7,11.142857142857142
ECU-002320,2122,7,2,5,3,2.3333333333333335
ECU-002321,2122,8,4,4,1,8.0
ECU-002322,2122,8,4,4,2,4.0
ECU-002323,2122,21,9,12,12,1.75
ECU-002324,2122,28,17,11,11,2.5454545454545454
ECU-002325,2122,45,21,24,6,7.5
ECU-002326,2122,67,30,37,12,5.583333333333333
ECU-002327,2122,25,12,13,8,3.125
ECU-002328,2122,2,1,1,1,2.0
ECU-002329,2122,38,20,18,5,7.6
ECU-002330,2122,18,8,10,3,6.0
ECU-002331,2122,16,11,5,1,16.0
ECU-002332,2122,18,7,11,3,6.0
ECU-002333,2122,19,9,10,2,9.5
ECU-002334,2122,26,9,17,3,8.666666666666666
ECU-002335,2122,43,14,29,9,4.777777777777778
ECU-002336,2122,50,18,32,6,8.333333333333334
ECU-002337,2122,6,4,2,2,3.0
ECU-002338,2122,23,12,11,2,11.5
ECU-002339,2122,14,9,5,2,7.0
ECU-002340,2122,47,22,25,5,9.4
ECU-002341,2122,302,149,153,18,16.77777777777778
ECU-002342,2122,14,9,5,1,14.0
ECU-002343,2122,25,12,13,1,25.0
ECU-002344,2122,19,5,14,1,19.0
ECU-002345,2122,161,74,87,9,17.88888888888889
ECU-002346,2122,94,48,46,3,31.333333333333332
ECU-002347,2122,109,55,54,11,9.909090909090908
ECU-002348,2122,100,50,50,3,33.333333333333336
ECU-002349,2122,11,7,4,1,11.0
ECU-002350,2122,21,6,15,1,21.0
ECU-002351,2122,6,3,3,1,6.0
ECU-002352,2122,166,79,87,8,20.75
ECU-002353,2122,121,65,56,8,15.125
ECU-002354,2122,15,9,6,1,15.0
ECU-002355,2122,15,8,7,1,15.0
ECU-002356,2122,12,5,7,1,12.0
ECU-002357,2122,112,47,65,10,11.2
ECU-002358,2122,13,5,8,1,13.0
ECU-002359,2122,8,4,4,1,8.0
ECU-002360,2122,23,16,7,1,23.0
ECU-002361,2122,14,4,10,1,14.0
ECU-002362,2122,7,3,4,1,7.0
ECU-002363,2122,44,24,20,2,22.0
ECU-002364,2122,75,41,34,3,25.0
ECU-002365,2122,40,20,20,2,20.0
ECU-002366,2122,63,33,30,2,31.5
ECU-002367,2122,19,8,11,1,19.0
ECU-002368,2122,8,4,4,1,8.0
ECU-002369,2122,30,13,17,1,30.0
ECU-002370,2122,16,7,9,1,16.0
ECU-002371,2122,171,93,78,13,13.153846153846153
ECU-002372,2122,29,18,11,1,29.0
ECU-002373,2122,14,6,8,1,14.0
ECU-002374,2122,20,7,13,1,20.0
ECU-002375,2122,38,19,19,2,19.0
ECU-002376,2122,17,8,9,1,17.0
ECU-002377,2122,138,68,70,7,19.714285714285715
ECU-002378,2122,15,10,5,1,15.0
ECU-002379,2122,346,170,176,12,28.833333333333332
ECU-002380,2122,47,22,25,1,47.0
ECU-002381,2122,10,6,4,1,10.0
ECU-002382,2122,12,5,7,2,6.0
ECU-002383,2122,44,20,24,2,22.0
ECU-002384,2122,41,25,16,2,20.5
ECU-002385,2122,17,6,11,1,17.0
ECU-002386,2122,177,93,84,9,19.666666666666668
ECU-002387,2122,165,78,87,8,20.625
ECU-002388,2122,16,10,6,1,16.0
ECU-002389,2122,38,16,22,2,19.0
ECU-002390,2122,21,10,11,1,21.0
ECU-002391,2122,63,30,33,3,21.0
ECU-002392,2122,933,508,425,42,22.214285714285715
ECU-002393,2122,23,11,12,2,11.5
ECU-002394,2122,15,7,8,1,15.0
ECU-002395,2122,18,13,5,1,18.0
ECU-002396,2122,36,20,16,1,36.0
ECU-002397,2122,43,22,21,2,21.5
ECU-002398,2122,54,29,25,4,13.5
ECU-002399,2122,21,7,14,1,21.0
ECU-002400,2122,12,4,8,2,6.0
ECU-002401,2122,6,4,2,1,6.0
ECU-002402,2122,63,28,35,4,15.75
ECU-002403,2122,53,22,31,3,17.666666666666668
ECU-002404,2122,24,9,15,1,24.0
ECU-002405,2122,17,10,7,1,17.0
ECU-002406,2122,50,20,30,2,25.0
ECU-002407,2122,14,7,7,1,14.0
ECU-002408,2122,432,225,207,21,20.571428571428573
ECU-002409,2122,46,25,21,2,23.0
ECU-002410,2122,56,28,28,5,11.2
ECU-002411,2122,58,31,27,4,14.5
ECU-002412,2122,289,146,143,18,16.055555555555557
ECU-002413,2122,9,0,9,1,9.0
ECU-002414,2122,79,35,44,5,15.8
ECU-002415,2122,54,24,30,2,27.0
ECU-002416,2122,17,12,5,1,17.0
ECU-002417,2122,49,24,25,4,12.25
ECU-002418,2122,34,21,13,2,17.0
ECU-002419,2122,47,21,26,4,11.75
ECU-002420,2122,81,40,41,3,27.0
ECU-002421,2122,20,8,12,1,20.0
ECU-002422,2122,32,15,17,1,32.0
ECU-002423,2122,19,9,10,1,19.0
ECU-002424,2122,314,156,158,21,14.952380952380953
ECU-002425,2122,51,32,19,2,25.5
ECU-002426,2122,44,22,22,4,11.0
ECU-002427,2122,30,14,16,2,15.0
ECU-002428,2122,37,14,23,2,18.5
ECU-002429,2122,15,9,6,1,15.0
ECU-002430,2122,96,48,48,5,19.2
ECU-002431,2122,219,112,107,12,18.25
ECU-002432,2122,44,18,26,4,11.0
ECU-002433,2122,37,21,16,3,12.333333333333334
ECU-002434,2122,226,115,111,17,13.294117647058824
ECU-002435,2122,113,57,56,5,22.6
ECU-002436,2122,110,57,53,12,9.166666666666666
ECU-002437,2122,160,86,74,8,20.0
ECU-002438,2122,26,16,10,1,26.0
ECU-002439,2122,56,22,34,2,28.0
ECU-002440,2122,14,8,6,1,14.0
ECU-002441,2122,10,4,6,1,10.0
ECU-002442,2122,39,25,14,2,19.5
ECU-002443,2122,886,447,439,38,23.31578947368421
ECU-002444,2122,111,43,68,7,15.857142857142858
ECU-002445,2122,105,46,59,7,15.0
ECU-002446,2122,37,23,14,2,18.5
ECU-002447,2122,13,6,7,1,13.0
ECU-002448,2122,15,7,8,1,15.0
ECU-002449,2122,45,14,31,2,22.5
ECU-002450,2122,28,19,9,1,28.0
ECU-002451,2122,39,17,22,2,19.5
ECU-002452,2122,23,12,11,1,23.0
ECU-002453,2122,18,4,14,1,18.0
ECU-002454,2122,37,15,22,2,18.5
ECU-002455,2122,46,21,25,3,15.333333333333334
ECU-002456,2122,236,134,102,14,16.857142857142858
ECU-002457,2122,87,39,48,3,29.0
ECU-002458,2122,501,176,325,34,14.735294117647058
ECU-002459,2122,154,65,89,6,25.666666666666668
ECU-002460,2122,20,10,10,1,20.0
ECU-002461,2122,29,13,16,1,29.0
ECU-002462,2122,452,206,246,29,15.586206896551724
ECU-002463,2122,67,31,36,4,16.75
ECU-002464,2122,30,17,13,1,30.0
ECU-002465,2122,31,18,13,1,31.0
ECU-002466,2122,13,4,9,1,13.0
ECU-002467,2122,47,25,22,2,23.5
ECU-002468,2122,32,15,17,1,32.0
ECU-002469,2122,17,10,7,1,17.0
ECU-002470,2122,18,10,8,1,18.0
ECU-002471,2122,13,6,7,1,13.0
ECU-002472,2122,82,39,43,5,16.4
ECU-002473,2122,31,17,14,1,31.0
ECU-002474,2122,97,52,45,4,24.25
ECU-002475,2122,22,7,15,1,22.0
ECU-002476,2122,130,59,71,9,14.444444444444445
ECU-002477,2122,149,83,66,11,13.545454545454545
ECU-002478,2122,28,12,16,1,28.0
ECU-002479,2122,6,3,3,1,6.0
ECU-002480,2122,14,9,5,1,14.0
ECU-002481,2122,4,2,2,1,4.0
ECU-002482,2122,112,56,56,9,12.444444444444445
ECU-002483,2122,30,17,13,2,15.0
ECU-002484,2122,27,12,15,1,27.0
ECU-002485,2122,340,148,192,17,20.0
ECU-002486,2122,11,6,5,1,11.0
ECU-002487,2122,18,9,9,1,18.0
ECU-002488,2122,10,3,7,1,10.0
ECU-002489,2122,26,12,14,1,26.0
ECU-002490,2122,52,28,24,4,13.0
ECU-002491,2122,44,18,26,2,22.0
ECU-002492,2122,88,37,51,8,11.0
ECU-002493,2122,1446,732,714,78,18.53846153846154
ECU-002494,2122,47,28,19,2,23.5
ECU-002495,2122,14,11,3,1,14.0
ECU-002496,2122,9,7,2,1,9.0
ECU-002497,2122,8,3,5,1,8.0
ECU-002498,2122,13,5,8,1,13.0
ECU-002499,2122,41,20,21,2,20.5
ECU-002500,2122,51,25,26,3,17.0
ECU-002501,2122,317,42,275,16,19.8125
ECU-002502,2122,11,7,4,1,11.0
ECU-002503,2122,208,104,104,12,17.333333333333332
ECU-002504,2122,9,5,4,1,9.0
ECU-002505,2122,17,6,11,1,17.0
ECU-002506,2122,13,7,6,1,13.0
ECU-002507,2122,274,148,126,16,17.125
ECU-002508,2122,10,3,7,1,10.0
ECU-002509,2122,389,193,196,22,17.681818181818183
ECU-002510,2122,185,89,96,8,23.125
ECU-002511,2122,2137,1034,1103,75,28.493333333333332
ECU-002512,2122,13,5,8,1,13.0
ECU-002513,2122,1866,939,927,73,25.561643835616437
ECU-002514,2122,8,4,4,1,8.0
ECU-002515,2122,1005,454,551,5,201.0
ECU-002516,2122,44,25,19,8,5.5
ECU-002517,2122,92,40,52,6,15.333333333333334
ECU-002518,2122,37,20,17,2,18.5
ECU-002519,2122,26,16,10,1,26.0
ECU-002520,2122,26,13,13,1,26.0
ECU-002521,2122,365,208,157,20,18.25
ECU-002522,2122,8,2,6,1,8.0
ECU-002523,2122,18,10,8,1,18.0
ECU-002524,2122,40,22,18,2,20.0
ECU-002525,2122,469,219,250,28,16.75
ECU-002526,2122,143,61,82,12,11.916666666666666
ECU-002527,2122,485,222,263,25,19.4
ECU-002528,2122,679,343,336,30,22.633333333333333
ECU-002529,2122,41,24,17,1,41.0
ECU-002530,2122,18,8,10,1,18.0
ECU-002531,2122,573,293,280,27,21.22222222222222
ECU-002532,2122,918,426,492,36,25.5
ECU-002533,2122,26,9,17,1,26.0
ECU-002534,2122,44,23,21,3,14.666666666666666
ECU-002535,2122,474,250,224,22,21.545454545454547
ECU-002536,2122,144,61,83,22,6.545454545454546
ECU-002537,2122,1551,877,674,80,19.3875
ECU-002538,2122,72,31,41,2,36.0
ECU-002539,2122,1122,600,522,72,15.583333333333334
ECU-002540,2122,845,429,416,41,20.609756097560975
ECU-002541,2122,1013,519,494,44,23.022727272727273
ECU-002542,2122,2771,1359,1412,116,23.887931034482758
ECU-002543,2122,119,58,61,11,10.818181818181818
ECU-002544,2122,20,11,9,1,20.0
ECU-002545,2122,7,1,6,1,7.0
ECU-002546,2122,33,18,15,2,16.5
ECU-002547,2122,8,4,4,1,8.0
ECU-002548,2122,20,10,10,1,20.0
ECU-002549,2122,12,4,8,1,12.0
ECU-002550,2122,16,13,3,1,16.0
ECU-002551,2122,650,325,325,37,17.56756756756757
ECU-002552,2122,24,11,13,1,24.0
ECU-002553,2122,12,3,9,1,12.0
ECU-002554,2122,4,2,2,1,4.0
ECU-002555,2122,25,10,15,1,25.0
ECU-002556,2122,76,39,37,5,15.2
ECU-002557,2122,82,41,41,6,13.666666666666666
ECU-002558,2122,160,84,76,9,17.77777777777778
ECU-002559,2122,13,10,3,1,13.0
ECU-002560,2122,11,7,4,1,11.0
ECU-002561,2122,16,10,6,1,16.0
ECU-002562,2122,53,18,35,2,26.5
ECU-002563,2122,312,143,169,15,20.8
ECU-002564,2122,38,21,17,1,38.0
ECU-002565,2122,33,13,20,2,16.5
ECU-002566,2122,21,10,11,1,21.0
ECU-002567,2122,4,3,1,1,4.0
ECU-002568,2122,117,51,66,7,16.714285714285715
ECU-002569,2122,6,3,3,1,6.0
ECU-002570,2122,12,9,3,1,12.0
ECU-002571,2122,14,5,9,1,14.0
ECU-002572,2122,13,7,6,1,13.0
ECU-002573,2122,22,12,10,1,22.0
ECU-002574,2122,10,3,7,1,10.0
ECU-002575,2122,7,5,2,1,7.0
ECU-002576,2122,14,6,8,1,14.0
ECU-002577,2122,474,237,237,26,18.23076923076923
ECU-002578,2122,120,52,68,10,12.0
ECU-002579,2122,30,13,17,2,15.0
ECU-002580,2122,18,8,10,1,18.0
ECU-002581,2122,15,7,8,1,15.0
ECU-002582,2122,20,10,10,1,20.0
ECU-002583,2122,8,3,5,1,8.0
ECU-002584,2122,72,32,40,5,14.4
ECU-002585,2122,17,7,10,1,17.0
ECU-002586,2122,33,19,14,2,16.5
ECU-002587,2122,1182,625,557,58,20.379310344827587
ECU-002588,2122,388,188,200,20,19.4
ECU-002589,2122,17,10,7,1,17.0
ECU-002590,2122,438,219,219,22,19.90909090909091
ECU-002591,2122,92,34,58,6,15.333333333333334
ECU-002592,2122,1648,874,774,74,22.27027027027027
ECU-002593,2122,1449,790,659,54,26.833333333333332
ECU-002594,2122,48,24,24,3,16.0
ECU-002595,2122,34,24,10,2,17.0
ECU-002596,2122,54,26,28,3,18.0
ECU-002597,2122,92,42,50,8,11.5
ECU-002598,2122,340,164,176,15,22.666666666666668
ECU-002599,2122,59,25,34,4,14.75
ECU-002600,2122,30,12,18,1,30.0
ECU-002601,2122,1724,746,978,95,18.147368421052633
ECU-002602,2122,11,6,5,1,11.0
ECU-002603,2122,24,7,17,1,24.0
ECU-002604,2122,16,10,6,1,16.0
ECU-002605,2122,34,26,8,2,17.0
ECU-002606,2122,60,28,32,3,20.0
ECU-002607,2122,1,0,1,1,1.0
ECU-002608,2122,586,225,361,32,18.3125
ECU-002609,2122,15,11,4,1,15.0
ECU-002610,2122,86,39,47,10,8.6
ECU-002611,2122,338,189,149,18,18.77777777777778
ECU-002612,2122,35,17,18,2,17.5
ECU-002613,2122,46,23,23,2,23.0
ECU-002614,2122,3,2,1,1,3.0
ECU-002615,2122,27,8,19,2,13.5
ECU-002616,2122,10,5,5,1,10.0
ECU-002617,2122,4,2,2,1,4.0
ECU-002618,2122,10,4,6,1,10.0
ECU-002619,2122,43,25,18,2,21.5
ECU-002620,2122,8,4,4,1,8.0
ECU-002621,2122,243,116,127,18,13.5
ECU-002622,2122,11,3,8,1,11.0
ECU-002623,2122,650,290,360,33,19.696969696969695
ECU-002624,2122,122,52,70,10,12.2
ECU-002625,2122,14,5,9,1,14.0
ECU-002626,2122,51,30,21,3,17.0
ECU-002627,2122,20,8,12,1,20.0
ECU-002628,2122,23,10,13,1,23.0
ECU-002629,2122,28,12,16,1,28.0
ECU-002630,2122,45,20,25,3,15.0
ECU-002631,2122,15,9,6,1,15.0
ECU-002632,2122,11,4,7,2,5.5
ECU-002633,2122,103,50,53,9,11.444444444444445
ECU-002634,2122,26,12,14,1,26.0
ECU-002635,2122,24,16,8,2,12.0
ECU-002636,2122,51,23,28,1,51.0
ECU-002637,2122,105,56,49,5,21.0
ECU-002638,2122,18,8,10,1,18.0
ECU-002639,2122,52,25,27,2,26.0
ECU-002640,2122,28,10,18,2,14.0
ECU-002641,2122,18,9,9,1,18.0
ECU-002642,2122,9,5,4,1,9.0
ECU-002643,2122,16,5,11,1,16.0
ECU-002644,2122,484,225,259,35,13.82857142857143
ECU-002645,2122,16,5,11,1,16.0
ECU-002646,2122,28,14,14,1,28.0
ECU-002647,2122,25,10,15,1,25.0
ECU-002648,2122,22,15,7,1,22.0
ECU-002649,2122,100,49,51,5,20.0
ECU-002650,2122,14,5,9,1,14.0
ECU-002651,2122,62,25,37,3,20.666666666666668
ECU-002652,2122,1457,728,729,68,21.426470588235293
ECU-002653,2122,30,15,15,1,30.0
ECU-002654,2122,11,6,5,1,11.0
ECU-002655,2122,1313,669,644,67,19.597014925373134
ECU-002656,2122,13,7,6,1,13.0
ECU-002657,2122,12,6,6,1,12.0
ECU-002658,2122,94,45,49,3,31.333333333333332
ECU-002659,2122,2042,1085,957,90,22.68888888888889
ECU-002660,2122,20,13,7,1,20.0
ECU-002661,2122,22,7,15,1,22.0
ECU-002662,2122,36,20,16,2,18.0
ECU-002663,2122,16,9,7,1,16.0
ECU-002664,2122,22,13,9,1,22.0
ECU-002665,2122,33,11,22,1,33.0
ECU-002666,2122,163,76,87,8,20.375
ECU-002667,2122,13,5,8,1,13.0
ECU-002668,2122,40,14,26,2,20.0
ECU-002669,2122,13,8,5,1,13.0
ECU-002670,2122,57,27,30,2,28.5
ECU-002671,2122,57,30,27,2,28.5
ECU-002672,2122,586,262,324,23,25.47826086956522
ECU-002673,2122,44,23,21,2,22.0
ECU-002674,2122,23,9,14,1,23.0
ECU-002675,2122,17,5,12,1,17.0
ECU-002676,2122,18,12,6,1,18.0
ECU-002677,2122,23,8,15,1,23.0
ECU-002678,2122,179,84,95,9,19.88888888888889
ECU-002679,2122,39,25,14,1,39.0
ECU-002680,2122,19,7,12,1,19.0
ECU-002681,2122,11,6,5,1,11.0
ECU-002682,2122,17,8,9,1,17.0
ECU-002683,2122,104,51,53,8,13.0
ECU-002684,2122,69,38,31,2,34.5
ECU-002685,2122,18,11,7,1,18.0
ECU-002686,2122,19,13,6,1,19.0
ECU-002687,2122,52,29,23,2,26.0
ECU-002688,2122,14,7,7,1,14.0
ECU-002689,2122,208,106,102,16,13.0
ECU-002690,2122,133,69,64,7,19.0
ECU-002691,2122,21,10,11,1,21.0
ECU-002692,2122,433,210,223,25,17.32
ECU-002693,2122,18,9,9,1,18.0
ECU-002694,2122,11,5,6,1,11.0
ECU-002695,2122,6,2,4,1,6.0
ECU-002696,2122,13,3,10,1,13.0
ECU-002697,2122,624,304,320,42,14.857142857142858
ECU-002698,2122,12,6,6,1,12.0
ECU-002699,2122,11,3,8,1,11.0
ECU-002700,2122,29,15,14,1,29.0
ECU-002701,2122,163,80,83,13,12.538461538461538
ECU-002702,2122,174,95,79,9,19.333333333333332
ECU-002703,2122,13,4,9,1,13.0
ECU-002704,2122,11,6,5,1,11.0
ECU-002705,2122,8,4,4,1,8.0
ECU-002706,2122,8,4,4,1,8.0
ECU-002707,2122,9,3,6,1,9.0
ECU-002708,2122,8,5,3,1,8.0
ECU-002709,2122,69,26,43,12,5.75
ECU-002710,2122,4,2,2,2,2.0
ECU-002711,2122,496,231,265,22,22.545454545454547
ECU-002712,2122,417,204,213,26,16.03846153846154
ECU-002713,2122,74,38,36,4,18.5
ECU-002714,2122,39,19,20,1,39.0
ECU-002715,2122,678,372,306,33,20.545454545454547
ECU-002716,2122,23,8,15,1,23.0
ECU-002717,2122,866,371,495,49,17.6734693877551
ECU-002718,2122,477,234,243,21,22.714285714285715
ECU-002719,2122,2,0,2,0,
ECU-002720,2122,12,9,3,1,12.0
ECU-002721,2122,11,9,2,1,11.0
ECU-002722,2122,116,62,54,7,16.571428571428573
ECU-002723,2122,83,36,47,10,8.3
ECU-002724,2122,18,6,12,1,18.0
ECU-002725,2122,4,1,3,1,4.0
ECU-002726,2122,12,6,6,1,12.0
ECU-002727,2122,86,39,47,10,8.6
ECU-002728,2122,21,8,13,2,10.5
ECU-002729,2122,132,60,72,10,13.2
ECU-002730,2122,6,1,5,1,6.0
ECU-002731,2122,138,59,79,15,9.2
ECU-002732,2122,22,7,15,1,22.0
ECU-002733,2122,35,16,19,1,35.0
ECU-002734,2122,12,4,8,1,12.0
ECU-002735,2122,101,50,51,10,10.1
ECU-002736,2122,145,71,74,17,8.529411764705882
ECU-002737,2122,142,64,78,10,14.2
ECU-002738,2122,85,45,40,8,10.625
ECU-002739,2122,9,5,4,1,9.0
ECU-002740,2122,3,0,3,1,3.0
ECU-002741,2122,20,14,6,1,20.0
ECU-002742,2122,12,5,7,1,12.0
ECU-002743,2122,9,6,3,1,9.0
ECU-002744,2122,34,17,17,2,17.0
ECU-002745,2122,52,29,23,3,17.333333333333332
ECU-002746,2122,3,0,3,1,3.0
ECU-002747,2122,11,5,6,1,11.0
ECU-002748,2122,14,5,9,1,14.0
ECU-002749,2122,8,3,5,1,8.0
ECU-002750,2122,110,59,51,10,11.0
ECU-002751,2122,139,62,77,10,13.9
ECU-002752,2122,7,6,1,1,7.0
ECU-002753,2122,175,82,93,15,11.666666666666666
ECU-002754,2122,133,58,75,19,7.0
ECU-002755,2122,13,4,9,1,13.0
ECU-002756,2122,23,13,10,1,23.0
ECU-002757,2122,5,2,3,1,5.0
ECU-002758,2122,21,9,12,2,10.5
ECU-002759,2122,19,9,10,1,19.0
ECU-002760,2122,24,13,11,2,12.0
ECU-002761,2122,10,4,6,1,10.0
ECU-002762,2122,268,140,128,21,12.761904761904763
ECU-002763,2122,30,15,15,4,7.5
ECU-002764,2122,85,42,43,11,7.7272727272727275
ECU-002765,2122,23,12,11,2,11.5
ECU-002766,2122,103,52,51,8,12.875
ECU-002767,2122,31,21,10,7,4.428571428571429
ECU-002768,2122,9,4,5,1,9.0
ECU-002769,2122,2,2,0,1,2.0
ECU-002770,2122,193,96,97,15,12.866666666666667
ECU-002771,2122,12,9,3,1,12.0
ECU-002772,2122,10,3,7,1,10.0
ECU-002773,2122,9,6,3,1,9.0
ECU-002774,2122,7,0,7,1,7.0
ECU-002775,2122,7,3,4,1,7.0
ECU-002776,2122,29,10,19,2,14.5
ECU-002777,2122,78,45,33,8,9.75
ECU-002778,2122,27,10,17,2,13.5
ECU-002779,2122,126,62,64,14,9.0
ECU-002780,2122,115,61,54,13,8.846153846153847
ECU-002781,2122,54,19,35,2,27.0
ECU-002782,2122,11,6,5,1,11.0
ECU-002783,2122,31,17,14,2,15.5
ECU-002784,2122,15,8,7,1,15.0
ECU-002785,2122,6,3,3,1,6.0
ECU-002786,2122,8,5,3,1,8.0
ECU-002787,2122,7,4,3,1,7.0
ECU-002788,2122,12,6,6,1,12.0
ECU-002789,2122,9,4,5,1,9.0
ECU-002790,2122,50,25,25,1,50.0
ECU-002791,2122,55,26,29,3,18.333333333333332
ECU-002792,2122,17,8,9,1,17.0
ECU-002793,2122,62,35,27,5,12.4
ECU-002794,2122,93,58,35,11,8.454545454545455
ECU-002795,2122,113,49,64,10,11.3
ECU-002796,2122,208,115,93,16,13.0
ECU-002797,2122,12,6,6,1,12.0
ECU-002798,2122,44,24,20,8,5.5
ECU-002799,2122,1410,691,719,70,20.142857142857142
ECU-002800,2122,27,16,11,2,13.5
ECU-002801,2122,9,3,6,1,9.0
ECU-002802,2122,83,41,42,8,10.375
ECU-002803,2122,8,4,4,1,8.0
ECU-002804,2122,6,3,3,1,6.0
ECU-002805,2122,33,17,16,3,11.0
ECU-002806,2122,18,11,7,1,18.0
ECU-002807,2122,26,13,13,1,26.0
ECU-002808,2122,18,10,8,1,18.0
ECU-002809,2122,117,57,60,14,8.357142857142858
ECU-002810,2122,3,0,3,1,3.0
ECU-002811,2122,21,11,10,1,21.0
ECU-002812,2122,23,14,9,2,11.5
ECU-002813,2122,13,6,7,1,13.0
ECU-002814,2122,15,6,9,1,15.0
ECU-002815,2122,12,6,6,1,12.0
ECU-002816,2122,5,2,3,1,5.0
ECU-002817,2122,106,48,58,7,15.142857142857142
ECU-002818,2122,11,8,3,1,11.0
ECU-002819,2122,152,79,73,10,15.2
ECU-002820,2122,2896,872,2024,112,25.857142857142858
ECU-002821,2122,1342,499,843,53,25.32075471698113
ECU-002822,2122,181,81,100,9,20.11111111111111
ECU-002823,2122,1809,910,899,72,25.125
ECU-002824,2122,92,18,74,8,11.5
ECU-002825,2122,122,54,68,5,24.4
ECU-002826,2122,141,58,83,9,15.666666666666666
ECU-002827,2122,841,394,447,37,22.72972972972973
ECU-002828,2122,747,312,435,25,29.88
ECU-002829,2122,659,312,347,26,25.346153846153847
ECU-002830,2122,373,120,253,9,41.44444444444444
ECU-002831,2122,116,54,62,12,9.666666666666666
ECU-002832,2122,32,17,15,6,5.333333333333333
ECU-002833,2122,1565,885,680,54,28.98148148148148
ECU-002834,2122,257,130,127,19,13.526315789473685
ECU-002835,2122,25,14,11,2,12.5
ECU-002836,2122,330,150,180,21,15.714285714285714
ECU-002837,2122,520,284,236,27,19.25925925925926
ECU-002838,2122,146,75,71,9,16.22222222222222
ECU-002839,2122,178,82,96,19,9.368421052631579
ECU-002840,2122,1080,547,533,50,21.6
ECU-002841,2122,150,73,77,22,6.818181818181818
ECU-002842,2122,118,58,60,5,23.6
ECU-002843,2122,318,164,154,24,13.25
ECU-002844,2122,42,26,16,5,8.4
ECU-002845,2122,35,21,14,3,11.666666666666666
ECU-002846,2122,69,37,32,4,17.25
ECU-002847,2122,17,6,11,2,8.5
ECU-002848,2122,302,153,149,14,21.571428571428573
ECU-002849,2122,363,174,189,34,10.676470588235293
ECU-002850,2122,360,88,272,32,11.25
ECU-002851,2122,87,28,59,11,7.909090909090909
ECU-002852,2122,176,78,98,13,13.538461538461538
ECU-002853,2122,214,69,145,8,26.75
ECU-002854,2122,23,10,13,2,11.5
ECU-002855,2122,17,6,11,4,4.25
ECU-002856,2122,30,13,17,8,3.75
ECU-002857,2122,31,24,7,4,7.75
ECU-002858,2122,2763,1277,1486,82,33.69512195121951
ECU-002859,2122,3485,1670,1815,116,30.04310344827586
ECU-002860,2122,4794,2905,1889,161,29.77639751552795
ECU-002861,2122,2312,1147,1165,119,19.428571428571427
ECU-002862,2122,1538,721,817,53,29.0188679245283
ECU-002863,2122,973,554,419,41,23.73170731707317
ECU-002864,2122,98,40,58,15,6.533333333333333
ECU-002865,2122,20,7,13,2,10.0
ECU-002866,2122,50,23,27,8,6.25
ECU-002867,2122,343,183,160,12,28.583333333333332
ECU-002868,2122,413,396,17,29,14.241379310344827
ECU-002869,2122,1416,683,733,73,19.397260273972602
ECU-002870,2122,1819,918,901,85,21.4
ECU-002871,2122,1687,872,815,76,22.19736842105263
ECU-002872,2122,2959,790,2169,128,23.1171875
ECU-002873,2122,496,274,222,30,16.533333333333335
ECU-002874,2122,177,87,90,11,16.09090909090909
ECU-002875,2122,346,187,159,21,16.476190476190474
ECU-002876,2122,679,324,355,34,19.970588235294116
ECU-002877,2122,599,294,305,33,18.151515151515152
ECU-002878,2122,104,48,56,4,26.0
ECU-002879,2122,203,96,107,9,22.555555555555557
ECU-002880,2122,101,45,56,6,16.833333333333332
ECU-002881,2122,1289,561,728,46,28.02173913043478
ECU-002882,2122,1230,625,605,55,22.363636363636363
ECU-002883,2122,232,100,132,18,12.88888888888889
ECU-002884,2122,821,402,419,37,22.18918918918919
ECU-002885,2122,10,6,4,1,10.0
ECU-002886,2122,209,100,109,14,14.928571428571429
ECU-002887,2122,393,196,197,16,24.5625
ECU-002888,2122,65,35,30,4,16.25
ECU-002889,2122,141,65,76,10,14.1
ECU-002890,2122,34,19,15,3,11.333333333333334
ECU-002891,2122,287,142,145,18,15.944444444444445
ECU-002892,2122,49,23,26,3,16.333333333333332
ECU-002893,2122,10,6,4,2,5.0
ECU-002894,2122,28,12,16,3,9.333333333333334
ECU-002895,2122,36,19,17,2,18.0
ECU-002896,2122,215,110,105,13,16.53846153846154
ECU-002897,2122,199,91,108,13,15.307692307692308
ECU-002898,2122,208,106,102,15,13.866666666666667
ECU-002899,2122,742,380,362,36,20.61111111111111
ECU-002900,2122,47,20,27,3,15.666666666666666
ECU-002901,2122,142,64,78,10,14.2
ECU-002902,2122,947,291,656,42,22.547619047619047
ECU-002903,2122,1633,780,853,67,24.37313432835821
ECU-002904,2122,49,26,23,3,16.333333333333332
ECU-002905,2122,7,2,5,2,3.5
ECU-002906,2122,1097,526,571,46,23.847826086956523
ECU-002907,2122,544,260,284,24,22.666666666666668
ECU-002908,2122,52,29,23,5,10.4
ECU-002909,2122,21,10,11,2,10.5
ECU-002910,2122,18,4,14,1,18.0
ECU-002911,2122,37,14,23,2,18.5
ECU-002912,2122,35,18,17,2,17.5
ECU-002913,2122,1885,940,945,75,25.133333333333333
ECU-002914,2122,137,64,73,9,15.222222222222221
ECU-002915,2122,75,39,36,4,18.75
ECU-002916,2122,62,36,26,5,12.4
ECU-002917,2122,59,23,36,2,29.5
ECU-002918,2122,16,10,6,1,16.0
ECU-002919,2122,159,77,82,6,26.5
ECU-002920,2122,8,6,2,1,8.0
ECU-002921,2122,7,3,4,2,3.5
ECU-002922,2122,79,36,43,4,19.75
ECU-002923,2122,23,16,7,2,11.5
ECU-002924,2122,2340,1168,1172,82,28.536585365853657
ECU-002925,2122,430,211,219,16,26.875
ECU-002926,2122,16,8,8,1,16.0
ECU-002927,2122,3620,2085,1535,101,35.84158415841584
ECU-002928,2122,33,16,17,1,33.0
ECU-002929,2122,297,93,204,7,42.42857142857143
ECU-002930,2122,75,28,47,8,9.375
ECU-002931,2122,251,141,110,10,25.1
ECU-002932,2122,185,83,102,8,23.125
ECU-002933,2122,12,6,6,1,12.0
ECU-002934,2122,177,89,88,15,11.8
ECU-002935,2122,250,108,142,10,25.0
ECU-002936,2122,97,46,51,3,32.333333333333336
ECU-002937,2122,96,52,44,4,24.0
ECU-002938,2122,46,21,25,2,23.0
ECU-002939,2122,19,11,8,1,19.0
ECU-002940,2122,67,27,40,3,22.333333333333332
ECU-002941,2122,273,123,150,16,17.0625
ECU-002942,2122,126,62,64,7,18.0
ECU-002943,2122,762,379,383,33,23.09090909090909
ECU-002944,2122,2156,923,1233,75,28.746666666666666
ECU-002945,2122,15,9,6,2,7.5
ECU-002946,2122,42,29,13,2,21.0
ECU-002947,2122,474,259,215,15,31.6
ECU-002948,2122,2006,924,1082,79,25.39240506329114
ECU-002949,2122,4,2,2,1,4.0
ECU-002950,2122,12,3,9,1,12.0
ECU-002951,2122,5,3,2,1,5.0
ECU-002952,2122,9,4,5,1,9.0
ECU-002953,2122,13,4,9,1,13.0
ECU-002954,2122,12,5,7,1,12.0
ECU-002955,2122,16,6,10,1,16.0
ECU-002956,2122,92,56,36,8,11.5
ECU-002957,2122,12,7,5,1,12.0
ECU-002958,2122,19,8,11,1,19.0
ECU-002959,2122,126,69,57,8,15.75
ECU-002960,2122,7,3,4,1,7.0
ECU-002961,2122,22,10,12,1,22.0
ECU-002962,2122,603,304,299,28,21.535714285714285
ECU-002963,2122,506,249,257,27,18.74074074074074
ECU-002964,2122,10,4,6,1,10.0
ECU-002965,2122,109,51,58,6,18.166666666666668
ECU-002966,2122,13,3,10,1,13.0
ECU-002967,2122,11,7,4,1,11.0
ECU-002968,2122,10,4,6,1,10.0
ECU-002969,2122,7,4,3,1,7.0
ECU-002970,2122,8,4,4,1,8.0
ECU-002971,2122,16,8,8,1,16.0
ECU-002972,2122,13,9,4,1,13.0
ECU-002973,2122,21,12,9,1,21.0
ECU-002974,2122,31,12,19,1,31.0
ECU-002975,2122,198,93,105,10,19.8
ECU-002976,2122,21,13,8,2,10.5
ECU-002977,2122,328,178,150,16,20.5
ECU-002978,2122,535,256,279,22,24.318181818181817
ECU-002979,2122,55,30,25,6,9.166666666666666
ECU-002980,2122,16,8,8,1,16.0
ECU-002981,2122,8,5,3,1,8.0
ECU-002982,2122,29,15,14,1,29.0
ECU-002983,2122,29,18,11,1,29.0
ECU-002984,2122,32,15,17,2,16.0
ECU-002985,2122,24,9,15,1,24.0
ECU-002986,2122,168,91,77,12,14.0
ECU-002987,2122,108,52,56,8,13.5
ECU-002988,2122,526,268,258,19,27.68421052631579
ECU-002989,2122,19,14,5,1,19.0
ECU-002990,2122,31,11,20,1,31.0
ECU-002991,2122,8,3,5,1,8.0
ECU-002992,2122,38,21,17,2,19.0
ECU-002993,2122,307,151,156,15,20.466666666666665
ECU-002994,2122,11,8,3,1,11.0
ECU-002995,2122,47,26,21,2,23.5
ECU-002996,2122,56,30,26,3,18.666666666666668
ECU-002997,2122,30,21,9,2,15.0
ECU-002998,2122,15,8,7,1,15.0
ECU-002999,2122,675,333,342,26,25.96153846153846
ECU-003000,2122,41,24,17,2,20.5
ECU-003001,2122,34,19,15,1,34.0
ECU-003002,2122,36,13,23,2,18.0
ECU-003003,2122,35,17,18,1,35.0
ECU-003004,2122,95,48,47,6,15.833333333333334
ECU-003005,2122,9,2,7,1,9.0
ECU-003006,2122,826,393,433,36,22.944444444444443
ECU-003007,2122,14,4,10,1,14.0
ECU-003008,2122,18,6,12,1,18.0
ECU-003009,2122,16,7,9,1,16.0
ECU-003010,2122,17,10,7,1,17.0
ECU-003011,2122,212,110,102,16,13.25
ECU-003012,2122,10,4,6,1,10.0
ECU-003013,2122,4,2,2,1,4.0
ECU-003014,2122,10,7,3,1,10.0
ECU-003015,2122,11,5,6,1,11.0
ECU-003016,2122,16,4,12,1,16.0
ECU-003017,2122,20,8,12,1,20.0
ECU-003018,2122,11,8,3,1,11.0
ECU-003019,2122,11,8,3,1,11.0
ECU-003020,2122,11,6,5,1,11.0
ECU-003021,2122,17,9,8,1,17.0
ECU-003022,2122,14,5,9,1,14.0
ECU-003023,2122,13,5,8,1,13.0
ECU-003024,2122,51,30,21,5,10.2
ECU-003025,2122,11,5,6,1,11.0
ECU-003026,2122,8,6,2,1,8.0
ECU-003027,2122,67,34,33,6,11.166666666666666
ECU-003028,2122,439,76,363,47,9.340425531914894
ECU-003029,2122,51,38,13,6,8.5
ECU-003030,2122,246,129,117,10,24.6
ECU-003031,2122,289,155,134,13,22.23076923076923
ECU-003032,2122,2824,1457,1367,107,26.39252336448598
ECU-003033,2122,8,0,8,7,1.1428571428571428
ECU-003034,2122,1297,625,672,61,21.262295081967213
ECU-003035,2122,146,72,74,13,11.23076923076923
ECU-003036,2122,93,41,52,8,11.625
ECU-003037,2122,10,7,3,1,10.0
ECU-003038,2122,219,99,120,17,12.882352941176471
ECU-003039,2122,27,17,10,2,13.5
ECU-003040,2122,4,3,1,1,4.0
ECU-003041,2122,57,34,23,5,11.4
ECU-003042,2122,187,104,83,15,12.466666666666667
ECU-003043,2122,173,75,98,13,13.307692307692308
ECU-003044,2122,27,17,10,3,9.0
ECU-003045,2122,98,48,50,7,14.0
ECU-003046,2122,566,298,268,31,18.258064516129032
ECU-003047,2122,9,5,4,1,9.0
ECU-003048,2122,76,37,39,8,9.5
ECU-003049,2122,209,100,109,10,20.9
ECU-003050,2122,13,6,7,1,13.0
ECU-003051,2122,13,7,6,1,13.0
ECU-003052,2122,337,168,169,21,16.047619047619047
ECU-003053,2122,4,2,2,1,4.0
ECU-003054,2122,8,6,2,1,8.0
ECU-003055,2122,17,6,11,1,17.0
ECU-003056,2122,39,25,14,2,19.5
ECU-003057,2122,50,29,21,2,25.0
ECU-003058,2122,14,6,8,1,14.0
ECU-003059,2122,6,4,2,1,6.0
ECU-003060,2122,19,8,11,1,19.0
ECU-003061,2122,20,13,7,1,20.0
ECU-003062,2122,12,4,8,1,12.0
ECU-003063,2122,22,12,10,1,22.0
ECU-003064,2122,89,47,42,7,12.714285714285714
ECU-003065,2122,64,25,39,6,10.666666666666666
ECU-003066,2122,16,6,10,1,16.0
ECU-003067,2122,219,121,98,17,12.882352941176471
ECU-003068,2122,126,73,53,9,14.0
ECU-003069,2122,52,29,23,6,8.666666666666666
ECU-003070,2122,438,213,225,23,19.043478260869566
ECU-003071,2122,31,11,20,2,15.5
ECU-003072,2122,16,8,8,1,16.0
ECU-003073,2122,7,6,1,1,7.0
ECU-003074,2122,24,7,17,2,12.0
ECU-003075,2122,152,81,71,8,19.0
ECU-003076,2122,235,119,116,15,15.666666666666666
ECU-003077,2122,66,31,35,3,22.0
ECU-003078,2122,489,221,268,24,20.375
ECU-003079,2122,894,466,428,49,18.244897959183675
ECU-003080,2122,27,17,10,1,27.0
ECU-003081,2122,9,2,7,1,9.0
ECU-003082,2122,42,24,18,2,21.0
ECU-003083,2122,96,46,50,9,10.666666666666666
ECU-003084,2122,9,2,7,1,9.0
ECU-003085,2122,11,4,7,1,11.0
ECU-003086,2122,46,19,27,3,15.333333333333334
ECU-003087,2122,149,58,91,9,16.555555555555557
ECU-003088,2122,423,213,210,17,24.88235294117647
ECU-003089,2122,144,59,85,13,11.076923076923077
ECU-003090,2122,869,437,432,41,21.195121951219512
ECU-003091,2122,628,358,270,28,22.428571428571427
ECU-003092,2122,18,13,5,4,4.5
ECU-003093,2122,1132,539,593,37,30.594594594594593
ECU-003094,2122,96,54,42,6,16.0
ECU-003095,2122,237,117,120,14,16.928571428571427
ECU-003096,2122,2585,1178,1407,89,29.04494382022472
ECU-003097,2122,81,33,48,5,16.2
ECU-003098,2122,917,448,469,32,28.65625
ECU-003099,2122,344,174,170,18,19.11111111111111
ECU-003100,2122,13,7,6,1,13.0
ECU-003101,2122,260,129,131,16,16.25
ECU-003102,2122,1380,719,661,53,26.037735849056602
ECU-003103,2122,84,36,48,8,10.5
ECU-003104,2122,346,153,193,14,24.714285714285715
ECU-003105,2122,23,10,13,1,23.0
ECU-003106,2122,575,288,287,32,17.96875
ECU-003107,2122,33,13,20,2,16.5
ECU-003108,2122,47,30,17,1,47.0
ECU-003109,2122,35,16,19,2,17.5
ECU-003110,2122,49,26,23,2,24.5
ECU-003111,2122,1303,661,642,55,23.69090909090909
ECU-003112,2122,31,10,21,1,31.0
ECU-003113,2122,16,8,8,1,16.0
ECU-003114,2122,109,48,61,8,13.625
ECU-003115,2122,52,26,26,3,17.333333333333332
ECU-003116,2122,551,259,292,27,20.40740740740741
ECU-003117,2122,190,100,90,11,17.272727272727273
ECU-003118,2122,127,62,65,9,14.11111111111111
ECU-003119,2122,164,80,84,7,23.428571428571427
ECU-003120,2122,216,114,102,3,72.0
ECU-003121,2122,38,20,18,3,12.666666666666666
ECU-003122,2122,420,244,176,20,21.0
ECU-003123,2122,22,16,6,2,11.0
ECU-003124,2122,856,452,404,29,29.517241379310345
ECU-003125,2122,104,44,60,12,8.666666666666666
ECU-003126,2122,1209,558,651,57,21.210526315789473
ECU-003127,2122,1180,530,650,43,27.441860465116278
ECU-003128,2122,132,64,68,11,12.0
ECU-003129,2122,73,38,35,7,10.428571428571429
ECU-003130,2122,1009,550,459,44,22.931818181818183
ECU-003131,2122,1,1,0,1,1.0
ECU-003132,2122,14,7,7,1,14.0
ECU-003133,2122,5,2,3,1,5.0
ECU-003134,2122,41,20,21,6,6.833333333333333
ECU-003135,2122,64,34,30,6,10.666666666666666
ECU-003136,2122,418,209,209,24,17.416666666666668
ECU-003137,2122,95,49,46,7,13.571428571428571
ECU-003138,2122,10,4,6,1,10.0
ECU-003139,2122,9,3,6,1,9.0
ECU-003140,2122,4,1,3,1,4.0
ECU-003141,2122,12,6,6,1,12.0
ECU-003142,2122,30,17,13,2,15.0
ECU-003143,2122,26,12,14,2,13.0
ECU-003144,2122,3,1,2,1,3.0
ECU-003145,2122,15,8,7,1,15.0
ECU-003146,2122,1456,738,718,40,36.4
ECU-003147,2122,13,6,7,1,13.0
ECU-003148,2122,16,7,9,1,16.0
ECU-003149,2122,4,1,3,1,4.0
ECU-003150,2122,5,2,3,1,5.0
ECU-003151,2122,7,4,3,1,7.0
ECU-003152,2122,6,2,4,1,6.0
ECU-003153,2122,25,15,10,2,12.5
ECU-003154,2122,5,3,2,1,5.0
ECU-003155,2122,2,0,2,1,2.0
ECU-003156,2122,5,2,3,1,5.0
ECU-003157,2122,5,1,4,1,5.0
ECU-003158,2122,8,3,5,1,8.0
ECU-003159,2122,17,8,9,1,17.0
ECU-003160,2122,3,0,3,1,3.0
ECU-003161,2122,4,2,2,1,4.0
ECU-003162,2122,5,4,1,1,5.0
ECU-003163,2122,10,3,7,1,10.0
ECU-003164,2122,3,3,0,1,3.0
ECU-003165,2122,7,5,2,1,7.0
ECU-003166,2122,8,6,2,1,8.0
ECU-003167,2122,10,3,7,1,10.0
ECU-003168,2122,22,10,12,1,22.0
ECU-003169,2122,16,10,6,1,16.0
ECU-003170,2122,10,4,6,1,10.0
ECU-003171,2122,12,7,5,1,12.0
ECU-003172,2122,10,5,5,1,10.0
ECU-003173,2122,9,5,4,1,9.0
ECU-003174,2122,11,4,7,1,11.0
ECU-003175,2122,20,10,10,1,20.0
ECU-003176,2122,30,17,13,2,15.0
ECU-003177,2122,33,13,20,2,16.5
ECU-003178,2122,28,14,14,2,14.0
ECU-003179,2122,24,9,15,1,24.0
ECU-003180,2122,39,19,20,2,19.5
ECU-003181,2122,30,15,15,2,15.0
ECU-003182,2122,427,219,208,23,18.565217391304348
ECU-003183,2122,37,18,19,3,12.333333333333334
ECU-003184,2122,31,16,15,2,15.5
ECU-003185,2122,18,4,14,2,9.0
ECU-003186,2122,78,42,36,12,6.5
ECU-003187,2122,2,0,2,1,2.0
ECU-003188,2122,133,66,67,13,10.23076923076923
ECU-003189,2122,26,11,15,2,13.0
ECU-003190,2122,151,61,90,13,11.615384615384615
ECU-003191,2122,16,4,12,2,8.0
ECU-003192,2122,15,6,9,2,7.5
ECU-003193,2122,4,3,1,1,4.0
ECU-003194,2122,11,4,7,1,11.0
ECU-003195,2122,23,13,10,2,11.5
ECU-003196,2122,9,3,6,1,9.0
ECU-003197,2122,11,5,6,1,11.0
ECU-003198,2122,5,1,4,1,5.0
ECU-003199,2122,10,6,4,1,10.0
ECU-003200,2122,5,3,2,1,5.0
ECU-003201,2122,362,171,191,19,19.05263157894737
ECU-003202,2122,175,83,92,13,13.461538461538462
ECU-003203,2122,11,4,7,1,11.0
ECU-003204,2122,19,9,10,1,19.0
ECU-003205,2122,11,5,6,1,11.0
ECU-003206,2122,20,11,9,1,20.0
ECU-003207,2122,11,5,6,1,11.0
ECU-003208,2122,25,8,17,1,25.0
ECU-003209,2122,8,5,3,1,8.0
ECU-003210,2122,259,128,131,5,51.8
ECU-003211,2122,9,6,3,1,9.0
ECU-003212,2122,16,12,4,1,16.0
ECU-003213,2122,174,85,89,18,9.666666666666666
ECU-003214,2122,16,10,6,1,16.0
ECU-003215,2122,8,5,3,1,8.0
ECU-003216,2122,181,91,90,13,13.923076923076923
ECU-003217,2122,99,29,70,15,6.6
ECU-003218,2122,64,30,34,10,6.4
ECU-003219,2122,37,19,18,7,5.285714285714286
ECU-003220,2122,15,10,5,1,15.0
ECU-003221,2122,117,49,68,7,16.714285714285715
ECU-003222,2122,74,33,41,5,14.8
ECU-003223,2122,85,40,45,9,9.444444444444445
ECU-003224,2122,2197,1480,717,87,25.25287356321839
ECU-003225,2122,16,9,7,1,16.0
ECU-003226,2122,297,128,169,19,15.631578947368421
ECU-003227,2122,189,89,100,18,10.5
ECU-003228,2122,266,89,177,7,38.0
ECU-003229,2122,10,4,6,1,10.0
ECU-003230,2122,38,14,24,5,7.6
ECU-003231,2122,183,95,88,12,15.25
ECU-003232,2122,2920,1491,1429,113,25.84070796460177
ECU-003233,2122,63,27,36,6,10.5
ECU-003234,2122,14,7,7,2,7.0
ECU-003235,2122,36,14,22,4,9.0
ECU-003236,2122,78,33,45,5,15.6
ECU-003237,2122,212,107,105,10,21.2
ECU-003238,2122,242,124,118,4,60.5
ECU-003239,2122,59,25,34,10,5.9
ECU-003240,2122,68,20,48,11,6.181818181818182
ECU-003241,2122,35,14,21,2,17.5
ECU-003242,2122,123,56,67,10,12.3
ECU-003243,2122,185,86,99,13,14.23076923076923
ECU-003244,2122,24,11,13,3,8.0
ECU-003245,2122,9,3,6,2,4.5
ECU-003246,2122,54,24,30,6,9.0
ECU-003247,2122,645,341,304,56,11.517857142857142
ECU-003248,2122,28,15,13,5,5.6
ECU-003249,2122,5,2,3,1,5.0
ECU-003250,2122,24,11,13,2,12.0
ECU-003251,2122,146,66,80,12,12.166666666666666
ECU-003252,2122,139,70,69,14,9.928571428571429
ECU-003253,2122,59,38,21,4,14.75
ECU-003254,2122,78,45,33,12,6.5
ECU-003255,2122,65,27,38,6,10.833333333333334
ECU-003256,2122,18,6,12,2,9.0
ECU-003257,2122,36,25,11,3,12.0
ECU-003258,2122,46,22,24,2,23.0
ECU-003259,2122,15,7,8,1,15.0
ECU-003260,2122,9,4,5,1,9.0
ECU-003261,2122,30,14,16,4,7.5
ECU-003262,2122,5,1,4,1,5.0
ECU-003263,2122,12,4,8,1,12.0
ECU-003264,2122,6,5,1,1,6.0
ECU-003265,2122,85,52,33,11,7.7272727272727275
ECU-003266,2122,8,4,4,1,8.0
ECU-003267,2122,117,49,68,12,9.75
ECU-003268,2122,14,6,8,2,7.0
ECU-003269,2122,122,65,57,13,9.384615384615385
ECU-003270,2122,46,24,22,3,15.333333333333334
ECU-003271,2122,120,58,62,13,9.23076923076923
ECU-003272,2122,150,80,70,16,9.375
ECU-003273,2122,55,28,27,4,13.75
ECU-003274,2122,478,211,267,24,19.916666666666668
ECU-003275,2122,212,103,109,17,12.470588235294118
ECU-003276,2122,88,47,41,9,9.777777777777779
ECU-003277,2122,34,15,19,2,17.0
ECU-003278,2122,62,25,37,5,12.4
ECU-003279,2122,38,24,14,3,12.666666666666666
ECU-003280,2122,39,18,21,3,13.0
ECU-003281,2122,46,22,24,3,15.333333333333334
ECU-003282,2122,65,26,39,7,9.285714285714286
ECU-003283,2122,591,286,305,35,16.885714285714286
ECU-003284,2122,48,26,22,4,12.0
ECU-003285,2122,221,107,114,11,20.09090909090909
ECU-003286,2122,17,8,9,1,17.0
ECU-003287,2122,23,11,12,3,7.666666666666667
ECU-003288,2122,82,48,34,8,10.25
ECU-003289,2122,28,13,15,4,7.0
ECU-003290,2122,53,25,28,7,7.571428571428571
ECU-003291,2122,22,13,9,2,11.0
ECU-003292,2122,210,109,101,21,10.0
ECU-003293,2122,83,41,42,8,10.375
ECU-003294,2122,244,127,117,20,12.2
ECU-003295,2122,38,21,17,3,12.666666666666666
ECU-003296,2122,94,55,39,11,8.545454545454545
ECU-003297,2122,126,68,58,12,10.5
ECU-003298,2122,48,21,27,3,16.0
ECU-003299,2122,34,19,15,3,11.333333333333334
ECU-003300,2122,143,80,63,13,11.0
ECU-003301,2122,42,24,18,3,14.0
ECU-003302,2122,50,26,24,4,12.5
ECU-003303,2122,231,111,120,17,13.588235294117647
ECU-003304,2122,49,29,20,2,24.5
ECU-003305,2122,17,7,10,1,17.0
ECU-003306,2122,43,21,22,5,8.6
ECU-003307,2122,129,56,73,17,7.588235294117647
ECU-003308,2122,168,84,84,17,9.882352941176471
ECU-003309,2122,336,147,189,22,15.272727272727273
ECU-003310,2122,111,61,50,13,8.538461538461538
ECU-003311,2122,12,7,5,2,6.0
ECU-003312,2122,34,18,16,4,8.5
ECU-003313,2122,13,4,9,4,3.25
ECU-003314,2122,66,33,33,5,13.2
ECU-003315,2122,213,106,107,18,11.833333333333334
ECU-003316,2122,10,4,6,1,10.0
ECU-003317,2122,776,364,412,52,14.923076923076923
ECU-003318,2122,78,33,45,10,7.8
ECU-003319,2122,62,35,27,12,5.166666666666667
ECU-003320,2122,21,12,9,2,10.5
ECU-003321,2122,94,50,44,8,11.75
ECU-003322,2122,28,12,16,3,9.333333333333334
ECU-003323,2122,16,8,8,2,8.0
ECU-003324,2122,54,25,29,10,5.4
ECU-003325,2122,161,75,86,14,11.5
ECU-003326,2122,37,20,17,3,12.333333333333334
ECU-003327,2122,40,26,14,6,6.666666666666667
ECU-003328,2122,63,26,37,9,7.0
ECU-003329,2122,162,76,86,14,11.571428571428571
ECU-003330,2122,44,25,19,9,4.888888888888889
ECU-003331,2122,106,59,47,11,9.636363636363637
ECU-003332,2122,14,2,12,2,7.0
ECU-003333,2122,22,10,12,2,11.0
ECU-003334,2122,262,136,126,19,13.789473684210526
ECU-003335,2122,32,15,17,2,16.0
ECU-003336,2122,310,161,149,19,16.31578947368421
ECU-003337,2122,79,44,35,6,13.166666666666666
ECU-003338,2122,90,46,44,7,12.857142857142858
ECU-003339,2122,47,23,24,3,15.666666666666666
ECU-003340,2122,150,80,70,10,15.0
ECU-003341,2122,27,12,15,2,13.5
ECU-003342,2122,170,86,84,14,12.142857142857142
ECU-003343,2122,91,48,43,7,13.0
ECU-003344,2122,29,13,16,2,14.5
ECU-003345,2122,25,14,11,2,12.5
ECU-003346,2122,35,19,16,2,17.5
ECU-003347,2122,90,59,31,9,10.0
ECU-003348,2122,127,61,66,11,11.545454545454545
ECU-003349,2122,9,4,5,2,4.5
ECU-003350,2122,304,154,150,14,21.714285714285715
ECU-003351,2122,138,76,62,15,9.2
ECU-003352,2122,95,46,49,11,8.636363636363637
ECU-003353,2122,19,11,8,2,9.5
ECU-003354,2122,217,108,109,14,15.5
ECU-003355,2122,156,88,68,13,12.0
ECU-003356,2122,12,4,8,1,12.0
ECU-003357,2122,99,62,37,10,9.9
ECU-003358,2122,28,9,19,4,7.0
ECU-003359,2122,25,11,14,2,12.5
ECU-003360,2122,276,150,126,18,15.333333333333334
ECU-003361,2122,68,33,35,7,9.714285714285714
ECU-003362,2122,60,28,32,4,15.0
ECU-003363,2122,34,18,16,2,17.0
ECU-003364,2122,7,3,4,1,7.0
ECU-003365,2122,159,81,78,13,12.23076923076923
ECU-003366,2122,27,11,16,3,9.0
ECU-003367,2122,16,8,8,2,8.0
ECU-003368,2122,26,13,13,2,13.0
ECU-003369,2122,10,6,4,2,5.0
ECU-003370,2122,69,35,34,7,9.857142857142858
ECU-003371,2122,26,13,13,2,13.0
ECU-003372,2122,22,5,17,2,11.0
ECU-003373,2122,23,14,9,1,23.0
ECU-003374,2122,149,75,74,9,16.555555555555557
ECU-003375,2122,105,59,46,10,10.5
ECU-003376,2122,37,19,18,2,18.5
ECU-003377,2122,28,17,11,1,28.0
ECU-003378,2122,120,71,49,9,13.333333333333334
ECU-003379,2122,8,1,7,1,8.0
ECU-003380,2122,110,63,47,10,11.0
ECU-003381,2122,137,63,74,12,11.416666666666666
ECU-003382,2122,14,6,8,1,14.0
ECU-003383,2122,152,74,78,8,19.0
ECU-003384,2122,131,64,67,13,10.076923076923077
ECU-003385,2122,321,168,153,20,16.05
ECU-003386,2122,115,64,51,6,19.166666666666668
ECU-003387,2122,28,15,13,2,14.0
ECU-003388,2122,259,132,127,17,15.235294117647058
ECU-003389,2122,259,128,131,14,18.5
ECU-003390,2122,240,127,113,15,16.0
ECU-003391,2122,18,9,9,2,9.0
ECU-003392,2122,50,29,21,3,16.666666666666668
ECU-003393,2122,20,12,8,2,10.0
ECU-003394,2122,104,52,52,7,14.857142857142858
ECU-003395,2122,28,16,12,1,28.0
ECU-003396,2122,101,39,62,8,12.625
ECU-003397,2122,220,124,96,16,13.75
ECU-003398,2122,28,14,14,2,14.0
ECU-003399,2122,47,27,20,3,15.666666666666666
ECU-003400,2122,76,34,42,7,10.857142857142858
ECU-003401,2122,10,4,6,1,10.0
ECU-003402,2122,9,7,2,1,9.0
ECU-003403,2122,8,2,6,1,8.0
ECU-003404,2122,11,9,2,1,11.0
ECU-003405,2122,37,23,14,7,5.285714285714286
ECU-003406,2122,10,8,2,1,10.0
ECU-003407,2122,5,5,0,1,5.0
ECU-003408,2122,100,47,53,11,9.090909090909092
ECU-003409,2122,28,15,13,8,3.5
ECU-003410,2122,54,33,21,3,18.0
ECU-003411,2122,60,34,26,6,10.0
ECU-003412,2122,8,1,7,4,2.0
ECU-003413,2122,140,68,72,10,14.0
ECU-003414,2122,13,4,9,1,13.0
ECU-003415,2122,12,3,9,1,12.0
ECU-003416,2122,506,303,203,37,13.675675675675675
ECU-003417,2122,1364,589,775,59,23.11864406779661
ECU-003418,2122,21,5,16,2,10.5
ECU-003419,2122,1022,501,521,42,24.333333333333332
ECU-003420,2122,1231,606,625,55,22.381818181818183
ECU-003421,2122,133,64,69,6,22.166666666666668
ECU-003422,2122,647,443,204,29,22.310344827586206
ECU-003423,2122,1030,485,545,44,23.40909090909091
ECU-003424,2122,859,454,405,41,20.951219512195124
ECU-003425,2122,834,425,409,46,18.130434782608695
ECU-003426,2122,1037,450,587,78,13.294871794871796
ECU-003427,2122,3538,1788,1750,144,24.569444444444443
ECU-003428,2122,629,263,366,39,16.128205128205128
ECU-003429,2122,3540,2176,1364,147,24.081632653061224
ECU-003430,2122,181,93,88,6,30.166666666666668
ECU-003431,2122,216,100,116,9,24.0
ECU-003432,2122,876,262,614,80,10.95
ECU-003433,2122,2511,1361,1150,96,26.15625
ECU-003434,2122,16,9,7,9,1.7777777777777777
ECU-003435,2122,88,25,63,3,29.333333333333332
ECU-003436,2122,52,21,31,5,10.4
ECU-003437,2122,11,5,6,2,5.5
ECU-003438,2122,281,137,144,23,12.217391304347826
ECU-003439,2122,17,3,14,6,2.8333333333333335
ECU-003440,2122,244,106,138,18,13.555555555555555
ECU-003441,2122,22,11,11,3,7.333333333333333
ECU-003442,2122,4188,1132,3056,209,20.038277511961724
ECU-003443,2122,420,184,236,20,21.0
ECU-003444,2122,6,1,5,2,3.0
ECU-003445,2122,838,354,484,43,19.488372093023255
ECU-003446,2122,1316,1063,253,63,20.88888888888889
ECU-003447,2122,20,8,12,5,4.0
ECU-003448,2122,345,181,164,20,17.25
ECU-003449,2122,24,14,10,4,6.0
ECU-003450,2122,118,63,55,5,23.6
ECU-003451,2122,1614,691,923,85,18.988235294117647
ECU-003452,2122,94,38,56,7,13.428571428571429
ECU-003453,2122,248,176,72,8,31.0
ECU-003454,2122,49,23,26,19,2.5789473684210527
ECU-003455,2122,63,29,34,3,21.0
ECU-003456,2122,3181,1687,1494,148,21.493243243243242
ECU-003457,2122,428,214,214,17,25.176470588235293
ECU-003458,2122,88,46,42,7,12.571428571428571
ECU-003459,2122,1205,560,645,44,27.386363636363637
ECU-003460,2122,196,92,104,12,16.333333333333332
ECU-003461,2122,2238,997,1241,79,28.329113924050635
ECU-003462,2122,977,584,393,25,39.08
ECU-003463,2122,69,63,6,6,11.5
ECU-003464,2122,118,49,69,11,10.727272727272727
ECU-003465,2122,126,55,71,4,31.5
ECU-003466,2122,2906,1405,1501,122,23.81967213114754
ECU-003467,2122,1131,408,723,49,23.081632653061224
ECU-003468,2122,260,139,121,20,13.0
ECU-003469,2122,189,88,101,14,13.5
ECU-003470,2122,2979,1329,1650,161,18.503105590062113
ECU-003471,2122,444,201,243,23,19.304347826086957
ECU-003472,2122,329,145,184,15,21.933333333333334
ECU-003473,2122,307,130,177,53,5.7924528301886795
ECU-003474,2122,10,2,8,7,1.4285714285714286
ECU-003475,2122,596,267,329,25,23.84
ECU-003476,2122,1187,702,485,57,20.82456140350877
ECU-003477,2122,2,0,2,2,1.0
ECU-003478,2122,485,206,279,27,17.962962962962962
ECU-003479,2122,1638,817,821,53,30.90566037735849
ECU-003480,2122,1413,687,726,58,24.362068965517242
ECU-003481,2122,1031,1031,0,50,20.62
ECU-003482,2122,483,222,261,36,13.416666666666666
ECU-003483,2122,1236,587,649,57,21.68421052631579
ECU-003484,2122,525,265,260,23,22.82608695652174
ECU-003485,2122,84,36,48,14,6.0
ECU-003486,2122,126,54,72,13,9.692307692307692
ECU-003487,2122,2873,1815,1058,137,20.970802919708028
ECU-003488,2122,2220,829,1391,78,28.46153846153846
ECU-003489,2122,39,17,22,6,6.5
ECU-003490,2122,186,99,87,17,10.941176470588236
ECU-003491,2122,766,420,346,21,36.476190476190474
ECU-003492,2122,21,5,16,3,7.0
ECU-003493,2122,461,219,242,20,23.05
ECU-003494,2122,317,154,163,20,15.85
ECU-003495,2122,205,106,99,8,25.625
ECU-003496,2122,29,15,14,2,14.5
ECU-003497,2122,1092,555,537,44,24.818181818181817
ECU-003498,2122,85,40,45,4,21.25
ECU-003499,2122,20,10,10,1,20.0
ECU-003500,2122,637,297,340,50,12.74
ECU-003501,2122,112,61,51,14,8.0
ECU-003502,2122,103,54,49,9,11.444444444444445
ECU-003503,2122,248,116,132,18,13.777777777777779
ECU-003504,2122,28,15,13,2,14.0
ECU-003505,2122,618,307,311,24,25.75
ECU-003506,2122,60,29,31,3,20.0
ECU-003507,2122,158,78,80,14,11.285714285714286
ECU-003508,2122,11,8,3,1,11.0
ECU-003509,2122,24,13,11,2,12.0
ECU-003510,2122,63,35,28,4,15.75
ECU-003511,2122,3,1,2,1,3.0
ECU-003512,2122,18,9,9,1,18.0
ECU-003513,2122,113,58,55,9,12.555555555555555
ECU-003514,2122,154,78,76,9,17.11111111111111
ECU-003515,2122,105,50,55,8,13.125
ECU-003516,2122,123,61,62,11,11.181818181818182
ECU-003517,2122,139,67,72,11,12.636363636363637
ECU-003518,2122,15,12,3,1,15.0
ECU-003519,2122,16,5,11,1,16.0
ECU-003520,2122,17,6,11,1,17.0
ECU-003521,2122,139,77,62,13,10.692307692307692
ECU-003522,2122,7,4,3,1,7.0
ECU-003523,2122,13,9,4,1,13.0
ECU-003524,2122,187,45,142,18,10.38888888888889
ECU-003525,2122,10,3,7,1,10.0
ECU-003526,2122,187,91,96,9,20.77777777777778
ECU-003527,2122,6,2,4,1,6.0
ECU-003528,2122,31,8,23,3,10.333333333333334
ECU-003529,2122,45,23,22,3,15.0
ECU-003530,2122,39,20,19,2,19.5
ECU-003531,2122,482,249,233,29,16.620689655172413
ECU-003532,2122,189,70,119,18,10.5
ECU-003533,2122,72,35,37,4,18.0
ECU-003534,2122,54,23,31,3,18.0
ECU-003535,2122,153,65,88,14,10.928571428571429
ECU-003536,2122,191,101,90,17,11.235294117647058
ECU-003537,2122,298,145,153,14,21.285714285714285
ECU-003538,2122,295,142,153,18,16.38888888888889
ECU-003539,2122,1353,637,716,73,18.534246575342465
ECU-003540,2122,1331,692,639,61,21.81967213114754
ECU-003541,2122,149,83,66,13,11.461538461538462
ECU-003542,2122,103,44,59,6,17.166666666666668
ECU-003543,2122,115,53,62,8,14.375
ECU-003544,2122,30,10,20,2,15.0
ECU-003545,2122,598,314,284,36,16.61111111111111
ECU-003546,2122,391,198,193,21,18.61904761904762
ECU-003547,2122,20,10,10,2,10.0
ECU-003548,2122,239,126,113,18,13.277777777777779
ECU-003549,2122,5,3,2,1,5.0
ECU-003550,2122,10,4,6,1,10.0
ECU-003551,2122,34,17,17,2,17.0
ECU-003552,2122,371,184,187,25,14.84
ECU-003553,2122,272,132,140,19,14.31578947368421
ECU-003554,2122,10,4,6,1,10.0
ECU-003555,2122,9,4,5,1,9.0
ECU-003556,2122,59,28,31,8,7.375
ECU-003557,2122,34,20,14,4,8.5
ECU-003558,2122,31,15,16,2,15.5
ECU-003559,2122,28,10,18,3,9.333333333333334
ECU-003560,2122,12,5,7,1,12.0
ECU-003561,2122,427,204,223,29,14.724137931034482
ECU-003562,2122,895,461,434,47,19.04255319148936
ECU-003563,2122,34,24,10,1,34.0
ECU-003564,2122,99,52,47,16,6.1875
ECU-003565,2122,932,455,477,47,19.829787234042552
ECU-003566,2122,210,96,114,13,16.153846153846153
ECU-003567,2122,94,50,44,10,9.4
ECU-003568,2122,12,11,1,2,6.0
ECU-003569,2122,14,6,8,2,7.0
ECU-003570,2122,299,150,149,21,14.238095238095237
ECU-003571,2122,10,7,3,1,10.0
ECU-003572,2122,126,64,62,11,11.454545454545455
ECU-003573,2122,11,5,6,2,5.5
ECU-003574,2122,36,14,22,3,12.0
ECU-003575,2122,135,65,70,15,9.0
ECU-003576,2122,12,2,10,1,12.0
ECU-003577,2122,319,148,171,19,16.789473684210527
ECU-003578,2122,84,48,36,8,10.5
ECU-003579,2122,14,6,8,2,7.0
ECU-003580,2122,102,45,57,12,8.5
ECU-003581,2122,53,28,25,6,8.833333333333334
ECU-003582,2122,25,15,10,2,12.5
ECU-003583,2122,7,3,4,1,7.0
ECU-003584,2122,10,2,8,2,5.0
ECU-003585,2122,62,33,29,4,15.5
ECU-003586,2122,657,302,355,27,24.333333333333332
ECU-003587,2122,36,17,19,2,18.0
ECU-003588,2122,22,16,6,1,22.0
ECU-003589,2122,452,250,202,21,21.523809523809526
ECU-003590,2122,145,68,77,5,29.0
ECU-003591,2122,666,344,322,33,20.181818181818183
ECU-003592,2122,52,27,25,3,17.333333333333332
ECU-003593,2122,1449,720,729,82,17.670731707317074
ECU-003594,2122,18,10,8,1,18.0
ECU-003595,2122,398,219,179,20,19.9
ECU-003596,2122,23,12,11,2,11.5
ECU-003597,2122,113,42,71,12,9.416666666666666
ECU-003598,2122,66,39,27,9,7.333333333333333
ECU-003599,2122,25,9,16,3,8.333333333333334
ECU-003600,2122,86,51,35,12,7.166666666666667
ECU-003601,2122,42,22,20,2,21.0
ECU-003602,2122,211,97,114,20,10.55
ECU-003603,2122,341,185,156,19,17.94736842105263
ECU-003604,2122,370,185,185,26,14.23076923076923
ECU-003605,2122,31,12,19,4,7.75
ECU-003606,2122,26,12,14,3,8.666666666666666
ECU-003607,2122,11,5,6,1,11.0
ECU-003608,2122,73,43,30,7,10.428571428571429
ECU-003609,2122,2537,1286,1251,100,25.37
ECU-003610,2122,20,11,9,2,10.0
ECU-003611,2122,30,13,17,2,15.0
ECU-003612,2122,46,25,21,3,15.333333333333334
ECU-003613,2122,913,449,464,50,18.26
ECU-003614,2122,48,25,23,3,16.0
ECU-003615,2122,10,8,2,1,10.0
ECU-003616,2122,35,19,16,3,11.666666666666666
ECU-003617,2122,592,314,278,29,20.413793103448278
ECU-003618,2122,319,157,162,19,16.789473684210527
ECU-003619,2122,84,41,43,7,12.0
ECU-003620,2122,1149,560,589,48,23.9375
ECU-003621,2122,21,8,13,3,7.0
ECU-003622,2122,14,7,7,2,7.0
ECU-003623,2122,565,266,299,29,19.482758620689655
ECU-003624,2122,491,230,261,30,16.366666666666667
ECU-003625,2122,208,93,115,16,13.0
ECU-003626,2122,235,124,111,24,9.791666666666666
ECU-003627,2122,55,28,27,4,13.75
ECU-003628,2122,51,24,27,10,5.1
ECU-003629,2122,242,108,134,19,12.736842105263158
ECU-003630,2122,73,34,39,8,9.125
ECU-003631,2122,803,388,415,37,21.7027027027027
ECU-003632,2122,251,134,117,22,11.409090909090908
ECU-003633,2122,153,65,88,18,8.5
ECU-003634,2122,75,38,37,8,9.375
ECU-003635,2122,35,13,22,4,8.75
ECU-003636,2122,20,8,12,4,5.0
ECU-003637,2122,89,33,56,10,8.9
ECU-003638,2122,36,23,13,3,12.0
ECU-003639,2122,97,46,51,8,12.125
ECU-003640,2122,266,122,144,19,14.0
ECU-003641,2122,335,168,167,21,15.952380952380953
ECU-003642,2122,375,195,180,19,19.736842105263158
ECU-003643,2122,58,27,31,4,14.5
ECU-003644,2122,19,15,4,2,9.5
ECU-003645,2122,25,10,15,3,8.333333333333334
ECU-003646,2122,289,156,133,15,19.266666666666666
ECU-003647,2122,131,65,66,13,10.076923076923077
ECU-003648,2122,14,9,5,1,14.0
ECU-003649,2122,4,4,0,1,4.0
ECU-003650,2122,24,8,16,2,12.0
ECU-003651,2122,215,99,116,15,14.333333333333334
ECU-003652,2122,135,60,75,12,11.25
ECU-003653,2122,77,43,34,7,11.0
ECU-003654,2122,41,22,19,2,20.5
ECU-003655,2122,217,100,117,15,14.466666666666667
ECU-003656,2122,10,3,7,1,10.0
ECU-003657,2122,1141,532,609,55,20.745454545454546
ECU-003658,2122,23,13,10,1,23.0
ECU-003659,2122,9,2,7,1,9.0
ECU-003660,2122,1322,731,591,46,28.73913043478261
ECU-003661,2122,20,10,10,1,20.0
ECU-003662,2122,127,65,62,9,14.11111111111111
ECU-003663,2122,7,6,1,1,7.0
ECU-003664,2122,4,4,0,1,4.0
ECU-003665,2122,900,432,468,50,18.0
ECU-003666,2122,42,26,16,3,14.0
ECU-003667,2122,53,29,24,5,10.6
ECU-003668,2122,36,19,17,4,9.0
ECU-003669,2122,272,142,130,21,12.952380952380953
ECU-003670,2122,21,9,12,4,5.25
ECU-003671,2122,175,83,92,9,19.444444444444443
ECU-003672,2122,206,114,92,14,14.714285714285714
ECU-003673,2122,1101,576,525,46,23.934782608695652
ECU-003674,2122,14,8,6,1,14.0
ECU-003675,2122,27,18,9,2,13.5
ECU-003676,2122,99,53,46,7,14.142857142857142
ECU-003677,2122,1598,758,840,48,33.291666666666664
ECU-003678,2122,19,13,6,1,19.0
ECU-003679,2122,99,51,48,9,11.0
ECU-003680,2122,4,3,1,1,4.0
ECU-003681,2122,57,31,26,5,11.4
ECU-003682,2122,1128,587,541,50,22.56
ECU-003683,2122,51,26,25,2,25.5
ECU-003684,2122,11,7,4,1,11.0
ECU-003685,2122,21,7,14,2,10.5
ECU-003686,2122,46,23,23,6,7.666666666666667
ECU-003687,2122,11,5,6,1,11.0
ECU-003688,2122,242,136,106,23,10.521739130434783
ECU-003689,2122,12,5,7,1,12.0
ECU-003690,2122,244,114,130,16,15.25
ECU-003691,2122,77,39,38,7,11.0
ECU-003692,2122,135,71,64,16,8.4375
ECU-003693,2122,337,163,174,24,14.041666666666666
ECU-003694,2122,410,194,216,9,45.55555555555556
ECU-003695,2122,13,4,9,2,6.5
ECU-003696,2122,32,19,13,3,10.666666666666666
ECU-003697,2122,24,13,11,5,4.8
ECU-003698,2122,169,77,92,8,21.125
ECU-003699,2122,30,10,20,2,15.0
ECU-003700,2122,278,128,150,8,34.75
ECU-003701,2122,39,17,22,2,19.5
ECU-003702,2122,61,29,32,7,8.714285714285714
ECU-003703,2122,110,51,59,6,18.333333333333332
ECU-003704,2122,35,14,21,3,11.666666666666666
ECU-003705,2122,5,1,4,3,1.6666666666666667
ECU-003706,2122,36,17,19,8,4.5
ECU-003707,2122,66,40,26,18,3.6666666666666665
ECU-003708,2122,15,7,8,1,15.0
ECU-003709,2122,43,43,0,5,8.6
ECU-003710,2122,2,1,1,2,1.0
ECU-003711,2122,19,6,13,1,19.0
ECU-003712,2122,21,4,17,3,7.0
ECU-003713,2122,3,2,1,3,1.0
ECU-003714,2122,4,0,4,2,2.0
ECU-003715,2122,7,5,2,2,3.5
ECU-003716,2122,200,83,117,5,40.0
ECU-003717,2122,5,2,3,1,5.0
ECU-003718,2122,18,13,5,3,6.0
ECU-003719,2122,69,37,32,8,8.625
ECU-003720,2122,50,32,18,3,16.666666666666668
ECU-003721,2122,7,3,4,2,3.5
ECU-003722,2122,12,4,8,5,2.4
ECU-003723,2122,9,3,6,1,9.0
ECU-003724,2122,98,45,53,7,14.0
ECU-003725,2122,23,10,13,1,23.0
ECU-003726,2122,50,21,29,3,16.666666666666668
ECU-003727,2122,26,9,17,2,13.0
ECU-003728,2122,13,7,6,1,13.0
ECU-003729,2122,15,8,7,1,15.0
ECU-003730,2122,24,10,14,2,12.0
ECU-003731,2122,43,26,17,4,10.75
ECU-003732,2122,90,43,47,9,10.0
ECU-003733,2122,4,3,1,1,4.0
ECU-003734,2122,46,21,25,3,15.333333333333334
ECU-003735,2122,26,10,16,1,26.0
ECU-003736,2122,9,5,4,1,9.0
ECU-003737,2122,37,19,18,2,18.5
ECU-003738,2122,41,20,21,2,20.5
ECU-003739,2122,19,12,7,2,9.5
ECU-003740,2122,36,23,13,1,36.0
ECU-003741,2122,36,17,19,3,12.0
ECU-003742,2122,13,4,9,1,13.0
ECU-003743,2122,25,11,14,2,12.5
ECU-003744,2122,21,11,10,1,21.0
ECU-003745,2122,35,14,21,2,17.5
ECU-003746,2122,110,45,65,9,12.222222222222221
ECU-003747,2122,49,22,27,3,16.333333333333332
ECU-003748,2122,26,13,13,1,26.0
ECU-003749,2122,164,74,90,12,13.666666666666666
ECU-003750,2122,73,33,40,2,36.5
ECU-003751,2122,50,26,24,3,16.666666666666668
ECU-003752,2122,80,44,36,3,26.666666666666668
ECU-003753,2122,153,71,82,10,15.3
ECU-003754,2122,11,9,2,1,11.0
ECU-003755,2122,13,5,8,1,13.0
ECU-003756,2122,13,9,4,1,13.0
ECU-003757,2122,5,3,2,1,5.0
ECU-003758,2122,18,12,6,1,18.0
ECU-003759,2122,136,61,75,12,11.333333333333334
ECU-003760,2122,12,9,3,1,12.0
ECU-003761,2122,15,9,6,2,7.5
ECU-003762,2122,13,7,6,1,13.0
ECU-003763,2122,36,15,21,2,18.0
ECU-003764,2122,34,17,17,3,11.333333333333334
ECU-003765,2122,19,6,13,1,19.0
ECU-003766,2122,22,9,13,2,11.0
ECU-003767,2122,41,19,22,2,20.5
ECU-003768,2122,27,11,16,1,27.0
ECU-003769,2122,27,7,20,1,27.0
ECU-003770,2122,46,20,26,3,15.333333333333334
ECU-003771,2122,12,4,8,1,12.0
ECU-003772,2122,24,12,12,1,24.0
ECU-003773,2122,45,30,15,4,11.25
ECU-003774,2122,349,171,178,20,17.45
ECU-003775,2122,388,196,192,18,21.555555555555557
ECU-003776,2122,34,15,19,2,17.0
ECU-003777,2122,19,10,9,1,19.0
ECU-003778,2122,45,26,19,2,22.5
ECU-003779,2122,6,3,3,1,6.0
ECU-003780,2122,20,12,8,1,20.0
ECU-003781,2122,11,7,4,1,11.0
ECU-003782,2122,13,10,3,1,13.0
ECU-003783,2122,64,37,27,6,10.666666666666666
ECU-003784,2122,260,131,129,16,16.25
ECU-003785,2122,9,5,4,1,9.0
ECU-003786,2122,17,6,11,2,8.5
ECU-003787,2122,31,16,15,2,15.5
ECU-003788,2122,8,2,6,1,8.0
ECU-003789,2122,33,16,17,1,33.0
ECU-003790,2122,27,15,12,2,13.5
ECU-003791,2122,20,13,7,1,20.0
ECU-003792,2122,29,8,21,2,14.5
ECU-003793,2122,90,49,41,5,18.0
ECU-003794,2122,23,12,11,1,23.0
ECU-003795,2122,116,54,62,6,19.333333333333332
ECU-003796,2122,10,5,5,1,10.0
ECU-003797,2122,5,3,2,1,5.0
ECU-003798,2122,29,9,20,2,14.5
ECU-003799,2122,13,7,6,1,13.0
ECU-003800,2122,166,82,84,14,11.857142857142858
ECU-003801,2122,12,4,8,1,12.0
ECU-003802,2122,9,5,4,1,9.0
ECU-003803,2122,33,12,21,2,16.5
ECU-003804,2122,7,0,7,1,7.0
ECU-003805,2122,9,3,6,1,9.0
ECU-003806,2122,19,9,10,1,19.0
ECU-003807,2122,46,19,27,4,11.5
ECU-003808,2122,8,2,6,1,8.0
ECU-003809,2122,104,55,49,8,13.0
ECU-003810,2122,21,12,9,1,21.0
ECU-003811,2122,149,77,72,9,16.555555555555557
ECU-003812,2122,43,22,21,4,10.75
ECU-003813,2122,14,6,8,1,14.0
ECU-003814,2122,17,9,8,1,17.0
ECU-003815,2122,34,16,18,1,34.0
ECU-003816,2122,8,4,4,1,8.0
ECU-003817,2122,30,12,18,2,15.0
ECU-003818,2122,59,30,29,3,19.666666666666668
ECU-003819,2122,9,3,6,1,9.0
ECU-003820,2122,38,20,18,2,19.0
ECU-003821,2122,37,17,20,4,9.25
ECU-003822,2122,176,85,91,14,12.571428571428571
ECU-003823,2122,235,120,115,14,16.785714285714285
ECU-003824,2122,5,3,2,1,5.0
ECU-003825,2122,487,247,240,27,18.037037037037038
ECU-003826,2122,7,4,3,1,7.0
ECU-003827,2122,41,16,25,2,20.5
ECU-003828,2122,54,28,26,7,7.714285714285714
ECU-003829,2122,654,344,310,38,17.210526315789473
ECU-003830,2122,15,4,11,1,15.0
ECU-003831,2122,22,8,14,2,11.0
ECU-003832,2122,9,6,3,1,9.0
ECU-003833,2122,3,1,2,1,3.0
ECU-003834,2122,17,10,7,1,17.0
ECU-003835,2122,23,12,11,2,11.5
ECU-003836,2122,6,3,3,1,6.0
ECU-003837,2122,40,22,18,3,13.333333333333334
ECU-003838,2122,38,16,22,3,12.666666666666666
ECU-003839,2122,13,3,10,1,13.0
ECU-003840,2122,12,5,7,1,12.0
ECU-003841,2122,9,7,2,1,9.0
ECU-003842,2122,41,20,21,1,41.0
ECU-003843,2122,142,68,74,8,17.75
ECU-003844,2122,11,7,4,1,11.0
ECU-003845,2122,30,13,17,1,30.0
ECU-003846,2122,4,2,2,1,4.0
ECU-003847,2122,3,3,0,1,3.0
ECU-003848,2122,119,50,69,10,11.9
ECU-003849,2122,9,4,5,1,9.0
ECU-003850,2122,10,2,8,1,10.0
ECU-003851,2122,8,4,4,1,8.0
ECU-003852,2122,5,2,3,1,5.0
ECU-003853,2122,8,6,2,1,8.0
ECU-003854,2122,68,25,43,7,9.714285714285714
ECU-003855,2122,15,9,6,1,15.0
ECU-003856,2122,25,11,14,1,25.0
ECU-003857,2122,2,2,0,1,2.0
ECU-003858,2122,181,97,84,9,20.11111111111111
ECU-003859,2122,20,6,14,2,10.0
ECU-003860,2122,4,0,4,1,4.0
ECU-003861,2122,8,5,3,1,8.0
ECU-003862,2122,33,16,17,1,33.0
ECU-003863,2122,9,1,8,1,9.0
ECU-003864,2122,32,16,16,1,32.0
ECU-003865,2122,118,61,57,9,13.11111111111111
ECU-003866,2122,3,2,1,1,3.0
ECU-003867,2122,11,4,7,1,11.0
ECU-003868,2122,13,6,7,1,13.0
ECU-003869,2122,9,8,1,1,9.0
ECU-003870,2122,17,4,13,1,17.0
ECU-003871,2122,472,228,244,29,16.275862068965516
ECU-003872,2122,87,41,46,4,21.75
ECU-003873,2122,16,10,6,1,16.0
ECU-003874,2122,31,12,19,1,31.0
ECU-003875,2122,16,13,3,1,16.0
ECU-003876,2122,19,8,11,1,19.0
ECU-003877,2122,17,7,10,1,17.0
ECU-003878,2122,22,12,10,1,22.0
ECU-003879,2122,29,14,15,1,29.0
ECU-003880,2122,237,121,116,14,16.928571428571427
ECU-003881,2122,40,23,17,3,13.333333333333334
ECU-003882,2122,6,3,3,1,6.0
ECU-003883,2122,6,4,2,1,6.0
ECU-003884,2122,56,27,29,3,18.666666666666668
ECU-003885,2122,15,4,11,2,7.5
ECU-003886,2122,40,19,21,5,8.0
ECU-003887,2122,8,5,3,1,8.0
ECU-003888,2122,13,5,8,1,13.0
ECU-003889,2122,24,5,19,1,24.0
ECU-003890,2122,58,32,26,4,14.5
ECU-003891,2122,268,124,144,17,15.764705882352942
ECU-003892,2122,54,27,27,3,18.0
ECU-003893,2122,36,17,19,3,12.0
ECU-003894,2122,66,36,30,3,22.0
ECU-003895,2122,43,22,21,2,21.5
ECU-003896,2122,81,35,46,5,16.2
ECU-003897,2122,147,67,80,10,14.7
ECU-003898,2122,19,11,8,1,19.0
ECU-003899,2122,35,22,13,2,17.5
ECU-003900,2122,10,4,6,1,10.0
ECU-003901,2122,14,5,9,1,14.0
ECU-003902,2122,124,58,66,5,24.8
ECU-003903,2122,16,8,8,1,16.0
ECU-003904,2122,92,47,45,4,23.0
ECU-003905,2122,13,6,7,1,13.0
ECU-003906,2122,22,11,11,1,22.0
ECU-003907,2122,9,4,5,1,9.0
ECU-003908,2122,7,5,2,1,7.0
ECU-003909,2122,12,4,8,1,12.0
ECU-003910,2122,114,60,54,21,5.428571428571429
ECU-003911,2122,800,364,436,39,20.512820512820515
ECU-003912,2122,622,350,272,36,17.27777777777778
ECU-003913,2122,1506,733,773,63,23.904761904761905
ECU-003914,2122,41,15,26,5,8.2
ECU-003915,2122,145,76,69,7,20.714285714285715
ECU-003916,2122,216,116,100,12,18.0
ECU-003917,2122,1619,835,784,66,24.53030303030303
ECU-003918,2122,276,149,127,8,34.5
ECU-003919,2122,1971,1060,911,75,26.28
ECU-003920,2122,10,3,7,5,2.0
ECU-003921,2122,85,35,50,7,12.142857142857142
ECU-003922,2122,150,71,79,10,15.0
ECU-003923,2122,1356,810,546,59,22.983050847457626
ECU-003924,2122,2356,1059,1297,95,24.8
ECU-003925,2122,522,259,263,15,34.8
ECU-003926,2122,1613,840,773,71,22.718309859154928
ECU-003927,2122,1584,808,776,68,23.294117647058822
ECU-003928,2122,333,170,163,24,13.875
ECU-003929,2122,11,6,5,1,11.0
ECU-003930,2122,154,61,93,7,22.0
ECU-003931,2122,13,9,4,1,13.0
ECU-003932,2122,11,5,6,1,11.0
ECU-003933,2122,304,149,155,21,14.476190476190476
ECU-003934,2122,22,12,10,2,11.0
ECU-003935,2122,12,7,5,1,12.0
ECU-003936,2122,16,5,11,1,16.0
ECU-003937,2122,11,4,7,1,11.0
ECU-003938,2122,188,96,92,12,15.666666666666666
ECU-003939,2122,13,9,4,1,13.0
ECU-003940,2122,13,6,7,1,13.0
ECU-003941,2122,7,5,2,1,7.0
ECU-003942,2122,352,181,171,15,23.466666666666665
ECU-003943,2122,36,17,19,1,36.0
ECU-003944,2122,8,6,2,1,8.0
ECU-003945,2122,39,23,16,2,19.5
ECU-003946,2122,75,36,39,5,15.0
ECU-003947,2122,18,11,7,1,18.0
ECU-003948,2122,46,26,20,2,23.0
ECU-003949,2122,18,5,13,1,18.0
ECU-003950,2122,20,13,7,1,20.0
ECU-003951,2122,308,167,141,15,20.533333333333335
ECU-003952,2122,618,259,359,15,41.2
ECU-003953,2122,32,18,14,2,16.0
ECU-003954,2122,33,14,19,1,33.0
ECU-003955,2122,29,11,18,2,14.5
ECU-003956,2122,16,7,9,1,16.0
ECU-003957,2122,27,12,15,2,13.5
ECU-003958,2122,415,199,216,20,20.75
ECU-003959,2122,19,7,12,1,19.0
ECU-003960,2122,17,13,4,1,17.0
ECU-003961,2122,33,21,12,2,16.5
ECU-003962,2122,11,4,7,1,11.0
ECU-003963,2122,47,27,20,2,23.5
ECU-003964,2122,589,288,301,27,21.814814814814813
ECU-003965,2122,15,7,8,1,15.0
ECU-003966,2122,16,9,7,1,16.0
ECU-003967,2122,5,3,2,1,5.0
ECU-003968,2122,30,15,15,2,15.0
ECU-003969,2122,23,15,8,1,23.0
ECU-003970,2122,12,4,8,1,12.0
ECU-003971,2122,17,8,9,1,17.0
ECU-003972,2122,6,2,4,1,6.0
ECU-003973,2122,28,12,16,2,14.0
ECU-003974,2122,574,268,306,32,17.9375
ECU-003975,2122,2,1,1,1,2.0
ECU-003976,2122,341,165,176,18,18.944444444444443
ECU-003977,2122,111,55,56,12,9.25
ECU-003978,2122,18,5,13,1,18.0
ECU-003979,2122,9,5,4,1,9.0
ECU-003980,2122,169,83,86,12,14.083333333333334
ECU-003981,2122,423,208,215,24,17.625
ECU-003982,2122,28,11,17,1,28.0
ECU-003983,2122,29,13,16,2,14.5
ECU-003984,2122,11,1,10,1,11.0
ECU-003985,2122,35,14,21,2,17.5
ECU-003986,2122,1647,821,826,79,20.848101265822784
ECU-003987,2122,529,270,259,25,21.16
ECU-003988,2122,11,4,7,1,11.0
ECU-003989,2122,18,9,9,1,18.0
ECU-003990,2122,645,325,320,40,16.125
ECU-003991,2122,35,18,17,3,11.666666666666666
ECU-003992,2122,64,21,43,5,12.8
ECU-003993,2122,12,7,5,1,12.0
ECU-003994,2122,7,3,4,1,7.0
ECU-003995,2122,28,16,12,1,28.0
ECU-003996,2122,13,7,6,1,13.0
ECU-003997,2122,7,4,3,1,7.0
ECU-003998,2122,594,307,287,35,16.97142857142857
ECU-003999,2122,92,46,46,8,11.5
ECU-004000,2122,170,87,83,15,11.333333333333334
ECU-004001,2122,47,22,25,3,15.666666666666666
ECU-004002,2122,189,80,109,15,12.6
ECU-004003,2122,10,1,9,1,10.0
ECU-004004,2122,198,91,107,15,13.2
ECU-004005,2122,10,3,7,1,10.0
ECU-004006,2122,17,9,8,1,17.0
ECU-004007,2122,8,4,4,1,8.0
ECU-004008,2122,11,5,6,1,11.0
ECU-004009,2122,128,68,60,12,10.666666666666666
ECU-004010,2122,7,6,1,1,7.0
ECU-004011,2122,2,2,0,1,2.0
ECU-004012,2122,83,42,41,5,16.6
ECU-004013,2122,14,7,7,1,14.0
ECU-004014,2122,11,7,4,1,11.0
ECU-004015,2122,249,125,124,13,19.153846153846153
ECU-004016,2122,67,21,46,6,11.166666666666666
ECU-004017,2122,342,176,166,18,19.0
ECU-004018,2122,9,5,4,1,9.0
ECU-004019,2122,34,10,24,5,6.8
ECU-004020,2122,326,162,164,20,16.3
ECU-004021,2122,227,126,101,15,15.133333333333333
ECU-004022,2122,67,30,37,6,11.166666666666666
ECU-004023,2122,142,65,77,15,9.466666666666667
ECU-004024,2122,631,320,311,39,16.17948717948718
ECU-004025,2122,24,9,15,2,12.0
ECU-004026,2122,386,210,176,15,25.733333333333334
ECU-004027,2122,15,6,9,1,15.0
ECU-004028,2122,50,22,28,3,16.666666666666668
ECU-004029,2122,490,236,254,25,19.6
ECU-004030,2122,208,94,114,12,17.333333333333332
ECU-004031,2122,139,66,73,15,9.266666666666667
ECU-004032,2122,72,38,34,7,10.285714285714286
ECU-004033,2122,14,10,4,1,14.0
ECU-004034,2122,16,9,7,1,16.0
ECU-004035,2122,358,188,170,27,13.25925925925926
ECU-004036,2122,118,66,52,12,9.833333333333334
ECU-004037,2122,41,19,22,2,20.5
ECU-004038,2122,32,17,15,2,16.0
ECU-004039,2122,25,13,12,3,8.333333333333334
ECU-004040,2122,7,3,4,1,7.0
ECU-004041,2122,67,31,36,8,8.375
ECU-004042,2122,30,14,16,3,10.0
ECU-004043,2122,138,73,65,8,17.25
ECU-004044,2122,20,10,10,2,10.0
ECU-004045,2122,550,267,283,28,19.642857142857142
ECU-004046,2122,20,8,12,1,20.0
ECU-004047,2122,190,82,108,15,12.666666666666666
ECU-004048,2122,2242,1164,1078,93,24.107526881720432
ECU-004049,2122,131,60,71,14,9.357142857142858
ECU-004050,2122,1431,443,988,64,22.359375
ECU-004051,2122,70,33,37,7,10.0
ECU-004052,2122,1624,1135,489,63,25.77777777777778
ECU-004053,2122,314,109,205,25,12.56
ECU-004054,2122,293,135,158,22,13.318181818181818
ECU-004055,2122,266,71,195,15,17.733333333333334
ECU-004056,2122,1767,778,989,67,26.37313432835821
ECU-004057,2122,211,91,120,9,23.444444444444443
ECU-004058,2122,2866,1411,1455,103,27.825242718446603
ECU-004059,2122,489,228,261,24,20.375
ECU-004060,2122,41,18,23,10,4.1
ECU-004061,2122,1825,877,948,77,23.7012987012987
ECU-004062,2122,178,86,92,11,16.181818181818183
ECU-004063,2122,3030,1622,1408,116,26.120689655172413
ECU-004064,2122,363,159,204,31,11.709677419354838
ECU-004065,2122,686,350,336,27,25.40740740740741
ECU-004066,2122,503,236,267,32,15.71875
ECU-004067,2122,252,115,137,16,15.75
ECU-004068,2122,249,114,135,22,11.318181818181818
ECU-004069,2122,341,152,189,13,26.23076923076923
ECU-004070,2122,1051,389,662,41,25.634146341463413
ECU-004071,2122,156,67,89,11,14.181818181818182
ECU-004072,2122,2,2,0,1,2.0
ECU-004073,2122,629,335,294,23,27.347826086956523
ECU-004074,2122,29,11,18,9,3.2222222222222223
ECU-004075,2122,327,169,158,18,18.166666666666668
ECU-004076,2122,184,82,102,43,4.27906976744186
ECU-004077,2122,91,33,58,11,8.272727272727273
ECU-004078,2122,31,17,14,5,6.2
ECU-004079,2122,47,3,44,6,7.833333333333333
ECU-004080,2122,136,62,74,9,15.11111111111111
ECU-004081,2122,149,62,87,12,12.416666666666666
ECU-004082,2122,1165,482,683,55,21.181818181818183
ECU-004083,2122,3219,1158,2061,134,24.02238805970149
ECU-004084,2122,425,225,200,18,23.61111111111111
ECU-004085,2122,831,425,406,33,25.181818181818183
ECU-004086,2122,900,448,452,48,18.75
ECU-004087,2122,3938,2069,1869,129,30.527131782945737
ECU-004088,2122,231,101,130,15,15.4
ECU-004089,2122,1825,862,963,78,23.397435897435898
ECU-004090,2122,2846,1754,1092,131,21.72519083969466
ECU-004091,2122,2132,1268,864,77,27.68831168831169
ECU-004092,2122,301,126,175,15,20.066666666666666
ECU-004093,2122,257,157,100,12,21.416666666666668
ECU-004094,2122,7,4,3,2,3.5
ECU-004095,2122,223,110,113,13,17.153846153846153
ECU-004096,2122,208,93,115,12,17.333333333333332
ECU-004097,2122,321,116,205,13,24.692307692307693
ECU-004098,2122,385,136,249,13,29.615384615384617
ECU-004099,2122,200,80,120,7,28.571428571428573
ECU-004100,2122,1137,730,407,49,23.20408163265306
ECU-004101,2122,2371,900,1471,95,24.957894736842107
ECU-004102,2122,276,102,174,8,34.5
ECU-004103,2122,7,3,4,6,1.1666666666666667
ECU-004104,2122,206,88,118,11,18.727272727272727
ECU-004105,2122,830,644,186,46,18.043478260869566
ECU-004106,2122,1420,688,732,55,25.818181818181817
ECU-004107,2122,3108,1426,1682,108,28.77777777777778
ECU-004108,2122,2492,1507,985,106,23.50943396226415
ECU-004109,2122,109,48,61,12,9.083333333333334
ECU-004110,2122,818,641,177,35,23.37142857142857
ECU-004111,2122,417,417,0,26,16.03846153846154
ECU-004112,2122,98,48,50,10,9.8
ECU-004113,2122,667,321,346,27,24.703703703703702
ECU-004114,2122,238,127,111,14,17.0
ECU-004115,2122,292,134,158,19,15.368421052631579
ECU-004116,2122,700,331,369,31,22.580645161290324
ECU-004117,2122,506,292,214,29,17.448275862068964
ECU-004118,2122,64,28,36,8,8.0
ECU-004119,2122,314,136,178,15,20.933333333333334
ECU-004120,2122,2342,891,1451,81,28.91358024691358
ECU-004121,2122,218,70,148,4,54.5
ECU-004122,2122,291,141,150,21,13.857142857142858
ECU-004123,2122,309,136,173,21,14.714285714285714
ECU-004124,2122,591,300,291,37,15.972972972972974
ECU-004125,2122,305,149,156,18,16.944444444444443
ECU-004126,2122,98,43,55,9,10.88888888888889
ECU-004127,2122,178,87,91,9,19.77777777777778
ECU-004128,2122,114,60,54,12,9.5
ECU-004129,2122,2389,864,1525,101,23.653465346534652
ECU-004130,2122,630,319,311,35,18.0
ECU-004131,2122,563,282,281,32,17.59375
ECU-004132,2122,150,71,79,7,21.428571428571427
ECU-004133,2122,113,48,65,5,22.6
ECU-004134,2122,268,142,126,17,15.764705882352942
ECU-004135,2122,1427,715,712,56,25.482142857142858
ECU-004136,2122,271,133,138,14,19.357142857142858
ECU-004137,2122,170,80,90,14,12.142857142857142
ECU-004138,2122,314,133,181,17,18.470588235294116
ECU-004139,2122,418,207,211,19,22.0
ECU-004140,2122,395,199,196,31,12.741935483870968
ECU-004141,2122,728,353,375,78,9.333333333333334
ECU-004142,2122,850,456,394,49,17.346938775510203
ECU-004143,2122,144,53,91,13,11.076923076923077
ECU-004144,2122,855,403,452,41,20.853658536585368
ECU-004145,2122,2100,1090,1010,88,23.863636363636363
ECU-004146,2122,1013,511,502,37,27.37837837837838
ECU-004147,2122,395,170,225,32,12.34375
ECU-004148,2122,306,147,159,19,16.105263157894736
ECU-004149,2122,872,456,416,41,21.26829268292683
ECU-004150,2122,239,115,124,14,17.071428571428573
ECU-004151,2122,626,296,330,34,18.41176470588235
ECU-004152,2122,77,35,42,6,12.833333333333334
ECU-004153,2122,120,57,63,12,10.0
ECU-004154,2122,744,368,376,36,20.666666666666668
ECU-004155,2122,69,35,34,7,9.857142857142858
ECU-004156,2122,400,201,199,20,20.0
ECU-004157,2122,1248,711,537,61,20.459016393442624
ECU-004158,2122,724,352,372,36,20.11111111111111
ECU-004159,2122,245,120,125,15,16.333333333333332
ECU-004160,2122,380,172,208,20,19.0
ECU-004161,2122,108,62,46,8,13.5
ECU-004162,2122,2517,1278,1239,84,29.964285714285715
ECU-004163,2122,290,149,141,13,22.307692307692307
ECU-004164,2122,282,130,152,15,18.8
ECU-004165,2122,965,492,473,32,30.15625
ECU-004166,2122,790,423,367,35,22.571428571428573
ECU-004167,2122,325,154,171,18,18.055555555555557
ECU-004168,2122,180,91,89,11,16.363636363636363
ECU-004169,2122,1364,622,742,53,25.735849056603772
ECU-004170,2122,62,34,28,4,15.5
ECU-004171,2122,311,138,173,16,19.4375
ECU-004172,2122,822,429,393,37,22.216216216216218
ECU-004173,2122,557,261,296,27,20.62962962962963
ECU-004174,2122,8,4,4,1,8.0
ECU-004175,2122,43,18,25,3,14.333333333333334
ECU-004176,2122,881,463,418,43,20.488372093023255
ECU-004177,2122,76,42,34,6,12.666666666666666
ECU-004178,2122,105,51,54,6,17.5
ECU-004179,2122,398,214,184,17,23.41176470588235
ECU-004180,2122,10,3,7,1,10.0
ECU-004181,2122,54,25,29,2,27.0
ECU-004182,2122,134,69,65,11,12.181818181818182
ECU-004183,2122,14,6,8,1,14.0
ECU-004184,2122,29,14,15,2,14.5
ECU-004185,2122,83,38,45,9,9.222222222222221
ECU-004186,2122,5,4,1,1,5.0
ECU-004187,2122,24,9,15,3,8.0
ECU-004188,2122,129,48,81,10,12.9
ECU-004189,2122,1869,914,955,66,28.318181818181817
ECU-004190,2122,347,172,175,20,17.35
ECU-004191,2122,386,196,190,17,22.705882352941178
ECU-004192,2122,1101,574,527,52,21.173076923076923
ECU-004193,2122,306,153,153,22,13.909090909090908
ECU-004194,2122,131,74,57,8,16.375
ECU-004195,2122,13,4,9,1,13.0
ECU-004196,2122,555,288,267,29,19.137931034482758
ECU-004197,2122,97,39,58,8,12.125
ECU-004198,2122,37,19,18,3,12.333333333333334
ECU-004199,2122,29,9,20,5,5.8
ECU-004200,2122,49,25,24,2,24.5
ECU-004201,2122,885,476,409,36,24.583333333333332
ECU-004202,2122,13,7,6,1,13.0
ECU-004203,2122,142,65,77,9,15.777777777777779
ECU-004204,2122,15,9,6,1,15.0
ECU-004205,2122,138,59,79,7,19.714285714285715
ECU-004206,2122,65,28,37,3,21.666666666666668
ECU-004207,2122,11,2,9,1,11.0
ECU-004208,2122,457,235,222,23,19.869565217391305
ECU-004209,2122,68,30,38,5,13.6
ECU-004210,2122,54,23,31,2,27.0
ECU-004211,2122,412,213,199,20,20.6
ECU-004212,2122,342,152,190,19,18.0
ECU-004213,2122,2561,1258,1303,93,27.537634408602152
ECU-004214,2122,307,128,179,18,17.055555555555557
ECU-004215,2122,233,119,114,16,14.5625
ECU-004216,2122,9,5,4,1,9.0
ECU-004217,2122,1798,899,899,71,25.323943661971832
ECU-004218,2122,426,203,223,23,18.52173913043478
ECU-004219,2122,835,436,399,27,30.925925925925927
ECU-004220,2122,2035,1011,1024,74,27.5
ECU-004221,2122,682,159,523,35,19.485714285714284
ECU-004222,2122,779,398,381,24,32.458333333333336
ECU-004223,2122,196,95,101,10,19.6
ECU-004224,2122,512,261,251,28,18.285714285714285
ECU-004225,2122,77,46,31,5,15.4
ECU-004226,2122,1066,582,484,38,28.05263157894737
ECU-004227,2122,87,38,49,5,17.4
ECU-004228,2122,31,12,19,1,31.0
ECU-004229,2122,345,169,176,18,19.166666666666668
ECU-004230,2122,281,136,145,16,17.5625
ECU-004231,2122,119,62,57,8,14.875
ECU-004232,2122,395,200,195,19,20.789473684210527
ECU-004233,2122,240,128,112,17,14.117647058823529
ECU-004234,2122,189,96,93,11,17.181818181818183
ECU-004235,2122,219,108,111,11,19.90909090909091
ECU-004236,2122,1425,792,633,57,25.0
ECU-004237,2122,96,41,55,4,24.0
ECU-004238,2122,134,62,72,7,19.142857142857142
ECU-004239,2122,146,72,74,9,16.22222222222222
ECU-004240,2122,82,41,41,2,41.0
ECU-004241,2122,402,197,205,16,25.125
ECU-004242,2122,526,259,267,21,25.047619047619047
ECU-004243,2122,318,163,155,14,22.714285714285715
ECU-004244,2122,718,354,364,36,19.944444444444443
ECU-004245,2122,510,268,242,19,26.842105263157894
ECU-004246,2122,249,122,127,12,20.75
ECU-004247,2122,1046,584,462,61,17.147540983606557
ECU-004248,2122,1816,832,984,74,24.54054054054054
ECU-004249,2122,510,217,293,19,26.842105263157894
ECU-004250,2122,553,261,292,22,25.136363636363637
ECU-004251,2122,731,405,326,29,25.20689655172414
ECU-004252,2122,874,471,403,28,31.214285714285715
ECU-004253,2122,174,77,97,12,14.5
ECU-004254,2122,138,76,62,8,17.25
ECU-004255,2122,711,326,385,44,16.15909090909091
ECU-004256,2122,119,59,60,9,13.222222222222221
ECU-004257,2122,533,257,276,29,18.379310344827587
ECU-004258,2122,262,133,129,19,13.789473684210526
ECU-004259,2122,79,41,38,7,11.285714285714286
ECU-004260,2122,694,310,384,43,16.13953488372093
ECU-004261,2122,335,156,179,19,17.63157894736842
ECU-004262,2122,178,90,88,12,14.833333333333334
ECU-004263,2122,53,25,28,3,17.666666666666668
ECU-004264,2122,1182,583,599,52,22.73076923076923
ECU-004265,2122,132,60,72,10,13.2
ECU-004266,2122,130,54,76,18,7.222222222222222
ECU-004267,2122,34,18,16,8,4.25
ECU-004268,2122,431,213,218,18,23.944444444444443
ECU-004269,2122,995,489,506,49,20.306122448979593
ECU-004270,2122,2229,901,1328,8,278.625
ECU-004271,2122,117,50,67,8,14.625
ECU-004272,2122,24,0,24,5,4.8
ECU-004273,2122,183,78,105,2,91.5
ECU-004274,2122,403,198,205,36,11.194444444444445
ECU-004275,2122,4,1,3,3,1.3333333333333333
ECU-004276,2122,16,10,6,2,8.0
ECU-004277,2122,20,7,13,2,10.0
ECU-004278,2122,53,21,32,5,10.6
ECU-004279,2122,15,4,11,1,15.0
ECU-004280,2122,24,9,15,3,8.0
ECU-004281,2122,21,3,18,1,21.0
ECU-004282,2122,21,10,11,2,10.5
ECU-004283,2122,31,18,13,1,31.0
ECU-004284,2122,299,146,153,20,14.95
ECU-004285,2122,179,85,94,11,16.272727272727273
ECU-004286,2122,21,11,10,4,5.25
ECU-004287,2122,14,6,8,1,14.0
ECU-004288,2122,12,9,3,1,12.0
ECU-004289,2122,316,29,287,26,12.153846153846153
ECU-004290,2122,35,15,20,7,5.0
ECU-004291,2122,16,3,13,5,3.2
ECU-004292,2122,219,98,121,8,27.375
ECU-004293,2122,94,48,46,8,11.75
ECU-004294,2122,132,54,78,6,22.0
ECU-004295,2122,44,29,15,8,5.5
ECU-004296,2122,90,48,42,6,15.0
ECU-004297,2122,5,3,2,4,1.25
ECU-004298,2122,5,4,1,1,5.0
ECU-004299,2122,66,26,40,3,22.0
ECU-004300,2122,207,98,109,17,12.176470588235293
ECU-004301,2122,264,143,121,14,18.857142857142858
ECU-004302,2122,188,89,99,12,15.666666666666666
ECU-004303,2122,228,113,115,8,28.5
ECU-004304,2122,413,203,210,24,17.208333333333332
ECU-004305,2122,407,201,206,15,27.133333333333333
ECU-004306,2122,222,127,95,9,24.666666666666668
ECU-004307,2122,247,118,129,8,30.875
ECU-004308,2122,207,102,105,20,10.35
ECU-004309,2122,979,495,484,34,28.794117647058822
ECU-004310,2122,22,4,18,5,4.4
ECU-004311,2122,441,216,225,14,31.5
ECU-004312,2122,1546,715,831,56,27.607142857142858
ECU-004313,2122,641,314,327,20,32.05
ECU-004314,2122,753,381,372,34,22.147058823529413
ECU-004315,2122,79,44,35,8,9.875
ECU-004316,2122,713,349,364,31,23.0
ECU-004317,2122,323,184,139,14,23.071428571428573
ECU-004318,2122,76,27,49,14,5.428571428571429
ECU-004319,2122,500,235,265,29,17.24137931034483
ECU-004320,2122,1521,804,717,66,23.045454545454547
ECU-004321,2122,12,5,7,1,12.0
ECU-004322,2122,106,46,60,3,35.333333333333336
ECU-004323,2122,14,4,10,1,14.0
ECU-004324,2122,30,18,12,1,30.0
ECU-004325,2122,319,156,163,17,18.764705882352942
ECU-004326,2122,6,2,4,1,6.0
ECU-004327,2122,880,425,455,38,23.157894736842106
ECU-004328,2122,346,166,180,15,23.066666666666666
ECU-004329,2122,500,264,236,22,22.727272727272727
ECU-004330,2122,11,10,1,1,11.0
ECU-004331,2122,63,40,23,7,9.0
ECU-004332,2122,107,52,55,4,26.75
ECU-004333,2122,188,104,84,10,18.8
ECU-004334,2122,45,21,24,3,15.0
ECU-004335,2122,71,37,34,7,10.142857142857142
ECU-004336,2122,123,64,59,4,30.75
ECU-004337,2122,188,95,93,11,17.09090909090909
ECU-004338,2122,144,75,69,8,18.0
ECU-004339,2122,24,15,9,2,12.0
ECU-004340,2122,127,65,62,12,10.583333333333334
ECU-004341,2122,396,197,199,18,22.0
ECU-004342,2122,761,399,362,35,21.742857142857144
ECU-004343,2122,170,89,81,9,18.88888888888889
ECU-004344,2122,25,10,15,4,6.25
ECU-004345,2122,13,6,7,6,2.1666666666666665
ECU-004346,2122,190,71,119,14,13.571428571428571
ECU-004347,2122,407,191,216,16,25.4375
ECU-004348,2122,70,37,33,8,8.75
ECU-004349,2122,1338,678,660,47,28.46808510638298
ECU-004350,2122,942,317,625,56,16.821428571428573
ECU-004351,2122,364,179,185,22,16.545454545454547
ECU-004352,2122,371,180,191,16,23.1875
ECU-004353,2122,211,105,106,8,26.375
ECU-004354,2122,208,101,107,10,20.8
ECU-004355,2122,140,75,65,8,17.5
ECU-004356,2122,136,64,72,5,27.2
ECU-004357,2122,32,25,7,1,32.0
ECU-004358,2122,1548,727,821,62,24.967741935483872
ECU-004359,2122,1494,703,791,49,30.489795918367346
ECU-004360,2122,89,36,53,8,11.125
ECU-004361,2122,695,343,352,39,17.82051282051282
ECU-004362,2122,423,222,201,19,22.263157894736842
ECU-004363,2122,147,66,81,8,18.375
ECU-004364,2122,948,452,496,38,24.94736842105263
ECU-004365,2122,1144,645,499,41,27.902439024390244
ECU-004366,2122,302,151,151,19,15.894736842105264
ECU-004367,2122,455,214,241,22,20.681818181818183
ECU-004368,2122,402,211,191,21,19.142857142857142
ECU-004369,2122,568,277,291,24,23.666666666666668
ECU-004370,2122,1253,649,604,46,27.23913043478261
ECU-004371,2122,214,102,112,16,13.375
ECU-004372,2122,1748,1013,735,92,19.0
ECU-004373,2122,160,96,64,5,32.0
ECU-004374,2122,273,138,135,15,18.2
ECU-004375,2122,51,24,27,5,10.2
ECU-004376,2122,127,57,70,5,25.4
ECU-004377,2122,71,38,33,9,7.888888888888889
ECU-004378,2122,88,38,50,8,11.0
ECU-004379,2122,514,235,279,23,22.347826086956523
ECU-004380,2122,2492,1208,1284,118,21.11864406779661
ECU-004381,2122,223,124,99,5,44.6
ECU-004382,2122,23,8,15,3,7.666666666666667
ECU-004383,2122,515,270,245,29,17.75862068965517
ECU-004384,2122,372,178,194,19,19.57894736842105
ECU-004385,2122,157,69,88,15,10.466666666666667
ECU-004386,2122,589,261,328,21,28.047619047619047
ECU-004387,2122,60,30,30,3,20.0
ECU-004388,2122,459,224,235,19,24.157894736842106
ECU-004389,2122,225,97,128,12,18.75
ECU-004390,2122,253,131,122,14,18.071428571428573
ECU-004391,2122,122,60,62,7,17.428571428571427
ECU-004392,2122,905,462,443,45,20.11111111111111
ECU-004393,2122,115,44,71,7,16.428571428571427
ECU-004394,2122,5,1,4,1,5.0
ECU-004395,2122,34,25,9,2,17.0
ECU-004396,2122,952,468,484,37,25.72972972972973
ECU-004397,2122,145,62,83,10,14.5
ECU-004398,2122,247,116,131,14,17.642857142857142
ECU-004399,2122,29,8,21,2,14.5
ECU-004400,2122,132,75,57,12,11.0
ECU-004401,2122,19,10,9,2,9.5
ECU-004402,2122,5,3,2,1,5.0
ECU-004403,2122,11,5,6,3,3.6666666666666665
ECU-004404,2122,125,75,50,8,15.625
ECU-004405,2122,92,44,48,7,13.142857142857142
ECU-004406,2122,52,21,31,4,13.0
ECU-004407,2122,98,53,45,4,24.5
ECU-004408,2122,107,58,49,13,8.23076923076923
ECU-004409,2122,1,0,1,1,1.0
ECU-004410,2122,39,15,24,4,9.75
ECU-004411,2122,480,250,230,35,13.714285714285714
ECU-004412,2122,722,341,381,25,28.88
ECU-004413,2122,166,118,48,9,18.444444444444443
ECU-004414,2122,2111,1216,895,91,23.197802197802197
ECU-004415,2122,406,224,182,14,29.0
ECU-004416,2122,224,103,121,10,22.4
ECU-004417,2122,497,232,265,19,26.157894736842106
ECU-004418,2122,183,93,90,11,16.636363636363637
ECU-004419,2122,1439,680,759,56,25.696428571428573
ECU-004420,2122,660,344,316,25,26.4
ECU-004421,2122,520,284,236,32,16.25
ECU-004422,2122,668,294,374,24,27.833333333333332
ECU-004423,2122,713,356,357,26,27.423076923076923
ECU-004424,2122,59,30,29,4,14.75
ECU-004425,2122,520,232,288,34,15.294117647058824
ECU-004426,2122,206,90,116,12,17.166666666666668
ECU-004427,2122,423,193,230,28,15.107142857142858
ECU-004428,2122,417,209,208,21,19.857142857142858
ECU-004429,2122,410,210,200,20,20.5
ECU-004430,2122,482,227,255,17,28.352941176470587
ECU-004431,2122,205,99,106,8,25.625
ECU-004432,2122,200,100,100,11,18.181818181818183
ECU-004433,2122,137,58,79,23,5.956521739130435
ECU-004434,2122,82,28,54,4,20.5
ECU-004435,2122,2360,1106,1254,99,23.838383838383837
ECU-004436,2122,215,89,126,14,15.357142857142858
ECU-004437,2122,262,127,135,15,17.466666666666665
ECU-004438,2122,146,63,83,10,14.6
ECU-004439,2122,589,295,294,23,25.608695652173914
ECU-004440,2122,9,5,4,1,9.0
ECU-004441,2122,379,158,221,17,22.294117647058822
ECU-004442,2122,443,214,229,18,24.61111111111111
ECU-004443,2122,63,35,28,5,12.6
ECU-004444,2122,102,65,37,7,14.571428571428571
ECU-004445,2122,75,41,34,4,18.75
ECU-004446,2122,75,32,43,5,15.0
ECU-004447,2122,83,44,39,4,20.75
ECU-004448,2122,55,25,30,4,13.75
ECU-004449,2122,242,114,128,15,16.133333333333333
ECU-004450,2122,190,78,112,15,12.666666666666666
ECU-004451,2122,220,120,100,11,20.0
ECU-004452,2122,35,23,12,2,17.5
ECU-004453,2122,84,45,39,4,21.0
ECU-004454,2122,74,32,42,7,10.571428571428571
ECU-004455,2122,97,39,58,7,13.857142857142858
ECU-004456,2122,218,100,118,15,14.533333333333333
ECU-004457,2122,382,179,203,17,22.470588235294116
ECU-004458,2122,104,34,70,11,9.454545454545455
ECU-004459,2122,1384,635,749,115,12.034782608695652
ECU-004460,2122,300,137,163,12,25.0
ECU-004461,2122,338,164,174,18,18.77777777777778
ECU-004462,2122,1117,578,539,40,27.925
ECU-004463,2122,314,134,180,14,22.428571428571427
ECU-004464,2122,1094,483,611,44,24.863636363636363
ECU-004465,2122,253,128,125,11,23.0
ECU-004466,2122,630,308,322,22,28.636363636363637
ECU-004467,2122,340,234,106,21,16.19047619047619
ECU-004468,2122,108,57,51,5,21.6
ECU-004469,2122,424,192,232,20,21.2
ECU-004470,2122,803,401,402,41,19.585365853658537
ECU-004471,2122,404,180,224,22,18.363636363636363
ECU-004472,2122,56,24,32,2,28.0
ECU-004473,2122,405,209,196,22,18.40909090909091
ECU-004474,2122,1183,650,533,45,26.288888888888888
ECU-004475,2122,379,202,177,19,19.94736842105263
ECU-004476,2122,307,151,156,16,19.1875
ECU-004477,2122,376,183,193,17,22.11764705882353
ECU-004478,2122,434,216,218,25,17.36
ECU-004479,2122,300,143,157,11,27.272727272727273
ECU-004480,2122,39,19,20,2,19.5
ECU-004481,2122,162,78,84,10,16.2
ECU-004482,2122,266,140,126,14,19.0
ECU-004483,2122,229,111,118,9,25.444444444444443
ECU-004484,2122,194,95,99,10,19.4
ECU-004485,2122,867,448,419,38,22.81578947368421
ECU-004486,2122,215,99,116,9,23.88888888888889
ECU-004487,2122,588,297,291,26,22.615384615384617
ECU-004488,2122,398,230,168,18,22.11111111111111
ECU-004489,2122,10,3,7,1,10.0
ECU-004490,2122,14,11,3,1,14.0
ECU-004491,2122,35,16,19,2,17.5
ECU-004492,2122,25,11,14,2,12.5
ECU-004493,2122,31,11,20,2,15.5
ECU-004494,2122,4,2,2,1,4.0
ECU-004495,2122,459,229,230,19,24.157894736842106
ECU-004496,2122,32,20,12,2,16.0
ECU-004497,2122,13,6,7,1,13.0
ECU-004498,2122,17,9,8,2,8.5
ECU-004499,2122,11,5,6,1,11.0
ECU-004500,2122,22,8,14,2,11.0
ECU-004501,2122,16,11,5,1,16.0
ECU-004502,2122,88,46,42,4,22.0
ECU-004503,2122,18,5,13,1,18.0
ECU-004504,2122,15,9,6,1,15.0
ECU-004505,2122,906,466,440,42,21.571428571428573
ECU-004506,2122,34,16,18,2,17.0
ECU-004507,2122,38,17,21,2,19.0
ECU-004508,2122,204,100,104,8,25.5
ECU-004509,2122,611,294,317,28,21.821428571428573
ECU-004510,2122,276,119,157,13,21.23076923076923
ECU-004511,2122,960,463,497,35,27.428571428571427
ECU-004512,2122,342,168,174,12,28.5
ECU-004513,2122,141,75,66,7,20.142857142857142
ECU-004514,2122,87,32,55,4,21.75
ECU-004515,2122,579,261,318,32,18.09375
ECU-004516,2122,123,62,61,6,20.5
ECU-004517,2122,23,12,11,2,11.5
ECU-004518,2122,89,50,39,4,22.25
ECU-004519,2122,34,18,16,2,17.0
ECU-004520,2122,61,27,34,2,30.5
ECU-004521,2122,15,8,7,1,15.0
ECU-004522,2122,24,8,16,1,24.0
ECU-004523,2122,16,8,8,1,16.0
ECU-004524,2122,11,3,8,1,11.0
ECU-004525,2122,295,141,154,12,24.583333333333332
ECU-004526,2122,171,78,93,7,24.428571428571427
ECU-004527,2122,111,42,69,5,22.2
ECU-004528,2122,440,220,220,17,25.88235294117647
ECU-004529,2122,470,263,207,21,22.38095238095238
ECU-004530,2122,261,117,144,23,11.347826086956522
ECU-004531,2122,48,26,22,1,48.0
ECU-004532,2122,50,22,28,3,16.666666666666668
ECU-004533,2122,49,24,25,3,16.333333333333332
ECU-004534,2122,83,33,50,3,27.666666666666668
ECU-004535,2122,77,42,35,2,38.5
ECU-004536,2122,130,62,68,5,26.0
ECU-004537,2122,102,50,52,5,20.4
ECU-004538,2122,9,5,4,1,9.0
ECU-004539,2122,127,63,64,5,25.4
ECU-004540,2122,19,10,9,2,9.5
ECU-004541,2122,248,125,123,9,27.555555555555557
ECU-004542,2122,266,129,137,14,19.0
ECU-004543,2122,26,16,10,1,26.0
ECU-004544,2122,41,17,24,2,20.5
ECU-004545,2122,94,50,44,4,23.5
ECU-004546,2122,9,5,4,1,9.0
ECU-004547,2122,28,13,15,2,14.0
ECU-004548,2122,16,11,5,1,16.0
ECU-004549,2122,8,6,2,1,8.0
ECU-004550,2122,33,17,16,2,16.5
ECU-004551,2122,8,2,6,1,8.0
ECU-004552,2122,17,8,9,1,17.0
ECU-004553,2122,6,4,2,1,6.0
ECU-004554,2122,65,29,36,2,32.5
ECU-004555,2122,13,2,11,1,13.0
ECU-004556,2122,13,9,4,1,13.0
ECU-004557,2122,7,2,5,1,7.0
ECU-004558,2122,41,20,21,2,20.5
ECU-004559,2122,22,12,10,1,22.0
ECU-004560,2122,11,8,3,1,11.0
ECU-004561,2122,37,19,18,2,18.5
ECU-004562,2122,51,26,25,3,17.0
ECU-004563,2122,23,12,11,2,11.5
ECU-004564,2122,5,1,4,1,5.0
ECU-004565,2122,10,2,8,1,10.0
ECU-004566,2122,15,6,9,1,15.0
ECU-004567,2122,22,12,10,1,22.0
ECU-004568,2122,18,11,7,2,9.0
ECU-004569,2122,7,2,5,1,7.0
ECU-004570,2122,115,52,63,4,28.75
ECU-004571,2122,278,138,140,11,25.272727272727273
ECU-004572,2122,264,139,125,24,11.0
ECU-004573,2122,352,175,177,18,19.555555555555557
ECU-004574,2122,6,5,1,1,6.0
ECU-004575,2122,529,248,281,24,22.041666666666668
ECU-004576,2122,74,36,38,3,24.666666666666668
ECU-004577,2122,17,12,5,1,17.0
ECU-004578,2122,8,3,5,1,8.0
ECU-004579,2122,24,11,13,2,12.0
ECU-004580,2122,11,5,6,1,11.0
ECU-004581,2122,13,8,5,1,13.0
ECU-004582,2122,12,7,5,1,12.0
ECU-004583,2122,386,185,201,22,17.545454545454547
ECU-004584,2122,4,2,2,1,4.0
ECU-004585,2122,59,21,38,3,19.666666666666668
ECU-004586,2122,60,35,25,2,30.0
ECU-004587,2122,34,19,15,2,17.0
ECU-004588,2122,16,6,10,1,16.0
ECU-004589,2122,15,7,8,1,15.0
ECU-004590,2122,10,5,5,1,10.0
ECU-004591,2122,63,38,25,3,21.0
ECU-004592,2122,57,35,22,3,19.0
ECU-004593,2122,23,12,11,1,23.0
ECU-004594,2122,5,1,4,1,5.0
ECU-004595,2122,135,68,67,13,10.384615384615385
ECU-004596,2122,349,205,144,20,17.45
ECU-004597,2122,588,258,330,35,16.8
ECU-004598,2122,830,417,413,43,19.302325581395348
ECU-004599,2122,365,176,189,15,24.333333333333332
ECU-004600,2122,583,273,310,20,29.15
ECU-004601,2122,1399,716,683,61,22.934426229508198
ECU-004602,2122,952,450,502,54,17.62962962962963
ECU-004603,2122,837,453,384,31,27.0
ECU-004604,2122,34,17,17,2,17.0
ECU-004605,2122,238,126,112,15,15.866666666666667
ECU-004606,2122,151,56,95,10,15.1
ECU-004607,2122,80,39,41,20,4.0
ECU-004608,2122,78,40,38,9,8.666666666666666
ECU-004609,2122,34,16,18,2,17.0
ECU-004610,2122,135,69,66,9,15.0
ECU-004611,2122,143,67,76,8,17.875
ECU-004612,2122,91,39,52,5,18.2
ECU-004613,2122,15,9,6,1,15.0
ECU-004614,2122,41,20,21,2,20.5
ECU-004615,2122,22,8,14,1,22.0
ECU-004616,2122,11,5,6,1,11.0
ECU-004617,2122,99,47,52,6,16.5
ECU-004618,2122,9,4,5,1,9.0
ECU-004619,2122,14,6,8,1,14.0
ECU-004620,2122,19,5,14,1,19.0
ECU-004621,2122,6,3,3,1,6.0
ECU-004622,2122,579,284,295,27,21.444444444444443
ECU-004623,2122,104,40,64,5,20.8
ECU-004624,2122,14,6,8,1,14.0
ECU-004625,2122,30,17,13,1,30.0
ECU-004626,2122,16,8,8,1,16.0
ECU-004627,2122,15,6,9,1,15.0
ECU-004628,2122,64,33,31,4,16.0
ECU-004629,2122,34,14,20,2,17.0
ECU-004630,2122,10,6,4,1,10.0
ECU-004631,2122,24,12,12,1,24.0
ECU-004632,2122,37,18,19,2,18.5
ECU-004633,2122,249,122,127,15,16.6
ECU-004634,2122,15,8,7,1,15.0
ECU-004635,2122,3,3,0,1,3.0
ECU-004636,2122,28,14,14,1,28.0
ECU-004637,2122,17,5,12,1,17.0
ECU-004638,2122,79,45,34,4,19.75
ECU-004639,2122,13,8,5,1,13.0
ECU-004640,2122,8,3,5,1,8.0
ECU-004641,2122,27,14,13,1,27.0
ECU-004642,2122,2,0,2,1,2.0
ECU-004643,2122,21,10,11,1,21.0
ECU-004644,2122,7,2,5,1,7.0
ECU-004645,2122,153,81,72,12,12.75
ECU-004646,2122,22,12,10,1,22.0
ECU-004647,2122,10,7,3,1,10.0
ECU-004648,2122,10,3,7,1,10.0
ECU-004649,2122,32,17,15,2,16.0
ECU-004650,2122,8,2,6,1,8.0
ECU-004651,2122,35,12,23,2,17.5
ECU-004652,2122,56,27,29,3,18.666666666666668
ECU-004653,2122,50,24,26,4,12.5
ECU-004654,2122,3,3,0,1,3.0
ECU-004655,2122,3,1,2,1,3.0
ECU-004656,2122,9,6,3,1,9.0
ECU-004657,2122,19,8,11,1,19.0
ECU-004658,2122,8,3,5,1,8.0
ECU-004659,2122,12,5,7,1,12.0
ECU-004660,2122,5,4,1,1,5.0
ECU-004661,2122,16,10,6,1,16.0
ECU-004662,2122,6,1,5,1,6.0
ECU-004663,2122,3,0,3,1,3.0
ECU-004664,2122,23,10,13,1,23.0
ECU-004665,2122,62,34,28,2,31.0
ECU-004666,2122,670,318,352,32,20.9375
ECU-004667,2122,141,83,58,11,12.818181818181818
ECU-004668,2122,12,7,5,1,12.0
ECU-004669,2122,12,9,3,1,12.0
ECU-004670,2122,30,13,17,2,15.0
ECU-004671,2122,22,12,10,2,11.0
ECU-004672,2122,37,13,24,5,7.4
ECU-004673,2122,164,96,68,11,14.909090909090908
ECU-004674,2122,29,11,18,2,14.5
ECU-004675,2122,222,117,105,14,15.857142857142858
ECU-004676,2122,415,193,222,20,20.75
ECU-004677,2122,376,183,193,21,17.904761904761905
ECU-004678,2122,621,293,328,24,25.875
ECU-004679,2122,1547,826,721,61,25.360655737704917
ECU-004680,2122,31,17,14,6,5.166666666666667
ECU-004681,2122,586,296,290,34,17.235294117647058
ECU-004682,2122,72,38,34,6,12.0
ECU-004683,2122,309,155,154,19,16.263157894736842
ECU-004684,2122,290,139,151,15,19.333333333333332
ECU-004685,2122,7,2,5,2,3.5
ECU-004686,2122,13,7,6,2,6.5
ECU-004687,2122,278,140,138,18,15.444444444444445
ECU-004688,2122,1245,663,582,60,20.75
ECU-004689,2122,839,258,581,55,15.254545454545454
ECU-004690,2122,993,535,458,57,17.42105263157895
ECU-004691,2122,182,98,84,26,7.0
ECU-004692,2122,69,47,22,11,6.2727272727272725
ECU-004693,2122,16,8,8,3,5.333333333333333
ECU-004694,2122,15,8,7,3,5.0
ECU-004695,2122,762,404,358,36,21.166666666666668
ECU-004696,2122,114,52,62,17,6.705882352941177
ECU-004697,2122,2015,1021,994,85,23.705882352941178
ECU-004698,2122,1124,679,445,53,21.20754716981132
ECU-004699,2122,182,91,91,15,12.133333333333333
ECU-004700,2122,517,316,201,34,15.205882352941176
ECU-004701,2122,214,107,107,14,15.285714285714286
ECU-004702,2122,549,255,294,26,21.115384615384617
ECU-004703,2122,100,57,43,7,14.285714285714286
ECU-004704,2122,82,46,36,8,10.25
ECU-004705,2122,240,120,120,11,21.818181818181817
ECU-004706,2122,203,98,105,10,20.3
ECU-004707,2122,24,9,15,3,8.0
ECU-004708,2122,797,403,394,33,24.151515151515152
ECU-004709,2122,16,9,7,1,16.0
ECU-004710,2122,225,113,112,14,16.071428571428573
ECU-004711,2122,13,7,6,1,13.0
ECU-004712,2122,29,12,17,1,29.0
ECU-004713,2122,4,2,2,1,4.0
ECU-004714,2122,29,16,13,2,14.5
ECU-004715,2122,9,3,6,1,9.0
ECU-004716,2122,14,7,7,1,14.0
ECU-004717,2122,67,38,29,4,16.75
ECU-004718,2122,4,0,4,1,4.0
ECU-004719,2122,12,7,5,1,12.0
ECU-004720,2122,5,2,3,1,5.0
ECU-004721,2122,12,7,5,1,12.0
ECU-004722,2122,229,100,129,13,17.615384615384617
ECU-004723,2122,21,10,11,1,21.0
ECU-004724,2122,63,31,32,7,9.0
ECU-004725,2122,20,8,12,2,10.0
ECU-004726,2122,11,4,7,1,11.0
ECU-004727,2122,248,112,136,6,41.333333333333336
ECU-004728,2122,46,28,18,8,5.75
ECU-004729,2122,199,101,98,11,18.09090909090909
ECU-004730,2122,74,31,43,5,14.8
ECU-004731,2122,198,98,100,15,13.2
ECU-004732,2122,150,84,66,11,13.636363636363637
ECU-004733,2122,17,9,8,2,8.5
ECU-004734,2122,9,2,7,1,9.0
ECU-004735,2122,23,14,9,1,23.0
ECU-004736,2122,21,7,14,1,21.0
ECU-004737,2122,586,237,349,38,15.421052631578947
ECU-004738,2122,338,166,172,19,17.789473684210527
ECU-004739,2122,9,6,3,1,9.0
ECU-004740,2122,11,5,6,2,5.5
ECU-004741,2122,10,4,6,1,10.0
ECU-004742,2122,14,5,9,1,14.0
ECU-004743,2122,93,41,52,9,10.333333333333334
ECU-004744,2122,21,11,10,1,21.0
ECU-004745,2122,10,5,5,1,10.0
ECU-004746,2122,1,1,0,1,1.0
ECU-004747,2122,9,4,5,1,9.0
ECU-004748,2122,7,5,2,1,7.0
ECU-004749,2122,8,4,4,1,8.0
ECU-004750,2122,2,0,2,1,2.0
ECU-004751,2122,89,39,50,9,9.88888888888889
ECU-004752,2122,246,111,135,17,14.470588235294118
ECU-004753,2122,37,20,17,4,9.25
ECU-004754,2122,59,30,29,2,29.5
ECU-004755,2122,15,8,7,1,15.0
ECU-004756,2122,7,4,3,1,7.0
ECU-004757,2122,7,2,5,1,7.0
ECU-004758,2122,435,210,225,20,21.75
ECU-004759,2122,762,381,381,48,15.875
ECU-004760,2122,182,106,76,8,22.75
ECU-004761,2122,39,19,20,4,9.75
ECU-004762,2122,20,9,11,1,20.0
ECU-004763,2122,5,3,2,1,5.0
ECU-004764,2122,565,278,287,26,21.73076923076923
ECU-004765,2122,29,13,16,1,29.0
ECU-004766,2122,15,8,7,1,15.0
ECU-004767,2122,31,16,15,3,10.333333333333334
ECU-004768,2122,9,6,3,1,9.0
ECU-004769,2122,4,3,1,1,4.0
ECU-004770,2122,25,12,13,1,25.0
ECU-004771,2122,42,22,20,2,21.0
ECU-004772,2122,29,11,18,1,29.0
ECU-004773,2122,35,18,17,2,17.5
ECU-004774,2122,17,9,8,2,8.5
ECU-004775,2122,17,6,11,1,17.0
ECU-004776,2122,12,4,8,1,12.0
ECU-004777,2122,15,9,6,1,15.0
ECU-004778,2122,17,8,9,2,8.5
ECU-004779,2122,28,8,20,2,14.0
ECU-004780,2122,59,36,23,4,14.75
ECU-004781,2122,55,29,26,4,13.75
ECU-004782,2122,20,10,10,1,20.0
ECU-004783,2122,8,3,5,1,8.0
ECU-004784,2122,5,1,4,1,5.0
ECU-004785,2122,14,4,10,1,14.0
ECU-004786,2122,13,8,5,1,13.0
ECU-004787,2122,5,2,3,1,5.0
ECU-004788,2122,170,76,94,14,12.142857142857142
ECU-004789,2122,468,222,246,30,15.6
ECU-004790,2122,288,150,138,18,16.0
ECU-004791,2122,111,57,54,11,10.090909090909092
ECU-004792,2122,8,5,3,1,8.0
ECU-004793,2122,14,8,6,2,7.0
ECU-004794,2122,16,12,4,2,8.0
ECU-004795,2122,11,7,4,1,11.0
ECU-004796,2122,3,2,1,1,3.0
ECU-004797,2122,6,3,3,1,6.0
ECU-004798,2122,27,16,11,2,13.5
ECU-004799,2122,4,1,3,1,4.0
ECU-004800,2122,107,66,41,7,15.285714285714286
ECU-004801,2122,47,24,23,3,15.666666666666666
ECU-004802,2122,14,10,4,1,14.0
ECU-004803,2122,333,174,159,16,20.8125
ECU-004804,2122,76,31,45,5,15.2
ECU-004805,2122,68,34,34,3,22.666666666666668
ECU-004806,2122,36,23,13,2,18.0
ECU-004807,2122,8,3,5,1,8.0
ECU-004808,2122,5,1,4,1,5.0
ECU-004809,2122,3,2,1,1,3.0
ECU-004810,2122,8,3,5,1,8.0
ECU-004811,2122,7,3,4,1,7.0
ECU-004812,2122,18,4,14,1,18.0
ECU-004813,2122,13,8,5,1,13.0
ECU-004814,2122,8,6,2,1,8.0
ECU-004815,2122,20,6,14,1,20.0
ECU-004816,2122,15,6,9,1,15.0
ECU-004817,2122,17,6,11,1,17.0
ECU-004818,2122,8,4,4,1,8.0
ECU-004819,2122,18,11,7,1,18.0
ECU-004820,2122,25,11,14,2,12.5
ECU-004821,2122,8,6,2,1,8.0
ECU-004822,2122,23,16,7,1,23.0
ECU-004823,2122,16,7,9,1,16.0
ECU-004824,2122,15,6,9,1,15.0
ECU-004825,2122,10,3,7,1,10.0
ECU-004826,2122,18,9,9,1,18.0
ECU-004827,2122,6,0,6,1,6.0
ECU-004828,2122,134,77,57,10,13.4
ECU-004829,2122,31,13,18,2,15.5
ECU-004830,2122,20,10,10,1,20.0
ECU-004831,2122,16,11,5,2,8.0
ECU-004832,2122,47,20,27,2,23.5
ECU-004833,2122,4,2,2,1,4.0
ECU-004834,2122,535,281,254,27,19.814814814814813
ECU-004835,2122,608,300,308,24,25.333333333333332
ECU-004836,2122,20,12,8,1,20.0
ECU-004837,2122,20,6,14,1,20.0
ECU-004838,2122,23,10,13,1,23.0
ECU-004839,2122,11,5,6,1,11.0
ECU-004840,2122,16,8,8,1,16.0
ECU-004841,2122,19,10,9,1,19.0
ECU-004842,2122,14,5,9,1,14.0
ECU-004843,2122,15,8,7,1,15.0
ECU-004844,2122,13,6,7,1,13.0
ECU-004845,2122,12,5,7,1,12.0
ECU-004846,2122,12,7,5,1,12.0
ECU-004847,2122,39,18,21,2,19.5
ECU-004848,2122,10,5,5,1,10.0
ECU-004849,2122,85,47,38,6,14.166666666666666
ECU-004850,2122,29,14,15,2,14.5
ECU-004851,2122,105,49,56,7,15.0
ECU-004852,2122,6,4,2,1,6.0
ECU-004853,2122,32,13,19,1,32.0
ECU-004854,2122,18,9,9,1,18.0
ECU-004855,2122,10,3,7,1,10.0
ECU-004856,2122,1,1,0,1,1.0
ECU-004857,2122,96,41,55,8,12.0
ECU-004858,2122,21,7,14,1,21.0
ECU-004859,2122,15,4,11,1,15.0
ECU-004860,2122,53,29,24,3,17.666666666666668
ECU-004861,2122,13,9,4,1,13.0
ECU-004862,2122,21,6,15,1,21.0
ECU-004863,2122,18,9,9,1,18.0
ECU-004864,2122,11,4,7,1,11.0
ECU-004865,2122,377,206,171,21,17.952380952380953
ECU-004866,2122,163,87,76,10,16.3
ECU-004867,2122,6,4,2,1,6.0
ECU-004868,2122,15,9,6,1,15.0
ECU-004869,2122,18,9,9,1,18.0
ECU-004870,2122,22,7,15,1,22.0
ECU-004871,2122,19,11,8,1,19.0
ECU-004872,2122,10,5,5,1,10.0
ECU-004873,2122,13,3,10,1,13.0
ECU-004874,2122,13,9,4,1,13.0
ECU-004875,2122,22,9,13,2,11.0
ECU-004876,2122,19,12,7,1,19.0
ECU-004877,2122,20,11,9,1,20.0
ECU-004878,2122,31,14,17,1,31.0
ECU-004879,2122,121,63,58,12,10.083333333333334
ECU-004880,2122,5,2,3,1,5.0
ECU-004881,2122,25,12,13,2,12.5
ECU-004882,2122,86,35,51,10,8.6
ECU-004883,2122,11,6,5,1,11.0
ECU-004884,2122,78,45,33,5,15.6
ECU-004885,2122,97,52,45,7,13.857142857142858
ECU-004886,2122,9,4,5,2,4.5
ECU-004887,2122,15,5,10,1,15.0
ECU-004888,2122,18,8,10,1,18.0
ECU-004889,2122,10,6,4,1,10.0
ECU-004890,2122,25,12,13,3,8.333333333333334
ECU-004891,2122,22,9,13,2,11.0
ECU-004892,2122,10,2,8,1,10.0
ECU-004893,2122,7,6,1,1,7.0
ECU-004894,2122,9,6,3,1,9.0
ECU-004895,2122,13,8,5,1,13.0
ECU-004896,2122,34,18,16,5,6.8
ECU-004897,2122,9,3,6,1,9.0
ECU-004898,2122,7,5,2,2,3.5
ECU-004899,2122,38,19,19,5,7.6
ECU-004900,2122,8,4,4,1,8.0
ECU-004901,2122,5,0,5,1,5.0
ECU-004902,2122,4,1,3,1,4.0
ECU-004903,2122,6,3,3,1,6.0
ECU-004904,2122,13,3,10,1,13.0
ECU-004905,2122,51,26,25,2,25.5
ECU-004906,2122,16,9,7,2,8.0
ECU-004907,2122,52,29,23,3,17.333333333333332
ECU-004908,2122,11,8,3,1,11.0
ECU-004909,2122,28,11,17,2,14.0
ECU-004910,2122,37,18,19,3,12.333333333333334
ECU-004911,2122,117,53,64,8,14.625
ECU-004912,2122,16,7,9,3,5.333333333333333
ECU-004913,2122,170,63,107,12,14.166666666666666
ECU-004914,2122,32,14,18,3,10.666666666666666
ECU-004915,2122,46,21,25,2,23.0
ECU-004916,2122,23,8,15,2,11.5
ECU-004917,2122,269,105,164,14,19.214285714285715
ECU-004918,2122,95,51,44,4,23.75
ECU-004919,2122,25,12,13,2,12.5
ECU-004920,2122,264,125,139,22,12.0
ECU-004921,2122,24,14,10,1,24.0
ECU-004922,2122,3,0,3,1,3.0
ECU-004923,2122,16,7,9,1,16.0
ECU-004924,2122,46,27,19,1,46.0
ECU-004925,2122,29,8,21,1,29.0
ECU-004926,2122,305,120,185,16,19.0625
ECU-004927,2122,37,20,17,1,37.0
ECU-004928,2122,524,262,262,20,26.2
ECU-004929,2122,85,39,46,3,28.333333333333332
ECU-004930,2122,17,6,11,1,17.0
ECU-004931,2122,26,14,12,1,26.0
ECU-004932,2122,118,58,60,6,19.666666666666668
ECU-004933,2122,26,17,9,1,26.0
ECU-004934,2122,584,260,324,30,19.466666666666665
ECU-004935,2122,19,7,12,1,19.0
ECU-004936,2122,224,114,110,7,32.0
ECU-004937,2122,1827,873,954,65,28.107692307692307
ECU-004938,2122,1525,757,768,52,29.326923076923077
ECU-004939,2122,3310,1670,1640,124,26.693548387096776
ECU-004940,2122,1962,1015,947,61,32.16393442622951
ECU-004941,2122,120,56,64,9,13.333333333333334
ECU-004942,2122,910,439,471,28,32.5
ECU-004943,2122,14,7,7,3,4.666666666666667
ECU-004944,2122,217,119,98,20,10.85
ECU-004945,2122,263,134,129,10,26.3
ECU-004946,2122,1764,874,890,62,28.451612903225808
ECU-004947,2122,685,324,361,25,27.4
ECU-004948,2122,1110,546,564,45,24.666666666666668
ECU-004949,2122,74,28,46,3,24.666666666666668
ECU-004950,2122,30,15,15,1,30.0
ECU-004951,2122,13,7,6,1,13.0
ECU-004952,2122,112,47,65,4,28.0
ECU-004953,2122,13,7,6,1,13.0
ECU-004954,2122,24,13,11,1,24.0
ECU-004955,2122,16,11,5,1,16.0
ECU-004956,2122,255,126,129,9,28.333333333333332
ECU-004957,2122,25,12,13,1,25.0
ECU-004958,2122,168,70,98,9,18.666666666666668
ECU-004959,2122,41,18,23,2,20.5
ECU-004960,2122,28,15,13,1,28.0
ECU-004961,2122,31,11,20,1,31.0
ECU-004962,2122,45,16,29,2,22.5
ECU-004963,2122,41,18,23,1,41.0
ECU-004964,2122,41,11,30,2,20.5
ECU-004965,2122,43,19,24,2,21.5
ECU-004966,2122,48,19,29,2,24.0
ECU-004967,2122,71,29,42,2,35.5
ECU-004968,2122,171,63,108,8,21.375
ECU-004969,2122,20,10,10,1,20.0
ECU-004970,2122,345,167,178,19,18.157894736842106
ECU-004971,2122,1156,546,610,42,27.523809523809526
ECU-004972,2122,38,14,24,1,38.0
ECU-004973,2122,41,25,16,2,20.5
ECU-004974,2122,322,173,149,16,20.125
ECU-004975,2122,22,11,11,1,22.0
ECU-004976,2122,21,8,13,1,21.0
ECU-004977,2122,34,15,19,1,34.0
ECU-004978,2122,220,116,104,12,18.333333333333332
ECU-004979,2122,506,262,244,20,25.3
ECU-004980,2122,178,90,88,7,25.428571428571427
ECU-004981,2122,297,163,134,14,21.214285714285715
ECU-004982,2122,151,83,68,12,12.583333333333334
ECU-004983,2122,692,338,354,30,23.066666666666666
ECU-004984,2122,10,6,4,1,10.0
ECU-004985,2122,50,25,25,2,25.0
ECU-004986,2122,397,192,205,17,23.352941176470587
ECU-004987,2122,364,168,196,18,20.22222222222222
ECU-004988,2122,27,16,11,1,27.0
ECU-004989,2122,21,11,10,1,21.0
ECU-004990,2122,19,7,12,1,19.0
ECU-004991,2122,11,4,7,1,11.0
ECU-004992,2122,33,15,18,1,33.0
ECU-004993,2122,28,18,10,1,28.0
ECU-004994,2122,50,25,25,2,25.0
ECU-004995,2122,45,20,25,2,22.5
ECU-004996,2122,19,9,10,1,19.0
ECU-004997,2122,22,10,12,1,22.0
ECU-004998,2122,24,17,7,1,24.0
ECU-004999,2122,24,14,10,1,24.0
ECU-005000,2122,594,293,301,24,24.75
ECU-005001,2122,16,11,5,1,16.0
ECU-005002,2122,14,5,9,1,14.0
ECU-005003,2122,17,8,9,1,17.0
ECU-005004,2122,90,41,49,3,30.0
ECU-005005,2122,47,18,29,2,23.5
ECU-005006,2122,19,5,14,1,19.0
ECU-005007,2122,18,7,11,1,18.0
ECU-005008,2122,5,2,3,1,5.0
ECU-005009,2122,635,317,318,34,18.676470588235293
ECU-005010,2122,227,96,131,11,20.636363636363637
ECU-005011,2122,17,9,8,1,17.0
ECU-005012,2122,508,261,247,20,25.4
ECU-005013,2122,30,13,17,1,30.0
ECU-005014,2122,29,20,9,1,29.0
ECU-005015,2122,51,20,31,3,17.0
ECU-005016,2122,16,10,6,1,16.0
ECU-005017,2122,11,2,9,1,11.0
ECU-005018,2122,42,20,22,2,21.0
ECU-005019,2122,7,3,4,1,7.0
ECU-005020,2122,43,25,18,3,14.333333333333334
ECU-005021,2122,4,2,2,1,4.0
ECU-005022,2122,10,7,3,1,10.0
ECU-005023,2122,48,23,25,5,9.6
ECU-005024,2122,7,2,5,1,7.0
ECU-005025,2122,11,6,5,1,11.0
ECU-005026,2122,15,12,3,1,15.0
ECU-005027,2122,17,7,10,1,17.0
ECU-005028,2122,8,4,4,1,8.0
ECU-005029,2122,130,55,75,8,16.25
ECU-005030,2122,15,7,8,1,15.0
ECU-005031,2122,13,7,6,1,13.0
ECU-005032,2122,6,4,2,1,6.0
ECU-005033,2122,22,11,11,1,22.0
ECU-005034,2122,17,2,15,1,17.0
ECU-005035,2122,27,10,17,1,27.0
ECU-005036,2122,10,5,5,1,10.0
ECU-005037,2122,9,6,3,1,9.0
ECU-005038,2122,31,12,19,2,15.5
ECU-005039,2122,11,4,7,1,11.0
ECU-005040,2122,301,138,163,18,16.72222222222222
ECU-005041,2122,936,456,480,39,24.0
ECU-005042,2122,525,268,257,19,27.63157894736842
ECU-005043,2122,30,27,3,2,15.0
ECU-005044,2122,4,2,2,1,4.0
ECU-005045,2122,9,6,3,1,9.0
ECU-005046,2122,18,9,9,1,18.0
ECU-005047,2122,2,0,2,1,2.0
ECU-005048,2122,4,1,3,1,4.0
ECU-005049,2122,589,324,265,31,19.0
ECU-005050,2122,6,4,2,1,6.0
ECU-005051,2122,24,16,8,2,12.0
ECU-005052,2122,37,17,20,1,37.0
ECU-005053,2122,9,3,6,1,9.0
ECU-005054,2122,23,15,8,1,23.0
ECU-005055,2122,9,6,3,1,9.0
ECU-005056,2122,4,1,3,1,4.0
ECU-005057,2122,6,2,4,1,6.0
ECU-005058,2122,11,4,7,1,11.0
ECU-005059,2122,15,9,6,1,15.0
ECU-005060,2122,8,7,1,1,8.0
ECU-005061,2122,203,86,117,11,18.454545454545453
ECU-005062,2122,6,3,3,1,6.0
ECU-005063,2122,15,9,6,1,15.0
ECU-005064,2122,12,7,5,1,12.0
ECU-005065,2122,11,5,6,1,11.0
ECU-005066,2122,43,16,27,1,43.0
ECU-005067,2122,278,127,151,16,17.375
ECU-005068,2122,340,170,170,18,18.88888888888889
ECU-005069,2122,355,190,165,19,18.68421052631579
ECU-005070,2122,71,38,33,3,23.666666666666668
ECU-005071,2122,21,11,10,1,21.0
ECU-005072,2122,63,29,34,5,12.6
ECU-005073,2122,12,3,9,1,12.0
ECU-005074,2122,10,5,5,1,10.0
ECU-005075,2122,7,6,1,1,7.0
ECU-005076,2122,22,8,14,1,22.0
ECU-005077,2122,18,9,9,1,18.0
ECU-005078,2122,10,5,5,1,10.0
ECU-005079,2122,6,3,3,1,6.0
ECU-005080,2122,12,7,5,1,12.0
ECU-005081,2122,31,17,14,1,31.0
ECU-005082,2122,27,11,16,2,13.5
ECU-005083,2122,5,2,3,1,5.0
ECU-005084,2122,15,6,9,1,15.0
ECU-005085,2122,16,6,10,1,16.0
ECU-005086,2122,33,21,12,3,11.0
ECU-005087,2122,59,27,32,4,14.75
ECU-005088,2122,240,124,116,14,17.142857142857142
ECU-005089,2122,10,3,7,1,10.0
ECU-005090,2122,15,6,9,1,15.0
ECU-005091,2122,14,5,9,1,14.0
ECU-005092,2122,14,5,9,1,14.0
ECU-005093,2122,6,5,1,1,6.0
ECU-005094,2122,11,5,6,1,11.0
ECU-005095,2122,14,5,9,1,14.0
ECU-005096,2122,13,3,10,1,13.0
ECU-005097,2122,62,24,38,3,20.666666666666668
ECU-005098,2122,909,437,472,35,25.97142857142857
ECU-005099,2122,179,71,108,8,22.375
ECU-005100,2122,294,142,152,17,17.294117647058822
ECU-005101,2122,552,263,289,27,20.444444444444443
ECU-005102,2122,706,293,413,53,13.320754716981131
ECU-005103,2122,142,63,79,15,9.466666666666667
ECU-005104,2122,333,170,163,13,25.615384615384617
ECU-005105,2122,14,10,4,2,7.0
ECU-005106,2122,17,6,11,1,17.0
ECU-005107,2122,163,74,89,14,11.642857142857142
ECU-005108,2122,28,18,10,2,14.0
ECU-005109,2122,8,4,4,1,8.0
ECU-005110,2122,56,25,31,8,7.0
ECU-005111,2122,12,2,10,1,12.0
ECU-005112,2122,26,15,11,2,13.0
ECU-005113,2122,40,18,22,2,20.0
ECU-005114,2122,96,43,53,19,5.052631578947368
ECU-005115,2122,81,43,38,4,20.25
ECU-005116,2122,20,9,11,1,20.0
ECU-005117,2122,14,9,5,1,14.0
ECU-005118,2122,14,8,6,1,14.0
ECU-005119,2122,3,2,1,1,3.0
ECU-005120,2122,30,11,19,1,30.0
ECU-005121,2122,13,5,8,1,13.0
ECU-005122,2122,34,15,19,2,17.0
ECU-005123,2122,49,27,22,3,16.333333333333332
ECU-005124,2122,8,1,7,1,8.0
ECU-005125,2122,9,4,5,1,9.0
ECU-005126,2122,10,4,6,1,10.0
ECU-005127,2122,133,65,68,12,11.083333333333334
ECU-005128,2122,322,172,150,18,17.88888888888889
ECU-005129,2122,13,4,9,1,13.0
ECU-005130,2122,52,28,24,3,17.333333333333332
ECU-005131,2122,232,108,124,14,16.571428571428573
ECU-005132,2122,29,8,21,2,14.5
ECU-005133,2122,8,3,5,1,8.0
ECU-005134,2122,49,26,23,2,24.5
ECU-005135,2122,14,9,5,1,14.0
ECU-005136,2122,32,17,15,2,16.0
ECU-005137,2122,402,191,211,19,21.157894736842106
ECU-005138,2122,12,5,7,1,12.0
ECU-005139,2122,544,260,284,28,19.428571428571427
ECU-005140,2122,18,9,9,1,18.0
ECU-005141,2122,12,7,5,1,12.0
ECU-005142,2122,8,3,5,1,8.0
ECU-005143,2122,26,0,26,3,8.666666666666666
ECU-005144,2122,27,14,13,2,13.5
ECU-005145,2122,29,18,11,2,14.5
ECU-005146,2122,354,177,177,15,23.6
ECU-005147,2122,450,241,209,28,16.071428571428573
ECU-005148,2122,163,77,86,8,20.375
ECU-005149,2122,10,2,8,1,10.0
ECU-005150,2122,627,279,348,32,19.59375
ECU-005151,2122,2458,1291,1167,102,24.098039215686274
ECU-005152,2122,869,523,346,29,29.96551724137931
ECU-005153,2122,1181,508,673,37,31.91891891891892
ECU-005154,2122,373,185,188,14,26.642857142857142
ECU-005155,2122,19,10,9,1,19.0
ECU-005156,2122,60,26,34,3,20.0
ECU-005157,2122,9,5,4,1,9.0
ECU-005158,2122,38,19,19,2,19.0
ECU-005159,2122,16,6,10,1,16.0
ECU-005160,2122,13,8,5,1,13.0
ECU-005161,2122,5,2,3,1,5.0
ECU-005162,2122,10,1,9,1,10.0
ECU-005163,2122,3,2,1,1,3.0
ECU-005164,2122,7,5,2,1,7.0
ECU-005165,2122,4,1,3,1,4.0
ECU-005166,2122,19,11,8,1,19.0
ECU-005167,2122,146,77,69,12,12.166666666666666
ECU-005168,2122,71,35,36,4,17.75
ECU-005169,2122,5,4,1,1,5.0
ECU-005170,2122,9,5,4,1,9.0
ECU-005171,2122,12,6,6,1,12.0
ECU-005172,2122,4,2,2,1,4.0
ECU-005173,2122,18,7,11,1,18.0
ECU-005174,2122,17,9,8,1,17.0
ECU-005175,2122,255,106,149,14,18.214285714285715
ECU-005176,2122,6,4,2,1,6.0
ECU-005177,2122,37,21,16,2,18.5
ECU-005178,2122,5,1,4,1,5.0
ECU-005179,2122,131,52,79,9,14.555555555555555
ECU-005180,2122,4,2,2,1,4.0
ECU-005181,2122,11,5,6,1,11.0
ECU-005182,2122,7,5,2,1,7.0
ECU-005183,2122,33,14,19,1,33.0
ECU-005184,2122,19,10,9,1,19.0
ECU-005185,2122,12,6,6,1,12.0
ECU-005186,2122,10,3,7,1,10.0
ECU-005187,2122,10,2,8,1,10.0
ECU-005188,2122,4,2,2,1,4.0
ECU-005189,2122,12,10,2,1,12.0
ECU-005190,2122,55,33,22,3,18.333333333333332
ECU-005191,2122,7,3,4,1,7.0
ECU-005192,2122,31,22,9,2,15.5
ECU-005193,2122,18,9,9,1,18.0
ECU-005194,2122,23,14,9,1,23.0
ECU-005195,2122,4,1,3,1,4.0
ECU-005196,2122,12,4,8,1,12.0
ECU-005197,2122,157,69,88,14,11.214285714285714
ECU-005198,2122,6,1,5,1,6.0
ECU-005199,2122,20,8,12,1,20.0
ECU-005200,2122,10,4,6,1,10.0
ECU-005201,2122,7,4,3,1,7.0
ECU-005202,2122,5,3,2,1,5.0
ECU-005203,2122,205,93,112,11,18.636363636363637
ECU-005204,2122,9,2,7,1,9.0
ECU-005205,2122,13,9,4,1,13.0
ECU-005206,2122,22,14,8,1,22.0
ECU-005207,2122,23,12,11,1,23.0
ECU-005208,2122,9,2,7,1,9.0
ECU-005209,2122,9,6,3,1,9.0
ECU-005210,2122,8,5,3,1,8.0
ECU-005211,2122,9,7,2,1,9.0
ECU-005212,2122,14,7,7,1,14.0
ECU-005213,2122,131,59,72,12,10.916666666666666
ECU-005214,2122,54,26,28,2,27.0
ECU-005215,2122,158,79,79,13,12.153846153846153
ECU-005216,2122,278,137,141,14,19.857142857142858
ECU-005217,2122,85,40,45,4,21.25
ECU-005218,2122,788,389,399,33,23.87878787878788
ECU-005219,2122,7,2,5,1,7.0
ECU-005220,2122,20,10,10,1,20.0
ECU-005221,2122,13,7,6,1,13.0
ECU-005222,2122,203,94,109,13,15.615384615384615
ECU-005223,2122,7,5,2,1,7.0
ECU-005224,2122,7,2,5,1,7.0
ECU-005225,2122,5,1,4,1,5.0
ECU-005226,2122,151,71,80,7,21.571428571428573
ECU-005227,2122,12,5,7,1,12.0
ECU-005228,2122,21,6,15,1,21.0
ECU-005229,2122,59,24,35,3,19.666666666666668
ECU-005230,2122,11,5,6,1,11.0
ECU-005231,2122,23,9,14,1,23.0
ECU-005232,2122,6,1,5,1,6.0
ECU-005233,2122,129,64,65,6,21.5
ECU-005234,2122,294,152,142,17,17.294117647058822
ECU-005235,2122,122,63,59,6,20.333333333333332
ECU-005236,2122,6,5,1,1,6.0
ECU-005237,2122,8,4,4,1,8.0
ECU-005238,2122,22,11,11,1,22.0
ECU-005239,2122,14,6,8,1,14.0
ECU-005240,2122,20,12,8,1,20.0
ECU-005241,2122,10,5,5,1,10.0
ECU-005242,2122,21,5,16,1,21.0
ECU-005243,2122,2,0,2,1,2.0
ECU-005244,2122,35,21,14,3,11.666666666666666
ECU-005245,2122,3,1,2,1,3.0
ECU-005246,2122,4,1,3,1,4.0
ECU-005247,2122,27,18,9,1,27.0
ECU-005248,2122,17,11,6,1,17.0
ECU-005249,2122,19,8,11,1,19.0
ECU-005250,2122,889,445,444,48,18.520833333333332
ECU-005251,2122,12,5,7,1,12.0
ECU-005252,2122,98,49,49,6,16.333333333333332
ECU-005253,2122,83,40,43,3,27.666666666666668
ECU-005254,2122,15,7,8,1,15.0
ECU-005255,2122,36,20,16,1,36.0
ECU-005256,2122,41,21,20,2,20.5
ECU-005257,2122,269,135,134,13,20.692307692307693
ECU-005258,2122,171,83,88,12,14.25
ECU-005259,2122,6,5,1,1,6.0
ECU-005260,2122,14,6,8,1,14.0
ECU-005261,2122,699,349,350,29,24.103448275862068
ECU-005262,2122,661,296,365,24,27.541666666666668
ECU-005263,2122,210,96,114,42,5.0
ECU-005264,2122,774,406,368,22,35.18181818181818
ECU-005265,2122,265,122,143,12,22.083333333333332
ECU-005266,2122,35,20,15,5,7.0
ECU-005267,2122,2048,958,1090,64,32.0
ECU-005268,2122,76,35,41,3,25.333333333333332
ECU-005269,2122,447,217,230,17,26.294117647058822
ECU-005270,2122,291,149,142,9,32.333333333333336
ECU-005271,2122,1004,497,507,32,31.375
ECU-005272,2122,1119,548,571,37,30.243243243243242
ECU-005273,2122,44,19,25,7,6.285714285714286
ECU-005274,2122,2929,1395,1534,109,26.871559633027523
ECU-005275,2122,149,78,71,11,13.545454545454545
ECU-005276,2122,184,88,96,9,20.444444444444443
ECU-005277,2122,15,7,8,1,15.0
ECU-005278,2122,489,242,247,16,30.5625
ECU-005279,2122,129,63,66,6,21.5
ECU-005280,2122,643,321,322,23,27.956521739130434
ECU-005281,2122,419,198,221,22,19.045454545454547
ECU-005282,2122,239,113,126,13,18.384615384615383
ECU-005283,2122,260,135,125,9,28.88888888888889
ECU-005284,2122,98,47,51,6,16.333333333333332
ECU-005285,2122,557,255,302,19,29.31578947368421
ECU-005286,2122,54,22,32,9,6.0
ECU-005287,2122,469,230,239,15,31.266666666666666
ECU-005288,2122,493,265,228,20,24.65
ECU-005289,2122,352,164,188,12,29.333333333333332
ECU-005290,2122,114,54,60,10,11.4
ECU-005291,2122,681,320,361,27,25.22222222222222
ECU-005292,2122,317,161,156,10,31.7
ECU-005293,2122,286,139,147,22,13.0
ECU-005294,2122,313,137,176,12,26.083333333333332
ECU-005295,2122,368,189,179,18,20.444444444444443
ECU-005296,2122,1079,173,906,64,16.859375
ECU-005297,2122,774,386,388,26,29.76923076923077
ECU-005298,2122,75,34,41,8,9.375
ECU-005299,2122,737,383,354,35,21.057142857142857
ECU-005300,2122,724,355,369,40,18.1
ECU-005301,2122,616,325,291,49,12.571428571428571
ECU-005302,2122,338,167,171,11,30.727272727272727
ECU-005303,2122,674,349,325,21,32.095238095238095
ECU-005304,2122,161,89,72,7,23.0
ECU-005305,2122,4,1,3,2,2.0
ECU-005306,2122,618,389,229,15,41.2
ECU-005307,2122,1255,594,661,53,23.67924528301887
ECU-005308,2122,2339,1317,1022,93,25.150537634408604
ECU-005309,2122,891,514,377,55,16.2
ECU-005310,2122,693,332,361,26,26.653846153846153
ECU-005311,2122,226,105,121,19,11.894736842105264
ECU-005312,2122,123,60,63,15,8.2
ECU-005313,2122,242,107,135,10,24.2
ECU-005314,2122,29,15,14,4,7.25
ECU-005315,2122,810,364,446,27,30.0
ECU-005316,2122,2145,972,1173,84,25.535714285714285
ECU-005317,2122,492,239,253,27,18.22222222222222
ECU-005318,2122,617,298,319,20,30.85
ECU-005319,2122,326,147,179,17,19.176470588235293
ECU-005320,2122,835,424,411,34,24.558823529411764
ECU-005321,2122,423,209,214,15,28.2
ECU-005322,2122,50,31,19,7,7.142857142857143
ECU-005323,2122,318,163,155,19,16.736842105263158
ECU-005324,2122,741,365,376,25,29.64
ECU-005325,2122,296,156,140,13,22.76923076923077
ECU-005326,2122,1261,541,720,58,21.74137931034483
ECU-005327,2122,788,458,330,44,17.90909090909091
ECU-005328,2122,6,2,4,2,3.0
ECU-005329,2122,418,185,233,19,22.0
ECU-005330,2122,1467,754,713,55,26.672727272727272
ECU-005331,2122,465,219,246,18,25.833333333333332
ECU-005332,2122,161,76,85,11,14.636363636363637
ECU-005333,2122,301,165,136,10,30.1
ECU-005334,2122,161,134,27,13,12.384615384615385
ECU-005335,2122,1003,518,485,37,27.10810810810811
ECU-005336,2122,81,39,42,10,8.1
ECU-005337,2122,137,69,68,14,9.785714285714286
ECU-005338,2122,600,303,297,23,26.08695652173913
ECU-005339,2122,120,60,60,12,10.0
ECU-005340,2122,110,64,46,5,22.0
ECU-005341,2122,540,242,298,21,25.714285714285715
ECU-005342,2122,1817,1028,789,79,23.0
ECU-005343,2122,247,122,125,9,27.444444444444443
ECU-005344,2122,1200,658,542,39,30.76923076923077
ECU-005345,2122,296,142,154,11,26.90909090909091
ECU-005346,2122,422,214,208,17,24.823529411764707
ECU-005347,2122,920,470,450,28,32.857142857142854
ECU-005348,2122,719,360,359,22,32.68181818181818
ECU-005349,2122,1011,497,514,39,25.923076923076923
ECU-005350,2122,249,121,128,10,24.9
ECU-005351,2122,138,64,74,7,19.714285714285715
ECU-005352,2122,502,258,244,18,27.88888888888889
ECU-005353,2122,193,114,79,17,11.352941176470589
ECU-005354,2122,105,48,57,8,13.125
ECU-005355,2122,81,44,37,6,13.5
ECU-005356,2122,160,77,83,14,11.428571428571429
ECU-005357,2122,19,7,12,4,4.75
ECU-005358,2122,1611,782,829,52,30.98076923076923
ECU-005359,2122,21,8,13,2,10.5
ECU-005360,2122,274,129,145,9,30.444444444444443
ECU-005361,2122,605,308,297,27,22.40740740740741
ECU-005362,2122,386,191,195,14,27.571428571428573
ECU-005363,2122,246,121,125,8,30.75
ECU-005364,2122,321,151,170,13,24.692307692307693
ECU-005365,2122,29,14,15,4,7.25
ECU-005366,2122,27,11,16,4,6.75
ECU-005367,2122,710,343,367,28,25.357142857142858
ECU-005368,2122,695,332,363,28,24.821428571428573
ECU-005369,2122,1146,593,553,34,33.705882352941174
ECU-005370,2122,737,344,393,26,28.346153846153847
ECU-005371,2122,36,16,20,6,6.0
ECU-005372,2122,609,289,320,19,32.05263157894737
ECU-005373,2122,2182,1176,1006,63,34.63492063492063
ECU-005374,2122,1522,777,745,53,28.71698113207547
ECU-005375,2122,169,81,88,6,28.166666666666668
ECU-005376,2122,54,24,30,6,9.0
ECU-005377,2122,923,454,469,30,30.766666666666666
ECU-005378,2122,1402,734,668,66,21.242424242424242
ECU-005379,2122,16,9,7,1,16.0
ECU-005380,2122,208,103,105,10,20.8
ECU-005381,2122,166,81,85,9,18.444444444444443
ECU-005382,2122,45,18,27,2,22.5
ECU-005383,2122,278,141,137,13,21.384615384615383
ECU-005384,2122,58,29,29,3,19.333333333333332
ECU-005385,2122,24,15,9,2,12.0
ECU-005386,2122,39,17,22,2,19.5
ECU-005387,2122,163,79,84,6,27.166666666666668
ECU-005388,2122,259,122,137,13,19.923076923076923
ECU-005389,2122,776,376,400,32,24.25
ECU-005390,2122,627,303,324,22,28.5
ECU-005391,2122,144,85,59,7,20.571428571428573
ECU-005392,2122,260,133,127,14,18.571428571428573
ECU-005393,2122,365,178,187,13,28.076923076923077
ECU-005394,2122,107,43,64,3,35.666666666666664
ECU-005395,2122,305,207,98,10,30.5
ECU-005396,2122,13,4,9,1,13.0
ECU-005397,2122,402,200,202,15,26.8
ECU-005398,2122,216,99,117,13,16.615384615384617
ECU-005399,2122,42,28,14,2,21.0
ECU-005400,2122,272,145,127,12,22.666666666666668
ECU-005401,2122,272,120,152,15,18.133333333333333
ECU-005402,2122,29,16,13,3,9.666666666666666
ECU-005403,2122,24,12,12,2,12.0
ECU-005404,2122,63,32,31,2,31.5
ECU-005405,2122,43,22,21,2,21.5
ECU-005406,2122,120,64,56,6,20.0
ECU-005407,2122,313,165,148,9,34.77777777777778
ECU-005408,2122,18,7,11,1,18.0
ECU-005409,2122,408,207,201,17,24.0
ECU-005410,2122,590,301,289,24,24.583333333333332
ECU-005411,2122,641,319,322,31,20.677419354838708
ECU-005412,2122,1276,601,675,55,23.2
ECU-005413,2122,35,17,18,2,17.5
ECU-005414,2122,69,30,39,14,4.928571428571429
ECU-005415,2122,24,14,10,1,24.0
ECU-005416,2122,287,136,151,14,20.5
ECU-005417,2122,13,7,6,1,13.0
ECU-005418,2122,99,51,48,9,11.0
ECU-005419,2122,61,37,24,4,15.25
ECU-005420,2122,266,128,138,10,26.6
ECU-005421,2122,204,104,100,8,25.5
ECU-005422,2122,195,105,90,9,21.666666666666668
ECU-005423,2122,347,170,177,14,24.785714285714285
ECU-005424,2122,307,146,161,12,25.583333333333332
ECU-005425,2122,339,171,168,16,21.1875
ECU-005426,2122,2270,1188,1082,89,25.50561797752809
ECU-005427,2122,106,61,45,12,8.833333333333334
ECU-005428,2122,569,274,295,23,24.73913043478261
ECU-005429,2122,762,433,329,30,25.4
ECU-005430,2122,281,142,139,10,28.1
ECU-005431,2122,9,3,6,1,9.0
ECU-005432,2122,126,66,60,8,15.75
ECU-005433,2122,513,239,274,21,24.428571428571427
ECU-005434,2122,9,5,4,1,9.0
ECU-005435,2122,1902,956,946,71,26.788732394366196
ECU-005436,2122,993,514,479,48,20.6875
ECU-005437,2122,336,165,171,16,21.0
ECU-005438,2122,187,104,83,9,20.77777777777778
ECU-005439,2122,1549,699,850,66,23.46969696969697
ECU-005440,2122,129,59,70,9,14.333333333333334
ECU-005441,2122,16,2,14,1,16.0
ECU-005442,2122,10,4,6,1,10.0
ECU-005443,2122,12,7,5,1,12.0
ECU-005444,2122,5,4,1,1,5.0
ECU-005445,2122,939,466,473,32,29.34375
ECU-005446,2122,586,292,294,18,32.55555555555556
ECU-005447,2122,33,13,20,2,16.5
ECU-005448,2122,31,15,16,1,31.0
ECU-005449,2122,16,7,9,1,16.0
ECU-005450,2122,7,1,6,1,7.0
ECU-005451,2122,14,8,6,1,14.0
ECU-005452,2122,18,7,11,1,18.0
ECU-005453,2122,4,2,2,1,4.0
ECU-005454,2122,10,5,5,1,10.0
ECU-005455,2122,15,6,9,1,15.0
ECU-005456,2122,4,1,3,1,4.0
ECU-005457,2122,17,9,8,1,17.0
ECU-005458,2122,26,14,12,3,8.666666666666666
ECU-005459,2122,35,15,20,2,17.5
ECU-005460,2122,23,14,9,1,23.0
ECU-005461,2122,17,11,6,1,17.0
ECU-005462,2122,14,9,5,1,14.0
ECU-005463,2122,15,8,7,1,15.0
ECU-005464,2122,28,8,20,1,28.0
ECU-005465,2122,15,6,9,1,15.0
ECU-005466,2122,26,15,11,1,26.0
ECU-005467,2122,21,9,12,1,21.0
ECU-005468,2122,30,15,15,1,30.0
ECU-005469,2122,19,7,12,1,19.0
ECU-005470,2122,26,14,12,1,26.0
ECU-005471,2122,23,16,7,1,23.0
ECU-005472,2122,22,11,11,2,11.0
ECU-005473,2122,12,5,7,1,12.0
ECU-005474,2122,15,7,8,1,15.0
ECU-005475,2122,24,8,16,1,24.0
ECU-005476,2122,887,409,478,35,25.34285714285714
ECU-005477,2122,5,3,2,1,5.0
ECU-005478,2122,15,7,8,1,15.0
ECU-005479,2122,17,7,10,1,17.0
ECU-005480,2122,18,8,10,1,18.0
ECU-005481,2122,19,8,11,1,19.0
ECU-005482,2122,31,10,21,2,15.5
ECU-005483,2122,15,11,4,1,15.0
ECU-005484,2122,19,10,9,1,19.0
ECU-005485,2122,23,10,13,1,23.0
ECU-005486,2122,28,17,11,1,28.0
ECU-005487,2122,186,98,88,8,23.25
ECU-005488,2122,69,48,21,3,23.0
ECU-005489,2122,33,18,15,1,33.0
ECU-005490,2122,9,4,5,1,9.0
ECU-005491,2122,396,202,194,16,24.75
ECU-005492,2122,6,3,3,1,6.0
ECU-005493,2122,11,4,7,1,11.0
ECU-005494,2122,9,2,7,1,9.0
ECU-005495,2122,12,6,6,1,12.0
ECU-005496,2122,43,16,27,1,43.0
ECU-005497,2122,37,16,21,1,37.0
ECU-005498,2122,13,10,3,1,13.0
ECU-005499,2122,19,9,10,1,19.0
ECU-005500,2122,18,8,10,1,18.0
ECU-005501,2122,10,6,4,1,10.0
ECU-005502,2122,15,7,8,1,15.0
ECU-005503,2122,34,15,19,2,17.0
ECU-005504,2122,26,16,10,1,26.0
ECU-005505,2122,8,4,4,1,8.0
ECU-005506,2122,441,219,222,14,31.5
ECU-005507,2122,9,2,7,1,9.0
ECU-005508,2122,3,2,1,1,3.0
ECU-005509,2122,17,8,9,1,17.0
ECU-005510,2122,44,24,20,2,22.0
ECU-005511,2122,23,11,12,1,23.0
ECU-005512,2122,28,12,16,1,28.0
ECU-005513,2122,48,26,22,2,24.0
ECU-005514,2122,73,32,41,3,24.333333333333332
ECU-005515,2122,27,13,14,1,27.0
ECU-005516,2122,18,11,7,1,18.0
ECU-005517,2122,112,57,55,4,28.0
ECU-005518,2122,86,38,48,3,28.666666666666668
ECU-005519,2122,55,22,33,3,18.333333333333332
ECU-005520,2122,74,40,34,3,24.666666666666668
ECU-005521,2122,45,24,21,3,15.0
ECU-005522,2122,13,7,6,1,13.0
ECU-005523,2122,19,8,11,1,19.0
ECU-005524,2122,11,3,8,1,11.0
ECU-005525,2122,12,7,5,1,12.0
ECU-005526,2122,32,15,17,2,16.0
ECU-005527,2122,30,14,16,2,15.0
ECU-005528,2122,8,4,4,1,8.0
ECU-005529,2122,811,410,401,38,21.342105263157894
ECU-005530,2122,19,8,11,1,19.0
ECU-005531,2122,35,14,21,2,17.5
ECU-005532,2122,89,40,49,3,29.666666666666668
ECU-005533,2122,9,3,6,1,9.0
ECU-005534,2122,22,10,12,1,22.0
ECU-005535,2122,28,13,15,1,28.0
ECU-005536,2122,12,4,8,1,12.0
ECU-005537,2122,47,23,24,2,23.5
ECU-005538,2122,122,64,58,7,17.428571428571427
ECU-005539,2122,18,8,10,1,18.0
ECU-005540,2122,98,43,55,4,24.5
ECU-005541,2122,4,3,1,1,4.0
ECU-005542,2122,103,50,53,5,20.6
ECU-005543,2122,10,5,5,1,10.0
ECU-005544,2122,1638,814,824,76,21.55263157894737
ECU-005545,2122,17,10,7,1,17.0
ECU-005546,2122,34,15,19,2,17.0
ECU-005547,2122,29,12,17,1,29.0
ECU-005548,2122,15,10,5,1,15.0
ECU-005549,2122,200,92,108,9,22.22222222222222
ECU-005550,2122,21,9,12,1,21.0
ECU-005551,2122,21,13,8,1,21.0
ECU-005552,2122,19,12,7,1,19.0
ECU-005553,2122,12,4,8,1,12.0
ECU-005554,2122,7,5,2,1,7.0
ECU-005555,2122,268,140,128,16,16.75
ECU-005556,2122,393,207,186,20,19.65
ECU-005557,2122,35,19,16,1,35.0
ECU-005558,2122,22,12,10,1,22.0
ECU-005559,2122,6,1,5,1,6.0
ECU-005560,2122,20,7,13,1,20.0
ECU-005561,2122,93,48,45,4,23.25
ECU-005562,2122,12,5,7,1,12.0
ECU-005563,2122,8,4,4,1,8.0
ECU-005564,2122,290,151,139,16,18.125
ECU-005565,2122,206,105,101,7,29.428571428571427
ECU-005566,2122,18,7,11,1,18.0
ECU-005567,2122,21,8,13,1,21.0
ECU-005568,2122,24,10,14,1,24.0
ECU-005569,2122,23,12,11,1,23.0
ECU-005570,2122,21,9,12,1,21.0
ECU-005571,2122,19,13,6,1,19.0
ECU-005572,2122,10,3,7,1,10.0
ECU-005573,2122,14,7,7,1,14.0
ECU-005574,2122,178,86,92,12,14.833333333333334
ECU-005575,2122,59,28,31,4,14.75
ECU-005576,2122,29,15,14,1,29.0
ECU-005577,2122,51,33,18,1,51.0
ECU-005578,2122,60,29,31,2,30.0
ECU-005579,2122,16,6,10,1,16.0
ECU-005580,2122,609,313,296,23,26.47826086956522
ECU-005581,2122,34,10,24,1,34.0
ECU-005582,2122,8,6,2,1,8.0
ECU-005583,2122,15,7,8,1,15.0
ECU-005584,2122,9,6,3,1,9.0
ECU-005585,2122,197,78,119,12,16.416666666666668
ECU-005586,2122,13,5,8,1,13.0
ECU-005587,2122,24,10,14,1,24.0
ECU-005588,2122,11,7,4,1,11.0
ECU-005589,2122,7,3,4,1,7.0
ECU-005590,2122,4,3,1,1,4.0
ECU-005591,2122,14,9,5,1,14.0
ECU-005592,2122,554,260,294,33,16.78787878787879
ECU-005593,2122,29,17,12,2,14.5
ECU-005594,2122,898,446,452,41,21.902439024390244
ECU-005595,2122,7,1,6,1,7.0
ECU-005596,2122,14,6,8,1,14.0
ECU-005597,2122,9,4,5,1,9.0
ECU-005598,2122,5,5,0,1,5.0
ECU-005599,2122,13,7,6,1,13.0
ECU-005600,2122,532,289,243,21,25.333333333333332
ECU-005601,2122,288,137,151,16,18.0
ECU-005602,2122,54,24,30,3,18.0
ECU-005603,2122,175,84,91,14,12.5
ECU-005604,2122,43,19,24,2,21.5
ECU-005605,2122,113,61,52,6,18.833333333333332
ECU-005606,2122,57,39,18,2,28.5
ECU-005607,2122,519,256,263,26,19.96153846153846
ECU-005608,2122,70,28,42,3,23.333333333333332
ECU-005609,2122,37,16,21,3,12.333333333333334
ECU-005610,2122,45,25,20,2,22.5
ECU-005611,2122,44,20,24,2,22.0
ECU-005612,2122,52,35,17,3,17.333333333333332
ECU-005613,2122,288,129,159,18,16.0
ECU-005614,2122,71,35,36,3,23.666666666666668
ECU-005615,2122,112,53,59,8,14.0
ECU-005616,2122,234,120,114,8,29.25
ECU-005617,2122,37,22,15,2,18.5
ECU-005618,2122,298,124,174,19,15.68421052631579
ECU-005619,2122,576,263,313,24,24.0
ECU-005620,2122,796,396,400,40,19.9
ECU-005621,2122,991,494,497,46,21.543478260869566
ECU-005622,2122,352,166,186,19,18.526315789473685
ECU-005623,2122,688,393,295,35,19.65714285714286
ECU-005624,2122,947,445,502,42,22.547619047619047
ECU-005625,2122,1032,491,541,48,21.5
ECU-005626,2122,505,246,259,27,18.703703703703702
ECU-005627,2122,334,158,176,19,17.57894736842105
ECU-005628,2122,324,163,161,17,19.058823529411764
ECU-005629,2122,189,107,82,10,18.9
ECU-005630,2122,232,109,123,10,23.2
ECU-005631,2122,12,4,8,1,12.0
ECU-005632,2122,1495,764,731,90,16.61111111111111
ECU-005633,2122,259,120,139,11,23.545454545454547
ECU-005634,2122,11,3,8,1,11.0
ECU-005635,2122,808,423,385,29,27.862068965517242
ECU-005636,2122,37,23,14,2,18.5
ECU-005637,2122,15,8,7,1,15.0
ECU-005638,2122,15,3,12,1,15.0
ECU-005639,2122,80,39,41,3,26.666666666666668
ECU-005640,2122,12,6,6,1,12.0
ECU-005641,2122,47,19,28,2,23.5
ECU-005642,2122,10,6,4,1,10.0
ECU-005643,2122,17,9,8,1,17.0
ECU-005644,2122,9,7,2,1,9.0
ECU-005645,2122,7,2,5,1,7.0
ECU-005646,2122,23,14,9,1,23.0
ECU-005647,2122,11,7,4,1,11.0
ECU-005648,2122,69,34,35,3,23.0
ECU-005649,2122,23,6,17,1,23.0
ECU-005650,2122,34,22,12,2,17.0
ECU-005651,2122,22,11,11,1,22.0
ECU-005652,2122,397,182,215,20,19.85
ECU-005653,2122,19,9,10,1,19.0
ECU-005654,2122,26,11,15,1,26.0
ECU-005655,2122,189,88,101,9,21.0
ECU-005656,2122,91,51,40,5,18.2
ECU-005657,2122,24,7,17,2,12.0
ECU-005658,2122,16,6,10,1,16.0
ECU-005659,2122,20,8,12,1,20.0
ECU-005660,2122,12,5,7,1,12.0
ECU-005661,2122,53,28,25,2,26.5
ECU-005662,2122,97,48,49,5,19.4
ECU-005663,2122,13,6,7,1,13.0
ECU-005664,2122,21,12,9,1,21.0
ECU-005665,2122,183,97,86,10,18.3
ECU-005666,2122,115,59,56,5,23.0
ECU-005667,2122,61,25,36,5,12.2
ECU-005668,2122,25,13,12,1,25.0
ECU-005669,2122,134,66,68,6,22.333333333333332
ECU-005670,2122,16,4,12,1,16.0
ECU-005671,2122,467,220,247,22,21.227272727272727
ECU-005672,2122,90,47,43,3,30.0
ECU-005673,2122,13,8,5,1,13.0
ECU-005674,2122,13,5,8,1,13.0
ECU-005675,2122,14,5,9,1,14.0
ECU-005676,2122,19,8,11,1,19.0
ECU-005677,2122,21,14,7,1,21.0
ECU-005678,2122,36,17,19,1,36.0
ECU-005679,2122,206,101,105,12,17.166666666666668
ECU-005680,2122,32,16,16,3,10.666666666666666
ECU-005681,2122,26,16,10,3,8.666666666666666
ECU-005682,2122,29,16,13,1,29.0
ECU-005683,2122,29,21,8,1,29.0
ECU-005684,2122,12,6,6,1,12.0
ECU-005685,2122,16,10,6,1,16.0
ECU-005686,2122,9,7,2,1,9.0
ECU-005687,2122,16,5,11,1,16.0
ECU-005688,2122,18,8,10,1,18.0
ECU-005689,2122,17,7,10,1,17.0
ECU-005690,2122,97,50,47,5,19.4
ECU-005691,2122,22,8,14,1,22.0
ECU-005692,2122,15,10,5,1,15.0
ECU-005693,2122,193,97,96,11,17.545454545454547
ECU-005694,2122,19,6,13,1,19.0
ECU-005695,2122,178,95,83,14,12.714285714285714
ECU-005696,2122,35,15,20,2,17.5
ECU-005697,2122,36,16,20,2,18.0
ECU-005698,2122,52,25,27,2,26.0
ECU-005699,2122,41,14,27,2,20.5
ECU-005700,2122,4,2,2,1,4.0
ECU-005701,2122,22,11,11,1,22.0
ECU-005702,2122,21,9,12,1,21.0
ECU-005703,2122,22,9,13,1,22.0
ECU-005704,2122,8,4,4,1,8.0
ECU-005705,2122,25,12,13,1,25.0
ECU-005706,2122,29,19,10,1,29.0
ECU-005707,2122,27,16,11,1,27.0
ECU-005708,2122,40,17,23,2,20.0
ECU-005709,2122,21,11,10,1,21.0
ECU-005710,2122,21,12,9,1,21.0
ECU-005711,2122,420,212,208,13,32.30769230769231
ECU-005712,2122,16,7,9,1,16.0
ECU-005713,2122,36,17,19,2,18.0
ECU-005714,2122,30,16,14,1,30.0
ECU-005715,2122,7,3,4,1,7.0
ECU-005716,2122,7,2,5,1,7.0
ECU-005717,2122,27,18,9,1,27.0
ECU-005718,2122,85,40,45,3,28.333333333333332
ECU-005719,2122,5,3,2,1,5.0
ECU-005720,2122,20,11,9,1,20.0
ECU-005721,2122,137,73,64,10,13.7
ECU-005722,2122,18,11,7,1,18.0
ECU-005723,2122,62,35,27,2,31.0
ECU-005724,2122,28,12,16,1,28.0
ECU-005725,2122,43,23,20,2,21.5
ECU-005726,2122,8,3,5,1,8.0
ECU-005727,2122,16,7,9,1,16.0
ECU-005728,2122,286,147,139,13,22.0
ECU-005729,2122,12,7,5,1,12.0
ECU-005730,2122,20,7,13,1,20.0
ECU-005731,2122,23,11,12,1,23.0
ECU-005732,2122,17,9,8,1,17.0
ECU-005733,2122,12,6,6,1,12.0
ECU-005734,2122,7,4,3,1,7.0
ECU-005735,2122,39,19,20,2,19.5
ECU-005736,2122,12,6,6,1,12.0
ECU-005737,2122,20,10,10,2,10.0
ECU-005738,2122,42,16,26,2,21.0
ECU-005739,2122,26,17,9,1,26.0
ECU-005740,2122,59,28,31,4,14.75
ECU-005741,2122,153,74,79,7,21.857142857142858
ECU-005742,2122,64,31,33,3,21.333333333333332
ECU-005743,2122,5,3,2,1,5.0
ECU-005744,2122,520,259,261,22,23.636363636363637
ECU-005745,2122,27,10,17,1,27.0
ECU-005746,2122,58,30,28,2,29.0
ECU-005747,2122,425,234,191,19,22.36842105263158
ECU-005748,2122,191,97,94,18,10.61111111111111
ECU-005749,2122,292,156,136,17,17.176470588235293
ECU-005750,2122,1136,567,569,60,18.933333333333334
ECU-005751,2122,230,138,92,10,23.0
ECU-005752,2122,329,146,183,15,21.933333333333334
ECU-005753,2122,694,350,344,21,33.04761904761905
ECU-005754,2122,324,182,142,23,14.08695652173913
ECU-005755,2122,14,6,8,1,14.0
ECU-005756,2122,173,72,101,22,7.863636363636363
ECU-005757,2122,233,101,132,9,25.88888888888889
ECU-005758,2122,36,22,14,2,18.0
ECU-005759,2122,362,184,178,15,24.133333333333333
ECU-005760,2122,226,108,118,9,25.11111111111111
ECU-005761,2122,37,19,18,2,18.5
ECU-005762,2122,103,42,61,9,11.444444444444445
ECU-005763,2122,257,97,160,14,18.357142857142858
ECU-005764,2122,934,445,489,39,23.94871794871795
ECU-005765,2122,65,28,37,2,32.5
ECU-005766,2122,45,24,21,2,22.5
ECU-005767,2122,86,43,43,3,28.666666666666668
ECU-005768,2122,90,43,47,7,12.857142857142858
ECU-005769,2122,143,73,70,6,23.833333333333332
ECU-005770,2122,17,6,11,1,17.0
ECU-005771,2122,67,31,36,2,33.5
ECU-005772,2122,66,35,31,2,33.0
ECU-005773,2122,31,17,14,1,31.0
ECU-005774,2122,11,3,8,1,11.0
ECU-005775,2122,53,27,26,2,26.5
ECU-005776,2122,357,163,194,16,22.3125
ECU-005777,2122,27,16,11,2,13.5
ECU-005778,2122,288,132,156,16,18.0
ECU-005779,2122,14,10,4,1,14.0
ECU-005780,2122,232,112,120,13,17.846153846153847
ECU-005781,2122,718,475,243,39,18.41025641025641
ECU-005782,2122,209,98,111,12,17.416666666666668
ECU-005783,2122,291,148,143,11,26.454545454545453
ECU-005784,2122,36,20,16,1,36.0
ECU-005785,2122,1007,474,533,44,22.886363636363637
ECU-005786,2122,559,267,292,23,24.304347826086957
ECU-005787,2122,1474,769,705,61,24.16393442622951
ECU-005788,2122,6,2,4,1,6.0
ECU-005789,2122,13,7,6,1,13.0
ECU-005790,2122,11,6,5,1,11.0
ECU-005791,2122,35,15,20,2,17.5
ECU-005792,2122,307,159,148,8,38.375
ECU-005793,2122,8,5,3,1,8.0
ECU-005794,2122,22,9,13,1,22.0
ECU-005795,2122,7,4,3,1,7.0
ECU-005796,2122,18,8,10,1,18.0
ECU-005797,2122,134,62,72,5,26.8
ECU-005798,2122,16,11,5,1,16.0
ECU-005799,2122,17,8,9,1,17.0
ECU-005800,2122,700,331,369,24,29.166666666666668
ECU-005801,2122,9,5,4,1,9.0
ECU-005802,2122,16,6,10,1,16.0
ECU-005803,2122,37,12,25,2,18.5
ECU-005804,2122,42,20,22,2,21.0
ECU-005805,2122,9,5,4,1,9.0
ECU-005806,2122,21,14,7,1,21.0
ECU-005807,2122,11,6,5,1,11.0
ECU-005808,2122,20,9,11,1,20.0
ECU-005809,2122,9,6,3,1,9.0
ECU-005810,2122,3,3,0,1,3.0
ECU-005811,2122,7,6,1,1,7.0
ECU-005812,2122,34,20,14,2,17.0
ECU-005813,2122,18,6,12,1,18.0
ECU-005814,2122,25,15,10,1,25.0
ECU-005815,2122,22,16,6,1,22.0
ECU-005816,2122,6,2,4,1,6.0
ECU-005817,2122,19,13,6,1,19.0
ECU-005818,2122,49,23,26,2,24.5
ECU-005819,2122,8,4,4,1,8.0
ECU-005820,2122,34,16,18,1,34.0
ECU-005821,2122,56,30,26,2,28.0
ECU-005822,2122,32,14,18,2,16.0
ECU-005823,2122,30,11,19,1,30.0
ECU-005824,2122,13,6,7,1,13.0
ECU-005825,2122,47,27,20,2,23.5
ECU-005826,2122,18,10,8,1,18.0
ECU-005827,2122,22,8,14,1,22.0
ECU-005828,2122,15,7,8,1,15.0
ECU-005829,2122,51,31,20,2,25.5
ECU-005830,2122,45,22,23,2,22.5
ECU-005831,2122,19,8,11,1,19.0
ECU-005832,2122,31,15,16,1,31.0
ECU-005833,2122,13,9,4,2,6.5
ECU-005834,2122,74,37,37,3,24.666666666666668
ECU-005835,2122,111,48,63,10,11.1
ECU-005836,2122,41,13,28,2,20.5
ECU-005837,2122,54,28,26,2,27.0
ECU-005838,2122,142,79,63,12,11.833333333333334
ECU-005839,2122,67,28,39,3,22.333333333333332
ECU-005840,2122,8,5,3,1,8.0
ECU-005841,2122,35,21,14,2,17.5
ECU-005842,2122,111,54,57,4,27.75
ECU-005843,2122,11,3,8,1,11.0
ECU-005844,2122,309,147,162,17,18.176470588235293
ECU-005845,2122,117,59,58,4,29.25
ECU-005846,2122,109,53,56,5,21.8
ECU-005847,2122,717,360,357,26,27.576923076923077
ECU-005848,2122,306,154,152,18,17.0
ECU-005849,2122,263,125,138,17,15.470588235294118
ECU-005850,2122,338,167,171,16,21.125
ECU-005851,2122,148,75,73,4,37.0
ECU-005852,2122,1179,558,621,43,27.41860465116279
ECU-005853,2122,974,491,483,35,27.82857142857143
ECU-005854,2122,613,320,293,22,27.863636363636363
ECU-005855,2122,401,221,180,16,25.0625
ECU-005856,2122,680,338,342,34,20.0
ECU-005857,2122,760,327,433,48,15.833333333333334
ECU-005858,2122,202,98,104,16,12.625
ECU-005859,2122,265,124,141,18,14.722222222222221
ECU-005860,2122,209,105,104,13,16.076923076923077
ECU-005861,2122,18,9,9,1,18.0
ECU-005862,2122,9,7,2,1,9.0
ECU-005863,2122,75,33,42,4,18.75
ECU-005864,2122,91,50,41,4,22.75
ECU-005865,2122,56,28,28,3,18.666666666666668
ECU-005866,2122,445,224,221,15,29.666666666666668
ECU-005867,2122,174,85,89,10,17.4
ECU-005868,2122,11,8,3,1,11.0
ECU-005869,2122,131,61,70,8,16.375
ECU-005870,2122,404,206,198,16,25.25
ECU-005871,2122,130,62,68,8,16.25
ECU-005872,2122,30,18,12,2,15.0
ECU-005873,2122,10,5,5,1,10.0
ECU-005874,2122,10,4,6,1,10.0
ECU-005875,2122,1035,490,545,60,17.25
ECU-005876,2122,29,12,17,1,29.0
ECU-005877,2122,21,7,14,1,21.0
ECU-005878,2122,4,2,2,1,4.0
ECU-005879,2122,15,8,7,1,15.0
ECU-005880,2122,7,2,5,1,7.0
ECU-005881,2122,12,4,8,1,12.0
ECU-005882,2122,37,12,25,2,18.5
ECU-005883,2122,12,6,6,1,12.0
ECU-005884,2122,11,8,3,1,11.0
ECU-005885,2122,29,14,15,3,9.666666666666666
ECU-005886,2122,60,33,27,3,20.0
ECU-005887,2122,12,7,5,1,12.0
ECU-005888,2122,290,141,149,15,19.333333333333332
ECU-005889,2122,88,41,47,3,29.333333333333332
ECU-005890,2122,142,65,77,8,17.75
ECU-005891,2122,27,15,12,1,27.0
ECU-005892,2122,8,4,4,1,8.0
ECU-005893,2122,19,12,7,1,19.0
ECU-005894,2122,91,45,46,3,30.333333333333332
ECU-005895,2122,31,16,15,1,31.0
ECU-005896,2122,254,126,128,14,18.142857142857142
ECU-005897,2122,22,11,11,1,22.0
ECU-005898,2122,37,19,18,2,18.5
ECU-005899,2122,19,9,10,1,19.0
ECU-005900,2122,39,20,19,2,19.5
ECU-005901,2122,15,6,9,1,15.0
ECU-005902,2122,3,3,0,1,3.0
ECU-005903,2122,168,86,82,6,28.0
ECU-005904,2122,15,9,6,1,15.0
ECU-005905,2122,15,10,5,1,15.0
ECU-005906,2122,7,4,3,1,7.0
ECU-005907,2122,12,9,3,7,1.7142857142857142
ECU-005908,2122,280,125,155,18,15.555555555555555
ECU-005909,2122,24,14,10,1,24.0
ECU-005910,2122,14,7,7,1,14.0
ECU-005911,2122,124,73,51,5,24.8
ECU-005912,2122,329,151,178,21,15.666666666666666
ECU-005913,2122,34,18,16,2,17.0
ECU-005914,2122,4,4,0,1,4.0
ECU-005915,2122,15,3,12,1,15.0
ECU-005916,2122,215,105,110,10,21.5
ECU-005917,2122,15,6,9,1,15.0
ECU-005918,2122,34,20,14,2,17.0
ECU-005919,2122,31,15,16,1,31.0
ECU-005920,2122,16,7,9,1,16.0
ECU-005921,2122,21,6,15,1,21.0
ECU-005922,2122,16,4,12,1,16.0
ECU-005923,2122,14,2,12,1,14.0
ECU-005924,2122,7,1,6,1,7.0
ECU-005925,2122,10,9,1,1,10.0
ECU-005926,2122,25,15,10,1,25.0
ECU-005927,2122,69,38,31,3,23.0
ECU-005928,2122,14,7,7,1,14.0
ECU-005929,2122,15,10,5,1,15.0
ECU-005930,2122,16,8,8,1,16.0
ECU-005931,2122,17,7,10,1,17.0
ECU-005932,2122,31,16,15,2,15.5
ECU-005933,2122,10,4,6,1,10.0
ECU-005934,2122,10,3,7,1,10.0
ECU-005935,2122,202,86,116,13,15.538461538461538
ECU-005936,2122,27,15,12,1,27.0
ECU-005937,2122,33,18,15,1,33.0
ECU-005938,2122,31,14,17,1,31.0
ECU-005939,2122,27,12,15,1,27.0
ECU-005940,2122,257,142,115,19,13.526315789473685
ECU-005941,2122,613,306,307,24,25.541666666666668
ECU-005942,2122,46,25,21,1,46.0
ECU-005943,2122,100,52,48,12,8.333333333333334
ECU-005944,2122,523,270,253,22,23.772727272727273
ECU-005945,2122,24,11,13,1,24.0
ECU-005946,2122,28,11,17,1,28.0
ECU-005947,2122,81,45,36,8,10.125
ECU-005948,2122,454,200,254,17,26.705882352941178
ECU-005949,2122,29,10,19,1,29.0
ECU-005950,2122,152,80,72,14,10.857142857142858
ECU-005951,2122,15,5,10,1,15.0
ECU-005952,2122,305,155,150,13,23.46153846153846
ECU-005953,2122,1161,579,582,42,27.642857142857142
ECU-005954,2122,1937,964,973,78,24.833333333333332
ECU-005955,2122,829,387,442,29,28.586206896551722
ECU-005956,2122,343,165,178,17,20.176470588235293
ECU-005957,2122,171,80,91,12,14.25
ECU-005958,2122,64,40,24,2,32.0
ECU-005959,2122,18,8,10,1,18.0
ECU-005960,2122,63,28,35,3,21.0
ECU-005961,2122,27,14,13,1,27.0
ECU-005962,2122,17,9,8,1,17.0
ECU-005963,2122,123,71,52,8,15.375
ECU-005964,2122,13,4,9,1,13.0
ECU-005965,2122,113,64,49,4,28.25
ECU-005966,2122,17,9,8,1,17.0
ECU-005967,2122,87,41,46,3,29.0
ECU-005968,2122,45,18,27,2,22.5
ECU-005969,2122,95,47,48,5,19.0
ECU-005970,2122,32,14,18,1,32.0
ECU-005971,2122,15,7,8,1,15.0
ECU-005972,2122,1414,683,731,56,25.25
ECU-005973,2122,149,81,68,4,37.25
ECU-005974,2122,379,188,191,13,29.153846153846153
ECU-005975,2122,101,56,45,3,33.666666666666664
ECU-005976,2122,24,14,10,1,24.0
ECU-005977,2122,323,156,167,12,26.916666666666668
ECU-005978,2122,78,38,40,2,39.0
ECU-005979,2122,40,21,19,2,20.0
ECU-005980,2122,346,165,181,13,26.615384615384617
ECU-005981,2122,45,20,25,2,22.5
ECU-005982,2122,194,101,93,9,21.555555555555557
ECU-005983,2122,83,42,41,3,27.666666666666668
ECU-005984,2122,20,6,14,1,20.0
ECU-005985,2122,71,28,43,5,14.2
ECU-005986,2122,81,30,51,3,27.0
ECU-005987,2122,150,79,71,6,25.0
ECU-005988,2122,20,6,14,1,20.0
ECU-005989,2122,367,177,190,18,20.38888888888889
ECU-005990,2122,48,23,25,2,24.0
ECU-005991,2122,25,15,10,1,25.0
ECU-005992,2122,21,12,9,1,21.0
ECU-005993,2122,33,14,19,1,33.0
ECU-005994,2122,9,2,7,1,9.0
ECU-005995,2122,651,307,344,21,31.0
ECU-005996,2122,17,11,6,1,17.0
ECU-005997,2122,15,4,11,1,15.0
ECU-005998,2122,45,19,26,2,22.5
ECU-005999,2122,25,12,13,1,25.0
ECU-006000,2122,8,7,1,1,8.0
ECU-006001,2122,16,12,4,1,16.0
ECU-006002,2122,25,14,11,1,25.0
ECU-006003,2122,16,11,5,1,16.0
ECU-006004,2122,77,46,31,6,12.833333333333334
ECU-006005,2122,4,2,2,1,4.0
ECU-006006,2122,12,7,5,1,12.0
ECU-006007,2122,8,4,4,1,8.0
ECU-006008,2122,21,8,13,1,21.0
ECU-006009,2122,19,11,8,1,19.0
ECU-006010,2122,16,10,6,1,16.0
ECU-006011,2122,8,7,1,1,8.0
ECU-006012,2122,30,16,14,2,15.0
ECU-006013,2122,14,6,8,1,14.0
ECU-006014,2122,522,259,263,22,23.727272727272727
ECU-006015,2122,9,3,6,1,9.0
ECU-006016,2122,65,30,35,2,32.5
ECU-006017,2122,485,253,232,20,24.25
ECU-006018,2122,33,14,19,1,33.0
ECU-006019,2122,13,4,9,1,13.0
ECU-006020,2122,23,13,10,1,23.0
ECU-006021,2122,21,10,11,1,21.0
ECU-006022,2122,9,4,5,1,9.0
ECU-006023,2122,47,21,26,2,23.5
ECU-006024,2122,12,6,6,1,12.0
ECU-006025,2122,7,7,0,1,7.0
ECU-006026,2122,78,35,43,3,26.0
ECU-006027,2122,27,8,19,1,27.0
ECU-006028,2122,24,5,19,1,24.0
ECU-006029,2122,186,81,105,9,20.666666666666668
ECU-006030,2122,13,6,7,1,13.0
ECU-006031,2122,72,34,38,3,24.0
ECU-006032,2122,33,18,15,2,16.5
ECU-006033,2122,21,10,11,1,21.0
ECU-006034,2122,49,18,31,2,24.5
ECU-006035,2122,49,24,25,2,24.5
ECU-006036,2122,41,20,21,2,20.5
ECU-006037,2122,862,440,422,40,21.55
ECU-006038,2122,577,255,322,26,22.192307692307693
ECU-006039,2122,251,132,119,9,27.88888888888889
ECU-006040,2122,18,13,5,1,18.0
ECU-006041,2122,22,9,13,1,22.0
ECU-006042,2122,13,8,5,1,13.0
ECU-006043,2122,14,9,5,1,14.0
ECU-006044,2122,57,27,30,3,19.0
ECU-006045,2122,25,14,11,1,25.0
ECU-006046,2122,27,14,13,1,27.0
ECU-006047,2122,28,17,11,1,28.0
ECU-006048,2122,12,4,8,1,12.0
ECU-006049,2122,52,24,28,2,26.0
ECU-006050,2122,8,5,3,1,8.0
ECU-006051,2122,19,8,11,1,19.0
ECU-006052,2122,17,8,9,1,17.0
ECU-006053,2122,21,11,10,1,21.0
ECU-006054,2122,6,2,4,1,6.0
ECU-006055,2122,54,31,23,2,27.0
ECU-006056,2122,8,4,4,1,8.0
ECU-006057,2122,10,3,7,1,10.0
ECU-006058,2122,15,7,8,1,15.0
ECU-006059,2122,10,6,4,1,10.0
ECU-006060,2122,73,41,32,3,24.333333333333332
ECU-006061,2122,17,9,8,1,17.0
ECU-006062,2122,23,11,12,1,23.0
ECU-006063,2122,12,8,4,1,12.0
ECU-006064,2122,34,17,17,2,17.0
ECU-006065,2122,13,9,4,1,13.0
ECU-006066,2122,8,6,2,1,8.0
ECU-006067,2122,54,20,34,3,18.0
ECU-006068,2122,20,6,14,1,20.0
ECU-006069,2122,56,23,33,2,28.0
ECU-006070,2122,29,17,12,1,29.0
ECU-006071,2122,81,40,41,9,9.0
ECU-006072,2122,390,176,214,17,22.941176470588236
ECU-006073,2122,211,97,114,12,17.583333333333332
ECU-006074,2122,959,481,478,47,20.404255319148938
ECU-006075,2122,34,18,16,2,17.0
ECU-006076,2122,14,8,6,1,14.0
ECU-006077,2122,39,15,24,3,13.0
ECU-006078,2122,1147,572,575,42,27.30952380952381
ECU-006079,2122,74,40,34,9,8.222222222222221
ECU-006080,2122,255,128,127,9,28.333333333333332
ECU-006081,2122,9,4,5,1,9.0
ECU-006082,2122,324,158,166,14,23.142857142857142
ECU-006083,2122,45,28,17,3,15.0
ECU-006084,2122,734,358,376,32,22.9375
ECU-006085,2122,69,36,33,5,13.8
ECU-006086,2122,13,6,7,1,13.0
ECU-006087,2122,85,36,49,3,28.333333333333332
ECU-006088,2122,483,242,241,20,24.15
ECU-006089,2122,11,7,4,1,11.0
ECU-006090,2122,97,48,49,4,24.25
ECU-006091,2122,405,199,206,20,20.25
ECU-006092,2122,12,7,5,1,12.0
ECU-006093,2122,46,23,23,2,23.0
ECU-006094,2122,203,83,120,11,18.454545454545453
ECU-006095,2122,35,11,24,1,35.0
ECU-006096,2122,6,2,4,1,6.0
ECU-006097,2122,249,128,121,14,17.785714285714285
ECU-006098,2122,403,188,215,19,21.210526315789473
ECU-006099,2122,9,4,5,1,9.0
ECU-006100,2122,1836,916,920,66,27.818181818181817
ECU-006101,2122,505,254,251,22,22.954545454545453
ECU-006102,2122,23,5,18,1,23.0
ECU-006103,2122,9,4,5,1,9.0
ECU-006104,2122,64,36,28,3,21.333333333333332
ECU-006105,2122,9,5,4,1,9.0
ECU-006106,2122,16,8,8,1,16.0
ECU-006107,2122,18,10,8,1,18.0
ECU-006108,2122,13,6,7,1,13.0
ECU-006109,2122,3,1,2,1,3.0
ECU-006110,2122,27,12,15,1,27.0
ECU-006111,2122,13,10,3,1,13.0
ECU-006112,2122,11,7,4,1,11.0
ECU-006113,2122,18,6,12,1,18.0
ECU-006114,2122,24,12,12,1,24.0
ECU-006115,2122,149,73,76,7,21.285714285714285
ECU-006116,2122,57,23,34,3,19.0
ECU-006117,2122,20,6,14,1,20.0
ECU-006118,2122,86,34,52,2,43.0
ECU-006119,2122,14,6,8,1,14.0
ECU-006120,2122,10,1,9,1,10.0
ECU-006121,2122,20,9,11,1,20.0
ECU-006122,2122,21,10,11,1,21.0
ECU-006123,2122,7,3,4,1,7.0
ECU-006124,2122,4,1,3,1,4.0
ECU-006125,2122,19,12,7,1,19.0
ECU-006126,2122,19,10,9,1,19.0
ECU-006127,2122,89,45,44,9,9.88888888888889
ECU-006128,2122,16,8,8,1,16.0
ECU-006129,2122,1623,803,820,48,33.8125
ECU-006130,2122,161,86,75,9,17.88888888888889
ECU-006131,2122,1868,894,974,67,27.880597014925375
ECU-006132,2122,103,46,57,9,11.444444444444445
ECU-006133,2122,74,38,36,4,18.5
ECU-006134,2122,234,117,117,17,13.764705882352942
ECU-006135,2122,37,18,19,6,6.166666666666667
ECU-006136,2122,17,7,10,1,17.0
ECU-006137,2122,6,5,1,1,6.0
ECU-006138,2122,12,6,6,1,12.0
ECU-006139,2122,8,3,5,1,8.0
ECU-006140,2122,123,59,64,7,17.571428571428573
ECU-006141,2122,107,47,60,4,26.75
ECU-006142,2122,556,254,302,17,32.705882352941174
ECU-006143,2122,1793,914,879,86,20.848837209302324
ECU-006144,2122,6,3,3,1,6.0
ECU-006145,2122,346,171,175,18,19.22222222222222
ECU-006146,2122,7,3,4,1,7.0
ECU-006147,2122,14,4,10,1,14.0
ECU-006148,2122,14,5,9,1,14.0
ECU-006149,2122,15,8,7,1,15.0
ECU-006150,2122,26,9,17,1,26.0
ECU-006151,2122,47,26,21,2,23.5
ECU-006152,2122,324,177,147,15,21.6
ECU-006153,2122,14,7,7,1,14.0
ECU-006154,2122,40,19,21,2,20.0
ECU-006155,2122,876,431,445,38,23.05263157894737
ECU-006156,2122,22,8,14,1,22.0
ECU-006157,2122,90,47,43,3,30.0
ECU-006158,2122,21,10,11,1,21.0
ECU-006159,2122,9,5,4,1,9.0
ECU-006160,2122,13,5,8,1,13.0
ECU-006161,2122,14,7,7,1,14.0
ECU-006162,2122,8,6,2,1,8.0
ECU-006163,2122,10,5,5,1,10.0
ECU-006164,2122,59,27,32,3,19.666666666666668
ECU-006165,2122,13,2,11,1,13.0
ECU-006166,2122,11,5,6,1,11.0
ECU-006167,2122,6,4,2,1,6.0
ECU-006168,2122,10,4,6,1,10.0
ECU-006169,2122,34,16,18,2,17.0
ECU-006170,2122,67,34,33,2,33.5
ECU-006171,2122,29,18,11,1,29.0
ECU-006172,2122,15,8,7,1,15.0
ECU-006173,2122,107,55,52,3,35.666666666666664
ECU-006174,2122,24,12,12,1,24.0
ECU-006175,2122,17,9,8,1,17.0
ECU-006176,2122,12,6,6,1,12.0
ECU-006177,2122,25,8,17,8,3.125
ECU-006178,2122,23,9,14,1,23.0
ECU-006179,2122,9,3,6,1,9.0
ECU-006180,2122,142,65,77,9,15.777777777777779
ECU-006181,2122,6,4,2,1,6.0
ECU-006182,2122,5,4,1,1,5.0
ECU-006183,2122,5,2,3,1,5.0
ECU-006184,2122,12,9,3,1,12.0
ECU-006185,2122,12,7,5,1,12.0
ECU-006186,2122,8,2,6,1,8.0
ECU-006187,2122,18,11,7,1,18.0
ECU-006188,2122,32,12,20,1,32.0
ECU-006189,2122,19,9,10,1,19.0
ECU-006190,2122,8,5,3,1,8.0
ECU-006191,2122,22,13,9,1,22.0
ECU-006192,2122,17,6,11,1,17.0
ECU-006193,2122,41,19,22,2,20.5
ECU-006194,2122,2330,1143,1187,75,31.066666666666666
ECU-006195,2122,17,8,9,1,17.0
ECU-006196,2122,75,39,36,5,15.0
ECU-006197,2122,56,29,27,3,18.666666666666668
ECU-006198,2122,254,136,118,17,14.941176470588236
ECU-006199,2122,30,13,17,2,15.0
ECU-006200,2122,9,0,9,1,9.0
ECU-006201,2122,22,13,9,1,22.0
ECU-006202,2122,17,10,7,1,17.0
ECU-006203,2122,25,17,8,1,25.0
ECU-006204,2122,28,20,8,1,28.0
ECU-006205,2122,7,4,3,1,7.0
ECU-006206,2122,15,8,7,1,15.0
ECU-006207,2122,22,10,12,1,22.0
ECU-006208,2122,37,23,14,1,37.0
ECU-006209,2122,20,7,13,1,20.0
ECU-006210,2122,46,18,28,4,11.5
ECU-006211,2122,11,3,8,1,11.0
ECU-006212,2122,32,14,18,1,32.0
ECU-006213,2122,9,4,5,1,9.0
ECU-006214,2122,5,1,4,1,5.0
ECU-006215,2122,14,6,8,1,14.0
ECU-006216,2122,14,6,8,1,14.0
ECU-006217,2122,34,17,17,3,11.333333333333334
ECU-006218,2122,195,99,96,9,21.666666666666668
ECU-006219,2122,30,14,16,1,30.0
ECU-006220,2122,19,7,12,1,19.0
ECU-006221,2122,3,1,2,1,3.0
ECU-006222,2122,14,6,8,1,14.0
ECU-006223,2122,2520,1268,1252,86,29.302325581395348
ECU-006224,2122,177,92,85,14,12.642857142857142
ECU-006225,2122,113,59,54,7,16.142857142857142
ECU-006226,2122,13,5,8,2,6.5
ECU-006227,2122,9,3,6,1,9.0
ECU-006228,2122,110,58,52,7,15.714285714285714
ECU-006229,2122,1850,938,912,85,21.764705882352942
ECU-006230,2122,255,121,134,11,23.181818181818183
ECU-006231,2122,2038,1015,1023,72,28.305555555555557
ECU-006232,2122,13,6,7,1,13.0
ECU-006233,2122,230,108,122,9,25.555555555555557
ECU-006234,2122,13,6,7,1,13.0
ECU-006235,2122,203,103,100,8,25.375
ECU-006236,2122,49,26,23,2,24.5
ECU-006237,2122,22,12,10,2,11.0
ECU-006238,2122,8,4,4,1,8.0
ECU-006239,2122,48,25,23,4,12.0
ECU-006240,2122,6,4,2,1,6.0
ECU-006241,2122,200,99,101,9,22.22222222222222
ECU-006242,2122,12,5,7,1,12.0
ECU-006243,2122,13,7,6,1,13.0
ECU-006244,2122,45,26,19,2,22.5
ECU-006245,2122,136,62,74,11,12.363636363636363
ECU-006246,2122,884,466,418,48,18.416666666666668
ECU-006247,2122,15,10,5,1,15.0
ECU-006248,2122,16,9,7,1,16.0
ECU-006249,2122,334,180,154,19,17.57894736842105
ECU-006250,2122,13,5,8,1,13.0
ECU-006251,2122,65,26,39,6,10.833333333333334
ECU-006252,2122,205,94,111,15,13.666666666666666
ECU-006253,2122,10,7,3,1,10.0
ECU-006254,2122,19,7,12,1,19.0
ECU-006255,2122,54,20,34,5,10.8
ECU-006256,2122,13,5,8,1,13.0
ECU-006257,2122,9,5,4,1,9.0
ECU-006258,2122,13,4,9,1,13.0
ECU-006259,2122,7,2,5,1,7.0
ECU-006260,2122,14,5,9,1,14.0
ECU-006261,2122,156,71,85,10,15.6
ECU-006262,2122,45,30,15,2,22.5
ECU-006263,2122,51,27,24,3,17.0
ECU-006264,2122,28,13,15,1,28.0
ECU-006265,2122,23,9,14,1,23.0
ECU-006266,2122,6,3,3,1,6.0
ECU-006267,2122,14,5,9,1,14.0
ECU-006268,2122,11,4,7,1,11.0
ECU-006269,2122,12,6,6,1,12.0
ECU-006270,2122,169,88,81,10,16.9
ECU-006271,2122,12,6,6,1,12.0
ECU-006272,2122,19,13,6,1,19.0
ECU-006273,2122,8,4,4,1,8.0
ECU-006274,2122,47,26,21,4,11.75
ECU-006275,2122,14,6,8,1,14.0
ECU-006276,2122,20,13,7,1,20.0
ECU-006277,2122,29,8,21,1,29.0
ECU-006278,2122,80,43,37,9,8.88888888888889
ECU-006279,2122,48,22,26,5,9.6
ECU-006280,2122,5,2,3,1,5.0
ECU-006281,2122,4,1,3,1,4.0
ECU-006282,2122,41,15,26,4,10.25
ECU-006283,2122,18,4,14,1,18.0
ECU-006284,2122,45,22,23,4,11.25
ECU-006285,2122,54,29,25,2,27.0
ECU-006286,2122,31,12,19,1,31.0
ECU-006287,2122,10,4,6,1,10.0
ECU-006288,2122,11,1,10,1,11.0
ECU-006289,2122,39,20,19,2,19.5
ECU-006290,2122,213,108,105,9,23.666666666666668
ECU-006291,2122,5,3,2,1,5.0
ECU-006292,2122,29,15,14,2,14.5
ECU-006293,2122,11,5,6,1,11.0
ECU-006294,2122,14,7,7,1,14.0
ECU-006295,2122,117,68,49,4,29.25
ECU-006296,2122,230,118,112,8,28.75
ECU-006297,2122,46,22,24,7,6.571428571428571
ECU-006298,2122,113,49,64,6,18.833333333333332
ECU-006299,2122,78,40,38,4,19.5
ECU-006300,2122,168,74,94,14,12.0
ECU-006301,2122,16,6,10,1,16.0
ECU-006302,2122,4,2,2,1,4.0
ECU-006303,2122,158,75,83,8,19.75
ECU-006304,2122,240,122,118,11,21.818181818181817
ECU-006305,2122,47,22,25,3,15.666666666666666
ECU-006306,2122,14,4,10,1,14.0
ECU-006307,2122,13,6,7,1,13.0
ECU-006308,2122,137,54,83,11,12.454545454545455
ECU-006309,2122,299,97,202,7,42.714285714285715
ECU-006310,2122,16,7,9,1,16.0
ECU-006311,2122,24,9,15,1,24.0
ECU-006312,2122,636,319,317,19,33.473684210526315
ECU-006313,2122,338,174,164,12,28.166666666666668
ECU-006314,2122,72,39,33,5,14.4
ECU-006315,2122,79,43,36,3,26.333333333333332
ECU-006316,2122,64,28,36,8,8.0
ECU-006317,2122,278,131,147,9,30.88888888888889
ECU-006318,2122,343,161,182,17,20.176470588235293
ECU-006319,2122,12,4,8,1,12.0
ECU-006320,2122,167,75,92,8,20.875
ECU-006321,2122,23,8,15,1,23.0
ECU-006322,2122,53,29,24,2,26.5
ECU-006323,2122,7,2,5,1,7.0
ECU-006324,2122,9,4,5,1,9.0
ECU-006325,2122,23,14,9,1,23.0
ECU-006326,2122,7,1,6,1,7.0
ECU-006327,2122,5,3,2,1,5.0
ECU-006328,2122,10,6,4,1,10.0
ECU-006329,2122,452,233,219,17,26.58823529411765
ECU-006330,2122,9,4,5,1,9.0
ECU-006331,2122,31,20,11,4,7.75
ECU-006332,2122,12,5,7,1,12.0
ECU-006333,2122,298,162,136,16,18.625
ECU-006334,2122,17,7,10,1,17.0
ECU-006335,2122,19,9,10,1,19.0
ECU-006336,2122,25,10,15,5,5.0
ECU-006337,2122,65,26,39,2,32.5
ECU-006338,2122,245,105,140,17,14.411764705882353
ECU-006339,2122,16,7,9,1,16.0
ECU-006340,2122,56,30,26,2,28.0
ECU-006341,2122,2,1,1,1,2.0
ECU-006342,2122,12,8,4,1,12.0
ECU-006343,2122,43,23,20,4,10.75
ECU-006344,2122,37,21,16,5,7.4
ECU-006345,2122,21,13,8,7,3.0
ECU-006346,2122,110,46,64,8,13.75
ECU-006347,2122,6,2,4,5,1.2
ECU-006348,2122,8,5,3,4,2.0
ECU-006349,2122,11,6,5,6,1.8333333333333333
ECU-006350,2122,21,15,6,4,5.25
ECU-006351,2122,5,2,3,3,1.6666666666666667
ECU-006352,2122,19,9,10,1,19.0
ECU-006353,2122,8,2,6,1,8.0
ECU-006354,2122,16,7,9,1,16.0
ECU-006355,2122,55,32,23,2,27.5
ECU-006356,2122,55,25,30,6,9.166666666666666
ECU-006357,2122,251,106,145,8,31.375
ECU-006358,2122,51,22,29,3,17.0
ECU-006359,2122,18,9,9,2,9.0
ECU-006360,2122,35,20,15,5,7.0
ECU-006361,2122,90,34,56,7,12.857142857142858
ECU-006362,2122,14,6,8,1,14.0
ECU-006363,2122,387,180,207,23,16.82608695652174
ECU-006364,2122,29,16,13,1,29.0
ECU-006365,2122,23,9,14,1,23.0
ECU-006366,2122,7,4,3,1,7.0
ECU-006367,2122,38,17,21,1,38.0
ECU-006368,2122,7,4,3,1,7.0
ECU-006369,2122,35,18,17,1,35.0
ECU-006370,2122,12,6,6,1,12.0
ECU-006371,2122,16,8,8,1,16.0
ECU-006372,2122,34,15,19,1,34.0
ECU-006373,2122,9,4,5,1,9.0
ECU-006374,2122,19,8,11,1,19.0
ECU-006375,2122,153,74,79,5,30.6
ECU-006376,2122,21,12,9,1,21.0
ECU-006377,2122,1175,643,532,58,20.25862068965517
ECU-006378,2122,97,51,46,5,19.4
ECU-006379,2122,73,39,34,2,36.5
ECU-006380,2122,55,28,27,2,27.5
ECU-006381,2122,48,20,28,2,24.0
ECU-006382,2122,19,10,9,2,9.5
ECU-006383,2122,367,183,184,11,33.36363636363637
ECU-006384,2122,16,7,9,2,8.0
ECU-006385,2122,1922,979,943,63,30.50793650793651
ECU-006386,2122,8,6,2,1,8.0
ECU-006387,2122,17,9,8,4,4.25
ECU-006388,2122,71,35,36,5,14.2
ECU-006389,2122,13,3,10,1,13.0
ECU-006390,2122,7,4,3,1,7.0
ECU-006391,2122,272,136,136,18,15.11111111111111
ECU-006392,2122,32,17,15,4,8.0
ECU-006393,2122,36,21,15,8,4.5
ECU-006394,2122,60,24,36,7,8.571428571428571
ECU-006395,2122,5,1,4,1,5.0
ECU-006396,2122,259,129,130,14,18.5
ECU-006397,2122,145,66,79,9,16.11111111111111
ECU-006398,2122,205,101,104,11,18.636363636363637
ECU-006399,2122,214,106,108,16,13.375
ECU-006400,2122,284,149,135,13,21.846153846153847
ECU-006401,2122,365,166,199,24,15.208333333333334
ECU-006402,2122,445,205,240,21,21.19047619047619
ECU-006403,2122,261,121,140,16,16.3125
ECU-006404,2122,556,280,276,24,23.166666666666668
ECU-006405,2122,522,249,273,25,20.88
ECU-006406,2122,234,110,124,16,14.625
ECU-006407,2122,789,402,387,30,26.3
ECU-006408,2122,864,414,450,46,18.782608695652176
ECU-006409,2122,593,288,305,31,19.129032258064516
ECU-006410,2122,391,190,201,21,18.61904761904762
ECU-006411,2122,568,260,308,24,23.666666666666668
ECU-006412,2122,299,140,159,18,16.61111111111111
ECU-006413,2122,218,105,113,11,19.818181818181817
ECU-006414,2122,242,117,125,9,26.88888888888889
ECU-006415,2122,186,113,73,9,20.666666666666668
ECU-006416,2122,174,76,98,14,12.428571428571429
ECU-006417,2122,395,194,201,20,19.75
ECU-006418,2122,691,343,348,26,26.576923076923077
ECU-006419,2122,703,353,350,34,20.676470588235293
ECU-006420,2122,513,242,271,22,23.318181818181817
ECU-006421,2122,326,166,160,15,21.733333333333334
ECU-006422,2122,299,145,154,18,16.61111111111111
ECU-006423,2122,242,125,117,18,13.444444444444445
ECU-006424,2122,241,115,126,14,17.214285714285715
ECU-006425,2122,402,184,218,18,22.333333333333332
ECU-006426,2122,612,278,334,26,23.53846153846154
ECU-006427,2122,347,158,189,14,24.785714285714285
ECU-006428,2122,119,56,63,7,17.0
ECU-006429,2122,456,225,231,22,20.727272727272727
ECU-006430,2122,1842,890,952,69,26.695652173913043
ECU-006431,2122,200,83,117,14,14.285714285714286
ECU-006432,2122,375,190,185,17,22.058823529411764
ECU-006433,2122,484,248,236,23,21.043478260869566
ECU-006434,2122,1850,995,855,74,25.0
ECU-006435,2122,961,440,521,50,19.22
ECU-006436,2122,636,310,326,28,22.714285714285715
ECU-006437,2122,653,335,318,26,25.115384615384617
ECU-006438,2122,287,113,174,10,28.7
ECU-006439,2122,901,478,423,42,21.452380952380953
ECU-006440,2122,872,444,428,32,27.25
ECU-006441,2122,596,261,335,27,22.074074074074073
ECU-006442,2122,639,300,339,33,19.363636363636363
ECU-006443,2122,750,364,386,34,22.058823529411764
ECU-006444,2122,463,207,256,23,20.130434782608695
ECU-006445,2122,32,13,19,3,10.666666666666666
ECU-006446,2122,606,298,308,25,24.24
ECU-006447,2122,245,124,121,19,12.894736842105264
ECU-006448,2122,142,68,74,9,15.777777777777779
ECU-006449,2122,1633,798,835,63,25.92063492063492
ECU-006450,2122,1125,513,612,44,25.568181818181817
ECU-006451,2122,327,163,164,15,21.8
ECU-006452,2122,145,70,75,12,12.083333333333334
ECU-006453,2122,1461,736,725,71,20.577464788732396
ECU-006454,2122,108,55,53,8,13.5
ECU-006455,2122,245,125,120,15,16.333333333333332
ECU-006456,2122,189,91,98,13,14.538461538461538
ECU-006457,2122,130,60,70,7,18.571428571428573
ECU-006458,2122,440,212,228,19,23.157894736842106
ECU-006459,2122,136,61,75,9,15.11111111111111
ECU-006460,2122,120,62,58,7,17.142857142857142
ECU-006461,2122,874,424,450,51,17.137254901960784
ECU-006462,2122,405,210,195,23,17.608695652173914
ECU-006463,2122,1074,523,551,52,20.653846153846153
ECU-006464,2122,210,111,99,10,21.0
ECU-006465,2122,136,60,76,9,15.11111111111111
ECU-006466,2122,184,87,97,12,15.333333333333334
ECU-006467,2122,925,468,457,54,17.12962962962963
ECU-006468,2122,33,20,13,4,8.25
ECU-006469,2122,138,71,67,6,23.0
ECU-006470,2122,77,44,33,13,5.923076923076923
ECU-006471,2122,118,60,58,8,14.75
ECU-006472,2122,31,8,23,5,6.2
ECU-006473,2122,46,22,24,6,7.666666666666667
ECU-006474,2122,13,6,7,6,2.1666666666666665
ECU-006475,2122,276,134,142,14,19.714285714285715
ECU-006476,2122,90,49,41,16,5.625
ECU-006477,2122,22,11,11,1,22.0
ECU-006478,2122,15,3,12,1,15.0
ECU-006479,2122,32,15,17,1,32.0
ECU-006480,2122,192,101,91,10,19.2
ECU-006481,2122,133,68,65,9,14.777777777777779
ECU-006482,2122,12,6,6,1,12.0
ECU-006483,2122,48,24,24,3,16.0
ECU-006484,2122,8,4,4,1,8.0
ECU-006485,2122,74,34,40,6,12.333333333333334
ECU-006486,2122,67,34,33,3,22.333333333333332
ECU-006487,2122,73,27,46,3,24.333333333333332
ECU-006488,2122,37,14,23,2,18.5
ECU-006489,2122,406,199,207,21,19.333333333333332
ECU-006490,2122,438,208,230,16,27.375
ECU-006491,2122,654,389,265,28,23.357142857142858
ECU-006492,2122,2033,988,1045,75,27.106666666666666
ECU-006493,2122,733,369,364,27,27.14814814814815
ECU-006494,2122,1244,631,613,43,28.930232558139537
ECU-006495,2122,1072,493,579,40,26.8
ECU-006496,2122,264,140,124,13,20.307692307692307
ECU-006497,2122,819,410,409,25,32.76
ECU-006498,2122,145,82,63,10,14.5
ECU-006499,2122,182,51,131,12,15.166666666666666
ECU-006500,2122,18,11,7,1,18.0
ECU-006501,2122,188,92,96,8,23.5
ECU-006502,2122,313,152,161,14,22.357142857142858
ECU-006503,2122,1074,560,514,40,26.85
ECU-006504,2122,14,10,4,1,14.0
ECU-006505,2122,144,59,85,7,20.571428571428573
ECU-006506,2122,30,10,20,1,30.0
ECU-006507,2122,54,31,23,5,10.8
ECU-006508,2122,9,4,5,2,4.5
ECU-006509,2122,855,418,437,23,37.17391304347826
ECU-006510,2122,51,23,28,6,8.5
ECU-006511,2122,509,222,287,23,22.130434782608695
ECU-006512,2122,2070,1059,1011,69,30.0
ECU-006513,2122,386,182,204,13,29.692307692307693
ECU-006514,2122,1428,689,739,82,17.414634146341463
ECU-006515,2122,264,137,127,16,16.5
ECU-006516,2122,84,40,44,3,28.0
ECU-006517,2122,215,111,104,7,30.714285714285715
ECU-006518,2122,85,43,42,3,28.333333333333332
ECU-006519,2122,380,176,204,13,29.23076923076923
ECU-006520,2122,212,99,113,16,13.25
ECU-006521,2122,1090,528,562,43,25.348837209302324
ECU-006522,2122,1298,715,583,66,19.666666666666668
ECU-006523,2122,1080,553,527,46,23.47826086956522
ECU-006524,2122,2482,1279,1203,89,27.8876404494382
ECU-006525,2122,448,239,209,18,24.88888888888889
ECU-006526,2122,102,52,50,7,14.571428571428571
ECU-006527,2122,1204,597,607,46,26.17391304347826
ECU-006528,2122,18,7,11,2,9.0
ECU-006529,2122,577,293,284,21,27.476190476190474
ECU-006530,2122,769,372,397,28,27.464285714285715
ECU-006531,2122,1517,748,769,58,26.155172413793103
ECU-006532,2122,509,316,193,21,24.238095238095237
ECU-006533,2122,25,16,9,1,25.0
ECU-006534,2122,13,7,6,1,13.0
ECU-006535,2122,1082,521,561,43,25.162790697674417
ECU-006536,2122,138,55,83,26,5.3076923076923075
ECU-006537,2122,110,59,51,8,13.75
ECU-006538,2122,565,272,293,18,31.38888888888889
ECU-006539,2122,877,474,403,23,38.130434782608695
ECU-006540,2122,308,150,158,12,25.666666666666668
ECU-006541,2122,1070,619,451,33,32.42424242424242
ECU-006542,2122,113,57,56,3,37.666666666666664
ECU-006543,2122,1378,680,698,43,32.04651162790697
ECU-006544,2122,759,363,396,29,26.17241379310345
ECU-006545,2122,1444,867,577,48,30.083333333333332
ECU-006546,2122,366,196,170,12,30.5
ECU-006547,2122,122,57,65,12,10.166666666666666
ECU-006548,2122,3819,1904,1915,105,36.371428571428574
ECU-006549,2122,151,75,76,9,16.77777777777778
ECU-006550,2122,349,163,186,14,24.928571428571427
ECU-006551,2122,91,44,47,6,15.166666666666666
ECU-006552,2122,153,75,78,14,10.928571428571429
ECU-006553,2122,34,16,18,2,17.0
ECU-006554,2122,267,133,134,11,24.272727272727273
ECU-006555,2122,591,279,312,25,23.64
ECU-006556,2122,9,5,4,1,9.0
ECU-006557,2122,1143,557,586,37,30.89189189189189
ECU-006558,2122,132,75,57,12,11.0
ECU-006559,2122,9,3,6,1,9.0
ECU-006560,2122,1293,640,653,49,26.387755102040817
ECU-006561,2122,111,47,64,5,22.2
ECU-006562,2122,20,14,6,1,20.0
ECU-006563,2122,7,1,6,1,7.0
ECU-006564,2122,46,20,26,2,23.0
ECU-006565,2122,478,230,248,21,22.761904761904763
ECU-006566,2122,746,391,355,27,27.62962962962963
ECU-006567,2122,85,38,47,3,28.333333333333332
ECU-006568,2122,300,144,156,17,17.647058823529413
ECU-006569,2122,1137,540,597,44,25.84090909090909
ECU-006570,2122,1050,500,550,38,27.63157894736842
ECU-006571,2122,1442,729,713,50,28.84
ECU-006572,2122,1205,596,609,45,26.77777777777778
ECU-006573,2122,570,282,288,25,22.8
ECU-006574,2122,231,120,111,8,28.875
ECU-006575,2122,393,183,210,18,21.833333333333332
ECU-006576,2122,147,71,76,16,9.1875
ECU-006577,2122,295,132,163,12,24.583333333333332
ECU-006578,2122,308,152,156,16,19.25
ECU-006579,2122,73,31,42,13,5.615384615384615
ECU-006580,2122,219,104,115,9,24.333333333333332
ECU-006581,2122,769,361,408,42,18.30952380952381
ECU-006582,2122,1120,681,439,51,21.96078431372549
ECU-006583,2122,1717,869,848,64,26.828125
ECU-006584,2122,228,113,115,13,17.53846153846154
ECU-006585,2122,23,14,9,1,23.0
ECU-006586,2122,8,6,2,1,8.0
ECU-006587,2122,1327,637,690,53,25.037735849056602
ECU-006588,2122,22,12,10,1,22.0
ECU-006589,2122,59,28,31,2,29.5
ECU-006590,2122,71,29,42,3,23.666666666666668
ECU-006591,2122,1491,726,765,52,28.673076923076923
ECU-006592,2122,112,52,60,9,12.444444444444445
ECU-006593,2122,1962,1005,957,75,26.16
ECU-006594,2122,126,59,67,10,12.6
ECU-006595,2122,2915,1486,1429,103,28.300970873786408
ECU-006596,2122,294,149,145,13,22.615384615384617
ECU-006597,2122,248,119,129,15,16.533333333333335
ECU-006598,2122,988,498,490,31,31.870967741935484
ECU-006599,2122,167,81,86,12,13.916666666666666
ECU-006600,2122,10,4,6,1,10.0
ECU-006601,2122,10,3,7,1,10.0
ECU-006602,2122,473,231,242,20,23.65
ECU-006603,2122,376,198,178,14,26.857142857142858
ECU-006604,2122,76,30,46,3,25.333333333333332
ECU-006605,2122,16,9,7,1,16.0
ECU-006606,2122,49,26,23,2,24.5
ECU-006607,2122,290,143,147,18,16.11111111111111
ECU-006608,2122,223,88,135,9,24.77777777777778
ECU-006609,2122,427,192,235,15,28.466666666666665
ECU-006610,2122,103,47,56,9,11.444444444444445
ECU-006611,2122,33,14,19,1,33.0
ECU-006612,2122,415,295,120,10,41.5
ECU-006613,2122,14,6,8,1,14.0
ECU-006614,2122,13,7,6,1,13.0
ECU-006615,2122,202,96,106,12,16.833333333333332
ECU-006616,2122,12,5,7,1,12.0
ECU-006617,2122,6,4,2,1,6.0
ECU-006618,2122,1461,726,735,45,32.46666666666667
ECU-006619,2122,251,120,131,10,25.1
ECU-006620,2122,113,60,53,7,16.142857142857142
ECU-006621,2122,210,94,116,12,17.5
ECU-006622,2122,62,22,40,7,8.857142857142858
ECU-006623,2122,508,244,264,14,36.285714285714285
ECU-006624,2122,311,153,158,18,17.27777777777778
ECU-006625,2122,828,379,449,27,30.666666666666668
ECU-006626,2122,438,228,210,12,36.5
ECU-006627,2122,2500,1287,1213,80,31.25
ECU-006628,2122,10,3,7,1,10.0
ECU-006629,2122,1612,783,829,63,25.58730158730159
ECU-006630,2122,306,147,159,17,18.0
ECU-006631,2122,31,20,11,2,15.5
ECU-006632,2122,1858,1068,790,66,28.151515151515152
ECU-006633,2122,154,86,68,14,11.0
ECU-006634,2122,1748,1046,702,64,27.3125
ECU-006635,2122,1018,508,510,36,28.27777777777778
ECU-006636,2122,1733,699,1034,64,27.078125
ECU-006637,2122,259,134,125,15,17.266666666666666
ECU-006638,2122,585,320,265,34,17.205882352941178
ECU-006639,2122,28,11,17,1,28.0
ECU-006640,2122,39,21,18,1,39.0
ECU-006641,2122,15,9,6,1,15.0
ECU-006642,2122,49,23,26,2,24.5
ECU-006643,2122,13,7,6,1,13.0
ECU-006644,2122,9,4,5,1,9.0
ECU-006645,2122,9,3,6,1,9.0
ECU-006646,2122,34,11,23,1,34.0
ECU-006647,2122,21,10,11,1,21.0
ECU-006648,2122,16,5,11,1,16.0
ECU-006649,2122,6,4,2,1,6.0
ECU-006650,2122,2,1,1,1,2.0
ECU-006651,2122,8,6,2,1,8.0
ECU-006652,2122,18,7,11,1,18.0
ECU-006653,2122,54,21,33,3,18.0
ECU-006654,2122,22,14,8,1,22.0
ECU-006655,2122,8,4,4,1,8.0
ECU-006656,2122,637,339,298,23,27.695652173913043
ECU-006657,2122,20,9,11,1,20.0
ECU-006658,2122,20,13,7,1,20.0
ECU-006659,2122,11,6,5,1,11.0
ECU-006660,2122,261,136,125,10,26.1
ECU-006661,2122,21,14,7,1,21.0
ECU-006662,2122,15,7,8,1,15.0
ECU-006663,2122,26,13,13,1,26.0
ECU-006664,2122,9,8,1,1,9.0
ECU-006665,2122,12,7,5,1,12.0
ECU-006666,2122,2,1,1,1,2.0
ECU-006667,2122,14,10,4,1,14.0
ECU-006668,2122,348,163,185,16,21.75
ECU-006669,2122,10,3,7,1,10.0
ECU-006670,2122,13,3,10,1,13.0
ECU-006671,2122,10,5,5,1,10.0
ECU-006672,2122,29,16,13,1,29.0
ECU-006673,2122,8,5,3,1,8.0
ECU-006674,2122,11,5,6,1,11.0
ECU-006675,2122,812,413,399,31,26.193548387096776
ECU-006676,2122,19,5,14,1,19.0
ECU-006677,2122,53,24,29,3,17.666666666666668
ECU-006678,2122,8,5,3,1,8.0
ECU-006679,2122,14,8,6,1,14.0
ECU-006680,2122,10,7,3,1,10.0
ECU-006681,2122,11,4,7,1,11.0
ECU-006682,2122,12,9,3,1,12.0
ECU-006683,2122,82,40,42,3,27.333333333333332
ECU-006684,2122,3,2,1,1,3.0
ECU-006685,2122,19,8,11,1,19.0
ECU-006686,2122,7,4,3,1,7.0
ECU-006687,2122,14,8,6,1,14.0
ECU-006688,2122,51,30,21,2,25.5
ECU-006689,2122,38,21,17,2,19.0
ECU-006690,2122,16,6,10,1,16.0
ECU-006691,2122,3,2,1,1,3.0
ECU-006692,2122,86,43,43,3,28.666666666666668
ECU-006693,2122,32,13,19,1,32.0
ECU-006694,2122,1,1,0,1,1.0
ECU-006695,2122,14,5,9,1,14.0
ECU-006696,2122,4,0,4,1,4.0
ECU-006697,2122,294,134,160,12,24.5
ECU-006698,2122,260,129,131,9,28.88888888888889
ECU-006699,2122,19,7,12,1,19.0
ECU-006700,2122,58,35,23,3,19.333333333333332
ECU-006701,2122,50,21,29,3,16.666666666666668
ECU-006702,2122,11,6,5,1,11.0
ECU-006703,2122,100,45,55,4,25.0
ECU-006704,2122,133,73,60,7,19.0
ECU-006705,2122,1485,790,695,56,26.517857142857142
ECU-006706,2122,39,19,20,2,19.5
ECU-006707,2122,15,6,9,1,15.0
ECU-006708,2122,61,33,28,2,30.5
ECU-006709,2122,24,13,11,1,24.0
ECU-006710,2122,207,101,106,9,23.0
ECU-006711,2122,29,13,16,1,29.0
ECU-006712,2122,38,17,21,2,19.0
ECU-006713,2122,32,17,15,1,32.0
ECU-006714,2122,6,6,0,1,6.0
ECU-006715,2122,36,20,16,1,36.0
ECU-006716,2122,215,95,120,8,26.875
ECU-006717,2122,717,367,350,23,31.17391304347826
ECU-006718,2122,26,17,9,1,26.0
ECU-006719,2122,11,8,3,1,11.0
ECU-006720,2122,1047,536,511,44,23.795454545454547
ECU-006721,2122,405,197,208,22,18.40909090909091
ECU-006722,2122,84,37,47,3,28.0
ECU-006723,2122,716,352,364,34,21.058823529411764
ECU-006724,2122,44,24,20,2,22.0
ECU-006725,2122,56,33,23,2,28.0
ECU-006726,2122,17,6,11,1,17.0
ECU-006727,2122,79,30,49,3,26.333333333333332
ECU-006728,2122,67,32,35,3,22.333333333333332
ECU-006729,2122,550,281,269,23,23.91304347826087
ECU-006730,2122,23,11,12,1,23.0
ECU-006731,2122,30,15,15,1,30.0
ECU-006732,2122,114,48,66,5,22.8
ECU-006733,2122,188,99,89,8,23.5
ECU-006734,2122,41,24,17,2,20.5
ECU-006735,2122,42,21,21,2,21.0
ECU-006736,2122,645,316,329,30,21.5
ECU-006737,2122,180,81,99,10,18.0
ECU-006738,2122,41,25,16,2,20.5
ECU-006739,2122,23,8,15,1,23.0
ECU-006740,2122,27,15,12,1,27.0
ECU-006741,2122,18,10,8,1,18.0
ECU-006742,2122,27,9,18,1,27.0
ECU-006743,2122,7,2,5,1,7.0
ECU-006744,2122,49,29,20,2,24.5
ECU-006745,2122,8,4,4,1,8.0
ECU-006746,2122,41,17,24,2,20.5
ECU-006747,2122,34,17,17,2,17.0
ECU-006748,2122,55,28,27,2,27.5
ECU-006749,2122,17,8,9,1,17.0
ECU-006750,2122,22,6,16,1,22.0
ECU-006751,2122,211,106,105,21,10.047619047619047
ECU-006752,2122,53,27,26,2,26.5
ECU-006753,2122,15,5,10,1,15.0
ECU-006754,2122,15,8,7,1,15.0
ECU-006755,2122,14,6,8,1,14.0
ECU-006756,2122,27,18,9,1,27.0
ECU-006757,2122,1107,575,532,43,25.74418604651163
ECU-006758,2122,9,4,5,1,9.0
ECU-006759,2122,15,7,8,1,15.0
ECU-006760,2122,81,39,42,4,20.25
ECU-006761,2122,9,6,3,1,9.0
ECU-006762,2122,165,75,90,13,12.692307692307692
ECU-006763,2122,19,10,9,1,19.0
ECU-006764,2122,14,8,6,1,14.0
ECU-006765,2122,35,24,11,1,35.0
ECU-006766,2122,295,161,134,16,18.4375
ECU-006767,2122,14,7,7,1,14.0
ECU-006768,2122,26,17,9,1,26.0
ECU-006769,2122,36,25,11,2,18.0
ECU-006770,2122,13,7,6,1,13.0
ECU-006771,2122,16,7,9,1,16.0
ECU-006772,2122,15,8,7,1,15.0
ECU-006773,2122,653,329,324,26,25.115384615384617
ECU-006774,2122,8,2,6,1,8.0
ECU-006775,2122,39,23,16,1,39.0
ECU-006776,2122,18,9,9,1,18.0
ECU-006777,2122,168,80,88,8,21.0
ECU-006778,2122,20,9,11,1,20.0
ECU-006779,2122,13,3,10,1,13.0
ECU-006780,2122,48,22,26,4,12.0
ECU-006781,2122,8,4,4,1,8.0
ECU-006782,2122,47,22,25,2,23.5
ECU-006783,2122,32,19,13,1,32.0
ECU-006784,2122,6,5,1,1,6.0
ECU-006785,2122,57,29,28,3,19.0
ECU-006786,2122,39,24,15,2,19.5
ECU-006787,2122,44,25,19,2,22.0
ECU-006788,2122,18,9,9,1,18.0
ECU-006789,2122,5,2,3,1,5.0
ECU-006790,2122,755,349,406,34,22.205882352941178
ECU-006791,2122,42,19,23,2,21.0
ECU-006792,2122,244,108,136,10,24.4
ECU-006793,2122,13,4,9,1,13.0
ECU-006794,2122,21,4,17,1,21.0
ECU-006795,2122,26,13,13,1,26.0
ECU-006796,2122,28,14,14,1,28.0
ECU-006797,2122,16,10,6,1,16.0
ECU-006798,2122,11,3,8,1,11.0
ECU-006799,2122,14,7,7,5,2.8
ECU-006800,2122,1271,632,639,49,25.93877551020408
ECU-006801,2122,1813,942,871,72,25.180555555555557
ECU-006802,2122,248,130,118,13,19.076923076923077
ECU-006803,2122,41,19,22,9,4.555555555555555
ECU-006804,2122,33,12,21,2,16.5
ECU-006805,2122,841,437,404,33,25.484848484848484
ECU-006806,2122,9,4,5,1,9.0
ECU-006807,2122,182,75,107,11,16.545454545454547
ECU-006808,2122,13,6,7,1,13.0
ECU-006809,2122,942,459,483,41,22.975609756097562
ECU-006810,2122,16,7,9,2,8.0
ECU-006811,2122,70,37,33,10,7.0
ECU-006812,2122,19,8,11,1,19.0
ECU-006813,2122,9,3,6,1,9.0
ECU-006814,2122,9,4,5,1,9.0
ECU-006815,2122,95,17,78,6,15.833333333333334
ECU-006816,2122,43,24,19,2,21.5
ECU-006817,2122,5,3,2,1,5.0
ECU-006818,2122,100,31,69,6,16.666666666666668
ECU-006819,2122,17,3,14,5,3.4
ECU-006820,2122,184,96,88,8,23.0
ECU-006821,2122,69,36,33,6,11.5
ECU-006822,2122,201,97,104,15,13.4
ECU-006823,2122,48,16,32,6,8.0
ECU-006824,2122,7,4,3,6,1.1666666666666667
ECU-006825,2122,25,19,6,1,25.0
ECU-006826,2122,120,49,71,15,8.0
ECU-006827,2122,101,14,87,5,20.2
ECU-006828,2122,284,143,141,29,9.793103448275861
ECU-006829,2122,66,40,26,8,8.25
ECU-006830,2122,10,1,9,2,5.0
ECU-006831,2122,170,72,98,5,34.0
ECU-006832,2122,40,16,24,6,6.666666666666667
ECU-006833,2122,98,24,74,8,12.25
ECU-006834,2122,4,1,3,1,4.0
ECU-006835,2122,224,99,125,14,16.0
ECU-006836,2122,467,225,242,19,24.57894736842105
ECU-006837,2122,206,100,106,11,18.727272727272727
ECU-006838,2122,399,201,198,20,19.95
ECU-006839,2122,2728,1159,1569,111,24.576576576576578
ECU-006840,2122,2750,1221,1529,124,22.177419354838708
ECU-006841,2122,394,188,206,19,20.736842105263158
ECU-006842,2122,601,306,295,23,26.130434782608695
ECU-006843,2122,1790,900,890,72,24.86111111111111
ECU-006844,2122,1418,702,716,58,24.448275862068964
ECU-006845,2122,313,135,178,17,18.41176470588235
ECU-006846,2122,662,300,362,27,24.51851851851852
ECU-006847,2122,145,71,74,8,18.125
ECU-006848,2122,1136,593,543,55,20.654545454545456
ECU-006849,2122,1935,976,959,68,28.455882352941178
ECU-006850,2122,1845,867,978,64,28.828125
ECU-006851,2122,749,412,337,26,28.807692307692307
ECU-006852,2122,21,10,11,1,21.0
ECU-006853,2122,301,147,154,13,23.153846153846153
ECU-006854,2122,22,13,9,3,7.333333333333333
ECU-006855,2122,54,25,29,8,6.75
ECU-006856,2122,421,206,215,19,22.157894736842106
ECU-006857,2122,1347,686,661,40,33.675
ECU-006858,2122,1938,1030,908,75,25.84
ECU-006859,2122,1591,884,707,45,35.355555555555554
ECU-006860,2122,146,66,80,9,16.22222222222222
ECU-006861,2122,155,81,74,8,19.375
ECU-006862,2122,96,48,48,9,10.666666666666666
ECU-006863,2122,139,59,80,8,17.375
ECU-006864,2122,169,68,101,8,21.125
ECU-006865,2122,701,334,367,35,20.02857142857143
ECU-006866,2122,312,155,157,12,26.0
ECU-006867,2122,908,0,908,105,8.647619047619047
ECU-006868,2122,1167,513,654,57,20.473684210526315
ECU-006869,2122,291,148,143,13,22.384615384615383
ECU-006870,2122,30,10,20,1,30.0
ECU-006871,2122,27,15,12,2,13.5
ECU-006872,2122,43,15,28,2,21.5
ECU-006873,2122,1156,570,586,34,34.0
ECU-006874,2122,675,386,289,30,22.5
ECU-006875,2122,1183,622,561,38,31.13157894736842
ECU-006876,2122,525,261,264,26,20.192307692307693
ECU-006877,2122,448,228,220,18,24.88888888888889
ECU-006878,2122,398,193,205,16,24.875
ECU-006879,2122,873,421,452,39,22.384615384615383
ECU-006880,2122,504,228,276,26,19.384615384615383
ECU-006881,2122,9,5,4,0,
ECU-006882,2122,2048,1092,956,89,23.01123595505618
ECU-006883,2122,1498,715,783,60,24.966666666666665
ECU-006884,2122,1664,835,829,65,25.6
ECU-006885,2122,263,141,122,12,21.916666666666668
ECU-006886,2122,882,423,459,31,28.451612903225808
ECU-006887,2122,1073,517,556,32,33.53125
ECU-006888,2122,1028,490,538,37,27.783783783783782
ECU-006889,2122,476,235,241,13,36.61538461538461
ECU-006890,2122,326,146,180,10,32.6
ECU-006891,2122,1068,493,575,37,28.864864864864863
ECU-006892,2122,949,446,503,38,24.973684210526315
ECU-006893,2122,127,66,61,10,12.7
ECU-006894,2122,88,32,56,3,29.333333333333332
ECU-006895,2122,595,275,320,21,28.333333333333332
ECU-006896,2122,356,168,188,12,29.666666666666668
ECU-006897,2122,1021,495,526,36,28.36111111111111
ECU-006898,2122,34,21,13,2,17.0
ECU-006899,2122,119,57,62,9,13.222222222222221
ECU-006900,2122,1335,616,719,73,18.28767123287671
ECU-006901,2122,2480,1292,1188,88,28.181818181818183
ECU-006902,2122,295,154,141,8,36.875
ECU-006903,2122,68,33,35,7,9.714285714285714
ECU-006904,2122,600,287,313,22,27.272727272727273
ECU-006905,2122,1817,885,932,76,23.907894736842106
ECU-006906,2122,593,292,301,18,32.94444444444444
ECU-006907,2122,862,460,402,41,21.024390243902438
ECU-006908,2122,469,213,256,17,27.58823529411765
ECU-006909,2122,541,270,271,24,22.541666666666668
ECU-006910,2122,103,50,53,9,11.444444444444445
ECU-006911,2122,2060,1004,1056,73,28.21917808219178
ECU-006912,2122,1012,488,524,36,28.11111111111111
ECU-006913,2122,116,68,48,12,9.666666666666666
ECU-006914,2122,24,6,18,1,24.0
ECU-006915,2122,66,33,33,1,66.0
ECU-006916,2122,26,15,11,1,26.0
ECU-006917,2122,13,6,7,1,13.0
ECU-006918,2122,469,237,232,24,19.541666666666668
ECU-006919,2122,48,21,27,3,16.0
ECU-006920,2122,175,86,89,13,13.461538461538462
ECU-006921,2122,16,9,7,1,16.0
ECU-006922,2122,179,92,87,12,14.916666666666666
ECU-006923,2122,5,2,3,1,5.0
ECU-006924,2122,35,17,18,1,35.0
ECU-006925,2122,96,45,51,9,10.666666666666666
ECU-006926,2122,157,76,81,8,19.625
ECU-006927,2122,42,16,26,2,21.0
ECU-006928,2122,39,17,22,2,19.5
ECU-006929,2122,10,3,7,1,10.0
ECU-006930,2122,18,11,7,1,18.0
ECU-006931,2122,46,18,28,3,15.333333333333334
ECU-006932,2122,28,11,17,2,14.0
ECU-006933,2122,50,23,27,2,25.0
ECU-006934,2122,335,166,169,16,20.9375
ECU-006935,2122,10,4,6,1,10.0
ECU-006936,2122,8,5,3,1,8.0
ECU-006937,2122,32,10,22,1,32.0
ECU-006938,2122,32,19,13,1,32.0
ECU-006939,2122,21,10,11,1,21.0
ECU-006940,2122,22,13,9,1,22.0
ECU-006941,2122,12,4,8,1,12.0
ECU-006942,2122,29,14,15,2,14.5
ECU-006943,2122,124,63,61,11,11.272727272727273
ECU-006944,2122,5,1,4,1,5.0
ECU-006945,2122,56,21,35,2,28.0
ECU-006946,2122,32,14,18,2,16.0
ECU-006947,2122,31,20,11,2,15.5
ECU-006948,2122,94,38,56,3,31.333333333333332
ECU-006949,2122,955,514,441,46,20.76086956521739
ECU-006950,2122,160,79,81,11,14.545454545454545
ECU-006951,2122,169,87,82,13,13.0
ECU-006952,2122,20,8,12,1,20.0
ECU-006953,2122,14,7,7,1,14.0
ECU-006954,2122,60,31,29,2,30.0
ECU-006955,2122,50,27,23,3,16.666666666666668
ECU-006956,2122,29,14,15,2,14.5
ECU-006957,2122,2,2,0,1,2.0
ECU-006958,2122,11,6,5,1,11.0
ECU-006959,2122,9,4,5,1,9.0
ECU-006960,2122,9,5,4,1,9.0
ECU-006961,2122,20,10,10,1,20.0
ECU-006962,2122,10,4,6,1,10.0
ECU-006963,2122,15,6,9,1,15.0
ECU-006964,2122,9,4,5,1,9.0
ECU-006965,2122,54,22,32,3,18.0
ECU-006966,2122,47,20,27,2,23.5
ECU-006967,2122,68,39,29,3,22.666666666666668
ECU-006968,2122,2,2,0,1,2.0
ECU-006969,2122,55,33,22,3,18.333333333333332
ECU-006970,2122,33,20,13,2,16.5
ECU-006971,2122,169,86,83,13,13.0
ECU-006972,2122,115,55,60,10,11.5
ECU-006973,2122,27,10,17,2,13.5
ECU-006974,2122,14,8,6,1,14.0
ECU-006975,2122,147,70,77,7,21.0
ECU-006976,2122,220,107,113,21,10.476190476190476
ECU-006977,2122,238,120,118,21,11.333333333333334
ECU-006978,2122,38,23,15,2,19.0
ECU-006979,2122,60,35,25,7,8.571428571428571
ECU-006980,2122,352,174,178,19,18.526315789473685
ECU-006981,2122,24,11,13,3,8.0
ECU-006982,2122,366,171,195,17,21.529411764705884
ECU-006983,2122,149,70,79,7,21.285714285714285
ECU-006984,2122,462,238,224,18,25.666666666666668
ECU-006985,2122,1122,406,716,70,16.02857142857143
ECU-006986,2122,2427,1364,1063,107,22.682242990654206
ECU-006987,2122,31,23,8,5,6.2
ECU-006988,2122,246,107,139,12,20.5
ECU-006989,2122,55,13,42,13,4.230769230769231
ECU-006990,2122,31,11,20,4,7.75
ECU-006991,2122,1765,865,900,68,25.955882352941178
ECU-006992,2122,991,519,472,34,29.147058823529413
ECU-006993,2122,545,264,281,20,27.25
ECU-006994,2122,971,524,447,47,20.659574468085108
ECU-006995,2122,90,43,47,4,22.5
ECU-006996,2122,43,15,28,1,43.0
ECU-006997,2122,396,185,211,18,22.0
ECU-006998,2122,2537,1207,1330,96,26.427083333333332
ECU-006999,2122,82,39,43,4,20.5
ECU-007000,2122,26,10,16,1,26.0
ECU-007001,2122,19,14,5,1,19.0
ECU-007002,2122,330,160,170,16,20.625
ECU-007003,2122,20,9,11,1,20.0
ECU-007004,2122,443,229,214,25,17.72
ECU-007005,2122,44,23,21,2,22.0
ECU-007006,2122,64,30,34,3,21.333333333333332
ECU-007007,2122,153,74,79,11,13.909090909090908
ECU-007008,2122,145,70,75,10,14.5
ECU-007009,2122,217,93,124,11,19.727272727272727
ECU-007010,2122,901,418,483,42,21.452380952380953
ECU-007011,2122,66,31,35,3,22.0
ECU-007012,2122,334,166,168,11,30.363636363636363
ECU-007013,2122,26,12,14,1,26.0
ECU-007014,2122,491,275,216,25,19.64
ECU-007015,2122,62,27,35,3,20.666666666666668
ECU-007016,2122,72,36,36,7,10.285714285714286
ECU-007017,2122,70,37,33,6,11.666666666666666
ECU-007018,2122,16,7,9,1,16.0
ECU-007019,2122,7,3,4,1,7.0
ECU-007020,2122,62,30,32,4,15.5
ECU-007021,2122,14,4,10,1,14.0
ECU-007022,2122,23,9,14,1,23.0
ECU-007023,2122,13,4,9,1,13.0
ECU-007024,2122,13,9,4,1,13.0
ECU-007025,2122,56,35,21,5,11.2
ECU-007026,2122,19,9,10,1,19.0
ECU-007027,2122,11,6,5,1,11.0
ECU-007028,2122,102,44,58,7,14.571428571428571
ECU-007029,2122,382,170,212,12,31.833333333333332
ECU-007030,2122,709,359,350,39,18.17948717948718
ECU-007031,2122,11,6,5,1,11.0
ECU-007032,2122,15,5,10,1,15.0
ECU-007033,2122,112,57,55,9,12.444444444444445
ECU-007034,2122,15,5,10,1,15.0
ECU-007035,2122,54,26,28,2,27.0
ECU-007036,2122,47,23,24,3,15.666666666666666
ECU-007037,2122,9,3,6,1,9.0
ECU-007038,2122,3,0,3,1,3.0
ECU-007039,2122,17,7,10,1,17.0
ECU-007040,2122,24,15,9,2,12.0
ECU-007041,2122,4,2,2,1,4.0
ECU-007042,2122,72,36,36,4,18.0
ECU-007043,2122,278,98,180,34,8.176470588235293
ECU-007044,2122,6,4,2,1,6.0
ECU-007045,2122,92,41,51,5,18.4
ECU-007046,2122,5,1,4,1,5.0
ECU-007047,2122,26,13,13,1,26.0
ECU-007048,2122,68,34,34,7,9.714285714285714
ECU-007049,2122,3,2,1,1,3.0
ECU-007050,2122,9,5,4,1,9.0
ECU-007051,2122,198,94,104,14,14.142857142857142
ECU-007052,2122,17,9,8,1,17.0
ECU-007053,2122,786,385,401,39,20.153846153846153
ECU-007054,2122,11,4,7,1,11.0
ECU-007055,2122,18,9,9,1,18.0
ECU-007056,2122,11,5,6,1,11.0
ECU-007057,2122,15,9,6,1,15.0
ECU-007058,2122,8,6,2,1,8.0
ECU-007059,2122,19,7,12,1,19.0
ECU-007060,2122,21,12,9,1,21.0
ECU-007061,2122,14,6,8,1,14.0
ECU-007062,2122,37,15,22,2,18.5
ECU-007063,2122,52,29,23,2,26.0
ECU-007064,2122,21,6,15,1,21.0
ECU-007065,2122,190,103,87,16,11.875
ECU-007066,2122,7,4,3,1,7.0
ECU-007067,2122,7,2,5,1,7.0
ECU-007068,2122,1394,729,665,56,24.892857142857142
ECU-007069,2122,23,7,16,1,23.0
ECU-007070,2122,10,5,5,1,10.0
ECU-007071,2122,117,62,55,11,10.636363636363637
ECU-007072,2122,351,171,180,19,18.473684210526315
ECU-007073,2122,4,2,2,1,4.0
ECU-007074,2122,17,9,8,1,17.0
ECU-007075,2122,1558,741,817,73,21.34246575342466
ECU-007076,2122,16,11,5,2,8.0
ECU-007077,2122,9,4,5,1,9.0
ECU-007078,2122,10,7,3,1,10.0
ECU-007079,2122,4,1,3,1,4.0
ECU-007080,2122,4,1,3,1,4.0
ECU-007081,2122,15,4,11,1,15.0
ECU-007082,2122,105,53,52,8,13.125
ECU-007083,2122,16,6,10,1,16.0
ECU-007084,2122,6,5,1,1,6.0
ECU-007085,2122,128,59,69,12,10.666666666666666
ECU-007086,2122,200,99,101,11,18.181818181818183
ECU-007087,2122,6,4,2,1,6.0
ECU-007088,2122,10,7,3,1,10.0
ECU-007089,2122,5,3,2,1,5.0
ECU-007090,2122,12,5,7,2,6.0
ECU-007091,2122,2,1,1,1,2.0
ECU-007092,2122,7,4,3,1,7.0
ECU-007093,2122,2,0,2,1,2.0
ECU-007094,2122,4,4,0,1,4.0
ECU-007095,2122,6,6,0,1,6.0
ECU-007096,2122,4,2,2,1,4.0
ECU-007097,2122,79,34,45,5,15.8
ECU-007098,2122,9,6,3,1,9.0
ECU-007099,2122,30,19,11,2,15.0
ECU-007100,2122,49,19,30,9,5.444444444444445
ECU-007101,2122,18,9,9,1,18.0
ECU-007102,2122,5,2,3,1,5.0
ECU-007103,2122,32,16,16,2,16.0
ECU-007104,2122,8,4,4,1,8.0
ECU-007105,2122,49,28,21,2,24.5
ECU-007106,2122,2,2,0,1,2.0
ECU-007107,2122,11,5,6,1,11.0
ECU-007108,2122,44,21,23,4,11.0
ECU-007109,2122,7,3,4,1,7.0
ECU-007110,2122,182,78,104,7,26.0
ECU-007111,2122,79,36,43,4,19.75
ECU-007112,2122,34,17,17,2,17.0
ECU-007113,2122,4,1,3,1,4.0
ECU-007114,2122,81,35,46,4,20.25
ECU-007115,2122,17,9,8,1,17.0
ECU-007116,2122,8,4,4,1,8.0
ECU-007117,2122,7,6,1,1,7.0
ECU-007118,2122,11,4,7,1,11.0
ECU-007119,2122,20,9,11,2,10.0
ECU-007120,2122,22,9,13,1,22.0
ECU-007121,2122,22,10,12,1,22.0
ECU-007122,2122,506,232,274,19,26.63157894736842
ECU-007123,2122,33,12,21,1,33.0
ECU-007124,2122,27,10,17,2,13.5
ECU-007125,2122,14,7,7,1,14.0
ECU-007126,2122,406,188,218,19,21.36842105263158
ECU-007127,2122,53,24,29,2,26.5
ECU-007128,2122,24,11,13,1,24.0
ECU-007129,2122,28,11,17,5,5.6
ECU-007130,2122,201,103,98,11,18.272727272727273
ECU-007131,2122,456,237,219,23,19.82608695652174
ECU-007132,2122,232,116,116,12,19.333333333333332
ECU-007133,2122,316,135,181,22,14.363636363636363
ECU-007134,2122,257,142,115,17,15.117647058823529
ECU-007135,2122,7,5,2,1,7.0
ECU-007136,2122,122,59,63,10,12.2
ECU-007137,2122,13,6,7,1,13.0
ECU-007138,2122,20,11,9,1,20.0
ECU-007139,2122,15,6,9,1,15.0
ECU-007140,2122,167,74,93,18,9.277777777777779
ECU-007141,2122,20,9,11,1,20.0
ECU-007142,2122,43,17,26,2,21.5
ECU-007143,2122,132,77,55,7,18.857142857142858
ECU-007144,2122,13,5,8,1,13.0
ECU-007145,2122,65,33,32,2,32.5
ECU-007146,2122,3,1,2,1,3.0
ECU-007147,2122,248,121,127,16,15.5
ECU-007148,2122,2,2,0,1,2.0
ECU-007149,2122,10,4,6,1,10.0
ECU-007150,2122,33,18,15,1,33.0
ECU-007151,2122,33,17,16,2,16.5
ECU-007152,2122,6,1,5,1,6.0
ECU-007153,2122,10,4,6,1,10.0
ECU-007154,2122,9,3,6,1,9.0
ECU-007155,2122,19,10,9,2,9.5
ECU-007156,2122,19,8,11,1,19.0
ECU-007157,2122,5,3,2,1,5.0
ECU-007158,2122,4,2,2,1,4.0
ECU-007159,2122,3,1,2,1,3.0
ECU-007160,2122,12,8,4,1,12.0
ECU-007161,2122,15,6,9,2,7.5
ECU-007162,2122,26,11,15,1,26.0
ECU-007163,2122,10,3,7,1,10.0
ECU-007164,2122,11,8,3,1,11.0
ECU-007165,2122,14,4,10,1,14.0
ECU-007166,2122,7,2,5,1,7.0
ECU-007167,2122,15,8,7,1,15.0
ECU-007168,2122,184,80,104,12,15.333333333333334
ECU-007169,2122,6,3,3,1,6.0
ECU-007170,2122,13,6,7,1,13.0
ECU-007171,2122,5,1,4,1,5.0
ECU-007172,2122,56,27,29,3,18.666666666666668
ECU-007173,2122,1,0,1,1,1.0
ECU-007174,2122,78,35,43,7,11.142857142857142
ECU-007175,2122,47,20,27,3,15.666666666666666
ECU-007176,2122,31,19,12,1,31.0
ECU-007177,2122,9,3,6,1,9.0
ECU-007178,2122,108,55,53,5,21.6
ECU-007179,2122,45,20,25,5,9.0
ECU-007180,2122,440,214,226,19,23.157894736842106
ECU-007181,2122,912,450,462,34,26.823529411764707
ECU-007182,2122,10,3,7,1,10.0
ECU-007183,2122,196,97,99,9,21.77777777777778
ECU-007184,2122,330,155,175,16,20.625
ECU-007185,2122,17,6,11,1,17.0
ECU-007186,2122,979,486,493,35,27.97142857142857
ECU-007187,2122,20,8,12,1,20.0
ECU-007188,2122,10,3,7,1,10.0
ECU-007189,2122,20,9,11,2,10.0
ECU-007190,2122,156,77,79,4,39.0
ECU-007191,2122,122,61,61,7,17.428571428571427
ECU-007192,2122,1151,560,591,48,23.979166666666668
ECU-007193,2122,11,3,8,1,11.0
ECU-007194,2122,241,108,133,14,17.214285714285715
ECU-007195,2122,1087,512,575,60,18.116666666666667
ECU-007196,2122,4,1,3,1,4.0
ECU-007197,2122,3,1,2,1,3.0
ECU-007198,2122,1727,846,881,76,22.723684210526315
ECU-007199,2122,74,40,34,5,14.8
ECU-007200,2122,71,40,31,4,17.75
ECU-007201,2122,9,2,7,1,9.0
ECU-007202,2122,263,142,121,22,11.954545454545455
ECU-007203,2122,8,6,2,1,8.0
ECU-007204,2122,96,30,66,10,9.6
ECU-007205,2122,22,11,11,2,11.0
ECU-007206,2122,5,1,4,1,5.0
ECU-007207,2122,4,2,2,1,4.0
ECU-007208,2122,9,3,6,1,9.0
ECU-007209,2122,23,7,16,1,23.0
ECU-007210,2122,33,18,15,2,16.5
ECU-007211,2122,48,23,25,6,8.0
ECU-007212,2122,20,11,9,1,20.0
ECU-007213,2122,10,7,3,1,10.0
ECU-007214,2122,12,6,6,1,12.0
ECU-007215,2122,5,3,2,1,5.0
ECU-007216,2122,366,177,189,19,19.263157894736842
ECU-007217,2122,9,7,2,1,9.0
ECU-007218,2122,11,3,8,1,11.0
ECU-007219,2122,5,1,4,1,5.0
ECU-007220,2122,9,4,5,1,9.0
ECU-007221,2122,9,4,5,1,9.0
ECU-007222,2122,4,3,1,1,4.0
ECU-007223,2122,211,101,110,13,16.23076923076923
ECU-007224,2122,25,12,13,1,25.0
ECU-007225,2122,6,5,1,1,6.0
ECU-007226,2122,3,3,0,1,3.0
ECU-007227,2122,16,9,7,1,16.0
ECU-007228,2122,6,5,1,1,6.0
ECU-007229,2122,13,5,8,1,13.0
ECU-007230,2122,35,17,18,2,17.5
ECU-007231,2122,4,1,3,1,4.0
ECU-007232,2122,17,7,10,1,17.0
ECU-007233,2122,6,3,3,1,6.0
ECU-007234,2122,10,7,3,1,10.0
ECU-007235,2122,7,4,3,1,7.0
ECU-007236,2122,5,1,4,1,5.0
ECU-007237,2122,12,6,6,1,12.0
ECU-007238,2122,5,1,4,1,5.0
ECU-007239,2122,14,7,7,1,14.0
ECU-007240,2122,187,101,86,13,14.384615384615385
ECU-007241,2122,8,7,1,1,8.0
ECU-007242,2122,49,25,24,3,16.333333333333332
ECU-007243,2122,16,9,7,1,16.0
ECU-007244,2122,53,28,25,2,26.5
ECU-007245,2122,314,156,158,16,19.625
ECU-007246,2122,348,163,185,28,12.428571428571429
ECU-007247,2122,17,12,5,1,17.0
ECU-007248,2122,6,3,3,1,6.0
ECU-007249,2122,137,53,84,8,17.125
ECU-007250,2122,2,2,0,1,2.0
ECU-007251,2122,9,4,5,1,9.0
ECU-007252,2122,61,33,28,7,8.714285714285714
ECU-007253,2122,18,8,10,1,18.0
ECU-007254,2122,10,8,2,1,10.0
ECU-007255,2122,18,6,12,1,18.0
ECU-007256,2122,7,4,3,1,7.0
ECU-007257,2122,216,104,112,18,12.0
ECU-007258,2122,36,20,16,2,18.0
ECU-007259,2122,79,41,38,6,13.166666666666666
ECU-007260,2122,44,22,22,2,22.0
ECU-007261,2122,18,6,12,1,18.0
ECU-007262,2122,537,271,266,25,21.48
ECU-007263,2122,1492,734,758,49,30.448979591836736
ECU-007264,2122,12,6,6,1,12.0
ECU-007265,2122,48,21,27,3,16.0
ECU-007266,2122,92,39,53,9,10.222222222222221
ECU-007267,2122,8,1,7,1,8.0
ECU-007268,2122,3,1,2,1,3.0
ECU-007269,2122,23,7,16,2,11.5
ECU-007270,2122,99,49,50,4,24.75
ECU-007271,2122,5,3,2,1,5.0
ECU-007272,2122,100,56,44,4,25.0
ECU-007273,2122,191,99,92,14,13.642857142857142
ECU-007274,2122,28,12,16,1,28.0
ECU-007275,2122,5,3,2,1,5.0
ECU-007276,2122,237,115,122,17,13.941176470588236
ECU-007277,2122,66,29,37,3,22.0
ECU-007278,2122,86,47,39,9,9.555555555555555
ECU-007279,2122,130,60,70,12,10.833333333333334
ECU-007280,2122,9,3,6,1,9.0
ECU-007281,2122,105,50,55,7,15.0
ECU-007282,2122,13,8,5,3,4.333333333333333
ECU-007283,2122,4,0,4,1,4.0
ECU-007284,2122,80,33,47,12,6.666666666666667
ECU-007285,2122,1192,586,606,60,19.866666666666667
ECU-007286,2122,174,91,83,8,21.75
ECU-007287,2122,177,75,102,9,19.666666666666668
ECU-007288,2122,29,15,14,2,14.5
ECU-007289,2122,22,10,12,1,22.0
ECU-007290,2122,62,42,20,7,8.857142857142858
ECU-007291,2122,10,5,5,1,10.0
ECU-007292,2122,148,73,75,13,11.384615384615385
ECU-007293,2122,419,206,213,14,29.928571428571427
ECU-007294,2122,23,12,11,1,23.0
ECU-007295,2122,59,31,28,3,19.666666666666668
ECU-007296,2122,12,3,9,1,12.0
ECU-007297,2122,73,34,39,2,36.5
ECU-007298,2122,13,7,6,1,13.0
ECU-007299,2122,9,4,5,1,9.0
ECU-007300,2122,85,36,49,8,10.625
ECU-007301,2122,8,2,6,1,8.0
ECU-007302,2122,2,1,1,1,2.0
ECU-007303,2122,6,3,3,1,6.0
ECU-007304,2122,7,3,4,1,7.0
ECU-007305,2122,7,4,3,1,7.0
ECU-007306,2122,2,0,2,1,2.0
ECU-007307,2122,82,49,33,6,13.666666666666666
ECU-007308,2122,44,31,13,5,8.8
ECU-007309,2122,34,17,17,3,11.333333333333334
ECU-007310,2122,16,8,8,3,5.333333333333333
ECU-007311,2122,623,333,290,32,19.46875
ECU-007312,2122,7,2,5,2,3.5
ECU-007313,2122,74,38,36,7,10.571428571428571
ECU-007314,2122,15,8,7,1,15.0
ECU-007315,2122,49,28,21,4,12.25
ECU-007316,2122,33,12,21,2,16.5
ECU-007317,2122,2,1,1,1,2.0
ECU-007318,2122,8,6,2,1,8.0
ECU-007319,2122,48,12,36,4,12.0
ECU-007320,2122,24,8,16,8,3.0
ECU-007321,2122,55,22,33,6,9.166666666666666
ECU-007322,2122,7,1,6,1,7.0
ECU-007323,2122,48,32,16,3,16.0
ECU-007324,2122,33,15,18,7,4.714285714285714
ECU-007325,2122,7,4,3,2,3.5
ECU-007326,2122,5,1,4,1,5.0
ECU-007327,2122,83,45,38,3,27.666666666666668
ECU-007328,2122,192,92,100,12,16.0
ECU-007329,2122,14,6,8,1,14.0
ECU-007330,2122,15,5,10,1,15.0
ECU-007331,2122,580,286,294,20,29.0
ECU-007332,2122,37,18,19,1,37.0
ECU-007333,2122,71,36,35,10,7.1
ECU-007334,2122,232,132,100,9,25.77777777777778
ECU-007335,2122,281,146,135,21,13.380952380952381
ECU-007336,2122,31,17,14,1,31.0
ECU-007337,2122,101,55,46,4,25.25
ECU-007338,2122,3,0,3,1,3.0
ECU-007339,2122,71,30,41,3,23.666666666666668
ECU-007340,2122,120,53,67,9,13.333333333333334
ECU-007341,2122,112,51,61,4,28.0
ECU-007342,2122,454,229,225,17,26.705882352941178
ECU-007343,2122,55,22,33,2,27.5
ECU-007344,2122,42,20,22,2,21.0
ECU-007345,2122,93,42,51,3,31.0
ECU-007346,2122,73,31,42,3,24.333333333333332
ECU-007347,2122,100,56,44,4,25.0
ECU-007348,2122,75,32,43,3,25.0
ECU-007349,2122,47,20,27,2,23.5
ECU-007350,2122,136,62,74,6,22.666666666666668
ECU-007351,2122,201,100,101,8,25.125
ECU-007352,2122,40,13,27,2,20.0
ECU-007353,2122,28,12,16,2,14.0
ECU-007354,2122,71,29,42,3,23.666666666666668
ECU-007355,2122,79,39,40,3,26.333333333333332
ECU-007356,2122,194,82,112,8,24.25
ECU-007357,2122,873,430,443,30,29.1
ECU-007358,2122,1478,746,732,51,28.980392156862745
ECU-007359,2122,60,32,28,3,20.0
ECU-007360,2122,289,147,142,13,22.23076923076923
ECU-007361,2122,1786,924,862,51,35.01960784313726
ECU-007362,2122,592,283,309,18,32.888888888888886
ECU-007363,2122,12,4,8,1,12.0
ECU-007364,2122,107,44,63,3,35.666666666666664
ECU-007365,2122,27,13,14,1,27.0
ECU-007366,2122,1020,517,503,35,29.142857142857142
ECU-007367,2122,70,33,37,2,35.0
ECU-007368,2122,875,436,439,29,30.17241379310345
ECU-007369,2122,20,7,13,1,20.0
ECU-007370,2122,818,393,425,24,34.083333333333336
ECU-007371,2122,274,125,149,9,30.444444444444443
ECU-007372,2122,100,57,43,3,33.333333333333336
ECU-007373,2122,27,8,19,1,27.0
ECU-007374,2122,20,6,14,1,20.0
ECU-007375,2122,100,51,49,4,25.0
ECU-007376,2122,14,10,4,1,14.0
ECU-007377,2122,15,7,8,1,15.0
ECU-007378,2122,6,3,3,1,6.0
ECU-007379,2122,251,122,129,12,20.916666666666668
ECU-007380,2122,27,12,15,1,27.0
ECU-007381,2122,44,21,23,2,22.0
ECU-007382,2122,45,22,23,2,22.5
ECU-007383,2122,18,9,9,1,18.0
ECU-007384,2122,32,18,14,2,16.0
ECU-007385,2122,18,9,9,1,18.0
ECU-007386,2122,38,20,18,1,38.0
ECU-007387,2122,17,6,11,1,17.0
ECU-007388,2122,1951,1095,856,69,28.27536231884058
ECU-007389,2122,11,5,6,1,11.0
ECU-007390,2122,74,39,35,3,24.666666666666668
ECU-007391,2122,479,248,231,19,25.210526315789473
ECU-007392,2122,55,27,28,2,27.5
ECU-007393,2122,53,24,29,2,26.5
ECU-007394,2122,35,22,13,2,17.5
ECU-007395,2122,19,5,14,1,19.0
ECU-007396,2122,16,8,8,1,16.0
ECU-007397,2122,760,360,400,29,26.20689655172414
ECU-007398,2122,252,131,121,12,21.0
ECU-007399,2122,544,270,274,22,24.727272727272727
ECU-007400,2122,319,149,170,15,21.266666666666666
ECU-007401,2122,20,10,10,1,20.0
ECU-007402,2122,19,5,14,1,19.0
ECU-007403,2122,11,4,7,1,11.0
ECU-007404,2122,14,5,9,1,14.0
ECU-007405,2122,22,6,16,1,22.0
ECU-007406,2122,26,16,10,1,26.0
ECU-007407,2122,21,16,5,1,21.0
ECU-007408,2122,18,13,5,1,18.0
ECU-007409,2122,44,25,19,2,22.0
ECU-007410,2122,31,13,18,1,31.0
ECU-007411,2122,17,8,9,1,17.0
ECU-007412,2122,93,53,40,4,23.25
ECU-007413,2122,33,21,12,1,33.0
ECU-007414,2122,21,5,16,1,21.0
ECU-007415,2122,11,9,2,1,11.0
ECU-007416,2122,839,405,434,30,27.966666666666665
ECU-007417,2122,78,37,41,3,26.0
ECU-007418,2122,65,26,39,2,32.5
ECU-007419,2122,23,5,18,1,23.0
ECU-007420,2122,150,67,83,6,25.0
ECU-007421,2122,26,11,15,1,26.0
ECU-007422,2122,27,14,13,1,27.0
ECU-007423,2122,537,264,273,26,20.653846153846153
ECU-007424,2122,24,12,12,1,24.0
ECU-007425,2122,9,6,3,1,9.0
ECU-007426,2122,20,13,7,1,20.0
ECU-007427,2122,45,19,26,2,22.5
ECU-007428,2122,15,7,8,1,15.0
ECU-007429,2122,503,250,253,21,23.952380952380953
ECU-007430,2122,35,17,18,2,17.5
ECU-007431,2122,523,247,276,22,23.772727272727273
ECU-007432,2122,380,175,205,12,31.666666666666668
ECU-007433,2122,1150,528,622,37,31.08108108108108
ECU-007434,2122,73,42,31,3,24.333333333333332
ECU-007435,2122,71,27,44,3,23.666666666666668
ECU-007436,2122,1311,686,625,49,26.755102040816325
ECU-007437,2122,55,27,28,2,27.5
ECU-007438,2122,853,475,378,28,30.464285714285715
ECU-007439,2122,28,12,16,1,28.0
ECU-007440,2122,79,38,41,3,26.333333333333332
ECU-007441,2122,17,8,9,1,17.0
ECU-007442,2122,39,15,24,2,19.5
ECU-007443,2122,974,468,506,30,32.46666666666667
ECU-007444,2122,26,18,8,1,26.0
ECU-007445,2122,35,14,21,2,17.5
ECU-007446,2122,237,111,126,7,33.857142857142854
ECU-007447,2122,701,340,361,29,24.17241379310345
ECU-007448,2122,200,93,107,15,13.333333333333334
ECU-007449,2122,409,226,183,22,18.59090909090909
ECU-007450,2122,131,47,84,8,16.375
ECU-007451,2122,109,50,59,5,21.8
ECU-007452,2122,101,46,55,4,25.25
ECU-007453,2122,39,16,23,2,19.5
ECU-007454,2122,9,5,4,1,9.0
ECU-007455,2122,225,103,122,10,22.5
ECU-007456,2122,470,244,226,17,27.647058823529413
ECU-007457,2122,19,8,11,1,19.0
ECU-007458,2122,27,15,12,1,27.0
ECU-007459,2122,457,225,232,16,28.5625
ECU-007460,2122,448,255,193,17,26.352941176470587
ECU-007461,2122,1081,535,546,39,27.71794871794872
ECU-007462,2122,26,12,14,1,26.0
ECU-007463,2122,13,7,6,1,13.0
ECU-007464,2122,46,17,29,1,46.0
ECU-007465,2122,41,26,15,2,20.5
ECU-007466,2122,33,14,19,1,33.0
ECU-007467,2122,12,5,7,1,12.0
ECU-007468,2122,30,16,14,1,30.0
ECU-007469,2122,15,9,6,1,15.0
ECU-007470,2122,51,29,22,2,25.5
ECU-007471,2122,31,14,17,1,31.0
ECU-007472,2122,26,16,10,1,26.0
ECU-007473,2122,21,8,13,1,21.0
ECU-007474,2122,44,20,24,1,44.0
ECU-007475,2122,33,18,15,1,33.0
ECU-007476,2122,24,10,14,1,24.0
ECU-007477,2122,24,12,12,1,24.0
ECU-007478,2122,12,11,1,1,12.0
ECU-007479,2122,25,12,13,1,25.0
ECU-007480,2122,108,48,60,4,27.0
ECU-007481,2122,12,3,9,1,12.0
ECU-007482,2122,44,14,30,2,22.0
ECU-007483,2122,36,19,17,2,18.0
ECU-007484,2122,26,15,11,1,26.0
ECU-007485,2122,696,360,336,24,29.0
ECU-007486,2122,50,24,26,2,25.0
ECU-007487,2122,23,14,9,1,23.0
ECU-007488,2122,16,7,9,1,16.0
ECU-007489,2122,156,90,66,8,19.5
ECU-007490,2122,273,147,126,14,19.5
ECU-007491,2122,16,11,5,1,16.0
ECU-007492,2122,43,23,20,2,21.5
ECU-007493,2122,731,399,332,34,21.5
ECU-007494,2122,56,25,31,2,28.0
ECU-007495,2122,92,44,48,3,30.666666666666668
ECU-007496,2122,46,23,23,2,23.0
ECU-007497,2122,12,5,7,1,12.0
ECU-007498,2122,8,4,4,1,8.0
ECU-007499,2122,40,17,23,2,20.0
ECU-007500,2122,142,66,76,5,28.4
ECU-007501,2122,821,821,0,36,22.805555555555557
ECU-007502,2122,274,129,145,9,30.444444444444443
ECU-007503,2122,670,306,364,18,37.22222222222222
ECU-007504,2122,315,156,159,13,24.23076923076923
ECU-007505,2122,1012,465,547,35,28.914285714285715
ECU-007506,2122,1287,638,649,45,28.6
ECU-007507,2122,131,77,54,4,32.75
ECU-007508,2122,604,326,278,17,35.529411764705884
ECU-007509,2122,131,78,53,5,26.2
ECU-007510,2122,332,164,168,12,27.666666666666668
ECU-007511,2122,1802,957,845,67,26.895522388059703
ECU-007512,2122,22,8,14,3,7.333333333333333
ECU-007513,2122,33,13,20,1,33.0
ECU-007514,2122,25,9,16,1,25.0
ECU-007515,2122,77,41,36,3,25.666666666666668
ECU-007516,2122,1809,874,935,61,29.65573770491803
ECU-007517,2122,116,59,57,4,29.0
ECU-007518,2122,62,35,27,6,10.333333333333334
ECU-007519,2122,873,500,373,35,24.942857142857143
ECU-007520,2122,54,21,33,2,27.0
ECU-007521,2122,1943,837,1106,82,23.695121951219512
ECU-007522,2122,268,136,132,9,29.77777777777778
ECU-007523,2122,29,14,15,2,14.5
ECU-007524,2122,39,17,22,5,7.8
ECU-007525,2122,62,36,26,6,10.333333333333334
ECU-007526,2122,175,100,75,11,15.909090909090908
ECU-007527,2122,761,384,377,26,29.26923076923077
ECU-007528,2122,45,27,18,2,22.5
ECU-007529,2122,1085,511,574,42,25.833333333333332
ECU-007530,2122,448,227,221,31,14.451612903225806
ECU-007531,2122,27,9,18,6,4.5
ECU-007532,2122,365,177,188,12,30.416666666666668
ECU-007533,2122,19,8,11,1,19.0
ECU-007534,2122,445,241,204,16,27.8125
ECU-007535,2122,201,105,96,8,25.125
ECU-007536,2122,598,286,312,19,31.473684210526315
ECU-007537,2122,278,126,152,9,30.88888888888889
ECU-007538,2122,104,60,44,3,34.666666666666664
ECU-007539,2122,14,8,6,1,14.0
ECU-007540,2122,11,4,7,1,11.0
ECU-007541,2122,22,10,12,1,22.0
ECU-007542,2122,25,11,14,1,25.0
ECU-007543,2122,100,51,49,3,33.333333333333336
ECU-007544,2122,1956,1001,955,73,26.794520547945204
ECU-007545,2122,17,12,5,1,17.0
ECU-007546,2122,197,97,100,8,24.625
ECU-007547,2122,79,37,42,3,26.333333333333332
ECU-007548,2122,16,10,6,1,16.0
ECU-007549,2122,49,28,21,2,24.5
ECU-007550,2122,244,124,120,8,30.5
ECU-007551,2122,513,255,258,20,25.65
ECU-007552,2122,47,20,27,2,23.5
ECU-007553,2122,14,9,5,1,14.0
ECU-007554,2122,27,19,8,1,27.0
ECU-007555,2122,271,151,120,16,16.9375
ECU-007556,2122,66,36,30,2,33.0
ECU-007557,2122,45,22,23,2,22.5
ECU-007558,2122,18,4,14,1,18.0
ECU-007559,2122,73,37,36,2,36.5
ECU-007560,2122,20,11,9,1,20.0
ECU-007561,2122,396,178,218,19,20.842105263157894
ECU-007562,2122,26,14,12,1,26.0
ECU-007563,2122,29,12,17,1,29.0
ECU-007564,2122,26,14,12,1,26.0
ECU-007565,2122,26,14,12,1,26.0
ECU-007566,2122,43,20,23,2,21.5
ECU-007567,2122,32,14,18,1,32.0
ECU-007568,2122,38,19,19,2,19.0
ECU-007569,2122,56,30,26,2,28.0
ECU-007570,2122,32,11,21,1,32.0
ECU-007571,2122,416,202,214,17,24.470588235294116
ECU-007572,2122,81,40,41,3,27.0
ECU-007573,2122,508,256,252,13,39.07692307692308
ECU-007574,2122,184,97,87,7,26.285714285714285
ECU-007575,2122,12,2,10,1,12.0
ECU-007576,2122,48,20,28,2,24.0
ECU-007577,2122,44,20,24,2,22.0
ECU-007578,2122,52,21,31,2,26.0
ECU-007579,2122,66,37,29,2,33.0
ECU-007580,2122,42,17,25,2,21.0
ECU-007581,2122,36,17,19,2,18.0
ECU-007582,2122,531,263,268,18,29.5
ECU-007583,2122,134,79,55,4,33.5
ECU-007584,2122,30,17,13,1,30.0
ECU-007585,2122,62,28,34,2,31.0
ECU-007586,2122,28,12,16,1,28.0
ECU-007587,2122,223,112,111,8,27.875
ECU-007588,2122,86,45,41,3,28.666666666666668
ECU-007589,2122,50,20,30,2,25.0
ECU-007590,2122,32,14,18,2,16.0
ECU-007591,2122,39,15,24,2,19.5
ECU-007592,2122,44,22,22,2,22.0
ECU-007593,2122,96,45,51,4,24.0
ECU-007594,2122,29,13,16,1,29.0
ECU-007595,2122,878,457,421,28,31.357142857142858
ECU-007596,2122,172,87,85,13,13.23076923076923
ECU-007597,2122,638,298,340,21,30.38095238095238
ECU-007598,2122,52,33,19,2,26.0
ECU-007599,2122,47,17,30,2,23.5
ECU-007600,2122,20,11,9,1,20.0
ECU-007601,2122,23,10,13,1,23.0
ECU-007602,2122,139,75,64,8,17.375
ECU-007603,2122,898,433,465,25,35.92
ECU-007604,2122,66,32,34,2,33.0
ECU-007605,2122,338,166,172,11,30.727272727272727
ECU-007606,2122,26,8,18,1,26.0
ECU-007607,2122,40,21,19,2,20.0
ECU-007608,2122,18,12,6,1,18.0
ECU-007609,2122,35,19,16,2,17.5
ECU-007610,2122,81,50,31,2,40.5
ECU-007611,2122,61,35,26,3,20.333333333333332
ECU-007612,2122,213,106,107,9,23.666666666666668
ECU-007613,2122,36,18,18,1,36.0
ECU-007614,2122,79,42,37,3,26.333333333333332
ECU-007615,2122,38,18,20,2,19.0
ECU-007616,2122,252,104,148,11,22.90909090909091
ECU-007617,2122,984,489,495,44,22.363636363636363
ECU-007618,2122,53,19,34,2,26.5
ECU-007619,2122,880,403,477,31,28.387096774193548
ECU-007620,2122,147,71,76,9,16.333333333333332
ECU-007621,2122,1224,613,611,42,29.142857142857142
ECU-007622,2122,379,194,185,22,17.227272727272727
ECU-007623,2122,476,226,250,17,28.0
ECU-007624,2122,230,114,116,20,11.5
ECU-007625,2122,737,353,384,26,28.346153846153847
ECU-007626,2122,333,174,159,9,37.0
ECU-007627,2122,16,8,8,1,16.0
ECU-007628,2122,687,304,383,32,21.46875
ECU-007629,2122,1225,998,227,158,7.753164556962025
ECU-007630,2122,245,131,114,11,22.272727272727273
ECU-007631,2122,213,111,102,9,23.666666666666668
ECU-007632,2122,97,45,52,4,24.25
ECU-007633,2122,54,25,29,2,27.0
ECU-007634,2122,28,10,18,1,28.0
ECU-007635,2122,61,25,36,2,30.5
ECU-007636,2122,8,5,3,1,8.0
ECU-007637,2122,230,112,118,11,20.90909090909091
ECU-007638,2122,5,3,2,1,5.0
ECU-007639,2122,796,403,393,29,27.448275862068964
ECU-007640,2122,17,10,7,1,17.0
ECU-007641,2122,83,33,50,2,41.5
ECU-007642,2122,28,14,14,1,28.0
ECU-007643,2122,48,23,25,2,24.0
ECU-007644,2122,104,48,56,6,17.333333333333332
ECU-007645,2122,178,95,83,16,11.125
ECU-007646,2122,35,14,21,2,17.5
ECU-007647,2122,106,53,53,3,35.333333333333336
ECU-007648,2122,87,49,38,4,21.75
ECU-007649,2122,34,19,15,1,34.0
ECU-007650,2122,47,20,27,3,15.666666666666666
ECU-007651,2122,446,244,202,20,22.3
ECU-007652,2122,325,156,169,11,29.545454545454547
ECU-007653,2122,673,337,336,21,32.04761904761905
ECU-007654,2122,34,17,17,1,34.0
ECU-007655,2122,257,126,131,9,28.555555555555557
ECU-007656,2122,153,64,89,7,21.857142857142858
ECU-007657,2122,16,7,9,1,16.0
ECU-007658,2122,1071,527,544,43,24.906976744186046
ECU-007659,2122,1588,795,793,56,28.357142857142858
ECU-007660,2122,163,78,85,7,23.285714285714285
ECU-007661,2122,593,289,304,18,32.94444444444444
ECU-007662,2122,36,14,22,1,36.0
ECU-007663,2122,526,274,252,17,30.941176470588236
ECU-007664,2122,555,272,283,18,30.833333333333332
ECU-007665,2122,961,465,496,36,26.694444444444443
ECU-007666,2122,3183,1684,1499,116,27.439655172413794
ECU-007667,2122,69,47,22,2,34.5
ECU-007668,2122,88,46,42,4,22.0
ECU-007669,2122,212,95,117,8,26.5
ECU-007670,2122,212,91,121,12,17.666666666666668
ECU-007671,2122,964,485,479,32,30.125
ECU-007672,2122,500,274,226,16,31.25
ECU-007673,2122,145,73,72,4,36.25
ECU-007674,2122,200,95,105,8,25.0
ECU-007675,2122,606,307,299,25,24.24
ECU-007676,2122,234,112,122,10,23.4
ECU-007677,2122,296,144,152,12,24.666666666666668
ECU-007678,2122,17,8,9,2,8.5
ECU-007679,2122,61,26,35,12,5.083333333333333
ECU-007680,2122,220,94,126,9,24.444444444444443
ECU-007681,2122,439,211,228,15,29.266666666666666
ECU-007682,2122,1009,536,473,38,26.55263157894737
ECU-007683,2122,758,360,398,26,29.153846153846153
ECU-007684,2122,736,350,386,25,29.44
ECU-007685,2122,259,135,124,9,28.77777777777778
ECU-007686,2122,40,24,16,2,20.0
ECU-007687,2122,54,27,27,2,27.0
ECU-007688,2122,622,312,310,23,27.043478260869566
ECU-007689,2122,376,183,193,15,25.066666666666666
ECU-007690,2122,204,95,109,8,25.5
ECU-007691,2122,33,10,23,2,16.5
ECU-007692,2122,287,147,140,11,26.09090909090909
ECU-007693,2122,87,35,52,3,29.0
ECU-007694,2122,48,24,24,2,24.0
ECU-007695,2122,609,335,274,21,29.0
ECU-007696,2122,36,16,20,1,36.0
ECU-007697,2122,13,8,5,1,13.0
ECU-007698,2122,102,45,57,4,25.5
ECU-007699,2122,318,173,145,13,24.46153846153846
ECU-007700,2122,44,16,28,2,22.0
ECU-007701,2122,45,18,27,2,22.5
ECU-007702,2122,169,76,93,10,16.9
ECU-007703,2122,21,14,7,1,21.0
ECU-007704,2122,42,12,30,2,21.0
ECU-007705,2122,18,12,6,1,18.0
ECU-007706,2122,14,9,5,1,14.0
ECU-007707,2122,301,162,139,9,33.44444444444444
ECU-007708,2122,41,22,19,1,41.0
ECU-007709,2122,28,9,19,1,28.0
ECU-007710,2122,77,46,31,4,19.25
ECU-007711,2122,21,15,6,1,21.0
ECU-007712,2122,280,178,102,12,23.333333333333332
ECU-007713,2122,62,22,40,2,31.0
ECU-007714,2122,128,56,72,7,18.285714285714285
ECU-007715,2122,24,14,10,1,24.0
ECU-007716,2122,30,17,13,1,30.0
ECU-007717,2122,13,7,6,1,13.0
ECU-007718,2122,95,38,57,5,19.0
ECU-007719,2122,25,11,14,1,25.0
ECU-007720,2122,57,31,26,2,28.5
ECU-007721,2122,18,10,8,1,18.0
ECU-007722,2122,172,84,88,6,28.666666666666668
ECU-007723,2122,9,4,5,1,9.0
ECU-007724,2122,22,12,10,1,22.0
ECU-007725,2122,36,12,24,1,36.0
ECU-007726,2122,24,12,12,1,24.0
ECU-007727,2122,40,15,25,2,20.0
ECU-007728,2122,312,161,151,9,34.666666666666664
ECU-007729,2122,242,123,119,8,30.25
ECU-007730,2122,17,8,9,1,17.0
ECU-007731,2122,8,4,4,1,8.0
ECU-007732,2122,31,14,17,1,31.0
ECU-007733,2122,41,28,13,2,20.5
ECU-007734,2122,28,21,7,1,28.0
ECU-007735,2122,155,78,77,7,22.142857142857142
ECU-007736,2122,59,35,24,3,19.666666666666668
ECU-007737,2122,20,9,11,1,20.0
ECU-007738,2122,591,315,276,24,24.625
ECU-007739,2122,88,47,41,3,29.333333333333332
ECU-007740,2122,32,13,19,2,16.0
ECU-007741,2122,26,13,13,2,13.0
ECU-007742,2122,239,133,106,11,21.727272727272727
ECU-007743,2122,119,60,59,4,29.75
ECU-007744,2122,66,34,32,4,16.5
ECU-007745,2122,22,4,18,2,11.0
ECU-007746,2122,21,8,13,1,21.0
ECU-007747,2122,1304,651,653,43,30.325581395348838
ECU-007748,2122,322,152,170,15,21.466666666666665
ECU-007749,2122,317,164,153,11,28.818181818181817
ECU-007750,2122,440,215,225,15,29.333333333333332
ECU-007751,2122,255,125,130,10,25.5
ECU-007752,2122,25,15,10,1,25.0
ECU-007753,2122,57,22,35,2,28.5
ECU-007754,2122,51,21,30,2,25.5
ECU-007755,2122,38,20,18,2,19.0
ECU-007756,2122,232,118,114,14,16.571428571428573
ECU-007757,2122,19,9,10,1,19.0
ECU-007758,2122,196,97,99,9,21.77777777777778
ECU-007759,2122,269,132,137,9,29.88888888888889
ECU-007760,2122,309,160,149,12,25.75
ECU-007761,2122,511,246,265,17,30.058823529411764
ECU-007762,2122,1272,603,669,42,30.285714285714285
ECU-007763,2122,194,114,80,11,17.636363636363637
ECU-007764,2122,33,22,11,2,16.5
ECU-007765,2122,239,122,117,8,29.875
ECU-007766,2122,14,3,11,1,14.0
ECU-007767,2122,21,9,12,3,7.0
ECU-007768,2122,353,182,171,12,29.416666666666668
ECU-007769,2122,30,16,14,1,30.0
ECU-007770,2122,417,206,211,14,29.785714285714285
ECU-007771,2122,54,27,27,2,27.0
ECU-007772,2122,8,6,2,1,8.0
ECU-007773,2122,30,17,13,2,15.0
ECU-007774,2122,1154,646,508,42,27.476190476190474
ECU-007775,2122,595,307,288,19,31.31578947368421
ECU-007776,2122,369,181,188,16,23.0625
ECU-007777,2122,146,99,47,5,29.2
ECU-007778,2122,902,488,414,37,24.37837837837838
ECU-007779,2122,21,12,9,4,5.25
ECU-007780,2122,230,110,120,5,46.0
ECU-007781,2122,2325,1133,1192,88,26.420454545454547
ECU-007782,2122,604,193,411,22,27.454545454545453
ECU-007783,2122,1190,595,595,52,22.884615384615383
ECU-007784,2122,419,178,241,17,24.647058823529413
ECU-007785,2122,41,16,25,2,20.5
ECU-007786,2122,120,55,65,5,24.0
ECU-007787,2122,1349,613,736,49,27.53061224489796
ECU-007788,2122,2197,1163,1034,68,32.30882352941177
ECU-007789,2122,555,242,313,21,26.428571428571427
ECU-007790,2122,213,125,88,8,26.625
ECU-007791,2122,698,382,316,25,27.92
ECU-007792,2122,4201,2446,1755,149,28.19463087248322
ECU-007793,2122,831,406,425,23,36.130434782608695
ECU-007794,2122,746,390,356,34,21.941176470588236
ECU-007795,2122,390,176,214,15,26.0
ECU-007796,2122,1426,481,945,85,16.776470588235295
ECU-007797,2122,1137,536,601,30,37.9
ECU-007798,2122,65,32,33,3,21.666666666666668
ECU-007799,2122,162,82,80,6,27.0
ECU-007800,2122,319,143,176,16,19.9375
ECU-007801,2122,120,52,68,5,24.0
ECU-007802,2122,564,282,282,17,33.1764705882353
ECU-007803,2122,2762,1581,1181,80,34.525
ECU-007804,2122,240,111,129,8,30.0
ECU-007805,2122,76,32,44,10,7.6
ECU-007806,2122,1438,690,748,42,34.23809523809524
ECU-007807,2122,476,246,230,20,23.8
ECU-007808,2122,480,216,264,27,17.77777777777778
ECU-007809,2122,579,290,289,23,25.17391304347826
ECU-007810,2122,929,468,461,30,30.966666666666665
ECU-007811,2122,217,98,119,13,16.692307692307693
ECU-007812,2122,1274,408,866,56,22.75
ECU-007813,2122,959,498,461,28,34.25
ECU-007814,2122,27,9,18,1,27.0
ECU-007815,2122,1092,526,566,35,31.2
ECU-007816,2122,716,334,382,33,21.696969696969695
ECU-007817,2122,679,294,385,24,28.291666666666668
ECU-007818,2122,217,105,112,8,27.125
ECU-007819,2122,1196,613,583,36,33.22222222222222
ECU-007820,2122,157,86,71,10,15.7
ECU-007821,2122,575,292,283,21,27.38095238095238
ECU-007822,2122,46,20,26,2,23.0
ECU-007823,2122,137,80,57,11,12.454545454545455
ECU-007824,2122,453,453,0,24,18.875
ECU-007825,2122,178,77,101,11,16.181818181818183
ECU-007826,2122,323,156,167,11,29.363636363636363
ECU-007827,2122,25,14,11,1,25.0
ECU-007828,2122,841,405,436,29,29.0
ECU-007829,2122,26,14,12,1,26.0
ECU-007830,2122,17,5,12,1,17.0
ECU-007831,2122,175,80,95,7,25.0
ECU-007832,2122,43,24,19,2,21.5
ECU-007833,2122,277,141,136,9,30.77777777777778
ECU-007834,2122,80,41,39,2,40.0
ECU-007835,2122,64,39,25,2,32.0
ECU-007836,2122,122,62,60,5,24.4
ECU-007837,2122,91,41,50,3,30.333333333333332
ECU-007838,2122,1239,642,597,49,25.285714285714285
ECU-007839,2122,1401,703,698,35,40.02857142857143
ECU-007840,2122,19,8,11,1,19.0
ECU-007841,2122,719,353,366,22,32.68181818181818
ECU-007842,2122,180,99,81,6,30.0
ECU-007843,2122,60,32,28,2,30.0
ECU-007844,2122,96,41,55,2,48.0
ECU-007845,2122,85,44,41,10,8.5
ECU-007846,2122,1717,915,802,74,23.2027027027027
ECU-007847,2122,591,303,288,15,39.4
ECU-007848,2122,1599,783,816,42,38.07142857142857
ECU-007849,2122,65,47,18,2,32.5
ECU-007850,2122,65,36,29,2,32.5
ECU-007851,2122,1937,928,1009,50,38.74
ECU-007852,2122,1544,775,769,47,32.851063829787236
ECU-007853,2122,998,507,491,41,24.341463414634145
ECU-007854,2122,1149,636,513,40,28.725
ECU-007855,2122,81,35,46,5,16.2
ECU-007856,2122,16,7,9,1,16.0
ECU-007857,2122,56,26,30,2,28.0
ECU-007858,2122,66,35,31,2,33.0
ECU-007859,2122,29,8,21,1,29.0
ECU-007860,2122,55,28,27,3,18.333333333333332
ECU-007861,2122,34,17,17,1,34.0
ECU-007862,2122,255,149,106,8,31.875
ECU-007863,2122,49,21,28,1,49.0
ECU-007864,2122,750,344,406,24,31.25
ECU-007865,2122,24,13,11,1,24.0
ECU-007866,2122,135,68,67,5,27.0
ECU-007867,2122,36,18,18,2,18.0
ECU-007868,2122,666,334,332,25,26.64
ECU-007869,2122,34,16,18,1,34.0
ECU-007870,2122,15,9,6,1,15.0
ECU-007871,2122,84,37,47,3,28.0
ECU-007872,2122,353,182,171,14,25.214285714285715
ECU-007873,2122,785,383,402,22,35.68181818181818
ECU-007874,2122,9,2,7,1,9.0
ECU-007875,2122,27,8,19,1,27.0
ECU-007876,2122,876,456,420,29,30.20689655172414
ECU-007877,2122,25,14,11,1,25.0
ECU-007878,2122,604,304,300,23,26.26086956521739
ECU-007879,2122,66,33,33,2,33.0
ECU-007880,2122,177,75,102,6,29.5
ECU-007881,2122,121,48,73,3,40.333333333333336
ECU-007882,2122,31,11,20,1,31.0
ECU-007883,2122,98,54,44,3,32.666666666666664
ECU-007884,2122,15,8,7,1,15.0
ECU-007885,2122,18,8,10,1,18.0
ECU-007886,2122,832,474,358,26,32.0
ECU-007887,2122,17,11,6,1,17.0
ECU-007888,2122,142,80,62,12,11.833333333333334
ECU-007889,2122,237,114,123,12,19.75
ECU-007890,2122,26,11,15,1,26.0
ECU-007891,2122,34,15,19,2,17.0
ECU-007892,2122,412,208,204,15,27.466666666666665
ECU-007893,2122,648,316,332,27,24.0
ECU-007894,2122,1445,666,779,57,25.350877192982455
ECU-007895,2122,104,46,58,7,14.857142857142858
ECU-007896,2122,35,22,13,2,17.5
ECU-007897,2122,2274,1259,1015,74,30.72972972972973
ECU-007898,2122,148,81,67,5,29.6
ECU-007899,2122,65,34,31,3,21.666666666666668
ECU-007900,2122,212,123,89,8,26.5
ECU-007901,2122,106,59,47,4,26.5
ECU-007902,2122,180,89,91,8,22.5
ECU-007903,2122,32,14,18,1,32.0
ECU-007904,2122,17,10,7,1,17.0
ECU-007905,2122,856,416,440,27,31.703703703703702
ECU-007906,2122,1061,520,541,30,35.36666666666667
ECU-007907,2122,32,18,14,2,16.0
ECU-007908,2122,313,145,168,7,44.714285714285715
ECU-007909,2122,1350,676,674,50,27.0
ECU-007910,2122,141,71,70,5,28.2
ECU-007911,2122,29,15,14,2,14.5
ECU-007912,2122,895,403,492,31,28.870967741935484
ECU-007913,2122,90,45,45,4,22.5
ECU-007914,2122,102,50,52,4,25.5
ECU-007915,2122,18,11,7,1,18.0
ECU-007916,2122,55,24,31,2,27.5
ECU-007917,2122,117,46,71,5,23.4
ECU-007918,2122,557,294,263,18,30.944444444444443
ECU-007919,2122,33,19,14,2,16.5
ECU-007920,2122,43,21,22,2,21.5
ECU-007921,2122,81,44,37,3,27.0
ECU-007922,2122,89,37,52,4,22.25
ECU-007923,2122,36,19,17,2,18.0
ECU-007924,2122,34,19,15,2,17.0
ECU-007925,2122,104,43,61,4,26.0
ECU-007926,2122,20,6,14,1,20.0
ECU-007927,2122,225,106,119,8,28.125
ECU-007928,2122,33,15,18,2,16.5
ECU-007929,2122,8,4,4,1,8.0
ECU-007930,2122,56,20,36,12,4.666666666666667
ECU-007931,2122,77,37,40,2,38.5
ECU-007932,2122,31,10,21,1,31.0
ECU-007933,2122,245,120,125,10,24.5
ECU-007934,2122,502,251,251,17,29.529411764705884
ECU-007935,2122,6,2,4,1,6.0
ECU-007936,2122,60,36,24,2,30.0
ECU-007937,2122,471,218,253,16,29.4375
ECU-007938,2122,22,11,11,1,22.0
ECU-007939,2122,81,44,37,3,27.0
ECU-007940,2122,23,10,13,1,23.0
ECU-007941,2122,11,7,4,1,11.0
ECU-007942,2122,56,27,29,2,28.0
ECU-007943,2122,8,4,4,1,8.0
ECU-007944,2122,32,14,18,1,32.0
ECU-007945,2122,556,251,305,16,34.75
ECU-007946,2122,20,7,13,1,20.0
ECU-007947,2122,10,2,8,1,10.0
ECU-007948,2122,9,4,5,1,9.0
ECU-007949,2122,409,197,212,26,15.73076923076923
ECU-007950,2122,28,7,21,1,28.0
ECU-007951,2122,17,8,9,1,17.0
ECU-007952,2122,131,59,72,5,26.2
ECU-007953,2122,14,5,9,1,14.0
ECU-007954,2122,422,212,210,15,28.133333333333333
ECU-007955,2122,12,5,7,1,12.0
ECU-007956,2122,21,12,9,1,21.0
ECU-007957,2122,20,13,7,1,20.0
ECU-007958,2122,43,16,27,2,21.5
ECU-007959,2122,45,22,23,2,22.5
ECU-007960,2122,10,4,6,1,10.0
ECU-007961,2122,27,13,14,1,27.0
ECU-007962,2122,25,10,15,1,25.0
ECU-007963,2122,12,8,4,1,12.0
ECU-007964,2122,60,29,31,2,30.0
ECU-007965,2122,24,16,8,1,24.0
ECU-007966,2122,51,27,24,2,25.5
ECU-007967,2122,16,9,7,1,16.0
ECU-007968,2122,30,16,14,1,30.0
ECU-007969,2122,21,13,8,1,21.0
ECU-007970,2122,246,134,112,10,24.6
ECU-007971,2122,36,18,18,1,36.0
ECU-007972,2122,308,151,157,12,25.666666666666668
ECU-007973,2122,22,3,19,1,22.0
ECU-007974,2122,16,7,9,1,16.0
ECU-007975,2122,24,24,0,1,24.0
ECU-007976,2122,98,42,56,6,16.333333333333332
ECU-007977,2122,953,467,486,30,31.766666666666666
ECU-007978,2122,178,90,88,7,25.428571428571427
ECU-007979,2122,2008,1014,994,67,29.970149253731343
ECU-007980,2122,342,147,195,11,31.09090909090909
ECU-007981,2122,342,175,167,11,31.09090909090909
ECU-007982,2122,270,130,140,10,27.0
ECU-007983,2122,16,8,8,1,16.0
ECU-007984,2122,19,14,5,1,19.0
ECU-007985,2122,13,5,8,1,13.0
ECU-007986,2122,37,17,20,1,37.0
ECU-007987,2122,55,30,25,2,27.5
ECU-007988,2122,45,21,24,2,22.5
ECU-007989,2122,126,65,61,5,25.2
ECU-007990,2122,441,210,231,17,25.941176470588236
ECU-007991,2122,36,18,18,1,36.0
ECU-007992,2122,2470,1195,1275,81,30.493827160493826
ECU-007993,2122,26,16,10,1,26.0
ECU-007994,2122,42,16,26,2,21.0
ECU-007995,2122,827,399,428,30,27.566666666666666
ECU-007996,2122,49,26,23,2,24.5
ECU-007997,2122,4,3,1,1,4.0
ECU-007998,2122,608,294,314,24,25.333333333333332
ECU-007999,2122,21,12,9,1,21.0
ECU-008000,2122,16,7,9,1,16.0
ECU-008001,2122,1831,944,887,63,29.063492063492063
ECU-008002,2122,84,42,42,3,28.0
ECU-008003,2122,154,97,57,11,14.0
ECU-008004,2122,38,14,24,5,7.6
ECU-008005,2122,278,154,124,12,23.166666666666668
ECU-008006,2122,19,10,9,1,19.0
ECU-008007,2122,107,43,64,4,26.75
ECU-008008,2122,168,87,81,5,33.6
ECU-008009,2122,44,20,24,3,14.666666666666666
ECU-008010,2122,350,167,183,10,35.0
ECU-008011,2122,83,43,40,3,27.666666666666668
ECU-008012,2122,80,40,40,3,26.666666666666668
ECU-008013,2122,48,21,27,6,8.0
ECU-008014,2122,19,9,10,1,19.0
ECU-008015,2122,18,8,10,1,18.0
ECU-008016,2122,42,17,25,2,21.0
ECU-008017,2122,33,20,13,1,33.0
ECU-008018,2122,272,138,134,9,30.22222222222222
ECU-008019,2122,1145,548,597,35,32.714285714285715
ECU-008020,2122,585,271,314,30,19.5
ECU-008021,2122,81,34,47,3,27.0
ECU-008022,2122,789,369,420,25,31.56
ECU-008023,2122,109,54,55,4,27.25
ECU-008024,2122,190,93,97,8,23.75
ECU-008025,2122,24,13,11,1,24.0
ECU-008026,2122,277,131,146,9,30.77777777777778
ECU-008027,2122,89,35,54,3,29.666666666666668
ECU-008028,2122,19,9,10,1,19.0
ECU-008029,2122,21,8,13,1,21.0
ECU-008030,2122,21,10,11,1,21.0
ECU-008031,2122,77,31,46,3,25.666666666666668
ECU-008032,2122,21,15,6,1,21.0
ECU-008033,2122,200,106,94,9,22.22222222222222
ECU-008034,2122,192,92,100,8,24.0
ECU-008035,2122,131,55,76,4,32.75
ECU-008036,2122,128,54,74,4,32.0
ECU-008037,2122,14,6,8,1,14.0
ECU-008038,2122,138,57,81,5,27.6
ECU-008039,2122,213,108,105,10,21.3
ECU-008040,2122,25,11,14,1,25.0
ECU-008041,2122,116,45,71,4,29.0
ECU-008042,2122,22,7,15,1,22.0
ECU-008043,2122,121,79,42,6,20.166666666666668
ECU-008044,2122,28,12,16,1,28.0
ECU-008045,2122,108,50,58,4,27.0
ECU-008046,2122,19,10,9,1,19.0
ECU-008047,2122,233,110,123,15,15.533333333333333
ECU-008048,2122,37,20,17,2,18.5
ECU-008049,2122,57,24,33,2,28.5
ECU-008050,2122,40,11,29,2,20.0
ECU-008051,2122,27,15,12,2,13.5
ECU-008052,2122,25,13,12,1,25.0
ECU-008053,2122,801,381,420,29,27.620689655172413
ECU-008054,2122,134,76,58,5,26.8
ECU-008055,2122,201,98,103,9,22.333333333333332
ECU-008056,2122,105,40,65,4,26.25
ECU-008057,2122,28,14,14,1,28.0
ECU-008058,2122,22,9,13,1,22.0
ECU-008059,2122,40,22,18,2,20.0
ECU-008060,2122,303,144,159,12,25.25
ECU-008061,2122,11,6,5,1,11.0
ECU-008062,2122,77,39,38,3,25.666666666666668
ECU-008063,2122,1159,493,666,41,28.26829268292683
ECU-008064,2122,14,2,12,1,14.0
ECU-008065,2122,22,10,12,1,22.0
ECU-008066,2122,10,4,6,1,10.0
ECU-008067,2122,93,57,36,4,23.25
ECU-008068,2122,368,185,183,19,19.36842105263158
ECU-008069,2122,229,117,112,8,28.625
ECU-008070,2122,2431,1323,1108,98,24.806122448979593
ECU-008071,2122,448,201,247,17,26.352941176470587
ECU-008072,2122,78,41,37,3,26.0
ECU-008073,2122,312,159,153,11,28.363636363636363
ECU-008074,2122,329,183,146,28,11.75
ECU-008075,2122,9,4,5,1,9.0
ECU-008076,2122,1071,508,563,42,25.5
ECU-008077,2122,72,44,28,3,24.0
ECU-008078,2122,95,47,48,4,23.75
ECU-008079,2122,12,8,4,1,12.0
ECU-008080,2122,395,188,207,15,26.333333333333332
ECU-008081,2122,616,307,309,29,21.24137931034483
ECU-008082,2122,491,239,252,23,21.347826086956523
ECU-008083,2122,39,17,22,2,19.5
ECU-008084,2122,13,6,7,1,13.0
ECU-008085,2122,19,5,14,1,19.0
ECU-008086,2122,48,26,22,3,16.0
ECU-008087,2122,13,4,9,1,13.0
ECU-008088,2122,60,29,31,2,30.0
ECU-008089,2122,37,10,27,2,18.5
ECU-008090,2122,81,44,37,3,27.0
ECU-008091,2122,36,19,17,2,18.0
ECU-008092,2122,19,8,11,1,19.0
ECU-008093,2122,98,52,46,5,19.6
ECU-008094,2122,35,18,17,1,35.0
ECU-008095,2122,288,155,133,10,28.8
ECU-008096,2122,27,11,16,1,27.0
ECU-008097,2122,17,9,8,1,17.0
ECU-008098,2122,173,89,84,9,19.22222222222222
ECU-008099,2122,27,15,12,2,13.5
ECU-008100,2122,120,51,69,4,30.0
ECU-008101,2122,406,200,206,17,23.88235294117647
ECU-008102,2122,22,13,9,1,22.0
ECU-008103,2122,123,67,56,5,24.6
ECU-008104,2122,11,5,6,1,11.0
ECU-008105,2122,105,51,54,4,26.25
ECU-008106,2122,83,38,45,2,41.5
ECU-008107,2122,299,144,155,14,21.357142857142858
ECU-008108,2122,98,48,50,4,24.5
ECU-008109,2122,192,83,109,8,24.0
ECU-008110,2122,182,95,87,6,30.333333333333332
ECU-008111,2122,19,6,13,1,19.0
ECU-008112,2122,21,7,14,1,21.0
ECU-008113,2122,300,156,144,11,27.272727272727273
ECU-008114,2122,922,458,464,33,27.939393939393938
ECU-008115,2122,103,53,50,4,25.75
ECU-008116,2122,69,33,36,3,23.0
ECU-008117,2122,210,113,97,9,23.333333333333332
ECU-008118,2122,17,7,10,1,17.0
ECU-008119,2122,8,3,5,1,8.0
ECU-008120,2122,943,482,461,27,34.925925925925924
ECU-008121,2122,74,40,34,4,18.5
ECU-008122,2122,42,22,20,2,21.0
ECU-008123,2122,21,6,15,1,21.0
ECU-008124,2122,172,86,86,7,24.571428571428573
ECU-008125,2122,210,105,105,8,26.25
ECU-008126,2122,179,85,94,8,22.375
ECU-008127,2122,860,435,425,45,19.11111111111111
ECU-008128,2122,166,82,84,8,20.75
ECU-008129,2122,157,62,95,12,13.083333333333334
ECU-008130,2122,75,37,38,3,25.0
ECU-008131,2122,208,102,106,11,18.90909090909091
ECU-008132,2122,713,353,360,25,28.52
ECU-008133,2122,801,427,374,28,28.607142857142858
ECU-008134,2122,57,32,25,2,28.5
ECU-008135,2122,56,26,30,1,56.0
ECU-008136,2122,876,423,453,30,29.2
ECU-008137,2122,46,20,26,2,23.0
ECU-008138,2122,80,36,44,3,26.666666666666668
ECU-008139,2122,127,55,72,5,25.4
ECU-008140,2122,66,36,30,1,66.0
ECU-008141,2122,140,51,89,8,17.5
ECU-008142,2122,62,24,38,2,31.0
ECU-008143,2122,53,25,28,2,26.5
ECU-008144,2122,189,80,109,10,18.9
ECU-008145,2122,124,64,60,4,31.0
ECU-008146,2122,659,357,302,23,28.652173913043477
ECU-008147,2122,55,30,25,2,27.5
ECU-008148,2122,36,17,19,2,18.0
ECU-008149,2122,20,10,10,1,20.0
ECU-008150,2122,280,142,138,9,31.11111111111111
ECU-008151,2122,63,31,32,3,21.0
ECU-008152,2122,139,70,69,5,27.8
ECU-008153,2122,52,29,23,2,26.0
ECU-008154,2122,27,11,16,1,27.0
ECU-008155,2122,1057,573,484,42,25.166666666666668
ECU-008156,2122,42,22,20,2,21.0
ECU-008157,2122,31,13,18,1,31.0
ECU-008158,2122,149,85,64,8,18.625
ECU-008159,2122,105,51,54,5,21.0
ECU-008160,2122,116,64,52,4,29.0
ECU-008161,2122,545,288,257,18,30.27777777777778
ECU-008162,2122,217,85,132,7,31.0
ECU-008163,2122,756,383,373,24,31.5
ECU-008164,2122,1518,727,791,45,33.733333333333334
ECU-008165,2122,297,154,143,8,37.125
ECU-008166,2122,507,290,217,16,31.6875
ECU-008167,2122,40,16,24,2,20.0
ECU-008168,2122,129,66,63,5,25.8
ECU-008169,2122,242,120,122,9,26.88888888888889
ECU-008170,2122,269,128,141,14,19.214285714285715
ECU-008171,2122,928,444,484,32,29.0
ECU-008172,2122,155,80,75,8,19.375
ECU-008173,2122,52,20,32,2,26.0
ECU-008174,2122,74,33,41,5,14.8
ECU-008175,2122,153,89,64,3,51.0
ECU-008176,2122,99,54,45,10,9.9
ECU-008177,2122,484,241,243,16,30.25
ECU-008178,2122,20,11,9,2,10.0
ECU-008179,2122,631,319,312,33,19.12121212121212
ECU-008180,2122,332,158,174,8,41.5
ECU-008181,2122,67,31,36,6,11.166666666666666
ECU-008182,2122,33,18,15,5,6.6
ECU-008183,2122,68,31,37,11,6.181818181818182
ECU-008184,2122,2505,1294,1211,78,32.11538461538461
ECU-008185,2122,1697,891,806,39,43.51282051282051
ECU-008186,2122,101,52,49,3,33.666666666666664
ECU-008187,2122,131,68,63,3,43.666666666666664
ECU-008188,2122,408,201,207,20,20.4
ECU-008189,2122,193,95,98,6,32.166666666666664
ECU-008190,2122,163,79,84,11,14.818181818181818
ECU-008191,2122,161,80,81,4,40.25
ECU-008192,2122,274,138,136,8,34.25
ECU-008193,2122,395,210,185,17,23.235294117647058
ECU-008194,2122,217,105,112,8,27.125
ECU-008195,2122,685,393,292,30,22.833333333333332
ECU-008196,2122,208,98,110,11,18.90909090909091
ECU-008197,2122,274,134,140,8,34.25
ECU-008198,2122,30,16,14,7,4.285714285714286
ECU-008199,2122,26,10,16,1,26.0
ECU-008200,2122,743,362,381,21,35.38095238095238
ECU-008201,2122,1696,826,870,44,38.54545454545455
ECU-008202,2122,603,279,324,16,37.6875
ECU-008203,2122,1105,517,588,36,30.694444444444443
ECU-008204,2122,256,130,126,8,32.0
ECU-008205,2122,59,28,31,6,9.833333333333334
ECU-008206,2122,263,128,135,10,26.3
ECU-008207,2122,428,229,199,13,32.92307692307692
ECU-008208,2122,52,21,31,2,26.0
ECU-008209,2122,939,481,458,36,26.083333333333332
ECU-008210,2122,827,421,406,34,24.323529411764707
ECU-008211,2122,260,132,128,6,43.333333333333336
ECU-008212,2122,1741,922,819,63,27.634920634920636
ECU-008213,2122,55,29,26,2,27.5
ECU-008214,2122,40,23,17,1,40.0
ECU-008215,2122,444,220,224,18,24.666666666666668
ECU-008216,2122,872,427,445,31,28.129032258064516
ECU-008217,2122,766,349,417,33,23.21212121212121
ECU-008218,2122,476,230,246,17,28.0
ECU-008219,2122,238,128,110,10,23.8
ECU-008220,2122,686,325,361,22,31.181818181818183
ECU-008221,2122,235,112,123,9,26.11111111111111
ECU-008222,2122,681,322,359,34,20.029411764705884
ECU-008223,2122,12,6,6,1,12.0
ECU-008224,2122,12,5,7,1,12.0
ECU-008225,2122,89,52,37,7,12.714285714285714
ECU-008226,2122,1088,515,573,44,24.727272727272727
ECU-008227,2122,800,425,375,32,25.0
ECU-008228,2122,107,41,66,3,35.666666666666664
ECU-008229,2122,504,266,238,19,26.526315789473685
ECU-008230,2122,30,16,14,1,30.0
ECU-008231,2122,1184,566,618,38,31.157894736842106
ECU-008232,2122,132,64,68,4,33.0
ECU-008233,2122,294,156,138,13,22.615384615384617
ECU-008234,2122,1062,503,559,39,27.23076923076923
ECU-008235,2122,50,29,21,3,16.666666666666668
ECU-008236,2122,143,62,81,6,23.833333333333332
ECU-008237,2122,218,125,93,17,12.823529411764707
ECU-008238,2122,76,34,42,3,25.333333333333332
ECU-008239,2122,350,186,164,18,19.444444444444443
ECU-008240,2122,821,428,393,30,27.366666666666667
ECU-008241,2122,370,206,164,23,16.08695652173913
ECU-008242,2122,1652,858,794,54,30.59259259259259
ECU-008243,2122,22,9,13,1,22.0
ECU-008244,2122,253,121,132,14,18.071428571428573
ECU-008245,2122,128,60,68,4,32.0
ECU-008246,2122,26,10,16,2,13.0
ECU-008247,2122,906,469,437,35,25.885714285714286
ECU-008248,2122,303,148,155,14,21.642857142857142
ECU-008249,2122,16,6,10,1,16.0
ECU-008250,2122,84,41,43,3,28.0
ECU-008251,2122,365,182,183,13,28.076923076923077
ECU-008252,2122,301,134,167,14,21.5
ECU-008253,2122,1103,544,559,43,25.651162790697676
ECU-008254,2122,1027,545,482,31,33.12903225806452
ECU-008255,2122,18,11,7,1,18.0
ECU-008256,2122,20,13,7,1,20.0
ECU-008257,2122,27,14,13,1,27.0
ECU-008258,2122,125,62,63,9,13.88888888888889
ECU-008259,2122,90,46,44,3,30.0
ECU-008260,2122,11,5,6,1,11.0
ECU-008261,2122,107,53,54,4,26.75
ECU-008262,2122,5,1,4,1,5.0
ECU-008263,2122,32,15,17,1,32.0
ECU-008264,2122,325,158,167,12,27.083333333333332
ECU-008265,2122,16,9,7,1,16.0
ECU-008266,2122,27,12,15,1,27.0
ECU-008267,2122,22,14,8,1,22.0
ECU-008268,2122,5,1,4,1,5.0
ECU-008269,2122,294,144,150,9,32.666666666666664
ECU-008270,2122,654,290,364,22,29.727272727272727
ECU-008271,2122,779,381,398,31,25.129032258064516
ECU-008272,2122,247,131,116,9,27.444444444444443
ECU-008273,2122,14,6,8,1,14.0
ECU-008274,2122,110,49,61,3,36.666666666666664
ECU-008275,2122,11,3,8,1,11.0
ECU-008276,2122,50,17,33,2,25.0
ECU-008277,2122,14,6,8,1,14.0
ECU-008278,2122,46,25,21,1,46.0
ECU-008279,2122,68,33,35,8,8.5
ECU-008280,2122,13,6,7,1,13.0
ECU-008281,2122,28,13,15,1,28.0
ECU-008282,2122,50,20,30,2,25.0
ECU-008283,2122,50,20,30,2,25.0
ECU-008284,2122,12,2,10,1,12.0
ECU-008285,2122,24,8,16,1,24.0
ECU-008286,2122,41,18,23,2,20.5
ECU-008287,2122,59,28,31,4,14.75
ECU-008288,2122,7,4,3,1,7.0
ECU-008289,2122,156,77,79,4,39.0
ECU-008290,2122,85,44,41,3,28.333333333333332
ECU-008291,2122,44,16,28,2,22.0
ECU-008292,2122,12,9,3,1,12.0
ECU-008293,2122,21,11,10,1,21.0
ECU-008294,2122,20,9,11,1,20.0
ECU-008295,2122,43,25,18,2,21.5
ECU-008296,2122,26,13,13,1,26.0
ECU-008297,2122,31,17,14,2,15.5
ECU-008298,2122,23,12,11,1,23.0
ECU-008299,2122,24,16,8,1,24.0
ECU-008300,2122,44,20,24,1,44.0
ECU-008301,2122,44,21,23,2,22.0
ECU-008302,2122,706,360,346,9,78.44444444444444
ECU-008303,2122,115,63,52,4,28.75
ECU-008304,2122,41,20,21,1,41.0
ECU-008305,2122,17,12,5,1,17.0
ECU-008306,2122,17,9,8,1,17.0
ECU-008307,2122,16,8,8,1,16.0
ECU-008308,2122,457,234,223,12,38.083333333333336
ECU-008309,2122,171,85,86,8,21.375
ECU-008310,2122,86,30,56,4,21.5
ECU-008311,2122,391,175,216,18,21.72222222222222
ECU-008312,2122,14,7,7,1,14.0
ECU-008313,2122,548,291,257,26,21.076923076923077
ECU-008314,2122,36,11,25,2,18.0
ECU-008315,2122,310,152,158,20,15.5
ECU-008316,2122,22,9,13,1,22.0
ECU-008317,2122,295,138,157,12,24.583333333333332
ECU-008318,2122,2,2,0,1,2.0
ECU-008319,2122,371,171,200,18,20.61111111111111
ECU-008320,2122,100,48,52,12,8.333333333333334
ECU-008321,2122,31,17,14,1,31.0
ECU-008322,2122,13,5,8,1,13.0
ECU-008323,2122,66,32,34,2,33.0
ECU-008324,2122,33,13,20,1,33.0
ECU-008325,2122,313,134,179,16,19.5625
ECU-008326,2122,13,4,9,1,13.0
ECU-008327,2122,68,30,38,9,7.555555555555555
ECU-008328,2122,8,2,6,1,8.0
ECU-008329,2122,54,15,39,5,10.8
ECU-008330,2122,27,11,16,1,27.0
ECU-008331,2122,15,9,6,1,15.0
ECU-008332,2122,16,9,7,1,16.0
ECU-008333,2122,946,424,522,44,21.5
ECU-008334,2122,17,9,8,1,17.0
ECU-008335,2122,25,12,13,2,12.5
ECU-008336,2122,74,37,37,3,24.666666666666668
ECU-008337,2122,87,44,43,3,29.0
ECU-008338,2122,265,131,134,25,10.6
ECU-008339,2122,126,68,58,4,31.5
ECU-008340,2122,10,5,5,1,10.0
ECU-008341,2122,10,5,5,1,10.0
ECU-008342,2122,21,12,9,1,21.0
ECU-008343,2122,118,52,66,5,23.6
ECU-008344,2122,281,142,139,9,31.22222222222222
ECU-008345,2122,44,26,18,1,44.0
ECU-008346,2122,505,237,268,18,28.055555555555557
ECU-008347,2122,218,103,115,10,21.8
ECU-008348,2122,35,15,20,2,17.5
ECU-008349,2122,948,453,495,26,36.46153846153846
ECU-008350,2122,100,56,44,3,33.333333333333336
ECU-008351,2122,100,53,47,3,33.333333333333336
ECU-008352,2122,8,3,5,1,8.0
ECU-008353,2122,17,6,11,1,17.0
ECU-008354,2122,12,5,7,1,12.0
ECU-008355,2122,20,13,7,1,20.0
ECU-008356,2122,19,11,8,1,19.0
ECU-008357,2122,11,6,5,1,11.0
ECU-008358,2122,25,8,17,1,25.0
ECU-008359,2122,8,4,4,1,8.0
ECU-008360,2122,8,2,6,1,8.0
ECU-008361,2122,7,4,3,1,7.0
ECU-008362,2122,49,21,28,4,12.25
ECU-008363,2122,15,8,7,1,15.0
ECU-008364,2122,822,416,406,36,22.833333333333332
ECU-008365,2122,212,101,111,8,26.5
ECU-008366,2122,650,305,345,44,14.772727272727273
ECU-008367,2122,541,239,302,52,10.403846153846153
ECU-008368,2122,19,6,13,2,9.5
ECU-008369,2122,81,31,50,3,27.0
ECU-008370,2122,186,68,118,28,6.642857142857143
ECU-008371,2122,108,45,63,6,18.0
ECU-008372,2122,94,58,36,3,31.333333333333332
ECU-008373,2122,1058,533,525,40,26.45
ECU-008374,2122,61,28,33,1,61.0
ECU-008375,2122,45,20,25,9,5.0
ECU-008376,2122,16,9,7,4,4.0
ECU-008377,2122,31,16,15,3,10.333333333333334
ECU-008378,2122,179,94,85,7,25.571428571428573
ECU-008379,2122,250,118,132,9,27.77777777777778
ECU-008380,2122,229,116,113,12,19.083333333333332
ECU-008381,2122,276,135,141,11,25.09090909090909
ECU-008382,2122,343,150,193,19,18.05263157894737
ECU-008383,2122,765,352,413,37,20.675675675675677
ECU-008384,2122,551,244,307,25,22.04
ECU-008385,2122,2049,1020,1029,72,28.458333333333332
ECU-008386,2122,74,36,38,3,24.666666666666668
ECU-008387,2122,69,25,44,18,3.8333333333333335
ECU-008388,2122,1678,794,884,81,20.71604938271605
ECU-008389,2122,344,154,190,14,24.571428571428573
ECU-008390,2122,729,369,360,39,18.692307692307693
ECU-008391,2122,2363,1201,1162,88,26.852272727272727
ECU-008392,2122,18,12,6,1,18.0
ECU-008393,2122,1233,659,574,45,27.4
ECU-008394,2122,95,55,40,7,13.571428571428571
ECU-008395,2122,50,26,24,2,25.0
ECU-008396,2122,416,211,205,16,26.0
ECU-008397,2122,21,0,21,1,21.0
ECU-008398,2122,1001,484,517,39,25.666666666666668
ECU-008399,2122,42,12,30,3,14.0
ECU-008400,2122,384,187,197,21,18.285714285714285
ECU-008401,2122,446,205,241,15,29.733333333333334
ECU-008402,2122,965,501,464,42,22.976190476190474
ECU-008403,2122,3032,1704,1328,121,25.05785123966942
ECU-008404,2122,2199,1133,1066,67,32.82089552238806
ECU-008405,2122,474,222,252,26,18.23076923076923
ECU-008406,2122,1701,836,865,59,28.83050847457627
ECU-008407,2122,176,76,100,16,11.0
ECU-008408,2122,24,15,9,1,24.0
ECU-008409,2122,83,45,38,4,20.75
ECU-008410,2122,154,83,71,7,22.0
ECU-008411,2122,298,138,160,13,22.923076923076923
ECU-008412,2122,78,40,38,3,26.0
ECU-008413,2122,901,427,474,36,25.02777777777778
ECU-008414,2122,75,33,42,3,25.0
ECU-008415,2122,538,238,300,22,24.454545454545453
ECU-008416,2122,1397,707,690,57,24.50877192982456
ECU-008417,2122,1981,1003,978,79,25.075949367088608
ECU-008418,2122,875,426,449,39,22.435897435897434
ECU-008419,2122,1500,719,781,55,27.272727272727273
ECU-008420,2122,13,6,7,1,13.0
ECU-008421,2122,20,9,11,1,20.0
ECU-008422,2122,94,42,52,4,23.5
ECU-008423,2122,46,23,23,2,23.0
ECU-008424,2122,18,5,13,1,18.0
ECU-008425,2122,246,120,126,9,27.333333333333332
ECU-008426,2122,43,23,20,2,21.5
ECU-008427,2122,121,47,74,8,15.125
ECU-008428,2122,53,25,28,3,17.666666666666668
ECU-008429,2122,33,15,18,2,16.5
ECU-008430,2122,142,70,72,8,17.75
ECU-008431,2122,11,6,5,1,11.0
ECU-008432,2122,404,204,200,14,28.857142857142858
ECU-008433,2122,97,45,52,4,24.25
ECU-008434,2122,66,25,41,6,11.0
ECU-008435,2122,285,142,143,10,28.5
ECU-008436,2122,225,106,119,10,22.5
ECU-008437,2122,556,286,270,17,32.705882352941174
ECU-008438,2122,15,8,7,1,15.0
ECU-008439,2122,27,14,13,2,13.5
ECU-008440,2122,112,57,55,8,14.0
ECU-008441,2122,670,307,363,27,24.814814814814813
ECU-008442,2122,111,58,53,6,18.5
ECU-008443,2122,83,39,44,4,20.75
ECU-008444,2122,506,230,276,23,22.0
ECU-008445,2122,80,46,34,4,20.0
ECU-008446,2122,23,12,11,2,11.5
ECU-008447,2122,19,9,10,1,19.0
ECU-008448,2122,198,89,109,7,28.285714285714285
ECU-008449,2122,12,3,9,1,12.0
ECU-008450,2122,35,13,22,2,17.5
ECU-008451,2122,735,357,378,31,23.70967741935484
ECU-008452,2122,59,30,29,2,29.5
ECU-008453,2122,138,67,71,7,19.714285714285715
ECU-008454,2122,48,26,22,3,16.0
ECU-008455,2122,67,27,40,3,22.333333333333332
ECU-008456,2122,15,9,6,1,15.0
ECU-008457,2122,70,35,35,2,35.0
ECU-008458,2122,43,21,22,3,14.333333333333334
ECU-008459,2122,43,20,23,2,21.5
ECU-008460,2122,146,72,74,6,24.333333333333332
ECU-008461,2122,157,89,68,8,19.625
ECU-008462,2122,235,119,116,11,21.363636363636363
ECU-008463,2122,205,105,100,8,25.625
ECU-008464,2122,89,35,54,3,29.666666666666668
ECU-008465,2122,59,29,30,3,19.666666666666668
ECU-008466,2122,44,18,26,3,14.666666666666666
ECU-008467,2122,42,19,23,2,21.0
ECU-008468,2122,80,37,43,4,20.0
ECU-008469,2122,111,58,53,5,22.2
ECU-008470,2122,570,290,280,25,22.8
ECU-008471,2122,51,29,22,2,25.5
ECU-008472,2122,24,14,10,1,24.0
ECU-008473,2122,102,36,66,4,25.5
ECU-008474,2122,170,79,91,12,14.166666666666666
ECU-008475,2122,1520,773,747,57,26.666666666666668
ECU-008476,2122,21,8,13,1,21.0
ECU-008477,2122,14,7,7,1,14.0
ECU-008478,2122,6,2,4,1,6.0
ECU-008479,2122,99,40,59,5,19.8
ECU-008480,2122,127,67,60,6,21.166666666666668
ECU-008481,2122,140,64,76,8,17.5
ECU-008482,2122,8,5,3,1,8.0
ECU-008483,2122,78,37,41,4,19.5
ECU-008484,2122,29,16,13,1,29.0
ECU-008485,2122,48,20,28,5,9.6
ECU-008486,2122,73,34,39,3,24.333333333333332
ECU-008487,2122,21,9,12,1,21.0
ECU-008488,2122,10,6,4,1,10.0
ECU-008489,2122,136,72,64,6,22.666666666666668
ECU-008490,2122,203,79,124,9,22.555555555555557
ECU-008491,2122,1628,888,740,73,22.301369863013697
ECU-008492,2122,92,43,49,3,30.666666666666668
ECU-008493,2122,58,27,31,2,29.0
ECU-008494,2122,55,24,31,2,27.5
ECU-008495,2122,168,90,78,11,15.272727272727273
ECU-008496,2122,1105,448,657,43,25.697674418604652
ECU-008497,2122,73,38,35,2,36.5
ECU-008498,2122,33,17,16,2,16.5
ECU-008499,2122,36,14,22,2,18.0
ECU-008500,2122,55,27,28,2,27.5
ECU-008501,2122,61,28,33,3,20.333333333333332
ECU-008502,2122,46,19,27,2,23.0
ECU-008503,2122,47,20,27,2,23.5
ECU-008504,2122,1143,607,536,35,32.65714285714286
ECU-008505,2122,54,27,27,1,54.0
ECU-008506,2122,238,115,123,12,19.833333333333332
ECU-008507,2122,545,266,279,18,30.27777777777778
ECU-008508,2122,58,34,24,3,19.333333333333332
ECU-008509,2122,251,128,123,12,20.916666666666668
ECU-008510,2122,171,83,88,8,21.375
ECU-008511,2122,204,106,98,9,22.666666666666668
ECU-008512,2122,54,33,21,2,27.0
ECU-008513,2122,108,45,63,5,21.6
ECU-008514,2122,127,60,67,4,31.75
ECU-008515,2122,59,32,27,2,29.5
ECU-008516,2122,136,60,76,5,27.2
ECU-008517,2122,109,51,58,5,21.8
ECU-008518,2122,256,135,121,16,16.0
ECU-008519,2122,26,10,16,2,13.0
ECU-008520,2122,306,152,154,11,27.818181818181817
ECU-008521,2122,50,19,31,3,16.666666666666668
ECU-008522,2122,927,457,470,42,22.071428571428573
ECU-008523,2122,219,99,120,8,27.375
ECU-008524,2122,474,229,245,16,29.625
ECU-008525,2122,14,7,7,1,14.0
ECU-008526,2122,35,17,18,2,17.5
ECU-008527,2122,37,23,14,2,18.5
ECU-008528,2122,28,15,13,2,14.0
ECU-008529,2122,332,157,175,14,23.714285714285715
ECU-008530,2122,75,35,40,3,25.0
ECU-008531,2122,13,6,7,1,13.0
ECU-008532,2122,16,9,7,1,16.0
ECU-008533,2122,20,8,12,1,20.0
ECU-008534,2122,141,71,70,9,15.666666666666666
ECU-008535,2122,8,5,3,1,8.0
ECU-008536,2122,27,8,19,2,13.5
ECU-008537,2122,78,42,36,5,15.6
ECU-008538,2122,613,293,320,27,22.703703703703702
ECU-008539,2122,880,429,451,37,23.783783783783782
ECU-008540,2122,138,69,69,8,17.25
ECU-008541,2122,643,337,306,24,26.791666666666668
ECU-008542,2122,13,5,8,1,13.0
ECU-008543,2122,994,507,487,42,23.666666666666668
ECU-008544,2122,16,7,9,1,16.0
ECU-008545,2122,36,15,21,2,18.0
ECU-008546,2122,8,6,2,1,8.0
ECU-008547,2122,318,179,139,14,22.714285714285715
ECU-008548,2122,70,38,32,7,10.0
ECU-008549,2122,48,21,27,2,24.0
ECU-008550,2122,251,117,134,14,17.928571428571427
ECU-008551,2122,31,18,13,1,31.0
ECU-008552,2122,25,13,12,2,12.5
ECU-008553,2122,69,39,30,6,11.5
ECU-008554,2122,29,7,22,8,3.625
ECU-008555,2122,11,10,1,1,11.0
ECU-008556,2122,13,2,11,1,13.0
ECU-008557,2122,1089,549,540,47,23.170212765957448
ECU-008558,2122,616,279,337,21,29.333333333333332
ECU-008559,2122,72,32,40,5,14.4
ECU-008560,2122,857,458,399,32,26.78125
ECU-008561,2122,52,23,29,2,26.0
ECU-008562,2122,249,103,146,14,17.785714285714285
ECU-008563,2122,748,392,356,24,31.166666666666668
ECU-008564,2122,28,7,21,6,4.666666666666667
ECU-008565,2122,519,277,242,17,30.529411764705884
ECU-008566,2122,8,3,5,1,8.0
ECU-008567,2122,913,427,486,31,29.451612903225808
ECU-008568,2122,20,10,10,1,20.0
ECU-008569,2122,28,18,10,1,28.0
ECU-008570,2122,22,11,11,2,11.0
ECU-008571,2122,40,20,20,1,40.0
ECU-008572,2122,56,32,24,6,9.333333333333334
ECU-008573,2122,46,23,23,1,46.0
ECU-008574,2122,612,294,318,28,21.857142857142858
ECU-008575,2122,30,18,12,2,15.0
ECU-008576,2122,31,13,18,2,15.5
ECU-008577,2122,42,22,20,2,21.0
ECU-008578,2122,37,16,21,2,18.5
ECU-008579,2122,114,58,56,3,38.0
ECU-008580,2122,59,27,32,2,29.5
ECU-008581,2122,501,261,240,17,29.470588235294116
ECU-008582,2122,26,16,10,1,26.0
ECU-008583,2122,24,15,9,1,24.0
ECU-008584,2122,665,346,319,18,36.94444444444444
ECU-008585,2122,32,11,21,2,16.0
ECU-008586,2122,250,124,126,10,25.0
ECU-008587,2122,190,95,95,8,23.75
ECU-008588,2122,919,450,469,27,34.03703703703704
ECU-008589,2122,1499,839,660,57,26.29824561403509
ECU-008590,2122,22,12,10,1,22.0
ECU-008591,2122,37,22,15,2,18.5
ECU-008592,2122,52,29,23,2,26.0
ECU-008593,2122,24,8,16,1,24.0
ECU-008594,2122,16,5,11,1,16.0
ECU-008595,2122,1318,627,691,53,24.867924528301888
ECU-008596,2122,12,3,9,1,12.0
ECU-008597,2122,178,79,99,7,25.428571428571427
ECU-008598,2122,319,176,143,11,29.0
ECU-008599,2122,170,95,75,15,11.333333333333334
ECU-008600,2122,38,14,24,3,12.666666666666666
ECU-008601,2122,97,38,59,4,24.25
ECU-008602,2122,978,473,505,27,36.22222222222222
ECU-008603,2122,229,100,129,9,25.444444444444443
ECU-008604,2122,571,342,229,15,38.06666666666667
ECU-008605,2122,987,507,480,29,34.03448275862069
ECU-008606,2122,19,6,13,1,19.0
ECU-008607,2122,1206,501,705,31,38.903225806451616
ECU-008608,2122,924,486,438,46,20.08695652173913
ECU-008609,2122,466,318,148,19,24.526315789473685
ECU-008610,2122,180,83,97,5,36.0
ECU-008611,2122,41,23,18,2,20.5
ECU-008612,2122,3816,2048,1768,142,26.87323943661972
ECU-008613,2122,1287,623,664,35,36.77142857142857
ECU-008614,2122,1240,662,578,31,40.0
ECU-008615,2122,85,41,44,9,9.444444444444445
ECU-008616,2122,410,179,231,11,37.27272727272727
ECU-008617,2122,515,247,268,15,34.333333333333336
ECU-008618,2122,109,62,47,3,36.333333333333336
ECU-008619,2122,305,148,157,11,27.727272727272727
ECU-008620,2122,1836,913,923,52,35.30769230769231
ECU-008621,2122,826,409,417,35,23.6
ECU-008622,2122,241,135,106,10,24.1
ECU-008623,2122,54,25,29,4,13.5
ECU-008624,2122,684,355,329,32,21.375
ECU-008625,2122,273,142,131,30,9.1
ECU-008626,2122,132,54,78,7,18.857142857142858
ECU-008627,2122,581,267,314,15,38.733333333333334
ECU-008628,2122,9,5,4,1,9.0
ECU-008629,2122,25,17,8,3,8.333333333333334
ECU-008630,2122,984,486,498,51,19.294117647058822
ECU-008631,2122,1362,690,672,53,25.69811320754717
ECU-008632,2122,861,439,422,48,17.9375
ECU-008633,2122,275,142,133,8,34.375
ECU-008634,2122,174,87,87,9,19.333333333333332
ECU-008635,2122,1429,743,686,38,37.60526315789474
ECU-008636,2122,187,79,108,7,26.714285714285715
ECU-008637,2122,93,49,44,3,31.0
ECU-008638,2122,150,67,83,9,16.666666666666668
ECU-008639,2122,39,3,36,2,19.5
ECU-008640,2122,862,431,431,28,30.785714285714285
ECU-008641,2122,63,34,29,2,31.5
ECU-008642,2122,31,10,21,4,7.75
ECU-008643,2122,210,93,117,10,21.0
ECU-008644,2122,287,151,136,17,16.88235294117647
ECU-008645,2122,149,56,93,13,11.461538461538462
ECU-008646,2122,318,156,162,9,35.333333333333336
ECU-008647,2122,617,349,268,27,22.85185185185185
ECU-008648,2122,83,41,42,3,27.666666666666668
ECU-008649,2122,574,291,283,18,31.88888888888889
ECU-008650,2122,906,469,437,45,20.133333333333333
ECU-008651,2122,51,24,27,2,25.5
ECU-008652,2122,387,187,200,13,29.76923076923077
ECU-008653,2122,43,23,20,6,7.166666666666667
ECU-008654,2122,353,181,172,10,35.3
ECU-008655,2122,149,10,139,8,18.625
ECU-008656,2122,122,61,61,6,20.333333333333332
ECU-008657,2122,63,43,20,3,21.0
ECU-008658,2122,165,71,94,7,23.571428571428573
ECU-008659,2122,19,9,10,1,19.0
ECU-008660,2122,653,306,347,19,34.36842105263158
ECU-008661,2122,1452,388,1064,51,28.470588235294116
ECU-008662,2122,182,82,100,8,22.75
ECU-008663,2122,436,195,241,14,31.142857142857142
ECU-008664,2122,383,173,210,12,31.916666666666668
ECU-008665,2122,45,24,21,5,9.0
ECU-008666,2122,21,13,8,1,21.0
ECU-008667,2122,31,11,20,1,31.0
ECU-008668,2122,3354,1969,1385,127,26.409448818897637
ECU-008669,2122,113,65,48,7,16.142857142857142
ECU-008670,2122,70,36,34,4,17.5
ECU-008671,2122,49,21,28,2,24.5
ECU-008672,2122,548,280,268,32,17.125
ECU-008673,2122,1400,707,693,40,35.0
ECU-008674,2122,160,80,80,8,20.0
ECU-008675,2122,280,135,145,9,31.11111111111111
ECU-008676,2122,100,47,53,10,10.0
ECU-008677,2122,1122,571,551,31,36.193548387096776
ECU-008678,2122,144,72,72,7,20.571428571428573
ECU-008679,2122,479,224,255,14,34.214285714285715
ECU-008680,2122,106,53,53,7,15.142857142857142
ECU-008681,2122,176,99,77,12,14.666666666666666
ECU-008682,2122,196,91,105,8,24.5
ECU-008683,2122,672,344,328,19,35.36842105263158
ECU-008684,2122,203,95,108,6,33.833333333333336
ECU-008685,2122,255,124,131,8,31.875
ECU-008686,2122,55,18,37,3,18.333333333333332
ECU-008687,2122,231,108,123,9,25.666666666666668
ECU-008688,2122,2262,1149,1113,102,22.176470588235293
ECU-008689,2122,13,7,6,1,13.0
ECU-008690,2122,88,47,41,3,29.333333333333332
ECU-008691,2122,670,324,346,23,29.130434782608695
ECU-008692,2122,506,274,232,16,31.625
ECU-008693,2122,122,49,73,8,15.25
ECU-008694,2122,888,442,446,30,29.6
ECU-008695,2122,22,10,12,1,22.0
ECU-008696,2122,13,5,8,1,13.0
ECU-008697,2122,48,23,25,1,48.0
ECU-008698,2122,1013,541,472,51,19.862745098039216
ECU-008699,2122,674,339,335,23,29.304347826086957
ECU-008700,2122,421,213,208,13,32.38461538461539
ECU-008701,2122,132,65,67,5,26.4
ECU-008702,2122,58,32,26,3,19.333333333333332
ECU-008703,2122,301,150,151,12,25.083333333333332
ECU-008704,2122,29,14,15,1,29.0
ECU-008705,2122,51,28,23,2,25.5
ECU-008706,2122,18,10,8,1,18.0
ECU-008707,2122,848,418,430,23,36.869565217391305
ECU-008708,2122,14,5,9,1,14.0
ECU-008709,2122,105,52,53,4,26.25
ECU-008710,2122,92,47,45,8,11.5
ECU-008711,2122,616,316,300,27,22.814814814814813
ECU-008712,2122,18,12,6,1,18.0
ECU-008713,2122,784,435,349,27,29.037037037037038
ECU-008714,2122,1351,747,604,49,27.571428571428573
ECU-008715,2122,17,6,11,1,17.0
ECU-008716,2122,110,49,61,4,27.5
ECU-008717,2122,92,39,53,7,13.142857142857142
ECU-008718,2122,295,153,142,9,32.77777777777778
ECU-008719,2122,402,177,225,15,26.8
ECU-008720,2122,324,165,159,11,29.454545454545453
ECU-008721,2122,179,99,80,11,16.272727272727273
ECU-008722,2122,46,28,18,2,23.0
ECU-008723,2122,18,8,10,1,18.0
ECU-008724,2122,93,42,51,4,23.25
ECU-008725,2122,51,26,25,2,25.5
ECU-008726,2122,22,7,15,1,22.0
ECU-008727,2122,68,32,36,3,22.666666666666668
ECU-008728,2122,38,22,16,2,19.0
ECU-008729,2122,15,8,7,1,15.0
ECU-008730,2122,60,30,30,3,20.0
ECU-008731,2122,654,325,329,28,23.357142857142858
ECU-008732,2122,33,15,18,2,16.5
ECU-008733,2122,48,16,32,2,24.0
ECU-008734,2122,793,400,393,28,28.321428571428573
ECU-008735,2122,10,3,7,1,10.0
ECU-008736,2122,222,119,103,9,24.666666666666668
ECU-008737,2122,448,217,231,20,22.4
ECU-008738,2122,26,14,12,1,26.0
ECU-008739,2122,12,6,6,1,12.0
ECU-008740,2122,6,4,2,2,3.0
ECU-008741,2122,48,21,27,2,24.0
ECU-008742,2122,38,14,24,2,19.0
ECU-008743,2122,305,150,155,16,19.0625
ECU-008744,2122,32,16,16,1,32.0
ECU-008745,2122,32,10,22,1,32.0
ECU-008746,2122,72,37,35,3,24.0
ECU-008747,2122,1392,677,715,48,29.0
ECU-008748,2122,78,34,44,8,9.75
ECU-008749,2122,12,2,10,1,12.0
ECU-008750,2122,28,10,18,2,14.0
ECU-008751,2122,34,14,20,2,17.0
ECU-008752,2122,33,19,14,2,16.5
ECU-008753,2122,19,6,13,1,19.0
ECU-008754,2122,965,430,535,38,25.394736842105264
ECU-008755,2122,38,16,22,2,19.0
ECU-008756,2122,42,25,17,2,21.0
ECU-008757,2122,127,60,67,4,31.75
ECU-008758,2122,24,14,10,1,24.0
ECU-008759,2122,542,244,298,22,24.636363636363637
ECU-008760,2122,341,186,155,14,24.357142857142858
ECU-008761,2122,26,10,16,1,26.0
ECU-008762,2122,29,13,16,2,14.5
ECU-008763,2122,802,386,416,31,25.870967741935484
ECU-008764,2122,267,134,133,9,29.666666666666668
ECU-008765,2122,1997,1024,973,67,29.80597014925373
ECU-008766,2122,257,146,111,16,16.0625
ECU-008767,2122,83,42,41,3,27.666666666666668
ECU-008768,2122,28,15,13,2,14.0
ECU-008769,2122,300,140,160,12,25.0
ECU-008770,2122,41,21,20,2,20.5
ECU-008771,2122,17,6,11,3,5.666666666666667
ECU-008772,2122,23,8,15,1,23.0
ECU-008773,2122,717,374,343,25,28.68
ECU-008774,2122,1377,756,621,53,25.9811320754717
ECU-008775,2122,1861,1022,839,43,43.27906976744186
ECU-008776,2122,1507,752,755,67,22.492537313432837
ECU-008777,2122,361,170,191,20,18.05
ECU-008778,2122,22,7,15,4,5.5
ECU-008779,2122,1294,646,648,41,31.5609756097561
ECU-008780,2122,39,13,26,2,19.5
ECU-008781,2122,39,22,17,1,39.0
ECU-008782,2122,46,19,27,2,23.0
ECU-008783,2122,34,13,21,1,34.0
ECU-008784,2122,46,19,27,2,23.0
ECU-008785,2122,18,7,11,1,18.0
ECU-008786,2122,22,9,13,1,22.0
ECU-008787,2122,36,21,15,1,36.0
ECU-008788,2122,863,413,450,30,28.766666666666666
ECU-008789,2122,307,164,143,12,25.583333333333332
ECU-008790,2122,79,45,34,4,19.75
ECU-008791,2122,14,7,7,1,14.0
ECU-008792,2122,31,16,15,2,15.5
ECU-008793,2122,30,16,14,2,15.0
ECU-008794,2122,187,84,103,8,23.375
ECU-008795,2122,25,9,16,1,25.0
ECU-008796,2122,28,16,12,1,28.0
ECU-008797,2122,73,34,39,2,36.5
ECU-008798,2122,304,154,150,12,25.333333333333332
ECU-008799,2122,21,7,14,1,21.0
ECU-008800,2122,1155,613,542,42,27.5
ECU-008801,2122,12,7,5,1,12.0
ECU-008802,2122,26,12,14,2,13.0
ECU-008803,2122,19,8,11,1,19.0
ECU-008804,2122,28,14,14,1,28.0
ECU-008805,2122,32,19,13,1,32.0
ECU-008806,2122,106,51,55,4,26.5
ECU-008807,2122,81,31,50,3,27.0
ECU-008808,2122,23,5,18,1,23.0
ECU-008809,2122,14,8,6,1,14.0
ECU-008810,2122,337,172,165,12,28.083333333333332
ECU-008811,2122,18,6,12,1,18.0
ECU-008812,2122,22,12,10,1,22.0
ECU-008813,2122,100,43,57,4,25.0
ECU-008814,2122,17,8,9,1,17.0
ECU-008815,2122,224,105,119,8,28.0
ECU-008816,2122,19,7,12,1,19.0
ECU-008817,2122,512,268,244,24,21.333333333333332
ECU-008818,2122,17,10,7,1,17.0
ECU-008819,2122,75,39,36,5,15.0
ECU-008820,2122,915,482,433,36,25.416666666666668
ECU-008821,2122,17,16,1,1,17.0
ECU-008822,2122,15,7,8,1,15.0
ECU-008823,2122,56,27,29,3,18.666666666666668
ECU-008824,2122,411,209,202,15,27.4
ECU-008825,2122,67,35,32,3,22.333333333333332
ECU-008826,2122,21,11,10,1,21.0
ECU-008827,2122,323,157,166,13,24.846153846153847
ECU-008828,2122,80,36,44,3,26.666666666666668
ECU-008829,2122,17,6,11,1,17.0
ECU-008830,2122,22,8,14,1,22.0
ECU-008831,2122,99,45,54,3,33.0
ECU-008832,2122,11,10,1,1,11.0
ECU-008833,2122,40,19,21,2,20.0
ECU-008834,2122,14,5,9,1,14.0
ECU-008835,2122,20,12,8,1,20.0
ECU-008836,2122,266,130,136,9,29.555555555555557
ECU-008837,2122,7,1,6,1,7.0
ECU-008838,2122,12,4,8,1,12.0
ECU-008839,2122,49,22,27,3,16.333333333333332
ECU-008840,2122,191,95,96,12,15.916666666666666
ECU-008841,2122,22,12,10,1,22.0
ECU-008842,2122,28,15,13,1,28.0
ECU-008843,2122,140,62,78,9,15.555555555555555
ECU-008844,2122,17,6,11,1,17.0
ECU-008845,2122,25,11,14,1,25.0
ECU-008846,2122,18,8,10,1,18.0
ECU-008847,2122,102,44,58,7,14.571428571428571
ECU-008848,2122,44,20,24,1,44.0
ECU-008849,2122,1694,910,784,61,27.770491803278688
ECU-008850,2122,14,7,7,1,14.0
ECU-008851,2122,23,7,16,1,23.0
ECU-008852,2122,46,27,19,2,23.0
ECU-008853,2122,19,11,8,1,19.0
ECU-008854,2122,20,11,9,1,20.0
ECU-008855,2122,13,4,9,1,13.0
ECU-008856,2122,213,100,113,9,23.666666666666668
ECU-008857,2122,521,253,268,21,24.80952380952381
ECU-008858,2122,83,41,42,3,27.666666666666668
ECU-008859,2122,25,13,12,1,25.0
ECU-008860,2122,15,6,9,1,15.0
ECU-008861,2122,492,225,267,22,22.363636363636363
ECU-008862,2122,61,15,46,5,12.2
ECU-008863,2122,48,20,28,2,24.0
ECU-008864,2122,6,2,4,1,6.0
ECU-008865,2122,14,6,8,1,14.0
ECU-008866,2122,20,10,10,1,20.0
ECU-008867,2122,30,13,17,1,30.0
ECU-008868,2122,68,31,37,3,22.666666666666668
ECU-008869,2122,24,14,10,2,12.0
ECU-008870,2122,221,122,99,9,24.555555555555557
ECU-008871,2122,37,18,19,1,37.0
ECU-008872,2122,20,9,11,1,20.0
ECU-008873,2122,39,21,18,2,19.5
ECU-008874,2122,17,7,10,1,17.0
ECU-008875,2122,160,77,83,6,26.666666666666668
ECU-008876,2122,13,9,4,1,13.0
ECU-008877,2122,115,56,59,2,57.5
ECU-008878,2122,36,19,17,2,18.0
ECU-008879,2122,15,7,8,1,15.0
ECU-008880,2122,32,18,14,1,32.0
ECU-008881,2122,34,15,19,1,34.0
ECU-008882,2122,86,46,40,4,21.5
ECU-008883,2122,34,20,14,1,34.0
ECU-008884,2122,27,13,14,2,13.5
ECU-008885,2122,86,49,37,3,28.666666666666668
ECU-008886,2122,113,59,54,11,10.272727272727273
ECU-008887,2122,582,287,295,18,32.333333333333336
ECU-008888,2122,329,171,158,14,23.5
ECU-008889,2122,78,36,42,8,9.75
ECU-008890,2122,342,178,164,12,28.5
ECU-008891,2122,26,13,13,1,26.0
ECU-008892,2122,41,21,20,8,5.125
ECU-008893,2122,809,439,370,26,31.115384615384617
ECU-008894,2122,410,229,181,15,27.333333333333332
ECU-008895,2122,10,8,2,1,10.0
ECU-008896,2122,978,531,447,25,39.12
ECU-008897,2122,305,183,122,8,38.125
ECU-008898,2122,20,11,9,1,20.0
ECU-008899,2122,53,28,25,2,26.5
ECU-008900,2122,2349,1234,1115,80,29.3625
ECU-008901,2122,40,19,21,2,20.0
ECU-008902,2122,55,21,34,2,27.5
ECU-008903,2122,16,6,10,1,16.0
ECU-008904,2122,49,21,28,2,24.5
ECU-008905,2122,662,317,345,28,23.642857142857142
ECU-008906,2122,11,8,3,1,11.0
ECU-008907,2122,673,317,356,21,32.04761904761905
ECU-008908,2122,643,321,322,19,33.8421052631579
ECU-008909,2122,332,180,152,12,27.666666666666668
ECU-008910,2122,425,198,227,18,23.61111111111111
ECU-008911,2122,360,174,186,13,27.692307692307693
ECU-008912,2122,102,59,43,4,25.5
ECU-008913,2122,920,462,458,44,20.90909090909091
ECU-008914,2122,78,36,42,3,26.0
ECU-008915,2122,279,135,144,8,34.875
ECU-008916,2122,271,126,145,10,27.1
ECU-008917,2122,23,13,10,1,23.0
ECU-008918,2122,38,23,15,2,19.0
ECU-008919,2122,533,243,290,21,25.38095238095238
ECU-008920,2122,298,129,169,11,27.09090909090909
ECU-008921,2122,497,243,254,17,29.235294117647058
ECU-008922,2122,173,71,102,9,19.22222222222222
ECU-008923,2122,23,16,7,1,23.0
ECU-008924,2122,20,9,11,1,20.0
ECU-008925,2122,52,30,22,2,26.0
ECU-008926,2122,163,90,73,9,18.11111111111111
ECU-008927,2122,29,15,14,1,29.0
ECU-008928,2122,305,134,171,15,20.333333333333332
ECU-008929,2122,257,119,138,13,19.76923076923077
ECU-008930,2122,25,15,10,1,25.0
ECU-008931,2122,33,17,16,2,16.5
ECU-008932,2122,49,23,26,2,24.5
ECU-008933,2122,52,29,23,2,26.0
ECU-008934,2122,33,11,22,2,16.5
ECU-008935,2122,487,222,265,20,24.35
ECU-008936,2122,36,20,16,1,36.0
ECU-008937,2122,212,105,107,8,26.5
ECU-008938,2122,18,8,10,1,18.0
ECU-008939,2122,31,11,20,1,31.0
ECU-008940,2122,132,59,73,5,26.4
ECU-008941,2122,74,35,39,2,37.0
ECU-008942,2122,243,131,112,9,27.0
ECU-008943,2122,13,7,6,1,13.0
ECU-008944,2122,24,14,10,3,8.0
ECU-008945,2122,229,118,111,15,15.266666666666667
ECU-008946,2122,25,13,12,1,25.0
ECU-008947,2122,43,16,27,2,21.5
ECU-008948,2122,274,136,138,9,30.444444444444443
ECU-008949,2122,118,59,59,5,23.6
ECU-008950,2122,961,475,486,36,26.694444444444443
ECU-008951,2122,29,13,16,1,29.0
ECU-008952,2122,45,26,19,2,22.5
ECU-008953,2122,44,15,29,2,22.0
ECU-008954,2122,36,17,19,1,36.0
ECU-008955,2122,10,5,5,1,10.0
ECU-008956,2122,46,20,26,1,46.0
ECU-008957,2122,63,34,29,2,31.5
ECU-008958,2122,351,176,175,15,23.4
ECU-008959,2122,148,66,82,6,24.666666666666668
ECU-008960,2122,19,7,12,1,19.0
ECU-008961,2122,14,6,8,1,14.0
ECU-008962,2122,68,27,41,2,34.0
ECU-008963,2122,13,5,8,1,13.0
ECU-008964,2122,33,20,13,1,33.0
ECU-008965,2122,54,31,23,2,27.0
ECU-008966,2122,23,12,11,1,23.0
ECU-008967,2122,26,9,17,1,26.0
ECU-008968,2122,65,39,26,2,32.5
ECU-008969,2122,16,8,8,1,16.0
ECU-008970,2122,14,7,7,1,14.0
ECU-008971,2122,857,420,437,27,31.74074074074074
ECU-008972,2122,49,20,29,2,24.5
ECU-008973,2122,64,31,33,2,32.0
ECU-008974,2122,21,10,11,1,21.0
ECU-008975,2122,20,10,10,1,20.0
ECU-008976,2122,49,23,26,1,49.0
ECU-008977,2122,42,16,26,2,21.0
ECU-008978,2122,58,28,30,2,29.0
ECU-008979,2122,39,18,21,2,19.5
ECU-008980,2122,22,8,14,1,22.0
ECU-008981,2122,25,16,9,1,25.0
ECU-008982,2122,16,7,9,1,16.0
ECU-008983,2122,836,437,399,37,22.594594594594593
ECU-008984,2122,100,54,46,5,20.0
ECU-008985,2122,21,9,12,1,21.0
ECU-008986,2122,9,3,6,1,9.0
ECU-008987,2122,21,12,9,1,21.0
ECU-008988,2122,97,49,48,3,32.333333333333336
ECU-008989,2122,30,12,18,1,30.0
ECU-008990,2122,20,11,9,1,20.0
ECU-008991,2122,145,83,62,6,24.166666666666668
ECU-008992,2122,1459,681,778,42,34.73809523809524
ECU-008993,2122,1245,608,637,37,33.648648648648646
ECU-008994,2122,544,270,274,19,28.63157894736842
ECU-008995,2122,26,10,16,1,26.0
ECU-008996,2122,303,153,150,8,37.875
ECU-008997,2122,2861,1365,1496,85,33.65882352941176
ECU-008998,2122,671,316,355,20,33.55
ECU-008999,2122,227,124,103,7,32.42857142857143
ECU-009000,2122,546,273,273,17,32.11764705882353
ECU-009001,2122,170,85,85,6,28.333333333333332
ECU-009002,2122,340,169,171,9,37.77777777777778
ECU-009003,2122,2158,1023,1135,65,33.2
ECU-009004,2122,190,88,102,8,23.75
ECU-009005,2122,50,28,22,2,25.0
ECU-009006,2122,158,79,79,4,39.5
ECU-009007,2122,57,24,33,2,28.5
ECU-009008,2122,482,228,254,16,30.125
ECU-009009,2122,911,464,447,26,35.03846153846154
ECU-009010,2122,249,132,117,11,22.636363636363637
ECU-009011,2122,276,145,131,8,34.5
ECU-009012,2122,924,521,403,25,36.96
ECU-009013,2122,2704,1428,1276,136,19.88235294117647
ECU-009014,2122,39,16,23,2,19.5
ECU-009015,2122,34,15,19,2,17.0
ECU-009016,2122,33,19,14,1,33.0
ECU-009017,2122,47,23,24,2,23.5
ECU-009018,2122,110,52,58,3,36.666666666666664
ECU-009019,2122,34,14,20,1,34.0
ECU-009020,2122,10,3,7,1,10.0
ECU-009021,2122,835,407,428,25,33.4
ECU-009022,2122,98,28,70,10,9.8
ECU-009023,2122,1094,598,496,40,27.35
ECU-009024,2122,29,10,19,1,29.0
ECU-009025,2122,1243,592,651,37,33.5945945945946
ECU-009026,2122,288,135,153,9,32.0
ECU-009027,2122,173,80,93,10,17.3
ECU-009028,2122,60,30,30,1,60.0
ECU-009029,2122,390,185,205,14,27.857142857142858
ECU-009030,2122,489,253,236,17,28.764705882352942
ECU-009031,2122,262,132,130,14,18.714285714285715
ECU-009032,2122,354,200,154,23,15.391304347826088
ECU-009033,2122,52,27,25,1,52.0
ECU-009034,2122,760,370,390,26,29.23076923076923
ECU-009035,2122,43,21,22,2,21.5
ECU-009036,2122,24,11,13,1,24.0
ECU-009037,2122,25,10,15,1,25.0
ECU-009038,2122,32,14,18,2,16.0
ECU-009039,2122,27,14,13,1,27.0
ECU-009040,2122,49,21,28,2,24.5
ECU-009041,2122,119,54,65,9,13.222222222222221
ECU-009042,2122,1440,679,761,47,30.638297872340427
ECU-009043,2122,499,253,246,15,33.266666666666666
ECU-009044,2122,107,53,54,3,35.666666666666664
ECU-009045,2122,279,140,139,10,27.9
ECU-009046,2122,34,13,21,2,17.0
ECU-009047,2122,148,68,80,11,13.454545454545455
ECU-009048,2122,142,82,60,5,28.4
ECU-009049,2122,689,323,366,24,28.708333333333332
ECU-009050,2122,57,28,29,2,28.5
ECU-009051,2122,11,8,3,1,11.0
ECU-009052,2122,228,125,103,15,15.2
ECU-009053,2122,28,11,17,1,28.0
ECU-009054,2122,105,64,41,3,35.0
ECU-009055,2122,19,5,14,1,19.0
ECU-009056,2122,248,117,131,9,27.555555555555557
ECU-009057,2122,41,24,17,2,20.5
ECU-009058,2122,648,321,327,22,29.454545454545453
ECU-009059,2122,34,21,13,2,17.0
ECU-009060,2122,29,17,12,1,29.0
ECU-009061,2122,1900,1037,863,67,28.35820895522388
ECU-009062,2122,28,11,17,1,28.0
ECU-009063,2122,22,8,14,1,22.0
ECU-009064,2122,80,35,45,3,26.666666666666668
ECU-009065,2122,28,11,17,1,28.0
ECU-009066,2122,353,185,168,16,22.0625
ECU-009067,2122,60,33,27,2,30.0
ECU-009068,2122,1160,565,595,37,31.35135135135135
ECU-009069,2122,73,32,41,3,24.333333333333332
ECU-009070,2122,23,8,15,1,23.0
ECU-009071,2122,22,13,9,1,22.0
ECU-009072,2122,35,13,22,1,35.0
ECU-009073,2122,362,173,189,15,24.133333333333333
ECU-009074,2122,45,21,24,2,22.5
ECU-009075,2122,53,21,32,2,26.5
ECU-009076,2122,233,112,121,13,17.923076923076923
ECU-009077,2122,912,444,468,30,30.4
ECU-009078,2122,29,13,16,1,29.0
ECU-009079,2122,40,19,21,1,40.0
ECU-009080,2122,23,13,10,1,23.0
ECU-009081,2122,35,20,15,2,17.5
ECU-009082,2122,26,15,11,1,26.0
ECU-009083,2122,140,64,76,8,17.5
ECU-009084,2122,14,10,4,1,14.0
ECU-009085,2122,28,9,19,1,28.0
ECU-009086,2122,19,8,11,1,19.0
ECU-009087,2122,42,15,27,2,21.0
ECU-009088,2122,199,99,100,9,22.11111111111111
ECU-009089,2122,324,148,176,8,40.5
ECU-009090,2122,36,14,22,2,18.0
ECU-009091,2122,175,80,95,10,17.5
ECU-009092,2122,56,34,22,2,28.0
ECU-009093,2122,24,8,16,1,24.0
ECU-009094,2122,3,0,3,1,3.0
ECU-009095,2122,218,110,108,9,24.22222222222222
ECU-009096,2122,10,4,6,1,10.0
ECU-009097,2122,36,16,20,1,36.0
ECU-009098,2122,65,28,37,1,65.0
ECU-009099,2122,35,10,25,1,35.0
ECU-009100,2122,17,6,11,1,17.0
ECU-009101,2122,19,9,10,1,19.0
ECU-009102,2122,32,14,18,2,16.0
ECU-009103,2122,540,265,275,19,28.42105263157895
ECU-009104,2122,48,28,20,2,24.0
ECU-009105,2122,400,198,202,17,23.529411764705884
ECU-009106,2122,675,324,351,23,29.347826086956523
ECU-009107,2122,20,8,12,1,20.0
ECU-009108,2122,50,25,25,2,25.0
ECU-009109,2122,19,7,12,1,19.0
ECU-009110,2122,63,30,33,2,31.5
ECU-009111,2122,75,38,37,7,10.714285714285714
ECU-009112,2122,244,128,116,12,20.333333333333332
ECU-009113,2122,482,259,223,18,26.77777777777778
ECU-009114,2122,10,6,4,1,10.0
ECU-009115,2122,10,3,7,1,10.0
ECU-009116,2122,20,10,10,1,20.0
ECU-009117,2122,14,8,6,1,14.0
ECU-009118,2122,40,16,24,2,20.0
ECU-009119,2122,19,8,11,1,19.0
ECU-009120,2122,236,113,123,7,33.714285714285715
ECU-009121,2122,3,0,3,1,3.0
ECU-009122,2122,19,9,10,1,19.0
ECU-009123,2122,29,16,13,1,29.0
ECU-009124,2122,49,29,20,2,24.5
ECU-009125,2122,33,14,19,1,33.0
ECU-009126,2122,140,73,67,5,28.0
ECU-009127,2122,551,267,284,15,36.733333333333334
ECU-009128,2122,10,2,8,1,10.0
ECU-009129,2122,458,228,230,16,28.625
ECU-009130,2122,53,25,28,2,26.5
ECU-009131,2122,33,13,20,1,33.0
ECU-009132,2122,105,56,49,4,26.25
ECU-009133,2122,406,206,200,12,33.833333333333336
ECU-009134,2122,25,14,11,1,25.0
ECU-009135,2122,11,6,5,1,11.0
ECU-009136,2122,2070,1026,1044,76,27.236842105263158
ECU-009137,2122,37,25,12,1,37.0
ECU-009138,2122,445,222,223,14,31.785714285714285
ECU-009139,2122,17,11,6,1,17.0
ECU-009140,2122,400,195,205,14,28.571428571428573
ECU-009141,2122,21,12,9,1,21.0
ECU-009142,2122,32,16,16,1,32.0
ECU-009143,2122,176,95,81,10,17.6
ECU-009144,2122,19,11,8,1,19.0
ECU-009145,2122,560,269,291,17,32.94117647058823
ECU-009146,2122,40,20,20,1,40.0
ECU-009147,2122,17,10,7,1,17.0
ECU-009148,2122,17,9,8,1,17.0
ECU-009149,2122,59,30,29,2,29.5
ECU-009150,2122,38,17,21,2,19.0
ECU-009151,2122,32,14,18,1,32.0
ECU-009152,2122,33,17,16,1,33.0
ECU-009153,2122,41,21,20,2,20.5
ECU-009154,2122,75,39,36,2,37.5
ECU-009155,2122,35,17,18,1,35.0
ECU-009156,2122,14,4,10,1,14.0
ECU-009157,2122,204,105,99,9,22.666666666666668
ECU-009158,2122,475,298,177,16,29.6875
ECU-009159,2122,20,11,9,1,20.0
ECU-009160,2122,138,68,70,8,17.25
ECU-009161,2122,28,14,14,1,28.0
ECU-009162,2122,28,13,15,1,28.0
ECU-009163,2122,19,12,7,1,19.0
ECU-009164,2122,22,9,13,4,5.5
ECU-009165,2122,41,15,26,1,41.0
ECU-009166,2122,730,364,366,26,28.076923076923077
ECU-009167,2122,60,35,25,3,20.0
ECU-009168,2122,20,8,12,5,4.0
ECU-009169,2122,341,174,167,20,17.05
ECU-009170,2122,43,24,19,6,7.166666666666667
ECU-009171,2122,23,9,14,1,23.0
ECU-009172,2122,224,110,114,12,18.666666666666668
ECU-009173,2122,3,1,2,1,3.0
ECU-009174,2122,33,11,22,4,8.25
ECU-009175,2122,20,7,13,1,20.0
ECU-009176,2122,195,90,105,7,27.857142857142858
ECU-009177,2122,26,16,10,1,26.0
ECU-009178,2122,19,10,9,1,19.0
ECU-009179,2122,891,478,413,28,31.821428571428573
ECU-009180,2122,991,537,454,39,25.41025641025641
ECU-009181,2122,1586,806,780,68,23.323529411764707
ECU-009182,2122,1295,609,686,57,22.719298245614034
ECU-009183,2122,33,12,21,2,16.5
ECU-009184,2122,265,143,122,7,37.857142857142854
ECU-009185,2122,297,149,148,9,33.0
ECU-009186,2122,220,132,88,9,24.444444444444443
ECU-009187,2122,103,56,47,3,34.333333333333336
ECU-009188,2122,139,59,80,10,13.9
ECU-009189,2122,834,434,400,52,16.03846153846154
ECU-009190,2122,486,225,261,31,15.67741935483871
ECU-009191,2122,350,156,194,21,16.666666666666668
ECU-009192,2122,168,74,94,19,8.842105263157896
ECU-009193,2122,69,40,29,7,9.857142857142858
ECU-009194,2122,28,12,16,3,9.333333333333334
ECU-009195,2122,260,113,147,15,17.333333333333332
ECU-009196,2122,489,243,246,34,14.382352941176471
ECU-009197,2122,5,1,4,1,5.0
ECU-009198,2122,689,346,343,33,20.87878787878788
ECU-009199,2122,560,272,288,39,14.35897435897436
ECU-009200,2122,222,109,113,12,18.5
ECU-009201,2122,488,228,260,30,16.266666666666666
ECU-009202,2122,169,93,76,14,12.071428571428571
ECU-009203,2122,1212,653,559,58,20.896551724137932
ECU-009204,2122,125,64,61,20,6.25
ECU-009205,2122,508,260,248,21,24.19047619047619
ECU-009206,2122,18,8,10,2,9.0
ECU-009207,2122,65,33,32,6,10.833333333333334
ECU-009208,2122,19,7,12,6,3.1666666666666665
ECU-009209,2122,9,2,7,3,3.0
ECU-009210,2122,306,157,149,11,27.818181818181817
ECU-009211,2122,528,297,231,22,24.0
ECU-009212,2122,1690,817,873,52,32.5
ECU-009213,2122,755,359,396,26,29.03846153846154
ECU-009214,2122,150,74,76,7,21.428571428571427
ECU-009215,2122,199,97,102,9,22.11111111111111
ECU-009216,2122,206,101,105,9,22.88888888888889
ECU-009217,2122,79,33,46,3,26.333333333333332
ECU-009218,2122,1334,659,675,45,29.644444444444446
ECU-009219,2122,608,284,324,21,28.952380952380953
ECU-009220,2122,1507,679,828,60,25.116666666666667
ECU-009221,2122,236,117,119,8,29.5
ECU-009222,2122,216,94,122,16,13.5
ECU-009223,2122,480,244,236,19,25.263157894736842
ECU-009224,2122,625,328,297,23,27.17391304347826
ECU-009225,2122,2071,932,1139,64,32.359375
ECU-009226,2122,2976,1697,1279,94,31.659574468085108
ECU-009227,2122,41,22,19,2,20.5
ECU-009228,2122,312,161,151,16,19.5
ECU-009229,2122,61,37,24,3,20.333333333333332
ECU-009230,2122,186,104,82,6,31.0
ECU-009231,2122,11,8,3,1,11.0
ECU-009232,2122,505,238,267,25,20.2
ECU-009233,2122,271,118,153,21,12.904761904761905
ECU-009234,2122,2177,1120,1057,72,30.23611111111111
ECU-009235,2122,197,92,105,7,28.142857142857142
ECU-009236,2122,2068,1076,992,55,37.6
ECU-009237,2122,1000,489,511,30,33.333333333333336
ECU-009238,2122,132,69,63,6,22.0
ECU-009239,2122,212,96,116,8,26.5
ECU-009240,2122,127,59,68,9,14.11111111111111
ECU-009241,2122,175,95,80,13,13.461538461538462
ECU-009242,2122,303,137,166,10,30.3
ECU-009243,2122,433,216,217,20,21.65
ECU-009244,2122,1050,604,446,21,50.0
ECU-009245,2122,285,141,144,9,31.666666666666668
ECU-009246,2122,44,19,25,2,22.0
ECU-009247,2122,333,160,173,14,23.785714285714285
ECU-009248,2122,60,27,33,2,30.0
ECU-009249,2122,1240,651,589,46,26.956521739130434
ECU-009250,2122,23,12,11,1,23.0
ECU-009251,2122,67,28,39,4,16.75
ECU-009252,2122,123,66,57,4,30.75
ECU-009253,2122,1744,853,891,62,28.129032258064516
ECU-009254,2122,175,98,77,7,25.0
ECU-009255,2122,236,118,118,14,16.857142857142858
ECU-009256,2122,439,199,240,17,25.823529411764707
ECU-009257,2122,1035,557,478,33,31.363636363636363
ECU-009258,2122,72,40,32,3,24.0
ECU-009259,2122,23,16,7,1,23.0
ECU-009260,2122,40,21,19,2,20.0
ECU-009261,2122,77,32,45,3,25.666666666666668
ECU-009262,2122,30,14,16,1,30.0
ECU-009263,2122,499,260,239,19,26.263157894736842
ECU-009264,2122,50,25,25,3,16.666666666666668
ECU-009265,2122,145,74,71,6,24.166666666666668
ECU-009266,2122,75,43,32,3,25.0
ECU-009267,2122,22,15,7,1,22.0
ECU-009268,2122,414,203,211,15,27.6
ECU-009269,2122,104,57,47,4,26.0
ECU-009270,2122,25,12,13,1,25.0
ECU-009271,2122,1031,504,527,36,28.63888888888889
ECU-009272,2122,47,20,27,2,23.5
ECU-009273,2122,76,43,33,2,38.0
ECU-009274,2122,738,357,381,29,25.448275862068964
ECU-009275,2122,320,154,166,15,21.333333333333332
ECU-009276,2122,61,30,31,8,7.625
ECU-009277,2122,33,15,18,6,5.5
ECU-009278,2122,674,367,307,27,24.962962962962962
ECU-009279,2122,351,167,184,14,25.071428571428573
ECU-009280,2122,525,264,261,18,29.166666666666668
ECU-009281,2122,446,211,235,17,26.235294117647058
ECU-009282,2122,60,33,27,3,20.0
ECU-009283,2122,383,185,198,12,31.916666666666668
ECU-009284,2122,507,262,245,22,23.045454545454547
ECU-009285,2122,7,2,5,1,7.0
ECU-009286,2122,162,76,86,7,23.142857142857142
ECU-009287,2122,774,390,384,25,30.96
ECU-009288,2122,633,322,311,23,27.52173913043478
ECU-009289,2122,533,257,276,21,25.38095238095238
ECU-009290,2122,222,95,127,12,18.5
ECU-009291,2122,567,281,286,23,24.652173913043477
ECU-009292,2122,559,294,265,22,25.40909090909091
ECU-009293,2122,119,58,61,6,19.833333333333332
ECU-009294,2122,86,47,39,3,28.666666666666668
ECU-009295,2122,102,51,51,9,11.333333333333334
ECU-009296,2122,77,41,36,3,25.666666666666668
ECU-009297,2122,475,231,244,17,27.941176470588236
ECU-009298,2122,139,64,75,4,34.75
ECU-009299,2122,106,45,61,4,26.5
ECU-009300,2122,472,225,247,18,26.22222222222222
ECU-009301,2122,733,371,362,23,31.869565217391305
ECU-009302,2122,944,419,525,35,26.97142857142857
ECU-009303,2122,1198,568,630,41,29.21951219512195
ECU-009304,2122,461,238,223,17,27.11764705882353
ECU-009305,2122,215,109,106,8,26.875
ECU-009306,2122,266,138,128,10,26.6
ECU-009307,2122,1114,511,603,46,24.217391304347824
ECU-009308,2122,12,4,8,1,12.0
ECU-009309,2122,426,215,211,16,26.625
ECU-009310,2122,117,52,65,5,23.4
ECU-009311,2122,606,280,326,31,19.548387096774192
ECU-009312,2122,24,11,13,1,24.0
ECU-009313,2122,256,137,119,9,28.444444444444443
ECU-009314,2122,158,73,85,7,22.571428571428573
ECU-009315,2122,63,30,33,3,21.0
ECU-009316,2122,7,3,4,1,7.0
ECU-009317,2122,318,151,167,14,22.714285714285715
ECU-009318,2122,190,99,91,9,21.11111111111111
ECU-009319,2122,916,412,504,48,19.083333333333332
ECU-009320,2122,892,450,442,31,28.774193548387096
ECU-009321,2122,15,6,9,4,3.75
ECU-009322,2122,560,294,266,19,29.473684210526315
ECU-009323,2122,748,377,371,29,25.79310344827586
ECU-009324,2122,571,263,308,21,27.19047619047619
ECU-009325,2122,182,87,95,14,13.0
ECU-009326,2122,426,203,223,15,28.4
ECU-009327,2122,366,187,179,11,33.27272727272727
ECU-009328,2122,977,580,397,52,18.78846153846154
ECU-009329,2122,33,16,17,5,6.6
ECU-009330,2122,41,23,18,5,8.2
ECU-009331,2122,2112,1003,1109,60,35.2
ECU-009332,2122,592,288,304,16,37.0
ECU-009333,2122,364,155,209,19,19.157894736842106
ECU-009334,2122,143,82,61,9,15.88888888888889
ECU-009335,2122,60,22,38,8,7.5
ECU-009336,2122,348,170,178,11,31.636363636363637
ECU-009337,2122,848,427,421,28,30.285714285714285
ECU-009338,2122,1669,846,823,67,24.91044776119403
ECU-009339,2122,365,162,203,13,28.076923076923077
ECU-009340,2122,1587,797,790,56,28.339285714285715
ECU-009341,2122,172,80,92,13,13.23076923076923
ECU-009342,2122,4,4,0,2,2.0
ECU-009343,2122,263,115,148,18,14.61111111111111
ECU-009344,2122,58,25,33,9,6.444444444444445
ECU-009345,2122,73,36,37,10,7.3
ECU-009346,2122,30,16,14,2,15.0
ECU-009347,2122,1001,502,499,32,31.28125
ECU-009348,2122,148,59,89,9,16.444444444444443
ECU-009349,2122,775,378,397,25,31.0
ECU-009350,2122,73,44,29,8,9.125
ECU-009351,2122,218,100,118,8,27.25
ECU-009352,2122,76,34,42,5,15.2
ECU-009353,2122,1556,862,694,44,35.36363636363637
ECU-009354,2122,217,120,97,6,36.166666666666664
ECU-009355,2122,1394,670,724,39,35.743589743589745
ECU-009356,2122,633,314,319,35,18.085714285714285
ECU-009357,2122,2266,1122,1144,66,34.333333333333336
ECU-009358,2122,392,186,206,20,19.6
ECU-009359,2122,2353,1243,1110,94,25.03191489361702
ECU-009360,2122,356,186,170,16,22.25
ECU-009361,2122,544,266,278,20,27.2
ECU-009362,2122,452,198,254,17,26.58823529411765
ECU-009363,2122,1501,696,805,47,31.93617021276596
ECU-009364,2122,1321,716,605,35,37.74285714285714
ECU-009365,2122,126,66,60,6,21.0
ECU-009366,2122,53,25,28,5,10.6
ECU-009367,2122,899,463,436,33,27.242424242424242
ECU-009368,2122,1109,601,508,34,32.61764705882353
ECU-009369,2122,324,156,168,11,29.454545454545453
ECU-009370,2122,739,326,413,27,27.37037037037037
ECU-009371,2122,76,37,39,10,7.6
ECU-009372,2122,753,360,393,33,22.818181818181817
ECU-009373,2122,73,43,30,7,10.428571428571429
ECU-009374,2122,864,399,465,38,22.736842105263158
ECU-009375,2122,214,94,120,12,17.833333333333332
ECU-009376,2122,36,28,8,12,3.0
ECU-009377,2122,26,16,10,2,13.0
ECU-009378,2122,3088,1531,1557,102,30.274509803921568
ECU-009379,2122,20,14,6,3,6.666666666666667
ECU-009380,2122,815,375,440,25,32.6
ECU-009381,2122,9,2,7,2,4.5
ECU-009382,2122,58,28,30,9,6.444444444444445
ECU-009383,2122,1227,605,622,59,20.796610169491526
ECU-009384,2122,649,343,306,31,20.93548387096774
ECU-009385,2122,34,18,16,6,5.666666666666667
ECU-009386,2122,1002,488,514,34,29.470588235294116
ECU-009387,2122,350,157,193,12,29.166666666666668
ECU-009388,2122,1662,806,856,54,30.77777777777778
ECU-009389,2122,178,75,103,13,13.692307692307692
ECU-009390,2122,204,110,94,14,14.571428571428571
ECU-009391,2122,93,46,47,5,18.6
ECU-009392,2122,36,14,22,6,6.0
ECU-009393,2122,88,46,42,9,9.777777777777779
ECU-009394,2122,156,105,51,9,17.333333333333332
ECU-009395,2122,570,279,291,25,22.8
ECU-009396,2122,290,140,150,9,32.22222222222222
ECU-009397,2122,1128,553,575,51,22.11764705882353
ECU-009398,2122,611,293,318,33,18.515151515151516
ECU-009399,2122,533,260,273,22,24.227272727272727
ECU-009400,2122,648,325,323,22,29.454545454545453
ECU-009401,2122,990,484,506,27,36.666666666666664
ECU-009402,2122,1067,519,548,34,31.38235294117647
ECU-009403,2122,1138,549,589,38,29.94736842105263
ECU-009404,2122,800,407,393,26,30.76923076923077
ECU-009405,2122,371,180,191,34,10.911764705882353
ECU-009406,2122,22,7,15,1,22.0
ECU-009407,2122,12,4,8,1,12.0
ECU-009408,2122,22,10,12,1,22.0
ECU-009409,2122,456,218,238,26,17.53846153846154
ECU-009410,2122,43,24,19,1,43.0
ECU-009411,2122,9,4,5,1,9.0
ECU-009412,2122,138,65,73,11,12.545454545454545
ECU-009413,2122,155,71,84,11,14.090909090909092
ECU-009414,2122,241,102,139,15,16.066666666666666
ECU-009415,2122,959,508,451,30,31.966666666666665
ECU-009416,2122,249,118,131,4,62.25
ECU-009417,2122,470,242,228,18,26.11111111111111
ECU-009418,2122,375,177,198,13,28.846153846153847
ECU-009419,2122,66,31,35,5,13.2
ECU-009420,2122,59,27,32,11,5.363636363636363
ECU-009421,2122,274,124,150,10,27.4
ECU-009422,2122,6,2,4,1,6.0
ECU-009423,2122,164,77,87,14,11.714285714285714
ECU-009424,2122,70,28,42,10,7.0
ECU-009425,2122,8,4,4,1,8.0
ECU-009426,2122,674,323,351,22,30.636363636363637
ECU-009427,2122,12,4,8,1,12.0
ECU-009428,2122,275,138,137,9,30.555555555555557
ECU-009429,2122,138,68,70,9,15.333333333333334
ECU-009430,2122,10,2,8,2,5.0
ECU-009431,2122,589,286,303,23,25.608695652173914
ECU-009432,2122,29,7,22,6,4.833333333333333
ECU-009433,2122,7,5,2,1,7.0
ECU-009434,2122,235,120,115,14,16.785714285714285
ECU-009435,2122,78,38,40,7,11.142857142857142
ECU-009436,2122,79,41,38,5,15.8
ECU-009437,2122,216,107,109,8,27.0
ECU-009438,2122,153,70,83,8,19.125
ECU-009439,2122,118,64,54,6,19.666666666666668
ECU-009440,2122,198,100,98,5,39.6
ECU-009441,2122,807,408,399,35,23.057142857142857
ECU-009442,2122,413,212,201,19,21.736842105263158
ECU-009443,2122,182,100,82,17,10.705882352941176
ECU-009444,2122,597,305,292,28,21.321428571428573
ECU-009445,2122,1047,533,514,49,21.367346938775512
ECU-009446,2122,100,41,59,11,9.090909090909092
ECU-009447,2122,400,213,187,18,22.22222222222222
ECU-009448,2122,943,470,473,37,25.486486486486488
ECU-009449,2122,7,2,5,0,
ECU-009450,2122,7,3,4,0,
ECU-009451,2122,1,0,1,0,
ECU-009452,2122,731,335,396,30,24.366666666666667
ECU-009453,2122,87,48,39,3,29.0
ECU-009454,2122,1133,591,542,41,27.634146341463413
ECU-009455,2122,17,8,9,0,
ECU-009456,2122,57,33,24,2,28.5
ECU-009457,2122,50,24,26,2,25.0
ECU-009458,2122,92,46,46,6,15.333333333333334
ECU-009459,2122,41,25,16,2,20.5
ECU-009460,2122,27,10,17,0,
ECU-009461,2122,14,5,9,1,14.0
ECU-009462,2122,37,19,18,1,37.0
ECU-009463,2122,447,228,219,27,16.555555555555557
ECU-009464,2122,905,426,479,40,22.625
ECU-009465,2122,11,4,7,1,11.0
ECU-009466,2122,173,78,95,11,15.727272727272727
ECU-009467,2122,36,18,18,3,12.0
ECU-009468,2122,1444,712,732,52,27.76923076923077
ECU-009469,2122,51,23,28,4,12.75
ECU-009470,2122,19,10,9,2,9.5
ECU-009471,2122,25,7,18,3,8.333333333333334
ECU-009472,2122,17,8,9,2,8.5
ECU-009473,2122,113,58,55,6,18.833333333333332
ECU-009474,2122,121,60,61,7,17.285714285714285
ECU-009475,2122,62,35,27,3,20.666666666666668
ECU-009476,2122,5,3,2,1,5.0
ECU-009477,2122,73,35,38,7,10.428571428571429
ECU-009478,2122,131,69,62,9,14.555555555555555
ECU-009479,2122,91,46,45,8,11.375
ECU-009480,2122,66,30,36,5,13.2
ECU-009481,2122,10,3,7,1,10.0
ECU-009482,2122,28,14,14,6,4.666666666666667
ECU-009483,2122,202,101,101,17,11.882352941176471
ECU-009484,2122,13,7,6,1,13.0
ECU-009485,2122,226,119,107,18,12.555555555555555
ECU-009486,2122,10,7,3,1,10.0
ECU-009487,2122,63,31,32,3,21.0
ECU-009488,2122,89,46,43,7,12.714285714285714
ECU-009489,2122,5,1,4,1,5.0
ECU-009490,2122,43,17,26,3,14.333333333333334
ECU-009491,2122,5,2,3,1,5.0
ECU-009492,2122,24,11,13,2,12.0
ECU-009493,2122,21,15,6,2,10.5
ECU-009494,2122,3,0,3,1,3.0
ECU-009495,2122,3,1,2,1,3.0
ECU-009496,2122,39,19,20,2,19.5
ECU-009497,2122,3,1,2,1,3.0
ECU-009498,2122,265,131,134,15,17.666666666666668
ECU-009499,2122,575,267,308,32,17.96875
ECU-009500,2122,664,352,312,37,17.945945945945947
ECU-009501,2122,76,34,42,8,9.5
ECU-009502,2122,1070,572,498,41,26.097560975609756
ECU-009503,2122,1170,497,673,43,27.209302325581394
ECU-009504,2122,1140,501,639,41,27.804878048780488
ECU-009505,2122,1494,898,596,43,34.74418604651163
ECU-009506,2122,1638,434,1204,71,23.070422535211268
ECU-009507,2122,862,404,458,41,21.024390243902438
ECU-009508,2122,13,7,6,2,6.5
ECU-009509,2122,78,27,51,10,7.8
ECU-009510,2122,38,15,23,10,3.8
ECU-009511,2122,1047,621,426,44,23.795454545454547
ECU-009512,2122,41,20,21,13,3.1538461538461537
ECU-009513,2122,102,46,56,13,7.846153846153846
ECU-009514,2122,772,365,407,35,22.057142857142857
ECU-009515,2122,20,6,14,2,10.0
ECU-009516,2122,58,25,33,15,3.8666666666666667
ECU-009517,2122,1304,628,676,50,26.08
ECU-009518,2122,60,30,30,12,5.0
ECU-009519,2122,1077,476,601,59,18.25423728813559
ECU-009520,2122,223,100,123,10,22.3
ECU-009521,2122,954,490,464,30,31.8
ECU-009522,2122,262,140,122,17,15.411764705882353
ECU-009523,2122,180,94,86,9,20.0
ECU-009524,2122,784,400,384,28,28.0
ECU-009525,2122,23,17,6,4,5.75
ECU-009526,2122,21,7,14,13,1.6153846153846154
ECU-009527,2122,810,365,445,38,21.31578947368421
ECU-009528,2122,980,558,422,58,16.896551724137932
ECU-009529,2122,939,939,0,67,14.014925373134329
ECU-009530,2122,666,344,322,31,21.483870967741936
ECU-009531,2122,1020,705,315,48,21.25
ECU-009532,2122,659,380,279,24,27.458333333333332
ECU-009533,2122,371,84,287,20,18.55
ECU-009534,2122,908,486,422,59,15.389830508474576
ECU-009535,2122,242,113,129,12,20.166666666666668
ECU-009536,2122,23,13,10,3,7.666666666666667
ECU-009537,2122,243,108,135,15,16.2
ECU-009538,2122,237,119,118,15,15.8
ECU-009539,2122,1451,850,601,56,25.910714285714285
ECU-009540,2122,10,3,7,26,0.38461538461538464
ECU-009541,2122,329,206,123,13,25.307692307692307
ECU-009542,2122,9,2,7,4,2.25
ECU-009543,2122,738,350,388,40,18.45
ECU-009544,2122,494,242,252,26,19.0
ECU-009545,2122,1388,708,680,56,24.785714285714285
ECU-009546,2122,44,21,23,2,22.0
ECU-009547,2122,264,100,164,23,11.478260869565217
ECU-009548,2122,857,389,468,48,17.854166666666668
ECU-009549,2122,1163,854,309,46,25.282608695652176
ECU-009550,2122,227,95,132,14,16.214285714285715
ECU-009551,2122,1593,882,711,61,26.114754098360656
ECU-009552,2122,1030,432,598,31,33.225806451612904
ECU-009553,2122,524,249,275,26,20.153846153846153
ECU-009554,2122,897,133,764,59,15.203389830508474
ECU-009555,2122,1925,575,1350,83,23.19277108433735
ECU-009556,2122,336,166,170,15,22.4
ECU-009557,2122,100,54,46,10,10.0
ECU-009558,2122,198,104,94,9,22.0
ECU-009559,2122,897,453,444,40,22.425
ECU-009560,2122,2622,1340,1282,151,17.364238410596027
ECU-009561,2122,43,19,24,3,14.333333333333334
ECU-009562,2122,38,14,24,16,2.375
ECU-009563,2122,43,17,26,6,7.166666666666667
ECU-009564,2122,20,13,7,8,2.5
ECU-009565,2122,36,12,24,15,2.4
ECU-009566,2122,222,79,143,37,6.0
ECU-009567,2122,9,5,4,2,4.5
ECU-009568,2122,11,5,6,2,5.5
ECU-009569,2122,694,310,384,31,22.387096774193548
ECU-009570,2122,812,416,396,42,19.333333333333332
ECU-009571,2122,196,84,112,9,21.77777777777778
ECU-009572,2122,791,349,442,38,20.81578947368421
ECU-009573,2122,288,141,147,15,19.2
ECU-009574,2122,247,105,142,14,17.642857142857142
ECU-009575,2122,201,105,96,12,16.75
ECU-009576,2122,698,290,408,51,13.686274509803921
ECU-009577,2122,666,269,397,45,14.8
ECU-009578,2122,1517,578,939,55,27.581818181818182
ECU-009579,2122,31,12,19,4,7.75
ECU-009580,2122,1120,1120,0,53,21.132075471698112
ECU-009581,2122,612,312,300,28,21.857142857142858
ECU-009582,2122,1219,570,649,56,21.767857142857142
ECU-009583,2122,32,14,18,4,8.0
ECU-009584,2122,793,714,79,45,17.622222222222224
ECU-009585,2122,756,374,382,61,12.39344262295082
ECU-009586,2122,158,75,83,8,19.75
ECU-009587,2122,321,161,160,14,22.928571428571427
ECU-009588,2122,568,291,277,33,17.21212121212121
ECU-009589,2122,1238,652,586,64,19.34375
ECU-009590,2122,264,138,126,11,24.0
ECU-009591,2122,459,213,246,19,24.157894736842106
ECU-009592,2122,563,279,284,28,20.107142857142858
ECU-009593,2122,237,111,126,13,18.23076923076923
ECU-009594,2122,168,71,97,7,24.0
ECU-009595,2122,1150,533,617,55,20.90909090909091
ECU-009596,2122,1161,661,500,57,20.36842105263158
ECU-009597,2122,102,50,52,11,9.272727272727273
ECU-009598,2122,323,137,186,22,14.681818181818182
ECU-009599,2122,610,270,340,28,21.785714285714285
ECU-009600,2122,385,224,161,20,19.25
ECU-009601,2122,31,20,11,6,5.166666666666667
ECU-009602,2122,22,9,13,1,22.0
ECU-009603,2122,1100,1100,0,43,25.58139534883721
ECU-009604,2122,798,348,450,36,22.166666666666668
ECU-009605,2122,50,23,27,6,8.333333333333334
ECU-009606,2122,10,5,5,1,10.0
ECU-009607,2122,664,300,364,43,15.44186046511628
ECU-009608,2122,1457,695,762,62,23.5
ECU-009609,2122,207,82,125,14,14.785714285714286
ECU-009610,2122,932,448,484,41,22.73170731707317
ECU-009611,2122,1139,620,519,59,19.305084745762713
ECU-009612,2122,534,266,268,31,17.225806451612904
ECU-009613,2122,879,436,443,36,24.416666666666668
ECU-009614,2122,961,479,482,50,19.22
ECU-009615,2122,907,490,417,49,18.510204081632654
ECU-009616,2122,2,1,1,2,1.0
ECU-009617,2122,87,36,51,5,17.4
ECU-009618,2122,2179,1263,916,90,24.211111111111112
ECU-009619,2122,170,77,93,8,21.25
ECU-009620,2122,85,55,30,10,8.5
ECU-009621,2122,935,434,501,39,23.974358974358974
ECU-009622,2122,72,29,43,8,9.0
ECU-009623,2122,878,461,417,41,21.414634146341463
ECU-009624,2122,630,280,350,30,21.0
ECU-009625,2122,634,296,338,35,18.114285714285714
ECU-009626,2122,100,61,39,14,7.142857142857143
ECU-009627,2122,133,50,83,17,7.823529411764706
ECU-009628,2122,606,307,299,29,20.896551724137932
ECU-009629,2122,95,37,58,11,8.636363636363637
ECU-009630,2122,371,191,180,13,28.53846153846154
ECU-009631,2122,236,103,133,24,9.833333333333334
ECU-009632,2122,8,4,4,2,4.0
ECU-009633,2122,64,28,36,6,10.666666666666666
ECU-009634,2122,571,286,285,27,21.14814814814815
ECU-009635,2122,732,367,365,26,28.153846153846153
ECU-009636,2122,2272,605,1667,138,16.463768115942027
ECU-009637,2122,1311,697,614,54,24.27777777777778
ECU-009638,2122,815,383,432,36,22.63888888888889
ECU-009639,2122,899,466,433,32,28.09375
ECU-009640,2122,448,222,226,24,18.666666666666668
ECU-009641,2122,193,96,97,12,16.083333333333332
ECU-009642,2122,183,83,100,9,20.333333333333332
ECU-009643,2122,1109,578,531,46,24.108695652173914
ECU-009644,2122,724,360,364,34,21.294117647058822
ECU-009645,2122,922,456,466,43,21.441860465116278
ECU-009646,2122,785,361,424,31,25.322580645161292
ECU-009647,2122,151,83,68,10,15.1
ECU-009648,2122,201,98,103,14,14.357142857142858
ECU-009649,2122,140,79,61,9,15.555555555555555
ECU-009650,2122,842,435,407,37,22.756756756756758
ECU-009651,2122,424,203,221,27,15.703703703703704
ECU-009652,2122,1322,0,1322,106,12.471698113207546
ECU-009653,2122,465,212,253,45,10.333333333333334
ECU-009654,2122,648,323,325,38,17.05263157894737
ECU-009655,2122,316,143,173,16,19.75
ECU-009656,2122,361,181,180,29,12.448275862068966
ECU-009657,2122,245,124,121,13,18.846153846153847
ECU-009658,2122,26,15,11,2,13.0
ECU-009659,2122,624,297,327,29,21.517241379310345
ECU-009660,2122,381,199,182,18,21.166666666666668
ECU-009661,2122,458,251,207,18,25.444444444444443
ECU-009662,2122,10,5,5,1,10.0
ECU-009663,2122,13,4,9,1,13.0
ECU-009664,2122,15,9,6,1,15.0
ECU-009665,2122,10,6,4,1,10.0
ECU-009666,2122,10,6,4,1,10.0
ECU-009667,2122,24,15,9,1,24.0
ECU-009668,2122,22,20,2,2,11.0
ECU-009669,2122,4,2,2,1,4.0
ECU-009670,2122,10,4,6,1,10.0
ECU-009671,2122,3,2,1,1,3.0
ECU-009672,2122,28,5,23,1,28.0
ECU-009673,2122,167,75,92,11,15.181818181818182
ECU-009674,2122,52,23,29,3,17.333333333333332
ECU-009675,2122,494,258,236,24,20.583333333333332
ECU-009676,2122,42,25,17,2,21.0
ECU-009677,2122,1213,604,609,50,24.26
ECU-009678,2122,65,32,33,3,21.666666666666668
ECU-009679,2122,193,104,89,11,17.545454545454547
ECU-009680,2122,20,11,9,1,20.0
ECU-009681,2122,454,217,237,25,18.16
ECU-009682,2122,16,7,9,1,16.0
ECU-009683,2122,163,83,80,11,14.818181818181818
ECU-009684,2122,390,197,193,18,21.666666666666668
ECU-009685,2122,39,15,24,2,19.5
ECU-009686,2122,699,320,379,32,21.84375
ECU-009687,2122,15,9,6,1,15.0
ECU-009688,2122,13,9,4,1,13.0
ECU-009689,2122,9,2,7,1,9.0
ECU-009690,2122,24,12,12,1,24.0
ECU-009691,2122,161,81,80,8,20.125
ECU-009692,2122,8,6,2,1,8.0
ECU-009693,2122,242,119,123,12,20.166666666666668
ECU-009694,2122,26,8,18,1,26.0
ECU-009695,2122,14,7,7,1,14.0
ECU-009696,2122,28,14,14,2,14.0
ECU-009697,2122,5,5,0,1,5.0
ECU-009698,2122,14,8,6,1,14.0
ECU-009699,2122,407,196,211,16,25.4375
ECU-009700,2122,8,1,7,1,8.0
ECU-009701,2122,11,3,8,1,11.0
ECU-009702,2122,20,9,11,1,20.0
ECU-009703,2122,30,16,14,1,30.0
ECU-009704,2122,45,24,21,2,22.5
ECU-009705,2122,143,61,82,7,20.428571428571427
ECU-009706,2122,5,4,1,1,5.0
ECU-009707,2122,26,7,19,2,13.0
ECU-009708,2122,66,32,34,6,11.0
ECU-009709,2122,5,3,2,1,5.0
ECU-009710,2122,65,35,30,3,21.666666666666668
ECU-009711,2122,18,12,6,1,18.0
ECU-009712,2122,737,331,406,28,26.321428571428573
ECU-009713,2122,200,95,105,15,13.333333333333334
ECU-009714,2122,17,9,8,1,17.0
ECU-009715,2122,7,4,3,1,7.0
ECU-009716,2122,19,11,8,1,19.0
ECU-009717,2122,33,21,12,6,5.5
ECU-009718,2122,20,9,11,1,20.0
ECU-009719,2122,42,18,24,2,21.0
ECU-009720,2122,56,30,26,3,18.666666666666668
ECU-009721,2122,12,5,7,1,12.0
ECU-009722,2122,11,3,8,1,11.0
ECU-009723,2122,9,4,5,1,9.0
ECU-009724,2122,76,30,46,4,19.0
ECU-009725,2122,6,3,3,1,6.0
ECU-009726,2122,67,34,33,4,16.75
ECU-009727,2122,4,3,1,1,4.0
ECU-009728,2122,24,10,14,1,24.0
ECU-009729,2122,45,21,24,3,15.0
ECU-009730,2122,64,25,39,2,32.0
ECU-009731,2122,7,2,5,1,7.0
ECU-009732,2122,23,10,13,2,11.5
ECU-009733,2122,11,4,7,2,5.5
ECU-009734,2122,351,139,212,23,15.26086956521739
ECU-009735,2122,219,98,121,15,14.6
ECU-009736,2122,806,380,426,67,12.029850746268657
ECU-009737,2122,21,7,14,2,10.5
ECU-009738,2122,25,15,10,1,25.0
ECU-009739,2122,432,219,213,18,24.0
ECU-009740,2122,19,8,11,2,9.5
ECU-009741,2122,15,10,5,2,7.5
ECU-009742,2122,377,202,175,20,18.85
ECU-009743,2122,11,3,8,2,5.5
ECU-009744,2122,816,407,409,45,18.133333333333333
ECU-009745,2122,13,8,5,1,13.0
ECU-009746,2122,184,85,99,11,16.727272727272727
ECU-009747,2122,47,21,26,3,15.666666666666666
ECU-009748,2122,270,143,127,19,14.210526315789474
ECU-009749,2122,10,4,6,1,10.0
ECU-009750,2122,27,14,13,2,13.5
ECU-009751,2122,33,21,12,2,16.5
ECU-009752,2122,16,9,7,1,16.0
ECU-009753,2122,817,391,426,35,23.34285714285714
ECU-009754,2122,32,19,13,5,6.4
ECU-009755,2122,1240,503,737,55,22.545454545454547
ECU-009756,2122,1470,759,711,56,26.25
ECU-009757,2122,681,299,382,44,15.477272727272727
ECU-009758,2122,130,56,74,8,16.25
ECU-009759,2122,310,138,172,16,19.375
ECU-009760,2122,141,76,65,11,12.818181818181818
ECU-009761,2122,471,250,221,30,15.7
ECU-009762,2122,225,97,128,10,22.5
ECU-009763,2122,296,132,164,14,21.142857142857142
ECU-009764,2122,273,136,137,18,15.166666666666666
ECU-009765,2122,11,6,5,1,11.0
ECU-009766,2122,36,21,15,2,18.0
ECU-009767,2122,800,374,426,44,18.181818181818183
ECU-009768,2122,251,118,133,15,16.733333333333334
ECU-009769,2122,269,149,120,18,14.944444444444445
ECU-009770,2122,8,4,4,1,8.0
ECU-009771,2122,90,44,46,7,12.857142857142858
ECU-009772,2122,8,2,6,1,8.0
ECU-009773,2122,596,301,295,28,21.285714285714285
ECU-009774,2122,320,164,156,23,13.91304347826087
ECU-009775,2122,342,165,177,14,24.428571428571427
ECU-009776,2122,784,390,394,26,30.153846153846153
ECU-009777,2122,621,291,330,55,11.290909090909091
ECU-009778,2122,359,180,179,17,21.11764705882353
ECU-009779,2122,32,9,23,2,16.0
ECU-009780,2122,306,168,138,20,15.3
ECU-009781,2122,33,14,19,2,16.5
ECU-009782,2122,167,74,93,11,15.181818181818182
ECU-009783,2122,556,281,275,30,18.533333333333335
ECU-009784,2122,183,89,94,13,14.076923076923077
ECU-009785,2122,144,71,73,6,24.0
ECU-009786,2122,204,102,102,14,14.571428571428571
ECU-009787,2122,359,172,187,19,18.894736842105264
ECU-009788,2122,31,15,16,2,15.5
ECU-009789,2122,71,36,35,3,23.666666666666668
ECU-009790,2122,100,47,53,4,25.0
ECU-009791,2122,316,160,156,13,24.307692307692307
ECU-009792,2122,25,13,12,2,12.5
ECU-009793,2122,7,5,2,1,7.0
ECU-009794,2122,17,10,7,1,17.0
ECU-009795,2122,459,249,210,18,25.5
ECU-009796,2122,10,5,5,1,10.0
ECU-009797,2122,30,14,16,1,30.0
ECU-009798,2122,9,5,4,1,9.0
ECU-009799,2122,738,356,382,33,22.363636363636363
ECU-009800,2122,7,5,2,1,7.0
ECU-009801,2122,21,14,7,2,10.5
ECU-009802,2122,179,85,94,11,16.272727272727273
ECU-009803,2122,207,94,113,13,15.923076923076923
ECU-009804,2122,9,6,3,1,9.0
ECU-009805,2122,183,87,96,12,15.25
ECU-009806,2122,25,16,9,2,12.5
ECU-009807,2122,280,152,128,17,16.470588235294116
ECU-009808,2122,238,111,127,14,17.0
ECU-009809,2122,79,40,39,4,19.75
ECU-009810,2122,248,116,132,16,15.5
ECU-009811,2122,498,238,260,31,16.06451612903226
ECU-009812,2122,176,79,97,9,19.555555555555557
ECU-009813,2122,302,170,132,18,16.77777777777778
ECU-009814,2122,6,3,3,1,6.0
ECU-009815,2122,107,54,53,8,13.375
ECU-009816,2122,1376,650,726,61,22.557377049180328
ECU-009817,2122,97,45,52,4,24.25
ECU-009818,2122,4,0,4,1,4.0
ECU-009819,2122,356,172,184,15,23.733333333333334
ECU-009820,2122,354,159,195,11,32.18181818181818
ECU-009821,2122,623,250,373,30,20.766666666666666
ECU-009822,2122,873,500,373,34,25.676470588235293
ECU-009823,2122,121,62,59,6,20.166666666666668
ECU-009824,2122,16,7,9,1,16.0
ECU-009825,2122,1134,548,586,50,22.68
ECU-009826,2122,34,18,16,2,17.0
ECU-009827,2122,29,15,14,9,3.2222222222222223
ECU-009828,2122,8,1,7,1,8.0
ECU-009829,2122,28,16,12,2,14.0
ECU-009830,2122,510,246,264,27,18.88888888888889
ECU-009831,2122,614,315,299,30,20.466666666666665
ECU-009832,2122,7,2,5,1,7.0
ECU-009833,2122,10,5,5,1,10.0
ECU-009834,2122,32,17,15,2,16.0
ECU-009835,2122,9,6,3,1,9.0
ECU-009836,2122,14,5,9,1,14.0
ECU-009837,2122,15,7,8,1,15.0
ECU-009838,2122,201,108,93,10,20.1
ECU-009839,2122,10,1,9,1,10.0
ECU-009840,2122,10,4,6,1,10.0
ECU-009841,2122,15,7,8,1,15.0
ECU-009842,2122,291,153,138,11,26.454545454545453
ECU-009843,2122,18,10,8,1,18.0
ECU-009844,2122,364,200,164,15,24.266666666666666
ECU-009845,2122,142,62,80,8,17.75
ECU-009846,2122,417,228,189,17,24.529411764705884
ECU-009847,2122,16,8,8,1,16.0
ECU-009848,2122,8,2,6,1,8.0
ECU-009849,2122,12,5,7,1,12.0
ECU-009850,2122,7,7,0,1,7.0
ECU-009851,2122,12,6,6,1,12.0
ECU-009852,2122,100,51,49,6,16.666666666666668
ECU-009853,2122,502,330,172,29,17.310344827586206
ECU-009854,2122,5,1,4,1,5.0
ECU-009855,2122,76,35,41,9,8.444444444444445
ECU-009856,2122,1287,538,749,53,24.28301886792453
ECU-009857,2122,836,446,390,46,18.17391304347826
ECU-009858,2122,66,34,32,10,6.6
ECU-009859,2122,22,11,11,1,22.0
ECU-009860,2122,1044,546,498,43,24.27906976744186
ECU-009861,2122,820,372,448,31,26.451612903225808
ECU-009862,2122,267,132,135,13,20.53846153846154
ECU-009863,2122,9,6,3,1,9.0
ECU-009864,2122,395,216,179,15,26.333333333333332
ECU-009865,2122,512,262,250,24,21.333333333333332
ECU-009866,2122,48,20,28,4,12.0
ECU-009867,2122,71,40,31,3,23.666666666666668
ECU-009868,2122,782,428,354,36,21.72222222222222
ECU-009869,2122,504,285,219,18,28.0
ECU-009870,2122,220,106,114,11,20.0
ECU-009871,2122,111,58,53,7,15.857142857142858
ECU-009872,2122,45,20,25,2,22.5
ECU-009873,2122,93,58,35,5,18.6
ECU-009874,2122,277,142,135,12,23.083333333333332
ECU-009875,2122,524,256,268,23,22.782608695652176
ECU-009876,2122,167,77,90,10,16.7
ECU-009877,2122,8,6,2,1,8.0
ECU-009878,2122,11,8,3,1,11.0
ECU-009879,2122,7,4,3,1,7.0
ECU-009880,2122,33,14,19,2,16.5
ECU-009881,2122,21,11,10,1,21.0
ECU-009882,2122,36,21,15,2,18.0
ECU-009883,2122,14,7,7,1,14.0
ECU-009884,2122,17,10,7,1,17.0
ECU-009885,2122,66,31,35,4,16.5
ECU-009886,2122,16,12,4,1,16.0
ECU-009887,2122,75,39,36,3,25.0
ECU-009888,2122,15,10,5,1,15.0
ECU-009889,2122,390,199,191,20,19.5
ECU-009890,2122,61,31,30,3,20.333333333333332
ECU-009891,2122,8,5,3,1,8.0
ECU-009892,2122,15,6,9,1,15.0
ECU-009893,2122,17,7,10,1,17.0
ECU-009894,2122,236,120,116,14,16.857142857142858
ECU-009895,2122,13,8,5,1,13.0
ECU-009896,2122,9,4,5,1,9.0
ECU-009897,2122,6,1,5,1,6.0
ECU-009898,2122,16,8,8,2,8.0
ECU-009899,2122,9,7,2,1,9.0
ECU-009900,2122,24,15,9,2,12.0
ECU-009901,2122,9,4,5,1,9.0
ECU-009902,2122,11,5,6,1,11.0
ECU-009903,2122,12,8,4,1,12.0
ECU-009904,2122,89,48,41,5,17.8
ECU-009905,2122,20,10,10,2,10.0
ECU-009906,2122,27,16,11,1,27.0
ECU-009907,2122,24,15,9,1,24.0
ECU-009908,2122,4,0,4,1,4.0
ECU-009909,2122,217,114,103,19,11.421052631578947
ECU-009910,2122,29,16,13,2,14.5
ECU-009911,2122,71,33,38,5,14.2
ECU-009912,2122,8,3,5,1,8.0
ECU-009913,2122,29,16,13,2,14.5
ECU-009914,2122,35,18,17,3,11.666666666666666
ECU-009915,2122,17,8,9,1,17.0
ECU-009916,2122,4,2,2,1,4.0
ECU-009917,2122,56,28,28,3,18.666666666666668
ECU-009918,2122,34,15,19,3,11.333333333333334
ECU-009919,2122,4,2,2,1,4.0
ECU-009920,2122,3,1,2,1,3.0
ECU-009921,2122,7,5,2,1,7.0
ECU-009922,2122,5,4,1,1,5.0
ECU-009923,2122,2,0,2,1,2.0
ECU-009924,2122,7,3,4,1,7.0
ECU-009925,2122,193,117,76,16,12.0625
ECU-009926,2122,37,14,23,3,12.333333333333334
ECU-009927,2122,856,419,437,40,21.4
ECU-009928,2122,234,129,105,12,19.5
ECU-009929,2122,277,142,135,13,21.307692307692307
ECU-009930,2122,11,7,4,1,11.0
ECU-009931,2122,1850,969,881,86,21.511627906976745
ECU-009932,2122,680,355,325,31,21.93548387096774
ECU-009933,2122,13,9,4,1,13.0
ECU-009934,2122,14,6,8,1,14.0
ECU-009935,2122,9,4,5,1,9.0
ECU-009936,2122,374,196,178,19,19.68421052631579
ECU-009937,2122,60,26,34,11,5.454545454545454
ECU-009938,2122,193,83,110,14,13.785714285714286
ECU-009939,2122,21,10,11,1,21.0
ECU-009940,2122,120,60,60,7,17.142857142857142
ECU-009941,2122,6,3,3,1,6.0
ECU-009942,2122,23,13,10,1,23.0
ECU-009943,2122,245,110,135,18,13.61111111111111
ECU-009944,2122,642,277,365,52,12.346153846153847
ECU-009945,2122,5,3,2,1,5.0
ECU-009946,2122,15,5,10,1,15.0
ECU-009947,2122,338,160,178,20,16.9
ECU-009948,2122,9,7,2,1,9.0
ECU-009949,2122,10,5,5,1,10.0
ECU-009950,2122,151,78,73,14,10.785714285714286
ECU-009951,2122,16,6,10,1,16.0
ECU-009952,2122,10,5,5,1,10.0
ECU-009953,2122,261,140,121,20,13.05
ECU-009954,2122,27,12,15,2,13.5
ECU-009955,2122,119,60,59,9,13.222222222222221
ECU-009956,2122,208,100,108,12,17.333333333333332
ECU-009957,2122,12,5,7,2,6.0
ECU-009958,2122,25,15,10,2,12.5
ECU-009959,2122,4,2,2,1,4.0
ECU-009960,2122,12,5,7,1,12.0
ECU-009961,2122,14,10,4,1,14.0
ECU-009962,2122,123,62,61,8,15.375
ECU-009963,2122,10,7,3,1,10.0
ECU-009964,2122,8,6,2,1,8.0
ECU-009965,2122,18,10,8,1,18.0
ECU-009966,2122,35,15,20,2,17.5
ECU-009967,2122,9,6,3,1,9.0
ECU-009968,2122,21,9,12,1,21.0
ECU-009969,2122,3,1,2,1,3.0
ECU-009970,2122,18,6,12,2,9.0
ECU-009971,2122,25,11,14,2,12.5
ECU-009972,2122,7,3,4,1,7.0
ECU-009973,2122,9,3,6,1,9.0
ECU-009974,2122,402,207,195,20,20.1
ECU-009975,2122,293,133,160,20,14.65
ECU-009976,2122,53,32,21,2,26.5
ECU-009977,2122,2,0,2,1,2.0
ECU-009978,2122,117,62,55,11,10.636363636363637
ECU-009979,2122,20,9,11,2,10.0
ECU-009980,2122,10,2,8,1,10.0
ECU-009981,2122,46,25,21,1,46.0
ECU-009982,2122,4,3,1,1,4.0
ECU-009983,2122,4,2,2,1,4.0
ECU-009984,2122,16,11,5,1,16.0
ECU-009985,2122,23,18,5,1,23.0
ECU-009986,2122,29,14,15,2,14.5
ECU-009987,2122,135,62,73,12,11.25
ECU-009988,2122,15,6,9,1,15.0
ECU-009989,2122,45,27,18,2,22.5
ECU-009990,2122,7,5,2,1,7.0
ECU-009991,2122,6,1,5,1,6.0
ECU-009992,2122,4,3,1,1,4.0
ECU-009993,2122,141,70,71,12,11.75
ECU-009994,2122,253,139,114,12,21.083333333333332
ECU-009995,2122,8,2,6,1,8.0
ECU-009996,2122,20,9,11,1,20.0
ECU-009997,2122,6,3,3,1,6.0
ECU-009998,2122,8,4,4,1,8.0
ECU-009999,2122,110,54,56,4,27.5
ECU-010000,2122,12,5,7,1,12.0
ECU-010001,2122,9,5,4,1,9.0
ECU-010002,2122,9,2,7,1,9.0
ECU-010003,2122,9,4,5,1,9.0
ECU-010004,2122,43,22,21,2,21.5
ECU-010005,2122,17,8,9,1,17.0
ECU-010006,2122,287,150,137,18,15.944444444444445
ECU-010007,2122,407,204,203,15,27.133333333333333
ECU-010008,2122,91,39,52,5,18.2
ECU-010009,2122,12,7,5,1,12.0
ECU-010010,2122,343,170,173,15,22.866666666666667
ECU-010011,2122,353,196,157,16,22.0625
ECU-010012,2122,33,13,20,2,16.5
ECU-010013,2122,298,149,149,10,29.8
ECU-010014,2122,185,84,101,10,18.5
ECU-010015,2122,663,302,361,25,26.52
ECU-010016,2122,45,21,24,2,22.5
ECU-010017,2122,45,21,24,2,22.5
ECU-010018,2122,12,6,6,1,12.0
ECU-010019,2122,10,5,5,1,10.0
ECU-010020,2122,9,6,3,1,9.0
ECU-010021,2122,19,11,8,1,19.0
ECU-010022,2122,19,8,11,1,19.0
ECU-010023,2122,26,11,15,2,13.0
ECU-010024,2122,1093,540,553,58,18.844827586206897
ECU-010025,2122,44,15,29,6,7.333333333333333
ECU-010026,2122,121,67,54,9,13.444444444444445
ECU-010027,2122,12,4,8,1,12.0
ECU-010028,2122,8,5,3,1,8.0
ECU-010029,2122,15,8,7,1,15.0
ECU-010030,2122,987,490,497,40,24.675
ECU-010031,2122,29,12,17,2,14.5
ECU-010032,2122,19,13,6,1,19.0
ECU-010033,2122,12,7,5,1,12.0
ECU-010034,2122,28,10,18,1,28.0
ECU-010035,2122,2,1,1,1,2.0
ECU-010036,2122,6,4,2,1,6.0
ECU-010037,2122,24,10,14,3,8.0
ECU-010038,2122,5,4,1,1,5.0
ECU-010039,2122,10,5,5,1,10.0
ECU-010040,2122,172,88,84,13,13.23076923076923
ECU-010041,2122,16,6,10,1,16.0
ECU-010042,2122,79,39,40,3,26.333333333333332
ECU-010043,2122,16,5,11,1,16.0
ECU-010044,2122,19,9,10,1,19.0
ECU-010045,2122,11,6,5,1,11.0
ECU-010046,2122,4,2,2,1,4.0
ECU-010047,2122,9,3,6,1,9.0
ECU-010048,2122,32,15,17,2,16.0
ECU-010049,2122,15,6,9,1,15.0
ECU-010050,2122,8,5,3,1,8.0
ECU-010051,2122,12,6,6,1,12.0
ECU-010052,2122,11,3,8,1,11.0
ECU-010053,2122,320,179,141,15,21.333333333333332
ECU-010054,2122,33,17,16,2,16.5
ECU-010055,2122,440,223,217,30,14.666666666666666
ECU-010056,2122,565,284,281,30,18.833333333333332
ECU-010057,2122,218,100,118,17,12.823529411764707
ECU-010058,2122,8,3,5,1,8.0
ECU-010059,2122,1084,567,517,52,20.846153846153847
ECU-010060,2122,106,44,62,8,13.25
ECU-010061,2122,8,4,4,1,8.0
ECU-010062,2122,155,67,88,10,15.5
ECU-010063,2122,7,2,5,1,7.0
ECU-010064,2122,16,7,9,1,16.0
ECU-010065,2122,120,61,59,7,17.142857142857142
ECU-010066,2122,22,10,12,1,22.0
ECU-010067,2122,255,125,130,20,12.75
ECU-010068,2122,24,9,15,1,24.0
ECU-010069,2122,475,245,230,26,18.26923076923077
ECU-010070,2122,27,10,17,1,27.0
ECU-010071,2122,9,6,3,1,9.0
ECU-010072,2122,32,12,20,2,16.0
ECU-010073,2122,8,5,3,1,8.0
ECU-010074,2122,19,9,10,1,19.0
ECU-010075,2122,238,122,116,19,12.526315789473685
ECU-010076,2122,40,18,22,2,20.0
ECU-010077,2122,18,8,10,1,18.0
ECU-010078,2122,24,14,10,1,24.0
ECU-010079,2122,25,18,7,1,25.0
ECU-010080,2122,193,90,103,11,17.545454545454547
ECU-010081,2122,32,18,14,2,16.0
ECU-010082,2122,205,101,104,13,15.76923076923077
ECU-010083,2122,21,7,14,1,21.0
ECU-010084,2122,29,17,12,2,14.5
ECU-010085,2122,136,67,69,8,17.0
ECU-010086,2122,6,3,3,1,6.0
ECU-010087,2122,496,256,240,29,17.103448275862068
ECU-010088,2122,7,3,4,1,7.0
ECU-010089,2122,183,92,91,12,15.25
ECU-010090,2122,54,26,28,3,18.0
ECU-010091,2122,57,23,34,4,14.25
ECU-010092,2122,19,7,12,1,19.0
ECU-010093,2122,93,49,44,4,23.25
ECU-010094,2122,56,26,30,2,28.0
ECU-010095,2122,15,6,9,1,15.0
ECU-010096,2122,20,10,10,1,20.0
ECU-010097,2122,9,1,8,1,9.0
ECU-010098,2122,78,34,44,5,15.6
ECU-010099,2122,8,3,5,1,8.0
ECU-010100,2122,358,166,192,22,16.272727272727273
ECU-010101,2122,167,95,72,10,16.7
ECU-010102,2122,106,66,40,11,9.636363636363637
ECU-010103,2122,16,5,11,1,16.0
ECU-010104,2122,96,49,47,3,32.0
ECU-010105,2122,281,137,144,19,14.789473684210526
ECU-010106,2122,468,245,223,16,29.25
ECU-010107,2122,92,46,46,3,30.666666666666668
ECU-010108,2122,627,290,337,28,22.392857142857142
ECU-010109,2122,963,495,468,45,21.4
ECU-010110,2122,61,31,30,2,30.5
ECU-010111,2122,213,109,104,13,16.384615384615383
ECU-010112,2122,14,9,5,1,14.0
ECU-010113,2122,212,106,106,13,16.307692307692307
ECU-010114,2122,165,75,90,10,16.5
ECU-010115,2122,10,7,3,1,10.0
ECU-010116,2122,212,114,98,12,17.666666666666668
ECU-010117,2122,323,156,167,26,12.423076923076923
ECU-010118,2122,31,15,16,2,15.5
ECU-010119,2122,64,40,24,3,21.333333333333332
ECU-010120,2122,63,35,28,3,21.0
ECU-010121,2122,68,39,29,4,17.0
ECU-010122,2122,22,14,8,1,22.0
ECU-010123,2122,33,13,20,2,16.5
ECU-010124,2122,328,157,171,20,16.4
ECU-010125,2122,258,128,130,16,16.125
ECU-010126,2122,12,4,8,1,12.0
ECU-010127,2122,429,212,217,27,15.88888888888889
ECU-010128,2122,20,7,13,1,20.0
ECU-010129,2122,4,3,1,1,4.0
ECU-010130,2122,16,8,8,1,16.0
ECU-010131,2122,34,19,15,2,17.0
ECU-010132,2122,219,101,118,18,12.166666666666666
ECU-010133,2122,245,109,136,14,17.5
ECU-010134,2122,37,23,14,2,18.5
ECU-010135,2122,427,215,212,18,23.72222222222222
ECU-010136,2122,11,6,5,1,11.0
ECU-010137,2122,6,1,5,1,6.0
ECU-010138,2122,239,134,105,11,21.727272727272727
ECU-010139,2122,504,240,264,10,50.4
ECU-010140,2122,406,220,186,14,29.0
ECU-010141,2122,47,24,23,2,23.5
ECU-010142,2122,22,15,7,1,22.0
ECU-010143,2122,11,2,9,1,11.0
ECU-010144,2122,28,15,13,1,28.0
ECU-010145,2122,1580,763,817,52,30.384615384615383
ECU-010146,2122,18,8,10,1,18.0
ECU-010147,2122,11,7,4,1,11.0
ECU-010148,2122,110,51,59,6,18.333333333333332
ECU-010149,2122,617,303,314,29,21.275862068965516
ECU-010150,2122,63,32,31,3,21.0
ECU-010151,2122,271,130,141,12,22.583333333333332
ECU-010152,2122,377,201,176,18,20.944444444444443
ECU-010153,2122,20,5,15,1,20.0
ECU-010154,2122,1453,831,622,53,27.41509433962264
ECU-010155,2122,100,49,51,5,20.0
ECU-010156,2122,441,228,213,15,29.4
ECU-010157,2122,18,10,8,1,18.0
ECU-010158,2122,23,8,15,2,11.5
ECU-010159,2122,29,18,11,1,29.0
ECU-010160,2122,15,9,6,1,15.0
ECU-010161,2122,19,11,8,1,19.0
ECU-010162,2122,7,2,5,1,7.0
ECU-010163,2122,5,3,2,1,5.0
ECU-010164,2122,161,71,90,10,16.1
ECU-010165,2122,8,5,3,1,8.0
ECU-010166,2122,6,1,5,1,6.0
ECU-010167,2122,192,89,103,9,21.333333333333332
ECU-010168,2122,11,4,7,1,11.0
ECU-010169,2122,8,3,5,1,8.0
ECU-010170,2122,19,6,13,1,19.0
ECU-010171,2122,23,9,14,1,23.0
ECU-010172,2122,3,2,1,1,3.0
ECU-010173,2122,32,16,16,2,16.0
ECU-010174,2122,1,1,0,1,1.0
ECU-010175,2122,9,4,5,1,9.0
ECU-010176,2122,7,6,1,1,7.0
ECU-010177,2122,3,0,3,1,3.0
ECU-010178,2122,6,4,2,1,6.0
ECU-010179,2122,144,62,82,7,20.571428571428573
ECU-010180,2122,80,51,29,6,13.333333333333334
ECU-010181,2122,359,183,176,32,11.21875
ECU-010182,2122,46,21,25,5,9.2
ECU-010183,2122,25,9,16,1,25.0
ECU-010184,2122,13,9,4,1,13.0
ECU-010185,2122,13,6,7,1,13.0
ECU-010186,2122,6,3,3,1,6.0
ECU-010187,2122,4,4,0,1,4.0
ECU-010188,2122,135,69,66,7,19.285714285714285
ECU-010189,2122,11,5,6,1,11.0
ECU-010190,2122,12,5,7,1,12.0
ECU-010191,2122,3,1,2,1,3.0
ECU-010192,2122,13,8,5,1,13.0
ECU-010193,2122,1602,1602,0,99,16.181818181818183
ECU-010194,2122,270,124,146,15,18.0
ECU-010195,2122,85,34,51,8,10.625
ECU-010196,2122,158,31,127,17,9.294117647058824
ECU-010197,2122,147,66,81,10,14.7
ECU-010198,2122,332,138,194,19,17.473684210526315
ECU-010199,2122,398,250,148,19,20.94736842105263
ECU-010200,2122,59,28,31,9,6.555555555555555
ECU-010201,2122,34,18,16,5,6.8
ECU-010202,2122,993,468,525,15,66.2
ECU-010203,2122,29,12,17,4,7.25
ECU-010204,2122,10,6,4,2,5.0
ECU-010205,2122,19,8,11,4,4.75
ECU-010206,2122,46,27,19,7,6.571428571428571
ECU-010207,2122,22,12,10,7,3.142857142857143
ECU-010208,2122,34,17,17,5,6.8
ECU-010209,2122,37,21,16,4,9.25
ECU-010210,2122,30,17,13,6,5.0
ECU-010211,2122,47,27,20,3,15.666666666666666
ECU-010212,2122,27,14,13,2,13.5
ECU-010213,2122,27,19,8,6,4.5
ECU-010214,2122,20,12,8,4,5.0
ECU-010215,2122,42,19,23,10,4.2
ECU-010216,2122,76,32,44,4,19.0
ECU-010217,2122,25,12,13,6,4.166666666666667
ECU-010218,2122,233,103,130,19,12.263157894736842
ECU-010219,2122,7,3,4,1,7.0
ECU-010220,2122,28,15,13,7,4.0
ECU-010221,2122,151,60,91,22,6.863636363636363
ECU-010222,2122,8,7,1,1,8.0
ECU-010223,2122,6,2,4,1,6.0
ECU-010224,2122,9,4,5,1,9.0
ECU-010225,2122,39,18,21,12,3.25
ECU-010226,2122,25,14,11,3,8.333333333333334
ECU-010227,2122,840,420,420,57,14.736842105263158
ECU-010228,2122,126,38,88,11,11.454545454545455
ECU-010229,2122,230,119,111,16,14.375
ECU-010230,2122,30,15,15,4,7.5
ECU-010231,2122,189,86,103,10,18.9
ECU-010232,2122,962,505,457,43,22.372093023255815
ECU-010233,2122,8,2,6,3,2.6666666666666665
ECU-010234,2122,8,3,5,2,4.0
ECU-010235,2122,31,15,16,3,10.333333333333334
ECU-010236,2122,42,23,19,2,21.0
ECU-010237,2122,64,34,30,6,10.666666666666666
ECU-010238,2122,39,14,25,6,6.5
ECU-010239,2122,43,18,25,2,21.5
ECU-010240,2122,7,1,6,1,7.0
ECU-010241,2122,31,22,9,4,7.75
ECU-010242,2122,779,413,366,37,21.054054054054053
ECU-010243,2122,57,27,30,8,7.125
ECU-010244,2122,3,1,2,1,3.0
ECU-010245,2122,53,27,26,3,17.666666666666668
ECU-010246,2122,64,30,34,4,16.0
ECU-010247,2122,42,22,20,2,21.0
ECU-010248,2122,5,2,3,4,1.25
ECU-010249,2122,17,11,6,2,8.5
ECU-010250,2122,10,4,6,2,5.0
ECU-010251,2122,22,10,12,2,11.0
ECU-010252,2122,7,3,4,1,7.0
ECU-010253,2122,48,18,30,9,5.333333333333333
ECU-010254,2122,47,20,27,5,9.4
ECU-010255,2122,39,15,24,5,7.8
ECU-010256,2122,39,19,20,5,7.8
ECU-010257,2122,69,36,33,13,5.3076923076923075
ECU-010258,2122,7,3,4,6,1.1666666666666667
ECU-010259,2122,7,3,4,2,3.5
ECU-010260,2122,1,0,1,3,0.3333333333333333
ECU-010261,2122,18,14,4,2,9.0
ECU-010262,2122,19,8,11,1,19.0
ECU-010263,2122,81,38,43,12,6.75
ECU-010264,2122,35,17,18,3,11.666666666666666
ECU-010265,2122,13,2,11,4,3.25
ECU-010266,2122,13,2,11,1,13.0
ECU-010267,2122,7,4,3,1,7.0
ECU-010268,2122,2172,983,1189,81,26.814814814814813
ECU-010269,2122,1905,861,1044,74,25.743243243243242
ECU-010270,2122,2900,1755,1145,84,34.523809523809526
ECU-010271,2122,5,3,2,3,1.6666666666666667
ECU-010272,2122,1,0,1,1,1.0
ECU-010273,2122,2061,1053,1008,87,23.689655172413794
ECU-010274,2122,47,17,30,1,47.0
ECU-010275,2122,929,477,452,37,25.10810810810811
ECU-010276,2122,53,27,26,4,13.25
ECU-010277,2122,10,8,2,2,5.0
ECU-010278,2122,26,13,13,3,8.666666666666666
ECU-010279,2122,26,16,10,2,13.0
ECU-010280,2122,14,8,6,1,14.0
ECU-010281,2122,20,5,15,1,20.0
ECU-010282,2122,49,29,20,6,8.166666666666666
ECU-010283,2122,17,7,10,1,17.0
ECU-010284,2122,370,203,167,10,37.0
ECU-010285,2122,180,79,101,11,16.363636363636363
ECU-010286,2122,25,11,14,4,6.25
ECU-010287,2122,20,13,7,4,5.0
ECU-010288,2122,8,4,4,2,4.0
ECU-010289,2122,40,14,26,2,20.0
ECU-010290,2122,85,45,40,7,12.142857142857142
ECU-010291,2122,114,48,66,20,5.7
ECU-010292,2122,17,7,10,6,2.8333333333333335
ECU-010293,2122,90,41,49,15,6.0
ECU-010294,2122,4,2,2,1,4.0
ECU-010295,2122,18,9,9,1,18.0
ECU-010296,2122,5,2,3,1,5.0
ECU-010297,2122,7,4,3,1,7.0
ECU-010298,2122,4,4,0,1,4.0
ECU-010299,2122,49,20,29,5,9.8
ECU-010300,2122,12,6,6,1,12.0
ECU-010301,2122,5,3,2,1,5.0
ECU-010302,2122,10,3,7,2,5.0
ECU-010303,2122,7,3,4,1,7.0
ECU-010304,2122,10,6,4,1,10.0
ECU-010305,2122,6,2,4,1,6.0
ECU-010306,2122,14,4,10,1,14.0
ECU-010307,2122,5,1,4,1,5.0
ECU-010308,2122,7,3,4,1,7.0
ECU-010309,2122,35,16,19,2,17.5
ECU-010310,2122,93,40,53,5,18.6
ECU-010311,2122,14,7,7,1,14.0
ECU-010312,2122,10,4,6,1,10.0
ECU-010313,2122,38,19,19,2,19.0
ECU-010314,2122,5,3,2,1,5.0
ECU-010315,2122,25,14,11,2,12.5
ECU-010316,2122,10,2,8,1,10.0
ECU-010317,2122,70,39,31,3,23.333333333333332
ECU-010318,2122,10,5,5,1,10.0
ECU-010319,2122,29,14,15,2,14.5
ECU-010320,2122,6,5,1,1,6.0
ECU-010321,2122,47,22,25,3,15.666666666666666
ECU-010322,2122,179,96,83,10,17.9
ECU-010323,2122,18,8,10,1,18.0
ECU-010324,2122,12,4,8,1,12.0
ECU-010325,2122,61,27,34,3,20.333333333333332
ECU-010326,2122,20,9,11,1,20.0
ECU-010327,2122,164,93,71,16,10.25
ECU-010328,2122,74,33,41,9,8.222222222222221
ECU-010329,2122,11,8,3,1,11.0
ECU-010330,2122,24,7,17,2,12.0
ECU-010331,2122,34,22,12,2,17.0
ECU-010332,2122,29,16,13,2,14.5
ECU-010333,2122,290,143,147,20,14.5
ECU-010334,2122,7,3,4,1,7.0
ECU-010335,2122,8,4,4,1,8.0
ECU-010336,2122,352,192,160,25,14.08
ECU-010337,2122,14,8,6,1,14.0
ECU-010338,2122,9,3,6,1,9.0
ECU-010339,2122,83,41,42,6,13.833333333333334
ECU-010340,2122,52,22,30,3,17.333333333333332
ECU-010341,2122,9,6,3,1,9.0
ECU-010342,2122,27,13,14,2,13.5
ECU-010343,2122,3,0,3,1,3.0
ECU-010344,2122,404,200,204,29,13.931034482758621
ECU-010345,2122,13,8,5,2,6.5
ECU-010346,2122,42,17,25,3,14.0
ECU-010347,2122,27,12,15,2,13.5
ECU-010348,2122,5,2,3,1,5.0
ECU-010349,2122,24,10,14,2,12.0
ECU-010350,2122,10,6,4,1,10.0
ECU-010351,2122,28,15,13,1,28.0
ECU-010352,2122,140,70,70,10,14.0
ECU-010353,2122,164,81,83,8,20.5
ECU-010354,2122,1657,844,813,75,22.093333333333334
ECU-010355,2122,340,166,174,23,14.782608695652174
ECU-010356,2122,418,205,213,20,20.9
ECU-010357,2122,434,191,243,22,19.727272727272727
ECU-010358,2122,201,115,86,16,12.5625
ECU-010359,2122,1108,570,538,47,23.574468085106382
ECU-010360,2122,1098,583,515,45,24.4
ECU-010361,2122,358,175,183,26,13.76923076923077
ECU-010362,2122,227,116,111,15,15.133333333333333
ECU-010363,2122,610,340,270,30,20.333333333333332
ECU-010364,2122,79,31,48,17,4.647058823529412
ECU-010365,2122,148,52,96,17,8.705882352941176
ECU-010366,2122,197,102,95,9,21.88888888888889
ECU-010367,2122,360,187,173,15,24.0
ECU-010368,2122,3095,1711,1384,88,35.17045454545455
ECU-010369,2122,1346,576,770,45,29.91111111111111
ECU-010370,2122,504,277,227,25,20.16
ECU-010371,2122,590,262,328,31,19.032258064516128
ECU-010372,2122,1698,889,809,63,26.952380952380953
ECU-010373,2122,1213,446,767,72,16.84722222222222
ECU-010374,2122,15,7,8,1,15.0
ECU-010375,2122,28,16,12,2,14.0
ECU-010376,2122,61,23,38,3,20.333333333333332
ECU-010377,2122,187,85,102,11,17.0
ECU-010378,2122,169,74,95,10,16.9
ECU-010379,2122,202,106,96,9,22.444444444444443
ECU-010380,2122,11,5,6,1,11.0
ECU-010381,2122,9,3,6,1,9.0
ECU-010382,2122,20,10,10,1,20.0
ECU-010383,2122,8,4,4,1,8.0
ECU-010384,2122,482,241,241,24,20.083333333333332
ECU-010385,2122,63,32,31,3,21.0
ECU-010386,2122,9,4,5,1,9.0
ECU-010387,2122,203,107,96,14,14.5
ECU-010388,2122,40,14,26,3,13.333333333333334
ECU-010389,2122,35,15,20,2,17.5
ECU-010390,2122,44,22,22,2,22.0
ECU-010391,2122,95,55,40,9,10.555555555555555
ECU-010392,2122,8,6,2,1,8.0
ECU-010393,2122,37,22,15,2,18.5
ECU-010394,2122,40,18,22,1,40.0
ECU-010395,2122,8,3,5,1,8.0
ECU-010396,2122,132,67,65,5,26.4
ECU-010397,2122,201,87,114,13,15.461538461538462
ECU-010398,2122,165,85,80,8,20.625
ECU-010399,2122,512,243,269,26,19.692307692307693
ECU-010400,2122,8,4,4,1,8.0
ECU-010401,2122,5,0,5,1,5.0
ECU-010402,2122,30,16,14,2,15.0
ECU-010403,2122,499,234,265,28,17.821428571428573
ECU-010404,2122,15,9,6,1,15.0
ECU-010405,2122,29,15,14,2,14.5
ECU-010406,2122,3,2,1,1,3.0
ECU-010407,2122,27,14,13,2,13.5
ECU-010408,2122,23,10,13,2,11.5
ECU-010409,2122,104,52,52,6,17.333333333333332
ECU-010410,2122,96,54,42,4,24.0
ECU-010411,2122,15,9,6,1,15.0
ECU-010412,2122,62,27,35,6,10.333333333333334
ECU-010413,2122,38,17,21,2,19.0
ECU-010414,2122,11,6,5,1,11.0
ECU-010415,2122,17,6,11,1,17.0
ECU-010416,2122,13,8,5,1,13.0
ECU-010417,2122,17,9,8,1,17.0
ECU-010418,2122,24,14,10,2,12.0
ECU-010419,2122,84,43,41,4,21.0
ECU-010420,2122,48,23,25,2,24.0
ECU-010421,2122,131,71,60,6,21.833333333333332
ECU-010422,2122,60,29,31,2,30.0
ECU-010423,2122,115,59,56,7,16.428571428571427
ECU-010424,2122,9,5,4,1,9.0
ECU-010425,2122,3,2,1,1,3.0
ECU-010426,2122,71,40,31,8,8.875
ECU-010427,2122,152,70,82,7,21.714285714285715
ECU-010428,2122,21,9,12,1,21.0
ECU-010429,2122,3,3,0,1,3.0
ECU-010430,2122,166,91,75,10,16.6
ECU-010431,2122,603,303,300,29,20.79310344827586
ECU-010432,2122,188,84,104,10,18.8
ECU-010433,2122,23,11,12,1,23.0
ECU-010434,2122,487,247,240,23,21.17391304347826
ECU-010435,2122,33,17,16,2,16.5
ECU-010436,2122,18,10,8,1,18.0
ECU-010437,2122,99,46,53,8,12.375
ECU-010438,2122,26,12,14,1,26.0
ECU-010439,2122,879,421,458,36,24.416666666666668
ECU-010440,2122,31,17,14,2,15.5
ECU-010441,2122,391,230,161,18,21.72222222222222
ECU-010442,2122,220,105,115,17,12.941176470588236
ECU-010443,2122,234,113,121,12,19.5
ECU-010444,2122,32,16,16,2,16.0
ECU-010445,2122,8,2,6,1,8.0
ECU-010446,2122,5,2,3,1,5.0
ECU-010447,2122,209,102,107,14,14.928571428571429
ECU-010448,2122,49,23,26,2,24.5
ECU-010449,2122,133,67,66,9,14.777777777777779
ECU-010450,2122,29,14,15,2,14.5
ECU-010451,2122,8,4,4,1,8.0
ECU-010452,2122,57,28,29,3,19.0
ECU-010453,2122,13,7,6,1,13.0
ECU-010454,2122,17,12,5,1,17.0
ECU-010455,2122,42,24,18,3,14.0
ECU-010456,2122,4,1,3,1,4.0
ECU-010457,2122,9,5,4,1,9.0
ECU-010458,2122,841,394,447,54,15.574074074074074
ECU-010459,2122,1127,580,547,55,20.490909090909092
ECU-010460,2122,297,143,154,18,16.5
ECU-010461,2122,29,10,19,2,14.5
ECU-010462,2122,1154,556,598,46,25.08695652173913
ECU-010463,2122,34,17,17,9,3.7777777777777777
ECU-010464,2122,133,70,63,7,19.0
ECU-010465,2122,12,4,8,1,12.0
ECU-010466,2122,423,206,217,20,21.15
ECU-010467,2122,14,6,8,1,14.0
ECU-010468,2122,520,285,235,20,26.0
ECU-010469,2122,15,10,5,1,15.0
ECU-010470,2122,399,169,230,20,19.95
ECU-010471,2122,168,84,84,14,12.0
ECU-010472,2122,789,436,353,35,22.542857142857144
ECU-010473,2122,10,6,4,1,10.0
ECU-010474,2122,45,22,23,2,22.5
ECU-010475,2122,5,2,3,1,5.0
ECU-010476,2122,44,23,21,2,22.0
ECU-010477,2122,4,1,3,1,4.0
ECU-010478,2122,29,17,12,1,29.0
ECU-010479,2122,29,13,16,2,14.5
ECU-010480,2122,42,23,19,2,21.0
ECU-010481,2122,3,2,1,1,3.0
ECU-010482,2122,252,128,124,21,12.0
ECU-010483,2122,29,11,18,2,14.5
ECU-010484,2122,11,5,6,1,11.0
ECU-010485,2122,17,7,10,1,17.0
ECU-010486,2122,2,0,2,1,2.0
ECU-010487,2122,10,8,2,1,10.0
ECU-010488,2122,34,21,13,2,17.0
ECU-010489,2122,18,10,8,1,18.0
ECU-010490,2122,32,19,13,3,10.666666666666666
ECU-010491,2122,7,4,3,1,7.0
ECU-010492,2122,211,103,108,14,15.071428571428571
ECU-010493,2122,14,7,7,1,14.0
ECU-010494,2122,347,195,152,19,18.263157894736842
ECU-010495,2122,119,65,54,6,19.833333333333332
ECU-010496,2122,1,1,0,1,1.0
ECU-010497,2122,20,10,10,2,10.0
ECU-010498,2122,28,13,15,2,14.0
ECU-010499,2122,365,171,194,20,18.25
ECU-010500,2122,13,5,8,1,13.0
ECU-010501,2122,46,23,23,2,23.0
ECU-010502,2122,24,9,15,1,24.0
ECU-010503,2122,13,7,6,1,13.0
ECU-010504,2122,8,4,4,1,8.0
ECU-010505,2122,16,10,6,1,16.0
ECU-010506,2122,3,2,1,1,3.0
ECU-010507,2122,134,68,66,10,13.4
ECU-010508,2122,4,2,2,1,4.0
ECU-010509,2122,343,169,174,25,13.72
ECU-010510,2122,129,66,63,7,18.428571428571427
ECU-010511,2122,4,1,3,1,4.0
ECU-010512,2122,50,18,32,3,16.666666666666668
ECU-010513,2122,27,14,13,2,13.5
ECU-010514,2122,6,4,2,1,6.0
ECU-010515,2122,296,134,162,14,21.142857142857142
ECU-010516,2122,70,29,41,4,17.5
ECU-010517,2122,200,103,97,10,20.0
ECU-010518,2122,193,94,99,12,16.083333333333332
ECU-010519,2122,49,26,23,3,16.333333333333332
ECU-010520,2122,20,7,13,2,10.0
ECU-010521,2122,5,1,4,1,5.0
ECU-010522,2122,241,111,130,16,15.0625
ECU-010523,2122,15,10,5,1,15.0
ECU-010524,2122,33,18,15,2,16.5
ECU-010525,2122,34,16,18,2,17.0
ECU-010526,2122,36,16,20,2,18.0
ECU-010527,2122,92,42,50,4,23.0
ECU-010528,2122,28,13,15,2,14.0
ECU-010529,2122,26,17,9,2,13.0
ECU-010530,2122,64,28,36,3,21.333333333333332
ECU-010531,2122,122,65,57,11,11.090909090909092
ECU-010532,2122,501,249,252,23,21.782608695652176
ECU-010533,2122,2,0,2,1,2.0
ECU-010534,2122,10,4,6,1,10.0
ECU-010535,2122,37,18,19,2,18.5
ECU-010536,2122,421,183,238,26,16.192307692307693
ECU-010537,2122,43,23,20,3,14.333333333333334
ECU-010538,2122,5,3,2,1,5.0
ECU-010539,2122,34,14,20,1,34.0
ECU-010540,2122,4,2,2,1,4.0
ECU-010541,2122,39,18,21,2,19.5
ECU-010542,2122,116,54,62,10,11.6
ECU-010543,2122,18,9,9,1,18.0
ECU-010544,2122,155,82,73,8,19.375
ECU-010545,2122,269,134,135,19,14.157894736842104
ECU-010546,2122,597,319,278,26,22.96153846153846
ECU-010547,2122,12,7,5,1,12.0
ECU-010548,2122,57,25,32,12,4.75
ECU-010549,2122,649,322,327,27,24.037037037037038
ECU-010550,2122,1348,656,692,48,28.083333333333332
ECU-010551,2122,92,47,45,6,15.333333333333334
ECU-010552,2122,927,466,461,44,21.068181818181817
ECU-010553,2122,408,207,201,22,18.545454545454547
ECU-010554,2122,628,302,326,28,22.428571428571427
ECU-010555,2122,1578,831,747,59,26.74576271186441
ECU-010556,2122,573,291,282,28,20.464285714285715
ECU-010557,2122,1548,798,750,65,23.815384615384616
ECU-010558,2122,901,490,411,56,16.089285714285715
ECU-010559,2122,756,401,355,29,26.06896551724138
ECU-010560,2122,434,214,220,17,25.529411764705884
ECU-010561,2122,1692,840,852,64,26.4375
ECU-010562,2122,121,57,64,9,13.444444444444445
ECU-010563,2122,668,213,455,36,18.555555555555557
ECU-010564,2122,995,578,417,32,31.09375
ECU-010565,2122,67,28,39,3,22.333333333333332
ECU-010566,2122,18,7,11,1,18.0
ECU-010567,2122,30,16,14,2,15.0
ECU-010568,2122,906,438,468,40,22.65
ECU-010569,2122,24,14,10,1,24.0
ECU-010570,2122,11,3,8,1,11.0
ECU-010571,2122,79,37,42,3,26.333333333333332
ECU-010572,2122,59,33,26,2,29.5
ECU-010573,2122,101,48,53,4,25.25
ECU-010574,2122,86,47,39,3,28.666666666666668
ECU-010575,2122,11,9,2,1,11.0
ECU-010576,2122,5,2,3,1,5.0
ECU-010577,2122,24,13,11,1,24.0
ECU-010578,2122,50,27,23,2,25.0
ECU-010579,2122,42,21,21,1,42.0
ECU-010580,2122,1093,551,542,46,23.76086956521739
ECU-010581,2122,233,125,108,10,23.3
ECU-010582,2122,662,335,327,27,24.51851851851852
ECU-010583,2122,607,329,278,25,24.28
ECU-010584,2122,679,303,376,42,16.166666666666668
ECU-010585,2122,232,108,124,9,25.77777777777778
ECU-010586,2122,23,15,8,2,11.5
ECU-010587,2122,55,31,24,4,13.75
ECU-010588,2122,123,55,68,9,13.666666666666666
ECU-010589,2122,23,13,10,2,11.5
ECU-010590,2122,39,19,20,2,19.5
ECU-010591,2122,34,14,20,2,17.0
ECU-010592,2122,229,116,113,10,22.9
ECU-010593,2122,44,21,23,3,14.666666666666666
ECU-010594,2122,680,363,317,27,25.185185185185187
ECU-010595,2122,37,15,22,2,18.5
ECU-010596,2122,224,110,114,14,16.0
ECU-010597,2122,202,97,105,13,15.538461538461538
ECU-010598,2122,5,1,4,1,5.0
ECU-010599,2122,5,2,3,1,5.0
ECU-010600,2122,239,113,126,17,14.058823529411764
ECU-010601,2122,438,214,224,21,20.857142857142858
ECU-010602,2122,34,18,16,2,17.0
ECU-010603,2122,28,11,17,2,14.0
ECU-010604,2122,10,6,4,1,10.0
ECU-010605,2122,6,3,3,1,6.0
ECU-010606,2122,2,1,1,1,2.0
ECU-010607,2122,10,4,6,1,10.0
ECU-010608,2122,39,19,20,5,7.8
ECU-010609,2122,216,93,123,16,13.5
ECU-010610,2122,5,4,1,1,5.0
ECU-010611,2122,81,45,36,5,16.2
ECU-010612,2122,6,3,3,1,6.0
ECU-010613,2122,25,13,12,2,12.5
ECU-010614,2122,323,192,131,16,20.1875
ECU-010615,2122,6,2,4,1,6.0
ECU-010616,2122,3,1,2,1,3.0
ECU-010617,2122,44,16,28,3,14.666666666666666
ECU-010618,2122,1092,528,564,45,24.266666666666666
ECU-010619,2122,40,16,24,5,8.0
ECU-010620,2122,45,22,23,6,7.5
ECU-010621,2122,51,19,32,4,12.75
ECU-010622,2122,1228,633,595,46,26.695652173913043
ECU-010623,2122,5,3,2,2,2.5
ECU-010624,2122,49,28,21,7,7.0
ECU-010625,2122,20,10,10,1,20.0
ECU-010626,2122,103,47,56,3,34.333333333333336
ECU-010627,2122,18,4,14,1,18.0
ECU-010628,2122,112,50,62,4,28.0
ECU-010629,2122,108,60,48,4,27.0
ECU-010630,2122,21,8,13,1,21.0
ECU-010631,2122,54,32,22,2,27.0
ECU-010632,2122,78,34,44,4,19.5
ECU-010633,2122,22,12,10,1,22.0
ECU-010634,2122,92,49,43,3,30.666666666666668
ECU-010635,2122,40,19,21,1,40.0
ECU-010636,2122,18,8,10,1,18.0
ECU-010637,2122,88,45,43,3,29.333333333333332
ECU-010638,2122,40,16,24,2,20.0
ECU-010639,2122,76,41,35,2,38.0
ECU-010640,2122,117,42,75,5,23.4
ECU-010641,2122,120,60,60,15,8.0
ECU-010642,2122,28,12,16,1,28.0
ECU-010643,2122,326,171,155,18,18.11111111111111
ECU-010644,2122,86,49,37,4,21.5
ECU-010645,2122,21,5,16,1,21.0
ECU-010646,2122,52,20,32,2,26.0
ECU-010647,2122,189,96,93,8,23.625
ECU-010648,2122,300,168,132,13,23.076923076923077
ECU-010649,2122,29,12,17,1,29.0
ECU-010650,2122,41,18,23,2,20.5
ECU-010651,2122,11,8,3,1,11.0
ECU-010652,2122,18,9,9,1,18.0
ECU-010653,2122,82,40,42,4,20.5
ECU-010654,2122,45,20,25,1,45.0
ECU-010655,2122,59,27,32,2,29.5
ECU-010656,2122,22,13,9,1,22.0
ECU-010657,2122,18,9,9,1,18.0
ECU-010658,2122,55,34,21,2,27.5
ECU-010659,2122,15,7,8,1,15.0
ECU-010660,2122,265,141,124,19,13.947368421052632
ECU-010661,2122,13,7,6,1,13.0
ECU-010662,2122,33,16,17,2,16.5
ECU-010663,2122,6,4,2,1,6.0
ECU-010664,2122,43,21,22,2,21.5
ECU-010665,2122,72,42,30,3,24.0
ECU-010666,2122,38,21,17,2,19.0
ECU-010667,2122,12,7,5,1,12.0
ECU-010668,2122,59,29,30,2,29.5
ECU-010669,2122,38,15,23,1,38.0
ECU-010670,2122,10,7,3,1,10.0
ECU-010671,2122,56,26,30,2,28.0
ECU-010672,2122,39,16,23,2,19.5
ECU-010673,2122,113,49,64,6,18.833333333333332
ECU-010674,2122,69,44,25,3,23.0
ECU-010675,2122,70,34,36,3,23.333333333333332
ECU-010676,2122,32,15,17,2,16.0
ECU-010677,2122,21,11,10,1,21.0
ECU-010678,2122,11,6,5,1,11.0
ECU-010679,2122,9,1,8,1,9.0
ECU-010680,2122,32,16,16,1,32.0
ECU-010681,2122,4,1,3,1,4.0
ECU-010682,2122,10,6,4,1,10.0
ECU-010683,2122,32,15,17,2,16.0
ECU-010684,2122,89,51,38,4,22.25
ECU-010685,2122,30,16,14,2,15.0
ECU-010686,2122,26,13,13,2,13.0
ECU-010687,2122,354,179,175,14,25.285714285714285
ECU-010688,2122,21,7,14,1,21.0
ECU-010689,2122,4,2,2,1,4.0
ECU-010690,2122,34,16,18,1,34.0
ECU-010691,2122,31,15,16,1,31.0
ECU-010692,2122,6,4,2,1,6.0
ECU-010693,2122,23,12,11,1,23.0
ECU-010694,2122,27,14,13,2,13.5
ECU-010695,2122,19,9,10,1,19.0
ECU-010696,2122,8,3,5,1,8.0
ECU-010697,2122,37,21,16,2,18.5
ECU-010698,2122,130,71,59,5,26.0
ECU-010699,2122,150,63,87,7,21.428571428571427
ECU-010700,2122,41,15,26,2,20.5
ECU-010701,2122,42,18,24,2,21.0
ECU-010702,2122,13,6,7,1,13.0
ECU-010703,2122,73,35,38,4,18.25
ECU-010704,2122,20,10,10,1,20.0
ECU-010705,2122,16,7,9,1,16.0
ECU-010706,2122,5,4,1,1,5.0
ECU-010707,2122,41,22,19,2,20.5
ECU-010708,2122,43,23,20,4,10.75
ECU-010709,2122,74,35,39,3,24.666666666666668
ECU-010710,2122,57,30,27,3,19.0
ECU-010711,2122,17,9,8,2,8.5
ECU-010712,2122,20,10,10,1,20.0
ECU-010713,2122,6,6,0,1,6.0
ECU-010714,2122,23,8,15,1,23.0
ECU-010715,2122,32,17,15,1,32.0
ECU-010716,2122,26,12,14,1,26.0
ECU-010717,2122,6,3,3,1,6.0
ECU-010718,2122,104,58,46,7,14.857142857142858
ECU-010719,2122,39,16,23,2,19.5
ECU-010720,2122,244,135,109,19,12.842105263157896
ECU-010721,2122,30,12,18,1,30.0
ECU-010722,2122,288,149,139,14,20.571428571428573
ECU-010723,2122,155,85,70,11,14.090909090909092
ECU-010724,2122,25,8,17,2,12.5
ECU-010725,2122,66,31,35,4,16.5
ECU-010726,2122,33,15,18,1,33.0
ECU-010727,2122,40,19,21,2,20.0
ECU-010728,2122,87,44,43,3,29.0
ECU-010729,2122,43,20,23,3,14.333333333333334
ECU-010730,2122,5,2,3,1,5.0
ECU-010731,2122,44,20,24,2,22.0
ECU-010732,2122,50,25,25,2,25.0
ECU-010733,2122,199,110,89,14,14.214285714285714
ECU-010734,2122,55,32,23,2,27.5
ECU-010735,2122,19,8,11,1,19.0
ECU-010736,2122,236,122,114,16,14.75
ECU-010737,2122,11,5,6,1,11.0
ECU-010738,2122,81,33,48,3,27.0
ECU-010739,2122,18,5,13,1,18.0
ECU-010740,2122,7,2,5,1,7.0
ECU-010741,2122,96,40,56,4,24.0
ECU-010742,2122,79,34,45,4,19.75
ECU-010743,2122,395,212,183,21,18.80952380952381
ECU-010744,2122,116,79,37,6,19.333333333333332
ECU-010745,2122,25,12,13,1,25.0
ECU-010746,2122,17,8,9,1,17.0
ECU-010747,2122,137,72,65,6,22.833333333333332
ECU-010748,2122,272,125,147,19,14.31578947368421
ECU-010749,2122,52,31,21,5,10.4
ECU-010750,2122,31,18,13,2,15.5
ECU-010751,2122,35,16,19,2,17.5
ECU-010752,2122,70,36,34,4,17.5
ECU-010753,2122,90,46,44,4,22.5
ECU-010754,2122,14,8,6,1,14.0
ECU-010755,2122,16,8,8,1,16.0
ECU-010756,2122,38,18,20,3,12.666666666666666
ECU-010757,2122,340,175,165,17,20.0
ECU-010758,2122,12,7,5,1,12.0
ECU-010759,2122,76,39,37,4,19.0
ECU-010760,2122,109,62,47,6,18.166666666666668
ECU-010761,2122,46,23,23,3,15.333333333333334
ECU-010762,2122,42,15,27,2,21.0
ECU-010763,2122,28,20,8,1,28.0
ECU-010764,2122,72,28,44,5,14.4
ECU-010765,2122,51,24,27,2,25.5
ECU-010766,2122,75,32,43,3,25.0
ECU-010767,2122,25,10,15,2,12.5
ECU-010768,2122,112,61,51,6,18.666666666666668
ECU-010769,2122,25,13,12,1,25.0
ECU-010770,2122,55,27,28,2,27.5
ECU-010771,2122,54,25,29,2,27.0
ECU-010772,2122,27,12,15,1,27.0
ECU-010773,2122,18,11,7,1,18.0
ECU-010774,2122,168,79,89,5,33.6
ECU-010775,2122,51,28,23,2,25.5
ECU-010776,2122,104,49,55,4,26.0
ECU-010777,2122,89,52,37,2,44.5
ECU-010778,2122,84,35,49,3,28.0
ECU-010779,2122,284,146,138,14,20.285714285714285
ECU-010780,2122,26,10,16,1,26.0
ECU-010781,2122,96,52,44,3,32.0
ECU-010782,2122,200,104,96,14,14.285714285714286
ECU-010783,2122,39,16,23,2,19.5
ECU-010784,2122,43,19,24,2,21.5
ECU-010785,2122,33,15,18,1,33.0
ECU-010786,2122,322,150,172,14,23.0
ECU-010787,2122,46,18,28,1,46.0
ECU-010788,2122,34,21,13,1,34.0
ECU-010789,2122,8,3,5,1,8.0
ECU-010790,2122,18,12,6,1,18.0
ECU-010791,2122,44,25,19,1,44.0
ECU-010792,2122,55,26,29,2,27.5
ECU-010793,2122,65,34,31,2,32.5
ECU-010794,2122,29,14,15,1,29.0
ECU-010795,2122,9,5,4,1,9.0
ECU-010796,2122,49,21,28,2,24.5
ECU-010797,2122,144,72,72,4,36.0
ECU-010798,2122,25,11,14,1,25.0
ECU-010799,2122,48,23,25,2,24.0
ECU-010800,2122,150,78,72,5,30.0
ECU-010801,2122,37,19,18,1,37.0
ECU-010802,2122,41,25,16,1,41.0
ECU-010803,2122,51,21,30,2,25.5
ECU-010804,2122,50,25,25,2,25.0
ECU-010805,2122,26,15,11,1,26.0
ECU-010806,2122,45,29,16,1,45.0
ECU-010807,2122,22,12,10,1,22.0
ECU-010808,2122,51,30,21,1,51.0
ECU-010809,2122,40,24,16,2,20.0
ECU-010810,2122,90,36,54,4,22.5
ECU-010811,2122,78,31,47,3,26.0
ECU-010812,2122,278,127,151,17,16.352941176470587
ECU-010813,2122,50,24,26,1,50.0
ECU-010814,2122,54,24,30,1,54.0
ECU-010815,2122,17,12,5,1,17.0
ECU-010816,2122,19,10,9,1,19.0
ECU-010817,2122,26,12,14,1,26.0
ECU-010818,2122,13,5,8,1,13.0
ECU-010819,2122,104,43,61,3,34.666666666666664
ECU-010820,2122,88,42,46,3,29.333333333333332
ECU-010821,2122,137,71,66,5,27.4
ECU-010822,2122,24,14,10,1,24.0
ECU-010823,2122,12,5,7,1,12.0
ECU-010824,2122,20,5,15,1,20.0
ECU-010825,2122,63,33,30,3,21.0
ECU-010826,2122,30,13,17,1,30.0
ECU-010827,2122,160,67,93,6,26.666666666666668
ECU-010828,2122,15,14,1,1,15.0
ECU-010829,2122,27,15,12,1,27.0
ECU-010830,2122,28,16,12,1,28.0
ECU-010831,2122,25,15,10,1,25.0
ECU-010832,2122,18,9,9,1,18.0
ECU-010833,2122,23,9,14,1,23.0
ECU-010834,2122,17,6,11,1,17.0
ECU-010835,2122,47,25,22,2,23.5
ECU-010836,2122,32,12,20,1,32.0
ECU-010837,2122,22,10,12,1,22.0
ECU-010838,2122,60,28,32,2,30.0
ECU-010839,2122,437,210,227,18,24.27777777777778
ECU-010840,2122,15,8,7,1,15.0
ECU-010841,2122,12,5,7,1,12.0
ECU-010842,2122,33,20,13,1,33.0
ECU-010843,2122,12,3,9,1,12.0
ECU-010844,2122,78,42,36,3,26.0
ECU-010845,2122,14,5,9,1,14.0
ECU-010846,2122,82,42,40,2,41.0
ECU-010847,2122,54,30,24,4,13.5
ECU-010848,2122,21,7,14,1,21.0
ECU-010849,2122,77,48,29,3,25.666666666666668
ECU-010850,2122,33,17,16,1,33.0
ECU-010851,2122,15,6,9,1,15.0
ECU-010852,2122,29,13,16,1,29.0
ECU-010853,2122,23,10,13,1,23.0
ECU-010854,2122,10,6,4,1,10.0
ECU-010855,2122,29,16,13,1,29.0
ECU-010856,2122,67,34,33,3,22.333333333333332
ECU-010857,2122,44,17,27,2,22.0
ECU-010858,2122,53,21,32,2,26.5
ECU-010859,2122,168,78,90,5,33.6
ECU-010860,2122,503,249,254,26,19.346153846153847
ECU-010861,2122,76,45,31,2,38.0
ECU-010862,2122,22,10,12,1,22.0
ECU-010863,2122,69,39,30,2,34.5
ECU-010864,2122,33,13,20,1,33.0
ECU-010865,2122,168,71,97,8,21.0
ECU-010866,2122,102,58,44,3,34.0
ECU-010867,2122,30,18,12,1,30.0
ECU-010868,2122,66,36,30,3,22.0
ECU-010869,2122,22,8,14,1,22.0
ECU-010870,2122,53,25,28,1,53.0
ECU-010871,2122,35,15,20,1,35.0
ECU-010872,2122,59,30,29,2,29.5
ECU-010873,2122,29,16,13,2,14.5
ECU-010874,2122,27,13,14,1,27.0
ECU-010875,2122,76,33,43,3,25.333333333333332
ECU-010876,2122,80,45,35,2,40.0
ECU-010877,2122,30,15,15,1,30.0
ECU-010878,2122,101,54,47,4,25.25
ECU-010879,2122,88,42,46,3,29.333333333333332
ECU-010880,2122,89,41,48,2,44.5
ECU-010881,2122,72,33,39,3,24.0
ECU-010882,2122,59,25,34,2,29.5
ECU-010883,2122,82,43,39,2,41.0
ECU-010884,2122,42,20,22,1,42.0
ECU-010885,2122,128,81,47,6,21.333333333333332
ECU-010886,2122,70,29,41,2,35.0
ECU-010887,2122,190,90,100,10,19.0
ECU-010888,2122,31,22,9,1,31.0
ECU-010889,2122,78,39,39,2,39.0
ECU-010890,2122,532,240,292,18,29.555555555555557
ECU-010891,2122,145,66,79,6,24.166666666666668
ECU-010892,2122,18,7,11,1,18.0
ECU-010893,2122,168,90,78,5,33.6
ECU-010894,2122,13,4,9,1,13.0
ECU-010895,2122,124,63,61,4,31.0
ECU-010896,2122,17,3,14,1,17.0
ECU-010897,2122,90,36,54,3,30.0
ECU-010898,2122,22,14,8,1,22.0
ECU-010899,2122,18,8,10,1,18.0
ECU-010900,2122,22,11,11,1,22.0
ECU-010901,2122,24,9,15,1,24.0
ECU-010902,2122,20,10,10,1,20.0
ECU-010903,2122,48,26,22,2,24.0
ECU-010904,2122,113,53,60,4,28.25
ECU-010905,2122,238,122,116,13,18.307692307692307
ECU-010906,2122,18,9,9,1,18.0
ECU-010907,2122,95,52,43,5,19.0
ECU-010908,2122,136,66,70,6,22.666666666666668
ECU-010909,2122,245,108,137,16,15.3125
ECU-010910,2122,20,5,15,1,20.0
ECU-010911,2122,32,15,17,2,16.0
ECU-010912,2122,27,13,14,1,27.0
ECU-010913,2122,13,4,9,1,13.0
ECU-010914,2122,14,8,6,1,14.0
ECU-010915,2122,114,55,59,6,19.0
ECU-010916,2122,395,196,199,21,18.80952380952381
ECU-010917,2122,19,9,10,1,19.0
ECU-010918,2122,114,57,57,4,28.5
ECU-010919,2122,20,11,9,1,20.0
ECU-010920,2122,120,65,55,6,20.0
ECU-010921,2122,15,6,9,1,15.0
ECU-010922,2122,24,6,18,1,24.0
ECU-010923,2122,131,70,61,4,32.75
ECU-010924,2122,19,11,8,1,19.0
ECU-010925,2122,12,4,8,1,12.0
ECU-010926,2122,35,12,23,2,17.5
ECU-010927,2122,31,18,13,2,15.5
ECU-010928,2122,11,7,4,1,11.0
ECU-010929,2122,23,9,14,1,23.0
ECU-010930,2122,76,39,37,3,25.333333333333332
ECU-010931,2122,54,17,37,2,27.0
ECU-010932,2122,39,22,17,2,19.5
ECU-010933,2122,28,13,15,1,28.0
ECU-010934,2122,34,14,20,1,34.0
ECU-010935,2122,75,33,42,3,25.0
ECU-010936,2122,62,33,29,2,31.0
ECU-010937,2122,78,41,37,4,19.5
ECU-010938,2122,23,11,12,1,23.0
ECU-010939,2122,93,45,48,4,23.25
ECU-010940,2122,51,32,19,2,25.5
ECU-010941,2122,20,13,7,1,20.0
ECU-010942,2122,10,3,7,1,10.0
ECU-010943,2122,33,13,20,1,33.0
ECU-010944,2122,28,13,15,2,14.0
ECU-010945,2122,28,20,8,1,28.0
ECU-010946,2122,111,50,61,4,27.75
ECU-010947,2122,41,24,17,1,41.0
ECU-010948,2122,86,38,48,3,28.666666666666668
ECU-010949,2122,95,46,49,3,31.666666666666668
ECU-010950,2122,65,29,36,2,32.5
ECU-010951,2122,20,11,9,1,20.0
ECU-010952,2122,8,3,5,1,8.0
ECU-010953,2122,17,5,12,1,17.0
ECU-010954,2122,12,3,9,1,12.0
ECU-010955,2122,27,8,19,1,27.0
ECU-010956,2122,189,71,118,12,15.75
ECU-010957,2122,30,12,18,1,30.0
ECU-010958,2122,21,10,11,1,21.0
ECU-010959,2122,67,24,43,2,33.5
ECU-010960,2122,22,13,9,1,22.0
ECU-010961,2122,40,19,21,1,40.0
ECU-010962,2122,141,67,74,5,28.2
ECU-010963,2122,72,42,30,3,24.0
ECU-010964,2122,5,0,5,1,5.0
ECU-010965,2122,64,19,45,4,16.0
ECU-010966,2122,27,15,12,1,27.0
ECU-010967,2122,72,34,38,3,24.0
ECU-010968,2122,28,15,13,1,28.0
ECU-010969,2122,35,19,16,2,17.5
ECU-010970,2122,21,14,7,1,21.0
ECU-010971,2122,278,119,159,15,18.533333333333335
ECU-010972,2122,16,7,9,1,16.0
ECU-010973,2122,84,41,43,4,21.0
ECU-010974,2122,11,6,5,1,11.0
ECU-010975,2122,143,74,69,7,20.428571428571427
ECU-010976,2122,28,18,10,2,14.0
ECU-010977,2122,7,3,4,1,7.0
ECU-010978,2122,23,10,13,1,23.0
ECU-010979,2122,20,10,10,1,20.0
ECU-010980,2122,18,8,10,1,18.0
ECU-010981,2122,44,26,18,2,22.0
ECU-010982,2122,15,6,9,1,15.0
ECU-010983,2122,14,5,9,1,14.0
ECU-010984,2122,11,8,3,1,11.0
ECU-010985,2122,35,17,18,2,17.5
ECU-010986,2122,16,7,9,1,16.0
ECU-010987,2122,7,5,2,1,7.0
ECU-010988,2122,28,16,12,1,28.0
ECU-010989,2122,47,23,24,2,23.5
ECU-010990,2122,5,0,5,1,5.0
ECU-010991,2122,8,4,4,1,8.0
ECU-010992,2122,35,21,14,1,35.0
ECU-010993,2122,871,441,430,32,27.21875
ECU-010994,2122,1085,613,472,43,25.232558139534884
ECU-010995,2122,1215,620,595,42,28.928571428571427
ECU-010996,2122,114,69,45,7,16.285714285714285
ECU-010997,2122,683,342,341,24,28.458333333333332
ECU-010998,2122,369,176,193,29,12.724137931034482
ECU-010999,2122,2560,1263,1297,103,24.854368932038835
ECU-011000,2122,183,87,96,10,18.3
ECU-011001,2122,380,193,187,17,22.352941176470587
ECU-011002,2122,50,22,28,12,4.166666666666667
ECU-011003,2122,904,441,463,57,15.859649122807017
ECU-011004,2122,249,140,109,20,12.45
ECU-011005,2122,283,134,149,15,18.866666666666667
ECU-011006,2122,259,111,148,18,14.38888888888889
ECU-011007,2122,80,33,47,5,16.0
ECU-011008,2122,358,177,181,16,22.375
ECU-011009,2122,15,7,8,1,15.0
ECU-011010,2122,141,64,77,5,28.2
ECU-011011,2122,23,12,11,1,23.0
ECU-011012,2122,20,13,7,1,20.0
ECU-011013,2122,13,6,7,1,13.0
ECU-011014,2122,212,100,112,12,17.666666666666668
ECU-011015,2122,18,6,12,1,18.0
ECU-011016,2122,522,263,259,20,26.1
ECU-011017,2122,217,115,102,15,14.466666666666667
ECU-011018,2122,767,390,377,43,17.837209302325583
ECU-011019,2122,4,1,3,1,4.0
ECU-011020,2122,142,76,66,6,23.666666666666668
ECU-011021,2122,19,7,12,1,19.0
ECU-011022,2122,25,11,14,1,25.0
ECU-011023,2122,28,14,14,1,28.0
ECU-011024,2122,58,29,29,2,29.0
ECU-011025,2122,42,18,24,2,21.0
ECU-011026,2122,323,146,177,19,17.0
ECU-011027,2122,17,8,9,1,17.0
ECU-011028,2122,2,1,1,1,2.0
ECU-011029,2122,40,22,18,2,20.0
ECU-011030,2122,78,39,39,3,26.0
ECU-011031,2122,38,17,21,2,19.0
ECU-011032,2122,363,195,168,19,19.105263157894736
ECU-011033,2122,11,6,5,1,11.0
ECU-011034,2122,350,172,178,16,21.875
ECU-011035,2122,44,22,22,2,22.0
ECU-011036,2122,176,82,94,9,19.555555555555557
ECU-011037,2122,180,77,103,9,20.0
ECU-011038,2122,515,292,223,29,17.75862068965517
ECU-011039,2122,820,379,441,34,24.11764705882353
ECU-011040,2122,16,7,9,1,16.0
ECU-011041,2122,39,21,18,2,19.5
ECU-011042,2122,191,88,103,12,15.916666666666666
ECU-011043,2122,1715,876,839,77,22.272727272727273
ECU-011044,2122,19,11,8,1,19.0
ECU-011045,2122,40,17,23,10,4.0
ECU-011046,2122,177,80,97,12,14.75
ECU-011047,2122,6,3,3,1,6.0
ECU-011048,2122,33,15,18,2,16.5
ECU-011049,2122,5,3,2,1,5.0
ECU-011050,2122,25,10,15,1,25.0
ECU-011051,2122,50,20,30,3,16.666666666666668
ECU-011052,2122,22,9,13,2,11.0
ECU-011053,2122,160,76,84,10,16.0
ECU-011054,2122,22,11,11,1,22.0
ECU-011055,2122,81,32,49,4,20.25
ECU-011056,2122,43,22,21,2,21.5
ECU-011057,2122,6,4,2,1,6.0
ECU-011058,2122,16,9,7,1,16.0
ECU-011059,2122,64,33,31,2,32.0
ECU-011060,2122,17,10,7,1,17.0
ECU-011061,2122,20,8,12,1,20.0
ECU-011062,2122,10,5,5,1,10.0
ECU-011063,2122,7,5,2,1,7.0
ECU-011064,2122,146,73,73,13,11.23076923076923
ECU-011065,2122,33,17,16,2,16.5
ECU-011066,2122,180,82,98,13,13.846153846153847
ECU-011067,2122,21,14,7,1,21.0
ECU-011068,2122,212,85,127,19,11.157894736842104
ECU-011069,2122,31,18,13,2,15.5
ECU-011070,2122,46,19,27,2,23.0
ECU-011071,2122,6,1,5,1,6.0
ECU-011072,2122,4,2,2,1,4.0
ECU-011073,2122,10,6,4,1,10.0
ECU-011074,2122,263,149,114,13,20.23076923076923
ECU-011075,2122,366,175,191,24,15.25
ECU-011076,2122,4,1,3,1,4.0
ECU-011077,2122,351,166,185,20,17.55
ECU-011078,2122,686,367,319,34,20.176470588235293
ECU-011079,2122,8,4,4,1,8.0
ECU-011080,2122,19,9,10,1,19.0
ECU-011081,2122,217,103,114,16,13.5625
ECU-011082,2122,26,14,12,2,13.0
ECU-011083,2122,15,8,7,1,15.0
ECU-011084,2122,19,10,9,2,9.5
ECU-011085,2122,12,5,7,1,12.0
ECU-011086,2122,20,5,15,1,20.0
ECU-011087,2122,8,4,4,1,8.0
ECU-011088,2122,13,8,5,1,13.0
ECU-011089,2122,4,2,2,1,4.0
ECU-011090,2122,14,8,6,1,14.0
ECU-011091,2122,21,10,11,1,21.0
ECU-011092,2122,109,53,56,5,21.8
ECU-011093,2122,3,0,3,1,3.0
ECU-011094,2122,15,9,6,1,15.0
ECU-011095,2122,6,2,4,1,6.0
ECU-011096,2122,43,18,25,2,21.5
ECU-011097,2122,22,14,8,1,22.0
ECU-011098,2122,3,3,0,1,3.0
ECU-011099,2122,22,11,11,1,22.0
ECU-011100,2122,23,9,14,1,23.0
ECU-011101,2122,76,36,40,3,25.333333333333332
ECU-011102,2122,14,6,8,1,14.0
ECU-011103,2122,150,83,67,9,16.666666666666668
ECU-011104,2122,14,7,7,1,14.0
ECU-011105,2122,6,4,2,1,6.0
ECU-011106,2122,712,376,336,38,18.736842105263158
ECU-011107,2122,531,264,267,20,26.55
ECU-011108,2122,581,292,289,23,25.26086956521739
ECU-011109,2122,372,197,175,14,26.571428571428573
ECU-011110,2122,24,17,7,4,6.0
ECU-011111,2122,59,30,29,2,29.5
ECU-011112,2122,50,17,33,1,50.0
ECU-011113,2122,22,12,10,2,11.0
ECU-011114,2122,5,4,1,1,5.0
ECU-011115,2122,5,3,2,1,5.0
ECU-011116,2122,11,5,6,1,11.0
ECU-011117,2122,10,6,4,1,10.0
ECU-011118,2122,18,6,12,1,18.0
ECU-011119,2122,183,84,99,10,18.3
ECU-011120,2122,9,4,5,1,9.0
ECU-011121,2122,9,3,6,1,9.0
ECU-011122,2122,123,63,60,6,20.5
ECU-011123,2122,20,12,8,1,20.0
ECU-011124,2122,141,62,79,7,20.142857142857142
ECU-011125,2122,61,25,36,3,20.333333333333332
ECU-011126,2122,251,119,132,18,13.944444444444445
ECU-011127,2122,664,328,336,34,19.529411764705884
ECU-011128,2122,11,5,6,1,11.0
ECU-011129,2122,32,13,19,1,32.0
ECU-011130,2122,131,61,70,11,11.909090909090908
ECU-011131,2122,20,13,7,1,20.0
ECU-011132,2122,26,11,15,1,26.0
ECU-011133,2122,15,9,6,1,15.0
ECU-011134,2122,15,5,10,1,15.0
ECU-011135,2122,8,3,5,1,8.0
ECU-011136,2122,9,6,3,1,9.0
ECU-011137,2122,11,5,6,1,11.0
ECU-011138,2122,21,8,13,1,21.0
ECU-011139,2122,3,2,1,1,3.0
ECU-011140,2122,7,3,4,1,7.0
ECU-011141,2122,281,147,134,20,14.05
ECU-011142,2122,9,4,5,1,9.0
ECU-011143,2122,22,9,13,1,22.0
ECU-011144,2122,9,6,3,1,9.0
ECU-011145,2122,23,11,12,2,11.5
ECU-011146,2122,12,5,7,1,12.0
ECU-011147,2122,9,5,4,1,9.0
ECU-011148,2122,497,244,253,26,19.115384615384617
ECU-011149,2122,18,12,6,1,18.0
ECU-011150,2122,226,117,109,14,16.142857142857142
ECU-011151,2122,626,328,298,30,20.866666666666667
ECU-011152,2122,947,514,433,44,21.522727272727273
ECU-011153,2122,266,135,131,12,22.166666666666668
ECU-011154,2122,9,2,7,1,9.0
ECU-011155,2122,472,229,243,28,16.857142857142858
ECU-011156,2122,264,132,132,15,17.6
ECU-011157,2122,98,47,51,4,24.5
ECU-011158,2122,546,268,278,18,30.333333333333332
ECU-011159,2122,24,9,15,1,24.0
ECU-011160,2122,30,13,17,2,15.0
ECU-011161,2122,690,335,355,27,25.555555555555557
ECU-011162,2122,234,110,124,11,21.272727272727273
ECU-011163,2122,635,324,311,35,18.142857142857142
ECU-011164,2122,41,15,26,8,5.125
ECU-011165,2122,6,4,2,1,6.0
ECU-011166,2122,12,5,7,1,12.0
ECU-011167,2122,9,5,4,1,9.0
ECU-011168,2122,41,20,21,1,41.0
ECU-011169,2122,651,338,313,37,17.594594594594593
ECU-011170,2122,53,28,25,2,26.5
ECU-011171,2122,133,65,68,6,22.166666666666668
ECU-011172,2122,4,2,2,1,4.0
ECU-011173,2122,84,36,48,4,21.0
ECU-011174,2122,964,481,483,39,24.71794871794872
ECU-011175,2122,17,8,9,2,8.5
ECU-011176,2122,4,1,3,1,4.0
ECU-011177,2122,37,12,25,2,18.5
ECU-011178,2122,12,5,7,1,12.0
ECU-011179,2122,126,66,60,8,15.75
ECU-011180,2122,286,141,145,17,16.823529411764707
ECU-011181,2122,9,6,3,1,9.0
ECU-011182,2122,20,6,14,1,20.0
ECU-011183,2122,31,13,18,2,15.5
ECU-011184,2122,8,4,4,1,8.0
ECU-011185,2122,10,4,6,1,10.0
ECU-011186,2122,47,22,25,3,15.666666666666666
ECU-011187,2122,13,6,7,1,13.0
ECU-011188,2122,20,10,10,2,10.0
ECU-011189,2122,30,14,16,2,15.0
ECU-011190,2122,20,8,12,1,20.0
ECU-011191,2122,12,6,6,1,12.0
ECU-011192,2122,94,35,59,3,31.333333333333332
ECU-011193,2122,73,40,33,3,24.333333333333332
ECU-011194,2122,777,363,414,38,20.44736842105263
ECU-011195,2122,10,5,5,1,10.0
ECU-011196,2122,18,10,8,1,18.0
ECU-011197,2122,107,44,63,5,21.4
ECU-011198,2122,40,16,24,2,20.0
ECU-011199,2122,47,24,23,3,15.666666666666666
ECU-011200,2122,8,5,3,1,8.0
ECU-011201,2122,530,249,281,27,19.62962962962963
ECU-011202,2122,424,223,201,20,21.2
ECU-011203,2122,22,13,9,1,22.0
ECU-011204,2122,53,25,28,1,53.0
ECU-011205,2122,431,203,228,22,19.59090909090909
ECU-011206,2122,59,28,31,2,29.5
ECU-011207,2122,9,2,7,1,9.0
ECU-011208,2122,86,36,50,3,28.666666666666668
ECU-011209,2122,19,9,10,1,19.0
ECU-011210,2122,161,79,82,9,17.88888888888889
ECU-011211,2122,25,16,9,1,25.0
ECU-011212,2122,50,24,26,2,25.0
ECU-011213,2122,44,20,24,4,11.0
ECU-011214,2122,26,11,15,1,26.0
ECU-011215,2122,22,11,11,1,22.0
ECU-011216,2122,13,6,7,1,13.0
ECU-011217,2122,30,17,13,1,30.0
ECU-011218,2122,17,8,9,1,17.0
ECU-011219,2122,11,5,6,1,11.0
ECU-011220,2122,5,3,2,1,5.0
ECU-011221,2122,20,10,10,1,20.0
ECU-011222,2122,14,4,10,1,14.0
ECU-011223,2122,30,11,19,1,30.0
ECU-011224,2122,13,2,11,1,13.0
ECU-011225,2122,43,22,21,2,21.5
ECU-011226,2122,19,10,9,1,19.0
ECU-011227,2122,27,14,13,1,27.0
ECU-011228,2122,204,115,89,9,22.666666666666668
ECU-011229,2122,129,70,59,5,25.8
ECU-011230,2122,127,72,55,8,15.875
ECU-011231,2122,166,85,81,6,27.666666666666668
ECU-011232,2122,267,136,131,10,26.7
ECU-011233,2122,31,12,19,6,5.166666666666667
ECU-011234,2122,129,63,66,5,25.8
ECU-011235,2122,564,244,320,31,18.193548387096776
ECU-011236,2122,49,25,24,1,49.0
ECU-011237,2122,10,1,9,2,5.0
ECU-011238,2122,11,5,6,2,5.5
ECU-011239,2122,139,68,71,5,27.8
ECU-011240,2122,25,9,16,3,8.333333333333334
ECU-011241,2122,69,36,33,9,7.666666666666667
ECU-011242,2122,2333,1380,953,118,19.771186440677965
ECU-011243,2122,1272,439,833,64,19.875
ECU-011244,2122,612,214,398,36,17.0
ECU-011245,2122,282,136,146,15,18.8
ECU-011246,2122,1605,895,710,85,18.88235294117647
ECU-011247,2122,332,148,184,22,15.090909090909092
ECU-011248,2122,94,46,48,10,9.4
ECU-011249,2122,138,66,72,15,9.2
ECU-011250,2122,1693,768,925,60,28.216666666666665
ECU-011251,2122,799,530,269,38,21.026315789473685
ECU-011252,2122,1119,493,626,63,17.761904761904763
ECU-011253,2122,1860,886,974,67,27.761194029850746
ECU-011254,2122,776,400,376,58,13.379310344827585
ECU-011255,2122,213,97,116,19,11.210526315789474
ECU-011256,2122,541,254,287,31,17.451612903225808
ECU-011257,2122,1282,655,627,72,17.805555555555557
ECU-011258,2122,1204,535,669,61,19.737704918032787
ECU-011259,2122,2861,1469,1392,132,21.674242424242426
ECU-011260,2122,640,288,352,37,17.2972972972973
ECU-011261,2122,69,36,33,10,6.9
ECU-011262,2122,215,119,96,16,13.4375
ECU-011263,2122,1126,491,635,49,22.979591836734695
ECU-011264,2122,950,499,451,46,20.652173913043477
ECU-011265,2122,88,43,45,7,12.571428571428571
ECU-011266,2122,476,236,240,34,14.0
ECU-011267,2122,921,477,444,63,14.619047619047619
ECU-011268,2122,806,428,378,56,14.392857142857142
ECU-011269,2122,527,248,279,30,17.566666666666666
ECU-011270,2122,688,332,356,45,15.28888888888889
ECU-011271,2122,141,68,73,9,15.666666666666666
ECU-011272,2122,428,186,242,17,25.176470588235293
ECU-011273,2122,501,254,247,59,8.491525423728813
ECU-011274,2122,263,133,130,15,17.533333333333335
ECU-011275,2122,90,40,50,13,6.923076923076923
ECU-011276,2122,199,84,115,18,11.055555555555555
ECU-011277,2122,97,48,49,12,8.083333333333334
ECU-011278,2122,199,103,96,13,15.307692307692308
ECU-011279,2122,500,251,249,40,12.5
ECU-011280,2122,970,838,132,52,18.653846153846153
ECU-011281,2122,27,15,12,7,3.857142857142857
ECU-011282,2122,109,49,60,14,7.785714285714286
ECU-011283,2122,967,470,497,37,26.135135135135137
ECU-011284,2122,1149,534,615,48,23.9375
ECU-011285,2122,46,21,25,5,9.2
ECU-011286,2122,2619,1376,1243,107,24.476635514018692
ECU-011287,2122,22,10,12,1,22.0
ECU-011288,2122,260,137,123,17,15.294117647058824
ECU-011289,2122,400,200,200,18,22.22222222222222
ECU-011290,2122,109,55,54,5,21.8
ECU-011291,2122,603,293,310,35,17.228571428571428
ECU-011292,2122,506,267,239,26,19.46153846153846
ECU-011293,2122,881,421,460,46,19.152173913043477
ECU-011294,2122,232,122,110,11,21.09090909090909
ECU-011295,2122,196,100,96,7,28.0
ECU-011296,2122,443,210,233,28,15.821428571428571
ECU-011297,2122,65,19,46,16,4.0625
ECU-011298,2122,204,101,103,13,15.692307692307692
ECU-011299,2122,322,156,166,19,16.94736842105263
ECU-011300,2122,813,418,395,58,14.017241379310345
ECU-011301,2122,1872,867,1005,76,24.63157894736842
ECU-011302,2122,1172,596,576,56,20.928571428571427
ECU-011303,2122,186,86,100,18,10.333333333333334
ECU-011304,2122,10,3,7,1,10.0
ECU-011305,2122,31,16,15,2,15.5
ECU-011306,2122,85,43,42,9,9.444444444444445
ECU-011307,2122,34,19,15,3,11.333333333333334
ECU-011308,2122,197,102,95,14,14.071428571428571
ECU-011309,2122,319,160,159,17,18.764705882352942
ECU-011310,2122,685,347,338,39,17.564102564102566
ECU-011311,2122,38,16,22,3,12.666666666666666
ECU-011312,2122,1117,634,483,30,37.233333333333334
ECU-011313,2122,586,272,314,31,18.903225806451612
ECU-011314,2122,146,68,78,12,12.166666666666666
ECU-011315,2122,8,4,4,1,8.0
ECU-011316,2122,113,60,53,8,14.125
ECU-011317,2122,111,55,56,14,7.928571428571429
ECU-011318,2122,466,237,229,32,14.5625
ECU-011319,2122,615,296,319,47,13.085106382978724
ECU-011320,2122,964,465,499,57,16.912280701754387
ECU-011321,2122,18,9,9,1,18.0
ECU-011322,2122,852,462,390,38,22.42105263157895
ECU-011323,2122,14,5,9,1,14.0
ECU-011324,2122,379,198,181,23,16.47826086956522
ECU-011325,2122,244,136,108,16,15.25
ECU-011326,2122,19,7,12,1,19.0
ECU-011327,2122,60,36,24,8,7.5
ECU-011328,2122,46,21,25,4,11.5
ECU-011329,2122,414,212,202,23,18.0
ECU-011330,2122,3,2,1,1,3.0
ECU-011331,2122,11,10,1,1,11.0
ECU-011332,2122,78,38,40,9,8.666666666666666
ECU-011333,2122,28,12,16,1,28.0
ECU-011334,2122,13,5,8,1,13.0
ECU-011335,2122,11,6,5,1,11.0
ECU-011336,2122,473,245,228,28,16.892857142857142
ECU-011337,2122,501,250,251,26,19.26923076923077
ECU-011338,2122,10,5,5,1,10.0
ECU-011339,2122,14,7,7,1,14.0
ECU-011340,2122,68,29,39,6,11.333333333333334
ECU-011341,2122,19,10,9,1,19.0
ECU-011342,2122,13,5,8,1,13.0
ECU-011343,2122,626,434,192,26,24.076923076923077
ECU-011344,2122,268,136,132,31,8.64516129032258
ECU-011345,2122,82,43,39,5,16.4
ECU-011346,2122,277,117,160,24,11.541666666666666
ECU-011347,2122,161,78,83,13,12.384615384615385
ECU-011348,2122,1670,777,893,90,18.555555555555557
ECU-011349,2122,784,450,334,35,22.4
ECU-011350,2122,1657,818,839,94,17.627659574468087
ECU-011351,2122,106,51,55,13,8.153846153846153
ECU-011352,2122,115,59,56,10,11.5
ECU-011353,2122,134,67,67,10,13.4
ECU-011354,2122,136,76,60,11,12.363636363636363
ECU-011355,2122,796,454,342,30,26.533333333333335
ECU-011356,2122,788,326,462,42,18.761904761904763
ECU-011357,2122,31,11,20,3,10.333333333333334
ECU-011358,2122,278,134,144,18,15.444444444444445
ECU-011359,2122,105,62,43,6,17.5
ECU-011360,2122,131,69,62,13,10.076923076923077
ECU-011361,2122,222,105,117,12,18.5
ECU-011362,2122,81,48,33,9,9.0
ECU-011363,2122,151,81,70,12,12.583333333333334
ECU-011364,2122,394,192,202,27,14.592592592592593
ECU-011365,2122,500,271,229,22,22.727272727272727
ECU-011366,2122,229,118,111,11,20.818181818181817
ECU-011367,2122,735,365,370,26,28.26923076923077
ECU-011368,2122,1734,834,900,66,26.272727272727273
ECU-011369,2122,118,58,60,12,9.833333333333334
ECU-011370,2122,998,457,541,36,27.72222222222222
ECU-011371,2122,432,213,219,18,24.0
ECU-011372,2122,482,234,248,18,26.77777777777778
ECU-011373,2122,475,240,235,20,23.75
ECU-011374,2122,999,540,459,54,18.5
ECU-011375,2122,720,381,339,29,24.82758620689655
ECU-011376,2122,138,74,64,6,23.0
ECU-011377,2122,1133,966,167,61,18.57377049180328
ECU-011378,2122,687,343,344,30,22.9
ECU-011379,2122,542,279,263,18,30.11111111111111
ECU-011380,2122,611,282,329,20,30.55
ECU-011381,2122,210,102,108,8,26.25
ECU-011382,2122,175,90,85,7,25.0
ECU-011383,2122,312,157,155,13,24.0
ECU-011384,2122,767,378,389,25,30.68
ECU-011385,2122,502,255,247,27,18.59259259259259
ECU-011386,2122,626,280,346,51,12.27450980392157
ECU-011387,2122,215,110,105,9,23.88888888888889
ECU-011388,2122,648,296,352,30,21.6
ECU-011389,2122,1267,636,631,90,14.077777777777778
ECU-011390,2122,211,104,107,10,21.1
ECU-011391,2122,1285,584,701,38,33.81578947368421
ECU-011392,2122,868,428,440,35,24.8
ECU-011393,2122,416,199,217,15,27.733333333333334
ECU-011394,2122,154,78,76,14,11.0
ECU-011395,2122,435,201,234,14,31.071428571428573
ECU-011396,2122,1519,399,1120,72,21.09722222222222
ECU-011397,2122,573,234,339,31,18.483870967741936
ECU-011398,2122,349,156,193,13,26.846153846153847
ECU-011399,2122,289,127,162,10,28.9
ECU-011400,2122,1119,530,589,37,30.243243243243242
ECU-011401,2122,223,98,125,7,31.857142857142858
ECU-011402,2122,188,89,99,8,23.5
ECU-011403,2122,195,88,107,11,17.727272727272727
ECU-011404,2122,95,42,53,10,9.5
ECU-011405,2122,688,341,347,28,24.571428571428573
ECU-011406,2122,60,22,38,5,12.0
ECU-011407,2122,243,106,137,10,24.3
ECU-011408,2122,585,298,287,18,32.5
ECU-011409,2122,62,32,30,8,7.75
ECU-011410,2122,14,10,4,4,3.5
ECU-011411,2122,1222,569,653,50,24.44
ECU-011412,2122,443,212,231,19,23.31578947368421
ECU-011413,2122,205,100,105,11,18.636363636363637
ECU-011414,2122,491,242,249,19,25.842105263157894
ECU-011415,2122,240,101,139,9,26.666666666666668
ECU-011416,2122,1435,688,747,51,28.137254901960784
ECU-011417,2122,1494,692,802,66,22.636363636363637
ECU-011418,2122,338,169,169,19,17.789473684210527
ECU-011419,2122,476,208,268,19,25.05263157894737
ECU-011420,2122,410,202,208,18,22.77777777777778
ECU-011421,2122,415,188,227,23,18.043478260869566
ECU-011422,2122,95,40,55,10,9.5
ECU-011423,2122,111,57,54,10,11.1
ECU-011424,2122,247,139,108,14,17.642857142857142
ECU-011425,2122,127,56,71,18,7.055555555555555
ECU-011426,2122,136,69,67,12,11.333333333333334
ECU-011427,2122,2,2,0,1,2.0
ECU-011428,2122,213,122,91,8,26.625
ECU-011429,2122,121,60,61,12,10.083333333333334
ECU-011430,2122,405,195,210,15,27.0
ECU-011431,2122,828,348,480,29,28.551724137931036
ECU-011432,2122,1861,896,965,86,21.63953488372093
ECU-011433,2122,223,108,115,8,27.875
ECU-011434,2122,636,312,324,22,28.90909090909091
ECU-011435,2122,17,9,8,1,17.0
ECU-011436,2122,570,290,280,19,30.0
ECU-011437,2122,306,154,152,14,21.857142857142858
ECU-011438,2122,177,97,80,8,22.125
ECU-011439,2122,24,15,9,1,24.0
ECU-011440,2122,501,250,251,19,26.36842105263158
ECU-011441,2122,309,133,176,18,17.166666666666668
ECU-011442,2122,416,182,234,18,23.11111111111111
ECU-011443,2122,667,331,336,20,33.35
ECU-011444,2122,604,291,313,17,35.529411764705884
ECU-011445,2122,1146,527,619,48,23.875
ECU-011446,2122,258,149,109,11,23.454545454545453
ECU-011447,2122,87,43,44,8,10.875
ECU-011448,2122,105,49,56,4,26.25
ECU-011449,2122,262,135,127,11,23.818181818181817
ECU-011450,2122,33,14,19,3,11.0
ECU-011451,2122,293,154,139,10,29.3
ECU-011452,2122,1473,636,837,85,17.32941176470588
ECU-011453,2122,592,296,296,25,23.68
ECU-011454,2122,173,72,101,10,17.3
ECU-011455,2122,94,44,50,6,15.666666666666666
ECU-011456,2122,419,216,203,15,27.933333333333334
ECU-011457,2122,116,46,70,23,5.043478260869565
ECU-011458,2122,260,129,131,12,21.666666666666668
ECU-011459,2122,18,10,8,3,6.0
ECU-011460,2122,195,105,90,18,10.833333333333334
ECU-011461,2122,298,155,143,11,27.09090909090909
ECU-011462,2122,833,467,366,30,27.766666666666666
ECU-011463,2122,3041,1631,1410,125,24.328
ECU-011464,2122,223,99,124,16,13.9375
ECU-011465,2122,241,113,128,13,18.53846153846154
ECU-011466,2122,735,339,396,25,29.4
ECU-011467,2122,702,326,376,26,27.0
ECU-011468,2122,846,437,409,28,30.214285714285715
ECU-011469,2122,89,38,51,3,29.666666666666668
ECU-011470,2122,211,90,121,10,21.1
ECU-011471,2122,230,100,130,11,20.90909090909091
ECU-011472,2122,72,44,28,8,9.0
ECU-011473,2122,257,115,142,9,28.555555555555557
ECU-011474,2122,481,236,245,23,20.91304347826087
ECU-011475,2122,3022,1876,1146,124,24.370967741935484
ECU-011476,2122,121,58,63,5,24.2
ECU-011477,2122,1768,909,859,55,32.14545454545455
ECU-011478,2122,625,319,306,19,32.89473684210526
ECU-011479,2122,788,366,422,30,26.266666666666666
ECU-011480,2122,660,329,331,20,33.0
ECU-011481,2122,754,383,371,27,27.925925925925927
ECU-011482,2122,180,89,91,11,16.363636363636363
ECU-011483,2122,669,325,344,20,33.45
ECU-011484,2122,1552,810,742,69,22.492753623188406
ECU-011485,2122,368,166,202,13,28.307692307692307
ECU-011486,2122,70,29,41,15,4.666666666666667
ECU-011487,2122,298,144,154,22,13.545454545454545
ECU-011488,2122,75,37,38,7,10.714285714285714
ECU-011489,2122,838,412,426,25,33.52
ECU-011490,2122,559,286,273,19,29.42105263157895
ECU-011491,2122,592,344,248,20,29.6
ECU-011492,2122,821,483,338,26,31.576923076923077
ECU-011493,2122,579,259,320,25,23.16
ECU-011494,2122,1047,516,531,36,29.083333333333332
ECU-011495,2122,534,266,268,15,35.6
ECU-011496,2122,494,229,265,21,23.523809523809526
ECU-011497,2122,261,120,141,11,23.727272727272727
ECU-011498,2122,387,182,205,15,25.8
ECU-011499,2122,266,139,127,13,20.46153846153846
ECU-011500,2122,605,317,288,27,22.40740740740741
ECU-011501,2122,43,25,18,9,4.777777777777778
ECU-011502,2122,560,286,274,26,21.53846153846154
ECU-011503,2122,232,96,136,16,14.5
ECU-011504,2122,14,7,7,1,14.0
ECU-011505,2122,808,420,388,31,26.06451612903226
ECU-011506,2122,1238,582,656,47,26.340425531914892
ECU-011507,2122,160,62,98,13,12.307692307692308
ECU-011508,2122,532,274,258,25,21.28
ECU-011509,2122,170,98,72,10,17.0
ECU-011510,2122,353,169,184,18,19.61111111111111
ECU-011511,2122,623,288,335,28,22.25
ECU-011512,2122,11,5,6,1,11.0
ECU-011513,2122,49,27,22,2,24.5
ECU-011514,2122,196,105,91,11,17.818181818181817
ECU-011515,2122,20,7,13,1,20.0
ECU-011516,2122,21,11,10,2,10.5
ECU-011517,2122,8,5,3,1,8.0
ECU-011518,2122,182,94,88,11,16.545454545454547
ECU-011519,2122,43,20,23,2,21.5
ECU-011520,2122,80,34,46,4,20.0
ECU-011521,2122,74,34,40,6,12.333333333333334
ECU-011522,2122,180,83,97,9,20.0
ECU-011523,2122,263,125,138,14,18.785714285714285
ECU-011524,2122,9,5,4,1,9.0
ECU-011525,2122,7,3,4,1,7.0
ECU-011526,2122,8,6,2,1,8.0
ECU-011527,2122,15,8,7,1,15.0
ECU-011528,2122,15,7,8,1,15.0
ECU-011529,2122,9,2,7,1,9.0
ECU-011530,2122,285,138,147,16,17.8125
ECU-011531,2122,15,7,8,1,15.0
ECU-011532,2122,10,7,3,1,10.0
ECU-011533,2122,22,14,8,1,22.0
ECU-011534,2122,1,0,1,1,1.0
ECU-011535,2122,280,131,149,14,20.0
ECU-011536,2122,17,6,11,1,17.0
ECU-011537,2122,69,38,31,3,23.0
ECU-011538,2122,8,3,5,1,8.0
ECU-011539,2122,6,2,4,1,6.0
ECU-011540,2122,51,27,24,3,17.0
ECU-011541,2122,12,8,4,1,12.0
ECU-011542,2122,554,261,293,23,24.08695652173913
ECU-011543,2122,18,7,11,1,18.0
ECU-011544,2122,33,14,19,2,16.5
ECU-011545,2122,279,141,138,18,15.5
ECU-011546,2122,133,60,73,12,11.083333333333334
ECU-011547,2122,14,7,7,1,14.0
ECU-011548,2122,11,6,5,1,11.0
ECU-011549,2122,8,5,3,1,8.0
ECU-011550,2122,9,5,4,1,9.0
ECU-011551,2122,63,38,25,3,21.0
ECU-011552,2122,42,17,25,2,21.0
ECU-011553,2122,378,179,199,13,29.076923076923077
ECU-011554,2122,593,298,295,24,24.708333333333332
ECU-011555,2122,769,382,387,29,26.517241379310345
ECU-011556,2122,11,5,6,1,11.0
ECU-011557,2122,426,194,232,19,22.42105263157895
ECU-011558,2122,7,5,2,1,7.0
ECU-011559,2122,21,10,11,2,10.5
ECU-011560,2122,400,195,205,18,22.22222222222222
ECU-011561,2122,35,18,17,3,11.666666666666666
ECU-011562,2122,28,13,15,2,14.0
ECU-011563,2122,25,10,15,1,25.0
ECU-011564,2122,10,7,3,1,10.0
ECU-011565,2122,17,10,7,2,8.5
ECU-011566,2122,16,8,8,1,16.0
ECU-011567,2122,10,6,4,1,10.0
ECU-011568,2122,293,153,140,20,14.65
ECU-011569,2122,6,3,3,1,6.0
ECU-011570,2122,7,2,5,1,7.0
ECU-011571,2122,210,92,118,11,19.09090909090909
ECU-011572,2122,991,459,532,36,27.52777777777778
ECU-011573,2122,75,33,42,4,18.75
ECU-011574,2122,166,79,87,13,12.76923076923077
ECU-011575,2122,2649,1342,1307,103,25.718446601941746
ECU-011576,2122,114,58,56,4,28.5
ECU-011577,2122,39,23,16,2,19.5
ECU-011578,2122,267,137,130,19,14.052631578947368
ECU-011579,2122,99,54,45,4,24.75
ECU-011580,2122,1318,610,708,48,27.458333333333332
ECU-011581,2122,904,407,497,31,29.161290322580644
ECU-011582,2122,157,86,71,9,17.444444444444443
ECU-011583,2122,38,15,23,8,4.75
ECU-011584,2122,907,457,450,30,30.233333333333334
ECU-011585,2122,118,61,57,11,10.727272727272727
ECU-011586,2122,170,85,85,8,21.25
ECU-011587,2122,17,7,10,8,2.125
ECU-011588,2122,184,85,99,15,12.266666666666667
ECU-011589,2122,243,111,132,9,27.0
ECU-011590,2122,178,79,99,7,25.428571428571427
ECU-011591,2122,1326,693,633,50,26.52
ECU-011592,2122,135,65,70,7,19.285714285714285
ECU-011593,2122,37,20,17,2,18.5
ECU-011594,2122,823,381,442,35,23.514285714285716
ECU-011595,2122,203,101,102,9,22.555555555555557
ECU-011596,2122,85,40,45,3,28.333333333333332
ECU-011597,2122,55,21,34,3,18.333333333333332
ECU-011598,2122,899,460,439,28,32.107142857142854
ECU-011599,2122,471,235,236,19,24.789473684210527
ECU-011600,2122,60,27,33,2,30.0
ECU-011601,2122,84,43,41,3,28.0
ECU-011602,2122,329,165,164,13,25.307692307692307
ECU-011603,2122,5,2,3,1,5.0
ECU-011604,2122,45,22,23,2,22.5
ECU-011605,2122,140,61,79,5,28.0
ECU-011606,2122,254,131,123,11,23.09090909090909
ECU-011607,2122,328,152,176,17,19.294117647058822
ECU-011608,2122,26,14,12,1,26.0
ECU-011609,2122,29,9,20,2,14.5
ECU-011610,2122,46,25,21,2,23.0
ECU-011611,2122,261,110,151,18,14.5
ECU-011612,2122,12,5,7,1,12.0
ECU-011613,2122,122,67,55,4,30.5
ECU-011614,2122,290,131,159,14,20.714285714285715
ECU-011615,2122,338,160,178,13,26.0
ECU-011616,2122,14,8,6,1,14.0
ECU-011617,2122,40,14,26,2,20.0
ECU-011618,2122,455,223,232,25,18.2
ECU-011619,2122,233,116,117,10,23.3
ECU-011620,2122,497,248,249,19,26.157894736842106
ECU-011621,2122,976,461,515,34,28.705882352941178
ECU-011622,2122,599,313,286,27,22.185185185185187
ECU-011623,2122,845,427,418,41,20.609756097560975
ECU-011624,2122,730,370,360,32,22.8125
ECU-011625,2122,187,86,101,10,18.7
ECU-011626,2122,289,138,151,12,24.083333333333332
ECU-011627,2122,71,25,46,3,23.666666666666668
ECU-011628,2122,180,82,98,10,18.0
ECU-011629,2122,160,73,87,8,20.0
ECU-011630,2122,359,185,174,14,25.642857142857142
ECU-011631,2122,230,146,84,6,38.333333333333336
ECU-011632,2122,1321,544,777,50,26.42
ECU-011633,2122,278,126,152,13,21.384615384615383
ECU-011634,2122,103,37,66,13,7.923076923076923
ECU-011635,2122,298,135,163,13,22.923076923076923
ECU-011636,2122,735,468,267,27,27.22222222222222
ECU-011637,2122,566,301,265,20,28.3
ECU-011638,2122,160,89,71,7,22.857142857142858
ECU-011639,2122,706,441,265,29,24.344827586206897
ECU-011640,2122,196,104,92,9,21.77777777777778
ECU-011641,2122,431,215,216,17,25.352941176470587
ECU-011642,2122,530,261,269,23,23.043478260869566
ECU-011643,2122,131,63,68,13,10.076923076923077
ECU-011644,2122,351,164,187,17,20.647058823529413
ECU-011645,2122,1188,591,597,55,21.6
ECU-011646,2122,1302,612,690,59,22.06779661016949
ECU-011647,2122,10,1,9,1,10.0
ECU-011648,2122,414,179,235,22,18.818181818181817
ECU-011649,2122,353,184,169,16,22.0625
ECU-011650,2122,50,32,18,2,25.0
ECU-011651,2122,71,38,33,3,23.666666666666668
ECU-011652,2122,571,302,269,39,14.64102564102564
ECU-011653,2122,13,5,8,1,13.0
ECU-011654,2122,261,112,149,17,15.352941176470589
ECU-011655,2122,1127,587,540,39,28.897435897435898
ECU-011656,2122,324,178,146,10,32.4
ECU-011657,2122,793,381,412,36,22.02777777777778
ECU-011658,2122,766,383,383,27,28.37037037037037
ECU-011659,2122,373,195,178,16,23.3125
ECU-011660,2122,1108,590,518,37,29.945945945945947
ECU-011661,2122,587,291,296,26,22.576923076923077
ECU-011662,2122,5,1,4,1,5.0
ECU-011663,2122,45,21,24,7,6.428571428571429
ECU-011664,2122,94,43,51,6,15.666666666666666
ECU-011665,2122,216,108,108,8,27.0
ECU-011666,2122,411,206,205,19,21.63157894736842
ECU-011667,2122,54,32,22,1,54.0
ECU-011668,2122,479,231,248,23,20.82608695652174
ECU-011669,2122,506,278,228,24,21.083333333333332
ECU-011670,2122,70,33,37,9,7.777777777777778
ECU-011671,2122,172,94,78,6,28.666666666666668
ECU-011672,2122,967,434,533,41,23.585365853658537
ECU-011673,2122,618,314,304,27,22.88888888888889
ECU-011674,2122,1203,633,570,35,34.371428571428574
ECU-011675,2122,463,217,246,18,25.72222222222222
ECU-011676,2122,227,114,113,8,28.375
ECU-011677,2122,1564,792,772,71,22.028169014084508
ECU-011678,2122,206,89,117,14,14.714285714285714
ECU-011679,2122,759,397,362,25,30.36
ECU-011680,2122,1528,719,809,66,23.151515151515152
ECU-011681,2122,432,229,203,22,19.636363636363637
ECU-011682,2122,61,34,27,10,6.1
ECU-011683,2122,401,251,150,27,14.851851851851851
ECU-011684,2122,387,166,221,25,15.48
ECU-011685,2122,113,47,66,5,22.6
ECU-011686,2122,851,466,385,27,31.51851851851852
ECU-011687,2122,151,60,91,9,16.77777777777778
ECU-011688,2122,60,27,33,6,10.0
ECU-011689,2122,111,52,59,6,18.5
ECU-011690,2122,147,74,73,6,24.5
ECU-011691,2122,610,300,310,27,22.59259259259259
ECU-011692,2122,1381,651,730,70,19.728571428571428
ECU-011693,2122,400,209,191,17,23.529411764705884
ECU-011694,2122,13,9,4,1,13.0
ECU-011695,2122,415,212,203,19,21.842105263157894
ECU-011696,2122,542,258,284,19,28.526315789473685
ECU-011697,2122,131,65,66,6,21.833333333333332
ECU-011698,2122,425,209,216,17,25.0
ECU-011699,2122,669,344,325,29,23.06896551724138
ECU-011700,2122,623,299,324,25,24.92
ECU-011701,2122,73,51,22,4,18.25
ECU-011702,2122,217,104,113,10,21.7
ECU-011703,2122,236,118,118,14,16.857142857142858
ECU-011704,2122,10,3,7,1,10.0
ECU-011705,2122,58,29,29,3,19.333333333333332
ECU-011706,2122,45,22,23,2,22.5
ECU-011707,2122,9,3,6,1,9.0
ECU-011708,2122,66,35,31,3,22.0
ECU-011709,2122,21,13,8,1,21.0
ECU-011710,2122,42,21,21,2,21.0
ECU-011711,2122,48,24,24,2,24.0
ECU-011712,2122,14,6,8,1,14.0
ECU-011713,2122,34,13,21,2,17.0
ECU-011714,2122,6,3,3,1,6.0
ECU-011715,2122,17,13,4,1,17.0
ECU-011716,2122,5,3,2,1,5.0
ECU-011717,2122,12,5,7,1,12.0
ECU-011718,2122,283,135,148,17,16.647058823529413
ECU-011719,2122,8,2,6,1,8.0
ECU-011720,2122,7,3,4,1,7.0
ECU-011721,2122,203,92,111,12,16.916666666666668
ECU-011722,2122,14,10,4,1,14.0
ECU-011723,2122,393,207,186,15,26.2
ECU-011724,2122,822,450,372,42,19.571428571428573
ECU-011725,2122,15,9,6,1,15.0
ECU-011726,2122,445,180,265,19,23.42105263157895
ECU-011727,2122,34,13,21,5,6.8
ECU-011728,2122,623,341,282,24,25.958333333333332
ECU-011729,2122,5,1,4,1,5.0
ECU-011730,2122,670,312,358,28,23.928571428571427
ECU-011731,2122,343,205,138,16,21.4375
ECU-011732,2122,661,297,364,28,23.607142857142858
ECU-011733,2122,1385,637,748,67,20.671641791044777
ECU-011734,2122,86,39,47,5,17.2
ECU-011735,2122,106,56,50,4,26.5
ECU-011736,2122,1,1,0,1,1.0
ECU-011737,2122,40,18,22,3,13.333333333333334
ECU-011738,2122,38,14,24,3,12.666666666666666
ECU-011739,2122,55,19,36,4,13.75
ECU-011740,2122,32,17,15,2,16.0
ECU-011741,2122,13,9,4,1,13.0
ECU-011742,2122,109,55,54,8,13.625
ECU-011743,2122,31,23,8,1,31.0
ECU-011744,2122,187,101,86,13,14.384615384615385
ECU-011745,2122,110,49,61,8,13.75
ECU-011746,2122,13,5,8,1,13.0
ECU-011747,2122,88,43,45,5,17.6
ECU-011748,2122,18,8,10,1,18.0
ECU-011749,2122,2,1,1,1,2.0
ECU-011750,2122,56,23,33,9,6.222222222222222
ECU-011751,2122,3,3,0,1,3.0
ECU-011752,2122,23,8,15,1,23.0
ECU-011753,2122,5,0,5,1,5.0
ECU-011754,2122,35,23,12,2,17.5
ECU-011755,2122,20,11,9,1,20.0
ECU-011756,2122,397,206,191,18,22.055555555555557
ECU-011757,2122,7,4,3,1,7.0
ECU-011758,2122,10,4,6,1,10.0
ECU-011759,2122,6,1,5,1,6.0
ECU-011760,2122,18,10,8,1,18.0
ECU-011761,2122,6,2,4,1,6.0
ECU-011762,2122,47,23,24,3,15.666666666666666
ECU-011763,2122,687,353,334,28,24.535714285714285
ECU-011764,2122,356,199,157,17,20.941176470588236
ECU-011765,2122,288,140,148,14,20.571428571428573
ECU-011766,2122,5,4,1,1,5.0
ECU-011767,2122,73,38,35,4,18.25
ECU-011768,2122,18,6,12,1,18.0
ECU-011769,2122,32,17,15,2,16.0
ECU-011770,2122,20,11,9,1,20.0
ECU-011771,2122,7,3,4,1,7.0
ECU-011772,2122,218,100,118,12,18.166666666666668
ECU-011773,2122,7,1,6,1,7.0
ECU-011774,2122,243,133,110,9,27.0
ECU-011775,2122,551,227,324,21,26.238095238095237
ECU-011776,2122,493,276,217,34,14.5
ECU-011777,2122,14,6,8,1,14.0
ECU-011778,2122,264,113,151,11,24.0
ECU-011779,2122,823,393,430,32,25.71875
ECU-011780,2122,13,5,8,1,13.0
ECU-011781,2122,637,406,231,35,18.2
ECU-011782,2122,180,88,92,10,18.0
ECU-011783,2122,99,95,4,6,16.5
ECU-011784,2122,29,11,18,1,29.0
ECU-011785,2122,144,71,73,6,24.0
ECU-011786,2122,213,106,107,9,23.666666666666668
ECU-011787,2122,995,513,482,48,20.729166666666668
ECU-011788,2122,359,173,186,17,21.11764705882353
ECU-011789,2122,115,71,44,8,14.375
ECU-011790,2122,179,80,99,8,22.375
ECU-011791,2122,179,75,104,10,17.9
ECU-011792,2122,58,17,41,10,5.8
ECU-011793,2122,134,75,59,6,22.333333333333332
ECU-011794,2122,724,387,337,29,24.96551724137931
ECU-011795,2122,101,43,58,6,16.833333333333332
ECU-011796,2122,1881,973,908,60,31.35
ECU-011797,2122,10,4,6,5,2.0
ECU-011798,2122,278,134,144,18,15.444444444444445
ECU-011799,2122,122,73,49,5,24.4
ECU-011800,2122,203,103,100,10,20.3
ECU-011801,2122,660,336,324,28,23.571428571428573
ECU-011802,2122,1536,744,792,65,23.630769230769232
ECU-011803,2122,384,183,201,22,17.454545454545453
ECU-011804,2122,176,90,86,7,25.142857142857142
ECU-011805,2122,1006,500,506,41,24.536585365853657
ECU-011806,2122,608,295,313,25,24.32
ECU-011807,2122,494,219,275,21,23.523809523809526
ECU-011808,2122,16,9,7,1,16.0
ECU-011809,2122,223,108,115,10,22.3
ECU-011810,2122,170,75,95,9,18.88888888888889
ECU-011811,2122,381,191,190,17,22.41176470588235
ECU-011812,2122,551,299,252,21,26.238095238095237
ECU-011813,2122,108,55,53,7,15.428571428571429
ECU-011814,2122,208,82,126,9,23.11111111111111
ECU-011815,2122,303,165,138,16,18.9375
ECU-011816,2122,169,95,74,9,18.77777777777778
ECU-011817,2122,741,303,438,40,18.525
ECU-011818,2122,334,173,161,19,17.57894736842105
ECU-011819,2122,86,40,46,4,21.5
ECU-011820,2122,204,99,105,12,17.0
ECU-011821,2122,63,31,32,4,15.75
ECU-011822,2122,153,65,88,10,15.3
ECU-011823,2122,228,114,114,9,25.333333333333332
ECU-011824,2122,112,50,62,8,14.0
ECU-011825,2122,92,45,47,8,11.5
ECU-011826,2122,106,59,47,11,9.636363636363637
ECU-011827,2122,70,34,36,6,11.666666666666666
ECU-011828,2122,15,6,9,1,15.0
ECU-011829,2122,32,15,17,2,16.0
ECU-011830,2122,138,67,71,8,17.25
ECU-011831,2122,258,122,136,11,23.454545454545453
ECU-011832,2122,14,8,6,1,14.0
ECU-011833,2122,25,14,11,2,12.5
ECU-011834,2122,85,38,47,5,17.0
ECU-011835,2122,147,72,75,10,14.7
ECU-011836,2122,11,7,4,1,11.0
ECU-011837,2122,226,111,115,10,22.6
ECU-011838,2122,43,21,22,2,21.5
ECU-011839,2122,14,8,6,1,14.0
ECU-011840,2122,217,93,124,12,18.083333333333332
ECU-011841,2122,66,29,37,6,11.0
ECU-011842,2122,35,21,14,2,17.5
ECU-011843,2122,85,40,45,5,17.0
ECU-011844,2122,234,125,109,13,18.0
ECU-011845,2122,305,154,151,18,16.944444444444443
ECU-011846,2122,18,9,9,1,18.0
ECU-011847,2122,69,38,31,4,17.25
ECU-011848,2122,20,12,8,1,20.0
ECU-011849,2122,320,140,180,16,20.0
ECU-011850,2122,247,133,114,10,24.7
ECU-011851,2122,52,22,30,11,4.7272727272727275
ECU-011852,2122,169,95,74,15,11.266666666666667
ECU-011853,2122,415,198,217,19,21.842105263157894
ECU-011854,2122,146,68,78,10,14.6
ECU-011855,2122,149,85,64,8,18.625
ECU-011856,2122,1014,494,520,40,25.35
ECU-011857,2122,1064,552,512,59,18.033898305084747
ECU-011858,2122,423,209,214,17,24.88235294117647
ECU-011859,2122,361,181,180,23,15.695652173913043
ECU-011860,2122,203,112,91,12,16.916666666666668
ECU-011861,2122,11,4,7,1,11.0
ECU-011862,2122,8,2,6,1,8.0
ECU-011863,2122,7,3,4,1,7.0
ECU-011864,2122,33,20,13,2,16.5
ECU-011865,2122,137,70,67,13,10.538461538461538
ECU-011866,2122,54,27,27,5,10.8
ECU-011867,2122,8,5,3,1,8.0
ECU-011868,2122,10,6,4,1,10.0
ECU-011869,2122,99,47,52,7,14.142857142857142
ECU-011870,2122,6,4,2,1,6.0
ECU-011871,2122,9,6,3,1,9.0
ECU-011872,2122,69,37,32,8,8.625
ECU-011873,2122,10,6,4,1,10.0
ECU-011874,2122,23,7,16,1,23.0
ECU-011875,2122,130,69,61,8,16.25
ECU-011876,2122,18,10,8,1,18.0
ECU-011877,2122,40,24,16,2,20.0
ECU-011878,2122,27,16,11,1,27.0
ECU-011879,2122,301,138,163,17,17.705882352941178
ECU-011880,2122,5,2,3,1,5.0
ECU-011881,2122,185,101,84,15,12.333333333333334
ECU-011882,2122,20,11,9,1,20.0
ECU-011883,2122,48,22,26,2,24.0
ECU-011884,2122,10,4,6,1,10.0
ECU-011885,2122,447,203,244,25,17.88
ECU-011886,2122,23,7,16,1,23.0
ECU-011887,2122,27,17,10,2,13.5
ECU-011888,2122,21,12,9,1,21.0
ECU-011889,2122,106,49,57,11,9.636363636363637
ECU-011890,2122,207,95,112,18,11.5
ECU-011891,2122,9,2,7,1,9.0
ECU-011892,2122,201,104,97,12,16.75
ECU-011893,2122,196,111,85,15,13.066666666666666
ECU-011894,2122,214,100,114,16,13.375
ECU-011895,2122,9,2,7,1,9.0
ECU-011896,2122,225,113,112,11,20.454545454545453
ECU-011897,2122,25,16,9,2,12.5
ECU-011898,2122,46,23,23,2,23.0
ECU-011899,2122,17,8,9,1,17.0
ECU-011900,2122,176,78,98,13,13.538461538461538
ECU-011901,2122,56,25,31,10,5.6
ECU-011902,2122,104,56,48,8,13.0
ECU-011903,2122,137,55,82,9,15.222222222222221
ECU-011904,2122,27,14,13,1,27.0
ECU-011905,2122,62,34,28,4,15.5
ECU-011906,2122,159,74,85,10,15.9
ECU-011907,2122,141,83,58,4,35.25
ECU-011908,2122,11,2,9,1,11.0
ECU-011909,2122,744,346,398,35,21.257142857142856
ECU-011910,2122,16,7,9,3,5.333333333333333
ECU-011911,2122,73,37,36,6,12.166666666666666
ECU-011912,2122,1023,536,487,42,24.357142857142858
ECU-011913,2122,15,5,10,2,7.5
ECU-011914,2122,52,23,29,5,10.4
ECU-011915,2122,66,25,41,14,4.714285714285714
ECU-011916,2122,11,3,8,2,5.5
ECU-011917,2122,82,53,29,4,20.5
ECU-011918,2122,39,18,21,4,9.75
ECU-011919,2122,388,196,192,26,14.923076923076923
ECU-011920,2122,27,13,14,2,13.5
ECU-011921,2122,26,11,15,3,8.666666666666666
ECU-011922,2122,6,4,2,1,6.0
ECU-011923,2122,36,12,24,2,18.0
ECU-011924,2122,32,19,13,3,10.666666666666666
ECU-011925,2122,125,68,57,11,11.363636363636363
ECU-011926,2122,7,2,5,1,7.0
ECU-011927,2122,26,12,14,2,13.0
ECU-011928,2122,33,15,18,4,8.25
ECU-011929,2122,7,4,3,1,7.0
ECU-011930,2122,9,3,6,1,9.0
ECU-011931,2122,50,26,24,6,8.333333333333334
ECU-011932,2122,11,4,7,2,5.5
ECU-011933,2122,26,6,20,2,13.0
ECU-011934,2122,36,11,25,3,12.0
ECU-011935,2122,238,108,130,21,11.333333333333334
ECU-011936,2122,49,30,19,7,7.0
ECU-011937,2122,80,39,41,8,10.0
ECU-011938,2122,11,5,6,1,11.0
ECU-011939,2122,116,48,68,11,10.545454545454545
ECU-011940,2122,62,29,33,4,15.5
ECU-011941,2122,25,12,13,2,12.5
ECU-011942,2122,313,150,163,22,14.227272727272727
ECU-011943,2122,51,29,22,7,7.285714285714286
ECU-011944,2122,19,12,7,2,9.5
ECU-011945,2122,9,3,6,1,9.0
ECU-011946,2122,23,13,10,2,11.5
ECU-011947,2122,9,4,5,1,9.0
ECU-011948,2122,5,3,2,1,5.0
ECU-011949,2122,77,38,39,5,15.4
ECU-011950,2122,42,23,19,3,14.0
ECU-011951,2122,159,88,71,10,15.9
ECU-011952,2122,32,16,16,3,10.666666666666666
ECU-011953,2122,38,18,20,3,12.666666666666666
ECU-011954,2122,57,26,31,6,9.5
ECU-011955,2122,27,11,16,2,13.5
ECU-011956,2122,31,15,16,3,10.333333333333334
ECU-011957,2122,8,2,6,1,8.0
ECU-011958,2122,5,4,1,1,5.0
ECU-011959,2122,3,2,1,1,3.0
ECU-011960,2122,3,1,2,1,3.0
ECU-011961,2122,68,29,39,6,11.333333333333334
ECU-011962,2122,69,30,39,12,5.75
ECU-011963,2122,132,61,71,12,11.0
ECU-011964,2122,1431,1386,45,67,21.35820895522388
ECU-011965,2122,292,76,216,16,18.25
ECU-011966,2122,1274,685,589,59,21.593220338983052
ECU-011967,2122,1820,66,1754,90,20.22222222222222
ECU-011968,2122,153,63,90,9,17.0
ECU-011969,2122,102,43,59,15,6.8
ECU-011970,2122,287,137,150,32,8.96875
ECU-011971,2122,823,412,411,46,17.891304347826086
ECU-011972,2122,201,96,105,13,15.461538461538462
ECU-011973,2122,899,477,422,40,22.475
ECU-011974,2122,17,8,9,8,2.125
ECU-011975,2122,42,24,18,2,21.0
ECU-011976,2122,10,3,7,3,3.3333333333333335
ECU-011977,2122,648,386,262,26,24.923076923076923
ECU-011978,2122,200,92,108,13,15.384615384615385
ECU-011979,2122,258,103,155,17,15.176470588235293
ECU-011980,2122,127,55,72,13,9.76923076923077
ECU-011981,2122,10,5,5,1,10.0
ECU-011982,2122,5,1,4,1,5.0
ECU-011983,2122,6,3,3,1,6.0
ECU-011984,2122,29,12,17,2,14.5
ECU-011985,2122,11,5,6,2,5.5
ECU-011986,2122,239,109,130,13,18.384615384615383
ECU-011987,2122,244,115,129,15,16.266666666666666
ECU-011988,2122,3691,1686,2005,165,22.36969696969697
ECU-011989,2122,147,68,79,11,13.363636363636363
ECU-011990,2122,191,87,104,12,15.916666666666666
ECU-011991,2122,92,44,48,7,13.142857142857142
ECU-011992,2122,4,1,3,2,2.0
ECU-011993,2122,18,5,13,9,2.0
ECU-011994,2122,11,4,7,1,11.0
ECU-011995,2122,114,38,76,14,8.142857142857142
ECU-011996,2122,130,70,60,6,21.666666666666668
ECU-011997,2122,6,3,3,1,6.0
ECU-011998,2122,849,397,452,83,10.228915662650602
ECU-011999,2122,121,65,56,9,13.444444444444445
ECU-012000,2122,87,40,47,10,8.7
ECU-012001,2122,52,27,25,6,8.666666666666666
ECU-012002,2122,13,5,8,1,13.0
ECU-012003,2122,275,128,147,16,17.1875
ECU-012004,2122,48,25,23,3,16.0
ECU-012005,2122,150,69,81,10,15.0
ECU-012006,2122,10,5,5,1,10.0
ECU-012007,2122,291,135,156,17,17.11764705882353
ECU-012008,2122,179,86,93,13,13.76923076923077
ECU-012009,2122,22,13,9,1,22.0
ECU-012010,2122,21,11,10,1,21.0
ECU-012011,2122,165,81,84,12,13.75
ECU-012012,2122,1,1,0,1,1.0
ECU-012013,2122,155,68,87,10,15.5
ECU-012014,2122,96,36,60,7,13.714285714285714
ECU-012015,2122,80,38,42,5,16.0
ECU-012016,2122,16,4,12,5,3.2
ECU-012017,2122,156,75,81,10,15.6
ECU-012018,2122,218,102,116,13,16.76923076923077
ECU-012019,2122,54,17,37,5,10.8
ECU-012020,2122,454,249,205,21,21.61904761904762
ECU-012021,2122,13,7,6,1,13.0
ECU-012022,2122,89,34,55,16,5.5625
ECU-012023,2122,161,82,79,13,12.384615384615385
ECU-012024,2122,195,95,100,13,15.0
ECU-012025,2122,112,54,58,7,16.0
ECU-012026,2122,8,4,4,1,8.0
ECU-012027,2122,186,105,81,13,14.307692307692308
ECU-012028,2122,941,434,507,44,21.386363636363637
ECU-012029,2122,58,28,30,4,14.5
ECU-012030,2122,15,9,6,1,15.0
ECU-012031,2122,354,188,166,19,18.63157894736842
ECU-012032,2122,153,36,117,12,12.75
ECU-012033,2122,30,16,14,2,15.0
ECU-012034,2122,4,3,1,1,4.0
ECU-012035,2122,9,3,6,1,9.0
ECU-012036,2122,4,3,1,1,4.0
ECU-012037,2122,2,0,2,1,2.0
ECU-012038,2122,129,64,65,10,12.9
ECU-012039,2122,107,48,59,5,21.4
ECU-012040,2122,722,340,382,34,21.235294117647058
ECU-012041,2122,34,18,16,2,17.0
ECU-012042,2122,132,57,75,16,8.25
ECU-012043,2122,79,36,43,8,9.875
ECU-012044,2122,194,93,101,9,21.555555555555557
ECU-012045,2122,184,95,89,11,16.727272727272727
ECU-012046,2122,439,205,234,24,18.291666666666668
ECU-012047,2122,50,25,25,3,16.666666666666668
ECU-012048,2122,32,15,17,3,10.666666666666666
ECU-012049,2122,21,14,7,1,21.0
ECU-012050,2122,9,3,6,1,9.0
ECU-012051,2122,64,43,21,3,21.333333333333332
ECU-012052,2122,130,58,72,8,16.25
ECU-012053,2122,11,4,7,1,11.0
ECU-012054,2122,85,42,43,5,17.0
ECU-012055,2122,9,4,5,1,9.0
ECU-012056,2122,9,4,5,1,9.0
ECU-012057,2122,8,4,4,2,4.0
ECU-012058,2122,4,1,3,1,4.0
ECU-012059,2122,16,7,9,1,16.0
ECU-012060,2122,311,142,169,22,14.136363636363637
ECU-012061,2122,9,7,2,1,9.0
ECU-012062,2122,6,4,2,1,6.0
ECU-012063,2122,124,70,54,13,9.538461538461538
ECU-012064,2122,5,1,4,1,5.0
ECU-012065,2122,2,2,0,1,2.0
ECU-012066,2122,4,1,3,1,4.0
ECU-012067,2122,120,64,56,11,10.909090909090908
ECU-012068,2122,12,7,5,1,12.0
ECU-012069,2122,127,64,63,8,15.875
ECU-012070,2122,12,9,3,1,12.0
ECU-012071,2122,261,133,128,13,20.076923076923077
ECU-012072,2122,31,15,16,1,31.0
ECU-012073,2122,15,7,8,1,15.0
ECU-012074,2122,18,8,10,1,18.0
ECU-012075,2122,5,3,2,1,5.0
ECU-012076,2122,17,5,12,1,17.0
ECU-012077,2122,8,3,5,1,8.0
ECU-012078,2122,75,49,26,8,9.375
ECU-012079,2122,48,23,25,4,12.0
ECU-012080,2122,8,5,3,1,8.0
ECU-012081,2122,15,10,5,1,15.0
ECU-012082,2122,5,2,3,1,5.0
ECU-012083,2122,18,10,8,1,18.0
ECU-012084,2122,3,2,1,1,3.0
ECU-012085,2122,205,89,116,14,14.642857142857142
ECU-012086,2122,13,8,5,1,13.0
ECU-012087,2122,8,7,1,1,8.0
ECU-012088,2122,132,65,67,9,14.666666666666666
ECU-012089,2122,4,0,4,1,4.0
ECU-012090,2122,11,5,6,1,11.0
ECU-012091,2122,52,28,24,2,26.0
ECU-012092,2122,5,3,2,1,5.0
ECU-012093,2122,36,15,21,2,18.0
ECU-012094,2122,270,135,135,19,14.210526315789474
ECU-012095,2122,13,4,9,1,13.0
ECU-012096,2122,14,6,8,1,14.0
ECU-012097,2122,677,321,356,29,23.344827586206897
ECU-012098,2122,211,100,111,10,21.1
ECU-012099,2122,5,1,4,1,5.0
ECU-012100,2122,40,17,23,3,13.333333333333334
ECU-012101,2122,6,1,5,1,6.0
ECU-012102,2122,113,57,56,12,9.416666666666666
ECU-012103,2122,15,8,7,1,15.0
ECU-012104,2122,139,64,75,14,9.928571428571429
ECU-012105,2122,8,4,4,1,8.0
ECU-012106,2122,81,40,41,7,11.571428571428571
ECU-012107,2122,9,5,4,1,9.0
ECU-012108,2122,132,65,67,8,16.5
ECU-012109,2122,6,3,3,1,6.0
ECU-012110,2122,29,14,15,2,14.5
ECU-012111,2122,30,17,13,2,15.0
ECU-012112,2122,35,19,16,2,17.5
ECU-012113,2122,6,4,2,1,6.0
ECU-012114,2122,14,8,6,1,14.0
ECU-012115,2122,12,4,8,1,12.0
ECU-012116,2122,19,11,8,1,19.0
ECU-012117,2122,227,110,117,14,16.214285714285715
ECU-012118,2122,3,1,2,1,3.0
ECU-012119,2122,7,4,3,1,7.0
ECU-012120,2122,124,80,44,4,31.0
ECU-012121,2122,346,168,178,22,15.727272727272727
ECU-012122,2122,5,3,2,1,5.0
ECU-012123,2122,510,271,239,28,18.214285714285715
ECU-012124,2122,226,116,110,14,16.142857142857142
ECU-012125,2122,13,5,8,1,13.0
ECU-012126,2122,9,4,5,1,9.0
ECU-012127,2122,7,4,3,1,7.0
ECU-012128,2122,3,2,1,1,3.0
ECU-012129,2122,6,2,4,1,6.0
ECU-012130,2122,2,0,2,1,2.0
ECU-012131,2122,18,9,9,1,18.0
ECU-012132,2122,8,6,2,1,8.0
ECU-012133,2122,15,8,7,1,15.0
ECU-012134,2122,12,6,6,1,12.0
ECU-012135,2122,6,3,3,1,6.0
ECU-012136,2122,682,470,212,42,16.238095238095237
ECU-012137,2122,23,12,11,2,11.5
ECU-012138,2122,16,7,9,6,2.6666666666666665
ECU-012139,2122,29,16,13,2,14.5
ECU-012140,2122,7,5,2,1,7.0
ECU-012141,2122,6,2,4,1,6.0
ECU-012142,2122,35,23,12,2,17.5
ECU-012143,2122,13,6,7,2,6.5
ECU-012144,2122,11,2,9,2,5.5
ECU-012145,2122,1,1,0,1,1.0
ECU-012146,2122,261,144,117,15,17.4
ECU-012147,2122,1327,597,730,102,13.009803921568627
ECU-012148,2122,11,8,3,1,11.0
ECU-012149,2122,6,3,3,1,6.0
ECU-012150,2122,11,6,5,1,11.0
ECU-012151,2122,32,12,20,3,10.666666666666666
ECU-012152,2122,7,3,4,1,7.0
ECU-012153,2122,9,4,5,1,9.0
ECU-012154,2122,97,41,56,9,10.777777777777779
ECU-012155,2122,9,3,6,1,9.0
ECU-012156,2122,5,2,3,1,5.0
ECU-012157,2122,26,13,13,2,13.0
ECU-012158,2122,9,6,3,1,9.0
ECU-012159,2122,9,2,7,1,9.0
ECU-012160,2122,3,0,3,1,3.0
ECU-012161,2122,25,11,14,2,12.5
ECU-012162,2122,16,9,7,1,16.0
ECU-012163,2122,537,267,270,31,17.322580645161292
ECU-012164,2122,5,5,0,1,5.0
ECU-012165,2122,9,5,4,2,4.5
ECU-012166,2122,20,14,6,2,10.0
ECU-012167,2122,24,12,12,2,12.0
ECU-012168,2122,4,0,4,1,4.0
ECU-012169,2122,157,75,82,10,15.7
ECU-012170,2122,7,4,3,1,7.0
ECU-012171,2122,33,21,12,3,11.0
ECU-012172,2122,739,368,371,56,13.196428571428571
ECU-012173,2122,13,4,9,1,13.0
ECU-012174,2122,4,2,2,1,4.0
ECU-012175,2122,6,1,5,1,6.0
ECU-012176,2122,10,6,4,1,10.0
ECU-012177,2122,11,9,2,1,11.0
ECU-012178,2122,4,2,2,1,4.0
ECU-012179,2122,9,4,5,1,9.0
ECU-012180,2122,6,6,0,1,6.0
ECU-012181,2122,5,2,3,1,5.0
ECU-012182,2122,8,5,3,1,8.0
ECU-012183,2122,6,3,3,1,6.0
ECU-012184,2122,29,8,21,1,29.0
ECU-012185,2122,16,8,8,1,16.0
ECU-012186,2122,1,1,0,1,1.0
ECU-012187,2122,7,6,1,1,7.0
ECU-012188,2122,7,6,1,1,7.0
ECU-012189,2122,23,10,13,2,11.5
ECU-012190,2122,16,12,4,2,8.0
ECU-012191,2122,4,2,2,1,4.0
ECU-012192,2122,7,4,3,1,7.0
ECU-012193,2122,16,9,7,1,16.0
ECU-012194,2122,95,47,48,10,9.5
ECU-012195,2122,28,12,16,1,28.0
ECU-012196,2122,5,3,2,1,5.0
ECU-012197,2122,5,0,5,1,5.0
ECU-012198,2122,8,2,6,1,8.0
ECU-012199,2122,170,83,87,10,17.0
ECU-012200,2122,6,2,4,1,6.0
ECU-012201,2122,89,48,41,9,9.88888888888889
ECU-012202,2122,5,2,3,1,5.0
ECU-012203,2122,17,8,9,1,17.0
ECU-012204,2122,17,10,7,2,8.5
ECU-012205,2122,7,4,3,1,7.0
ECU-012206,2122,6,2,4,1,6.0
ECU-012207,2122,21,10,11,1,21.0
ECU-012208,2122,33,17,16,2,16.5
ECU-012209,2122,9,2,7,1,9.0
ECU-012210,2122,9,3,6,1,9.0
ECU-012211,2122,5,2,3,1,5.0
ECU-012212,2122,3,1,2,1,3.0
ECU-012213,2122,6,3,3,1,6.0
ECU-012214,2122,8,4,4,1,8.0
ECU-012215,2122,18,8,10,1,18.0
ECU-012216,2122,16,6,10,1,16.0
ECU-012217,2122,8,4,4,1,8.0
ECU-012218,2122,146,78,68,17,8.588235294117647
ECU-012219,2122,10,4,6,1,10.0
ECU-012220,2122,14,7,7,1,14.0
ECU-012221,2122,2,2,0,1,2.0
ECU-012222,2122,25,13,12,2,12.5
ECU-012223,2122,9,1,8,1,9.0
ECU-012224,2122,13,9,4,1,13.0
ECU-012225,2122,30,11,19,5,6.0
ECU-012226,2122,31,14,17,5,6.2
ECU-012227,2122,609,308,301,29,21.0
ECU-012228,2122,139,70,69,8,17.375
ECU-012229,2122,130,67,63,6,21.666666666666668
ECU-012230,2122,122,57,65,8,15.25
ECU-012231,2122,20,9,11,1,20.0
ECU-012232,2122,225,110,115,12,18.75
ECU-012233,2122,120,60,60,8,15.0
ECU-012234,2122,15,5,10,1,15.0
ECU-012235,2122,18,11,7,1,18.0
ECU-012236,2122,62,30,32,3,20.666666666666668
ECU-012237,2122,133,70,63,10,13.3
ECU-012238,2122,3,2,1,1,3.0
ECU-012239,2122,10,6,4,1,10.0
ECU-012240,2122,11,2,9,1,11.0
ECU-012241,2122,10,7,3,1,10.0
ECU-012242,2122,5,2,3,1,5.0
ECU-012243,2122,150,80,70,12,12.5
ECU-012244,2122,64,32,32,6,10.666666666666666
ECU-012245,2122,7,5,2,1,7.0
ECU-012246,2122,10,5,5,1,10.0
ECU-012247,2122,12,3,9,1,12.0
ECU-012248,2122,7,3,4,1,7.0
ECU-012249,2122,6,4,2,1,6.0
ECU-012250,2122,31,14,17,2,15.5
ECU-012251,2122,14,4,10,1,14.0
ECU-012252,2122,13,8,5,1,13.0
ECU-012253,2122,8,4,4,1,8.0
ECU-012254,2122,17,8,9,1,17.0
ECU-012255,2122,8,3,5,1,8.0
ECU-012256,2122,6,2,4,1,6.0
ECU-012257,2122,32,15,17,2,16.0
ECU-012258,2122,17,10,7,1,17.0
ECU-012259,2122,32,18,14,2,16.0
ECU-012260,2122,53,29,24,2,26.5
ECU-012261,2122,13,8,5,1,13.0
ECU-012262,2122,196,102,94,10,19.6
ECU-012263,2122,14,6,8,1,14.0
ECU-012264,2122,256,124,132,16,16.0
ECU-012265,2122,21,8,13,1,21.0
ECU-012266,2122,2,1,1,1,2.0
ECU-012267,2122,6,3,3,1,6.0
ECU-012268,2122,13,5,8,2,6.5
ECU-012269,2122,6,2,4,1,6.0
ECU-012270,2122,160,79,81,9,17.77777777777778
ECU-012271,2122,6,6,0,1,6.0
ECU-012272,2122,8,3,5,1,8.0
ECU-012273,2122,15,5,10,1,15.0
ECU-012274,2122,24,8,16,1,24.0
ECU-012275,2122,8,3,5,1,8.0
ECU-012276,2122,21,9,12,1,21.0
ECU-012277,2122,1,0,1,1,1.0
ECU-012278,2122,12,6,6,1,12.0
ECU-012279,2122,14,2,12,1,14.0
ECU-012280,2122,21,12,9,1,21.0
ECU-012281,2122,230,102,128,12,19.166666666666668
ECU-012282,2122,33,16,17,2,16.5
ECU-012283,2122,2,2,0,1,2.0
ECU-012284,2122,53,32,21,2,26.5
ECU-012285,2122,3,0,3,1,3.0
ECU-012286,2122,7,3,4,1,7.0
ECU-012287,2122,121,53,68,8,15.125
ECU-012288,2122,10,6,4,1,10.0
ECU-012289,2122,57,23,34,3,19.0
ECU-012290,2122,33,18,15,2,16.5
ECU-012291,2122,4,2,2,1,4.0
ECU-012292,2122,4,2,2,1,4.0
ECU-012293,2122,5,3,2,1,5.0
ECU-012294,2122,6,3,3,1,6.0
ECU-012295,2122,4,2,2,1,4.0
ECU-012296,2122,423,206,217,22,19.227272727272727
ECU-012297,2122,6,3,3,1,6.0
ECU-012298,2122,11,6,5,1,11.0
ECU-012299,2122,237,107,130,14,16.928571428571427
ECU-012300,2122,6,5,1,1,6.0
ECU-012301,2122,8,4,4,1,8.0
ECU-012302,2122,10,3,7,1,10.0
ECU-012303,2122,96,41,55,7,13.714285714285714
ECU-012304,2122,9,4,5,1,9.0
ECU-012305,2122,137,60,77,9,15.222222222222221
ECU-012306,2122,11,5,6,1,11.0
ECU-012307,2122,8,5,3,1,8.0
ECU-012308,2122,5,2,3,1,5.0
ECU-012309,2122,14,8,6,1,14.0
ECU-012310,2122,8,3,5,1,8.0
ECU-012311,2122,10,7,3,1,10.0
ECU-012312,2122,36,15,21,2,18.0
ECU-012313,2122,69,34,35,4,17.25
ECU-012314,2122,19,9,10,1,19.0
ECU-012315,2122,9,2,7,1,9.0
ECU-012316,2122,12,4,8,1,12.0
ECU-012317,2122,13,7,6,1,13.0
ECU-012318,2122,5,3,2,1,5.0
ECU-012319,2122,32,14,18,3,10.666666666666666
ECU-012320,2122,12,5,7,1,12.0
ECU-012321,2122,11,4,7,1,11.0
ECU-012322,2122,7,3,4,1,7.0
ECU-012323,2122,332,167,165,28,11.857142857142858
ECU-012324,2122,11,4,7,1,11.0
ECU-012325,2122,4,1,3,1,4.0
ECU-012326,2122,9,2,7,1,9.0
ECU-012327,2122,8,1,7,1,8.0
ECU-012328,2122,5,4,1,1,5.0
ECU-012329,2122,141,65,76,12,11.75
ECU-012330,2122,198,94,104,15,13.2
ECU-012331,2122,24,9,15,2,12.0
ECU-012332,2122,39,17,22,2,19.5
ECU-012333,2122,48,16,32,3,16.0
ECU-012334,2122,12,7,5,1,12.0
ECU-012335,2122,17,7,10,1,17.0
ECU-012336,2122,9,2,7,1,9.0
ECU-012337,2122,8,3,5,1,8.0
ECU-012338,2122,12,4,8,1,12.0
ECU-012339,2122,2,1,1,1,2.0
ECU-012340,2122,40,18,22,2,20.0
ECU-012341,2122,31,16,15,2,15.5
ECU-012342,2122,2,0,2,1,2.0
ECU-012343,2122,92,49,43,11,8.363636363636363
ECU-012344,2122,7,2,5,1,7.0
ECU-012345,2122,175,89,86,17,10.294117647058824
ECU-012346,2122,22,10,12,1,22.0
ECU-012347,2122,7,2,5,1,7.0
ECU-012348,2122,22,11,11,1,22.0
ECU-012349,2122,8,3,5,1,8.0
ECU-012350,2122,29,15,14,2,14.5
ECU-012351,2122,153,64,89,15,10.2
ECU-012352,2122,126,68,58,8,15.75
ECU-012353,2122,9,5,4,1,9.0
ECU-012354,2122,28,12,16,2,14.0
ECU-012355,2122,18,10,8,1,18.0
ECU-012356,2122,13,5,8,1,13.0
ECU-012357,2122,5,2,3,1,5.0
ECU-012358,2122,86,44,42,8,10.75
ECU-012359,2122,9,5,4,1,9.0
ECU-012360,2122,36,17,19,2,18.0
ECU-012361,2122,7,2,5,1,7.0
ECU-012362,2122,89,36,53,12,7.416666666666667
ECU-012363,2122,4,2,2,1,4.0
ECU-012364,2122,165,89,76,13,12.692307692307692
ECU-012365,2122,6,4,2,1,6.0
ECU-012366,2122,9,5,4,1,9.0
ECU-012367,2122,44,16,28,3,14.666666666666666
ECU-012368,2122,41,19,22,3,13.666666666666666
ECU-012369,2122,143,61,82,6,23.833333333333332
ECU-012370,2122,28,16,12,2,14.0
ECU-012371,2122,18,10,8,1,18.0
ECU-012372,2122,580,263,317,37,15.675675675675675
ECU-012373,2122,11,5,6,1,11.0
ECU-012374,2122,7,5,2,1,7.0
ECU-012375,2122,4,3,1,1,4.0
ECU-012376,2122,10,4,6,1,10.0
ECU-012377,2122,7,3,4,1,7.0
ECU-012378,2122,14,7,7,2,7.0
ECU-012379,2122,4,1,3,1,4.0
ECU-012380,2122,7,3,4,1,7.0
ECU-012381,2122,305,162,143,25,12.2
ECU-012382,2122,5,4,1,1,5.0
ECU-012383,2122,8,6,2,1,8.0
ECU-012384,2122,167,76,91,18,9.277777777777779
ECU-012385,2122,21,9,12,1,21.0
ECU-012386,2122,3,1,2,1,3.0
ECU-012387,2122,10,4,6,1,10.0
ECU-012388,2122,4,2,2,1,4.0
ECU-012389,2122,407,190,217,25,16.28
ECU-012390,2122,3,0,3,1,3.0
ECU-012391,2122,3,1,2,1,3.0
ECU-012392,2122,1,0,1,1,1.0
ECU-012393,2122,11,8,3,1,11.0
ECU-012394,2122,30,17,13,3,10.0
ECU-012395,2122,8,5,3,1,8.0
ECU-012396,2122,17,7,10,1,17.0
ECU-012397,2122,13,7,6,1,13.0
ECU-012398,2122,6,4,2,1,6.0
ECU-012399,2122,2,1,1,1,2.0
ECU-012400,2122,10,4,6,1,10.0
ECU-012401,2122,12,5,7,1,12.0
ECU-012402,2122,13,5,8,1,13.0
ECU-012403,2122,22,8,14,1,22.0
ECU-012404,2122,5,2,3,1,5.0
ECU-012405,2122,25,13,12,2,12.5
ECU-012406,2122,13,7,6,1,13.0
ECU-012407,2122,13,5,8,1,13.0
ECU-012408,2122,8,4,4,1,8.0
ECU-012409,2122,120,70,50,11,10.909090909090908
ECU-012410,2122,6,3,3,1,6.0
ECU-012411,2122,7,1,6,1,7.0
ECU-012412,2122,6,6,0,1,6.0
ECU-012413,2122,1,1,0,1,1.0
ECU-012414,2122,6,2,4,1,6.0
ECU-012415,2122,23,14,9,1,23.0
ECU-012416,2122,63,29,34,8,7.875
ECU-012417,2122,3,2,1,1,3.0
ECU-012418,2122,6,2,4,1,6.0
ECU-012419,2122,6,3,3,1,6.0
ECU-012420,2122,8,4,4,1,8.0
ECU-012421,2122,11,4,7,1,11.0
ECU-012422,2122,9,5,4,1,9.0
ECU-012423,2122,10,6,4,1,10.0
ECU-012424,2122,146,73,73,14,10.428571428571429
ECU-012425,2122,15,9,6,1,15.0
ECU-012426,2122,2,2,0,1,2.0
ECU-012427,2122,8,4,4,1,8.0
ECU-012428,2122,9,6,3,1,9.0
ECU-012429,2122,296,125,171,17,17.41176470588235
ECU-012430,2122,10,6,4,1,10.0
ECU-012431,2122,11,8,3,1,11.0
ECU-012432,2122,410,202,208,24,17.083333333333332
ECU-012433,2122,10,5,5,1,10.0
ECU-012434,2122,7,3,4,1,7.0
ECU-012435,2122,10,3,7,1,10.0
ECU-012436,2122,15,5,10,1,15.0
ECU-012437,2122,14,6,8,1,14.0
ECU-012438,2122,37,19,18,2,18.5
ECU-012439,2122,985,547,438,43,22.906976744186046
ECU-012440,2122,216,100,116,11,19.636363636363637
ECU-012441,2122,13,6,7,1,13.0
ECU-012442,2122,4,2,2,1,4.0
ECU-012443,2122,4,3,1,1,4.0
ECU-012444,2122,22,14,8,1,22.0
ECU-012445,2122,170,73,97,10,17.0
ECU-012446,2122,7,2,5,1,7.0
ECU-012447,2122,1135,567,568,51,22.254901960784313
ECU-012448,2122,183,89,94,12,15.25
ECU-012449,2122,5,3,2,1,5.0
ECU-012450,2122,3,1,2,1,3.0
ECU-012451,2122,22,10,12,2,11.0
ECU-012452,2122,16,7,9,1,16.0
ECU-012453,2122,4,3,1,1,4.0
ECU-012454,2122,17,9,8,1,17.0
ECU-012455,2122,9,2,7,1,9.0
ECU-012456,2122,140,69,71,10,14.0
ECU-012457,2122,40,18,22,3,13.333333333333334
ECU-012458,2122,3,1,2,1,3.0
ECU-012459,2122,13,8,5,1,13.0
ECU-012460,2122,4,1,3,1,4.0
ECU-012461,2122,13,8,5,1,13.0
ECU-012462,2122,7,2,5,1,7.0
ECU-012463,2122,11,5,6,1,11.0
ECU-012464,2122,11,6,5,1,11.0
ECU-012465,2122,6,1,5,1,6.0
ECU-012466,2122,23,17,6,2,11.5
ECU-012467,2122,11,6,5,1,11.0
ECU-012468,2122,14,3,11,1,14.0
ECU-012469,2122,29,12,17,2,14.5
ECU-012470,2122,98,49,49,8,12.25
ECU-012471,2122,8,4,4,1,8.0
ECU-012472,2122,10,3,7,1,10.0
ECU-012473,2122,37,12,25,7,5.285714285714286
ECU-012474,2122,21,8,13,1,21.0
ECU-012475,2122,4,2,2,1,4.0
ECU-012476,2122,18,7,11,1,18.0
ECU-012477,2122,2,0,2,1,2.0
ECU-012478,2122,3,2,1,1,3.0
ECU-012479,2122,9,3,6,1,9.0
ECU-012480,2122,82,46,36,4,20.5
ECU-012481,2122,11,7,4,1,11.0
ECU-012482,2122,107,64,43,11,9.727272727272727
ECU-012483,2122,6,4,2,1,6.0
ECU-012484,2122,6,3,3,1,6.0
ECU-012485,2122,912,424,488,43,21.209302325581394
ECU-012486,2122,10,6,4,1,10.0
ECU-012487,2122,38,18,20,4,9.5
ECU-012488,2122,42,22,20,6,7.0
ECU-012489,2122,16,10,6,1,16.0
ECU-012490,2122,445,211,234,25,17.8
ECU-012491,2122,12,7,5,1,12.0
ECU-012492,2122,12,6,6,1,12.0
ECU-012493,2122,102,48,54,9,11.333333333333334
ECU-012494,2122,17,6,11,5,3.4
ECU-012495,2122,14,6,8,1,14.0
ECU-012496,2122,62,34,28,9,6.888888888888889
ECU-012497,2122,5,4,1,1,5.0
ECU-012498,2122,17,12,5,1,17.0
ECU-012499,2122,5,3,2,1,5.0
ECU-012500,2122,38,16,22,2,19.0
ECU-012501,2122,4,3,1,1,4.0
ECU-012502,2122,8,2,6,1,8.0
ECU-012503,2122,8,6,2,1,8.0
ECU-012504,2122,10,6,4,1,10.0
ECU-012505,2122,7,4,3,1,7.0
ECU-012506,2122,8,7,1,1,8.0
ECU-012507,2122,7,2,5,1,7.0
ECU-012508,2122,17,8,9,1,17.0
ECU-012509,2122,8,2,6,1,8.0
ECU-012510,2122,2,1,1,1,2.0
ECU-012511,2122,30,16,14,2,15.0
ECU-012512,2122,11,4,7,1,11.0
ECU-012513,2122,66,29,37,11,6.0
ECU-012514,2122,10,6,4,1,10.0
ECU-012515,2122,33,15,18,3,11.0
ECU-012516,2122,171,80,91,16,10.6875
ECU-012517,2122,195,103,92,14,13.928571428571429
ECU-012518,2122,126,63,63,12,10.5
ECU-012519,2122,21,11,10,2,10.5
ECU-012520,2122,6,1,5,1,6.0
ECU-012521,2122,22,12,10,1,22.0
ECU-012522,2122,21,9,12,1,21.0
ECU-012523,2122,3,2,1,1,3.0
ECU-012524,2122,6,2,4,1,6.0
ECU-012525,2122,6,4,2,1,6.0
ECU-012526,2122,7,4,3,1,7.0
ECU-012527,2122,10,3,7,1,10.0
ECU-012528,2122,4,1,3,1,4.0
ECU-012529,2122,295,148,147,24,12.291666666666666
ECU-012530,2122,31,15,16,2,15.5
ECU-012531,2122,5,1,4,1,5.0
ECU-012532,2122,1,0,1,1,1.0
ECU-012533,2122,4,1,3,1,4.0
ECU-012534,2122,8,4,4,1,8.0
ECU-012535,2122,106,50,56,11,9.636363636363637
ECU-012536,2122,6,5,1,1,6.0
ECU-012537,2122,4,1,3,1,4.0
ECU-012538,2122,11,3,8,1,11.0
ECU-012539,2122,8,4,4,1,8.0
ECU-012540,2122,12,8,4,1,12.0
ECU-012541,2122,132,55,77,14,9.428571428571429
ECU-012542,2122,20,11,9,1,20.0
ECU-012543,2122,94,37,57,14,6.714285714285714
ECU-012544,2122,22,10,12,1,22.0
ECU-012545,2122,17,8,9,1,17.0
ECU-012546,2122,18,5,13,1,18.0
ECU-012547,2122,7,2,5,1,7.0
ECU-012548,2122,106,53,53,8,13.25
ECU-012549,2122,11,6,5,1,11.0
ECU-012550,2122,7,3,4,1,7.0
ECU-012551,2122,12,7,5,1,12.0
ECU-012552,2122,3,1,2,1,3.0
ECU-012553,2122,5,3,2,1,5.0
ECU-012554,2122,8,2,6,1,8.0
ECU-012555,2122,589,325,264,28,21.035714285714285
ECU-012556,2122,2,2,0,1,2.0
ECU-012557,2122,8,3,5,1,8.0
ECU-012558,2122,11,3,8,1,11.0
ECU-012559,2122,5,2,3,1,5.0
ECU-012560,2122,7,4,3,1,7.0
ECU-012561,2122,10,8,2,1,10.0
ECU-012562,2122,3,3,0,1,3.0
ECU-012563,2122,8,5,3,1,8.0
ECU-012564,2122,134,68,66,10,13.4
ECU-012565,2122,2,0,2,1,2.0
ECU-012566,2122,7,3,4,1,7.0
ECU-012567,2122,19,11,8,1,19.0
ECU-012568,2122,3,0,3,1,3.0
ECU-012569,2122,5,3,2,1,5.0
ECU-012570,2122,7,4,3,1,7.0
ECU-012571,2122,19,9,10,1,19.0
ECU-012572,2122,749,374,375,34,22.029411764705884
ECU-012573,2122,6,1,5,1,6.0
ECU-012574,2122,3,2,1,1,3.0
ECU-012575,2122,12,5,7,1,12.0
ECU-012576,2122,4,3,1,1,4.0
ECU-012577,2122,4,1,3,1,4.0
ECU-012578,2122,10,4,6,1,10.0
ECU-012579,2122,6,5,1,1,6.0
ECU-012580,2122,327,172,155,16,20.4375
ECU-012581,2122,14,8,6,1,14.0
ECU-012582,2122,10,6,4,1,10.0
ECU-012583,2122,121,59,62,9,13.444444444444445
ECU-012584,2122,32,12,20,2,16.0
ECU-012585,2122,22,8,14,1,22.0
ECU-012586,2122,35,21,14,3,11.666666666666666
ECU-012587,2122,11,5,6,1,11.0
ECU-012588,2122,7,4,3,1,7.0
ECU-012589,2122,7,4,3,1,7.0
ECU-012590,2122,196,87,109,12,16.333333333333332
ECU-012591,2122,11,3,8,1,11.0
ECU-012592,2122,10,5,5,1,10.0
ECU-012593,2122,25,14,11,1,25.0
ECU-012594,2122,8,5,3,1,8.0
ECU-012595,2122,14,9,5,1,14.0
ECU-012596,2122,5,4,1,1,5.0
ECU-012597,2122,22,10,12,1,22.0
ECU-012598,2122,25,17,8,2,12.5
ECU-012599,2122,12,8,4,1,12.0
ECU-012600,2122,8,2,6,1,8.0
ECU-012601,2122,42,24,18,2,21.0
ECU-012602,2122,15,5,10,1,15.0
ECU-012603,2122,9,4,5,1,9.0
ECU-012604,2122,8,4,4,1,8.0
ECU-012605,2122,15,8,7,1,15.0
ECU-012606,2122,10,3,7,1,10.0
ECU-012607,2122,9,4,5,1,9.0
ECU-012608,2122,11,8,3,1,11.0
ECU-012609,2122,13,6,7,1,13.0
ECU-012610,2122,24,15,9,2,12.0
ECU-012611,2122,16,9,7,1,16.0
ECU-012612,2122,259,125,134,16,16.1875
ECU-012613,2122,117,52,65,8,14.625
ECU-012614,2122,22,10,12,1,22.0
ECU-012615,2122,25,9,16,1,25.0
ECU-012616,2122,176,86,90,10,17.6
ECU-012617,2122,10,5,5,1,10.0
ECU-012618,2122,17,7,10,1,17.0
ECU-012619,2122,6,3,3,1,6.0
ECU-012620,2122,147,71,76,10,14.7
ECU-012621,2122,7,3,4,1,7.0
ECU-012622,2122,14,7,7,1,14.0
ECU-012623,2122,7,3,4,1,7.0
ECU-012624,2122,6,4,2,1,6.0
ECU-012625,2122,1,1,0,1,1.0
ECU-012626,2122,5,3,2,1,5.0
ECU-012627,2122,8,4,4,1,8.0
ECU-012628,2122,10,6,4,1,10.0
ECU-012629,2122,20,9,11,1,20.0
ECU-012630,2122,61,34,27,4,15.25
ECU-012631,2122,33,23,10,3,11.0
ECU-012632,2122,334,183,151,16,20.875
ECU-012633,2122,27,17,10,5,5.4
ECU-012634,2122,26,10,16,2,13.0
ECU-012635,2122,295,153,142,19,15.526315789473685
ECU-012636,2122,13,7,6,1,13.0
ECU-012637,2122,29,16,13,2,14.5
ECU-012638,2122,21,7,14,2,10.5
ECU-012639,2122,5,2,3,1,5.0
ECU-012640,2122,19,11,8,1,19.0
ECU-012641,2122,14,6,8,1,14.0
ECU-012642,2122,49,28,21,3,16.333333333333332
ECU-012643,2122,23,10,13,2,11.5
ECU-012644,2122,83,37,46,7,11.857142857142858
ECU-012645,2122,49,28,21,3,16.333333333333332
ECU-012646,2122,225,115,110,19,11.842105263157896
ECU-012647,2122,8,6,2,1,8.0
ECU-012648,2122,8,3,5,1,8.0
ECU-012649,2122,8,1,7,1,8.0
ECU-012650,2122,14,5,9,1,14.0
ECU-012651,2122,15,11,4,1,15.0
ECU-012652,2122,6,3,3,1,6.0
ECU-012653,2122,13,11,2,1,13.0
ECU-012654,2122,7,2,5,1,7.0
ECU-012655,2122,94,45,49,7,13.428571428571429
ECU-012656,2122,15,7,8,1,15.0
ECU-012657,2122,7,3,4,1,7.0
ECU-012658,2122,22,8,14,2,11.0
ECU-012659,2122,9,5,4,1,9.0
ECU-012660,2122,14,6,8,1,14.0
ECU-012661,2122,20,7,13,1,20.0
ECU-012662,2122,77,42,35,11,7.0
ECU-012663,2122,45,18,27,5,9.0
ECU-012664,2122,134,67,67,12,11.166666666666666
ECU-012665,2122,20,12,8,2,10.0
ECU-012666,2122,15,6,9,1,15.0
ECU-012667,2122,4,1,3,1,4.0
ECU-012668,2122,17,7,10,2,8.5
ECU-012669,2122,30,13,17,2,15.0
ECU-012670,2122,64,35,29,6,10.666666666666666
ECU-012671,2122,6,1,5,1,6.0
ECU-012672,2122,62,30,32,4,15.5
ECU-012673,2122,9,7,2,1,9.0
ECU-012674,2122,222,117,105,12,18.5
ECU-012675,2122,170,84,86,9,18.88888888888889
ECU-012676,2122,25,16,9,2,12.5
ECU-012677,2122,5,3,2,1,5.0
ECU-012678,2122,31,18,13,2,15.5
ECU-012679,2122,6,2,4,1,6.0
ECU-012680,2122,995,452,543,55,18.09090909090909
ECU-012681,2122,51,24,27,3,17.0
ECU-012682,2122,28,23,5,2,14.0
ECU-012683,2122,26,18,8,2,13.0
ECU-012684,2122,59,31,28,3,19.666666666666668
ECU-012685,2122,10,3,7,1,10.0
ECU-012686,2122,192,95,97,16,12.0
ECU-012687,2122,5,2,3,1,5.0
ECU-012688,2122,8,5,3,1,8.0
ECU-012689,2122,6,1,5,1,6.0
ECU-012690,2122,8,5,3,1,8.0
ECU-012691,2122,48,18,30,4,12.0
ECU-012692,2122,18,9,9,1,18.0
ECU-012693,2122,7,3,4,1,7.0
ECU-012694,2122,11,7,4,1,11.0
ECU-012695,2122,92,47,45,5,18.4
ECU-012696,2122,6,1,5,1,6.0
ECU-012697,2122,11,5,6,1,11.0
ECU-012698,2122,7,4,3,1,7.0
ECU-012699,2122,213,103,110,14,15.214285714285714
ECU-012700,2122,10,6,4,1,10.0
ECU-012701,2122,6,3,3,1,6.0
ECU-012702,2122,18,9,9,1,18.0
ECU-012703,2122,12,5,7,1,12.0
ECU-012704,2122,18,10,8,1,18.0
ECU-012705,2122,13,7,6,1,13.0
ECU-012706,2122,94,43,51,8,11.75
ECU-012707,2122,2,2,0,1,2.0
ECU-012708,2122,5,3,2,1,5.0
ECU-012709,2122,5,4,1,1,5.0
ECU-012710,2122,11,8,3,1,11.0
ECU-012711,2122,33,12,21,3,11.0
ECU-012712,2122,14,6,8,1,14.0
ECU-012713,2122,6,3,3,1,6.0
ECU-012714,2122,24,14,10,2,12.0
ECU-012715,2122,6,3,3,1,6.0
ECU-012716,2122,51,23,28,5,10.2
ECU-012717,2122,9,3,6,1,9.0
ECU-012718,2122,9,3,6,1,9.0
ECU-012719,2122,13,5,8,1,13.0
ECU-012720,2122,15,8,7,1,15.0
ECU-012721,2122,15,6,9,1,15.0
ECU-012722,2122,8,2,6,1,8.0
ECU-012723,2122,3,2,1,1,3.0
ECU-012724,2122,11,7,4,1,11.0
ECU-012725,2122,10,5,5,1,10.0
ECU-012726,2122,53,25,28,8,6.625
ECU-012727,2122,3,1,2,1,3.0
ECU-012728,2122,11,6,5,1,11.0
ECU-012729,2122,193,96,97,13,14.846153846153847
ECU-012730,2122,9,5,4,1,9.0
ECU-012731,2122,15,7,8,1,15.0
ECU-012732,2122,6,2,4,1,6.0
ECU-012733,2122,25,16,9,2,12.5
ECU-012734,2122,6,3,3,1,6.0
ECU-012735,2122,12,5,7,1,12.0
ECU-012736,2122,27,11,16,2,13.5
ECU-012737,2122,21,8,13,2,10.5
ECU-012738,2122,5,3,2,1,5.0
ECU-012739,2122,6,5,1,1,6.0
ECU-012740,2122,30,11,19,2,15.0
ECU-012741,2122,5,4,1,1,5.0
ECU-012742,2122,376,191,185,17,22.11764705882353
ECU-012743,2122,111,51,60,9,12.333333333333334
ECU-012744,2122,14,7,7,1,14.0
ECU-012745,2122,10,4,6,1,10.0
ECU-012746,2122,365,200,165,17,21.470588235294116
ECU-012747,2122,20,10,10,1,20.0
ECU-012748,2122,236,116,120,17,13.882352941176471
ECU-012749,2122,3,3,0,1,3.0
ECU-012750,2122,61,26,35,7,8.714285714285714
ECU-012751,2122,103,49,54,10,10.3
ECU-012752,2122,21,11,10,1,21.0
ECU-012753,2122,13,6,7,1,13.0
ECU-012754,2122,8,6,2,1,8.0
ECU-012755,2122,8,4,4,1,8.0
ECU-012756,2122,49,17,32,3,16.333333333333332
ECU-012757,2122,8,4,4,1,8.0
ECU-012758,2122,12,5,7,1,12.0
ECU-012759,2122,10,6,4,1,10.0
ECU-012760,2122,10,5,5,1,10.0
ECU-012761,2122,17,10,7,1,17.0
ECU-012762,2122,12,3,9,1,12.0
ECU-012763,2122,52,27,25,5,10.4
ECU-012764,2122,14,10,4,1,14.0
ECU-012765,2122,8,1,7,1,8.0
ECU-012766,2122,16,11,5,1,16.0
ECU-012767,2122,2,1,1,1,2.0
ECU-012768,2122,21,10,11,2,10.5
ECU-012769,2122,15,7,8,1,15.0
ECU-012770,2122,11,7,4,1,11.0
ECU-012771,2122,10,5,5,1,10.0
ECU-012772,2122,167,80,87,12,13.916666666666666
ECU-012773,2122,2,1,1,1,2.0
ECU-012774,2122,4,2,2,1,4.0
ECU-012775,2122,55,25,30,5,11.0
ECU-012776,2122,10,5,5,1,10.0
ECU-012777,2122,15,6,9,1,15.0
ECU-012778,2122,4,1,3,1,4.0
ECU-012779,2122,8,7,1,1,8.0
ECU-012780,2122,4,3,1,1,4.0
ECU-012781,2122,3,2,1,1,3.0
ECU-012782,2122,6,4,2,1,6.0
ECU-012783,2122,11,6,5,1,11.0
ECU-012784,2122,22,9,13,1,22.0
ECU-012785,2122,15,9,6,1,15.0
ECU-012786,2122,11,7,4,1,11.0
ECU-012787,2122,221,105,116,10,22.1
ECU-012788,2122,34,18,16,2,17.0
ECU-012789,2122,18,9,9,1,18.0
ECU-012790,2122,8,3,5,1,8.0
ECU-012791,2122,147,80,67,10,14.7
ECU-012792,2122,104,51,53,8,13.0
ECU-012793,2122,21,9,12,1,21.0
ECU-012794,2122,46,24,22,3,15.333333333333334
ECU-012795,2122,4,2,2,1,4.0
ECU-012796,2122,134,63,71,6,22.333333333333332
ECU-012797,2122,16,6,10,1,16.0
ECU-012798,2122,23,9,14,1,23.0
ECU-012799,2122,15,8,7,1,15.0
ECU-012800,2122,55,28,27,5,11.0
ECU-012801,2122,16,4,12,1,16.0
ECU-012802,2122,164,80,84,8,20.5
ECU-012803,2122,9,4,5,1,9.0
ECU-012804,2122,11,5,6,1,11.0
ECU-012805,2122,21,9,12,1,21.0
ECU-012806,2122,7,3,4,1,7.0
ECU-012807,2122,388,199,189,15,25.866666666666667
ECU-012808,2122,72,31,41,4,18.0
ECU-012809,2122,11,5,6,1,11.0
ECU-012810,2122,74,30,44,3,24.666666666666668
ECU-012811,2122,940,460,480,41,22.926829268292682
ECU-012812,2122,20,12,8,1,20.0
ECU-012813,2122,33,12,21,2,16.5
ECU-012814,2122,26,13,13,1,26.0
ECU-012815,2122,6,3,3,1,6.0
ECU-012816,2122,8,7,1,1,8.0
ECU-012817,2122,12,8,4,1,12.0
ECU-012818,2122,10,7,3,1,10.0
ECU-012819,2122,10,6,4,1,10.0
ECU-012820,2122,28,15,13,1,28.0
ECU-012821,2122,15,6,9,1,15.0
ECU-012822,2122,4,2,2,1,4.0
ECU-012823,2122,13,4,9,1,13.0
ECU-012824,2122,21,8,13,1,21.0
ECU-012825,2122,11,6,5,1,11.0
ECU-012826,2122,40,21,19,2,20.0
ECU-012827,2122,6,3,3,1,6.0
ECU-012828,2122,13,7,6,1,13.0
ECU-012829,2122,20,7,13,1,20.0
ECU-012830,2122,19,11,8,1,19.0
ECU-012831,2122,7,1,6,1,7.0
ECU-012832,2122,3,0,3,1,3.0
ECU-012833,2122,12,4,8,1,12.0
ECU-012834,2122,158,73,85,12,13.166666666666666
ECU-012835,2122,45,17,28,2,22.5
ECU-012836,2122,30,15,15,1,30.0
ECU-012837,2122,8,5,3,1,8.0
ECU-012838,2122,17,8,9,1,17.0
ECU-012839,2122,38,23,15,2,19.0
ECU-012840,2122,3,0,3,1,3.0
ECU-012841,2122,28,12,16,2,14.0
ECU-012842,2122,38,14,24,2,19.0
ECU-012843,2122,130,51,79,6,21.666666666666668
ECU-012844,2122,17,12,5,1,17.0
ECU-012845,2122,13,5,8,1,13.0
ECU-012846,2122,11,7,4,1,11.0
ECU-012847,2122,4,2,2,1,4.0
ECU-012848,2122,6,0,6,1,6.0
ECU-012849,2122,6,3,3,1,6.0
ECU-012850,2122,11,6,5,1,11.0
ECU-012851,2122,21,12,9,2,10.5
ECU-012852,2122,13,9,4,1,13.0
ECU-012853,2122,11,7,4,1,11.0
ECU-012854,2122,8,4,4,1,8.0
ECU-012855,2122,100,54,46,11,9.090909090909092
ECU-012856,2122,9,3,6,1,9.0
ECU-012857,2122,49,22,27,7,7.0
ECU-012858,2122,9,7,2,1,9.0
ECU-012859,2122,5,3,2,1,5.0
ECU-012860,2122,5,3,2,1,5.0
ECU-012861,2122,34,17,17,7,4.857142857142857
ECU-012862,2122,7,4,3,1,7.0
ECU-012863,2122,7,5,2,1,7.0
ECU-012864,2122,12,7,5,1,12.0
ECU-012865,2122,14,9,5,1,14.0
ECU-012866,2122,9,5,4,1,9.0
ECU-012867,2122,71,37,34,6,11.833333333333334
ECU-012868,2122,11,4,7,1,11.0
ECU-012869,2122,11,4,7,1,11.0
ECU-012870,2122,24,14,10,1,24.0
ECU-012871,2122,269,136,133,23,11.695652173913043
ECU-012872,2122,16,9,7,2,8.0
ECU-012873,2122,9,7,2,1,9.0
ECU-012874,2122,3,3,0,1,3.0
ECU-012875,2122,10,5,5,1,10.0
ECU-012876,2122,186,93,93,9,20.666666666666668
ECU-012877,2122,2,0,2,1,2.0
ECU-012878,2122,5,1,4,1,5.0
ECU-012879,2122,13,5,8,1,13.0
ECU-012880,2122,15,6,9,1,15.0
ECU-012881,2122,228,109,119,15,15.2
ECU-012882,2122,12,6,6,2,6.0
ECU-012883,2122,10,4,6,1,10.0
ECU-012884,2122,5,3,2,1,5.0
ECU-012885,2122,11,4,7,1,11.0
ECU-012886,2122,20,10,10,1,20.0
ECU-012887,2122,7,5,2,1,7.0
ECU-012888,2122,8,5,3,1,8.0
ECU-012889,2122,5,3,2,1,5.0
ECU-012890,2122,27,16,11,2,13.5
ECU-012891,2122,11,7,4,1,11.0
ECU-012892,2122,11,6,5,1,11.0
ECU-012893,2122,16,4,12,1,16.0
ECU-012894,2122,669,330,339,43,15.55813953488372
ECU-012895,2122,255,126,129,18,14.166666666666666
ECU-012896,2122,81,44,37,11,7.363636363636363
ECU-012897,2122,86,43,43,6,14.333333333333334
ECU-012898,2122,12,8,4,1,12.0
ECU-012899,2122,21,6,15,6,3.5
ECU-012900,2122,7,3,4,4,1.75
ECU-012901,2122,5,4,1,1,5.0
ECU-012902,2122,10,3,7,1,10.0
ECU-012903,2122,4,3,1,1,4.0
ECU-012904,2122,3,3,0,1,3.0
ECU-012905,2122,8,3,5,1,8.0
ECU-012906,2122,6,3,3,1,6.0
ECU-012907,2122,59,33,26,3,19.666666666666668
ECU-012908,2122,95,26,69,4,23.75
ECU-012909,2122,693,328,365,38,18.236842105263158
ECU-012910,2122,37,18,19,2,18.5
ECU-012911,2122,6,4,2,1,6.0
ECU-012912,2122,11,7,4,1,11.0
ECU-012913,2122,522,301,221,32,16.3125
ECU-012914,2122,33,15,18,3,11.0
ECU-012915,2122,28,11,17,3,9.333333333333334
ECU-012916,2122,75,30,45,6,12.5
ECU-012917,2122,482,249,233,24,20.083333333333332
ECU-012918,2122,2,1,1,1,2.0
ECU-012919,2122,1,1,0,2,0.5
ECU-012920,2122,81,37,44,3,27.0
ECU-012921,2122,11,7,4,1,11.0
ECU-012922,2122,121,60,61,18,6.722222222222222
ECU-012923,2122,39,18,21,7,5.571428571428571
ECU-012924,2122,97,49,48,11,8.818181818181818
ECU-012925,2122,16,6,10,2,8.0
ECU-012926,2122,20,8,12,5,4.0
ECU-012927,2122,4,3,1,3,1.3333333333333333
ECU-012928,2122,7,4,3,1,7.0
ECU-012929,2122,8,3,5,3,2.6666666666666665
ECU-012930,2122,12,8,4,4,3.0
ECU-012931,2122,2,1,1,1,2.0
ECU-012932,2122,12,5,7,1,12.0
ECU-012933,2122,17,8,9,1,17.0
ECU-012934,2122,25,16,9,2,12.5
ECU-012935,2122,23,12,11,1,23.0
ECU-012936,2122,115,51,64,12,9.583333333333334
ECU-012937,2122,28,13,15,2,14.0
ECU-012938,2122,44,16,28,4,11.0
ECU-012939,2122,60,23,37,1,60.0
ECU-012940,2122,25,12,13,2,12.5
ECU-012941,2122,17,12,5,1,17.0
ECU-012942,2122,26,14,12,1,26.0
ECU-012943,2122,60,26,34,3,20.0
ECU-012944,2122,5,4,1,1,5.0
ECU-012945,2122,28,10,18,2,14.0
ECU-012946,2122,4,1,3,1,4.0
ECU-012947,2122,11,6,5,1,11.0
ECU-012948,2122,3,2,1,1,3.0
ECU-012949,2122,12,3,9,1,12.0
ECU-012950,2122,11,4,7,1,11.0
ECU-012951,2122,6,4,2,1,6.0
ECU-012952,2122,7,2,5,1,7.0
ECU-012953,2122,2,1,1,1,2.0
ECU-012954,2122,14,7,7,1,14.0
ECU-012955,2122,73,33,40,7,10.428571428571429
ECU-012956,2122,148,76,72,15,9.866666666666667
ECU-012957,2122,9,6,3,1,9.0
ECU-012958,2122,47,29,18,6,7.833333333333333
ECU-012959,2122,19,11,8,1,19.0
ECU-012960,2122,6,2,4,1,6.0
ECU-012961,2122,18,9,9,2,9.0
ECU-012962,2122,4,2,2,1,4.0
ECU-012963,2122,7,3,4,1,7.0
ECU-012964,2122,143,72,71,13,11.0
ECU-012965,2122,9,7,2,1,9.0
ECU-012966,2122,87,43,44,11,7.909090909090909
ECU-012967,2122,10,4,6,1,10.0
ECU-012968,2122,12,6,6,1,12.0
ECU-012969,2122,20,7,13,1,20.0
ECU-012970,2122,15,7,8,1,15.0
ECU-012971,2122,111,56,55,11,10.090909090909092
ECU-012972,2122,5,2,3,1,5.0
ECU-012973,2122,26,15,11,2,13.0
ECU-012974,2122,23,5,18,1,23.0
ECU-012975,2122,200,110,90,14,14.285714285714286
ECU-012976,2122,263,133,130,17,15.470588235294118
ECU-012977,2122,38,21,17,2,19.0
ECU-012978,2122,19,9,10,1,19.0
ECU-012979,2122,13,3,10,1,13.0
ECU-012980,2122,10,5,5,1,10.0
ECU-012981,2122,15,7,8,1,15.0
ECU-012982,2122,11,5,6,1,11.0
ECU-012983,2122,23,7,16,1,23.0
ECU-012984,2122,179,95,84,12,14.916666666666666
ECU-012985,2122,17,8,9,1,17.0
ECU-012986,2122,5,2,3,1,5.0
ECU-012987,2122,18,10,8,1,18.0
ECU-012988,2122,13,8,5,1,13.0
ECU-012989,2122,2,0,2,1,2.0
ECU-012990,2122,332,170,162,18,18.444444444444443
ECU-012991,2122,17,8,9,1,17.0
ECU-012992,2122,12,8,4,1,12.0
ECU-012993,2122,17,8,9,1,17.0
ECU-012994,2122,10,2,8,1,10.0
ECU-012995,2122,11,4,7,1,11.0
ECU-012996,2122,12,3,9,1,12.0
ECU-012997,2122,3,2,1,1,3.0
ECU-012998,2122,19,9,10,1,19.0
ECU-012999,2122,4,4,0,1,4.0
ECU-013000,2122,12,10,2,1,12.0
ECU-013001,2122,23,9,14,1,23.0
ECU-013002,2122,21,8,13,1,21.0
ECU-013003,2122,117,58,59,14,8.357142857142858
ECU-013004,2122,97,50,47,13,7.461538461538462
ECU-013005,2122,12,6,6,1,12.0
ECU-013006,2122,554,293,261,27,20.51851851851852
ECU-013007,2122,39,13,26,16,2.4375
ECU-013008,2122,119,65,54,9,13.222222222222221
ECU-013009,2122,57,25,32,5,11.4
ECU-013010,2122,288,103,185,15,19.2
ECU-013011,2122,645,350,295,45,14.333333333333334
ECU-013012,2122,468,202,266,35,13.371428571428572
ECU-013013,2122,16,16,0,1,16.0
ECU-013014,2122,140,74,66,13,10.76923076923077
ECU-013015,2122,6,2,4,1,6.0
ECU-013016,2122,327,148,179,14,23.357142857142858
ECU-013017,2122,12,6,6,1,12.0
ECU-013018,2122,262,126,136,14,18.714285714285715
ECU-013019,2122,4,2,2,1,4.0
ECU-013020,2122,96,52,44,8,12.0
ECU-013021,2122,54,24,30,6,9.0
ECU-013022,2122,484,243,241,33,14.666666666666666
ECU-013023,2122,45,23,22,6,7.5
ECU-013024,2122,240,116,124,14,17.142857142857142
ECU-013025,2122,10,2,8,1,10.0
ECU-013026,2122,10,5,5,1,10.0
ECU-013027,2122,10,5,5,1,10.0
ECU-013028,2122,9,4,5,1,9.0
ECU-013029,2122,18,11,7,3,6.0
ECU-013030,2122,14,6,8,1,14.0
ECU-013031,2122,5,2,3,1,5.0
ECU-013032,2122,7,2,5,1,7.0
ECU-013033,2122,54,17,37,8,6.75
ECU-013034,2122,14,8,6,2,7.0
ECU-013035,2122,7,1,6,1,7.0
ECU-013036,2122,15,5,10,1,15.0
ECU-013037,2122,100,48,52,13,7.6923076923076925
ECU-013038,2122,16,5,11,1,16.0
ECU-013039,2122,77,35,42,10,7.7
ECU-013040,2122,132,60,72,10,13.2
ECU-013041,2122,13,5,8,1,13.0
ECU-013042,2122,34,16,18,3,11.333333333333334
ECU-013043,2122,293,130,163,18,16.27777777777778
ECU-013044,2122,250,122,128,18,13.88888888888889
ECU-013045,2122,172,89,83,12,14.333333333333334
ECU-013046,2122,9,3,6,1,9.0
ECU-013047,2122,6,3,3,1,6.0
ECU-013048,2122,23,13,10,1,23.0
ECU-013049,2122,5,2,3,1,5.0
ECU-013050,2122,27,14,13,3,9.0
ECU-013051,2122,11,7,4,1,11.0
ECU-013052,2122,5,3,2,1,5.0
ECU-013053,2122,6,3,3,1,6.0
ECU-013054,2122,84,56,28,4,21.0
ECU-013055,2122,7,3,4,1,7.0
ECU-013056,2122,145,79,66,12,12.083333333333334
ECU-013057,2122,14,7,7,1,14.0
ECU-013058,2122,27,15,12,2,13.5
ECU-013059,2122,352,185,167,15,23.466666666666665
ECU-013060,2122,117,47,70,10,11.7
ECU-013061,2122,12,5,7,1,12.0
ECU-013062,2122,21,9,12,1,21.0
ECU-013063,2122,413,203,210,30,13.766666666666667
ECU-013064,2122,2,1,1,1,2.0
ECU-013065,2122,59,29,30,3,19.666666666666668
ECU-013066,2122,13,7,6,1,13.0
ECU-013067,2122,8,4,4,1,8.0
ECU-013068,2122,4,3,1,1,4.0
ECU-013069,2122,9,6,3,1,9.0
ECU-013070,2122,213,114,99,14,15.214285714285714
ECU-013071,2122,16,8,8,1,16.0
ECU-013072,2122,4,3,1,1,4.0
ECU-013073,2122,12,5,7,1,12.0
ECU-013074,2122,11,6,5,1,11.0
ECU-013075,2122,10,4,6,1,10.0
ECU-013076,2122,6,2,4,1,6.0
ECU-013077,2122,15,10,5,1,15.0
ECU-013078,2122,23,10,13,1,23.0
ECU-013079,2122,13,4,9,1,13.0
ECU-013080,2122,41,21,20,3,13.666666666666666
ECU-013081,2122,45,24,21,2,22.5
ECU-013082,2122,163,82,81,10,16.3
ECU-013083,2122,20,10,10,1,20.0
ECU-013084,2122,15,7,8,1,15.0
ECU-013085,2122,7,1,6,1,7.0
ECU-013086,2122,26,16,10,1,26.0
ECU-013087,2122,6,4,2,1,6.0
ECU-013088,2122,9,4,5,1,9.0
ECU-013089,2122,245,119,126,12,20.416666666666668
ECU-013090,2122,182,84,98,13,14.0
ECU-013091,2122,16,10,6,1,16.0
ECU-013092,2122,24,13,11,2,12.0
ECU-013093,2122,117,62,55,10,11.7
ECU-013094,2122,69,33,36,11,6.2727272727272725
ECU-013095,2122,547,268,279,28,19.535714285714285
ECU-013096,2122,31,21,10,2,15.5
ECU-013097,2122,6,4,2,1,6.0
ECU-013098,2122,9,2,7,1,9.0
ECU-013099,2122,4,2,2,1,4.0
ECU-013100,2122,9,5,4,1,9.0
ECU-013101,2122,63,31,32,5,12.6
ECU-013102,2122,4,2,2,1,4.0
ECU-013103,2122,23,11,12,1,23.0
ECU-013104,2122,59,27,32,7,8.428571428571429
ECU-013105,2122,4,3,1,1,4.0
ECU-013106,2122,1256,626,630,71,17.690140845070424
ECU-013107,2122,1259,522,737,52,24.21153846153846
ECU-013108,2122,13,5,8,1,13.0
ECU-013109,2122,120,53,67,6,20.0
ECU-013110,2122,10,4,6,1,10.0
ECU-013111,2122,1338,759,579,54,24.77777777777778
ECU-013112,2122,16,6,10,1,16.0
ECU-013113,2122,9,5,4,1,9.0
ECU-013114,2122,49,33,16,7,7.0
ECU-013115,2122,9,5,4,1,9.0
ECU-013116,2122,192,91,101,10,19.2
ECU-013117,2122,11,8,3,1,11.0
ECU-013118,2122,15,10,5,1,15.0
ECU-013119,2122,98,40,58,10,9.8
ECU-013120,2122,198,106,92,10,19.8
ECU-013121,2122,32,14,18,2,16.0
ECU-013122,2122,5,4,1,1,5.0
ECU-013123,2122,8,4,4,1,8.0
ECU-013124,2122,12,5,7,1,12.0
ECU-013125,2122,24,13,11,3,8.0
ECU-013126,2122,6,3,3,1,6.0
ECU-013127,2122,14,4,10,3,4.666666666666667
ECU-013128,2122,28,15,13,2,14.0
ECU-013129,2122,741,372,369,24,30.875
ECU-013130,2122,729,355,374,40,18.225
ECU-013131,2122,10,5,5,1,10.0
ECU-013132,2122,4,2,2,1,4.0
ECU-013133,2122,16,7,9,1,16.0
ECU-013134,2122,201,98,103,15,13.4
ECU-013135,2122,255,122,133,13,19.615384615384617
ECU-013136,2122,20,13,7,1,20.0
ECU-013137,2122,133,64,69,9,14.777777777777779
ECU-013138,2122,12,4,8,1,12.0
ECU-013139,2122,30,14,16,2,15.0
ECU-013140,2122,6,3,3,1,6.0
ECU-013141,2122,13,7,6,1,13.0
ECU-013142,2122,11,5,6,1,11.0
ECU-013143,2122,5,4,1,1,5.0
ECU-013144,2122,8,5,3,1,8.0
ECU-013145,2122,480,225,255,29,16.551724137931036
ECU-013146,2122,11,5,6,1,11.0
ECU-013147,2122,23,14,9,1,23.0
ECU-013148,2122,10,5,5,1,10.0
ECU-013149,2122,14,8,6,1,14.0
ECU-013150,2122,345,193,152,21,16.428571428571427
ECU-013151,2122,10,7,3,1,10.0
ECU-013152,2122,37,21,16,2,18.5
ECU-013153,2122,259,131,128,16,16.1875
ECU-013154,2122,282,126,156,15,18.8
ECU-013155,2122,53,24,29,5,10.6
ECU-013156,2122,124,66,58,10,12.4
ECU-013157,2122,11,6,5,2,5.5
ECU-013158,2122,20,12,8,2,10.0
ECU-013159,2122,815,413,402,35,23.285714285714285
ECU-013160,2122,113,51,62,11,10.272727272727273
ECU-013161,2122,7,4,3,1,7.0
ECU-013162,2122,71,38,33,10,7.1
ECU-013163,2122,16,7,9,3,5.333333333333333
ECU-013164,2122,6,2,4,1,6.0
ECU-013165,2122,15,5,10,1,15.0
ECU-013166,2122,12,5,7,1,12.0
ECU-013167,2122,9,6,3,1,9.0
ECU-013168,2122,2,0,2,1,2.0
ECU-013169,2122,7,4,3,1,7.0
ECU-013170,2122,16,8,8,1,16.0
ECU-013171,2122,96,41,55,8,12.0
ECU-013172,2122,121,58,63,10,12.1
ECU-013173,2122,13,5,8,1,13.0
ECU-013174,2122,12,6,6,1,12.0
ECU-013175,2122,25,11,14,1,25.0
ECU-013176,2122,5,4,1,1,5.0
ECU-013177,2122,14,7,7,1,14.0
ECU-013178,2122,26,15,11,1,26.0
ECU-013179,2122,13,6,7,1,13.0
ECU-013180,2122,106,57,49,9,11.777777777777779
ECU-013181,2122,30,14,16,2,15.0
ECU-013182,2122,25,14,11,1,25.0
ECU-013183,2122,27,15,12,2,13.5
ECU-013184,2122,18,9,9,1,18.0
ECU-013185,2122,258,129,129,20,12.9
ECU-013186,2122,14,6,8,1,14.0
ECU-013187,2122,19,8,11,1,19.0
ECU-013188,2122,12,4,8,1,12.0
ECU-013189,2122,59,33,26,6,9.833333333333334
ECU-013190,2122,79,36,43,6,13.166666666666666
ECU-013191,2122,45,22,23,2,22.5
ECU-013192,2122,12,4,8,1,12.0
ECU-013193,2122,25,11,14,2,12.5
ECU-013194,2122,6,2,4,1,6.0
ECU-013195,2122,18,9,9,1,18.0
ECU-013196,2122,102,44,58,8,12.75
ECU-013197,2122,245,125,120,13,18.846153846153847
ECU-013198,2122,7,5,2,1,7.0
ECU-013199,2122,12,5,7,2,6.0
ECU-013200,2122,16,8,8,1,16.0
ECU-013201,2122,69,31,38,4,17.25
ECU-013202,2122,14,4,10,1,14.0
ECU-013203,2122,7,3,4,1,7.0
ECU-013204,2122,14,7,7,1,14.0
ECU-013205,2122,24,13,11,2,12.0
ECU-013206,2122,10,5,5,1,10.0
ECU-013207,2122,12,5,7,2,6.0
ECU-013208,2122,4,3,1,1,4.0
ECU-013209,2122,8,5,3,1,8.0
ECU-013210,2122,94,49,45,13,7.230769230769231
ECU-013211,2122,11,5,6,1,11.0
ECU-013212,2122,14,4,10,1,14.0
ECU-013213,2122,1278,643,635,65,19.661538461538463
ECU-013214,2122,1142,589,553,51,22.392156862745097
ECU-013215,2122,775,387,388,37,20.945945945945947
ECU-013216,2122,2,0,2,1,2.0
ECU-013217,2122,54,22,32,6,9.0
ECU-013218,2122,352,193,159,14,25.142857142857142
ECU-013219,2122,565,272,293,23,24.565217391304348
ECU-013220,2122,447,241,206,14,31.928571428571427
ECU-013221,2122,2593,1262,1331,69,37.57971014492754
ECU-013222,2122,69,27,42,8,8.625
ECU-013223,2122,256,131,125,8,32.0
ECU-013224,2122,1099,548,551,41,26.804878048780488
ECU-013225,2122,434,227,207,15,28.933333333333334
ECU-013226,2122,1320,607,713,39,33.84615384615385
ECU-013227,2122,2729,1604,1125,125,21.832
ECU-013228,2122,1647,852,795,142,11.598591549295774
ECU-013229,2122,131,66,65,12,10.916666666666666
ECU-013230,2122,214,110,104,7,30.571428571428573
ECU-013231,2122,3718,2168,1550,100,37.18
ECU-013232,2122,117,61,56,13,9.0
ECU-013233,2122,1934,989,945,62,31.193548387096776
ECU-013234,2122,440,206,234,43,10.232558139534884
ECU-013235,2122,1897,914,983,51,37.19607843137255
ECU-013236,2122,2567,1319,1248,72,35.65277777777778
ECU-013237,2122,1792,925,867,73,24.54794520547945
ECU-013238,2122,2249,1245,1004,77,29.207792207792206
ECU-013239,2122,470,220,250,13,36.15384615384615
ECU-013240,2122,566,259,307,15,37.733333333333334
ECU-013241,2122,1558,790,768,59,26.406779661016948
ECU-013242,2122,745,332,413,21,35.476190476190474
ECU-013243,2122,1876,922,954,48,39.083333333333336
ECU-013244,2122,1827,899,928,50,36.54
ECU-013245,2122,660,322,338,18,36.666666666666664
ECU-013246,2122,90,43,47,8,11.25
ECU-013247,2122,82,38,44,3,27.333333333333332
ECU-013248,2122,362,202,160,10,36.2
ECU-013249,2122,530,267,263,19,27.894736842105264
ECU-013250,2122,1897,994,903,66,28.742424242424242
ECU-013251,2122,1338,646,692,184,7.271739130434782
ECU-013252,2122,153,59,94,37,4.135135135135135
ECU-013253,2122,229,131,98,0,
ECU-013254,2122,303,160,143,10,30.3
ECU-013255,2122,884,408,476,23,38.43478260869565
ECU-013256,2122,195,87,108,18,10.833333333333334
ECU-013257,2122,304,168,136,10,30.4
ECU-013258,2122,684,346,338,22,31.09090909090909
ECU-013259,2122,587,289,298,21,27.952380952380953
ECU-013260,2122,623,301,322,28,22.25
ECU-013261,2122,206,99,107,8,25.75
ECU-013262,2122,1172,596,576,33,35.515151515151516
ECU-013263,2122,261,142,119,12,21.75
ECU-013264,2122,237,126,111,11,21.545454545454547
ECU-013265,2122,144,61,83,15,9.6
ECU-013266,2122,50,3,47,7,7.142857142857143
ECU-013267,2122,51,25,26,5,10.2
ECU-013268,2122,570,518,52,29,19.655172413793103
ECU-013269,2122,1328,689,639,52,25.53846153846154
ECU-013270,2122,44,24,20,8,5.5
ECU-013271,2122,71,35,36,7,10.142857142857142
ECU-013272,2122,483,249,234,16,30.1875
ECU-013273,2122,642,346,296,20,32.1
ECU-013274,2122,572,257,315,20,28.6
ECU-013275,2122,233,112,121,8,29.125
ECU-013276,2122,435,208,227,17,25.58823529411765
ECU-013277,2122,1182,645,537,33,35.81818181818182
ECU-013278,2122,151,61,90,21,7.190476190476191
ECU-013279,2122,646,329,317,25,25.84
ECU-013280,2122,615,302,313,21,29.285714285714285
ECU-013281,2122,937,762,175,42,22.30952380952381
ECU-013282,2122,391,196,195,13,30.076923076923077
ECU-013283,2122,216,93,123,5,43.2
ECU-013284,2122,135,79,56,3,45.0
ECU-013285,2122,512,241,271,19,26.94736842105263
ECU-013286,2122,362,190,172,13,27.846153846153847
ECU-013287,2122,1048,637,411,55,19.054545454545455
ECU-013288,2122,108,46,62,7,15.428571428571429
ECU-013289,2122,328,151,177,21,15.619047619047619
ECU-013290,2122,1665,556,1109,102,16.323529411764707
ECU-013291,2122,1019,658,361,47,21.680851063829788
ECU-013292,2122,199,99,100,8,24.875
ECU-013293,2122,393,185,208,12,32.75
ECU-013294,2122,65,37,28,3,21.666666666666668
ECU-013295,2122,230,122,108,8,28.75
ECU-013296,2122,1413,647,766,56,25.232142857142858
ECU-013297,2122,789,402,387,20,39.45
ECU-013298,2122,498,246,252,15,33.2
ECU-013299,2122,32,16,16,3,10.666666666666666
ECU-013300,2122,65,28,37,7,9.285714285714286
ECU-013301,2122,942,464,478,31,30.387096774193548
ECU-013302,2122,119,52,67,12,9.916666666666666
ECU-013303,2122,1150,588,562,48,23.958333333333332
ECU-013304,2122,332,144,188,21,15.80952380952381
ECU-013305,2122,904,426,478,40,22.6
ECU-013306,2122,1035,512,523,29,35.689655172413794
ECU-013307,2122,749,365,384,32,23.40625
ECU-013308,2122,333,173,160,10,33.3
ECU-013309,2122,205,93,112,9,22.77777777777778
ECU-013310,2122,123,64,59,9,13.666666666666666
ECU-013311,2122,499,247,252,16,31.1875
ECU-013312,2122,160,91,69,6,26.666666666666668
ECU-013313,2122,444,221,223,14,31.714285714285715
ECU-013314,2122,797,384,413,21,37.95238095238095
ECU-013315,2122,230,112,118,8,28.75
ECU-013316,2122,546,295,251,15,36.4
ECU-013317,2122,864,159,705,43,20.093023255813954
ECU-013318,2122,106,50,56,4,26.5
ECU-013319,2122,446,218,228,14,31.857142857142858
ECU-013320,2122,63,37,26,6,10.5
ECU-013321,2122,992,480,512,36,27.555555555555557
ECU-013322,2122,82,36,46,8,10.25
ECU-013323,2122,78,47,31,4,19.5
ECU-013324,2122,155,83,72,12,12.916666666666666
ECU-013325,2122,342,163,179,10,34.2
ECU-013326,2122,2738,1380,1358,87,31.471264367816094
ECU-013327,2122,77,31,46,7,11.0
ECU-013328,2122,397,219,178,12,33.083333333333336
ECU-013329,2122,282,134,148,9,31.333333333333332
ECU-013330,2122,1154,535,619,33,34.96969696969697
ECU-013331,2122,378,186,192,16,23.625
ECU-013332,2122,886,429,457,24,36.916666666666664
ECU-013333,2122,225,112,113,8,28.125
ECU-013334,2122,223,108,115,7,31.857142857142858
ECU-013335,2122,419,194,225,21,19.952380952380953
ECU-013336,2122,248,132,116,12,20.666666666666668
ECU-013337,2122,863,418,445,30,28.766666666666666
ECU-013338,2122,129,69,60,7,18.428571428571427
ECU-013339,2122,463,293,170,17,27.235294117647058
ECU-013340,2122,442,217,225,13,34.0
ECU-013341,2122,1721,720,1001,70,24.585714285714285
ECU-013342,2122,75,30,45,6,12.5
ECU-013343,2122,306,155,151,7,43.714285714285715
ECU-013344,2122,350,159,191,11,31.818181818181817
ECU-013345,2122,1160,566,594,31,37.41935483870968
ECU-013346,2122,234,108,126,11,21.272727272727273
ECU-013347,2122,568,261,307,18,31.555555555555557
ECU-013348,2122,1216,624,592,38,32.0
ECU-013349,2122,442,235,207,16,27.625
ECU-013350,2122,584,295,289,16,36.5
ECU-013351,2122,34,22,12,2,17.0
ECU-013352,2122,869,476,393,39,22.28205128205128
ECU-013353,2122,218,111,107,12,18.166666666666668
ECU-013354,2122,178,82,96,11,16.181818181818183
ECU-013355,2122,794,381,413,28,28.357142857142858
ECU-013356,2122,200,101,99,8,25.0
ECU-013357,2122,185,81,104,11,16.818181818181817
ECU-013358,2122,25,11,14,8,3.125
ECU-013359,2122,667,326,341,24,27.791666666666668
ECU-013360,2122,99,62,37,7,14.142857142857142
ECU-013361,2122,1486,749,737,46,32.30434782608695
ECU-013362,2122,440,222,218,12,36.666666666666664
ECU-013363,2122,295,135,160,9,32.77777777777778
ECU-013364,2122,102,50,52,7,14.571428571428571
ECU-013365,2122,2468,1216,1252,84,29.38095238095238
ECU-013366,2122,234,111,123,7,33.42857142857143
ECU-013367,2122,31,13,18,6,5.166666666666667
ECU-013368,2122,297,129,168,9,33.0
ECU-013369,2122,20,7,13,2,10.0
ECU-013370,2122,1673,778,895,55,30.418181818181818
ECU-013371,2122,289,146,143,6,48.166666666666664
ECU-013372,2122,284,135,149,9,31.555555555555557
ECU-013373,2122,567,271,296,17,33.35294117647059
ECU-013374,2122,38,22,16,5,7.6
ECU-013375,2122,345,166,179,11,31.363636363636363
ECU-013376,2122,1150,549,601,30,38.333333333333336
ECU-013377,2122,429,214,215,16,26.8125
ECU-013378,2122,11,7,4,3,3.6666666666666665
ECU-013379,2122,240,107,133,6,40.0
ECU-013380,2122,18,5,13,7,2.5714285714285716
ECU-013381,2122,25,7,18,7,3.5714285714285716
ECU-013382,2122,77,37,40,6,12.833333333333334
ECU-013383,2122,2341,1150,1191,67,34.940298507462686
ECU-013384,2122,169,93,76,15,11.266666666666667
ECU-013385,2122,574,286,288,19,30.210526315789473
ECU-013386,2122,1124,516,608,42,26.761904761904763
ECU-013387,2122,311,162,149,8,38.875
ECU-013388,2122,323,135,188,11,29.363636363636363
ECU-013389,2122,30,17,13,5,6.0
ECU-013390,2122,135,71,64,10,13.5
ECU-013391,2122,1339,645,694,49,27.3265306122449
ECU-013392,2122,413,217,196,11,37.54545454545455
ECU-013393,2122,2183,1103,1080,69,31.63768115942029
ECU-013394,2122,27,12,15,2,13.5
ECU-013395,2122,28,10,18,5,5.6
ECU-013396,2122,266,154,112,15,17.733333333333334
ECU-013397,2122,833,407,426,39,21.358974358974358
ECU-013398,2122,418,199,219,20,20.9
ECU-013399,2122,2023,998,1025,66,30.651515151515152
ECU-013400,2122,517,250,267,15,34.46666666666667
ECU-013401,2122,944,465,479,30,31.466666666666665
ECU-013402,2122,2,1,1,2,1.0
ECU-013403,2122,44,19,25,4,11.0
ECU-013404,2122,82,42,40,4,20.5
ECU-013405,2122,91,45,46,3,30.333333333333332
ECU-013406,2122,54,26,28,4,13.5
ECU-013407,2122,814,464,350,30,27.133333333333333
ECU-013408,2122,132,57,75,10,13.2
ECU-013409,2122,2154,1101,1053,100,21.54
ECU-013410,2122,645,310,335,26,24.807692307692307
ECU-013411,2122,564,243,321,18,31.333333333333332
ECU-013412,2122,1182,581,601,35,33.77142857142857
ECU-013413,2122,314,165,149,10,31.4
ECU-013414,2122,304,148,156,9,33.77777777777778
ECU-013415,2122,125,65,60,5,25.0
ECU-013416,2122,679,332,347,21,32.333333333333336
ECU-013417,2122,1364,707,657,55,24.8
ECU-013418,2122,268,136,132,7,38.285714285714285
ECU-013419,2122,116,56,60,7,16.571428571428573
ECU-013420,2122,85,45,40,6,14.166666666666666
ECU-013421,2122,560,282,278,19,29.473684210526315
ECU-013422,2122,314,165,149,10,31.4
ECU-013423,2122,710,343,367,21,33.80952380952381
ECU-013424,2122,2171,1079,1092,65,33.4
ECU-013425,2122,749,371,378,22,34.04545454545455
ECU-013426,2122,80,39,41,7,11.428571428571429
ECU-013427,2122,30,14,16,2,15.0
ECU-013428,2122,445,231,214,20,22.25
ECU-013429,2122,328,156,172,12,27.333333333333332
ECU-013430,2122,497,245,252,17,29.235294117647058
ECU-013431,2122,437,205,232,13,33.61538461538461
ECU-013432,2122,175,92,83,12,14.583333333333334
ECU-013433,2122,73,30,43,5,14.6
ECU-013434,2122,241,113,128,9,26.77777777777778
ECU-013435,2122,951,506,445,44,21.613636363636363
ECU-013436,2122,763,763,0,32,23.84375
ECU-013437,2122,42,18,24,9,4.666666666666667
ECU-013438,2122,1098,941,157,47,23.361702127659573
ECU-013439,2122,366,171,195,13,28.153846153846153
ECU-013440,2122,102,51,51,17,6.0
ECU-013441,2122,237,94,143,17,13.941176470588236
ECU-013442,2122,117,54,63,7,16.714285714285715
ECU-013443,2122,893,526,367,16,55.8125
ECU-013444,2122,113,47,66,15,7.533333333333333
ECU-013445,2122,8,6,2,2,4.0
ECU-013446,2122,148,64,84,9,16.444444444444443
ECU-013447,2122,360,184,176,14,25.714285714285715
ECU-013448,2122,25,12,13,3,8.333333333333334
ECU-013449,2122,69,27,42,5,13.8
ECU-013450,2122,14,4,10,2,7.0
ECU-013451,2122,79,36,43,5,15.8
ECU-013452,2122,81,47,34,24,3.375
ECU-013453,2122,229,113,116,9,25.444444444444443
ECU-013454,2122,3435,1900,1535,111,30.945945945945947
ECU-013455,2122,497,229,268,17,29.235294117647058
ECU-013456,2122,1016,203,813,30,33.86666666666667
ECU-013457,2122,417,202,215,15,27.8
ECU-013458,2122,48,24,24,5,9.6
ECU-013459,2122,110,50,60,6,18.333333333333332
ECU-013460,2122,20,10,10,4,5.0
ECU-013461,2122,725,338,387,28,25.892857142857142
ECU-013462,2122,307,152,155,8,38.375
ECU-013463,2122,89,42,47,5,17.8
ECU-013464,2122,141,55,86,10,14.1
ECU-013465,2122,407,193,214,15,27.133333333333333
ECU-013466,2122,464,226,238,17,27.294117647058822
ECU-013467,2122,371,204,167,8,46.375
ECU-013468,2122,117,47,70,8,14.625
ECU-013469,2122,6,3,3,2,3.0
ECU-013470,2122,70,33,37,5,14.0
ECU-013471,2122,639,292,347,15,42.6
ECU-013472,2122,95,41,54,9,10.555555555555555
ECU-013473,2122,139,74,65,5,27.8
ECU-013474,2122,73,39,34,4,18.25
ECU-013475,2122,120,60,60,6,20.0
ECU-013476,2122,847,413,434,26,32.57692307692308
ECU-013477,2122,363,160,203,12,30.25
ECU-013478,2122,698,320,378,26,26.846153846153847
ECU-013479,2122,41,21,20,3,13.666666666666666
ECU-013480,2122,393,393,0,11,35.72727272727273
ECU-013481,2122,691,341,350,24,28.791666666666668
ECU-013482,2122,775,395,380,30,25.833333333333332
ECU-013483,2122,891,458,433,27,33.0
ECU-013484,2122,1232,606,626,40,30.8
ECU-013485,2122,533,242,291,18,29.61111111111111
ECU-013486,2122,833,413,420,32,26.03125
ECU-013487,2122,707,317,390,22,32.13636363636363
ECU-013488,2122,236,108,128,9,26.22222222222222
ECU-013489,2122,1045,488,557,36,29.02777777777778
ECU-013490,2122,175,90,85,9,19.444444444444443
ECU-013491,2122,28,14,14,5,5.6
ECU-013492,2122,253,117,136,10,25.3
ECU-013493,2122,210,94,116,9,23.333333333333332
ECU-013494,2122,88,43,45,4,22.0
ECU-013495,2122,238,118,120,11,21.636363636363637
ECU-013496,2122,588,263,325,27,21.77777777777778
ECU-013497,2122,704,348,356,26,27.076923076923077
ECU-013498,2122,258,118,140,9,28.666666666666668
ECU-013499,2122,91,34,57,5,18.2
ECU-013500,2122,724,366,358,27,26.814814814814813
ECU-013501,2122,535,266,269,16,33.4375
ECU-013502,2122,262,139,123,23,11.391304347826088
ECU-013503,2122,350,111,239,17,20.58823529411765
ECU-013504,2122,1121,559,562,43,26.069767441860463
ECU-013505,2122,184,93,91,16,11.5
ECU-013506,2122,191,77,114,18,10.61111111111111
ECU-013507,2122,36,13,23,4,9.0
ECU-013508,2122,196,96,100,10,19.6
ECU-013509,2122,1150,439,711,33,34.84848484848485
ECU-013510,2122,355,179,176,13,27.307692307692307
ECU-013511,2122,1620,851,769,61,26.557377049180328
ECU-013512,2122,2207,1480,727,81,27.246913580246915
ECU-013513,2122,233,109,124,8,29.125
ECU-013514,2122,242,110,132,13,18.615384615384617
ECU-013515,2122,1079,878,201,50,21.58
ECU-013516,2122,1054,619,435,24,43.916666666666664
ECU-013517,2122,548,191,357,25,21.92
ECU-013518,2122,954,482,472,36,26.5
ECU-013519,2122,40,13,27,12,3.3333333333333335
ECU-013520,2122,633,329,304,24,26.375
ECU-013521,2122,51,23,28,9,5.666666666666667
ECU-013522,2122,544,247,297,16,34.0
ECU-013523,2122,10,6,4,2,5.0
ECU-013524,2122,9,3,6,4,2.25
ECU-013525,2122,421,331,90,15,28.066666666666666
ECU-013526,2122,861,401,460,22,39.13636363636363
ECU-013527,2122,695,339,356,23,30.217391304347824
ECU-013528,2122,1239,634,605,51,24.294117647058822
ECU-013529,2122,485,252,233,10,48.5
ECU-013530,2122,230,117,113,10,23.0
ECU-013531,2122,2258,1026,1232,77,29.324675324675326
ECU-013532,2122,933,637,296,41,22.75609756097561
ECU-013533,2122,108,50,58,9,12.0
ECU-013534,2122,472,257,215,14,33.714285714285715
ECU-013535,2122,36,18,18,6,6.0
ECU-013536,2122,936,433,503,47,19.914893617021278
ECU-013537,2122,1149,609,540,33,34.81818181818182
ECU-013538,2122,339,178,161,10,33.9
ECU-013539,2122,309,121,188,21,14.714285714285714
ECU-013540,2122,582,299,283,17,34.23529411764706
ECU-013541,2122,15,11,4,2,7.5
ECU-013542,2122,190,92,98,8,23.75
ECU-013543,2122,43,20,23,4,10.75
ECU-013544,2122,596,282,314,19,31.36842105263158
ECU-013545,2122,954,481,473,33,28.90909090909091
ECU-013546,2122,1154,737,417,40,28.85
ECU-013547,2122,285,144,141,9,31.666666666666668
ECU-013548,2122,3261,1612,1649,92,35.44565217391305
ECU-013549,2122,2275,1323,952,90,25.27777777777778
ECU-013550,2122,173,88,85,12,14.416666666666666
ECU-013551,2122,570,285,285,25,22.8
ECU-013552,2122,299,140,159,15,19.933333333333334
ECU-013553,2122,1034,515,519,31,33.354838709677416
ECU-013554,2122,583,259,324,22,26.5
ECU-013555,2122,37,18,19,6,6.166666666666667
ECU-013556,2122,604,328,276,13,46.46153846153846
ECU-013557,2122,118,46,72,13,9.076923076923077
ECU-013558,2122,411,212,199,15,27.4
ECU-013559,2122,89,35,54,8,11.125
ECU-013560,2122,281,132,149,14,20.071428571428573
ECU-013561,2122,111,55,56,17,6.529411764705882
ECU-013562,2122,447,194,253,15,29.8
ECU-013563,2122,1320,659,661,69,19.130434782608695
ECU-013564,2122,19,7,12,2,9.5
ECU-013565,2122,3148,1347,1801,141,22.326241134751772
ECU-013566,2122,1074,591,483,39,27.53846153846154
ECU-013567,2122,746,344,402,31,24.06451612903226
ECU-013568,2122,648,324,324,19,34.10526315789474
ECU-013569,2122,139,64,75,9,15.444444444444445
ECU-013570,2122,91,51,40,8,11.375
ECU-013571,2122,1683,0,1683,70,24.042857142857144
ECU-013572,2122,53,31,22,5,10.6
ECU-013573,2122,180,64,116,14,12.857142857142858
ECU-013574,2122,119,51,68,16,7.4375
ECU-013575,2122,473,252,221,21,22.523809523809526
ECU-013576,2122,342,174,168,11,31.09090909090909
ECU-013577,2122,219,109,110,8,27.375
ECU-013578,2122,2529,1166,1363,115,21.991304347826087
ECU-013579,2122,4268,2223,2045,141,30.26950354609929
ECU-013580,2122,68,35,33,3,22.666666666666668
ECU-013581,2122,841,415,426,30,28.033333333333335
ECU-013582,2122,104,50,54,4,26.0
ECU-013583,2122,124,74,50,3,41.333333333333336
ECU-013584,2122,57,34,23,8,7.125
ECU-013585,2122,520,259,261,16,32.5
ECU-013586,2122,135,59,76,6,22.5
ECU-013587,2122,233,135,98,12,19.416666666666668
ECU-013588,2122,311,146,165,9,34.55555555555556
ECU-013589,2122,66,27,39,7,9.428571428571429
ECU-013590,2122,6,1,5,3,2.0
ECU-013591,2122,1053,81,972,74,14.22972972972973
ECU-013592,2122,591,319,272,25,23.64
ECU-013593,2122,901,434,467,26,34.65384615384615
ECU-013594,2122,422,215,207,15,28.133333333333333
ECU-013595,2122,813,392,421,125,6.504
ECU-013596,2122,2812,1509,1303,70,40.17142857142857
ECU-013597,2122,161,83,78,13,12.384615384615385
ECU-013598,2122,984,518,466,30,32.8
ECU-013599,2122,607,303,304,16,37.9375
ECU-013600,2122,116,52,64,8,14.5
ECU-013601,2122,807,401,406,25,32.28
ECU-013602,2122,1246,611,635,43,28.976744186046513
ECU-013603,2122,9,5,4,2,4.5
ECU-013604,2122,338,157,181,19,17.789473684210527
ECU-013605,2122,985,498,487,28,35.17857142857143
ECU-013606,2122,739,382,357,30,24.633333333333333
ECU-013607,2122,204,105,99,9,22.666666666666668
ECU-013608,2122,230,119,111,8,28.75
ECU-013609,2122,904,432,472,28,32.285714285714285
ECU-013610,2122,288,147,141,17,16.941176470588236
ECU-013611,2122,206,88,118,8,25.75
ECU-013612,2122,1063,540,523,42,25.30952380952381
ECU-013613,2122,1187,637,550,68,17.455882352941178
ECU-013614,2122,307,161,146,16,19.1875
ECU-013615,2122,24,14,10,2,12.0
ECU-013616,2122,997,491,506,28,35.607142857142854
ECU-013617,2122,3540,1904,1636,136,26.029411764705884
ECU-013618,2122,458,223,235,16,28.625
ECU-013619,2122,35,16,19,3,11.666666666666666
ECU-013620,2122,1104,542,562,34,32.470588235294116
ECU-013621,2122,180,86,94,10,18.0
ECU-013622,2122,721,362,359,21,34.333333333333336
ECU-013623,2122,332,164,168,32,10.375
ECU-013624,2122,379,215,164,15,25.266666666666666
ECU-013625,2122,608,303,305,21,28.952380952380953
ECU-013626,2122,595,294,301,17,35.0
ECU-013627,2122,526,235,291,34,15.470588235294118
ECU-013628,2122,2589,1330,1259,87,29.75862068965517
ECU-013629,2122,189,78,111,15,12.6
ECU-013630,2122,555,278,277,43,12.906976744186046
ECU-013631,2122,337,174,163,11,30.636363636363637
ECU-013632,2122,246,125,121,13,18.923076923076923
ECU-013633,2122,209,105,104,8,26.125
ECU-013634,2122,114,51,63,9,12.666666666666666
ECU-013635,2122,189,96,93,9,21.0
ECU-013636,2122,213,101,112,6,35.5
ECU-013637,2122,540,268,272,18,30.0
ECU-013638,2122,127,58,69,8,15.875
ECU-013639,2122,768,358,410,21,36.57142857142857
ECU-013640,2122,303,148,155,10,30.3
ECU-013641,2122,148,77,71,6,24.666666666666668
ECU-013642,2122,229,121,108,17,13.470588235294118
ECU-013643,2122,18,7,11,3,6.0
ECU-013644,2122,1223,588,635,37,33.054054054054056
ECU-013645,2122,1088,546,542,44,24.727272727272727
ECU-013646,2122,47,18,29,9,5.222222222222222
ECU-013647,2122,355,185,170,14,25.357142857142858
ECU-013648,2122,163,90,73,8,20.375
ECU-013649,2122,97,49,48,9,10.777777777777779
ECU-013650,2122,5,1,4,2,2.5
ECU-013651,2122,67,31,36,11,6.090909090909091
ECU-013652,2122,713,365,348,24,29.708333333333332
ECU-013653,2122,685,387,298,11,62.27272727272727
ECU-013654,2122,733,384,349,26,28.192307692307693
ECU-013655,2122,891,449,442,26,34.26923076923077
ECU-013656,2122,227,118,109,10,22.7
ECU-013657,2122,562,268,294,16,35.125
ECU-013658,2122,200,97,103,18,11.11111111111111
ECU-013659,2122,639,300,339,22,29.045454545454547
ECU-013660,2122,382,168,214,15,25.466666666666665
ECU-013661,2122,531,273,258,17,31.235294117647058
ECU-013662,2122,807,401,406,26,31.03846153846154
ECU-013663,2122,108,50,58,6,18.0
ECU-013664,2122,201,118,83,7,28.714285714285715
ECU-013665,2122,243,125,118,9,27.0
ECU-013666,2122,20,10,10,7,2.857142857142857
ECU-013667,2122,155,79,76,8,19.375
ECU-013668,2122,668,381,287,35,19.085714285714285
ECU-013669,2122,214,115,99,13,16.46153846153846
ECU-013670,2122,474,214,260,19,24.94736842105263
ECU-013671,2122,44,28,16,8,5.5
ECU-013672,2122,316,162,154,25,12.64
ECU-013673,2122,2127,1048,1079,57,37.31578947368421
ECU-013674,2122,330,158,172,10,33.0
ECU-013675,2122,77,39,38,10,7.7
ECU-013676,2122,120,56,64,9,13.333333333333334
ECU-013677,2122,180,93,87,8,22.5
ECU-013678,2122,355,190,165,15,23.666666666666668
ECU-013679,2122,284,132,152,11,25.818181818181817
ECU-013680,2122,255,118,137,21,12.142857142857142
ECU-013681,2122,954,508,446,35,27.257142857142856
ECU-013682,2122,285,140,145,9,31.666666666666668
ECU-013683,2122,408,199,209,30,13.6
ECU-013684,2122,220,98,122,10,22.0
ECU-013685,2122,996,546,450,14,71.14285714285714
ECU-013686,2122,711,355,356,27,26.333333333333332
ECU-013687,2122,693,141,552,36,19.25
ECU-013688,2122,13,8,5,3,4.333333333333333
ECU-013689,2122,263,140,123,11,23.90909090909091
ECU-013690,2122,1485,831,654,44,33.75
ECU-013691,2122,222,108,114,9,24.666666666666668
ECU-013692,2122,645,0,645,27,23.88888888888889
ECU-013693,2122,10,4,6,2,5.0
ECU-013694,2122,1190,569,621,31,38.38709677419355
ECU-013695,2122,188,104,84,11,17.09090909090909
ECU-013696,2122,118,60,58,7,16.857142857142858
ECU-013697,2122,20,9,11,4,5.0
ECU-013698,2122,148,76,72,6,24.666666666666668
ECU-013699,2122,171,76,95,18,9.5
ECU-013700,2122,61,23,38,16,3.8125
ECU-013701,2122,974,425,549,30,32.46666666666667
ECU-013702,2122,972,457,515,37,26.27027027027027
ECU-013703,2122,263,136,127,11,23.90909090909091
ECU-013704,2122,126,59,67,6,21.0
ECU-013705,2122,159,81,78,8,19.875
ECU-013706,2122,368,181,187,13,28.307692307692307
ECU-013707,2122,1309,623,686,36,36.361111111111114
ECU-013708,2122,252,132,120,9,28.0
ECU-013709,2122,1130,145,985,69,16.3768115942029
ECU-013710,2122,812,373,439,23,35.30434782608695
ECU-013711,2122,377,176,201,13,29.0
ECU-013712,2122,127,63,64,12,10.583333333333334
ECU-013713,2122,94,51,43,7,13.428571428571429
ECU-013714,2122,969,440,529,24,40.375
ECU-013715,2122,179,97,82,8,22.375
ECU-013716,2122,86,39,47,6,14.333333333333334
ECU-013717,2122,162,66,96,8,20.25
ECU-013718,2122,175,77,98,6,29.166666666666668
ECU-013719,2122,270,150,120,19,14.210526315789474
ECU-013720,2122,281,139,142,9,31.22222222222222
ECU-013721,2122,840,416,424,21,40.0
ECU-013722,2122,187,83,104,11,17.0
ECU-013723,2122,109,58,51,4,27.25
ECU-013724,2122,532,269,263,19,28.0
ECU-013725,2122,61,32,29,2,30.5
ECU-013726,2122,49,26,23,5,9.8
ECU-013727,2122,458,221,237,14,32.714285714285715
ECU-013728,2122,102,51,51,10,10.2
ECU-013729,2122,195,96,99,8,24.375
ECU-013730,2122,1166,571,595,39,29.897435897435898
ECU-013731,2122,720,379,341,22,32.72727272727273
ECU-013732,2122,258,121,137,9,28.666666666666668
ECU-013733,2122,995,514,481,19,52.36842105263158
ECU-013734,2122,189,90,99,11,17.181818181818183
ECU-013735,2122,191,102,89,8,23.875
ECU-013736,2122,303,152,151,9,33.666666666666664
ECU-013737,2122,1361,1340,21,76,17.907894736842106
ECU-013738,2122,108,54,54,9,12.0
ECU-013739,2122,768,384,384,23,33.391304347826086
ECU-013740,2122,3087,1398,1689,119,25.941176470588236
ECU-013741,2122,701,401,300,11,63.72727272727273
ECU-013742,2122,638,316,322,19,33.578947368421055
ECU-013743,2122,72,24,48,15,4.8
ECU-013744,2122,2225,1065,1160,59,37.71186440677966
ECU-013745,2122,693,321,372,86,8.05813953488372
ECU-013746,2122,528,235,293,20,26.4
ECU-013747,2122,81,38,43,8,10.125
ECU-013748,2122,62,25,37,12,5.166666666666667
ECU-013749,2122,263,127,136,9,29.22222222222222
ECU-013750,2122,202,106,96,7,28.857142857142858
ECU-013751,2122,1458,705,753,58,25.137931034482758
ECU-013752,2122,1185,492,693,77,15.38961038961039
ECU-013753,2122,488,242,246,13,37.53846153846154
ECU-013754,2122,776,396,380,26,29.846153846153847
ECU-013755,2122,810,397,413,21,38.57142857142857
ECU-013756,2122,996,499,497,36,27.666666666666668
ECU-013757,2122,120,65,55,3,40.0
ECU-013758,2122,333,168,165,8,41.625
ECU-013759,2122,196,85,111,7,28.0
ECU-013760,2122,1399,740,659,53,26.39622641509434
ECU-013761,2122,264,136,128,8,33.0
ECU-013762,2122,300,164,136,9,33.333333333333336
ECU-013763,2122,847,448,399,97,8.731958762886597
ECU-013764,2122,801,392,409,23,34.82608695652174
ECU-013765,2122,163,79,84,10,16.3
ECU-013766,2122,28,10,18,5,5.6
ECU-013767,2122,197,104,93,9,21.88888888888889
ECU-013768,2122,66,20,46,6,11.0
ECU-013769,2122,474,244,230,19,24.94736842105263
ECU-013770,2122,648,327,321,23,28.17391304347826
ECU-013771,2122,206,106,100,17,12.117647058823529
ECU-013772,2122,1077,537,540,33,32.63636363636363
ECU-013773,2122,186,84,102,7,26.571428571428573
ECU-013774,2122,275,147,128,10,27.5
ECU-013775,2122,22,13,9,6,3.6666666666666665
ECU-013776,2122,44,20,24,9,4.888888888888889
ECU-013777,2122,875,410,465,79,11.075949367088608
ECU-013778,2122,184,91,93,14,13.142857142857142
ECU-013779,2122,58,23,35,8,7.25
ECU-013780,2122,1216,607,609,38,32.0
ECU-013781,2122,498,316,182,15,33.2
ECU-013782,2122,394,392,2,40,9.85
ECU-013783,2122,16,10,6,4,4.0
ECU-013784,2122,7,3,4,1,7.0
ECU-013785,2122,1052,500,552,40,26.3
ECU-013786,2122,223,99,124,9,24.77777777777778
ECU-013787,2122,164,84,80,11,14.909090909090908
ECU-013788,2122,178,76,102,18,9.88888888888889
ECU-013789,2122,660,337,323,43,15.348837209302326
ECU-013790,2122,413,200,213,13,31.76923076923077
ECU-013791,2122,798,374,424,29,27.517241379310345
ECU-013792,2122,151,73,78,9,16.77777777777778
ECU-013793,2122,241,131,110,15,16.066666666666666
ECU-013794,2122,1856,876,980,47,39.48936170212766
ECU-013795,2122,215,103,112,15,14.333333333333334
ECU-013796,2122,104,51,53,8,13.0
ECU-013797,2122,592,279,313,17,34.8235294117647
ECU-013798,2122,503,243,260,15,33.53333333333333
ECU-013799,2122,324,161,163,16,20.25
ECU-013800,2122,10,3,7,5,2.0
ECU-013801,2122,30,13,17,2,15.0
ECU-013802,2122,410,211,199,20,20.5
ECU-013803,2122,416,214,202,14,29.714285714285715
ECU-013804,2122,30,21,9,2,15.0
ECU-013805,2122,308,146,162,13,23.692307692307693
ECU-013806,2122,1026,507,519,31,33.096774193548384
ECU-013807,2122,833,441,392,25,33.32
ECU-013808,2122,1211,586,625,33,36.696969696969695
ECU-013809,2122,145,74,71,10,14.5
ECU-013810,2122,544,282,262,25,21.76
ECU-013811,2122,586,311,275,20,29.3
ECU-013812,2122,477,260,217,18,26.5
ECU-013813,2122,391,190,201,11,35.54545454545455
ECU-013814,2122,253,127,126,10,25.3
ECU-013815,2122,212,99,113,8,26.5
ECU-013816,2122,408,202,206,23,17.73913043478261
ECU-013817,2122,138,62,76,7,19.714285714285715
ECU-013818,2122,299,151,148,10,29.9
ECU-013819,2122,317,153,164,17,18.647058823529413
ECU-013820,2122,322,164,158,5,64.4
ECU-013821,2122,66,33,33,5,13.2
ECU-013822,2122,400,202,198,12,33.333333333333336
ECU-013823,2122,295,164,131,9,32.77777777777778
ECU-013824,2122,734,348,386,40,18.35
ECU-013825,2122,185,77,108,9,20.555555555555557
ECU-013826,2122,882,477,405,27,32.666666666666664
ECU-013827,2122,117,56,61,7,16.714285714285715
ECU-013828,2122,517,261,256,22,23.5
ECU-013829,2122,76,32,44,4,19.0
ECU-013830,2122,1239,610,629,34,36.44117647058823
ECU-013831,2122,161,79,82,8,20.125
ECU-013832,2122,180,92,88,9,20.0
ECU-013833,2122,60,19,41,5,12.0
ECU-013834,2122,10,4,6,2,5.0
ECU-013835,2122,865,459,406,25,34.6
ECU-013836,2122,1037,518,519,38,27.289473684210527
ECU-013837,2122,217,119,98,9,24.11111111111111
ECU-013838,2122,1298,659,639,49,26.489795918367346
ECU-013839,2122,978,428,550,39,25.076923076923077
ECU-013840,2122,569,295,274,18,31.61111111111111
ECU-013841,2122,739,366,373,30,24.633333333333333
ECU-013842,2122,204,93,111,12,17.0
ECU-013843,2122,109,51,58,7,15.571428571428571
ECU-013844,2122,608,299,309,26,23.384615384615383
ECU-013845,2122,4142,2103,2039,147,28.17687074829932
ECU-013846,2122,240,115,125,6,40.0
ECU-013847,2122,248,126,122,10,24.8
ECU-013848,2122,159,88,71,8,19.875
ECU-013849,2122,900,436,464,22,40.90909090909091
ECU-013850,2122,290,168,122,10,29.0
ECU-013851,2122,256,130,126,11,23.272727272727273
ECU-013852,2122,167,83,84,6,27.833333333333332
ECU-013853,2122,114,45,69,5,22.8
ECU-013854,2122,287,130,157,10,28.7
ECU-013855,2122,246,138,108,10,24.6
ECU-013856,2122,397,211,186,21,18.904761904761905
ECU-013857,2122,50,22,28,16,3.125
ECU-013858,2122,99,54,45,6,16.5
ECU-013859,2122,86,38,48,11,7.818181818181818
ECU-013860,2122,78,34,44,12,6.5
ECU-013861,2122,193,191,2,15,12.866666666666667
ECU-013862,2122,513,255,258,16,32.0625
ECU-013863,2122,362,186,176,29,12.482758620689655
ECU-013864,2122,995,462,533,31,32.096774193548384
ECU-013865,2122,344,165,179,12,28.666666666666668
ECU-013866,2122,908,423,485,27,33.629629629629626
ECU-013867,2122,714,280,434,49,14.571428571428571
ECU-013868,2122,44,22,22,8,5.5
ECU-013869,2122,2175,1032,1143,90,24.166666666666668
ECU-013870,2122,497,242,255,17,29.235294117647058
ECU-013871,2122,599,278,321,19,31.526315789473685
ECU-013872,2122,288,165,123,12,24.0
ECU-013873,2122,540,272,268,16,33.75
ECU-013874,2122,1399,713,686,40,34.975
ECU-013875,2122,330,185,145,19,17.36842105263158
ECU-013876,2122,1534,736,798,43,35.674418604651166
ECU-013877,2122,137,75,62,6,22.833333333333332
ECU-013878,2122,43,16,27,7,6.142857142857143
ECU-013879,2122,211,103,108,10,21.1
ECU-013880,2122,125,70,55,5,25.0
ECU-013881,2122,1588,1155,433,83,19.132530120481928
ECU-013882,2122,125,66,59,4,31.25
ECU-013883,2122,482,272,210,19,25.36842105263158
ECU-013884,2122,1338,676,662,50,26.76
ECU-013885,2122,312,163,149,11,28.363636363636363
ECU-013886,2122,86,40,46,5,17.2
ECU-013887,2122,211,103,108,11,19.181818181818183
ECU-013888,2122,38,14,24,3,12.666666666666666
ECU-013889,2122,197,108,89,4,49.25
ECU-013890,2122,1936,1043,893,81,23.901234567901234
ECU-013891,2122,619,284,335,19,32.578947368421055
ECU-013892,2122,620,297,323,19,32.63157894736842
ECU-013893,2122,154,77,77,13,11.846153846153847
ECU-013894,2122,921,453,468,22,41.86363636363637
ECU-013895,2122,41,20,21,8,5.125
ECU-013896,2122,1080,562,518,42,25.714285714285715
ECU-013897,2122,896,480,416,20,44.8
ECU-013898,2122,1359,687,672,36,37.75
ECU-013899,2122,22,12,10,2,11.0
ECU-013900,2122,341,179,162,12,28.416666666666668
ECU-013901,2122,590,300,290,19,31.05263157894737
ECU-013902,2122,68,36,32,6,11.333333333333334
ECU-013903,2122,126,66,60,7,18.0
ECU-013904,2122,845,400,445,25,33.8
ECU-013905,2122,1570,805,765,48,32.708333333333336
ECU-013906,2122,2588,1257,1331,70,36.97142857142857
ECU-013907,2122,869,431,438,18,48.27777777777778
ECU-013908,2122,582,274,308,18,32.333333333333336
ECU-013909,2122,2533,1249,1284,64,39.578125
ECU-013910,2122,386,195,191,12,32.166666666666664
ECU-013911,2122,704,331,373,20,35.2
ECU-013912,2122,405,205,200,13,31.153846153846153
ECU-013913,2122,121,66,55,8,15.125
ECU-013914,2122,2159,957,1202,108,19.99074074074074
ECU-013915,2122,14,8,6,3,4.666666666666667
ECU-013916,2122,53,28,25,4,13.25
ECU-013917,2122,477,238,239,17,28.058823529411764
ECU-013918,2122,1960,865,1095,39,50.256410256410255
ECU-013919,2122,524,263,261,21,24.952380952380953
ECU-013920,2122,31,15,16,9,3.4444444444444446
ECU-013921,2122,13,6,7,2,6.5
ECU-013922,2122,503,229,274,16,31.4375
ECU-013923,2122,16,7,9,5,3.2
ECU-013924,2122,1317,713,604,46,28.630434782608695
ECU-013925,2122,1157,151,1006,108,10.712962962962964
ECU-013926,2122,1022,1022,0,78,13.102564102564102
ECU-013927,2122,107,38,69,6,17.833333333333332
ECU-013928,2122,978,488,490,73,13.397260273972602
ECU-013929,2122,451,227,224,38,11.868421052631579
ECU-013930,2122,2146,1041,1105,70,30.65714285714286
ECU-013931,2122,156,64,92,8,19.5
ECU-013932,2122,570,284,286,22,25.90909090909091
ECU-013933,2122,81,37,44,7,11.571428571428571
ECU-013934,2122,137,79,58,7,19.571428571428573
ECU-013935,2122,1377,668,709,46,29.934782608695652
ECU-013936,2122,122,64,58,8,15.25
ECU-013937,2122,586,289,297,27,21.703703703703702
ECU-013938,2122,454,222,232,11,41.27272727272727
ECU-013939,2122,118,57,61,13,9.076923076923077
ECU-013940,2122,136,61,75,11,12.363636363636363
ECU-013941,2122,1142,608,534,36,31.72222222222222
ECU-013942,2122,633,304,329,20,31.65
ECU-013943,2122,182,89,93,7,26.0
ECU-013944,2122,462,218,244,15,30.8
ECU-013945,2122,778,372,406,24,32.416666666666664
ECU-013946,2122,649,431,218,34,19.08823529411765
ECU-013947,2122,576,276,300,22,26.181818181818183
ECU-013948,2122,239,93,146,11,21.727272727272727
ECU-013949,2122,129,1,128,8,16.125
ECU-013950,2122,35,17,18,9,3.888888888888889
ECU-013951,2122,928,457,471,35,26.514285714285716
ECU-013952,2122,13,8,5,3,4.333333333333333
ECU-013953,2122,570,282,288,17,33.529411764705884
ECU-013954,2122,231,111,120,9,25.666666666666668
ECU-013955,2122,99,51,48,8,12.375
ECU-013956,2122,430,131,299,26,16.53846153846154
ECU-013957,2122,3913,1912,2001,110,35.57272727272727
ECU-013958,2122,1359,746,613,41,33.146341463414636
ECU-013959,2122,1529,826,703,65,23.523076923076925
ECU-013960,2122,84,41,43,7,12.0
ECU-013961,2122,1889,1014,875,59,32.016949152542374
ECU-013962,2122,6,0,6,2,3.0
ECU-013963,2122,1281,342,939,71,18.04225352112676
ECU-013964,2122,215,108,107,8,26.875
ECU-013965,2122,38,16,22,2,19.0
ECU-013966,2122,89,48,41,5,17.8
ECU-013967,2122,287,132,155,10,28.7
ECU-013968,2122,201,98,103,5,40.2
ECU-013969,2122,693,353,340,23,30.130434782608695
ECU-013970,2122,712,547,165,63,11.301587301587302
ECU-013971,2122,116,44,72,8,14.5
ECU-013972,2122,192,93,99,7,27.428571428571427
ECU-013973,2122,2226,745,1481,90,24.733333333333334
ECU-013974,2122,169,77,92,13,13.0
ECU-013975,2122,835,409,426,25,33.4
ECU-013976,2122,22,8,14,7,3.142857142857143
ECU-013977,2122,834,425,409,30,27.8
ECU-013978,2122,748,360,388,53,14.11320754716981
ECU-013979,2122,69,32,37,9,7.666666666666667
ECU-013980,2122,1429,714,715,59,24.220338983050848
ECU-013981,2122,359,132,227,26,13.807692307692308
ECU-013982,2122,1251,594,657,45,27.8
ECU-013983,2122,119,68,51,8,14.875
ECU-013984,2122,309,143,166,9,34.333333333333336
ECU-013985,2122,201,87,114,7,28.714285714285715
ECU-013986,2122,77,39,38,8,9.625
ECU-013987,2122,255,148,107,10,25.5
ECU-013988,2122,629,318,311,17,37.0
ECU-013989,2122,204,94,110,7,29.142857142857142
ECU-013990,2122,50,28,22,3,16.666666666666668
ECU-013991,2122,23,11,12,3,7.666666666666667
ECU-013992,2122,140,67,73,7,20.0
ECU-013993,2122,391,207,184,13,30.076923076923077
ECU-013994,2122,1847,999,848,59,31.305084745762713
ECU-013995,2122,134,70,64,8,16.75
ECU-013996,2122,312,148,164,18,17.333333333333332
ECU-013997,2122,203,98,105,7,29.0
ECU-013998,2122,1224,569,655,32,38.25
ECU-013999,2122,594,297,297,18,33.0
ECU-014000,2122,1170,730,440,76,15.394736842105264
ECU-014001,2122,169,74,95,7,24.142857142857142
ECU-014002,2122,604,296,308,16,37.75
ECU-014003,2122,152,67,85,9,16.88888888888889
ECU-014004,2122,1097,528,569,33,33.24242424242424
ECU-014005,2122,2063,984,1079,68,30.33823529411765
ECU-014006,2122,380,192,188,13,29.23076923076923
ECU-014007,2122,32,17,15,6,5.333333333333333
ECU-014008,2122,211,107,104,18,11.722222222222221
ECU-014009,2122,458,218,240,12,38.166666666666664
ECU-014010,2122,216,117,99,6,36.0
ECU-014011,2122,1679,754,925,60,27.983333333333334
ECU-014012,2122,622,304,318,35,17.771428571428572
ECU-014013,2122,84,50,34,7,12.0
ECU-014014,2122,261,136,125,9,29.0
ECU-014015,2122,538,294,244,16,33.625
ECU-014016,2122,93,45,48,6,15.5
ECU-014017,2122,88,46,42,5,17.6
ECU-014018,2122,92,38,54,4,23.0
ECU-014019,2122,1075,554,521,35,30.714285714285715
ECU-014020,2122,176,65,111,12,14.666666666666666
ECU-014021,2122,183,93,90,11,16.636363636363637
ECU-014022,2122,19,15,4,5,3.8
ECU-014023,2122,478,224,254,24,19.916666666666668
ECU-014024,2122,266,136,130,9,29.555555555555557
ECU-014025,2122,17,6,11,4,4.25
ECU-014026,2122,521,259,262,16,32.5625
ECU-014027,2122,47,18,29,2,23.5
ECU-014028,2122,257,127,130,7,36.714285714285715
ECU-014029,2122,11,7,4,10,1.1
ECU-014030,2122,648,336,312,24,27.0
ECU-014031,2122,1211,518,693,35,34.6
ECU-014032,2122,993,494,499,27,36.77777777777778
ECU-014033,2122,23,9,14,4,5.75
ECU-014034,2122,351,168,183,13,27.0
ECU-014035,2122,1196,621,575,44,27.181818181818183
ECU-014036,2122,59,28,31,9,6.555555555555555
ECU-014037,2122,5,2,3,1,5.0
ECU-014038,2122,548,264,284,17,32.23529411764706
ECU-014039,2122,354,190,164,9,39.333333333333336
ECU-014040,2122,195,103,92,10,19.5
ECU-014041,2122,722,347,375,22,32.81818181818182
ECU-014042,2122,2,0,2,1,2.0
ECU-014043,2122,370,206,164,20,18.5
ECU-014044,2122,654,324,330,17,38.470588235294116
ECU-014045,2122,566,297,269,22,25.727272727272727
ECU-014046,2122,222,94,128,22,10.090909090909092
ECU-014047,2122,161,82,79,7,23.0
ECU-014048,2122,1082,582,500,40,27.05
ECU-014049,2122,5,1,4,2,2.5
ECU-014050,2122,28,14,14,3,9.333333333333334
ECU-014051,2122,2,0,2,2,1.0
ECU-014052,2122,186,100,86,7,26.571428571428573
ECU-014053,2122,344,173,171,25,13.76
ECU-014054,2122,28,13,15,4,7.0
ECU-014055,2122,53,27,26,5,10.6
ECU-014056,2122,123,60,63,7,17.571428571428573
ECU-014057,2122,55,33,22,9,6.111111111111111
ECU-014058,2122,586,288,298,16,36.625
ECU-014059,2122,1521,705,816,40,38.025
ECU-014060,2122,437,196,241,10,43.7
ECU-014061,2122,211,100,111,10,21.1
ECU-014062,2122,685,328,357,23,29.782608695652176
ECU-014063,2122,327,175,152,16,20.4375
ECU-014064,2122,1481,704,777,42,35.26190476190476
ECU-014065,2122,201,93,108,9,22.333333333333332
ECU-014066,2122,258,121,137,13,19.846153846153847
ECU-014067,2122,2159,1097,1062,64,33.734375
ECU-014068,2122,726,404,322,14,51.857142857142854
ECU-014069,2122,763,368,395,14,54.5
ECU-014070,2122,332,146,186,14,23.714285714285715
ECU-014071,2122,157,83,74,15,10.466666666666667
ECU-014072,2122,66,28,38,10,6.6
ECU-014073,2122,544,252,292,15,36.266666666666666
ECU-014074,2122,31,10,21,3,10.333333333333334
ECU-014075,2122,918,450,468,25,36.72
ECU-014076,2122,630,326,304,17,37.05882352941177
ECU-014077,2122,1006,480,526,28,35.92857142857143
ECU-014078,2122,102,43,59,10,10.2
ECU-014079,2122,30,12,18,3,10.0
ECU-014080,2122,206,102,104,10,20.6
ECU-014081,2122,52,28,24,6,8.666666666666666
ECU-014082,2122,911,481,430,40,22.775
ECU-014083,2122,44,20,24,7,6.285714285714286
ECU-014084,2122,44,19,25,4,11.0
ECU-014085,2122,451,211,240,14,32.214285714285715
ECU-014086,2122,183,85,98,12,15.25
ECU-014087,2122,560,273,287,15,37.333333333333336
ECU-014088,2122,517,257,260,16,32.3125
ECU-014089,2122,201,113,88,7,28.714285714285715
ECU-014090,2122,103,0,103,4,25.75
ECU-014091,2122,224,111,113,12,18.666666666666668
ECU-014092,2122,561,75,486,39,14.384615384615385
ECU-014093,2122,1128,552,576,28,40.285714285714285
ECU-014094,2122,678,327,351,19,35.68421052631579
ECU-014095,2122,23,7,16,4,5.75
ECU-014096,2122,910,416,494,24,37.916666666666664
ECU-014097,2122,1308,610,698,39,33.53846153846154
ECU-014098,2122,70,32,38,6,11.666666666666666
ECU-014099,2122,366,186,180,15,24.4
ECU-014100,2122,347,174,173,13,26.692307692307693
ECU-014101,2122,393,196,197,13,30.23076923076923
ECU-014102,2122,156,79,77,9,17.333333333333332
ECU-014103,2122,93,52,41,3,31.0
ECU-014104,2122,1267,675,592,50,25.34
ECU-014105,2122,1106,551,555,34,32.529411764705884
ECU-014106,2122,169,83,86,14,12.071428571428571
ECU-014107,2122,55,25,30,6,9.166666666666666
ECU-014108,2122,858,448,410,24,35.75
ECU-014109,2122,151,80,71,7,21.571428571428573
ECU-014110,2122,39,13,26,6,6.5
ECU-014111,2122,249,98,151,36,6.916666666666667
ECU-014112,2122,109,44,65,13,8.384615384615385
ECU-014113,2122,153,67,86,9,17.0
ECU-014114,2122,673,321,352,22,30.59090909090909
ECU-014115,2122,124,59,65,11,11.272727272727273
ECU-014116,2122,525,243,282,13,40.38461538461539
ECU-014117,2122,671,345,326,19,35.31578947368421
ECU-014118,2122,260,132,128,9,28.88888888888889
ECU-014119,2122,372,178,194,11,33.81818181818182
ECU-014120,2122,551,262,289,22,25.045454545454547
ECU-014121,2122,30,15,15,6,5.0
ECU-014122,2122,95,42,53,13,7.3076923076923075
ECU-014123,2122,2409,1228,1181,72,33.458333333333336
ECU-014124,2122,642,319,323,18,35.666666666666664
ECU-014125,2122,573,281,292,16,35.8125
ECU-014126,2122,133,71,62,12,11.083333333333334
ECU-014127,2122,484,237,247,13,37.23076923076923
ECU-014128,2122,1049,602,447,44,23.84090909090909
ECU-014129,2122,536,263,273,13,41.23076923076923
ECU-014130,2122,2156,1050,1106,75,28.746666666666666
ECU-014131,2122,83,40,43,8,10.375
ECU-014132,2122,825,408,417,20,41.25
ECU-014133,2122,22,7,15,4,5.5
ECU-014134,2122,989,474,515,27,36.629629629629626
ECU-014135,2122,332,153,179,30,11.066666666666666
ECU-014136,2122,1093,586,507,34,32.14705882352941
ECU-014137,2122,878,450,428,24,36.583333333333336
ECU-014138,2122,252,122,130,11,22.90909090909091
ECU-014139,2122,620,319,301,20,31.0
ECU-014140,2122,406,190,216,21,19.333333333333332
ECU-014141,2122,2594,1274,1320,71,36.53521126760563
ECU-014142,2122,56,31,25,12,4.666666666666667
ECU-014143,2122,71,31,40,2,35.5
ECU-014144,2122,522,250,272,19,27.473684210526315
ECU-014145,2122,122,61,61,10,12.2
ECU-014146,2122,351,183,168,11,31.90909090909091
ECU-014147,2122,542,278,264,19,28.526315789473685
ECU-014148,2122,213,103,110,9,23.666666666666668
ECU-014149,2122,340,168,172,18,18.88888888888889
ECU-014150,2122,1046,526,520,32,32.6875
ECU-014151,2122,717,469,248,36,19.916666666666668
ECU-014152,2122,1223,574,649,30,40.766666666666666
ECU-014153,2122,352,182,170,10,35.2
ECU-014154,2122,1403,611,792,57,24.614035087719298
ECU-014155,2122,19,12,7,4,4.75
ECU-014156,2122,125,79,46,7,17.857142857142858
ECU-014157,2122,1036,508,528,29,35.724137931034484
ECU-014158,2122,227,122,105,10,22.7
ECU-014159,2122,57,29,28,6,9.5
ECU-014160,2122,219,91,128,10,21.9
ECU-014161,2122,408,191,217,13,31.384615384615383
ECU-014162,2122,447,226,221,14,31.928571428571427
ECU-014163,2122,109,52,57,7,15.571428571428571
ECU-014164,2122,602,314,288,19,31.68421052631579
ECU-014165,2122,220,116,104,6,36.666666666666664
ECU-014166,2122,1093,519,574,31,35.25806451612903
ECU-014167,2122,1440,726,714,62,23.225806451612904
ECU-014168,2122,2742,1338,1404,96,28.5625
ECU-014169,2122,348,170,178,33,10.545454545454545
ECU-014170,2122,2311,1131,1180,72,32.09722222222222
ECU-014171,2122,77,40,37,6,12.833333333333334
ECU-014172,2122,267,137,130,5,53.4
ECU-014173,2122,11,5,6,2,5.5
ECU-014174,2122,150,80,70,9,16.666666666666668
ECU-014175,2122,323,158,165,10,32.3
ECU-014176,2122,2671,1458,1213,94,28.414893617021278
ECU-014177,2122,55,31,24,4,13.75
ECU-014178,2122,156,71,85,8,19.5
ECU-014179,2122,100,52,48,11,9.090909090909092
ECU-014180,2122,175,84,91,10,17.5
ECU-014181,2122,222,76,146,11,20.181818181818183
ECU-014182,2122,50,15,35,7,7.142857142857143
ECU-014183,2122,158,57,101,10,15.8
ECU-014184,2122,492,285,207,28,17.571428571428573
ECU-014185,2122,853,437,416,24,35.541666666666664
ECU-014186,2122,1238,626,612,37,33.45945945945946
ECU-014187,2122,47,21,26,8,5.875
ECU-014188,2122,318,154,164,20,15.9
ECU-014189,2122,232,104,128,8,29.0
ECU-014190,2122,361,167,194,15,24.066666666666666
ECU-014191,2122,1094,548,546,35,31.257142857142856
ECU-014192,2122,736,380,356,22,33.45454545454545
ECU-014193,2122,36,19,17,7,5.142857142857143
ECU-014194,2122,2299,1234,1065,73,31.493150684931507
ECU-014195,2122,121,59,62,8,15.125
ECU-014196,2122,81,44,37,6,13.5
ECU-014197,2122,329,145,184,12,27.416666666666668
ECU-014198,2122,45,18,27,6,7.5
ECU-014199,2122,122,59,63,5,24.4
ECU-014200,2122,302,190,112,10,30.2
ECU-014201,2122,344,165,179,14,24.571428571428573
ECU-014202,2122,26,16,10,8,3.25
ECU-014203,2122,214,102,112,24,8.916666666666666
ECU-014204,2122,1239,610,629,44,28.15909090909091
ECU-014205,2122,1484,712,772,38,39.05263157894737
ECU-014206,2122,270,130,140,8,33.75
ECU-014207,2122,301,162,139,8,37.625
ECU-014208,2122,1205,617,588,35,34.42857142857143
ECU-014209,2122,236,116,120,24,9.833333333333334
ECU-014210,2122,78,35,43,11,7.090909090909091
ECU-014211,2122,545,265,280,18,30.27777777777778
ECU-014212,2122,21,11,10,1,21.0
ECU-014213,2122,489,246,243,18,27.166666666666668
ECU-014214,2122,987,498,489,119,8.294117647058824
ECU-014215,2122,253,121,132,11,23.0
ECU-014216,2122,307,182,125,10,30.7
ECU-014217,2122,247,124,123,10,24.7
ECU-014218,2122,709,360,349,38,18.657894736842106
ECU-014219,2122,293,146,147,38,7.7105263157894735
ECU-014220,2122,1088,514,574,76,14.31578947368421
ECU-014221,2122,174,90,84,9,19.333333333333332
ECU-014222,2122,254,137,117,12,21.166666666666668
ECU-014223,2122,571,270,301,22,25.954545454545453
ECU-014224,2122,301,166,135,10,30.1
ECU-014225,2122,283,127,156,8,35.375
ECU-014226,2122,648,309,339,18,36.0
ECU-014227,2122,340,164,176,12,28.333333333333332
ECU-014228,2122,36,18,18,2,18.0
ECU-014229,2122,99,48,51,4,24.75
ECU-014230,2122,595,303,292,28,21.25
ECU-014231,2122,186,110,76,18,10.333333333333334
ECU-014232,2122,584,287,297,19,30.736842105263158
ECU-014233,2122,119,63,56,5,23.8
ECU-014234,2122,294,117,177,9,32.666666666666664
ECU-014235,2122,117,68,49,4,29.25
ECU-014236,2122,153,69,84,6,25.5
ECU-014237,2122,299,153,146,9,33.22222222222222
ECU-014238,2122,120,67,53,4,30.0
ECU-014239,2122,3,1,2,1,3.0
ECU-014240,2122,2,0,2,1,2.0
ECU-014241,2122,15,10,5,2,7.5
ECU-014242,2122,747,371,376,24,31.125
ECU-014243,2122,49,27,22,2,24.5
ECU-014244,2122,142,64,78,3,47.333333333333336
ECU-014245,2122,1486,354,1132,35,42.457142857142856
ECU-014246,2122,926,448,478,32,28.9375
ECU-014247,2122,150,81,69,6,25.0
ECU-014248,2122,1690,840,850,52,32.5
ECU-014249,2122,1138,538,600,37,30.756756756756758
ECU-014250,2122,1094,539,555,35,31.257142857142856
ECU-014251,2122,761,382,379,26,29.26923076923077
ECU-014252,2122,296,132,164,12,24.666666666666668
ECU-014253,2122,190,110,80,7,27.142857142857142
ECU-014254,2122,286,149,137,12,23.833333333333332
ECU-014255,2122,64,37,27,3,21.333333333333332
ECU-014256,2122,1667,814,853,49,34.02040816326531
ECU-014257,2122,58,31,27,3,19.333333333333332
ECU-014258,2122,725,323,402,26,27.884615384615383
ECU-014259,2122,556,273,283,20,27.8
ECU-014260,2122,888,428,460,24,37.0
ECU-014261,2122,475,245,230,18,26.38888888888889
ECU-014262,2122,243,119,124,8,30.375
ECU-014263,2122,709,344,365,18,39.388888888888886
ECU-014264,2122,1582,770,812,43,36.7906976744186
ECU-014265,2122,81,42,39,7,11.571428571428571
ECU-014266,2122,2226,1149,1077,68,32.73529411764706
ECU-014267,2122,417,221,196,20,20.85
ECU-014268,2122,23,12,11,4,5.75
ECU-014269,2122,52,27,25,10,5.2
ECU-014270,2122,1093,543,550,32,34.15625
ECU-014271,2122,381,190,191,15,25.4
ECU-014272,2122,182,93,89,6,30.333333333333332
ECU-014273,2122,3249,1679,1570,85,38.22352941176471
ECU-014274,2122,637,306,331,17,37.470588235294116
ECU-014275,2122,1025,508,517,27,37.96296296296296
ECU-014276,2122,1184,605,579,31,38.193548387096776
ECU-014277,2122,268,143,125,10,26.8
ECU-014278,2122,422,190,232,13,32.46153846153846
ECU-014279,2122,58,31,27,7,8.285714285714286
ECU-014280,2122,21,10,11,2,10.5
ECU-014281,2122,1135,546,589,32,35.46875
ECU-014282,2122,508,266,242,16,31.75
ECU-014283,2122,83,36,47,3,27.666666666666668
ECU-014284,2122,322,169,153,13,24.76923076923077
ECU-014285,2122,84,42,42,3,28.0
ECU-014286,2122,126,64,62,5,25.2
ECU-014287,2122,288,159,129,12,24.0
ECU-014288,2122,337,162,175,16,21.0625
ECU-014289,2122,355,146,209,12,29.583333333333332
ECU-014290,2122,28,13,15,1,28.0
ECU-014291,2122,182,83,99,10,18.2
ECU-014292,2122,77,34,43,3,25.666666666666668
ECU-014293,2122,243,116,127,9,27.0
ECU-014294,2122,203,88,115,8,25.375
ECU-014295,2122,179,106,73,12,14.916666666666666
ECU-014296,2122,193,90,103,11,17.545454545454547
ECU-014297,2122,331,177,154,15,22.066666666666666
ECU-014298,2122,25,11,14,1,25.0
ECU-014299,2122,139,55,84,6,23.166666666666668
ECU-014300,2122,654,328,326,26,25.153846153846153
ECU-014301,2122,47,26,21,2,23.5
ECU-014302,2122,140,71,69,6,23.333333333333332
ECU-014303,2122,68,26,42,3,22.666666666666668
ECU-014304,2122,1732,857,875,61,28.39344262295082
ECU-014305,2122,297,143,154,10,29.7
ECU-014306,2122,131,67,64,7,18.714285714285715
ECU-014307,2122,428,213,215,12,35.666666666666664
ECU-014308,2122,1015,465,550,27,37.592592592592595
ECU-014309,2122,265,115,150,9,29.444444444444443
ECU-014310,2122,29,15,14,3,9.666666666666666
ECU-014311,2122,103,48,55,7,14.714285714285714
ECU-014312,2122,314,164,150,14,22.428571428571427
ECU-014313,2122,186,103,83,7,26.571428571428573
ECU-014314,2122,275,107,168,33,8.333333333333334
ECU-014315,2122,200,107,93,8,25.0
ECU-014316,2122,46,15,31,5,9.2
ECU-014317,2122,47,23,24,6,7.833333333333333
ECU-014318,2122,55,25,30,7,7.857142857142857
ECU-014319,2122,234,104,130,6,39.0
ECU-014320,2122,1609,867,742,58,27.74137931034483
ECU-014321,2122,286,140,146,13,22.0
ECU-014322,2122,2635,1332,1303,79,33.35443037974684
ECU-014323,2122,627,310,317,18,34.833333333333336
ECU-014324,2122,447,220,227,12,37.25
ECU-014325,2122,333,169,164,16,20.8125
ECU-014326,2122,149,81,68,9,16.555555555555557
ECU-014327,2122,1219,590,629,34,35.85294117647059
ECU-014328,2122,662,342,320,19,34.8421052631579
ECU-014329,2122,191,95,96,8,23.875
ECU-014330,2122,950,454,496,26,36.53846153846154
ECU-014331,2122,788,354,434,22,35.81818181818182
ECU-014332,2122,766,377,389,18,42.55555555555556
ECU-014333,2122,428,190,238,17,25.176470588235293
ECU-014334,2122,213,108,105,15,14.2
ECU-014335,2122,591,292,299,18,32.833333333333336
ECU-014336,2122,816,392,424,22,37.09090909090909
ECU-014337,2122,199,108,91,13,15.307692307692308
ECU-014338,2122,484,232,252,28,17.285714285714285
ECU-014339,2122,320,163,157,9,35.55555555555556
ECU-014340,2122,52,30,22,8,6.5
ECU-014341,2122,55,22,33,5,11.0
ECU-014342,2122,7,3,4,2,3.5
ECU-014343,2122,364,186,178,26,14.0
ECU-014344,2122,481,233,248,14,34.357142857142854
ECU-014345,2122,725,355,370,18,40.27777777777778
ECU-014346,2122,649,337,312,23,28.217391304347824
ECU-014347,2122,45,16,29,4,11.25
ECU-014348,2122,662,352,310,18,36.77777777777778
ECU-014349,2122,307,135,172,18,17.055555555555557
ECU-014350,2122,1687,829,858,39,43.256410256410255
ECU-014351,2122,732,399,333,28,26.142857142857142
ECU-014352,2122,1060,504,556,27,39.25925925925926
ECU-014353,2122,254,159,95,27,9.407407407407407
ECU-014354,2122,344,179,165,18,19.11111111111111
ECU-014355,2122,966,531,435,30,32.2
ECU-014356,2122,86,39,47,7,12.285714285714286
ECU-014357,2122,770,390,380,22,35.0
ECU-014358,2122,1296,599,697,33,39.27272727272727
ECU-014359,2122,99,41,58,3,33.0
ECU-014360,2122,118,54,64,10,11.8
ECU-014361,2122,1714,826,888,43,39.86046511627907
ECU-014362,2122,277,124,153,9,30.77777777777778
ECU-014363,2122,359,175,184,14,25.642857142857142
ECU-014364,2122,800,431,369,21,38.095238095238095
ECU-014365,2122,223,101,122,7,31.857142857142858
ECU-014366,2122,331,155,176,9,36.77777777777778
ECU-014367,2122,195,103,92,7,27.857142857142858
ECU-014368,2122,204,104,100,7,29.142857142857142
ECU-014369,2122,246,136,110,8,30.75
ECU-014370,2122,455,222,233,15,30.333333333333332
ECU-014371,2122,27,12,15,1,27.0
ECU-014372,2122,261,127,134,8,32.625
ECU-014373,2122,242,116,126,8,30.25
ECU-014374,2122,373,191,182,17,21.941176470588236
ECU-014375,2122,187,93,94,9,20.77777777777778
ECU-014376,2122,114,60,54,8,14.25
ECU-014377,2122,322,163,159,18,17.88888888888889
ECU-014378,2122,616,318,298,17,36.23529411764706
ECU-014379,2122,50,23,27,10,5.0
ECU-014380,2122,140,71,69,8,17.5
ECU-014381,2122,88,38,50,9,9.777777777777779
ECU-014382,2122,643,312,331,18,35.72222222222222
ECU-014383,2122,247,126,121,14,17.642857142857142
ECU-014384,2122,668,307,361,19,35.1578947368421
ECU-014385,2122,98,47,51,5,19.6
ECU-014386,2122,498,216,282,19,26.210526315789473
ECU-014387,2122,1120,575,545,52,21.53846153846154
ECU-014388,2122,2211,1086,1125,57,38.78947368421053
ECU-014389,2122,133,68,65,11,12.090909090909092
ECU-014390,2122,1197,582,615,31,38.61290322580645
ECU-014391,2122,76,37,39,5,15.2
ECU-014392,2122,241,123,118,7,34.42857142857143
ECU-014393,2122,355,157,198,9,39.44444444444444
ECU-014394,2122,744,392,352,25,29.76
ECU-014395,2122,282,144,138,12,23.5
ECU-014396,2122,6,3,3,1,6.0
ECU-014397,2122,638,312,326,18,35.44444444444444
ECU-014398,2122,145,139,6,4,36.25
ECU-014399,2122,948,460,488,27,35.111111111111114
ECU-014400,2122,979,472,507,28,34.964285714285715
ECU-014401,2122,22,10,12,1,22.0
ECU-014402,2122,44,15,29,1,44.0
ECU-014403,2122,18,8,10,1,18.0
ECU-014404,2122,197,100,97,5,39.4
ECU-014405,2122,5,3,2,3,1.6666666666666667
ECU-014406,2122,19,8,11,1,19.0
ECU-014407,2122,40,21,19,2,20.0
ECU-014408,2122,19,9,10,1,19.0
ECU-014409,2122,79,42,37,2,39.5
ECU-014410,2122,338,151,187,29,11.655172413793103
ECU-014411,2122,13,7,6,1,13.0
ECU-014412,2122,19,9,10,1,19.0
ECU-014413,2122,476,187,289,21,22.666666666666668
ECU-014414,2122,112,70,42,4,28.0
ECU-014415,2122,248,132,116,14,17.714285714285715
ECU-014416,2122,31,16,15,1,31.0
ECU-014417,2122,1545,765,780,55,28.09090909090909
ECU-014418,2122,26,12,14,1,26.0
ECU-014419,2122,14,9,5,1,14.0
ECU-014420,2122,747,360,387,21,35.57142857142857
ECU-014421,2122,45,14,31,2,22.5
ECU-014422,2122,22,10,12,1,22.0
ECU-014423,2122,130,66,64,4,32.5
ECU-014424,2122,1495,773,722,183,8.169398907103826
ECU-014425,2122,1248,621,627,50,24.96
ECU-014426,2122,26,10,16,1,26.0
ECU-014427,2122,16,7,9,1,16.0
ECU-014428,2122,119,60,59,5,23.8
ECU-014429,2122,114,45,69,4,28.5
ECU-014430,2122,12,7,5,1,12.0
ECU-014431,2122,227,125,102,5,45.4
ECU-014432,2122,11,7,4,1,11.0
ECU-014433,2122,228,115,113,9,25.333333333333332
ECU-014434,2122,138,62,76,4,34.5
ECU-014435,2122,90,43,47,3,30.0
ECU-014436,2122,30,21,9,1,30.0
ECU-014437,2122,164,82,82,6,27.333333333333332
ECU-014438,2122,16,7,9,1,16.0
ECU-014439,2122,48,25,23,2,24.0
ECU-014440,2122,8,3,5,1,8.0
ECU-014441,2122,109,58,51,3,36.333333333333336
ECU-014442,2122,63,34,29,2,31.5
ECU-014443,2122,263,130,133,13,20.23076923076923
ECU-014444,2122,61,29,32,2,30.5
ECU-014445,2122,25,13,12,1,25.0
ECU-014446,2122,52,19,33,1,52.0
ECU-014447,2122,29,17,12,1,29.0
ECU-014448,2122,55,23,32,2,27.5
ECU-014449,2122,890,483,407,32,27.8125
ECU-014450,2122,23,11,12,1,23.0
ECU-014451,2122,27,6,21,1,27.0
ECU-014452,2122,123,65,58,3,41.0
ECU-014453,2122,266,126,140,9,29.555555555555557
ECU-014454,2122,49,21,28,2,24.5
ECU-014455,2122,19,14,5,1,19.0
ECU-014456,2122,18,10,8,1,18.0
ECU-014457,2122,15,10,5,1,15.0
ECU-014458,2122,672,326,346,64,10.5
ECU-014459,2122,29,15,14,1,29.0
ECU-014460,2122,44,21,23,2,22.0
ECU-014461,2122,106,51,55,4,26.5
ECU-014462,2122,356,176,180,13,27.384615384615383
ECU-014463,2122,50,24,26,2,25.0
ECU-014464,2122,207,89,118,11,18.818181818181817
ECU-014465,2122,45,19,26,2,22.5
ECU-014466,2122,385,190,195,20,19.25
ECU-014467,2122,137,67,70,5,27.4
ECU-014468,2122,154,67,87,12,12.833333333333334
ECU-014469,2122,268,138,130,8,33.5
ECU-014470,2122,12,2,10,3,4.0
ECU-014471,2122,875,433,442,33,26.515151515151516
ECU-014472,2122,3,0,3,3,1.0
ECU-014473,2122,809,401,408,40,20.225
ECU-014474,2122,70,40,30,5,14.0
ECU-014475,2122,565,265,300,16,35.3125
ECU-014476,2122,1131,640,491,82,13.792682926829269
ECU-014477,2122,19,5,14,7,2.7142857142857144
ECU-014478,2122,213,100,113,6,35.5
ECU-014479,2122,154,74,80,10,15.4
ECU-014480,2122,77,40,37,5,15.4
ECU-014481,2122,25,12,13,1,25.0
ECU-014482,2122,548,275,273,26,21.076923076923077
ECU-014483,2122,1214,612,602,106,11.452830188679245
ECU-014484,2122,10,4,6,1,10.0
ECU-014485,2122,115,61,54,8,14.375
ECU-014486,2122,64,31,33,5,12.8
ECU-014487,2122,167,83,84,7,23.857142857142858
ECU-014488,2122,162,73,89,10,16.2
ECU-014489,2122,210,108,102,9,23.333333333333332
ECU-014490,2122,62,28,34,9,6.888888888888889
ECU-014491,2122,146,75,71,7,20.857142857142858
ECU-014492,2122,29,13,16,1,29.0
ECU-014493,2122,369,168,201,13,28.384615384615383
ECU-014494,2122,79,37,42,8,9.875
ECU-014495,2122,21,10,11,2,10.5
ECU-014496,2122,751,388,363,35,21.457142857142856
ECU-014497,2122,288,107,181,14,20.571428571428573
ECU-014498,2122,129,54,75,8,16.125
ECU-014499,2122,592,299,293,28,21.142857142857142
ECU-014500,2122,561,226,335,22,25.5
ECU-014501,2122,32,8,24,4,8.0
ECU-014502,2122,1230,684,546,86,14.30232558139535
ECU-014503,2122,1685,803,882,139,12.122302158273381
ECU-014504,2122,464,70,394,10,46.4
ECU-014505,2122,847,385,462,35,24.2
ECU-014506,2122,4803,2451,2352,140,34.30714285714286
ECU-014507,2122,213,107,106,8,26.625
ECU-014508,2122,391,199,192,14,27.928571428571427
ECU-014509,2122,496,241,255,21,23.61904761904762
ECU-014510,2122,331,163,168,15,22.066666666666666
ECU-014511,2122,142,72,70,5,28.4
ECU-014512,2122,84,45,39,4,21.0
ECU-014513,2122,14,7,7,1,14.0
ECU-014514,2122,54,29,25,6,9.0
ECU-014515,2122,290,135,155,9,32.22222222222222
ECU-014516,2122,104,55,49,4,26.0
ECU-014517,2122,3956,2085,1871,112,35.32142857142857
ECU-014518,2122,302,141,161,10,30.2
ECU-014519,2122,31,15,16,6,5.166666666666667
ECU-014520,2122,107,45,62,3,35.666666666666664
ECU-014521,2122,636,336,300,17,37.411764705882355
ECU-014522,2122,2697,1336,1361,99,27.242424242424242
ECU-014523,2122,254,110,144,5,50.8
ECU-014524,2122,1007,496,511,26,38.73076923076923
ECU-014525,2122,215,106,109,10,21.5
ECU-014526,2122,502,258,244,15,33.46666666666667
ECU-014527,2122,155,26,129,6,25.833333333333332
ECU-014528,2122,432,294,138,10,43.2
ECU-014529,2122,450,215,235,14,32.142857142857146
ECU-014530,2122,951,509,442,32,29.71875
ECU-014531,2122,199,105,94,8,24.875
ECU-014532,2122,75,41,34,4,18.75
ECU-014533,2122,188,88,100,7,26.857142857142858
ECU-014534,2122,231,105,126,6,38.5
ECU-014535,2122,406,198,208,19,21.36842105263158
ECU-014536,2122,133,62,71,8,16.625
ECU-014537,2122,255,144,111,8,31.875
ECU-014538,2122,150,72,78,8,18.75
ECU-014539,2122,96,54,42,11,8.727272727272727
ECU-014540,2122,92,49,43,6,15.333333333333334
ECU-014541,2122,74,39,35,6,12.333333333333334
ECU-014542,2122,341,165,176,10,34.1
ECU-014543,2122,92,60,32,6,15.333333333333334
ECU-014544,2122,68,28,40,5,13.6
ECU-014545,2122,503,428,75,22,22.863636363636363
ECU-014546,2122,128,67,61,4,32.0
ECU-014547,2122,134,61,73,3,44.666666666666664
ECU-014548,2122,1686,845,841,44,38.31818181818182
ECU-014549,2122,96,41,55,8,12.0
ECU-014550,2122,35,17,18,2,17.5
ECU-014551,2122,61,38,23,4,15.25
ECU-014552,2122,1309,621,688,42,31.166666666666668
ECU-014553,2122,71,29,42,8,8.875
ECU-014554,2122,35,18,17,4,8.75
ECU-014555,2122,2374,1087,1287,66,35.96969696969697
ECU-014556,2122,42,21,21,10,4.2
ECU-014557,2122,389,201,188,16,24.3125
ECU-014558,2122,60,29,31,6,10.0
ECU-014559,2122,13,8,5,2,6.5
ECU-014560,2122,2370,963,1407,62,38.225806451612904
ECU-014561,2122,1116,554,562,39,28.615384615384617
ECU-014562,2122,166,66,100,6,27.666666666666668
ECU-014563,2122,38,17,21,1,38.0
ECU-014564,2122,26,12,14,2,13.0
ECU-014565,2122,170,82,88,7,24.285714285714285
ECU-014566,2122,40,16,24,1,40.0
ECU-014567,2122,126,60,66,6,21.0
ECU-014568,2122,11,6,5,1,11.0
ECU-014569,2122,5,3,2,1,5.0
ECU-014570,2122,31,12,19,4,7.75
ECU-014571,2122,77,32,45,6,12.833333333333334
ECU-014572,2122,2019,996,1023,53,38.094339622641506
ECU-014573,2122,1825,889,936,52,35.09615384615385
ECU-014574,2122,1433,743,690,43,33.325581395348834
ECU-014575,2122,212,120,92,7,30.285714285714285
ECU-014576,2122,13,6,7,5,2.6
ECU-014577,2122,418,196,222,32,13.0625
ECU-014578,2122,233,116,117,8,29.125
ECU-014579,2122,2224,1125,1099,57,39.01754385964912
ECU-014580,2122,447,209,238,16,27.9375
ECU-014581,2122,97,47,50,5,19.4
ECU-014582,2122,90,43,47,6,15.0
ECU-014583,2122,198,102,96,10,19.8
ECU-014584,2122,303,149,154,12,25.25
ECU-014585,2122,79,29,50,5,15.8
ECU-014586,2122,289,142,147,11,26.272727272727273
ECU-014587,2122,113,49,64,9,12.555555555555555
ECU-014588,2122,887,402,485,26,34.11538461538461
ECU-014589,2122,227,121,106,8,28.375
ECU-014590,2122,18,11,7,5,3.6
ECU-014591,2122,135,66,69,11,12.272727272727273
ECU-014592,2122,95,45,50,4,23.75
ECU-014593,2122,1483,792,691,41,36.170731707317074
ECU-014594,2122,1005,491,514,25,40.2
ECU-014595,2122,146,71,75,19,7.684210526315789
ECU-014596,2122,126,65,61,12,10.5
ECU-014597,2122,376,177,199,11,34.18181818181818
ECU-014598,2122,340,116,224,7,48.57142857142857
ECU-014599,2122,106,46,60,4,26.5
ECU-014600,2122,236,236,0,10,23.6
ECU-014601,2122,47,25,22,3,15.666666666666666
ECU-014602,2122,419,207,212,16,26.1875
ECU-014603,2122,1632,772,860,46,35.47826086956522
ECU-014604,2122,260,120,140,15,17.333333333333332
ECU-014605,2122,65,36,29,2,32.5
ECU-014606,2122,90,44,46,2,45.0
ECU-014607,2122,749,387,362,22,34.04545454545455
ECU-014608,2122,163,71,92,6,27.166666666666668
ECU-014609,2122,427,201,226,7,61.0
ECU-014610,2122,161,89,72,10,16.1
ECU-014611,2122,976,482,494,63,15.492063492063492
ECU-014612,2122,302,150,152,19,15.894736842105264
ECU-014613,2122,1686,826,860,121,13.933884297520661
ECU-014614,2122,345,173,172,32,10.78125
ECU-014615,2122,368,178,190,28,13.142857142857142
ECU-014616,2122,31,16,15,7,4.428571428571429
ECU-014617,2122,104,22,82,7,14.857142857142858
ECU-014618,2122,9,5,4,4,2.25
ECU-014619,2122,83,41,42,5,16.6
ECU-014620,2122,139,61,78,8,17.375
ECU-014621,2122,110,56,54,3,36.666666666666664
ECU-014622,2122,473,247,226,42,11.261904761904763
ECU-014623,2122,1320,636,684,35,37.714285714285715
ECU-014624,2122,1209,601,608,34,35.55882352941177
ECU-014625,2122,44,24,20,3,14.666666666666666
ECU-014626,2122,109,61,48,6,18.166666666666668
ECU-014627,2122,257,101,156,11,23.363636363636363
ECU-014628,2122,40,30,10,1,40.0
ECU-014629,2122,73,68,5,7,10.428571428571429
ECU-014630,2122,80,33,47,8,10.0
ECU-014631,2122,15,1,14,7,2.142857142857143
ECU-014632,2122,42,17,25,2,21.0
ECU-014633,2122,60,30,30,7,8.571428571428571
ECU-014634,2122,34,18,16,2,17.0
ECU-014635,2122,10,5,5,8,1.25
ECU-014636,2122,43,27,16,5,8.6
ECU-014637,2122,47,22,25,4,11.75
ECU-014638,2122,19,13,6,2,9.5
ECU-014639,2122,978,526,452,139,7.0359712230215825
ECU-014640,2122,62,26,36,6,10.333333333333334
ECU-014641,2122,262,129,133,35,7.485714285714286
ECU-014642,2122,35,16,19,4,8.75
ECU-014643,2122,8,3,5,1,8.0
ECU-014644,2122,2197,1118,1079,59,37.23728813559322
ECU-014645,2122,1039,517,522,26,39.96153846153846
ECU-014646,2122,2029,1002,1027,57,35.59649122807018
ECU-014647,2122,1160,574,586,28,41.42857142857143
ECU-014648,2122,1626,842,784,64,25.40625
ECU-014649,2122,79,50,29,6,13.166666666666666
ECU-014650,2122,131,64,67,12,10.916666666666666
ECU-014651,2122,30,7,23,3,10.0
ECU-014652,2122,1172,559,613,33,35.515151515151516
ECU-014653,2122,1467,742,725,39,37.61538461538461
ECU-014654,2122,465,319,146,9,51.666666666666664
ECU-014655,2122,1504,747,757,42,35.80952380952381
ECU-014656,2122,62,35,27,5,12.4
ECU-014657,2122,848,460,388,37,22.91891891891892
ECU-014658,2122,11,6,5,2,5.5
ECU-014659,2122,9,4,5,6,1.5
ECU-014660,2122,80,37,43,3,26.666666666666668
ECU-014661,2122,113,40,73,6,18.833333333333332
ECU-014662,2122,1905,1028,877,63,30.238095238095237
ECU-014663,2122,79,49,30,4,19.75
ECU-014664,2122,155,69,86,7,22.142857142857142
ECU-014665,2122,951,473,478,27,35.22222222222222
ECU-014666,2122,2292,1207,1085,64,35.8125
ECU-014667,2122,2193,1034,1159,68,32.25
ECU-014668,2122,1853,918,935,72,25.73611111111111
ECU-014669,2122,1070,593,477,121,8.84297520661157
ECU-014670,2122,271,107,164,40,6.775
ECU-014671,2122,164,6,158,9,18.22222222222222
ECU-014672,2122,133,32,101,9,14.777777777777779
ECU-014673,2122,120,59,61,17,7.0588235294117645
ECU-014674,2122,275,144,131,13,21.153846153846153
ECU-014675,2122,5,2,3,2,2.5
ECU-014676,2122,43,17,26,4,10.75
ECU-014677,2122,901,441,460,32,28.15625
ECU-014678,2122,16,8,8,2,8.0
ECU-014679,2122,84,41,43,10,8.4
ECU-014680,2122,99,50,49,8,12.375
ECU-014681,2122,25,10,15,4,6.25
ECU-014682,2122,22,8,14,4,5.5
ECU-014683,2122,81,41,40,5,16.2
ECU-014684,2122,28,17,11,2,14.0
ECU-014685,2122,181,90,91,8,22.625
ECU-014686,2122,241,108,133,22,10.954545454545455
ECU-014687,2122,6,3,3,2,3.0
ECU-014688,2122,43,22,21,6,7.166666666666667
ECU-014689,2122,74,37,37,9,8.222222222222221
ECU-014690,2122,158,66,92,22,7.181818181818182
ECU-014691,2122,1982,974,1008,68,29.147058823529413
ECU-014692,2122,62,27,35,6,10.333333333333334
ECU-014693,2122,173,90,83,12,14.416666666666666
ECU-014694,2122,35,11,24,5,7.0
ECU-014695,2122,76,37,39,4,19.0
ECU-014696,2122,33,20,13,2,16.5
ECU-014697,2122,12,7,5,2,6.0
ECU-014698,2122,119,60,59,7,17.0
ECU-014699,2122,392,205,187,15,26.133333333333333
ECU-014700,2122,2312,1123,1189,57,40.56140350877193
ECU-014701,2122,242,122,120,13,18.615384615384617
ECU-014702,2122,336,166,170,26,12.923076923076923
ECU-014703,2122,38,28,10,6,6.333333333333333
ECU-014704,2122,322,166,156,13,24.76923076923077
ECU-014705,2122,341,181,160,14,24.357142857142858
ECU-014706,2122,167,66,101,7,23.857142857142858
ECU-014707,2122,973,471,502,32,30.40625
ECU-014708,2122,105,51,54,11,9.545454545454545
ECU-014709,2122,140,47,93,9,15.555555555555555
ECU-014710,2122,55,23,32,8,6.875
ECU-014711,2122,74,33,41,13,5.6923076923076925
ECU-014712,2122,37,16,21,7,5.285714285714286
ECU-014713,2122,38,12,26,9,4.222222222222222
ECU-014714,2122,44,21,23,14,3.142857142857143
ECU-014715,2122,73,41,32,5,14.6
ECU-014716,2122,40,12,28,3,13.333333333333334
ECU-014717,2122,141,69,72,14,10.071428571428571
ECU-014718,2122,220,111,109,15,14.666666666666666
ECU-014719,2122,48,19,29,10,4.8
ECU-014720,2122,1293,675,618,43,30.069767441860463
ECU-014721,2122,839,420,419,28,29.964285714285715
ECU-014722,2122,1635,805,830,73,22.397260273972602
ECU-014723,2122,4876,2317,2559,163,29.914110429447852
ECU-014724,2122,1,0,1,0,
ECU-014725,2122,2737,1572,1165,102,26.833333333333332
ECU-014726,2122,10,5,5,0,
ECU-014727,2122,646,356,290,91,7.0989010989010985
ECU-014728,2122,265,122,143,24,11.041666666666666
ECU-014729,2122,1,0,1,0,
ECU-014730,2122,25,12,13,0,
ECU-014731,2122,108,38,70,0,
ECU-014732,2122,126,42,84,0,
ECU-014733,2122,2,1,1,0,
ECU-014734,2122,4,2,2,0,
ECU-014735,2122,4,0,4,0,
ECU-014736,2122,1,0,1,0,
ECU-014737,2122,11,7,4,0,
ECU-014738,2122,19,10,9,0,
ECU-014739,2122,12,7,5,0,
ECU-014740,2122,8,6,2,0,
ECU-014741,2122,7,4,3,1,7.0
ECU-014742,2122,8,3,5,1,8.0
ECU-014743,2122,30,15,15,2,15.0
ECU-014744,2122,467,230,237,19,24.57894736842105
ECU-014745,2122,42,16,26,5,8.4
ECU-014746,2122,974,478,496,38,25.63157894736842
ECU-014747,2122,488,252,236,23,21.217391304347824
ECU-014748,2122,83,42,41,6,13.833333333333334
ECU-014749,2122,180,84,96,18,10.0
ECU-014750,2122,591,282,309,27,21.88888888888889
ECU-014751,2122,615,274,341,34,18.08823529411765
ECU-014752,2122,148,70,78,6,24.666666666666668
ECU-014753,2122,28,10,18,3,9.333333333333334
ECU-014754,2122,112,65,47,5,22.4
ECU-014755,2122,75,33,42,4,18.75
ECU-014756,2122,1380,661,719,58,23.79310344827586
ECU-014757,2122,27,12,15,3,9.0
ECU-014758,2122,1024,1024,0,45,22.755555555555556
ECU-014759,2122,1689,867,822,83,20.349397590361445
ECU-014760,2122,26,14,12,9,2.888888888888889
ECU-014761,2122,42,25,17,4,10.5
ECU-014762,2122,8,3,5,1,8.0
ECU-014763,2122,1935,1057,878,74,26.14864864864865
ECU-014764,2122,2412,1629,783,92,26.217391304347824
ECU-014765,2122,1538,824,714,52,29.576923076923077
ECU-014766,2122,767,397,370,21,36.523809523809526
ECU-014767,2122,1787,601,1186,139,12.856115107913668
ECU-014768,2122,2890,1108,1782,117,24.700854700854702
ECU-014769,2122,774,489,285,52,14.884615384615385
ECU-014770,2122,1162,655,507,78,14.897435897435898
ECU-014771,2122,557,130,427,39,14.282051282051283
ECU-014772,2122,104,46,58,6,17.333333333333332
ECU-014773,2122,305,162,143,11,27.727272727272727
ECU-014774,2122,826,598,228,58,14.241379310344827
ECU-014775,2122,216,122,94,10,21.6
ECU-014776,2122,69,31,38,8,8.625
ECU-014777,2122,17,8,9,3,5.666666666666667
ECU-014778,2122,104,43,61,15,6.933333333333334
ECU-014779,2122,22,10,12,8,2.75
ECU-014780,2122,469,223,246,23,20.391304347826086
ECU-014781,2122,276,148,128,13,21.23076923076923
ECU-014782,2122,505,254,251,36,14.027777777777779
ECU-014783,2122,85,36,49,8,10.625
ECU-014784,2122,166,81,85,8,20.75
ECU-014785,2122,1152,591,561,36,32.0
ECU-014786,2122,33,14,19,5,6.6
ECU-014787,2122,1013,661,352,38,26.657894736842106
ECU-014788,2122,7,5,2,3,2.3333333333333335
ECU-014789,2122,46,18,28,6,7.666666666666667
ECU-014790,2122,282,140,142,19,14.842105263157896
ECU-014791,2122,317,140,177,23,13.782608695652174
ECU-014792,2122,117,54,63,10,11.7
ECU-014793,2122,128,65,63,12,10.666666666666666
ECU-014794,2122,337,160,177,21,16.047619047619047
ECU-014795,2122,68,34,34,11,6.181818181818182
ECU-014796,2122,463,216,247,48,9.645833333333334
ECU-014797,2122,129,75,54,12,10.75
ECU-014798,2122,555,259,296,21,26.428571428571427
ECU-014799,2122,641,361,280,27,23.74074074074074
ECU-014800,2122,21,7,14,1,21.0
ECU-014801,2122,1660,773,887,70,23.714285714285715
ECU-014802,2122,340,163,177,16,21.25
ECU-014803,2122,65,26,39,15,4.333333333333333
ECU-014804,2122,316,140,176,35,9.028571428571428
ECU-014805,2122,728,355,373,71,10.253521126760564
ECU-014806,2122,215,91,124,14,15.357142857142858
ECU-014807,2122,123,53,70,13,9.461538461538462
ECU-014808,2122,2676,1423,1253,102,26.235294117647058
ECU-014809,2122,1598,773,825,55,29.054545454545455
ECU-014810,2122,1338,714,624,48,27.875
ECU-014811,2122,916,462,454,36,25.444444444444443
ECU-014812,2122,1154,577,577,51,22.627450980392158
ECU-014813,2122,118,66,52,6,19.666666666666668
ECU-014814,2122,317,162,155,13,24.384615384615383
ECU-014815,2122,1253,773,480,49,25.571428571428573
ECU-014816,2122,38,16,22,7,5.428571428571429
ECU-014817,2122,988,483,505,38,26.0
ECU-014818,2122,497,229,268,19,26.157894736842106
ECU-014819,2122,201,103,98,14,14.357142857142858
ECU-014820,2122,78,40,38,5,15.6
ECU-014821,2122,64,33,31,6,10.666666666666666
ECU-014822,2122,184,97,87,8,23.0
ECU-014823,2122,34,14,20,5,6.8
ECU-014824,2122,560,288,272,29,19.310344827586206
ECU-014825,2122,230,104,126,10,23.0
ECU-014826,2122,91,42,49,4,22.75
ECU-014827,2122,271,125,146,14,19.357142857142858
ECU-014828,2122,1617,784,833,67,24.134328358208954
ECU-014829,2122,278,151,127,16,17.375
ECU-014830,2122,437,208,229,18,24.27777777777778
ECU-014831,2122,1085,529,556,32,33.90625
ECU-014832,2122,1475,690,785,51,28.92156862745098
ECU-014833,2122,1550,768,782,46,33.69565217391305
ECU-014834,2122,865,437,428,37,23.37837837837838
ECU-014835,2122,260,113,147,28,9.285714285714286
ECU-014836,2122,780,439,341,38,20.526315789473685
ECU-014837,2122,857,390,467,37,23.16216216216216
ECU-014838,2122,1574,793,781,38,41.421052631578945
ECU-014839,2122,95,35,60,9,10.555555555555555
ECU-014840,2122,195,94,101,15,13.0
ECU-014841,2122,163,92,71,9,18.11111111111111
ECU-014842,2122,62,27,35,9,6.888888888888889
ECU-014843,2122,277,133,144,13,21.307692307692307
ECU-014844,2122,119,53,66,9,13.222222222222221
ECU-014845,2122,71,28,43,8,8.875
ECU-014846,2122,721,352,369,26,27.73076923076923
ECU-014847,2122,821,416,405,34,24.147058823529413
ECU-014848,2122,1595,782,813,62,25.725806451612904
ECU-014849,2122,864,433,431,37,23.35135135135135
ECU-014850,2122,1268,609,659,38,33.36842105263158
ECU-014851,2122,40,24,16,2,20.0
ECU-014852,2122,303,152,151,23,13.173913043478262
ECU-014853,2122,120,61,59,17,7.0588235294117645
ECU-014854,2122,339,155,184,20,16.95
ECU-014855,2122,212,96,116,24,8.833333333333334
ECU-014856,2122,1067,636,431,46,23.195652173913043
ECU-014857,2122,12,4,8,3,4.0
ECU-014858,2122,163,49,114,18,9.055555555555555
ECU-014859,2122,2187,1033,1154,79,27.68354430379747
ECU-014860,2122,1350,632,718,63,21.428571428571427
ECU-014861,2122,35,15,20,13,2.6923076923076925
ECU-014862,2122,1056,569,487,31,34.064516129032256
ECU-014863,2122,90,30,60,7,12.857142857142858
ECU-014864,2122,9,5,4,3,3.0
ECU-014865,2122,29,15,14,9,3.2222222222222223
ECU-014866,2122,84,45,39,8,10.5
ECU-014867,2122,596,286,310,21,28.38095238095238
ECU-014868,2122,597,305,292,24,24.875
ECU-014869,2122,1112,608,504,44,25.272727272727273
ECU-014870,2122,192,79,113,21,9.142857142857142
ECU-014871,2122,104,43,61,4,26.0
ECU-014872,2122,90,42,48,8,11.25
ECU-014873,2122,18,8,10,3,6.0
ECU-014874,2122,286,134,152,42,6.809523809523809
ECU-014875,2122,402,203,199,17,23.647058823529413
ECU-014876,2122,157,90,67,8,19.625
ECU-014877,2122,121,67,54,6,20.166666666666668
ECU-014878,2122,1290,703,587,43,30.0
ECU-014879,2122,1185,568,617,53,22.358490566037737
ECU-014880,2122,401,206,195,15,26.733333333333334
ECU-014881,2122,150,69,81,15,10.0
ECU-014882,2122,98,39,59,18,5.444444444444445
ECU-014883,2122,164,72,92,22,7.454545454545454
ECU-014884,2122,538,270,268,35,15.371428571428572
ECU-014885,2122,85,45,40,5,17.0
ECU-014886,2122,151,69,82,13,11.615384615384615
ECU-014887,2122,1576,774,802,60,26.266666666666666
ECU-014888,2122,13,2,11,5,2.6
ECU-014889,2122,1703,314,1389,85,20.03529411764706
ECU-014890,2122,979,486,493,83,11.795180722891565
ECU-014891,2122,483,219,264,44,10.977272727272727
ECU-014892,2122,3321,919,2402,171,19.42105263157895
ECU-014893,2122,4548,2822,1726,159,28.60377358490566
ECU-014894,2122,312,170,142,26,12.0
ECU-014895,2122,111,52,59,4,27.75
ECU-014896,2122,247,122,125,22,11.227272727272727
ECU-014897,2122,40,0,40,7,5.714285714285714
ECU-014898,2122,238,107,131,24,9.916666666666666
ECU-014899,2122,370,208,162,20,18.5
ECU-014900,2122,142,61,81,25,5.68
ECU-014901,2122,200,92,108,9,22.22222222222222
ECU-014902,2122,1139,553,586,37,30.783783783783782
ECU-014903,2122,55,31,24,12,4.583333333333333
ECU-014904,2122,476,213,263,22,21.636363636363637
ECU-014905,2122,433,228,205,17,25.470588235294116
ECU-014906,2122,75,42,33,9,8.333333333333334
ECU-014907,2122,254,131,123,16,15.875
ECU-014908,2122,128,57,71,11,11.636363636363637
ECU-014909,2122,49,21,28,4,12.25
ECU-014910,2122,253,128,125,11,23.0
ECU-014911,2122,3301,1654,1647,86,38.383720930232556
ECU-014912,2122,122,55,67,11,11.090909090909092
ECU-014913,2122,2118,977,1141,74,28.62162162162162
ECU-014914,2122,177,82,95,8,22.125
ECU-014915,2122,292,144,148,16,18.25
ECU-014916,2122,713,335,378,35,20.37142857142857
ECU-014917,2122,227,97,130,17,13.352941176470589
ECU-014918,2122,123,47,76,7,17.571428571428573
ECU-014919,2122,307,137,170,11,27.90909090909091
ECU-014920,2122,78,34,44,22,3.5454545454545454
ECU-014921,2122,674,332,342,26,25.923076923076923
ECU-014922,2122,136,54,82,16,8.5
ECU-014923,2122,1099,524,575,46,23.891304347826086
ECU-014924,2122,3089,1312,1777,149,20.731543624161073
ECU-014925,2122,20,10,10,1,20.0
ECU-014926,2122,1487,777,710,43,34.58139534883721
ECU-014927,2122,956,464,492,31,30.838709677419356
ECU-014928,2122,477,230,247,19,25.105263157894736
ECU-014929,2122,493,242,251,35,14.085714285714285
ECU-014930,2122,107,43,64,11,9.727272727272727
ECU-014931,2122,183,98,85,11,16.636363636363637
ECU-014932,2122,18,3,15,2,9.0
ECU-014933,2122,881,396,485,49,17.979591836734695
ECU-014934,2122,172,91,81,18,9.555555555555555
ECU-014935,2122,29,13,16,6,4.833333333333333
ECU-014936,2122,479,256,223,11,43.54545454545455
ECU-014937,2122,153,67,86,11,13.909090909090908
ECU-014938,2122,14,4,10,5,2.8
ECU-014939,2122,292,138,154,17,17.176470588235293
ECU-014940,2122,473,233,240,18,26.27777777777778
ECU-014941,2122,879,410,469,33,26.636363636363637
ECU-014942,2122,1964,946,1018,62,31.677419354838708
ECU-014943,2122,607,288,319,29,20.93103448275862
ECU-014944,2122,2249,1124,1125,72,31.23611111111111
ECU-014945,2122,208,101,107,8,26.0
ECU-014946,2122,2319,1149,1170,69,33.608695652173914
ECU-014947,2122,1679,772,907,56,29.982142857142858
ECU-014948,2122,435,207,228,17,25.58823529411765
ECU-014949,2122,480,211,269,19,25.263157894736842
ECU-014950,2122,460,219,241,20,23.0
ECU-014951,2122,1511,739,772,49,30.836734693877553
ECU-014952,2122,1465,655,810,55,26.636363636363637
ECU-014953,2122,660,309,351,27,24.444444444444443
ECU-014954,2122,524,239,285,22,23.818181818181817
ECU-014955,2122,160,69,91,13,12.307692307692308
ECU-014956,2122,63,24,39,6,10.5
ECU-014957,2122,611,291,320,54,11.314814814814815
ECU-014958,2122,2274,1146,1128,86,26.441860465116278
ECU-014959,2122,42,23,19,4,10.5
ECU-014960,2122,158,78,80,4,39.5
ECU-014961,2122,642,313,329,23,27.91304347826087
ECU-014962,2122,237,14,223,19,12.473684210526315
ECU-014963,2122,5,3,2,3,1.6666666666666667
ECU-014964,2122,336,162,174,18,18.666666666666668
ECU-014965,2122,5377,2896,2481,185,29.064864864864866
ECU-014966,2122,8,7,1,1,8.0
ECU-014967,2122,351,170,181,17,20.647058823529413
ECU-014968,2122,663,43,620,26,25.5
ECU-014969,2122,1781,881,900,59,30.1864406779661
ECU-014970,2122,789,413,376,45,17.533333333333335
ECU-014971,2122,487,224,263,21,23.19047619047619
ECU-014972,2122,1102,1102,0,60,18.366666666666667
ECU-014973,2122,159,67,92,17,9.352941176470589
ECU-014974,2122,1207,572,635,45,26.822222222222223
ECU-014975,2122,3215,1644,1571,115,27.956521739130434
ECU-014976,2122,144,59,85,13,11.076923076923077
ECU-014977,2122,1076,533,543,44,24.454545454545453
ECU-014978,2122,3378,1714,1664,136,24.83823529411765
ECU-014979,2122,20,9,11,1,20.0
ECU-014980,2122,184,67,117,15,12.266666666666667
ECU-014981,2122,133,62,71,11,12.090909090909092
ECU-014982,2122,1257,457,800,59,21.305084745762713
ECU-014983,2122,1325,636,689,54,24.537037037037038
ECU-014984,2122,48,22,26,8,6.0
ECU-014985,2122,76,36,40,13,5.846153846153846
ECU-014986,2122,1843,685,1158,83,22.204819277108435
ECU-014987,2122,189,99,90,15,12.6
ECU-014988,2122,491,216,275,19,25.842105263157894
ECU-014989,2122,57,27,30,6,9.5
ECU-014990,2122,83,32,51,13,6.384615384615385
ECU-014991,2122,45,20,25,4,11.25
ECU-014992,2122,2416,1188,1228,93,25.978494623655912
ECU-014993,2122,842,429,413,30,28.066666666666666
ECU-014994,2122,1029,521,508,48,21.4375
ECU-014995,2122,818,404,414,53,15.433962264150944
ECU-014996,2122,268,137,131,11,24.363636363636363
ECU-014997,2122,490,214,276,22,22.272727272727273
ECU-014998,2122,303,137,166,15,20.2
ECU-014999,2122,450,216,234,20,22.5
ECU-015000,2122,966,471,495,38,25.42105263157895
ECU-015001,2122,18,9,9,1,18.0
ECU-015002,2122,9,3,6,4,2.25
ECU-015003,2122,838,413,425,31,27.032258064516128
ECU-015004,2122,2858,1321,1537,103,27.74757281553398
ECU-015005,2122,83,34,49,6,13.833333333333334
ECU-015006,2122,5,0,5,4,1.25
ECU-015007,2122,3387,1510,1877,112,30.241071428571427
ECU-015008,2122,509,219,290,28,18.178571428571427
ECU-015009,2122,76,32,44,7,10.857142857142858
ECU-015010,2122,584,307,277,21,27.80952380952381
ECU-015011,2122,23,11,12,2,11.5
ECU-015012,2122,379,174,205,17,22.294117647058822
ECU-015013,2122,1090,552,538,77,14.155844155844155
ECU-015014,2122,238,118,120,14,17.0
ECU-015015,2122,157,86,71,10,15.7
ECU-015016,2122,595,291,304,18,33.05555555555556
ECU-015017,2122,638,323,315,25,25.52
ECU-015018,2122,428,337,91,34,12.588235294117647
ECU-015019,2122,597,280,317,29,20.586206896551722
ECU-015020,2122,598,377,221,59,10.135593220338983
ECU-015021,2122,146,71,75,8,18.25
ECU-015022,2122,1068,674,394,59,18.10169491525424
ECU-015023,2122,72,34,38,14,5.142857142857143
ECU-015024,2122,15,4,11,6,2.5
ECU-015025,2122,4535,2611,1924,168,26.99404761904762
ECU-015026,2122,26,13,13,1,26.0
ECU-015027,2122,232,113,119,9,25.77777777777778
ECU-015028,2122,91,47,44,7,13.0
ECU-015029,2122,166,77,89,13,12.76923076923077
ECU-015030,2122,134,62,72,6,22.333333333333332
ECU-015031,2122,210,96,114,18,11.666666666666666
ECU-015032,2122,13,6,7,3,4.333333333333333
ECU-015033,2122,2099,821,1278,89,23.584269662921347
ECU-015034,2122,137,70,67,9,15.222222222222221
ECU-015035,2122,604,396,208,35,17.257142857142856
ECU-015036,2122,7,2,5,2,3.5
ECU-015037,2122,135,53,82,15,9.0
ECU-015038,2122,222,111,111,7,31.714285714285715
ECU-015039,2122,109,48,61,9,12.11111111111111
ECU-015040,2122,73,31,42,9,8.11111111111111
ECU-015041,2122,75,20,55,9,8.333333333333334
ECU-015042,2122,106,52,54,6,17.666666666666668
ECU-015043,2122,72,34,38,4,18.0
ECU-015044,2122,2624,1294,1330,127,20.661417322834644
ECU-015045,2122,200,114,86,18,11.11111111111111
ECU-015046,2122,625,317,308,34,18.38235294117647
ECU-015047,2122,18,8,10,4,4.5
ECU-015048,2122,548,214,334,22,24.90909090909091
ECU-015049,2122,120,67,53,15,8.0
ECU-015050,2122,793,431,362,26,30.5
ECU-015051,2122,1741,922,819,76,22.907894736842106
ECU-015052,2122,514,180,334,34,15.117647058823529
ECU-015053,2122,102,47,55,10,10.2
ECU-015054,2122,195,89,106,10,19.5
ECU-015055,2122,82,45,37,8,10.25
ECU-015056,2122,735,383,352,41,17.926829268292682
ECU-015057,2122,365,184,181,23,15.869565217391305
ECU-015058,2122,156,84,72,17,9.176470588235293
ECU-015059,2122,403,189,214,24,16.791666666666668
ECU-015060,2122,521,272,249,24,21.708333333333332
ECU-015061,2122,3253,1859,1394,120,27.108333333333334
ECU-015062,2122,1426,723,703,53,26.90566037735849
ECU-015063,2122,765,373,392,34,22.5
ECU-015064,2122,842,463,379,28,30.071428571428573
ECU-015065,2122,1195,630,565,56,21.339285714285715
ECU-015066,2122,212,94,118,9,23.555555555555557
ECU-015067,2122,376,128,248,17,22.11764705882353
ECU-015068,2122,621,296,325,44,14.113636363636363
ECU-015069,2122,592,308,284,22,26.90909090909091
ECU-015070,2122,38,20,18,9,4.222222222222222
ECU-015071,2122,377,231,146,23,16.391304347826086
ECU-015072,2122,330,164,166,20,16.5
ECU-015073,2122,7,1,6,3,2.3333333333333335
ECU-015074,2122,252,140,112,12,21.0
ECU-015075,2122,550,381,169,31,17.741935483870968
ECU-015076,2122,223,113,110,10,22.3
ECU-015077,2122,392,187,205,21,18.666666666666668
ECU-015078,2122,1885,888,997,92,20.48913043478261
ECU-015079,2122,199,89,110,13,15.307692307692308
ECU-015080,2122,1017,940,77,52,19.557692307692307
ECU-015081,2122,202,72,130,12,16.833333333333332
ECU-015082,2122,312,206,106,13,24.0
ECU-015083,2122,322,165,157,20,16.1
ECU-015084,2122,337,212,125,22,15.318181818181818
ECU-015085,2122,43,18,25,6,7.166666666666667
ECU-015086,2122,1043,394,649,42,24.833333333333332
ECU-015087,2122,73,36,37,8,9.125
ECU-015088,2122,206,104,102,9,22.88888888888889
ECU-015089,2122,577,298,279,38,15.18421052631579
ECU-015090,2122,527,256,271,16,32.9375
ECU-015091,2122,30,18,12,7,4.285714285714286
ECU-015092,2122,1430,739,691,38,37.63157894736842
ECU-015093,2122,176,77,99,8,22.0
ECU-015094,2122,351,179,172,15,23.4
ECU-015095,2122,5297,2507,2790,209,25.3444976076555
ECU-015096,2122,423,174,249,27,15.666666666666666
ECU-015097,2122,104,49,55,6,17.333333333333332
ECU-015098,2122,87,34,53,10,8.7
ECU-015099,2122,386,201,185,22,17.545454545454547
ECU-015100,2122,2915,1470,1445,141,20.673758865248228
ECU-015101,2122,136,83,53,12,11.333333333333334
ECU-015102,2122,608,311,297,20,30.4
ECU-015103,2122,10,6,4,3,3.3333333333333335
ECU-015104,2122,1050,622,428,48,21.875
ECU-015105,2122,729,337,392,44,16.568181818181817
ECU-015106,2122,199,91,108,13,15.307692307692308
ECU-015107,2122,27,15,12,4,6.75
ECU-015108,2122,93,32,61,15,6.2
ECU-015109,2122,364,172,192,18,20.22222222222222
ECU-015110,2122,143,73,70,11,13.0
ECU-015111,2122,1761,1162,599,73,24.123287671232877
ECU-015112,2122,155,99,56,11,14.090909090909092
ECU-015113,2122,1400,1400,0,93,15.053763440860216
ECU-015114,2122,13,8,5,2,6.5
ECU-015115,2122,12,5,7,6,2.0
ECU-015116,2122,2087,1053,1034,88,23.71590909090909
ECU-015117,2122,45,22,23,9,5.0
ECU-015118,2122,556,276,280,28,19.857142857142858
ECU-015119,2122,1698,806,892,59,28.779661016949152
ECU-015120,2122,190,88,102,12,15.833333333333334
ECU-015121,2122,2141,647,1494,78,27.44871794871795
ECU-015122,2122,933,390,543,42,22.214285714285715
ECU-015123,2122,93,43,50,14,6.642857142857143
ECU-015124,2122,60,27,33,9,6.666666666666667
ECU-015125,2122,108,46,62,8,13.5
ECU-015126,2122,180,72,108,10,18.0
ECU-015127,2122,41,19,22,6,6.833333333333333
ECU-015128,2122,2556,1242,1314,104,24.576923076923077
ECU-015129,2122,1226,601,625,46,26.652173913043477
ECU-015130,2122,1949,961,988,68,28.66176470588235
ECU-015131,2122,1472,711,761,54,27.25925925925926
ECU-015132,2122,444,212,232,17,26.11764705882353
ECU-015133,2122,1050,500,550,39,26.923076923076923
ECU-015134,2122,42,19,23,10,4.2
ECU-015135,2122,80,33,47,15,5.333333333333333
ECU-015136,2122,534,267,267,29,18.413793103448278
ECU-015137,2122,236,109,127,22,10.727272727272727
ECU-015138,2122,1537,827,710,52,29.557692307692307
ECU-015139,2122,35,14,21,6,5.833333333333333
ECU-015140,2122,176,92,84,23,7.6521739130434785
ECU-015141,2122,841,432,409,37,22.72972972972973
ECU-015142,2122,210,115,95,9,23.333333333333332
ECU-015143,2122,1619,837,782,53,30.547169811320753
ECU-015144,2122,50,30,20,9,5.555555555555555
ECU-015145,2122,135,55,80,18,7.5
ECU-015146,2122,273,129,144,11,24.818181818181817
ECU-015147,2122,213,92,121,6,35.5
ECU-015148,2122,787,422,365,39,20.17948717948718
ECU-015149,2122,1435,684,751,60,23.916666666666668
ECU-015150,2122,119,67,52,5,23.8
ECU-015151,2122,47,15,32,7,6.714285714285714
ECU-015152,2122,1079,518,561,52,20.75
ECU-015153,2122,327,163,164,12,27.25
ECU-015154,2122,91,48,43,14,6.5
ECU-015155,2122,921,464,457,37,24.89189189189189
ECU-015156,2122,217,86,131,13,16.692307692307693
ECU-015157,2122,255,125,130,13,19.615384615384617
ECU-015158,2122,599,288,311,23,26.043478260869566
ECU-015159,2122,1061,530,531,35,30.314285714285713
ECU-015160,2122,73,36,37,5,14.6
ECU-015161,2122,810,391,419,37,21.89189189189189
ECU-015162,2122,475,231,244,17,27.941176470588236
ECU-015163,2122,28,16,12,3,9.333333333333334
ECU-015164,2122,1262,596,666,44,28.681818181818183
ECU-015165,2122,1059,535,524,42,25.214285714285715
ECU-015166,2122,1322,701,621,107,12.355140186915888
ECU-015167,2122,2319,1210,1109,86,26.96511627906977
ECU-015168,2122,1058,517,541,41,25.804878048780488
ECU-015169,2122,706,362,344,79,8.936708860759493
ECU-015170,2122,634,348,286,39,16.256410256410255
ECU-015171,2122,387,187,200,20,19.35
ECU-015172,2122,388,169,219,35,11.085714285714285
ECU-015173,2122,563,260,303,33,17.060606060606062
ECU-015174,2122,297,170,127,15,19.8
ECU-015175,2122,104,50,54,7,14.857142857142858
ECU-015176,2122,1244,616,628,61,20.39344262295082
ECU-015177,2122,33,8,25,5,6.6
ECU-015178,2122,318,151,167,9,35.333333333333336
ECU-015179,2122,1918,965,953,67,28.62686567164179
ECU-015180,2122,256,128,128,12,21.333333333333332
ECU-015181,2122,1194,577,617,43,27.767441860465116
ECU-015182,2122,1535,803,732,60,25.583333333333332
ECU-015183,2122,82,46,36,6,13.666666666666666
ECU-015184,2122,443,271,172,25,17.72
ECU-015185,2122,2393,1169,1224,83,28.83132530120482
ECU-015186,2122,228,112,116,10,22.8
ECU-015187,2122,1023,489,534,35,29.228571428571428
ECU-015188,2122,1545,775,770,60,25.75
ECU-015189,2122,1371,694,677,42,32.642857142857146
ECU-015190,2122,1217,601,616,43,28.302325581395348
ECU-015191,2122,502,249,253,60,8.366666666666667
ECU-015192,2122,348,163,185,15,23.2
ECU-015193,2122,94,37,57,16,5.875
ECU-015194,2122,515,279,236,17,30.294117647058822
ECU-015195,2122,293,135,158,35,8.371428571428572
ECU-015196,2122,18,9,9,4,4.5
ECU-015197,2122,226,94,132,19,11.894736842105264
ECU-015198,2122,508,205,303,55,9.236363636363636
ECU-015199,2122,98,51,47,9,10.88888888888889
ECU-015200,2122,1117,575,542,41,27.24390243902439
ECU-015201,2122,452,212,240,47,9.617021276595745
ECU-015202,2122,236,116,120,22,10.727272727272727
ECU-015203,2122,1663,790,873,98,16.96938775510204
ECU-015204,2122,1293,600,693,35,36.94285714285714
ECU-015205,2122,53,23,30,7,7.571428571428571
ECU-015206,2122,698,354,344,78,8.948717948717949
ECU-015207,2122,1832,697,1135,78,23.487179487179485
ECU-015208,2122,224,107,117,16,14.0
ECU-015209,2122,6,3,3,2,3.0
ECU-015210,2122,171,71,100,17,10.058823529411764
ECU-015211,2122,306,143,163,13,23.53846153846154
ECU-015212,2122,114,45,69,11,10.363636363636363
ECU-015213,2122,427,232,195,30,14.233333333333333
ECU-015214,2122,738,393,345,82,9.0
ECU-015215,2122,1049,1046,3,65,16.138461538461538
ECU-015216,2122,149,68,81,17,8.764705882352942
ECU-015217,2122,234,122,112,10,23.4
ECU-015218,2122,30,17,13,6,5.0
ECU-015219,2122,2356,1209,1147,77,30.5974025974026
ECU-015220,2122,8703,5420,3283,281,30.97153024911032
ECU-015221,2122,111,61,50,5,22.2
ECU-015222,2122,17,7,10,2,8.5
ECU-015223,2122,22,15,7,1,22.0
ECU-015224,2122,32,20,12,4,8.0
ECU-015225,2122,160,82,78,8,20.0
ECU-015226,2122,23,11,12,3,7.666666666666667
ECU-015227,2122,981,630,351,42,23.357142857142858
ECU-015228,2122,617,380,237,11,56.09090909090909
ECU-015229,2122,230,101,129,21,10.952380952380953
ECU-015230,2122,3,1,2,1,3.0
ECU-015231,2122,1,0,1,1,1.0
ECU-015232,2122,245,131,114,14,17.5
ECU-015233,2122,99,38,61,12,8.25
ECU-015234,2122,676,350,326,33,20.484848484848484
ECU-015235,2122,175,92,83,8,21.875
ECU-015236,2122,26,10,16,1,26.0
ECU-015237,2122,1014,535,479,49,20.693877551020407
ECU-015238,2122,1349,723,626,59,22.864406779661017
ECU-015239,2122,26,11,15,7,3.7142857142857144
ECU-015240,2122,724,228,496,38,19.05263157894737
ECU-015241,2122,304,123,181,52,5.846153846153846
ECU-015242,2122,624,314,310,36,17.333333333333332
ECU-015243,2122,592,287,305,18,32.888888888888886
ECU-015244,2122,22,9,13,3,7.333333333333333
ECU-015245,2122,1329,654,675,58,22.913793103448278
ECU-015246,2122,1483,739,744,64,23.171875
ECU-015247,2122,749,429,320,22,34.04545454545455
ECU-015248,2122,4306,1972,2334,153,28.143790849673202
ECU-015249,2122,1122,567,555,47,23.872340425531913
ECU-015250,2122,112,42,70,9,12.444444444444445
ECU-015251,2122,73,30,43,4,18.25
ECU-015252,2122,1430,665,765,50,28.6
ECU-015253,2122,495,246,249,25,19.8
ECU-015254,2122,1145,575,570,39,29.358974358974358
ECU-015255,2122,1615,806,809,66,24.46969696969697
ECU-015256,2122,668,308,360,26,25.692307692307693
ECU-015257,2122,657,328,329,28,23.464285714285715
ECU-015258,2122,312,145,167,15,20.8
ECU-015259,2122,12,3,9,3,4.0
ECU-015260,2122,652,347,305,32,20.375
ECU-015261,2122,1057,412,645,63,16.77777777777778
ECU-015262,2122,365,185,180,19,19.210526315789473
ECU-015263,2122,1671,877,794,59,28.322033898305083
ECU-015264,2122,345,161,184,14,24.642857142857142
ECU-015265,2122,187,117,70,12,15.583333333333334
ECU-015266,2122,34,18,16,3,11.333333333333334
ECU-015267,2122,1112,592,520,52,21.384615384615383
ECU-015268,2122,17,7,10,7,2.4285714285714284
ECU-015269,2122,1301,670,631,56,23.232142857142858
ECU-015270,2122,7,4,3,6,1.1666666666666667
ECU-015271,2122,578,301,277,29,19.93103448275862
ECU-015272,2122,689,317,372,31,22.225806451612904
ECU-015273,2122,308,145,163,8,38.5
ECU-015274,2122,831,402,429,28,29.678571428571427
ECU-015275,2122,2589,1266,1323,92,28.141304347826086
ECU-015276,2122,42,21,21,3,14.0
ECU-015277,2122,644,331,313,29,22.20689655172414
ECU-015278,2122,322,131,191,23,14.0
ECU-015279,2122,121,58,63,7,17.285714285714285
ECU-015280,2122,223,77,146,12,18.583333333333332
ECU-015281,2122,1333,686,647,52,25.634615384615383
ECU-015282,2122,228,107,121,16,14.25
ECU-015283,2122,795,396,399,26,30.576923076923077
ECU-015284,2122,29,16,13,3,9.666666666666666
ECU-015285,2122,110,58,52,6,18.333333333333332
ECU-015286,2122,148,81,67,12,12.333333333333334
ECU-015287,2122,2300,1104,1196,71,32.394366197183096
ECU-015288,2122,117,56,61,20,5.85
ECU-015289,2122,552,270,282,21,26.285714285714285
ECU-015290,2122,419,190,229,17,24.647058823529413
ECU-015291,2122,292,131,161,25,11.68
ECU-015292,2122,82,37,45,5,16.4
ECU-015293,2122,540,258,282,49,11.020408163265307
ECU-015294,2122,1643,881,762,57,28.82456140350877
ECU-015295,2122,728,635,93,83,8.771084337349398
ECU-015296,2122,1484,810,674,57,26.035087719298247
ECU-015297,2122,1152,541,611,42,27.428571428571427
ECU-015298,2122,91,41,50,10,9.1
ECU-015299,2122,1955,1057,898,68,28.75
ECU-015300,2122,581,255,326,22,26.40909090909091
ECU-015301,2122,240,107,133,12,20.0
ECU-015302,2122,115,62,53,5,23.0
ECU-015303,2122,2340,1043,1297,92,25.434782608695652
ECU-015304,2122,83,40,43,15,5.533333333333333
ECU-015305,2122,458,213,245,22,20.818181818181817
ECU-015306,2122,1734,849,885,72,24.083333333333332
ECU-015307,2122,199,100,99,20,9.95
ECU-015308,2122,95,44,51,9,10.555555555555555
ECU-015309,2122,1319,647,672,58,22.74137931034483
ECU-015310,2122,425,241,184,15,28.333333333333332
ECU-015311,2122,1050,501,549,65,16.153846153846153
ECU-015312,2122,779,390,389,25,31.16
ECU-015313,2122,1399,671,728,64,21.859375
ECU-015314,2122,172,77,95,14,12.285714285714286
ECU-015315,2122,89,43,46,6,14.833333333333334
ECU-015316,2122,902,442,460,44,20.5
ECU-015317,2122,509,228,281,35,14.542857142857143
ECU-015318,2122,136,66,70,8,17.0
ECU-015319,2122,100,47,53,9,11.11111111111111
ECU-015320,2122,258,139,119,20,12.9
ECU-015321,2122,162,80,82,10,16.2
ECU-015322,2122,83,43,40,10,8.3
ECU-015323,2122,77,38,39,7,11.0
ECU-015324,2122,233,118,115,9,25.88888888888889
ECU-015325,2122,10,3,7,2,5.0
ECU-015326,2122,277,130,147,7,39.57142857142857
ECU-015327,2122,752,341,411,76,9.894736842105264
ECU-015328,2122,76,39,37,9,8.444444444444445
ECU-015329,2122,43,18,25,2,21.5
ECU-015330,2122,11,5,6,2,5.5
ECU-015331,2122,85,37,48,16,5.3125
ECU-015332,2122,94,43,51,10,9.4
ECU-015333,2122,305,166,139,12,25.416666666666668
ECU-015334,2122,653,332,321,37,17.64864864864865
ECU-015335,2122,291,149,142,11,26.454545454545453
ECU-015336,2122,1364,671,693,59,23.11864406779661
ECU-015337,2122,617,354,263,57,10.824561403508772
ECU-015338,2122,297,147,150,18,16.5
ECU-015339,2122,966,468,498,38,25.42105263157895
ECU-015340,2122,162,90,72,7,23.142857142857142
ECU-015341,2122,147,65,82,6,24.5
ECU-015342,2122,861,413,448,48,17.9375
ECU-015343,2122,474,235,239,26,18.23076923076923
ECU-015344,2122,136,67,69,10,13.6
ECU-015345,2122,237,113,124,27,8.777777777777779
ECU-015346,2122,2393,1198,1195,85,28.152941176470588
ECU-015347,2122,2098,1043,1055,72,29.13888888888889
ECU-015348,2122,814,392,422,32,25.4375
ECU-015349,2122,482,247,235,17,28.352941176470587
ECU-015350,2122,123,61,62,7,17.571428571428573
ECU-015351,2122,102,37,65,16,6.375
ECU-015352,2122,2232,880,1352,80,27.9
ECU-015353,2122,792,396,396,25,31.68
ECU-015354,2122,561,277,284,31,18.096774193548388
ECU-015355,2122,1262,608,654,53,23.81132075471698
ECU-015356,2122,303,136,167,16,18.9375
ECU-015357,2122,192,99,93,9,21.333333333333332
ECU-015358,2122,747,305,442,36,20.75
ECU-015359,2122,158,74,84,12,13.166666666666666
ECU-015360,2122,110,50,60,9,12.222222222222221
ECU-015361,2122,409,205,204,19,21.526315789473685
ECU-015362,2122,183,81,102,11,16.636363636363637
ECU-015363,2122,104,51,53,10,10.4
ECU-015364,2122,462,232,230,24,19.25
ECU-015365,2122,197,98,99,9,21.88888888888889
ECU-015366,2122,198,103,95,8,24.75
ECU-015367,2122,51,28,23,3,17.0
ECU-015368,2122,191,110,81,12,15.916666666666666
ECU-015369,2122,169,77,92,7,24.142857142857142
ECU-015370,2122,3,1,2,1,3.0
ECU-015371,2122,1,0,1,1,1.0
ECU-015372,2122,419,222,197,18,23.27777777777778
ECU-015373,2122,9,5,4,1,9.0
ECU-015374,2122,439,202,237,16,27.4375
ECU-015375,2122,81,50,31,3,27.0
ECU-015376,2122,22,12,10,1,22.0
ECU-015377,2122,2085,1070,1015,162,12.87037037037037
ECU-015378,2122,227,110,117,11,20.636363636363637
ECU-015379,2122,215,125,90,12,17.916666666666668
ECU-015380,2122,19,12,7,4,4.75
ECU-015381,2122,27,12,15,3,9.0
ECU-015382,2122,65,27,38,5,13.0
ECU-015383,2122,68,32,36,12,5.666666666666667
ECU-015384,2122,112,54,58,13,8.615384615384615
ECU-015385,2122,1534,715,819,56,27.392857142857142
ECU-015386,2122,3990,1960,2030,129,30.930232558139537
ECU-015387,2122,21,8,13,7,3.0
ECU-015388,2122,2893,1502,1391,98,29.520408163265305
ECU-015389,2122,989,515,474,17,58.1764705882353
ECU-015390,2122,73,32,41,9,8.11111111111111
ECU-015391,2122,2017,953,1064,65,31.03076923076923
ECU-015392,2122,2191,1133,1058,64,34.234375
ECU-015393,2122,825,390,435,32,25.78125
ECU-015394,2122,89,40,49,10,8.9
ECU-015395,2122,76,39,37,10,7.6
ECU-015396,2122,544,261,283,39,13.948717948717949
ECU-015397,2122,2101,1098,1003,72,29.180555555555557
ECU-015398,2122,1741,876,865,59,29.508474576271187
ECU-015399,2122,1129,563,566,46,24.543478260869566
ECU-015400,2122,112,38,74,4,28.0
ECU-015401,2122,8,5,3,2,4.0
ECU-015402,2122,130,53,77,13,10.0
ECU-015403,2122,15,9,6,1,15.0
ECU-015404,2122,23,9,14,1,23.0
ECU-015405,2122,134,70,64,16,8.375
ECU-015406,2122,16,3,13,6,2.6666666666666665
ECU-015407,2122,10,7,3,2,5.0
ECU-015408,2122,842,408,434,47,17.914893617021278
ECU-015409,2122,98,35,63,12,8.166666666666666
ECU-015410,2122,214,103,111,24,8.916666666666666
ECU-015411,2122,983,501,482,36,27.305555555555557
ECU-015412,2122,255,125,130,17,15.0
ECU-015413,2122,2091,1009,1082,75,27.88
ECU-015414,2122,485,242,243,31,15.64516129032258
ECU-015415,2122,35,13,22,7,5.0
ECU-015416,2122,492,237,255,17,28.941176470588236
ECU-015417,2122,395,179,216,16,24.6875
ECU-015418,2122,388,180,208,26,14.923076923076923
ECU-015419,2122,565,289,276,26,21.73076923076923
ECU-015420,2122,165,67,98,10,16.5
ECU-015421,2122,1681,867,814,55,30.563636363636363
ECU-015422,2122,292,148,144,20,14.6
ECU-015423,2122,339,172,167,21,16.142857142857142
ECU-015424,2122,304,156,148,18,16.88888888888889
ECU-015425,2122,131,70,61,9,14.555555555555555
ECU-015426,2122,1404,706,698,41,34.24390243902439
ECU-015427,2122,262,104,158,15,17.466666666666665
ECU-015428,2122,386,194,192,16,24.125
ECU-015429,2122,117,59,58,9,13.0
ECU-015430,2122,399,196,203,16,24.9375
ECU-015431,2122,2285,1165,1120,80,28.5625
ECU-015432,2122,310,145,165,20,15.5
ECU-015433,2122,326,162,164,11,29.636363636363637
ECU-015434,2122,357,172,185,20,17.85
ECU-015435,2122,1376,666,710,46,29.91304347826087
ECU-015436,2122,220,98,122,9,24.444444444444443
ECU-015437,2122,2179,1148,1031,92,23.684782608695652
ECU-015438,2122,1377,602,775,62,22.20967741935484
ECU-015439,2122,20,9,11,7,2.857142857142857
ECU-015440,2122,1194,512,682,79,15.113924050632912
ECU-015441,2122,56,25,31,4,14.0
ECU-015442,2122,139,58,81,9,15.444444444444445
ECU-015443,2122,213,120,93,13,16.384615384615383
ECU-015444,2122,266,105,161,16,16.625
ECU-015445,2122,790,407,383,31,25.483870967741936
ECU-015446,2122,414,208,206,22,18.818181818181817
ECU-015447,2122,471,236,235,20,23.55
ECU-015448,2122,695,335,360,28,24.821428571428573
ECU-015449,2122,708,348,360,54,13.11111111111111
ECU-015450,2122,1543,736,807,42,36.73809523809524
ECU-015451,2122,325,159,166,16,20.3125
ECU-015452,2122,563,277,286,32,17.59375
ECU-015453,2122,202,91,111,19,10.631578947368421
ECU-015454,2122,623,306,317,29,21.482758620689655
ECU-015455,2122,993,477,516,56,17.732142857142858
ECU-015456,2122,919,420,499,51,18.019607843137255
ECU-015457,2122,196,95,101,20,9.8
ECU-015458,2122,572,286,286,28,20.428571428571427
ECU-015459,2122,1442,771,671,66,21.848484848484848
ECU-015460,2122,2218,1185,1033,64,34.65625
ECU-015461,2122,157,80,77,16,9.8125
ECU-015462,2122,273,148,125,24,11.375
ECU-015463,2122,325,163,162,21,15.476190476190476
ECU-015464,2122,210,101,109,19,11.052631578947368
ECU-015465,2122,151,74,77,12,12.583333333333334
ECU-015466,2122,318,157,161,18,17.666666666666668
ECU-015467,2122,524,255,269,28,18.714285714285715
ECU-015468,2122,2073,999,1074,103,20.12621359223301
ECU-015469,2122,104,47,57,8,13.0
ECU-015470,2122,233,106,127,18,12.944444444444445
ECU-015471,2122,101,45,56,13,7.769230769230769
ECU-015472,2122,1102,486,616,63,17.49206349206349
ECU-015473,2122,511,255,256,43,11.883720930232558
ECU-015474,2122,1014,524,490,50,20.28
ECU-015475,2122,789,404,385,31,25.451612903225808
ECU-015476,2122,370,159,211,20,18.5
ECU-015477,2122,916,427,489,32,28.625
ECU-015478,2122,88,38,50,9,9.777777777777779
ECU-015479,2122,887,446,441,62,14.306451612903226
ECU-015480,2122,1639,649,990,84,19.511904761904763
ECU-015481,2122,1151,572,579,118,9.754237288135593
ECU-015482,2122,880,207,673,37,23.783783783783782
ECU-015483,2122,91,44,47,5,18.2
ECU-015484,2122,1733,885,848,173,10.017341040462428
ECU-015485,2122,1412,698,714,58,24.344827586206897
ECU-015486,2122,212,106,106,10,21.2
ECU-015487,2122,353,182,171,14,25.214285714285715
ECU-015488,2122,416,220,196,20,20.8
ECU-015489,2122,366,184,182,19,19.263157894736842
ECU-015490,2122,755,373,382,32,23.59375
ECU-015491,2122,272,126,146,11,24.727272727272727
ECU-015492,2122,2434,1220,1214,104,23.403846153846153
ECU-015493,2122,805,382,423,30,26.833333333333332
ECU-015494,2122,80,38,42,5,16.0
ECU-015495,2122,221,116,105,10,22.1
ECU-015496,2122,239,120,119,10,23.9
ECU-015497,2122,149,56,93,8,18.625
ECU-015498,2122,72,34,38,5,14.4
ECU-015499,2122,49,26,23,3,16.333333333333332
ECU-015500,2122,13,6,7,1,13.0
ECU-015501,2122,24,11,13,1,24.0
ECU-015502,2122,31,15,16,2,15.5
ECU-015503,2122,151,82,69,11,13.727272727272727
ECU-015504,2122,34,16,18,2,17.0
ECU-015505,2122,30,16,14,2,15.0
ECU-015506,2122,633,309,324,33,19.181818181818183
ECU-015507,2122,93,43,50,7,13.285714285714286
ECU-015508,2122,199,91,108,12,16.583333333333332
ECU-015509,2122,1124,549,575,48,23.416666666666668
ECU-015510,2122,1542,802,740,67,23.01492537313433
ECU-015511,2122,395,197,198,17,23.235294117647058
ECU-015512,2122,244,132,112,13,18.76923076923077
ECU-015513,2122,1008,477,531,37,27.243243243243242
ECU-015514,2122,215,120,95,11,19.545454545454547
ECU-015515,2122,1144,578,566,48,23.833333333333332
ECU-015516,2122,35,20,15,2,17.5
ECU-015517,2122,189,85,104,14,13.5
ECU-015518,2122,47,26,21,4,11.75
ECU-015519,2122,490,230,260,31,15.806451612903226
ECU-015520,2122,159,79,80,8,19.875
ECU-015521,2122,767,385,382,29,26.448275862068964
ECU-015522,2122,262,136,126,28,9.357142857142858
ECU-015523,2122,90,44,46,13,6.923076923076923
ECU-015524,2122,624,247,377,35,17.82857142857143
ECU-015525,2122,197,87,110,7,28.142857142857142
ECU-015526,2122,268,139,129,9,29.77777777777778
ECU-015527,2122,612,310,302,26,23.53846153846154
ECU-015528,2122,85,42,43,6,14.166666666666666
ECU-015529,2122,160,76,84,16,10.0
ECU-015530,2122,56,23,33,6,9.333333333333334
ECU-015531,2122,40,24,16,1,40.0
ECU-015532,2122,34,23,11,6,5.666666666666667
ECU-015533,2122,346,173,173,17,20.352941176470587
ECU-015534,2122,31,17,14,2,15.5
ECU-015535,2122,13,10,3,1,13.0
ECU-015536,2122,224,122,102,13,17.23076923076923
ECU-015537,2122,52,22,30,3,17.333333333333332
ECU-015538,2122,299,146,153,15,19.933333333333334
ECU-015539,2122,17,10,7,1,17.0
ECU-015540,2122,30,14,16,2,15.0
ECU-015541,2122,620,306,314,27,22.962962962962962
ECU-015542,2122,144,51,93,23,6.260869565217392
ECU-015543,2122,290,144,146,17,17.058823529411764
ECU-015544,2122,168,93,75,11,15.272727272727273
ECU-015545,2122,83,47,36,3,27.666666666666668
ECU-015546,2122,154,79,75,11,14.0
ECU-015547,2122,93,50,43,8,11.625
ECU-015548,2122,207,100,107,14,14.785714285714286
ECU-015549,2122,54,27,27,2,27.0
ECU-015550,2122,599,290,309,26,23.03846153846154
ECU-015551,2122,46,23,23,3,15.333333333333334
ECU-015552,2122,35,14,21,2,17.5
ECU-015553,2122,196,91,105,14,14.0
ECU-015554,2122,5,4,1,1,5.0
ECU-015555,2122,11,9,2,1,11.0
ECU-015556,2122,8,2,6,1,8.0
ECU-015557,2122,17,9,8,1,17.0
ECU-015558,2122,7,3,4,1,7.0
ECU-015559,2122,58,25,33,3,19.333333333333332
ECU-015560,2122,13,4,9,1,13.0
ECU-015561,2122,61,22,39,4,15.25
ECU-015562,2122,6,4,2,1,6.0
ECU-015563,2122,28,11,17,2,14.0
ECU-015564,2122,16,8,8,1,16.0
ECU-015565,2122,26,10,16,1,26.0
ECU-015566,2122,46,22,24,4,11.5
ECU-015567,2122,5,4,1,1,5.0
ECU-015568,2122,1112,633,479,54,20.59259259259259
ECU-015569,2122,140,75,65,10,14.0
ECU-015570,2122,350,176,174,14,25.0
ECU-015571,2122,817,421,396,26,31.423076923076923
ECU-015572,2122,13,5,8,1,13.0
ECU-015573,2122,73,37,36,4,18.25
ECU-015574,2122,16,13,3,2,8.0
ECU-015575,2122,502,247,255,29,17.310344827586206
ECU-015576,2122,484,234,250,18,26.88888888888889
ECU-015577,2122,25,12,13,5,5.0
ECU-015578,2122,247,120,127,20,12.35
ECU-015579,2122,1313,622,691,42,31.261904761904763
ECU-015580,2122,49,27,22,5,9.8
ECU-015581,2122,76,39,37,9,8.444444444444445
ECU-015582,2122,962,470,492,37,26.0
ECU-015583,2122,217,109,108,11,19.727272727272727
ECU-015584,2122,57,28,29,5,11.4
ECU-015585,2122,37,18,19,2,18.5
ECU-015586,2122,815,393,422,48,16.979166666666668
ECU-015587,2122,248,116,132,10,24.8
ECU-015588,2122,584,281,303,28,20.857142857142858
ECU-015589,2122,451,237,214,19,23.736842105263158
ECU-015590,2122,776,357,419,34,22.823529411764707
ECU-015591,2122,111,56,55,6,18.5
ECU-015592,2122,19,8,11,2,9.5
ECU-015593,2122,105,51,54,7,15.0
ECU-015594,2122,43,20,23,4,10.75
ECU-015595,2122,336,160,176,18,18.666666666666668
ECU-015596,2122,63,37,26,6,10.5
ECU-015597,2122,27,7,20,3,9.0
ECU-015598,2122,32,14,18,1,32.0
ECU-015599,2122,429,240,189,21,20.428571428571427
ECU-015600,2122,702,385,317,47,14.936170212765957
ECU-015601,2122,27,11,16,2,13.5
ECU-015602,2122,400,191,209,18,22.22222222222222
ECU-015603,2122,178,86,92,15,11.866666666666667
ECU-015604,2122,672,267,405,42,16.0
ECU-015605,2122,1756,851,905,65,27.015384615384615
ECU-015606,2122,535,251,284,38,14.078947368421053
ECU-015607,2122,503,243,260,21,23.952380952380953
ECU-015608,2122,46,19,27,2,23.0
ECU-015609,2122,827,431,396,31,26.677419354838708
ECU-015610,2122,938,463,475,30,31.266666666666666
ECU-015611,2122,18,5,13,1,18.0
ECU-015612,2122,286,141,145,8,35.75
ECU-015613,2122,277,131,146,17,16.294117647058822
ECU-015614,2122,88,43,45,5,17.6
ECU-015615,2122,158,78,80,10,15.8
ECU-015616,2122,74,33,41,3,24.666666666666668
ECU-015617,2122,466,217,249,18,25.88888888888889
ECU-015618,2122,57,26,31,11,5.181818181818182
ECU-015619,2122,980,515,465,44,22.272727272727273
ECU-015620,2122,555,280,275,31,17.903225806451612
ECU-015621,2122,162,77,85,6,27.0
ECU-015622,2122,534,295,239,16,33.375
ECU-015623,2122,79,32,47,17,4.647058823529412
ECU-015624,2122,306,151,155,11,27.818181818181817
ECU-015625,2122,748,353,395,25,29.92
ECU-015626,2122,117,48,69,10,11.7
ECU-015627,2122,366,174,192,31,11.806451612903226
ECU-015628,2122,890,456,434,35,25.428571428571427
ECU-015629,2122,151,70,81,8,18.875
ECU-015630,2122,309,183,126,16,19.3125
ECU-015631,2122,21,12,9,4,5.25
ECU-015632,2122,2331,1117,1214,86,27.1046511627907
ECU-015633,2122,1273,665,608,40,31.825
ECU-015634,2122,62,33,29,3,20.666666666666668
ECU-015635,2122,244,97,147,11,22.181818181818183
ECU-015636,2122,57,26,31,3,19.0
ECU-015637,2122,4087,2028,2059,101,40.46534653465346
ECU-015638,2122,251,110,141,9,27.88888888888889
ECU-015639,2122,9,3,6,1,9.0
ECU-015640,2122,408,196,212,19,21.473684210526315
ECU-015641,2122,6,3,3,1,6.0
ECU-015642,2122,51,19,32,5,10.2
ECU-015643,2122,441,212,229,16,27.5625
ECU-015644,2122,132,61,71,10,13.2
ECU-015645,2122,10,6,4,1,10.0
ECU-015646,2122,4,1,3,1,4.0
ECU-015647,2122,13,8,5,1,13.0
ECU-015648,2122,6,4,2,1,6.0
ECU-015649,2122,151,78,73,10,15.1
ECU-015650,2122,958,478,480,40,23.95
ECU-015651,2122,577,276,301,21,27.476190476190474
ECU-015652,2122,433,228,205,23,18.82608695652174
ECU-015653,2122,98,39,59,8,12.25
ECU-015654,2122,380,196,184,19,20.0
ECU-015655,2122,223,111,112,12,18.583333333333332
ECU-015656,2122,316,150,166,27,11.703703703703704
ECU-015657,2122,106,46,60,10,10.6
ECU-015658,2122,429,209,220,16,26.8125
ECU-015659,2122,182,99,83,10,18.2
ECU-015660,2122,86,40,46,7,12.285714285714286
ECU-015661,2122,1087,504,583,34,31.970588235294116
ECU-015662,2122,198,82,116,11,18.0
ECU-015663,2122,118,54,64,23,5.130434782608695
ECU-015664,2122,122,66,56,9,13.555555555555555
ECU-015665,2122,548,292,256,43,12.744186046511627
ECU-015666,2122,847,452,395,40,21.175
ECU-015667,2122,3251,1693,1558,134,24.261194029850746
ECU-015668,2122,2605,1422,1183,90,28.944444444444443
ECU-015669,2122,675,351,324,25,27.0
ECU-015670,2122,119,58,61,17,7.0
ECU-015671,2122,40,14,26,5,8.0
ECU-015672,2122,16,4,12,2,8.0
ECU-015673,2122,155,77,78,14,11.071428571428571
ECU-015674,2122,317,159,158,51,6.215686274509804
ECU-015675,2122,19,10,9,2,9.5
ECU-015676,2122,39,20,19,4,9.75
ECU-015677,2122,750,379,371,27,27.77777777777778
ECU-015678,2122,156,81,75,7,22.285714285714285
ECU-015679,2122,78,38,40,5,15.6
ECU-015680,2122,2107,1097,1010,71,29.676056338028168
ECU-015681,2122,65,28,37,3,21.666666666666668
ECU-015682,2122,121,41,80,7,17.285714285714285
ECU-015683,2122,413,212,201,23,17.956521739130434
ECU-015684,2122,185,92,93,11,16.818181818181817
ECU-015685,2122,1397,618,779,61,22.901639344262296
ECU-015686,2122,801,413,388,38,21.07894736842105
ECU-015687,2122,928,427,501,37,25.08108108108108
ECU-015688,2122,90,41,49,8,11.25
ECU-015689,2122,73,34,39,14,5.214285714285714
ECU-015690,2122,537,271,266,28,19.178571428571427
ECU-015691,2122,422,216,206,41,10.292682926829269
ECU-015692,2122,18,7,11,1,18.0
ECU-015693,2122,1511,766,745,122,12.385245901639344
ECU-015694,2122,391,176,215,41,9.536585365853659
ECU-015695,2122,64,32,32,3,21.333333333333332
ECU-015696,2122,51,31,20,2,25.5
ECU-015697,2122,12,6,6,2,6.0
ECU-015698,2122,110,55,55,8,13.75
ECU-015699,2122,65,32,33,4,16.25
ECU-015700,2122,438,216,222,28,15.642857142857142
ECU-015701,2122,46,27,19,2,23.0
ECU-015702,2122,168,69,99,18,9.333333333333334
ECU-015703,2122,994,300,694,41,24.24390243902439
ECU-015704,2122,148,68,80,7,21.142857142857142
ECU-015705,2122,136,65,71,9,15.11111111111111
ECU-015706,2122,196,99,97,10,19.6
ECU-015707,2122,159,81,78,10,15.9
ECU-015708,2122,1921,987,934,92,20.880434782608695
ECU-015709,2122,727,330,397,30,24.233333333333334
ECU-015710,2122,610,306,304,84,7.261904761904762
ECU-015711,2122,322,137,185,9,35.77777777777778
ECU-015712,2122,783,382,401,27,29.0
ECU-015713,2122,27,9,18,2,13.5
ECU-015714,2122,83,30,53,11,7.545454545454546
ECU-015715,2122,773,349,424,30,25.766666666666666
ECU-015716,2122,143,92,51,5,28.6
ECU-015717,2122,72,28,44,5,14.4
ECU-015718,2122,493,229,264,41,12.024390243902438
ECU-015719,2122,46,20,26,4,11.5
ECU-015720,2122,18,6,12,2,9.0
ECU-015721,2122,488,186,302,23,21.217391304347824
ECU-015722,2122,9,3,6,1,9.0
ECU-015723,2122,9,5,4,2,4.5
ECU-015724,2122,2,1,1,4,0.5
ECU-015725,2122,579,293,286,21,27.571428571428573
ECU-015726,2122,34,15,19,2,17.0
ECU-015727,2122,22,11,11,1,22.0
ECU-015728,2122,2,1,1,1,2.0
ECU-015729,2122,129,80,49,7,18.428571428571427
ECU-015730,2122,4,2,2,2,2.0
ECU-015731,2122,56,21,35,14,4.0
ECU-015732,2122,236,126,110,10,23.6
ECU-015733,2122,135,53,82,13,10.384615384615385
ECU-015734,2122,1602,769,833,90,17.8
ECU-015735,2122,111,53,58,7,15.857142857142858
ECU-015736,2122,284,135,149,40,7.1
ECU-015737,2122,4,3,1,1,4.0
ECU-015738,2122,1880,940,940,71,26.47887323943662
ECU-015739,2122,1538,749,789,121,12.710743801652892
ECU-015740,2122,531,271,260,43,12.348837209302326
ECU-015741,2122,62,32,30,5,12.4
ECU-015742,2122,38,20,18,7,5.428571428571429
ECU-015743,2122,90,40,50,5,18.0
ECU-015744,2122,105,41,64,6,17.5
ECU-015745,2122,99,51,48,4,24.75
ECU-015746,2122,174,91,83,12,14.5
ECU-015747,2122,140,66,74,7,20.0
ECU-015748,2122,34,11,23,2,17.0
ECU-015749,2122,107,47,60,8,13.375
ECU-015750,2122,123,56,67,8,15.375
ECU-015751,2122,88,33,55,7,12.571428571428571
ECU-015752,2122,767,151,616,27,28.40740740740741
ECU-015753,2122,121,53,68,10,12.1
ECU-015754,2122,146,72,74,24,6.083333333333333
ECU-015755,2122,29,15,14,1,29.0
ECU-015756,2122,529,257,272,47,11.25531914893617
ECU-015757,2122,219,103,116,11,19.90909090909091
ECU-015758,2122,1288,530,758,46,28.0
ECU-015759,2122,397,199,198,29,13.689655172413794
ECU-015760,2122,45,18,27,2,22.5
ECU-015761,2122,32,19,13,4,8.0
ECU-015762,2122,156,60,96,15,10.4
ECU-015763,2122,150,73,77,14,10.714285714285714
ECU-015764,2122,20,8,12,1,20.0
ECU-015765,2122,9,5,4,1,9.0
ECU-015766,2122,86,36,50,4,21.5
ECU-015767,2122,169,79,90,6,28.166666666666668
ECU-015768,2122,15,7,8,3,5.0
ECU-015769,2122,22,11,11,4,5.5
ECU-015770,2122,645,336,309,18,35.833333333333336
ECU-015771,2122,78,36,42,9,8.666666666666666
ECU-015772,2122,123,30,93,11,11.181818181818182
ECU-015773,2122,131,45,86,11,11.909090909090908
ECU-015774,2122,490,257,233,39,12.564102564102564
ECU-015775,2122,5,4,1,3,1.6666666666666667
ECU-015776,2122,23,11,12,12,1.9166666666666667
ECU-015777,2122,152,69,83,18,8.444444444444445
ECU-015778,2122,158,49,109,16,9.875
ECU-015779,2122,260,141,119,28,9.285714285714286
ECU-015780,2122,159,79,80,11,14.454545454545455
ECU-015781,2122,166,75,91,18,9.222222222222221
ECU-015782,2122,442,236,206,56,7.892857142857143
ECU-015783,2122,18,12,6,3,6.0
ECU-015784,2122,91,48,43,16,5.6875
ECU-015785,2122,77,34,43,10,7.7
ECU-015786,2122,23,12,11,2,11.5
ECU-015787,2122,11,8,3,3,3.6666666666666665
ECU-015788,2122,46,21,25,3,15.333333333333334
ECU-015789,2122,31,16,15,4,7.75
ECU-015790,2122,57,30,27,4,14.25
ECU-015791,2122,287,137,150,24,11.958333333333334
ECU-015792,2122,3,2,1,1,3.0
ECU-015793,2122,225,138,87,14,16.071428571428573
ECU-015794,2122,43,18,25,5,8.6
ECU-015795,2122,26,12,14,2,13.0
ECU-015796,2122,79,36,43,10,7.9
ECU-015797,2122,10,5,5,3,3.3333333333333335
ECU-015798,2122,28,10,18,2,14.0
ECU-015799,2122,5,5,0,1,5.0
ECU-015800,2122,19,9,10,6,3.1666666666666665
ECU-015801,2122,57,30,27,6,9.5
ECU-015802,2122,367,179,188,44,8.340909090909092
ECU-015803,2122,77,50,27,15,5.133333333333334
ECU-015804,2122,664,314,350,33,20.12121212121212
ECU-015805,2122,205,92,113,32,6.40625
ECU-015806,2122,7,2,5,1,7.0
ECU-015807,2122,160,72,88,11,14.545454545454545
ECU-015808,2122,203,109,94,10,20.3
ECU-015809,2122,55,21,34,11,5.0
ECU-015810,2122,286,150,136,20,14.3
ECU-015811,2122,4,1,3,3,1.3333333333333333
ECU-015812,2122,39,22,17,5,7.8
ECU-015813,2122,631,0,631,56,11.267857142857142
ECU-015814,2122,152,71,81,9,16.88888888888889
ECU-015815,2122,49,20,29,7,7.0
ECU-015816,2122,654,311,343,60,10.9
ECU-015817,2122,336,192,144,31,10.838709677419354
ECU-015818,2122,446,232,214,43,10.372093023255815
ECU-015819,2122,735,396,339,92,7.989130434782608
ECU-015820,2122,42,18,24,19,2.210526315789474
ECU-015821,2122,137,63,74,14,9.785714285714286
ECU-015822,2122,171,86,85,13,13.153846153846153
ECU-015823,2122,1,0,1,3,0.3333333333333333
ECU-015824,2122,168,90,78,13,12.923076923076923
ECU-015825,2122,1031,520,511,38,27.13157894736842
ECU-015826,2122,519,251,268,25,20.76
ECU-015827,2122,177,177,0,10,17.7
ECU-015828,2122,268,14,254,11,24.363636363636363
ECU-015829,2122,112,6,106,6,18.666666666666668
ECU-015830,2122,264,118,146,14,18.857142857142858
ECU-015831,2122,135,59,76,9,15.0
ECU-015832,2122,155,64,91,12,12.916666666666666
ECU-015833,2122,129,61,68,20,6.45
ECU-015834,2122,2255,1115,1140,232,9.719827586206897
ECU-015835,2122,53,19,34,10,5.3
ECU-015836,2122,5,2,3,1,5.0
ECU-015837,2122,439,229,210,64,6.859375
ECU-015838,2122,122,61,61,8,15.25
ECU-015839,2122,407,237,170,26,15.653846153846153
ECU-015840,2122,92,26,66,13,7.076923076923077
ECU-015841,2122,188,104,84,14,13.428571428571429
ECU-015842,2122,69,40,29,8,8.625
ECU-015843,2122,48,25,23,11,4.363636363636363
ECU-015844,2122,44,26,18,3,14.666666666666666
ECU-015845,2122,191,108,83,17,11.235294117647058
ECU-015846,2122,52,21,31,6,8.666666666666666
ECU-015847,2122,347,206,141,4,86.75
ECU-015848,2122,32,17,15,4,8.0
ECU-015849,2122,240,110,130,10,24.0
ECU-015850,2122,38,4,34,7,5.428571428571429
ECU-015851,2122,10,6,4,4,2.5
ECU-015852,2122,230,161,69,6,38.333333333333336
ECU-015853,2122,13,7,6,6,2.1666666666666665
ECU-015854,2122,24,12,12,5,4.8
ECU-015855,2122,23,16,7,4,5.75
ECU-015856,2122,91,43,48,6,15.166666666666666
ECU-015857,2122,47,27,20,6,7.833333333333333
ECU-015858,2122,342,161,181,13,26.307692307692307
ECU-015859,2122,18,7,11,1,18.0
ECU-015860,2122,154,23,131,16,9.625
ECU-015861,2122,119,52,67,13,9.153846153846153
ECU-015862,2122,145,69,76,8,18.125
ECU-015863,2122,264,100,164,7,37.714285714285715
ECU-015864,2122,23,9,14,1,23.0
ECU-015865,2122,158,75,83,12,13.166666666666666
ECU-015866,2122,35,19,16,3,11.666666666666666
ECU-015867,2122,3,0,3,6,0.5
ECU-015868,2122,21,13,8,4,5.25
ECU-015869,2122,18,10,8,2,9.0
ECU-015870,2122,28,16,12,4,7.0
ECU-015871,2122,22,15,7,4,5.5
ECU-015872,2122,37,19,18,3,12.333333333333334
ECU-015873,2122,79,37,42,7,11.285714285714286
ECU-015874,2122,15,8,7,4,3.75
ECU-015875,2122,46,27,19,8,5.75
ECU-015876,2122,4,1,3,3,1.3333333333333333
ECU-015877,2122,19,10,9,4,4.75
ECU-015878,2122,20,6,14,2,10.0
ECU-015879,2122,59,30,29,4,14.75
ECU-015880,2122,3,2,1,1,3.0
ECU-015881,2122,23,10,13,2,11.5
ECU-015882,2122,54,19,35,4,13.5
ECU-015883,2122,93,36,57,9,10.333333333333334
ECU-015884,2122,37,18,19,4,9.25
ECU-015885,2122,63,25,38,13,4.846153846153846
ECU-015886,2122,67,25,42,8,8.375
ECU-015887,2122,63,25,38,4,15.75
ECU-015888,2122,18,6,12,4,4.5
ECU-015889,2122,108,52,56,11,9.818181818181818
ECU-015890,2122,69,37,32,6,11.5
ECU-015891,2122,23,10,13,6,3.8333333333333335
ECU-015892,2122,444,198,246,17,26.11764705882353
ECU-015893,2122,56,22,34,9,6.222222222222222
ECU-015894,2122,20,8,12,3,6.666666666666667
ECU-015895,2122,13,8,5,2,6.5
ECU-015896,2122,22,13,9,3,7.333333333333333
ECU-015897,2122,21,7,14,4,5.25
ECU-015898,2122,87,27,60,6,14.5
ECU-015899,2122,15,7,8,2,7.5
ECU-015900,2122,11,7,4,4,2.75
ECU-015901,2122,10,7,3,3,3.3333333333333335
ECU-015902,2122,9,5,4,2,4.5
ECU-015903,2122,5,3,2,1,5.0
ECU-015904,2122,30,17,13,3,10.0
ECU-015905,2122,25,12,13,2,12.5
ECU-015906,2122,13,7,6,2,6.5
ECU-015907,2122,89,44,45,8,11.125
ECU-015908,2122,17,7,10,2,8.5
ECU-015909,2122,2,0,2,1,2.0
ECU-015910,2122,25,8,17,4,6.25
ECU-015911,2122,11,7,4,3,3.6666666666666665
ECU-015912,2122,12,5,7,1,12.0
ECU-015913,2122,15,8,7,3,5.0
ECU-015914,2122,13,7,6,4,3.25
ECU-015915,2122,1,0,1,2,0.5
ECU-015916,2122,17,6,11,3,5.666666666666667
ECU-015917,2122,24,11,13,2,12.0
ECU-015918,2122,36,15,21,5,7.2
ECU-015919,2122,74,31,43,4,18.5
ECU-015920,2122,22,12,10,2,11.0
ECU-015921,2122,8,2,6,3,2.6666666666666665
ECU-015922,2122,12,9,3,4,3.0
ECU-015923,2122,13,8,5,3,4.333333333333333
ECU-015924,2122,83,44,39,3,27.666666666666668
ECU-015925,2122,63,32,31,13,4.846153846153846
ECU-015926,2122,5,1,4,1,5.0
ECU-015927,2122,61,25,36,5,12.2
ECU-015928,2122,8,5,3,1,8.0
ECU-015929,2122,25,16,9,2,12.5
ECU-015930,2122,16,6,10,3,5.333333333333333
ECU-015931,2122,83,30,53,12,6.916666666666667
ECU-015932,2122,51,20,31,9,5.666666666666667
ECU-015933,2122,147,80,67,7,21.0
ECU-015934,2122,223,123,100,10,22.3
ECU-015935,2122,3,1,2,1,3.0
ECU-015936,2122,100,19,81,6,16.666666666666668
ECU-015937,2122,30,12,18,4,7.5
ECU-015938,2122,12,7,5,2,6.0
ECU-015939,2122,38,15,23,4,9.5
ECU-015940,2122,48,22,26,4,12.0
ECU-015941,2122,80,24,56,11,7.2727272727272725
ECU-015942,2122,8,2,6,4,2.0
ECU-015943,2122,37,17,20,4,9.25
ECU-015944,2122,8,4,4,4,2.0
ECU-015945,2122,41,16,25,8,5.125
ECU-015946,2122,13,5,8,2,6.5
ECU-015947,2122,75,41,34,9,8.333333333333334
ECU-015948,2122,5,3,2,2,2.5
ECU-015949,2122,25,13,12,4,6.25
ECU-015950,2122,24,11,13,3,8.0
ECU-015951,2122,23,12,11,4,5.75
ECU-015952,2122,43,24,19,1,43.0
ECU-015953,2122,20,16,4,3,6.666666666666667
ECU-015954,2122,8,4,4,1,8.0
ECU-015955,2122,42,21,21,5,8.4
ECU-015956,2122,6,3,3,1,6.0
ECU-015957,2122,3,2,1,2,1.5
ECU-015958,2122,8,5,3,2,4.0
ECU-015959,2122,15,7,8,3,5.0
ECU-015960,2122,6,4,2,1,6.0
ECU-015961,2122,26,12,14,2,13.0
ECU-015962,2122,24,12,12,2,12.0
ECU-015963,2122,221,99,122,18,12.277777777777779
ECU-015964,2122,25,13,12,2,12.5
ECU-015965,2122,90,32,58,5,18.0
ECU-015966,2122,152,77,75,12,12.666666666666666
ECU-015967,2122,5,2,3,1,5.0
ECU-015968,2122,4,3,1,2,2.0
ECU-015969,2122,20,12,8,2,10.0
ECU-015970,2122,24,9,15,4,6.0
ECU-015971,2122,4,1,3,3,1.3333333333333333
ECU-015972,2122,25,13,12,3,8.333333333333334
ECU-015973,2122,228,110,118,16,14.25
ECU-015974,2122,43,26,17,4,10.75
ECU-015975,2122,8,4,4,2,4.0
ECU-015976,2122,4,2,2,1,4.0
ECU-015977,2122,21,9,12,3,7.0
ECU-015978,2122,14,5,9,1,14.0
ECU-015979,2122,11,7,4,2,5.5
ECU-015980,2122,4,3,1,1,4.0
ECU-015981,2122,20,8,12,2,10.0
ECU-015982,2122,20,11,9,4,5.0
ECU-015983,2122,8,3,5,1,8.0
ECU-015984,2122,3,1,2,1,3.0
ECU-015985,2122,15,5,10,2,7.5
ECU-015986,2122,33,13,20,3,11.0
ECU-015987,2122,14,13,1,2,7.0
ECU-015988,2122,28,15,13,2,14.0
ECU-015989,2122,17,9,8,1,17.0
ECU-015990,2122,37,21,16,4,9.25
ECU-015991,2122,11,5,6,3,3.6666666666666665
ECU-015992,2122,19,9,10,2,9.5
ECU-015993,2122,26,12,14,4,6.5
ECU-015994,2122,55,28,27,3,18.333333333333332
ECU-015995,2122,56,25,31,5,11.2
ECU-015996,2122,16,10,6,1,16.0
ECU-015997,2122,15,8,7,3,5.0
ECU-015998,2122,7,4,3,1,7.0
ECU-015999,2122,12,5,7,3,4.0
ECU-016000,2122,20,8,12,3,6.666666666666667
ECU-016001,2122,22,10,12,4,5.5
ECU-016002,2122,12,5,7,2,6.0
ECU-016003,2122,10,4,6,2,5.0
ECU-016004,2122,39,19,20,4,9.75
ECU-016005,2122,64,31,33,4,16.0
ECU-016006,2122,15,7,8,1,15.0
ECU-016007,2122,48,19,29,6,8.0
ECU-016008,2122,14,7,7,5,2.8
ECU-016009,2122,90,47,43,6,15.0
ECU-016010,2122,31,15,16,6,5.166666666666667
ECU-016011,2122,11,5,6,2,5.5
ECU-016012,2122,49,20,29,4,12.25
ECU-016013,2122,6,5,1,2,3.0
ECU-016014,2122,9,4,5,4,2.25
ECU-016015,2122,9,2,7,2,4.5
ECU-016016,2122,112,57,55,9,12.444444444444445
ECU-016017,2122,22,7,15,3,7.333333333333333
ECU-016018,2122,15,5,10,1,15.0
ECU-016019,2122,18,10,8,2,9.0
ECU-016020,2122,23,15,8,7,3.2857142857142856
ECU-016021,2122,1,1,0,1,1.0
ECU-016022,2122,63,32,31,9,7.0
ECU-016023,2122,45,25,20,4,11.25
ECU-016024,2122,51,22,29,5,10.2
ECU-016025,2122,28,12,16,4,7.0
ECU-016026,2122,26,17,9,2,13.0
ECU-016027,2122,329,129,200,18,18.27777777777778
ECU-016028,2122,22,12,10,2,11.0
ECU-016029,2122,15,9,6,3,5.0
ECU-016030,2122,38,16,22,5,7.6
ECU-016031,2122,21,13,8,7,3.0
ECU-016032,2122,69,45,24,6,11.5
ECU-016033,2122,8,6,2,1,8.0
ECU-016034,2122,242,116,126,50,4.84
ECU-016035,2122,40,22,18,3,13.333333333333334
ECU-016036,2122,14,4,10,1,14.0
ECU-016037,2122,384,169,215,24,16.0
ECU-016038,2122,9,4,5,1,9.0
ECU-016039,2122,34,15,19,3,11.333333333333334
ECU-016040,2122,19,11,8,3,6.333333333333333
ECU-016041,2122,117,59,58,11,10.636363636363637
ECU-016042,2122,13,6,7,3,4.333333333333333
ECU-016043,2122,10,5,5,4,2.5
ECU-016044,2122,36,20,16,5,7.2
ECU-016045,2122,32,8,24,5,6.4
ECU-016046,2122,32,13,19,6,5.333333333333333
ECU-016047,2122,21,3,18,7,3.0
ECU-016048,2122,11,1,10,2,5.5
ECU-016049,2122,12,8,4,1,12.0
ECU-016050,2122,124,60,64,22,5.636363636363637
ECU-016051,2122,22,11,11,1,22.0
ECU-016052,2122,44,25,19,3,14.666666666666666
ECU-016053,2122,123,64,59,13,9.461538461538462
ECU-016054,2122,25,16,9,9,2.7777777777777777
ECU-016055,2122,9,2,7,1,9.0
ECU-016056,2122,34,17,17,9,3.7777777777777777
ECU-016057,2122,41,14,27,6,6.833333333333333
ECU-016058,2122,14,5,9,4,3.5
ECU-016059,2122,3,1,2,2,1.5
ECU-016060,2122,93,52,41,11,8.454545454545455
ECU-016061,2122,6,2,4,1,6.0
ECU-016062,2122,194,87,107,6,32.333333333333336
ECU-016063,2122,66,32,34,9,7.333333333333333
ECU-016064,2122,30,12,18,2,15.0
ECU-016065,2122,41,15,26,1,41.0
ECU-016066,2122,48,23,25,6,8.0
ECU-016067,2122,9,4,5,2,4.5
ECU-016068,2122,11,4,7,2,5.5
ECU-016069,2122,16,11,5,4,4.0
ECU-016070,2122,61,32,29,4,15.25
ECU-016071,2122,27,12,15,3,9.0
ECU-016072,2122,26,12,14,9,2.888888888888889
ECU-016073,2122,97,51,46,10,9.7
ECU-016074,2122,31,15,16,6,5.166666666666667
ECU-016075,2122,11,5,6,4,2.75
ECU-016076,2122,5,2,3,1,5.0
ECU-016077,2122,5,2,3,2,2.5
ECU-016078,2122,10,4,6,2,5.0
ECU-016079,2122,9,3,6,1,9.0
ECU-016080,2122,27,17,10,5,5.4
ECU-016081,2122,4,2,2,3,1.3333333333333333
ECU-016082,2122,38,16,22,6,6.333333333333333
ECU-016083,2122,15,7,8,2,7.5
ECU-016084,2122,11,3,8,1,11.0
ECU-016085,2122,34,17,17,6,5.666666666666667
ECU-016086,2122,71,34,37,6,11.833333333333334
ECU-016087,2122,13,5,8,2,6.5
ECU-016088,2122,5,1,4,4,1.25
ECU-016089,2122,25,14,11,6,4.166666666666667
ECU-016090,2122,109,53,56,11,9.909090909090908
ECU-016091,2122,132,74,58,14,9.428571428571429
ECU-016092,2122,87,43,44,6,14.5
ECU-016093,2122,40,20,20,4,10.0
ECU-016094,2122,213,98,115,10,21.3
ECU-016095,2122,35,17,18,4,8.75
ECU-016096,2122,93,44,49,10,9.3
ECU-016097,2122,9,3,6,5,1.8
ECU-016098,2122,7,0,7,5,1.4
ECU-016099,2122,36,21,15,7,5.142857142857143
ECU-016100,2122,42,19,23,4,10.5
ECU-016101,2122,14,7,7,5,2.8
ECU-016102,2122,6,4,2,7,0.8571428571428571
ECU-016103,2122,20,11,9,3,6.666666666666667
ECU-016104,2122,435,214,221,42,10.357142857142858
ECU-016105,2122,1,0,1,2,0.5
ECU-016106,2122,0,0,0,5,
ECU-016107,2122,0,0,0,5,
ECU-016108,2122,0,0,0,6,
ECU-016109,2122,0,0,0,6,
ECU-016110,2122,0,0,0,6,
ECU-016111,2122,0,0,0,6,
ECU-016112,2122,0,0,0,8,
ECU-016113,2122,0,0,0,9,
ECU-016114,2122,0,0,0,9,
ECU-016115,2122,0,0,0,11,
ECU-016116,2122,0,0,0,11,
ECU-016117,2122,0,0,0,13,
ECU-016118,2122,0,0,0,13,
ECU-016119,2122,0,0,0,13,
ECU-016120,2122,0,0,0,14,
ECU-016121,2122,0,0,0,15,
ECU-016122,2122,0,0,0,19,
ECU-016123,2122,0,0,0,20,
ECU-016124,2122,0,0,0,23,
ECU-016125,2122,0,0,0,31,
ECU-016126,2122,0,0,0,33,
ECU-016127,2122,0,0,0,47,
ECU-016128,2122,0,0,0,56,
ECU-016129,2122,0,0,0,78,
ECU-016130,2122,0,0,0,83,
