geo_id,year,deped_id,total_teacher_male,total_teacher_female,total_teachers,total_student_male,total_student_female,total_student_enrollment
HND-000051,2011,10100058,,,,15,8,23
,2011,10100129,,,,9,12,21
HND-000093,2011,10100149,,,,8,10,18
HND-000094,2011,10100150,,,,18,17,35
HND-000096,2011,10100153,,,,13,12,25
,2011,10100155,,,,13,12,25
,2011,10100159,,,,2,2,4
HND-000100,2011,10100164,,,,24,13,37
HND-000101,2011,10100169,,,,19,18,37
HND-000104,2011,10100176,,,,20,11,31
HND-000106,2011,10100180,,,,19,20,39
HND-000108,2011,10100186,,,,20,28,48
,2011,10100190,,,,24,17,41
HND-000113,2011,10100196,,,,8,8,16
,2011,10100199,,,,10,3,13
HND-000116,2011,10100206,,,,10,14,24
HND-000119,2011,10100219,,,,9,10,19
HND-000120,2011,10100220,,,,7,6,13
HND-000121,2011,10100221,,,,13,8,21
HND-000122,2011,10100225,,,,14,16,30
HND-000124,2011,10100227,,,,14,11,25
,2011,10100228,,,,4,8,12
,2011,10100234,,,,5,12,17
HND-000127,2011,10100237,,,,11,7,18
HND-000128,2011,10100239,,,,10,8,18
HND-000129,2011,10100242,,,,14,14,28
,2011,10100243,,,,9,16,25
,2011,10100257,,,,8,6,14
HND-000133,2011,10100258,,,,6,2,8
HND-000134,2011,10100259,,,,6,11,17
,2011,10100291,,,,2,2,4
HND-000142,2011,10100304,,,,13,8,21
HND-000143,2011,10100315,,,,4,3,7
,2011,10100318,,,,4,7,11
HND-000144,2011,10100320,,,,5,9,14
HND-000145,2011,10100323,,,,9,13,22
,2011,10100328,,,,13,5,18
,2011,10100329,,,,10,10,20
HND-000146,2011,10100330,,,,8,5,13
,2011,10100331,,,,8,7,15
,2011,10100335,,,,2,1,3
,2011,10100336,,,,0,4,4
HND-000148,2011,10100338,,,,6,2,8
HND-000149,2011,10100340,,,,12,11,23
,2011,10100342,,,,8,15,23
,2011,10100343,,,,11,11,22
HND-000150,2011,10100349,,,,14,15,29
HND-000151,2011,10100353,,,,7,3,10
,2011,10100357,,,,13,7,20
,2011,10100359,,,,17,13,30
HND-000083,2011,10100114,,,,11,14,25
HND-000085,2011,10100117,,,,9,4,13
,2011,10100124,,,,5,2,7
,2011,10100127,,,,17,12,29
HND-000087,2011,10100128,,,,5,8,13
HND-000088,2011,10100130,,,,3,3,6
,2011,10100147,,,,9,13,22
HND-000095,2011,10100151,,,,9,9,18
,2011,10100165,,,,11,14,25
,2011,10100172,,,,16,10,26
HND-000105,2011,10100177,,,,10,5,15
HND-000109,2011,10100187,,,,10,11,21
,2011,10100189,,,,1,3,4
HND-000114,2011,10100197,,,,11,15,26
,2011,10100202,,,,3,1,4
,2011,10100236,,,,5,7,12
,2011,10100256,,,,14,19,33
HND-000135,2011,10100260,,,,6,3,9
,2011,10100262,,,,11,4,15
,2011,10100265,,,,2,3,5
,2011,10100290,,,,26,14,40
,2011,10100293,,,,6,4,10
HND-000141,2011,10100303,,,,8,7,15
,2011,10100310,,,,7,7,14
,2011,10100311,,,,7,8,15
,2011,10100313,,,,7,9,16
,2011,10100316,,,,15,12,27
,2011,10100321,,,,14,10,24
,2011,10100322,,,,13,12,25
,2011,10100327,,,,4,3,7
,2011,10100332,,,,16,7,23
HND-000147,2011,10100333,,,,7,7,14
,2011,10100334,,,,1,3,4
,2011,10100337,,,,1,2,3
,2011,10100339,,,,9,7,16
,2011,10100341,,,,7,13,20
HND-000152,2011,10100358,,,,12,6,18
,2011,10100013,,,,5,9,14
,2011,10100055,,,,12,12,24
,2011,10100086,,,,8,5,13
,2011,10100111,,,,20,12,32
,2011,10100152,,,,10,11,21
,2011,10100162,,,,4,7,11
,2011,10100168,,,,25,25,50
HND-000102,2011,10100170,,,,6,4,10
,2011,10100195,,,,3,5,8
,2011,10100200,,,,8,0,8
,2011,10100201,,,,8,10,18
HND-000123,2011,10100226,,,,11,13,24
,2011,10100229,,,,8,8,16
,2011,10100250,,,,6,6,12
,2011,10100348,,,,1,0,1
,2011,10100351,,,,7,8,15
,2011,10100352,,,,5,7,12
,2011,10100158,,,,8,5,13
,2011,10100214,,,,17,17,34
,2011,10100215,,,,4,0,4
,2011,10100217,,,,9,9,18
,2011,10100230,,,,12,10,22
,2011,10100241,,,,4,1,5
,2011,10100345,,,,2,2,4
,2011,10100346,,,,2,2,4
,2011,10100356,,,,6,5,11
,2011,10100013,,,,5,10,15
HND-000069,2011,10100091,,,,21,18,39
HND-000070,2011,10100092,,,,10,8,18
HND-000074,2011,10100097,,,,31,29,60
HND-000077,2011,10100101,,,,14,10,24
,2011,10100104,,,,6,2,8
,2011,10100112,,,,4,7,11
HND-000082,2011,10100113,,,,7,1,8
HND-000086,2011,10100118,,,,2,2,4
HND-000090,2011,10100134,,,,15,15,30
,2011,10100144,,,,14,13,27
,2011,10100152,,,,15,12,27
,2011,10100185,,,,3,3,6
,2011,10100195,,,,20,10,30
,2011,10100201,,,,9,11,20
,2011,10100214,,,,15,29,44
HND-000123,2011,10100226,,,,12,13,25
,2011,10100230,,,,13,12,25
,2011,10100241,,,,4,4,8
,2011,10100250,,,,8,8,16
,2011,10100286,,,,9,13,22
,2011,10100324,,,,3,4,7
,2011,10100345,,,,4,6,10
,2011,10100346,,,,4,6,10
,2011,10100356,,,,19,17,36
HND-000153,2011,10100360,,,,11,9,20
HND-000009,2011,10100011,,,,5,5,10
,2011,10100055,,,,7,11,18
,2011,10100080,,,,4,5,9
,2011,10100081,,,,1,1,2
,2011,10100086,,,,26,33,59
HND-000066,2011,10100088,,,,11,11,22
HND-000067,2011,10100089,,,,16,13,29
HND-000071,2011,10100093,,,,7,12,19
HND-000072,2011,10100094,,,,11,16,27
,2011,10100095,,,,6,6,12
HND-000073,2011,10100096,,,,9,12,21
HND-000075,2011,10100098,,,,16,10,26
HND-000078,2011,10100102,,,,14,14,28
HND-000079,2011,10100103,,,,2,3,5
HND-000080,2011,10100105,,,,15,18,33
HND-000081,2011,10100106,,,,3,1,4
,2011,10100107,,,,2,1,3
,2011,10100108,,,,8,8,16
,2011,10100110,,,,9,18,27
,2011,10100111,,,,22,19,41
HND-000084,2011,10100115,,,,9,5,14
,2011,10100158,,,,16,18,34
,2011,10100162,,,,32,18,50
,2011,10100168,,,,26,57,83
HND-000102,2011,10100170,,,,8,11,19
,2011,10100184,,,,3,5,8
,2011,10100200,,,,13,0,13
,2011,10100215,,,,1,1,2
,2011,10100217,,,,14,13,27
,2011,10100229,,,,5,10,15
,2011,10100254,,,,2,2,4
,2011,10100280,,,,11,12,23
,2011,10100347,,,,14,14,28
,2011,10100348,,,,1,2,3
,2011,10100351,,,,6,4,10
HND-000005,2011,10100007,,,,14,11,25
HND-000009,2011,10100011,,,,15,9,24
,2011,10100081,,,,1,1,2
,2011,10100086,,,,20,31,51
HND-000066,2011,10100088,,,,30,45,75
HND-000067,2011,10100089,,,,13,13,26
HND-000072,2011,10100094,,,,19,8,27
,2011,10100095,,,,29,24,53
HND-000073,2011,10100096,,,,14,15,29
HND-000074,2011,10100097,,,,54,51,105
HND-000075,2011,10100098,,,,20,25,45
HND-000076,2011,10100100,,,,18,17,35
HND-000077,2011,10100101,,,,20,16,36
HND-000078,2011,10100102,,,,26,24,50
HND-000080,2011,10100105,,,,33,38,71
,2011,10100107,,,,7,7,14
,2011,10100108,,,,20,24,44
HND-000084,2011,10100115,,,,28,18,46
,2011,10100162,,,,29,26,55
,2011,10100168,,,,54,68,122
HND-000102,2011,10100170,,,,40,34,74
,2011,10100184,,,,5,6,11
,2011,10100200,,,,18,0,18
,2011,10100201,,,,16,15,31
HND-000123,2011,10100226,,,,12,13,25
,2011,10100241,,,,3,3,6
,2011,10100254,,,,3,1,4
,2011,10100255,,,,14,11,25
,2011,10100280,,,,7,9,16
,2011,10100286,,,,9,9,18
,2011,10100324,,,,5,5,10
,2011,10100347,,,,13,14,27
,2011,10100348,,,,2,4,6
,2011,10100351,,,,4,0,4
,2011,10100080,,,,2,6,8
HND-000065,2011,10100087,,,,36,44,80
HND-000068,2011,10100090,,,,43,30,73
HND-000069,2011,10100091,,,,25,18,43
HND-000070,2011,10100092,,,,10,21,31
HND-000071,2011,10100093,,,,10,11,21
,2011,10100099,,,,12,22,34
HND-000079,2011,10100103,,,,8,10,18
,2011,10100104,,,,7,15,22
HND-000081,2011,10100106,,,,6,7,13
,2011,10100110,,,,35,29,64
,2011,10100112,,,,5,3,8
HND-000082,2011,10100113,,,,7,14,21
HND-000086,2011,10100118,,,,12,10,22
HND-000090,2011,10100134,,,,23,17,40
,2011,10100144,,,,18,23,41
,2011,10100152,,,,18,17,35
,2011,10100185,,,,8,9,17
,2011,10100195,,,,10,15,25
,2011,10100215,,,,3,1,4
,2011,10100217,,,,15,12,27
,2011,10100230,,,,13,14,27
HND-000132,2011,10100247,,,,17,17,34
,2011,10100250,,,,15,18,33
,2011,10100308,,,,11,15,26
,2011,10100345,,,,8,9,17
,2011,10100346,,,,8,9,17
,2011,10100352,,,,6,2,8
,2011,10100356,,,,14,14,28
HND-000001,2011,10100002,,,,40,42,82
,2011,10100003,,,,38,22,60
HND-000002,2011,10100004,,,,24,9,33
HND-000007,2011,10100009,,,,20,12,32
,2011,10100012,,,,30,26,56
HND-000010,2011,10100014,,,,27,25,52
HND-000011,2011,10100016,,,,43,55,98
HND-000012,2011,10100017,,,,19,8,27
HND-000015,2011,10100020,,,,11,7,18
HND-000016,2011,10100021,,,,12,12,24
HND-000017,2011,10100022,,,,16,15,31
HND-000018,2011,10100023,,,,3,0,3
HND-000024,2011,10100029,,,,14,12,26
HND-000025,2011,10100030,,,,21,14,35
HND-000032,2011,10100037,,,,4,5,9
HND-000033,2011,10100038,,,,5,7,12
HND-000034,2011,10100039,,,,8,4,12
HND-000036,2011,10100041,,,,25,15,40
HND-000038,2011,10100043,,,,20,5,25
,2011,10100044,,,,59,43,102
HND-000039,2011,10100045,,,,61,46,107
HND-000040,2011,10100046,,,,43,47,90
HND-000041,2011,10100047,,,,13,11,24
HND-000043,2011,10100049,,,,12,19,31
HND-000045,2011,10100051,,,,4,4,8
HND-000046,2011,10100052,,,,53,44,97
HND-000047,2011,10100053,,,,91,108,199
HND-000050,2011,10100057,,,,3,0,3
HND-000051,2011,10100058,,,,6,9,15
HND-000052,2011,10100060,,,,7,7,14
HND-000053,2011,10100061,,,,4,2,6
HND-000055,2011,10100063,,,,16,14,30
HND-000059,2011,10100071,,,,43,39,82
HND-000060,2011,10100072,,,,33,34,67
HND-000063,2011,10100078,,,,75,72,147
HND-000064,2011,10100079,,,,31,39,70
,2011,10100080,,,,19,20,39
,2011,10100081,,,,9,2,11
,2011,10100082,,,,30,25,55
,2011,10100104,,,,14,18,32
,2011,10100107,,,,7,8,15
,2011,10100137,,,,53,53,106
,2011,10100146,,,,11,8,19
HND-000097,2011,10100154,,,,1,1,2
HND-000098,2011,10100157,,,,25,33,58
HND-000103,2011,10100173,,,,13,12,25
HND-000110,2011,10100188,,,,5,5,10
HND-000112,2011,10100192,,,,30,29,59
,2011,10100214,,,,27,22,49
,2011,10100241,,,,11,13,24
,2011,10100250,,,,10,15,25
,2011,10100254,,,,4,4,8
HND-000136,2011,10100269,,,,21,15,36
,2011,10100286,,,,7,11,18
HND-000138,2011,10100287,,,,4,2,6
,2011,10100308,,,,18,13,31
,2011,10100324,,,,6,2,8
,2011,10100345,,,,7,8,15
,2011,10100346,,,,5,5,10
,2011,10100356,,,,4,15,19
,2011,10100001,,,,62,84,146
HND-000003,2011,10100005,,,,32,19,51
HND-000004,2011,10100006,,,,21,19,40
HND-000005,2011,10100007,,,,24,23,47
HND-000006,2011,10100008,,,,51,28,79
HND-000008,2011,10100010,,,,68,51,119
HND-000009,2011,10100011,,,,33,33,66
,2011,10100013,,,,10,10,20
HND-000013,2011,10100018,,,,4,4,8
HND-000014,2011,10100019,,,,7,5,12
HND-000019,2011,10100024,,,,7,6,13
HND-000020,2011,10100025,,,,42,43,85
HND-000021,2011,10100026,,,,15,14,29
HND-000022,2011,10100027,,,,3,1,4
HND-000023,2011,10100028,,,,19,27,46
HND-000026,2011,10100031,,,,33,28,61
HND-000027,2011,10100032,,,,69,54,123
HND-000028,2011,10100033,,,,73,48,121
HND-000029,2011,10100034,,,,39,36,75
HND-000030,2011,10100035,,,,60,41,101
HND-000031,2011,10100036,,,,11,10,21
HND-000035,2011,10100040,,,,18,10,28
HND-000037,2011,10100042,,,,27,21,48
HND-000042,2011,10100048,,,,15,12,27
HND-000044,2011,10100050,,,,21,20,41
HND-000048,2011,10100054,,,,11,7,18
,2011,10100055,,,,14,12,26
HND-000049,2011,10100056,,,,14,19,33
HND-000054,2011,10100062,,,,5,3,8
,2011,10100066,,,,28,28,56
HND-000056,2011,10100067,,,,9,12,21
HND-000057,2011,10100068,,,,69,49,118
,2011,10100069,,,,5,2,7
HND-000061,2011,10100075,,,,14,6,20
HND-000062,2011,10100076,,,,25,18,43
,2011,10100126,,,,19,37,56
,2011,10100158,,,,10,13,23
HND-000099,2011,10100160,,,,5,3,8
,2011,10100162,,,,24,21,45
HND-000102,2011,10100170,,,,36,24,60
,2011,10100171,,,,30,26,56
HND-000107,2011,10100181,,,,48,35,83
,2011,10100184,,,,10,7,17
,2011,10100185,,,,14,11,25
HND-000111,2011,10100191,,,,35,23,58
,2011,10100195,,,,20,18,38
HND-000115,2011,10100203,,,,1,2,3
,2011,10100215,,,,5,7,12
,2011,10100217,,,,16,26,42
HND-000126,2011,10100231,,,,40,30,70
HND-000131,2011,10100246,,,,6,4,10
,2011,10100249,,,,5,3,8
,2011,10100280,,,,11,9,20
,2011,10100281,,,,11,7,18
HND-000137,2011,10100285,,,,2,1,3
HND-000139,2011,10100288,,,,3,0,3
,2011,10100347,,,,17,31,48
,2011,10100348,,,,14,8,22
,2011,10100350,,,,10,10,20
HND-000002,2011,10100004,,,,24,14,38
HND-000003,2011,10100005,,,,21,28,49
HND-000004,2011,10100006,,,,17,9,26
HND-000005,2011,10100007,,,,16,10,26
HND-000009,2011,10100011,,,,32,26,58
HND-000011,2011,10100016,,,,41,39,80
HND-000012,2011,10100017,,,,20,18,38
HND-000015,2011,10100020,,,,17,5,22
HND-000018,2011,10100023,,,,3,0,3
HND-000019,2011,10100024,,,,6,5,11
HND-000020,2011,10100025,,,,54,40,94
HND-000021,2011,10100026,,,,16,18,34
HND-000025,2011,10100030,,,,12,18,30
HND-000027,2011,10100032,,,,65,61,126
HND-000028,2011,10100033,,,,58,47,105
HND-000030,2011,10100035,,,,42,35,77
HND-000031,2011,10100036,,,,12,3,15
HND-000033,2011,10100038,,,,4,1,5
HND-000035,2011,10100040,,,,10,12,22
HND-000038,2011,10100043,,,,8,12,20
,2011,10100044,,,,56,55,111
HND-000039,2011,10100045,,,,59,65,124
HND-000040,2011,10100046,,,,49,44,93
HND-000043,2011,10100049,,,,8,16,24
HND-000048,2011,10100054,,,,2,2,4
,2011,10100055,,,,13,9,22
HND-000049,2011,10100056,,,,11,14,25
HND-000050,2011,10100057,,,,3,1,4
HND-000054,2011,10100062,,,,3,2,5
,2011,10100066,,,,30,36,66
,2011,10100069,,,,0,2,2
HND-000059,2011,10100071,,,,48,36,84
HND-000061,2011,10100075,,,,8,5,13
HND-000062,2011,10100076,,,,12,19,31
HND-000063,2011,10100078,,,,69,56,125
,2011,10100081,,,,4,5,9
,2011,10100107,,,,3,16,19
,2011,10100126,,,,24,24,48
,2011,10100137,,,,44,44,88
,2011,10100146,,,,12,4,16
HND-000097,2011,10100154,,,,3,5,8
,2011,10100158,,,,10,10,20
,2011,10100162,,,,18,14,32
HND-000102,2011,10100170,,,,16,1,17
HND-000103,2011,10100173,,,,8,12,20
HND-000107,2011,10100181,,,,25,20,45
,2011,10100184,,,,4,5,9
HND-000111,2011,10100191,,,,17,20,37
HND-000126,2011,10100231,,,,22,22,44
,2011,10100241,,,,5,6,11
,2011,10100249,,,,3,5,8
,2011,10100254,,,,1,1,2
HND-000136,2011,10100269,,,,11,24,35
,2011,10100280,,,,9,12,21
HND-000137,2011,10100285,,,,4,5,9
,2011,10100286,,,,11,11,22
HND-000138,2011,10100287,,,,5,1,6
HND-000139,2011,10100288,,,,0,1,1
,2011,10100324,,,,8,10,18
,2011,10100347,,,,16,23,39
,2011,10100348,,,,10,9,19
,2011,10100350,,,,13,7,20
,2011,10100001,,,,64,88,152
HND-000001,2011,10100002,,,,43,40,83
,2011,10100003,,,,22,22,44
HND-000006,2011,10100008,,,,32,27,59
HND-000007,2011,10100009,,,,10,10,20
HND-000008,2011,10100010,,,,47,49,96
,2011,10100012,,,,20,21,41
,2011,10100013,,,,17,9,26
HND-000010,2011,10100014,,,,29,43,72
HND-000013,2011,10100018,,,,6,5,11
HND-000014,2011,10100019,,,,7,7,14
HND-000016,2011,10100021,,,,20,16,36
HND-000017,2011,10100022,,,,11,18,29
HND-000022,2011,10100027,,,,1,2,3
HND-000023,2011,10100028,,,,28,28,56
HND-000024,2011,10100029,,,,18,9,27
HND-000026,2011,10100031,,,,40,28,68
HND-000029,2011,10100034,,,,36,44,80
HND-000032,2011,10100037,,,,3,2,5
HND-000034,2011,10100039,,,,4,5,9
HND-000036,2011,10100041,,,,13,15,28
HND-000037,2011,10100042,,,,23,12,35
HND-000041,2011,10100047,,,,12,16,28
HND-000042,2011,10100048,,,,12,10,22
HND-000044,2011,10100050,,,,23,28,51
HND-000045,2011,10100051,,,,2,2,4
HND-000046,2011,10100052,,,,38,40,78
HND-000047,2011,10100053,,,,85,80,165
HND-000051,2011,10100058,,,,8,7,15
HND-000052,2011,10100060,,,,5,5,10
HND-000053,2011,10100061,,,,3,2,5
HND-000055,2011,10100063,,,,16,12,28
HND-000056,2011,10100067,,,,5,7,12
HND-000057,2011,10100068,,,,29,32,61
HND-000060,2011,10100072,,,,27,27,54
HND-000064,2011,10100079,,,,37,21,58
,2011,10100080,,,,31,17,48
,2011,10100082,,,,19,29,48
,2011,10100104,,,,10,19,29
HND-000091,2011,10100141,,,,2,11,13
HND-000098,2011,10100157,,,,14,13,27
HND-000099,2011,10100160,,,,5,1,6
,2011,10100171,,,,21,21,42
,2011,10100185,,,,10,8,18
HND-000110,2011,10100188,,,,6,9,15
HND-000112,2011,10100192,,,,24,16,40
,2011,10100195,,,,11,12,23
HND-000115,2011,10100203,,,,0,1,1
,2011,10100214,,,,24,25,49
,2011,10100215,,,,1,4,5
,2011,10100217,,,,16,11,27
HND-000131,2011,10100246,,,,5,2,7
,2011,10100250,,,,12,1,13
,2011,10100281,,,,10,6,16
,2011,10100308,,,,18,14,32
,2011,10100345,,,,11,4,15
,2011,10100346,,,,2,7,9
,2011,10100356,,,,6,5,11
,2011,10100001,,,,72,81,153
HND-000003,2011,10100005,,,,40,30,70
HND-000004,2011,10100006,,,,15,8,23
HND-000005,2011,10100007,,,,18,22,40
HND-000006,2011,10100008,,,,32,24,56
HND-000008,2011,10100010,,,,49,57,106
HND-000009,2011,10100011,,,,32,28,60
HND-000014,2011,10100019,,,,6,6,12
HND-000019,2011,10100024,,,,4,4,8
HND-000020,2011,10100025,,,,41,42,83
HND-000021,2011,10100026,,,,14,12,26
HND-000022,2011,10100027,,,,2,3,5
HND-000023,2011,10100028,,,,29,31,60
HND-000025,2011,10100030,,,,14,9,23
HND-000027,2011,10100032,,,,40,52,92
HND-000032,2011,10100037,,,,5,8,13
HND-000033,2011,10100038,,,,6,7,13
HND-000034,2011,10100039,,,,5,4,9
HND-000035,2011,10100040,,,,11,9,20
HND-000036,2011,10100041,,,,9,12,21
HND-000038,2011,10100043,,,,8,12,20
,2011,10100044,,,,50,50,100
HND-000039,2011,10100045,,,,46,41,87
HND-000040,2011,10100046,,,,45,40,85
HND-000043,2011,10100049,,,,15,15,30
HND-000046,2011,10100052,,,,34,40,74
HND-000047,2011,10100053,,,,94,89,183
,2011,10100055,,,,13,15,28
HND-000050,2011,10100057,,,,1,0,1
HND-000054,2011,10100062,,,,2,1,3
,2011,10100066,,,,28,36,64
HND-000056,2011,10100067,,,,12,3,15
HND-000057,2011,10100068,,,,40,45,85
,2011,10100069,,,,3,4,7
HND-000059,2011,10100071,,,,40,31,71
HND-000060,2011,10100072,,,,33,34,67
HND-000063,2011,10100078,,,,95,81,176
HND-000064,2011,10100079,,,,40,39,79
,2011,10100080,,,,26,8,34
,2011,10100081,,,,3,2,5
,2011,10100082,,,,18,25,43
,2011,10100108,,,,1,1,2
,2011,10100126,,,,26,23,49
,2011,10100158,,,,7,12,19
HND-000099,2011,10100160,,,,3,1,4
,2011,10100162,,,,13,16,29
HND-000102,2011,10100170,,,,6,8,14
HND-000107,2011,10100181,,,,25,32,57
,2011,10100184,,,,4,6,10
HND-000111,2011,10100191,,,,14,13,27
,2011,10100214,,,,23,27,50
HND-000126,2011,10100231,,,,25,11,36
,2011,10100249,,,,3,3,6
HND-000136,2011,10100269,,,,20,19,39
,2011,10100280,,,,13,9,22
,2011,10100281,,,,4,7,11
HND-000137,2011,10100285,,,,6,1,7
HND-000138,2011,10100287,,,,4,3,7
HND-000139,2011,10100288,,,,2,3,5
,2011,10100347,,,,18,24,42
,2011,10100348,,,,6,7,13
,2011,10100350,,,,7,13,20
HND-000001,2011,10100002,,,,33,37,70
,2011,10100003,,,,25,42,67
HND-000002,2011,10100004,,,,24,18,42
HND-000007,2011,10100009,,,,10,18,28
,2011,10100012,,,,20,22,42
,2011,10100013,,,,7,10,17
HND-000010,2011,10100014,,,,18,19,37
HND-000011,2011,10100016,,,,41,56,97
HND-000012,2011,10100017,,,,16,14,30
HND-000013,2011,10100018,,,,8,7,15
HND-000015,2011,10100020,,,,13,6,19
HND-000016,2011,10100021,,,,12,12,24
HND-000017,2011,10100022,,,,12,12,24
HND-000018,2011,10100023,,,,1,2,3
HND-000024,2011,10100029,,,,16,8,24
HND-000026,2011,10100031,,,,20,28,48
HND-000028,2011,10100033,,,,72,60,132
HND-000029,2011,10100034,,,,34,31,65
HND-000030,2011,10100035,,,,44,51,95
HND-000031,2011,10100036,,,,9,6,15
HND-000037,2011,10100042,,,,13,15,28
HND-000041,2011,10100047,,,,14,18,32
HND-000042,2011,10100048,,,,15,12,27
HND-000044,2011,10100050,,,,18,18,36
HND-000045,2011,10100051,,,,4,5,9
HND-000048,2011,10100054,,,,4,4,8
HND-000049,2011,10100056,,,,23,25,48
HND-000052,2011,10100060,,,,10,5,15
HND-000053,2011,10100061,,,,0,2,2
HND-000055,2011,10100063,,,,14,18,32
HND-000061,2011,10100075,,,,6,7,13
HND-000062,2011,10100076,,,,21,16,37
,2011,10100104,,,,14,17,31
,2011,10100107,,,,7,9,16
,2011,10100137,,,,54,44,98
,2011,10100146,,,,8,7,15
HND-000097,2011,10100154,,,,3,4,7
HND-000098,2011,10100157,,,,12,13,25
,2011,10100171,,,,20,22,42
HND-000103,2011,10100173,,,,10,15,25
,2011,10100185,,,,7,9,16
HND-000110,2011,10100188,,,,5,5,10
HND-000112,2011,10100192,,,,12,15,27
,2011,10100195,,,,12,12,24
HND-000115,2011,10100203,,,,0,2,2
,2011,10100215,,,,1,2,3
,2011,10100217,,,,11,10,21
,2011,10100241,,,,11,11,22
HND-000131,2011,10100246,,,,4,2,6
,2011,10100250,,,,11,3,14
,2011,10100254,,,,2,3,5
,2011,10100286,,,,13,8,21
,2011,10100308,,,,15,16,31
,2011,10100324,,,,2,5,7
,2011,10100345,,,,4,3,7
,2011,10100346,,,,5,8,13
,2011,10100356,,,,6,7,13
HND-000001,2011,10100002,,,,41,36,77
HND-000002,2011,10100004,,,,25,16,41
HND-000005,2011,10100007,,,,19,20,39
HND-000007,2011,10100009,,,,13,13,26
HND-000009,2011,10100011,,,,41,30,71
HND-000011,2011,10100016,,,,44,35,79
HND-000012,2011,10100017,,,,11,17,28
HND-000015,2011,10100020,,,,9,4,13
HND-000016,2011,10100021,,,,14,13,27
HND-000020,2011,10100025,,,,45,42,87
HND-000021,2011,10100026,,,,8,8,16
HND-000026,2011,10100031,,,,36,30,66
HND-000027,2011,10100032,,,,64,52,116
HND-000028,2011,10100033,,,,50,50,100
HND-000030,2011,10100035,,,,52,51,103
HND-000031,2011,10100036,,,,14,2,16
HND-000033,2011,10100038,,,,6,6,12
HND-000035,2011,10100040,,,,8,12,20
HND-000037,2011,10100042,,,,19,21,40
HND-000038,2011,10100043,,,,11,10,21
,2011,10100044,,,,57,66,123
HND-000042,2011,10100048,,,,13,8,21
HND-000043,2011,10100049,,,,11,16,27
HND-000048,2011,10100054,,,,8,10,18
,2011,10100055,,,,13,12,25
HND-000049,2011,10100056,,,,16,10,26
HND-000050,2011,10100057,,,,0,3,3
HND-000053,2011,10100061,,,,2,4,6
,2011,10100069,,,,1,3,4
HND-000059,2011,10100071,,,,55,31,86
HND-000061,2011,10100075,,,,5,6,11
HND-000062,2011,10100076,,,,17,19,36
HND-000063,2011,10100078,,,,75,75,150
,2011,10100104,,,,13,11,24
,2011,10100107,,,,7,12,19
,2011,10100137,,,,57,52,109
,2011,10100146,,,,4,14,18
HND-000097,2011,10100154,,,,0,1,1
HND-000098,2011,10100157,,,,14,17,31
,2011,10100158,,,,17,6,23
HND-000103,2011,10100173,,,,10,15,25
HND-000126,2011,10100231,,,,12,20,32
,2011,10100241,,,,8,10,18
,2011,10100249,,,,6,3,9
,2011,10100254,,,,2,8,10
HND-000137,2011,10100285,,,,4,2,6
,2011,10100286,,,,11,9,20
HND-000138,2011,10100287,,,,2,3,5
,2011,10100324,,,,2,3,5
,2011,10100345,,,,1,1,2
,2011,10100346,,,,4,5,9
,2011,10100347,,,,22,17,39
,2011,10100350,,,,17,3,20
,2011,10100356,,,,1,1,2
,2011,10100001,,,,77,55,132
,2011,10100003,,,,26,23,49
HND-000003,2011,10100005,,,,31,31,62
HND-000004,2011,10100006,,,,17,17,34
HND-000006,2011,10100008,,,,32,26,58
HND-000008,2011,10100010,,,,56,51,107
,2011,10100012,,,,21,8,29
,2011,10100013,,,,8,12,20
HND-000010,2011,10100014,,,,14,18,32
HND-000013,2011,10100018,,,,5,3,8
HND-000014,2011,10100019,,,,5,0,5
HND-000017,2011,10100022,,,,15,10,25
HND-000019,2011,10100024,,,,7,2,9
HND-000022,2011,10100027,,,,1,0,1
HND-000023,2011,10100028,,,,31,23,54
HND-000024,2011,10100029,,,,17,12,29
HND-000025,2011,10100030,,,,15,8,23
HND-000029,2011,10100034,,,,51,54,105
HND-000032,2011,10100037,,,,6,3,9
HND-000034,2011,10100039,,,,5,5,10
HND-000036,2011,10100041,,,,10,10,20
HND-000039,2011,10100045,,,,55,50,105
HND-000040,2011,10100046,,,,33,50,83
HND-000041,2011,10100047,,,,14,13,27
HND-000044,2011,10100050,,,,7,11,18
HND-000045,2011,10100051,,,,4,3,7
HND-000046,2011,10100052,,,,43,48,91
HND-000047,2011,10100053,,,,78,81,159
HND-000052,2011,10100060,,,,10,6,16
HND-000055,2011,10100063,,,,18,11,29
,2011,10100066,,,,36,35,71
HND-000056,2011,10100067,,,,8,6,14
HND-000057,2011,10100068,,,,47,47,94
HND-000060,2011,10100072,,,,34,56,90
HND-000064,2011,10100079,,,,40,21,61
,2011,10100080,,,,24,29,53
,2011,10100081,,,,0,4,4
,2011,10100082,,,,27,22,49
,2011,10100108,,,,9,6,15
,2011,10100126,,,,27,18,45
HND-000091,2011,10100141,,,,4,5,9
HND-000099,2011,10100160,,,,3,4,7
,2011,10100162,,,,11,15,26
,2011,10100171,,,,21,8,29
HND-000107,2011,10100181,,,,41,27,68
,2011,10100184,,,,5,6,11
,2011,10100185,,,,5,11,16
HND-000110,2011,10100188,,,,6,4,10
HND-000111,2011,10100191,,,,11,20,31
HND-000112,2011,10100192,,,,14,20,34
,2011,10100195,,,,7,13,20
HND-000115,2011,10100203,,,,1,2,3
,2011,10100214,,,,25,19,44
,2011,10100215,,,,0,1,1
,2011,10100217,,,,12,15,27
HND-000131,2011,10100246,,,,2,4,6
HND-000136,2011,10100269,,,,19,18,37
,2011,10100280,,,,6,7,13
,2011,10100281,,,,8,7,15
HND-000139,2011,10100288,,,,0,2,2
,2011,10100308,,,,17,17,34
,2011,10100348,,,,3,4,7
HND-000001,2011,10100002,,,,33,44,77
,2011,10100003,,,,36,31,67
HND-000002,2011,10100004,,,,15,15,30
HND-000007,2011,10100009,,,,14,11,25
HND-000010,2011,10100014,,,,32,16,48
HND-000011,2011,10100016,,,,53,43,96
HND-000012,2011,10100017,,,,10,10,20
HND-000015,2011,10100020,,,,10,7,17
HND-000016,2011,10100021,,,,9,18,27
HND-000017,2011,10100022,,,,13,7,20
HND-000018,2011,10100023,,,,5,0,5
HND-000024,2011,10100029,,,,17,7,24
HND-000026,2011,10100031,,,,33,33,66
HND-000027,2011,10100032,,,,68,58,126
HND-000028,2011,10100033,,,,50,48,98
HND-000030,2011,10100035,,,,33,39,72
HND-000031,2011,10100036,,,,6,7,13
HND-000033,2011,10100038,,,,8,6,14
HND-000035,2011,10100040,,,,9,9,18
HND-000037,2011,10100042,,,,29,16,45
HND-000038,2011,10100043,,,,12,21,33
,2011,10100044,,,,51,53,104
HND-000042,2011,10100048,,,,17,8,25
HND-000043,2011,10100049,,,,11,17,28
HND-000044,2011,10100050,,,,14,11,25
HND-000048,2011,10100054,,,,5,1,6
,2011,10100055,,,,11,15,26
HND-000049,2011,10100056,,,,20,11,31
HND-000053,2011,10100061,,,,2,3,5
HND-000054,2011,10100062,,,,1,0,1
HND-000055,2011,10100063,,,,6,11,17
,2011,10100069,,,,2,1,3
HND-000061,2011,10100075,,,,3,6,9
HND-000062,2011,10100076,,,,17,19,36
HND-000063,2011,10100078,,,,53,72,125
,2011,10100104,,,,18,16,34
,2011,10100107,,,,8,9,17
,2011,10100137,,,,52,55,107
,2011,10100146,,,,16,10,26
HND-000097,2011,10100154,,,,2,1,3
HND-000098,2011,10100157,,,,11,14,25
HND-000103,2011,10100173,,,,8,12,20
,2011,10100215,,,,1,3,4
,2011,10100241,,,,5,7,12
,2011,10100254,,,,2,3,5
,2011,10100286,,,,11,7,18
,2011,10100308,,,,17,15,32
,2011,10100345,,,,2,1,3
,2011,10100346,,,,2,4,6
,2011,10100347,,,,16,14,30
,2011,10100356,,,,3,4,7
,2011,10100001,,,,81,67,148
HND-000003,2011,10100005,,,,31,28,59
HND-000004,2011,10100006,,,,24,20,44
HND-000005,2011,10100007,,,,23,15,38
HND-000006,2011,10100008,,,,30,45,75
HND-000008,2011,10100010,,,,51,50,101
HND-000009,2011,10100011,,,,37,33,70
,2011,10100012,,,,9,10,19
,2011,10100013,,,,6,12,18
HND-000013,2011,10100018,,,,3,3,6
HND-000014,2011,10100019,,,,3,7,10
HND-000019,2011,10100024,,,,12,2,14
HND-000020,2011,10100025,,,,47,38,85
HND-000021,2011,10100026,,,,11,13,24
HND-000022,2011,10100027,,,,3,1,4
HND-000023,2011,10100028,,,,26,23,49
HND-000025,2011,10100030,,,,10,10,20
HND-000029,2011,10100034,,,,57,57,114
HND-000032,2011,10100037,,,,3,5,8
HND-000034,2011,10100039,,,,5,3,8
HND-000036,2011,10100041,,,,10,16,26
HND-000039,2011,10100045,,,,58,43,101
HND-000040,2011,10100046,,,,43,61,104
HND-000041,2011,10100047,,,,18,15,33
HND-000045,2011,10100051,,,,3,3,6
HND-000046,2011,10100052,,,,29,42,71
HND-000047,2011,10100053,,,,82,100,182
HND-000050,2011,10100057,,,,2,1,3
HND-000052,2011,10100060,,,,11,8,19
,2011,10100066,,,,25,20,45
HND-000056,2011,10100067,,,,10,12,22
HND-000057,2011,10100068,,,,30,31,61
HND-000059,2011,10100071,,,,42,32,74
HND-000060,2011,10100072,,,,31,39,70
HND-000064,2011,10100079,,,,19,39,58
,2011,10100080,,,,42,14,56
,2011,10100081,,,,2,4,6
,2011,10100082,,,,21,22,43
,2011,10100108,,,,9,5,14
,2011,10100126,,,,20,37,57
,2011,10100158,,,,4,6,10
HND-000099,2011,10100160,,,,3,1,4
,2011,10100162,,,,7,16,23
,2011,10100171,,,,8,10,18
HND-000107,2011,10100181,,,,24,18,42
,2011,10100184,,,,2,8,10
,2011,10100185,,,,8,7,15
HND-000110,2011,10100188,,,,4,6,10
HND-000111,2011,10100191,,,,12,12,24
HND-000112,2011,10100192,,,,14,14,28
,2011,10100195,,,,9,23,32
HND-000115,2011,10100203,,,,1,2,3
,2011,10100214,,,,31,23,54
,2011,10100217,,,,13,11,24
HND-000126,2011,10100231,,,,15,15,30
HND-000131,2011,10100246,,,,5,0,5
,2011,10100249,,,,5,1,6
HND-000136,2011,10100269,,,,14,11,25
,2011,10100280,,,,5,11,16
,2011,10100281,,,,5,9,14
HND-000137,2011,10100285,,,,0,3,3
HND-000139,2011,10100288,,,,4,3,7
,2011,10100348,,,,2,2,4
,2011,10100350,,,,11,11,22
,2011,10100001,,,,68,84,152
HND-000001,2011,10100002,,,,43,39,82
,2011,10100003,,,,27,30,57
HND-000006,2011,10100008,,,,42,34,76
HND-000007,2011,10100009,,,,16,21,37
HND-000008,2011,10100010,,,,89,68,157
,2011,10100013,,,,10,18,28
HND-000010,2011,10100014,,,,16,19,35
HND-000013,2011,10100018,,,,5,3,8
HND-000014,2011,10100019,,,,5,8,13
HND-000016,2011,10100021,,,,11,7,18
HND-000017,2011,10100022,,,,15,9,24
HND-000022,2011,10100027,,,,0,1,1
HND-000023,2011,10100028,,,,27,20,47
HND-000024,2011,10100029,,,,15,7,22
HND-000026,2011,10100031,,,,26,30,56
HND-000029,2011,10100034,,,,29,46,75
HND-000032,2011,10100037,,,,4,2,6
HND-000034,2011,10100039,,,,8,5,13
HND-000036,2011,10100041,,,,9,12,21
HND-000037,2011,10100042,,,,20,22,42
HND-000041,2011,10100047,,,,11,12,23
HND-000042,2011,10100048,,,,15,12,27
HND-000044,2011,10100050,,,,14,16,30
HND-000045,2011,10100051,,,,1,1,2
HND-000046,2011,10100052,,,,35,27,62
HND-000052,2011,10100060,,,,10,10,20
HND-000053,2011,10100061,,,,5,3,8
HND-000055,2011,10100063,,,,10,15,25
HND-000056,2011,10100067,,,,6,12,18
HND-000057,2011,10100068,,,,17,29,46
HND-000060,2011,10100072,,,,29,35,64
HND-000064,2011,10100079,,,,24,17,41
,2011,10100080,,,,33,19,52
,2011,10100082,,,,23,21,44
,2011,10100107,,,,15,12,27
,2011,10100108,,,,21,11,32
,2011,10100126,,,,22,23,45
HND-000091,2011,10100141,,,,6,5,11
HND-000098,2011,10100157,,,,15,15,30
,2011,10100162,,,,4,8,12
,2011,10100185,,,,0,3,3
HND-000110,2011,10100188,,,,6,2,8
HND-000112,2011,10100192,,,,13,19,32
,2011,10100195,,,,14,13,27
HND-000115,2011,10100203,,,,2,0,2
,2011,10100214,,,,20,16,36
,2011,10100217,,,,6,5,11
HND-000131,2011,10100246,,,,3,0,3
,2011,10100281,,,,4,7,11
,2011,10100308,,,,13,18,31
,2011,10100347,,,,13,14,27
HND-000002,2011,10100004,,,,33,20,53
HND-000003,2011,10100005,,,,32,34,66
HND-000004,2011,10100006,,,,19,19,38
HND-000005,2011,10100007,,,,15,23,38
HND-000009,2011,10100011,,,,58,31,89
HND-000011,2011,10100016,,,,52,49,101
HND-000012,2011,10100017,,,,16,16,32
HND-000015,2011,10100020,,,,7,5,12
HND-000018,2011,10100023,,,,1,1,2
HND-000019,2011,10100024,,,,8,3,11
HND-000020,2011,10100025,,,,40,46,86
HND-000021,2011,10100026,,,,11,16,27
HND-000025,2011,10100030,,,,5,10,15
HND-000027,2011,10100032,,,,28,40,68
HND-000028,2011,10100033,,,,44,41,85
HND-000030,2011,10100035,,,,40,40,80
HND-000031,2011,10100036,,,,6,11,17
HND-000033,2011,10100038,,,,5,9,14
HND-000035,2011,10100040,,,,6,13,19
HND-000038,2011,10100043,,,,8,5,13
,2011,10100044,,,,55,82,137
HND-000039,2011,10100045,,,,50,61,111
HND-000040,2011,10100046,,,,28,38,66
HND-000043,2011,10100049,,,,14,8,22
HND-000047,2011,10100053,,,,56,74,130
HND-000048,2011,10100054,,,,1,6,7
,2011,10100055,,,,11,14,25
HND-000049,2011,10100056,,,,11,9,20
HND-000050,2011,10100057,,,,3,4,7
HND-000054,2011,10100062,,,,1,0,1
,2011,10100066,,,,24,16,40
,2011,10100069,,,,2,5,7
HND-000059,2011,10100071,,,,40,45,85
HND-000061,2011,10100075,,,,5,4,9
HND-000062,2011,10100076,,,,7,8,15
HND-000063,2011,10100078,,,,57,52,109
,2011,10100081,,,,1,0,1
,2011,10100104,,,,21,23,44
,2011,10100137,,,,38,52,90
,2011,10100146,,,,9,12,21
HND-000097,2011,10100154,,,,2,3,5
,2011,10100158,,,,5,9,14
HND-000099,2011,10100160,,,,1,2,3
HND-000103,2011,10100173,,,,11,10,21
HND-000107,2011,10100181,,,,17,21,38
,2011,10100184,,,,5,9,14
HND-000111,2011,10100191,,,,16,10,26
HND-000126,2011,10100231,,,,13,20,33
,2011,10100241,,,,9,7,16
,2011,10100249,,,,4,3,7
,2011,10100254,,,,2,6,8
HND-000136,2011,10100269,,,,5,9,14
,2011,10100280,,,,2,8,10
HND-000137,2011,10100285,,,,1,1,2
HND-000138,2011,10100287,,,,1,3,4
HND-000139,2011,10100288,,,,1,0,1
,2011,10100345,,,,2,2,4
,2011,10100346,,,,5,3,8
,2011,10100356,,,,2,5,7
,2011,10100015,,,,85,102,187
HND-000011,2011,10100016,,,,73,59,132
HND-000026,2011,10100031,,,,39,31,70
HND-000027,2011,10100032,,,,43,61,104
HND-000028,2011,10100033,,,,26,55,81
HND-000037,2011,10100042,,,,37,31,68
HND-000044,2011,10100050,,,,30,30,60
HND-000047,2011,10100053,,,,82,95,177
,2011,10100055,,,,12,15,27
,2011,10100066,,,,27,30,57
,2011,10100080,,,,16,19,35
,2011,10100095,,,,143,167,310
HND-000089,2011,10100132,,,,309,93,402
,2011,10100135,,,,52,56,108
,2011,10100136,,,,12,36,48
,2011,10100138,,,,20,22,42
,2011,10100140,,,,25,40,65
,2011,10100142,,,,14,10,24
HND-000092,2011,10100145,,,,58,48,106
,2011,10100148,,,,44,12,56
,2011,10100158,,,,3,6,9
,2011,10100162,,,,15,11,26
,2011,10100195,,,,22,17,39
HND-000117,2011,10100208,,,,45,42,87
,2011,10100210,,,,29,15,44
,2011,10100214,,,,16,25,41
,2011,10100280,,,,6,8,14
HND-000140,2011,10100289,,,,79,70,149
HND-000005,2011,10100007,,,,29,27,56
,2011,10100013,,,,13,9,22
HND-000023,2011,10100028,,,,24,21,45
HND-000039,2011,10100045,,,,59,61,120
HND-000041,2011,10100047,,,,24,27,51
HND-000047,2011,10100053,,,,82,95,177
HND-000059,2011,10100071,,,,64,78,142
,2011,10100073,,,,8,6,14
,2011,10100131,,,,395,473,868
,2011,10100137,,,,45,56,101
,2011,10100139,,,,25,20,45
HND-000091,2011,10100141,,,,26,51,77
,2011,10100144,,,,19,22,41
,2011,10100171,,,,44,47,91
,2011,10100193,,,,16,15,31
HND-000118,2011,10100209,,,,15,26,41
,2011,10100217,,,,6,7,13
,2011,10100241,,,,9,15,24
,2011,10100344,,,,7,15,22
,2011,10100346,,,,18,16,34
,2011,10100355,,,,4,4,8
,2011,10100356,,,,4,2,6
HND-000005,2011,10100007,,,,17,27,44
HND-000011,2011,10100016,,,,44,65,109
HND-000027,2011,10100032,,,,34,31,65
HND-000028,2011,10100033,,,,13,33,46
HND-000039,2011,10100045,,,,33,47,80
,2011,10100055,,,,13,10,23
HND-000059,2011,10100071,,,,59,60,119
,2011,10100131,,,,243,375,618
HND-000089,2011,10100132,,,,222,52,274
,2011,10100135,,,,48,53,101
,2011,10100136,,,,10,29,39
,2011,10100137,,,,44,39,83
,2011,10100140,,,,18,38,56
,2011,10100144,,,,17,17,34
,2011,10100148,,,,34,26,60
,2011,10100193,,,,29,17,46
HND-000118,2011,10100209,,,,11,11,22
,2011,10100241,,,,5,9,14
,2011,10100346,,,,10,8,18
,2011,10100355,,,,6,1,7
,2011,10100356,,,,5,2,7
,2011,10100013,,,,6,9,15
,2011,10100015,,,,55,91,146
HND-000023,2011,10100028,,,,11,8,19
HND-000026,2011,10100031,,,,19,28,47
HND-000037,2011,10100042,,,,27,28,55
HND-000041,2011,10100047,,,,3,14,17
HND-000044,2011,10100050,,,,23,33,56
HND-000047,2011,10100053,,,,41,67,108
HND-000047,2011,10100053,,,,41,67,108
,2011,10100066,,,,17,28,45
,2011,10100073,,,,9,11,20
,2011,10100080,,,,17,14,31
,2011,10100095,,,,159,192,351
,2011,10100138,,,,16,23,39
,2011,10100139,,,,15,8,23
HND-000091,2011,10100141,,,,14,23,37
,2011,10100142,,,,17,16,33
HND-000092,2011,10100145,,,,39,43,82
,2011,10100158,,,,1,7,8
,2011,10100162,,,,5,12,17
,2011,10100171,,,,35,30,65
,2011,10100195,,,,12,16,28
HND-000117,2011,10100208,,,,26,28,54
,2011,10100210,,,,12,22,34
,2011,10100214,,,,15,20,35
,2011,10100217,,,,4,9,13
HND-000140,2011,10100289,,,,61,70,131
,2011,10100344,,,,9,11,20
HND-000005,2011,10100007,,,,16,16,32
,2011,10100013,,,,8,6,14
HND-000011,2011,10100016,,,,24,39,63
HND-000027,2011,10100032,,,,22,18,40
HND-000028,2011,10100033,,,,16,39,55
HND-000037,2011,10100042,,,,18,28,46
HND-000039,2011,10100045,,,,22,41,63
HND-000047,2011,10100053,,,,38,70,108
,2011,10100055,,,,10,17,27
HND-000059,2011,10100071,,,,37,68,105
,2011,10100095,,,,131,183,314
HND-000089,2011,10100132,,,,138,41,179
,2011,10100135,,,,44,58,102
,2011,10100136,,,,7,21,28
,2011,10100137,,,,41,39,80
,2011,10100138,,,,16,25,41
,2011,10100140,,,,21,40,61
,2011,10100142,,,,4,15,19
HND-000092,2011,10100145,,,,27,45,72
,2011,10100148,,,,17,21,38
,2011,10100193,,,,21,17,38
,2011,10100344,,,,9,15,24
,2011,10100346,,,,6,3,9
,2011,10100355,,,,3,3,6
,2011,10100356,,,,1,1,2
,2011,10100015,,,,64,85,149
HND-000023,2011,10100028,,,,16,12,28
HND-000026,2011,10100031,,,,20,15,35
HND-000041,2011,10100047,,,,10,11,21
HND-000044,2011,10100050,,,,14,22,36
HND-000047,2011,10100053,,,,38,70,108
,2011,10100066,,,,20,20,40
,2011,10100073,,,,11,11,22
,2011,10100080,,,,3,21,24
,2011,10100131,,,,227,421,648
,2011,10100139,,,,7,14,21
HND-000091,2011,10100141,,,,13,21,34
,2011,10100144,,,,19,19,38
,2011,10100162,,,,6,10,16
,2011,10100171,,,,22,35,57
,2011,10100195,,,,11,22,33
HND-000117,2011,10100208,,,,19,40,59
HND-000118,2011,10100209,,,,11,10,21
,2011,10100210,,,,16,14,30
,2011,10100214,,,,17,20,37
,2011,10100241,,,,4,5,9
HND-000140,2011,10100289,,,,56,58,114
,2011,10100015,,,,94,84,178
HND-000047,2011,10100053,,,,27,37,64
,2011,10100073,,,,12,21,33
,2011,10100138,,,,32,33,65
,2011,10100139,,,,5,13,18
,2011,10100144,,,,9,12,21
HND-000092,2011,10100145,,,,11,21,32
,2011,10100171,,,,43,68,111
,2011,10100195,,,,21,18,39
HND-000117,2011,10100208,,,,8,12,20
HND-000118,2011,10100209,,,,22,19,41
,2011,10100210,,,,9,13,22
,2011,10100214,,,,10,4,14
,2011,10100241,,,,8,11,19
,2011,10100346,,,,8,10,18
,2011,10100013,,,,6,2,8
,2011,10100055,,,,6,10,16
,2011,10100066,,,,22,28,50
,2011,10100095,,,,199,283,482
,2011,10100131,,,,442,631,1073
HND-000089,2011,10100132,,,,322,79,401
,2011,10100135,,,,25,60,85
,2011,10100136,,,,22,53,75
,2011,10100137,,,,50,48,98
,2011,10100140,,,,20,49,69
,2011,10100142,,,,12,23,35
,2011,10100148,,,,27,48,75
,2011,10100162,,,,9,6,15
,2011,10100193,,,,25,26,51
HND-000140,2011,10100289,,,,101,118,219
,2011,10100344,,,,6,5,11
,2011,10100015,,,,84,155,239
,2011,10100055,,,,12,9,21
,2011,10100095,,,,124,244,368
HND-000089,2011,10100132,,,,261,76,337
,2011,10100135,,,,32,44,76
,2011,10100136,,,,13,35,48
,2011,10100137,,,,31,43,74
,2011,10100138,,,,16,19,35
,2011,10100140,,,,13,40,53
,2011,10100142,,,,12,23,35
HND-000092,2011,10100145,,,,7,10,17
,2011,10100148,,,,20,31,51
,2011,10100193,,,,23,22,45
,2011,10100241,,,,4,6,10
HND-000140,2011,10100289,,,,34,94,128
,2011,10100346,,,,3,1,4
,2011,10100013,,,,6,6,12
HND-000047,2011,10100053,,,,14,18,32
,2011,10100066,,,,21,23,44
,2011,10100073,,,,7,5,12
,2011,10100131,,,,275,512,787
,2011,10100139,,,,7,9,16
,2011,10100144,,,,12,15,27
,2011,10100162,,,,6,14,20
,2011,10100171,,,,23,38,61
,2011,10100195,,,,12,13,25
HND-000117,2011,10100208,,,,3,12,15
HND-000118,2011,10100209,,,,13,19,32
,2011,10100210,,,,7,11,18
,2011,10100214,,,,7,8,15
,2011,10100344,,,,27,19,46
,2011,10100055,,,,12,11,23
,2011,10100095,,,,94,128,222
,2011,10100139,,,,3,6,9
,2011,10100144,,,,8,11,19
,2011,10100171,,,,11,15,26
HND-000140,2011,10100289,,,,24,62,86
,2011,10100015,,,,38,55,93
HND-000047,2011,10100053,,,,9,16,25
,2011,10100073,,,,3,6,9
,2011,10100131,,,,183,358,541
HND-000089,2011,10100132,,,,201,42,243
,2011,10100136,,,,7,35,42
,2011,10100138,,,,63,67,130
,2011,10100140,,,,6,32,38
,2011,10100142,,,,13,15,28
HND-000092,2011,10100145,,,,3,15,18
,2011,10100148,,,,15,32,47
,2011,10100193,,,,23,18,41
HND-000117,2011,10100208,,,,2,8,10
HND-000118,2011,10100209,,,,13,14,27
,2011,10100210,,,,4,17,21
,2011,10100346,,,,0,3,3
HND-000156,2011,10200001,,,,6,3,9
HND-000172,2011,10200019,,,,6,6,12
,2011,10200021,,,,7,8,15
,2011,10200022,,,,8,4,12
HND-000182,2011,10200033,,,,8,11,19
HND-000189,2011,10200051,,,,21,22,43
,2011,10200052,,,,0,8,8
,2011,10200063,,,,7,5,12
HND-000180,2011,10200031,,,,1,6,7
,2011,10200054,,,,2,8,10
,2011,10200057,,,,8,13,21
,2011,10200061,,,,16,10,26
HND-000191,2011,10200062,,,,7,5,12
HND-000170,2011,10200017,,,,3,1,4
HND-000175,2011,10200024,,,,2,1,3
,2011,10200039,,,,2,2,4
HND-000169,2011,10200016,,,,1,4,5
HND-000173,2011,10200020,,,,0,4,4
,2011,10200041,,,,2,3,5
HND-000186,2011,10200048,,,,0,2,2
HND-000188,2011,10200050,,,,6,6,12
HND-000167,2011,10200014,,,,6,14,20
HND-000168,2011,10200015,,,,16,17,33
HND-000169,2011,10200016,,,,25,21,46
HND-000173,2011,10200020,,,,3,3,6
HND-000174,2011,10200023,,,,8,3,11
,2011,10200041,,,,1,1,2
HND-000186,2011,10200048,,,,14,11,25
HND-000190,2011,10200056,,,,21,21,42
HND-000170,2011,10200017,,,,6,9,15
HND-000175,2011,10200024,,,,8,8,16
HND-000176,2011,10200025,,,,9,14,23
,2011,10200039,,,,6,4,10
,2011,10200004,,,,7,7,14
HND-000159,2011,10200005,,,,6,3,9
HND-000160,2011,10200006,,,,8,4,12
HND-000161,2011,10200007,,,,53,48,101
HND-000163,2011,10200010,,,,7,4,11
HND-000164,2011,10200011,,,,15,16,31
HND-000166,2011,10200013,,,,9,7,16
HND-000171,2011,10200018,,,,34,46,80
HND-000180,2011,10200031,,,,3,3,6
HND-000181,2011,10200032,,,,20,15,35
HND-000183,2011,10200035,,,,12,13,25
,2011,10200041,,,,2,4,6
HND-000184,2011,10200042,,,,36,22,58
HND-000187,2011,10200049,,,,4,1,5
HND-000156,2011,10200001,,,,8,9,17
HND-000157,2011,10200002,,,,51,45,96
HND-000158,2011,10200003,,,,6,8,14
HND-000162,2011,10200008,,,,16,17,33
HND-000165,2011,10200012,,,,1,3,4
HND-000167,2011,10200014,,,,47,30,77
,2011,10200038,,,,5,3,8
HND-000185,2011,10200047,,,,13,5,18
HND-000156,2011,10200001,,,,9,4,13
HND-000157,2011,10200002,,,,37,26,63
HND-000159,2011,10200005,,,,7,7,14
HND-000160,2011,10200006,,,,8,9,17
HND-000162,2011,10200008,,,,11,6,17
HND-000163,2011,10200010,,,,5,5,10
HND-000165,2011,10200012,,,,2,2,4
HND-000166,2011,10200013,,,,17,6,23
HND-000167,2011,10200014,,,,33,24,57
HND-000185,2011,10200047,,,,4,2,6
,2011,10200055,,,,1,1,2
HND-000158,2011,10200003,,,,7,10,17
,2011,10200004,,,,7,1,8
HND-000161,2011,10200007,,,,44,45,89
HND-000164,2011,10200011,,,,13,13,26
HND-000171,2011,10200018,,,,42,31,73
HND-000180,2011,10200031,,,,3,2,5
HND-000181,2011,10200032,,,,5,16,21
HND-000183,2011,10200035,,,,18,14,32
,2011,10200038,,,,2,3,5
,2011,10200041,,,,2,5,7
HND-000184,2011,10200042,,,,28,22,50
HND-000187,2011,10200049,,,,2,0,2
HND-000156,2011,10200001,,,,14,10,24
HND-000157,2011,10200002,,,,44,48,92
HND-000158,2011,10200003,,,,4,5,9
HND-000162,2011,10200008,,,,14,9,23
HND-000165,2011,10200012,,,,4,0,4
HND-000167,2011,10200014,,,,29,22,51
,2011,10200038,,,,3,3,6
HND-000185,2011,10200047,,,,4,3,7
,2011,10200004,,,,2,2,4
HND-000159,2011,10200005,,,,16,7,23
HND-000160,2011,10200006,,,,8,2,10
HND-000161,2011,10200007,,,,35,42,77
HND-000163,2011,10200010,,,,5,6,11
HND-000164,2011,10200011,,,,9,13,22
HND-000166,2011,10200013,,,,7,7,14
HND-000171,2011,10200018,,,,47,42,89
HND-000180,2011,10200031,,,,1,4,5
HND-000181,2011,10200032,,,,10,16,26
HND-000183,2011,10200035,,,,13,12,25
,2011,10200041,,,,1,5,6
HND-000184,2011,10200042,,,,38,22,60
HND-000187,2011,10200049,,,,3,2,5
HND-000156,2011,10200001,,,,9,10,19
HND-000157,2011,10200002,,,,58,49,107
HND-000159,2011,10200005,,,,8,9,17
HND-000160,2011,10200006,,,,6,5,11
HND-000161,2011,10200007,,,,34,52,86
HND-000162,2011,10200008,,,,7,9,16
HND-000163,2011,10200010,,,,11,7,18
HND-000164,2011,10200011,,,,14,6,20
HND-000165,2011,10200012,,,,3,0,3
HND-000166,2011,10200013,,,,4,13,17
HND-000171,2011,10200018,,,,40,32,72
HND-000180,2011,10200031,,,,3,1,4
HND-000185,2011,10200047,,,,2,3,5
,2011,10200055,,,,5,2,7
HND-000158,2011,10200003,,,,4,6,10
,2011,10200004,,,,7,5,12
HND-000167,2011,10200014,,,,14,14,28
HND-000181,2011,10200032,,,,12,16,28
HND-000183,2011,10200035,,,,10,10,20
,2011,10200038,,,,3,0,3
,2011,10200041,,,,4,2,6
HND-000184,2011,10200042,,,,27,21,48
HND-000187,2011,10200049,,,,3,0,3
HND-000156,2011,10200001,,,,9,9,18
HND-000158,2011,10200003,,,,7,1,8
HND-000167,2011,10200014,,,,19,18,37
HND-000180,2011,10200031,,,,1,2,3
HND-000181,2011,10200032,,,,13,18,31
HND-000184,2011,10200042,,,,23,27,50
HND-000185,2011,10200047,,,,10,3,13
HND-000187,2011,10200049,,,,3,0,3
,2011,10200055,,,,2,1,3
HND-000157,2011,10200002,,,,40,40,80
,2011,10200004,,,,2,4,6
HND-000159,2011,10200005,,,,3,12,15
HND-000160,2011,10200006,,,,4,7,11
HND-000161,2011,10200007,,,,61,25,86
HND-000162,2011,10200008,,,,14,15,29
HND-000163,2011,10200010,,,,5,6,11
HND-000164,2011,10200011,,,,18,12,30
HND-000165,2011,10200012,,,,1,0,1
HND-000166,2011,10200013,,,,3,8,11
HND-000171,2011,10200018,,,,33,40,73
HND-000183,2011,10200035,,,,20,13,33
,2011,10200041,,,,2,2,4
HND-000156,2011,10200001,,,,4,4,8
HND-000157,2011,10200002,,,,44,36,80
HND-000159,2011,10200005,,,,10,6,16
HND-000160,2011,10200006,,,,10,10,20
HND-000162,2011,10200008,,,,12,15,27
HND-000163,2011,10200010,,,,2,5,7
HND-000165,2011,10200012,,,,1,2,3
HND-000166,2011,10200013,,,,2,3,5
HND-000167,2011,10200014,,,,8,22,30
HND-000180,2011,10200031,,,,1,4,5
HND-000181,2011,10200032,,,,14,9,23
HND-000183,2011,10200035,,,,8,9,17
,2011,10200038,,,,3,2,5
,2011,10200041,,,,0,1,1
HND-000184,2011,10200042,,,,22,15,37
HND-000158,2011,10200003,,,,4,6,10
,2011,10200004,,,,2,3,5
HND-000161,2011,10200007,,,,36,42,78
HND-000164,2011,10200011,,,,8,7,15
HND-000171,2011,10200018,,,,33,40,73
HND-000185,2011,10200047,,,,2,3,5
HND-000164,2011,10200011,,,,9,13,22
HND-000178,2011,10200027,,,,36,35,71
HND-000179,2011,10200028,,,,91,99,190
HND-000167,2011,10200014,,,,6,21,27
HND-000177,2011,10200026,,,,88,54,142
HND-000183,2011,10200035,,,,15,4,19
,2011,10200053,,,,2,1,3
HND-000164,2011,10200011,,,,11,11,22
HND-000178,2011,10200027,,,,40,50,90
HND-000179,2011,10200028,,,,67,84,151
HND-000167,2011,10200014,,,,18,14,32
HND-000177,2011,10200026,,,,68,43,111
HND-000183,2011,10200035,,,,7,13,20
,2011,10200053,,,,1,3,4
HND-000164,2011,10200011,,,,6,8,14
HND-000167,2011,10200014,,,,5,7,12
HND-000178,2011,10200027,,,,27,48,75
,2011,10200053,,,,4,1,5
HND-000177,2011,10200026,,,,38,44,82
HND-000179,2011,10200028,,,,61,79,140
HND-000183,2011,10200035,,,,8,6,14
HND-000179,2011,10200028,,,,59,90,149
,2011,10200053,,,,5,4,9
HND-000177,2011,10200026,,,,42,48,90
HND-000178,2011,10200027,,,,10,26,36
HND-000179,2011,10200028,,,,38,61,99
HND-000177,2011,10200026,,,,40,40,80
HND-000178,2011,10200027,,,,8,12,20
HND-000177,2011,10200026,,,,36,29,65
HND-000178,2011,10200027,,,,10,15,25
HND-000179,2011,10200028,,,,27,40,67
,2011,10300080,,,,6,1,7
,2011,10300082,,,,4,4,8
,2011,10300088,,,,6,5,11
,2011,10300093,,,,8,5,13
,2011,10300094,,,,5,3,8
,2011,10300100,,,,3,2,5
,2011,10300102,,,,0,4,4
,2011,10300103,,,,8,4,12
,2011,10300105,,,,3,4,7
,2011,10300106,,,,2,2,4
,2011,10300067,,,,6,7,13
,2011,10300095,,,,2,4,6
,2011,10300096,,,,3,9,12
,2011,10300097,,,,2,3,5
,2011,10300101,,,,1,8,9
,2011,10300104,,,,5,2,7
,2011,10300107,,,,5,5,10
HND-000234,2011,10300042,,,,4,5,9
HND-000235,2011,10300043,,,,2,0,2
,2011,10300076,,,,3,4,7
,2011,10300077,,,,5,4,9
,2011,10300078,,,,2,1,3
,2011,10300081,,,,3,1,4
,2011,10300085,,,,2,1,3
,2011,10300086,,,,6,3,9
,2011,10300087,,,,3,4,7
,2011,10300098,,,,3,3,6
HND-000233,2011,10300041,,,,2,4,6
HND-000236,2011,10300044,,,,5,4,9
HND-000237,2011,10300045,,,,0,3,3
HND-000244,2011,10300054,,,,2,2,4
HND-000245,2011,10300055,,,,1,1,2
,2011,10300057,,,,2,2,4
HND-000250,2011,10300079,,,,3,7,10
,2011,10300083,,,,6,2,8
,2011,10300084,,,,1,5,6
,2011,10300089,,,,3,3,6
,2011,10300092,,,,2,1,3
HND-000233,2011,10300041,,,,12,17,29
HND-000234,2011,10300042,,,,11,11,22
HND-000236,2011,10300044,,,,4,7,11
HND-000244,2011,10300054,,,,3,6,9
HND-000245,2011,10300055,,,,9,7,16
,2011,10300057,,,,3,4,7
,2011,10300078,,,,1,5,6
HND-000250,2011,10300079,,,,12,11,23
,2011,10300081,,,,6,4,10
,2011,10300083,,,,1,1,2
,2011,10300089,,,,2,6,8
,2011,10300092,,,,8,4,12
HND-000235,2011,10300043,,,,12,11,23
HND-000237,2011,10300045,,,,6,7,13
HND-000247,2011,10300058,,,,6,3,9
,2011,10300076,,,,7,4,11
,2011,10300077,,,,7,5,12
,2011,10300084,,,,5,1,6
,2011,10300085,,,,5,3,8
,2011,10300086,,,,1,5,6
,2011,10300087,,,,2,4,6
,2011,10300098,,,,5,2,7
HND-000194,2011,10300002,,,,3,4,7
HND-000195,2011,10300003,,,,4,5,9
HND-000200,2011,10300008,,,,9,5,14
HND-000201,2011,10300009,,,,1,5,6
HND-000202,2011,10300010,,,,10,3,13
HND-000203,2011,10300011,,,,10,4,14
HND-000204,2011,10300012,,,,6,8,14
HND-000205,2011,10300013,,,,13,6,19
HND-000210,2011,10300018,,,,28,25,53
HND-000211,2011,10300019,,,,4,2,6
HND-000212,2011,10300020,,,,13,15,28
HND-000213,2011,10300021,,,,6,13,19
HND-000215,2011,10300023,,,,6,10,16
HND-000220,2011,10300028,,,,3,2,5
HND-000221,2011,10300029,,,,13,10,23
HND-000222,2011,10300030,,,,2,0,2
HND-000223,2011,10300031,,,,12,13,25
HND-000225,2011,10300033,,,,6,0,6
HND-000227,2011,10300035,,,,6,4,10
HND-000230,2011,10300038,,,,13,3,16
HND-000231,2011,10300039,,,,3,2,5
HND-000240,2011,10300050,,,,9,5,14
HND-000241,2011,10300051,,,,7,1,8
HND-000242,2011,10300052,,,,4,4,8
HND-000243,2011,10300053,,,,3,4,7
HND-000248,2011,10300071,,,,1,4,5
HND-000251,2011,10300090,,,,2,0,2
HND-000193,2011,10300001,,,,20,16,36
HND-000196,2011,10300004,,,,1,6,7
HND-000197,2011,10300005,,,,3,1,4
HND-000198,2011,10300006,,,,6,2,8
HND-000199,2011,10300007,,,,2,3,5
HND-000206,2011,10300014,,,,1,2,3
HND-000207,2011,10300015,,,,6,7,13
HND-000208,2011,10300016,,,,2,1,3
HND-000209,2011,10300017,,,,3,3,6
HND-000214,2011,10300022,,,,3,2,5
HND-000216,2011,10300024,,,,11,8,19
HND-000217,2011,10300025,,,,1,0,1
HND-000218,2011,10300026,,,,10,10,20
HND-000219,2011,10300027,,,,3,0,3
HND-000224,2011,10300032,,,,13,15,28
HND-000226,2011,10300034,,,,17,17,34
HND-000228,2011,10300036,,,,9,2,11
HND-000229,2011,10300037,,,,3,1,4
HND-000239,2011,10300047,,,,8,6,14
HND-000246,2011,10300056,,,,3,8,11
HND-000249,2011,10300074,,,,3,2,5
HND-000252,2011,10300099,,,,6,10,16
HND-000253,2011,10300108,,,,3,0,3
HND-000195,2011,10300003,,,,6,5,11
HND-000197,2011,10300005,,,,0,1,1
HND-000198,2011,10300006,,,,4,2,6
HND-000200,2011,10300008,,,,6,8,14
HND-000203,2011,10300011,,,,4,1,5
HND-000207,2011,10300015,,,,6,6,12
HND-000208,2011,10300016,,,,1,0,1
HND-000209,2011,10300017,,,,6,2,8
HND-000210,2011,10300018,,,,26,18,44
HND-000213,2011,10300021,,,,7,7,14
HND-000217,2011,10300025,,,,1,2,3
HND-000218,2011,10300026,,,,10,11,21
HND-000220,2011,10300028,,,,8,5,13
HND-000222,2011,10300030,,,,1,1,2
HND-000224,2011,10300032,,,,23,13,36
HND-000225,2011,10300033,,,,2,0,2
HND-000226,2011,10300034,,,,10,9,19
HND-000231,2011,10300039,,,,1,3,4
HND-000239,2011,10300047,,,,7,6,13
HND-000242,2011,10300052,,,,1,2,3
HND-000246,2011,10300056,,,,4,4,8
HND-000248,2011,10300071,,,,0,1,1
HND-000252,2011,10300099,,,,6,5,11
HND-000253,2011,10300108,,,,2,2,4
HND-000193,2011,10300001,,,,22,23,45
HND-000194,2011,10300002,,,,7,5,12
HND-000196,2011,10300004,,,,2,3,5
HND-000199,2011,10300007,,,,3,1,4
HND-000201,2011,10300009,,,,4,0,4
HND-000202,2011,10300010,,,,3,5,8
HND-000204,2011,10300012,,,,6,3,9
HND-000205,2011,10300013,,,,7,4,11
HND-000206,2011,10300014,,,,2,3,5
HND-000211,2011,10300019,,,,10,4,14
HND-000212,2011,10300020,,,,13,11,24
HND-000215,2011,10300023,,,,3,2,5
HND-000216,2011,10300024,,,,3,10,13
HND-000221,2011,10300029,,,,9,6,15
HND-000223,2011,10300031,,,,12,6,18
HND-000227,2011,10300035,,,,2,4,6
HND-000228,2011,10300036,,,,4,0,4
HND-000229,2011,10300037,,,,2,2,4
HND-000230,2011,10300038,,,,6,4,10
HND-000232,2011,10300040,,,,2,1,3
HND-000240,2011,10300050,,,,5,5,10
HND-000241,2011,10300051,,,,2,1,3
HND-000243,2011,10300053,,,,3,4,7
HND-000249,2011,10300074,,,,4,4,8
HND-000194,2011,10300002,,,,2,2,4
HND-000195,2011,10300003,,,,4,3,7
HND-000200,2011,10300008,,,,6,5,11
HND-000201,2011,10300009,,,,2,3,5
HND-000202,2011,10300010,,,,6,5,11
HND-000203,2011,10300011,,,,3,4,7
HND-000204,2011,10300012,,,,4,4,8
HND-000205,2011,10300013,,,,9,8,17
HND-000210,2011,10300018,,,,20,26,46
HND-000211,2011,10300019,,,,3,6,9
HND-000212,2011,10300020,,,,9,13,22
HND-000213,2011,10300021,,,,6,6,12
HND-000215,2011,10300023,,,,6,5,11
HND-000217,2011,10300025,,,,3,0,3
HND-000218,2011,10300026,,,,10,9,19
HND-000220,2011,10300028,,,,3,3,6
HND-000221,2011,10300029,,,,13,10,23
HND-000224,2011,10300032,,,,12,18,30
HND-000226,2011,10300034,,,,8,13,21
HND-000229,2011,10300037,,,,1,1,2
HND-000231,2011,10300039,,,,4,3,7
HND-000239,2011,10300047,,,,5,2,7
HND-000246,2011,10300056,,,,7,3,10
HND-000249,2011,10300074,,,,2,2,4
HND-000251,2011,10300090,,,,1,3,4
HND-000252,2011,10300099,,,,8,3,11
HND-000193,2011,10300001,,,,13,20,33
HND-000196,2011,10300004,,,,3,1,4
HND-000197,2011,10300005,,,,1,1,2
HND-000198,2011,10300006,,,,7,4,11
HND-000199,2011,10300007,,,,5,0,5
HND-000206,2011,10300014,,,,4,5,9
HND-000207,2011,10300015,,,,4,0,4
HND-000208,2011,10300016,,,,3,2,5
HND-000209,2011,10300017,,,,4,6,10
HND-000216,2011,10300024,,,,7,4,11
HND-000219,2011,10300027,,,,0,1,1
HND-000222,2011,10300030,,,,1,3,4
HND-000223,2011,10300031,,,,10,4,14
HND-000225,2011,10300033,,,,5,1,6
HND-000227,2011,10300035,,,,2,2,4
HND-000228,2011,10300036,,,,1,3,4
HND-000230,2011,10300038,,,,4,4,8
HND-000240,2011,10300050,,,,2,2,4
HND-000241,2011,10300051,,,,3,2,5
HND-000242,2011,10300052,,,,3,1,4
HND-000243,2011,10300053,,,,5,1,6
HND-000248,2011,10300071,,,,0,1,1
HND-000193,2011,10300001,,,,26,13,39
HND-000197,2011,10300005,,,,5,0,5
HND-000198,2011,10300006,,,,3,3,6
HND-000199,2011,10300007,,,,5,5,10
HND-000200,2011,10300008,,,,10,6,16
HND-000207,2011,10300015,,,,4,5,9
HND-000208,2011,10300016,,,,1,2,3
HND-000209,2011,10300017,,,,6,1,7
HND-000210,2011,10300018,,,,24,25,49
HND-000216,2011,10300024,,,,7,8,15
HND-000217,2011,10300025,,,,0,1,1
HND-000218,2011,10300026,,,,11,10,21
HND-000219,2011,10300027,,,,1,0,1
HND-000220,2011,10300028,,,,4,3,7
HND-000222,2011,10300030,,,,1,0,1
HND-000223,2011,10300031,,,,7,9,16
HND-000224,2011,10300032,,,,14,16,30
HND-000225,2011,10300033,,,,5,3,8
HND-000230,2011,10300038,,,,2,2,4
HND-000231,2011,10300039,,,,4,4,8
HND-000232,2011,10300040,,,,1,1,2
HND-000242,2011,10300052,,,,4,3,7
HND-000243,2011,10300053,,,,1,3,4
HND-000248,2011,10300071,,,,1,1,2
HND-000251,2011,10300090,,,,3,2,5
HND-000252,2011,10300099,,,,2,5,7
HND-000253,2011,10300108,,,,3,0,3
HND-000194,2011,10300002,,,,4,7,11
HND-000195,2011,10300003,,,,2,4,6
HND-000196,2011,10300004,,,,2,2,4
HND-000201,2011,10300009,,,,3,1,4
HND-000202,2011,10300010,,,,8,6,14
HND-000203,2011,10300011,,,,3,2,5
HND-000204,2011,10300012,,,,2,9,11
HND-000205,2011,10300013,,,,5,5,10
HND-000206,2011,10300014,,,,2,4,6
HND-000211,2011,10300019,,,,2,4,6
HND-000212,2011,10300020,,,,12,11,23
HND-000213,2011,10300021,,,,8,14,22
HND-000214,2011,10300022,,,,3,0,3
HND-000215,2011,10300023,,,,3,5,8
HND-000221,2011,10300029,,,,7,8,15
HND-000226,2011,10300034,,,,6,6,12
HND-000227,2011,10300035,,,,6,3,9
HND-000228,2011,10300036,,,,3,7,10
HND-000229,2011,10300037,,,,1,0,1
HND-000239,2011,10300047,,,,6,9,15
HND-000240,2011,10300050,,,,4,4,8
HND-000241,2011,10300051,,,,5,1,6
HND-000246,2011,10300056,,,,5,5,10
HND-000249,2011,10300074,,,,1,0,1
HND-000193,2011,10300001,,,,21,20,41
HND-000197,2011,10300005,,,,4,1,5
HND-000198,2011,10300006,,,,1,2,3
HND-000199,2011,10300007,,,,0,2,2
HND-000200,2011,10300008,,,,1,8,9
HND-000206,2011,10300014,,,,3,1,4
HND-000207,2011,10300015,,,,1,5,6
HND-000208,2011,10300016,,,,3,0,3
HND-000209,2011,10300017,,,,4,9,13
HND-000216,2011,10300024,,,,7,8,15
HND-000218,2011,10300026,,,,15,17,32
HND-000219,2011,10300027,,,,3,3,6
HND-000222,2011,10300030,,,,0,1,1
HND-000223,2011,10300031,,,,8,9,17
HND-000224,2011,10300032,,,,6,10,16
HND-000225,2011,10300033,,,,5,1,6
HND-000230,2011,10300038,,,,6,5,11
HND-000231,2011,10300039,,,,3,1,4
HND-000232,2011,10300040,,,,1,0,1
HND-000240,2011,10300050,,,,5,4,9
HND-000242,2011,10300052,,,,2,4,6
HND-000243,2011,10300053,,,,6,0,6
HND-000248,2011,10300071,,,,4,2,6
HND-000252,2011,10300099,,,,3,1,4
HND-000194,2011,10300002,,,,4,4,8
HND-000195,2011,10300003,,,,4,2,6
HND-000196,2011,10300004,,,,4,3,7
HND-000201,2011,10300009,,,,1,0,1
HND-000202,2011,10300010,,,,3,12,15
HND-000203,2011,10300011,,,,7,2,9
HND-000204,2011,10300012,,,,4,3,7
HND-000205,2011,10300013,,,,6,5,11
HND-000210,2011,10300018,,,,23,23,46
HND-000211,2011,10300019,,,,2,2,4
HND-000212,2011,10300020,,,,17,18,35
HND-000213,2011,10300021,,,,10,8,18
HND-000214,2011,10300022,,,,2,3,5
HND-000215,2011,10300023,,,,4,5,9
HND-000220,2011,10300028,,,,5,3,8
HND-000221,2011,10300029,,,,19,16,35
HND-000226,2011,10300034,,,,4,8,12
HND-000227,2011,10300035,,,,3,0,3
HND-000228,2011,10300036,,,,9,4,13
HND-000239,2011,10300047,,,,5,7,12
HND-000241,2011,10300051,,,,1,2,3
HND-000246,2011,10300056,,,,2,4,6
HND-000249,2011,10300074,,,,3,1,4
HND-000253,2011,10300108,,,,2,0,2
HND-000193,2011,10300001,,,,11,20,31
HND-000194,2011,10300002,,,,3,3,6
HND-000196,2011,10300004,,,,5,3,8
HND-000199,2011,10300007,,,,3,2,5
HND-000201,2011,10300009,,,,3,0,3
HND-000202,2011,10300010,,,,4,7,11
HND-000204,2011,10300012,,,,7,3,10
HND-000205,2011,10300013,,,,5,5,10
HND-000206,2011,10300014,,,,4,2,6
HND-000211,2011,10300019,,,,2,4,6
HND-000212,2011,10300020,,,,9,13,22
HND-000215,2011,10300023,,,,3,6,9
HND-000216,2011,10300024,,,,2,11,13
HND-000221,2011,10300029,,,,13,5,18
HND-000223,2011,10300031,,,,8,9,17
HND-000227,2011,10300035,,,,6,4,10
HND-000228,2011,10300036,,,,6,4,10
HND-000229,2011,10300037,,,,1,1,2
HND-000230,2011,10300038,,,,2,6,8
HND-000232,2011,10300040,,,,2,0,2
HND-000240,2011,10300050,,,,6,2,8
HND-000241,2011,10300051,,,,3,1,4
HND-000243,2011,10300053,,,,1,2,3
HND-000249,2011,10300074,,,,0,1,1
HND-000253,2011,10300108,,,,0,1,1
HND-000195,2011,10300003,,,,1,5,6
HND-000197,2011,10300005,,,,1,0,1
HND-000198,2011,10300006,,,,4,2,6
HND-000200,2011,10300008,,,,7,5,12
HND-000203,2011,10300011,,,,1,3,4
HND-000207,2011,10300015,,,,6,3,9
HND-000208,2011,10300016,,,,3,3,6
HND-000209,2011,10300017,,,,3,6,9
HND-000210,2011,10300018,,,,22,22,44
HND-000213,2011,10300021,,,,17,20,37
HND-000217,2011,10300025,,,,1,1,2
HND-000218,2011,10300026,,,,13,19,32
HND-000220,2011,10300028,,,,5,4,9
HND-000222,2011,10300030,,,,1,2,3
HND-000224,2011,10300032,,,,14,22,36
HND-000225,2011,10300033,,,,3,9,12
HND-000226,2011,10300034,,,,10,12,22
HND-000239,2011,10300047,,,,8,5,13
HND-000242,2011,10300052,,,,2,0,2
HND-000246,2011,10300056,,,,3,0,3
HND-000248,2011,10300071,,,,2,3,5
HND-000251,2011,10300090,,,,1,2,3
HND-000252,2011,10300099,,,,1,0,1
HND-000216,2011,10300024,,,,7,2,9
HND-000218,2011,10300026,,,,28,28,56
HND-000223,2011,10300031,,,,14,20,34
HND-000224,2011,10300032,,,,20,19,39
HND-000238,2011,10300046,,,,102,107,209
HND-000216,2011,10300024,,,,8,11,19
HND-000223,2011,10300031,,,,6,11,17
HND-000218,2011,10300026,,,,14,18,32
HND-000224,2011,10300032,,,,16,12,28
HND-000238,2011,10300046,,,,82,77,159
HND-000216,2011,10300024,,,,7,5,12
HND-000238,2011,10300046,,,,84,77,161
HND-000218,2011,10300026,,,,12,19,31
HND-000223,2011,10300031,,,,10,7,17
HND-000224,2011,10300032,,,,14,17,31
HND-000218,2011,10300026,,,,9,6,15
HND-000224,2011,10300032,,,,6,7,13
HND-000238,2011,10300046,,,,68,60,128
HND-000218,2011,10300026,,,,9,1,10
HND-000224,2011,10300032,,,,10,12,22
HND-000238,2011,10300046,,,,29,30,59
HND-000224,2011,10300032,,,,11,9,20
HND-000238,2011,10300046,,,,31,34,65
HND-000218,2011,10300026,,,,2,14,16
,2011,10400097,,,,1,4,5
,2011,10400117,,,,3,7,10
HND-000345,2011,10400122,,,,7,4,11
,2011,10400128,,,,5,3,8
,2011,10400154,,,,7,6,13
,2011,10400164,,,,4,3,7
,2011,10400165,,,,7,4,11
,2011,10400166,,,,5,3,8
HND-000365,2011,10400179,,,,7,7,14
,2011,10400201,,,,9,4,13
,2011,10400212,,,,8,10,18
,2011,10400219,,,,2,3,5
,2011,10400222,,,,4,5,9
,2011,10400227,,,,1,0,1
,2011,10400229,,,,1,4,5
,2011,10400231,,,,4,1,5
,2011,10400238,,,,2,5,7
,2011,10400244,,,,6,0,6
,2011,10400246,,,,1,8,9
HND-000381,2011,10400247,,,,6,9,15
,2011,10400121,,,,3,4,7
HND-000346,2011,10400124,,,,7,3,10
,2011,10400127,,,,2,3,5
,2011,10400129,,,,9,11,20
,2011,10400144,,,,5,6,11
,2011,10400158,,,,11,12,23
,2011,10400162,,,,7,9,16
,2011,10400163,,,,7,4,11
HND-000362,2011,10400168,,,,8,4,12
,2011,10400171,,,,6,7,13
HND-000363,2011,10400172,,,,2,5,7
,2011,10400194,,,,11,9,20
HND-000372,2011,10400204,,,,6,9,15
,2011,10400207,,,,5,6,11
HND-000378,2011,10400221,,,,2,7,9
,2011,10400226,,,,6,4,10
HND-000380,2011,10400232,,,,6,4,10
,2011,10400237,,,,4,1,5
,2011,10400240,,,,2,3,5
,2011,10400242,,,,5,3,8
,2011,10400243,,,,2,3,5
HND-000382,2011,10400248,,,,6,5,11
,2011,10400087,,,,3,3,6
,2011,10400091,,,,3,5,8
HND-000344,2011,10400120,,,,2,0,2
HND-000347,2011,10400126,,,,6,3,9
,2011,10400138,,,,2,1,3
,2011,10400145,,,,4,2,6
,2011,10400214,,,,3,1,4
,2011,10400250,,,,2,3,5
HND-000350,2011,10400134,,,,1,2,3
HND-000353,2011,10400139,,,,0,6,6
HND-000356,2011,10400149,,,,3,3,6
HND-000357,2011,10400150,,,,2,2,4
HND-000379,2011,10400225,,,,0,1,1
,2011,10400228,,,,3,0,3
,2011,10400249,,,,6,2,8
,2011,10400252,,,,6,6,12
HND-000321,2011,10400072,,,,5,6,11
HND-000323,2011,10400074,,,,4,8,12
HND-000325,2011,10400077,,,,3,2,5
HND-000327,2011,10400080,,,,6,4,10
HND-000328,2011,10400081,,,,1,1,2
,2011,10400091,,,,1,4,5
HND-000344,2011,10400120,,,,4,1,5
,2011,10400125,,,,5,11,16
HND-000348,2011,10400130,,,,3,4,7
HND-000351,2011,10400135,,,,5,6,11
,2011,10400136,,,,1,3,4
,2011,10400138,,,,3,3,6
HND-000353,2011,10400139,,,,4,4,8
,2011,10400142,,,,1,7,8
HND-000354,2011,10400143,,,,5,3,8
,2011,10400144,,,,6,3,9
HND-000356,2011,10400149,,,,0,5,5
,2011,10400167,,,,4,3,7
HND-000371,2011,10400196,,,,4,3,7
,2011,10400214,,,,3,2,5
,2011,10400250,,,,3,2,5
,2011,10400252,,,,1,1,2
HND-000319,2011,10400070,,,,27,4,31
HND-000320,2011,10400071,,,,9,8,17
HND-000322,2011,10400073,,,,2,4,6
HND-000324,2011,10400075,,,,7,6,13
,2011,10400078,,,,2,0,2
HND-000326,2011,10400079,,,,4,4,8
HND-000329,2011,10400086,,,,3,3,6
,2011,10400087,,,,5,1,6
HND-000332,2011,10400093,,,,0,2,2
HND-000339,2011,10400108,,,,2,3,5
HND-000343,2011,10400119,,,,5,5,10
HND-000349,2011,10400131,,,,6,2,8
HND-000350,2011,10400134,,,,0,3,3
HND-000352,2011,10400137,,,,1,3,4
,2011,10400140,,,,3,5,8
,2011,10400145,,,,1,3,4
HND-000355,2011,10400147,,,,4,2,6
HND-000357,2011,10400150,,,,0,2,2
HND-000373,2011,10400213,,,,6,9,15
HND-000379,2011,10400225,,,,1,3,4
,2011,10400228,,,,2,1,3
,2011,10400235,,,,4,3,7
,2011,10400249,,,,0,4,4
HND-000319,2011,10400070,,,,11,14,25
HND-000320,2011,10400071,,,,18,18,36
HND-000324,2011,10400075,,,,9,12,21
,2011,10400078,,,,3,6,9
,2011,10400087,,,,6,7,13
HND-000332,2011,10400093,,,,1,2,3
HND-000339,2011,10400108,,,,2,2,4
HND-000349,2011,10400131,,,,2,5,7
HND-000350,2011,10400134,,,,2,1,3
HND-000352,2011,10400137,,,,12,9,21
HND-000353,2011,10400139,,,,4,5,9
,2011,10400145,,,,5,6,11
HND-000355,2011,10400147,,,,2,12,14
HND-000357,2011,10400150,,,,7,7,14
HND-000361,2011,10400160,,,,4,5,9
,2011,10400199,,,,4,4,8
HND-000379,2011,10400225,,,,1,2,3
,2011,10400228,,,,7,6,13
,2011,10400249,,,,2,3,5
HND-000321,2011,10400072,,,,1,5,6
HND-000322,2011,10400073,,,,13,11,24
HND-000323,2011,10400074,,,,7,6,13
HND-000325,2011,10400077,,,,5,9,14
HND-000326,2011,10400079,,,,7,5,12
HND-000327,2011,10400080,,,,4,1,5
HND-000328,2011,10400081,,,,14,10,24
HND-000329,2011,10400086,,,,4,14,18
,2011,10400091,,,,4,5,9
HND-000343,2011,10400119,,,,13,17,30
HND-000344,2011,10400120,,,,6,2,8
,2011,10400125,,,,2,0,2
HND-000347,2011,10400126,,,,3,5,8
HND-000348,2011,10400130,,,,14,9,23
HND-000351,2011,10400135,,,,10,4,14
,2011,10400136,,,,5,3,8
,2011,10400138,,,,6,4,10
,2011,10400140,,,,10,4,14
,2011,10400142,,,,8,10,18
HND-000354,2011,10400143,,,,4,7,11
,2011,10400144,,,,5,4,9
HND-000356,2011,10400149,,,,2,4,6
,2011,10400167,,,,3,1,4
HND-000371,2011,10400196,,,,9,10,19
HND-000373,2011,10400213,,,,5,6,11
,2011,10400214,,,,4,1,5
,2011,10400235,,,,6,2,8
,2011,10400250,,,,7,6,13
HND-000254,2011,10400002,,,,5,8,13
HND-000259,2011,10400007,,,,6,11,17
HND-000261,2011,10400009,,,,4,2,6
HND-000263,2011,10400011,,,,24,14,38
HND-000265,2011,10400013,,,,53,50,103
HND-000267,2011,10400015,,,,6,8,14
HND-000268,2011,10400016,,,,11,18,29
HND-000269,2011,10400017,,,,10,14,24
HND-000270,2011,10400018,,,,3,0,3
HND-000276,2011,10400024,,,,4,9,13
HND-000277,2011,10400025,,,,6,8,14
HND-000278,2011,10400026,,,,11,6,17
HND-000279,2011,10400027,,,,3,3,6
HND-000282,2011,10400030,,,,3,4,7
HND-000283,2011,10400031,,,,3,3,6
HND-000284,2011,10400032,,,,7,6,13
HND-000285,2011,10400033,,,,2,2,4
HND-000290,2011,10400038,,,,6,4,10
HND-000291,2011,10400039,,,,1,6,7
HND-000292,2011,10400040,,,,9,9,18
HND-000293,2011,10400041,,,,14,13,27
HND-000294,2011,10400042,,,,1,4,5
HND-000295,2011,10400043,,,,0,3,3
HND-000301,2011,10400049,,,,1,2,3
HND-000305,2011,10400054,,,,3,1,4
HND-000306,2011,10400055,,,,0,2,2
HND-000307,2011,10400056,,,,8,3,11
HND-000308,2011,10400057,,,,8,2,10
HND-000311,2011,10400060,,,,5,4,9
HND-000312,2011,10400062,,,,6,1,7
HND-000313,2011,10400063,,,,5,2,7
HND-000317,2011,10400068,,,,5,2,7
HND-000318,2011,10400069,,,,3,4,7
,2011,10400083,,,,7,6,13
HND-000330,2011,10400088,,,,2,3,5
HND-000331,2011,10400089,,,,2,2,4
,2011,10400095,,,,1,1,2
HND-000335,2011,10400104,,,,1,4,5
HND-000336,2011,10400105,,,,3,3,6
HND-000337,2011,10400106,,,,2,2,4
HND-000338,2011,10400107,,,,0,1,1
HND-000339,2011,10400108,,,,2,5,7
HND-000341,2011,10400110,,,,4,0,4
,2011,10400144,,,,8,9,17
HND-000358,2011,10400155,,,,1,4,5
HND-000359,2011,10400156,,,,0,4,4
HND-000361,2011,10400160,,,,4,4,8
HND-000364,2011,10400174,,,,18,16,34
HND-000366,2011,10400184,,,,8,6,14
HND-000368,2011,10400189,,,,2,5,7
HND-000369,2011,10400190,,,,3,3,6
HND-000374,2011,10400215,,,,2,3,5
HND-000375,2011,10400216,,,,1,1,2
HND-000376,2011,10400217,,,,2,0,2
,2011,10400250,,,,1,4,5
HND-000255,2011,10400003,,,,2,4,6
HND-000257,2011,10400005,,,,7,4,11
HND-000258,2011,10400006,,,,2,2,4
HND-000260,2011,10400008,,,,12,7,19
HND-000262,2011,10400010,,,,17,19,36
HND-000264,2011,10400012,,,,3,3,6
HND-000266,2011,10400014,,,,8,7,15
HND-000271,2011,10400019,,,,9,3,12
HND-000272,2011,10400020,,,,6,3,9
HND-000273,2011,10400021,,,,6,5,11
HND-000274,2011,10400022,,,,6,6,12
HND-000275,2011,10400023,,,,19,18,37
HND-000280,2011,10400028,,,,1,4,5
HND-000281,2011,10400029,,,,6,3,9
HND-000286,2011,10400034,,,,9,8,17
HND-000287,2011,10400035,,,,14,6,20
HND-000288,2011,10400036,,,,3,5,8
HND-000289,2011,10400037,,,,3,6,9
HND-000296,2011,10400044,,,,6,8,14
HND-000297,2011,10400045,,,,4,4,8
HND-000298,2011,10400046,,,,1,1,2
HND-000299,2011,10400047,,,,1,3,4
HND-000300,2011,10400048,,,,5,1,6
HND-000302,2011,10400050,,,,3,2,5
HND-000303,2011,10400052,,,,8,8,16
HND-000304,2011,10400053,,,,3,4,7
HND-000309,2011,10400058,,,,9,11,20
HND-000310,2011,10400059,,,,8,3,11
HND-000314,2011,10400065,,,,10,10,20
HND-000315,2011,10400066,,,,17,18,35
HND-000316,2011,10400067,,,,26,25,51
HND-000333,2011,10400094,,,,4,2,6
HND-000334,2011,10400103,,,,1,2,3
HND-000340,2011,10400109,,,,2,2,4
HND-000342,2011,10400112,,,,7,3,10
HND-000360,2011,10400159,,,,1,0,1
HND-000367,2011,10400188,,,,10,3,13
HND-000370,2011,10400191,,,,4,1,5
HND-000377,2011,10400218,,,,1,2,3
,2011,10400236,,,,2,2,4
,2011,10400251,,,,5,5,10
HND-000254,2011,10400002,,,,4,6,10
HND-000255,2011,10400003,,,,7,2,9
HND-000256,2011,10400004,,,,3,3,6
HND-000261,2011,10400009,,,,3,4,7
HND-000265,2011,10400013,,,,30,32,62
HND-000266,2011,10400014,,,,5,8,13
HND-000267,2011,10400015,,,,9,4,13
HND-000268,2011,10400016,,,,17,12,29
HND-000269,2011,10400017,,,,8,11,19
HND-000274,2011,10400022,,,,3,4,7
HND-000275,2011,10400023,,,,15,22,37
HND-000276,2011,10400024,,,,4,6,10
HND-000279,2011,10400027,,,,6,5,11
HND-000281,2011,10400029,,,,9,6,15
HND-000284,2011,10400032,,,,10,7,17
HND-000286,2011,10400034,,,,13,6,19
HND-000289,2011,10400037,,,,8,10,18
HND-000291,2011,10400039,,,,2,2,4
HND-000292,2011,10400040,,,,6,9,15
HND-000294,2011,10400042,,,,1,3,4
HND-000295,2011,10400043,,,,3,3,6
HND-000296,2011,10400044,,,,8,5,13
HND-000301,2011,10400049,,,,1,1,2
HND-000306,2011,10400055,,,,3,0,3
HND-000307,2011,10400056,,,,8,3,11
HND-000308,2011,10400057,,,,5,4,9
HND-000309,2011,10400058,,,,6,8,14
HND-000314,2011,10400065,,,,8,7,15
HND-000315,2011,10400066,,,,14,24,38
HND-000316,2011,10400067,,,,34,30,64
HND-000317,2011,10400068,,,,7,1,8
,2011,10400083,,,,5,5,10
HND-000331,2011,10400089,,,,2,0,2
HND-000334,2011,10400103,,,,1,6,7
HND-000336,2011,10400105,,,,2,0,2
HND-000337,2011,10400106,,,,6,2,8
HND-000339,2011,10400108,,,,6,4,10
HND-000340,2011,10400109,,,,1,1,2
HND-000341,2011,10400110,,,,1,0,1
HND-000342,2011,10400112,,,,8,6,14
HND-000358,2011,10400155,,,,3,3,6
HND-000361,2011,10400160,,,,6,2,8
HND-000366,2011,10400184,,,,9,3,12
HND-000367,2011,10400188,,,,1,3,4
HND-000374,2011,10400215,,,,5,2,7
HND-000375,2011,10400216,,,,3,4,7
HND-000257,2011,10400005,,,,4,6,10
HND-000258,2011,10400006,,,,1,3,4
HND-000259,2011,10400007,,,,12,11,23
HND-000260,2011,10400008,,,,4,9,13
HND-000262,2011,10400010,,,,16,15,31
HND-000263,2011,10400011,,,,24,19,43
HND-000264,2011,10400012,,,,4,2,6
HND-000270,2011,10400018,,,,3,0,3
HND-000271,2011,10400019,,,,4,4,8
HND-000272,2011,10400020,,,,9,9,18
HND-000273,2011,10400021,,,,2,3,5
HND-000277,2011,10400025,,,,6,6,12
HND-000278,2011,10400026,,,,4,7,11
HND-000280,2011,10400028,,,,2,2,4
HND-000282,2011,10400030,,,,0,3,3
HND-000283,2011,10400031,,,,2,3,5
HND-000285,2011,10400033,,,,3,3,6
HND-000287,2011,10400035,,,,5,6,11
HND-000288,2011,10400036,,,,3,3,6
HND-000290,2011,10400038,,,,5,4,9
HND-000293,2011,10400041,,,,20,17,37
HND-000297,2011,10400045,,,,7,3,10
HND-000298,2011,10400046,,,,1,2,3
HND-000299,2011,10400047,,,,3,4,7
HND-000300,2011,10400048,,,,4,4,8
HND-000302,2011,10400050,,,,7,2,9
HND-000303,2011,10400052,,,,10,11,21
HND-000304,2011,10400053,,,,3,0,3
HND-000305,2011,10400054,,,,2,2,4
HND-000310,2011,10400059,,,,6,9,15
HND-000311,2011,10400060,,,,1,3,4
HND-000312,2011,10400062,,,,6,2,8
HND-000313,2011,10400063,,,,1,1,2
HND-000318,2011,10400069,,,,7,6,13
HND-000330,2011,10400088,,,,3,8,11
HND-000333,2011,10400094,,,,1,4,5
,2011,10400095,,,,0,1,1
HND-000335,2011,10400104,,,,1,0,1
HND-000338,2011,10400107,,,,1,3,4
,2011,10400144,,,,2,5,7
HND-000360,2011,10400159,,,,3,2,5
HND-000364,2011,10400174,,,,13,17,30
HND-000368,2011,10400189,,,,5,8,13
HND-000369,2011,10400190,,,,4,1,5
HND-000370,2011,10400191,,,,3,1,4
HND-000376,2011,10400217,,,,1,1,2
,2011,10400236,,,,2,2,4
,2011,10400251,,,,4,1,5
HND-000254,2011,10400002,,,,5,3,8
HND-000255,2011,10400003,,,,0,2,2
HND-000256,2011,10400004,,,,1,3,4
HND-000261,2011,10400009,,,,10,5,15
HND-000263,2011,10400011,,,,23,25,48
HND-000265,2011,10400013,,,,38,47,85
HND-000267,2011,10400015,,,,11,6,17
HND-000268,2011,10400016,,,,13,14,27
HND-000269,2011,10400017,,,,9,11,20
HND-000270,2011,10400018,,,,3,4,7
HND-000276,2011,10400024,,,,9,6,15
HND-000277,2011,10400025,,,,9,9,18
HND-000278,2011,10400026,,,,5,6,11
HND-000279,2011,10400027,,,,4,1,5
HND-000286,2011,10400034,,,,6,7,13
HND-000287,2011,10400035,,,,10,7,17
HND-000288,2011,10400036,,,,10,6,16
HND-000289,2011,10400037,,,,12,13,25
HND-000296,2011,10400044,,,,7,1,8
HND-000297,2011,10400045,,,,7,11,18
HND-000298,2011,10400046,,,,2,1,3
HND-000299,2011,10400047,,,,1,3,4
HND-000300,2011,10400048,,,,4,8,12
HND-000302,2011,10400050,,,,4,5,9
HND-000303,2011,10400052,,,,12,10,22
HND-000304,2011,10400053,,,,2,4,6
HND-000309,2011,10400058,,,,4,6,10
HND-000310,2011,10400059,,,,7,7,14
HND-000311,2011,10400060,,,,5,2,7
HND-000312,2011,10400062,,,,2,4,6
HND-000313,2011,10400063,,,,2,1,3
HND-000317,2011,10400068,,,,0,4,4
HND-000318,2011,10400069,,,,8,12,20
HND-000333,2011,10400094,,,,4,6,10
HND-000334,2011,10400103,,,,4,0,4
HND-000339,2011,10400108,,,,9,5,14
HND-000340,2011,10400109,,,,1,0,1
HND-000342,2011,10400112,,,,4,9,13
HND-000360,2011,10400159,,,,3,2,5
HND-000367,2011,10400188,,,,3,3,6
HND-000370,2011,10400191,,,,2,2,4
HND-000377,2011,10400218,,,,3,3,6
,2011,10400236,,,,0,1,1
,2011,10400251,,,,7,3,10
HND-000257,2011,10400005,,,,4,3,7
HND-000258,2011,10400006,,,,1,2,3
HND-000259,2011,10400007,,,,11,5,16
HND-000260,2011,10400008,,,,8,10,18
HND-000262,2011,10400010,,,,18,14,32
HND-000264,2011,10400012,,,,2,2,4
HND-000266,2011,10400014,,,,3,3,6
HND-000271,2011,10400019,,,,2,6,8
HND-000272,2011,10400020,,,,9,7,16
HND-000273,2011,10400021,,,,4,1,5
HND-000274,2011,10400022,,,,4,6,10
HND-000275,2011,10400023,,,,8,13,21
HND-000280,2011,10400028,,,,2,3,5
HND-000281,2011,10400029,,,,1,7,8
HND-000282,2011,10400030,,,,5,0,5
HND-000283,2011,10400031,,,,1,2,3
HND-000284,2011,10400032,,,,6,8,14
HND-000285,2011,10400033,,,,4,7,11
HND-000290,2011,10400038,,,,3,2,5
HND-000291,2011,10400039,,,,1,2,3
HND-000292,2011,10400040,,,,7,10,17
HND-000293,2011,10400041,,,,24,16,40
HND-000294,2011,10400042,,,,4,4,8
HND-000295,2011,10400043,,,,2,5,7
HND-000301,2011,10400049,,,,3,2,5
HND-000305,2011,10400054,,,,2,2,4
HND-000306,2011,10400055,,,,4,0,4
HND-000307,2011,10400056,,,,1,7,8
HND-000308,2011,10400057,,,,4,1,5
HND-000314,2011,10400065,,,,12,8,20
HND-000315,2011,10400066,,,,17,30,47
HND-000316,2011,10400067,,,,10,22,32
,2011,10400083,,,,1,3,4
HND-000330,2011,10400088,,,,2,1,3
HND-000331,2011,10400089,,,,2,2,4
,2011,10400095,,,,0,1,1
HND-000336,2011,10400105,,,,0,1,1
HND-000337,2011,10400106,,,,3,0,3
HND-000338,2011,10400107,,,,1,2,3
HND-000341,2011,10400110,,,,2,2,4
,2011,10400144,,,,4,7,11
HND-000358,2011,10400155,,,,2,0,2
HND-000359,2011,10400156,,,,4,0,4
HND-000361,2011,10400160,,,,2,2,4
HND-000364,2011,10400174,,,,16,13,29
HND-000366,2011,10400184,,,,4,9,13
HND-000368,2011,10400189,,,,1,2,3
HND-000369,2011,10400190,,,,2,0,2
HND-000374,2011,10400215,,,,2,2,4
HND-000375,2011,10400216,,,,2,0,2
HND-000376,2011,10400217,,,,8,1,9
HND-000254,2011,10400002,,,,4,5,9
HND-000255,2011,10400003,,,,2,2,4
HND-000260,2011,10400008,,,,4,11,15
HND-000261,2011,10400009,,,,9,3,12
HND-000264,2011,10400012,,,,2,2,4
HND-000266,2011,10400014,,,,4,14,18
HND-000267,2011,10400015,,,,7,4,11
HND-000268,2011,10400016,,,,18,5,23
HND-000269,2011,10400017,,,,13,12,25
HND-000272,2011,10400020,,,,8,9,17
HND-000274,2011,10400022,,,,6,5,11
HND-000275,2011,10400023,,,,14,18,32
HND-000276,2011,10400024,,,,1,5,6
HND-000281,2011,10400029,,,,8,3,11
HND-000282,2011,10400030,,,,1,0,1
HND-000284,2011,10400032,,,,5,5,10
HND-000285,2011,10400033,,,,6,4,10
HND-000286,2011,10400034,,,,8,5,13
HND-000291,2011,10400039,,,,0,2,2
HND-000292,2011,10400040,,,,4,2,6
HND-000294,2011,10400042,,,,1,1,2
HND-000295,2011,10400043,,,,1,0,1
HND-000296,2011,10400044,,,,9,4,13
HND-000301,2011,10400049,,,,3,1,4
HND-000306,2011,10400055,,,,3,5,8
HND-000307,2011,10400056,,,,5,4,9
HND-000308,2011,10400057,,,,6,3,9
HND-000309,2011,10400058,,,,4,5,9
HND-000314,2011,10400065,,,,8,2,10
HND-000315,2011,10400066,,,,16,21,37
HND-000316,2011,10400067,,,,19,22,41
HND-000317,2011,10400068,,,,5,3,8
,2011,10400083,,,,3,1,4
HND-000331,2011,10400089,,,,1,1,2
HND-000336,2011,10400105,,,,0,3,3
HND-000337,2011,10400106,,,,5,0,5
HND-000338,2011,10400107,,,,2,1,3
HND-000339,2011,10400108,,,,3,8,11
HND-000341,2011,10400110,,,,1,1,2
HND-000342,2011,10400112,,,,6,8,14
,2011,10400144,,,,3,4,7
HND-000358,2011,10400155,,,,2,3,5
HND-000359,2011,10400156,,,,1,2,3
HND-000361,2011,10400160,,,,0,3,3
HND-000364,2011,10400174,,,,20,18,38
HND-000366,2011,10400184,,,,8,7,15
HND-000374,2011,10400215,,,,4,0,4
HND-000375,2011,10400216,,,,4,2,6
HND-000376,2011,10400217,,,,0,2,2
HND-000377,2011,10400218,,,,3,1,4
HND-000256,2011,10400004,,,,1,1,2
HND-000257,2011,10400005,,,,6,5,11
HND-000258,2011,10400006,,,,2,2,4
HND-000259,2011,10400007,,,,5,12,17
HND-000262,2011,10400010,,,,28,16,44
HND-000263,2011,10400011,,,,14,12,26
HND-000265,2011,10400013,,,,45,40,85
HND-000270,2011,10400018,,,,4,5,9
HND-000271,2011,10400019,,,,6,3,9
HND-000273,2011,10400021,,,,3,0,3
HND-000277,2011,10400025,,,,7,12,19
HND-000278,2011,10400026,,,,1,2,3
HND-000279,2011,10400027,,,,7,6,13
HND-000280,2011,10400028,,,,2,1,3
HND-000283,2011,10400031,,,,3,2,5
HND-000287,2011,10400035,,,,7,6,13
HND-000288,2011,10400036,,,,2,12,14
HND-000289,2011,10400037,,,,6,4,10
HND-000290,2011,10400038,,,,1,2,3
HND-000293,2011,10400041,,,,19,19,38
HND-000297,2011,10400045,,,,5,5,10
HND-000298,2011,10400046,,,,0,2,2
HND-000299,2011,10400047,,,,4,4,8
HND-000300,2011,10400048,,,,3,4,7
HND-000302,2011,10400050,,,,4,1,5
HND-000303,2011,10400052,,,,9,7,16
HND-000304,2011,10400053,,,,1,3,4
HND-000305,2011,10400054,,,,4,6,10
HND-000310,2011,10400059,,,,5,4,9
HND-000311,2011,10400060,,,,1,4,5
HND-000312,2011,10400062,,,,1,0,1
HND-000313,2011,10400063,,,,4,5,9
HND-000318,2011,10400069,,,,11,4,15
HND-000330,2011,10400088,,,,1,6,7
HND-000333,2011,10400094,,,,3,0,3
HND-000335,2011,10400104,,,,0,3,3
HND-000340,2011,10400109,,,,1,1,2
HND-000360,2011,10400159,,,,1,3,4
HND-000367,2011,10400188,,,,5,2,7
HND-000368,2011,10400189,,,,1,1,2
HND-000369,2011,10400190,,,,3,0,3
HND-000370,2011,10400191,,,,3,0,3
,2011,10400236,,,,2,2,4
,2011,10400251,,,,4,2,6
HND-000255,2011,10400003,,,,0,3,3
HND-000260,2011,10400008,,,,11,7,18
HND-000261,2011,10400009,,,,5,7,12
HND-000264,2011,10400012,,,,4,0,4
HND-000266,2011,10400014,,,,6,9,15
HND-000269,2011,10400017,,,,9,3,12
HND-000271,2011,10400019,,,,3,8,11
HND-000272,2011,10400020,,,,9,6,15
HND-000273,2011,10400021,,,,0,1,1
HND-000274,2011,10400022,,,,6,4,10
HND-000275,2011,10400023,,,,6,15,21
HND-000281,2011,10400029,,,,0,3,3
HND-000282,2011,10400030,,,,0,2,2
HND-000283,2011,10400031,,,,0,2,2
HND-000284,2011,10400032,,,,3,6,9
HND-000285,2011,10400033,,,,3,2,5
HND-000291,2011,10400039,,,,3,1,4
HND-000292,2011,10400040,,,,9,5,14
HND-000293,2011,10400041,,,,11,9,20
HND-000294,2011,10400042,,,,1,2,3
HND-000295,2011,10400043,,,,1,5,6
HND-000301,2011,10400049,,,,2,1,3
HND-000305,2011,10400054,,,,2,1,3
HND-000306,2011,10400055,,,,3,3,6
HND-000307,2011,10400056,,,,5,6,11
HND-000308,2011,10400057,,,,3,3,6
HND-000314,2011,10400065,,,,6,12,18
HND-000315,2011,10400066,,,,15,13,28
HND-000316,2011,10400067,,,,27,17,44
,2011,10400083,,,,5,5,10
HND-000331,2011,10400089,,,,0,1,1
,2011,10400095,,,,1,1,2
HND-000336,2011,10400105,,,,1,6,7
HND-000337,2011,10400106,,,,3,0,3
HND-000338,2011,10400107,,,,3,1,4
HND-000339,2011,10400108,,,,0,3,3
HND-000341,2011,10400110,,,,1,0,1
HND-000342,2011,10400112,,,,7,5,12
HND-000360,2011,10400159,,,,2,6,8
HND-000361,2011,10400160,,,,1,2,3
HND-000367,2011,10400188,,,,6,3,9
HND-000369,2011,10400190,,,,5,1,6
HND-000370,2011,10400191,,,,1,1,2
HND-000254,2011,10400002,,,,4,5,9
HND-000256,2011,10400004,,,,0,2,2
HND-000257,2011,10400005,,,,3,6,9
HND-000258,2011,10400006,,,,2,0,2
HND-000259,2011,10400007,,,,8,10,18
HND-000262,2011,10400010,,,,14,17,31
HND-000263,2011,10400011,,,,24,20,44
HND-000265,2011,10400013,,,,50,42,92
HND-000267,2011,10400015,,,,15,9,24
HND-000268,2011,10400016,,,,12,9,21
HND-000270,2011,10400018,,,,1,2,3
HND-000276,2011,10400024,,,,5,3,8
HND-000277,2011,10400025,,,,8,10,18
HND-000278,2011,10400026,,,,7,4,11
HND-000279,2011,10400027,,,,6,3,9
HND-000280,2011,10400028,,,,5,2,7
HND-000286,2011,10400034,,,,6,10,16
HND-000287,2011,10400035,,,,2,11,13
HND-000288,2011,10400036,,,,5,5,10
HND-000289,2011,10400037,,,,17,7,24
HND-000290,2011,10400038,,,,2,3,5
HND-000296,2011,10400044,,,,7,1,8
HND-000297,2011,10400045,,,,7,2,9
HND-000298,2011,10400046,,,,2,4,6
HND-000300,2011,10400048,,,,6,5,11
HND-000302,2011,10400050,,,,3,1,4
HND-000303,2011,10400052,,,,10,11,21
HND-000309,2011,10400058,,,,8,6,14
HND-000310,2011,10400059,,,,2,6,8
HND-000311,2011,10400060,,,,2,1,3
HND-000312,2011,10400062,,,,4,4,8
HND-000313,2011,10400063,,,,5,3,8
HND-000317,2011,10400068,,,,6,1,7
HND-000318,2011,10400069,,,,4,7,11
HND-000330,2011,10400088,,,,2,0,2
HND-000333,2011,10400094,,,,4,4,8
HND-000334,2011,10400103,,,,2,0,2
HND-000335,2011,10400104,,,,4,0,4
HND-000340,2011,10400109,,,,0,1,1
,2011,10400144,,,,2,2,4
HND-000358,2011,10400155,,,,0,4,4
HND-000364,2011,10400174,,,,25,16,41
HND-000366,2011,10400184,,,,0,7,7
HND-000368,2011,10400189,,,,2,2,4
HND-000374,2011,10400215,,,,1,1,2
HND-000375,2011,10400216,,,,0,3,3
HND-000376,2011,10400217,,,,2,1,3
HND-000377,2011,10400218,,,,2,1,3
,2011,10400236,,,,3,1,4
,2011,10400251,,,,3,2,5
HND-000257,2011,10400005,,,,6,3,9
HND-000258,2011,10400006,,,,5,0,5
HND-000259,2011,10400007,,,,7,7,14
HND-000260,2011,10400008,,,,7,8,15
HND-000262,2011,10400010,,,,13,14,27
HND-000263,2011,10400011,,,,13,18,31
HND-000264,2011,10400012,,,,5,3,8
HND-000270,2011,10400018,,,,1,3,4
HND-000271,2011,10400019,,,,1,5,6
HND-000272,2011,10400020,,,,3,6,9
HND-000273,2011,10400021,,,,3,1,4
HND-000277,2011,10400025,,,,4,8,12
HND-000278,2011,10400026,,,,3,3,6
HND-000280,2011,10400028,,,,1,2,3
HND-000282,2011,10400030,,,,2,1,3
HND-000283,2011,10400031,,,,2,1,3
HND-000285,2011,10400033,,,,3,7,10
HND-000287,2011,10400035,,,,2,8,10
HND-000288,2011,10400036,,,,8,5,13
HND-000290,2011,10400038,,,,0,2,2
HND-000293,2011,10400041,,,,8,14,22
HND-000297,2011,10400045,,,,4,3,7
HND-000298,2011,10400046,,,,0,2,2
HND-000299,2011,10400047,,,,5,1,6
HND-000300,2011,10400048,,,,3,3,6
HND-000302,2011,10400050,,,,2,2,4
HND-000303,2011,10400052,,,,7,15,22
HND-000304,2011,10400053,,,,1,1,2
HND-000305,2011,10400054,,,,3,4,7
HND-000310,2011,10400059,,,,5,5,10
HND-000311,2011,10400060,,,,2,3,5
HND-000312,2011,10400062,,,,1,0,1
HND-000313,2011,10400063,,,,3,1,4
HND-000318,2011,10400069,,,,9,11,20
HND-000330,2011,10400088,,,,6,7,13
,2011,10400095,,,,3,3,6
HND-000338,2011,10400107,,,,2,2,4
HND-000358,2011,10400155,,,,4,3,7
HND-000359,2011,10400156,,,,0,2,2
HND-000366,2011,10400184,,,,4,9,13
HND-000367,2011,10400188,,,,3,3,6
HND-000375,2011,10400216,,,,0,2,2
HND-000377,2011,10400218,,,,0,1,1
,2011,10400236,,,,3,2,5
,2011,10400251,,,,2,2,4
HND-000254,2011,10400002,,,,2,6,8
HND-000255,2011,10400003,,,,1,2,3
HND-000256,2011,10400004,,,,1,2,3
HND-000261,2011,10400009,,,,4,4,8
HND-000265,2011,10400013,,,,32,36,68
HND-000266,2011,10400014,,,,8,4,12
HND-000267,2011,10400015,,,,5,14,19
HND-000268,2011,10400016,,,,13,9,22
HND-000269,2011,10400017,,,,8,13,21
HND-000274,2011,10400022,,,,3,6,9
HND-000275,2011,10400023,,,,7,9,16
HND-000276,2011,10400024,,,,5,1,6
HND-000279,2011,10400027,,,,4,2,6
HND-000281,2011,10400029,,,,8,3,11
HND-000284,2011,10400032,,,,3,3,6
HND-000286,2011,10400034,,,,6,5,11
HND-000289,2011,10400037,,,,12,9,21
HND-000291,2011,10400039,,,,0,2,2
HND-000292,2011,10400040,,,,6,2,8
HND-000294,2011,10400042,,,,2,4,6
HND-000295,2011,10400043,,,,4,2,6
HND-000296,2011,10400044,,,,2,1,3
HND-000301,2011,10400049,,,,2,2,4
HND-000306,2011,10400055,,,,3,0,3
HND-000307,2011,10400056,,,,3,6,9
HND-000308,2011,10400057,,,,3,3,6
HND-000309,2011,10400058,,,,5,8,13
HND-000314,2011,10400065,,,,2,5,7
HND-000315,2011,10400066,,,,13,13,26
HND-000316,2011,10400067,,,,11,13,24
HND-000317,2011,10400068,,,,0,5,5
,2011,10400083,,,,3,3,6
HND-000334,2011,10400103,,,,1,0,1
HND-000336,2011,10400105,,,,0,2,2
HND-000337,2011,10400106,,,,3,1,4
HND-000339,2011,10400108,,,,1,2,3
HND-000340,2011,10400109,,,,1,1,2
HND-000341,2011,10400110,,,,1,2,3
HND-000342,2011,10400112,,,,5,3,8
,2011,10400144,,,,4,9,13
HND-000360,2011,10400159,,,,1,2,3
HND-000361,2011,10400160,,,,0,3,3
HND-000364,2011,10400174,,,,16,12,28
HND-000368,2011,10400189,,,,0,2,2
HND-000369,2011,10400190,,,,1,0,1
HND-000376,2011,10400217,,,,1,1,2
HND-000260,2011,10400008,,,,21,16,37
HND-000262,2011,10400010,,,,16,22,38
HND-000293,2011,10400041,,,,23,33,56
HND-000316,2011,10400067,,,,26,17,43
,2011,10400001,,,,137,129,266
HND-000263,2011,10400011,,,,15,19,34
HND-000267,2011,10400015,,,,25,32,57
HND-000268,2011,10400016,,,,6,15,21
HND-000318,2011,10400069,,,,15,5,20
HND-000267,2011,10400015,,,,15,17,32
HND-000268,2011,10400016,,,,9,7,16
HND-000316,2011,10400067,,,,18,10,28
,2011,10400001,,,,107,113,220
HND-000260,2011,10400008,,,,15,16,31
HND-000262,2011,10400010,,,,14,8,22
HND-000263,2011,10400011,,,,8,10,18
HND-000293,2011,10400041,,,,18,30,48
HND-000318,2011,10400069,,,,6,10,16
HND-000260,2011,10400008,,,,4,10,14
HND-000267,2011,10400015,,,,10,12,22
HND-000268,2011,10400016,,,,12,8,20
HND-000316,2011,10400067,,,,10,14,24
,2011,10400001,,,,99,87,186
HND-000262,2011,10400010,,,,11,11,22
HND-000263,2011,10400011,,,,8,12,20
HND-000293,2011,10400041,,,,28,13,41
HND-000318,2011,10400069,,,,5,8,13
,2011,10400001,,,,203,254,457
HND-000260,2011,10400008,,,,14,10,24
HND-000260,2011,10400008,,,,9,16,25
,2011,10400001,,,,116,166,282
HND-000260,2011,10400008,,,,4,10,14
,2011,10400001,,,,91,138,229
HND-000466,2011,10500136,,,,3,3,6
,2011,10500139,,,,4,4,8
HND-000470,2011,10500148,,,,3,13,16
,2011,10500149,,,,1,4,5
,2011,10500151,,,,4,4,8
HND-000453,2011,10500097,,,,1,3,4
HND-000461,2011,10500128,,,,2,3,5
HND-000465,2011,10500134,,,,4,3,7
,2011,10500137,,,,3,4,7
,2011,10500145,,,,3,2,5
,2011,10500146,,,,4,2,6
,2011,10500147,,,,1,4,5
HND-000471,2011,10500150,,,,6,6,12
HND-000472,2011,10500152,,,,4,3,7
,2011,10500153,,,,4,4,8
HND-000436,2011,10500059,,,,8,3,11
HND-000441,2011,10500073,,,,2,1,3
HND-000448,2011,10500090,,,,0,3,3
HND-000457,2011,10500121,,,,1,0,1
HND-000464,2011,10500132,,,,0,1,1
,2011,10500060,,,,1,0,1
HND-000444,2011,10500078,,,,0,3,3
HND-000385,2011,10500001,,,,2,4,6
HND-000425,2011,10500045,,,,15,8,23
HND-000426,2011,10500046,,,,1,2,3
HND-000428,2011,10500048,,,,5,7,12
,2011,10500051,,,,4,2,6
HND-000432,2011,10500055,,,,7,3,10
,2011,10500060,,,,4,7,11
,2011,10500063,,,,4,3,7
HND-000440,2011,10500072,,,,5,5,10
,2011,10500074,,,,1,1,2
,2011,10500077,,,,4,4,8
HND-000448,2011,10500090,,,,4,7,11
HND-000458,2011,10500122,,,,1,1,2
,2011,10500124,,,,4,2,6
,2011,10500125,,,,2,5,7
HND-000462,2011,10500129,,,,6,5,11
HND-000463,2011,10500130,,,,4,4,8
HND-000464,2011,10500132,,,,3,1,4
HND-000424,2011,10500044,,,,0,2,2
HND-000427,2011,10500047,,,,7,3,10
HND-000429,2011,10500049,,,,3,2,5
HND-000430,2011,10500050,,,,0,4,4
HND-000431,2011,10500052,,,,1,4,5
,2011,10500053,,,,3,1,4
HND-000436,2011,10500059,,,,6,7,13
,2011,10500071,,,,3,7,10
HND-000441,2011,10500073,,,,2,2,4
HND-000442,2011,10500075,,,,2,6,8
HND-000443,2011,10500076,,,,2,2,4
HND-000444,2011,10500078,,,,3,3,6
HND-000451,2011,10500095,,,,6,5,11
HND-000457,2011,10500121,,,,2,4,6
HND-000459,2011,10500123,,,,2,3,5
HND-000460,2011,10500126,,,,8,3,11
,2011,10500141,,,,15,8,23
HND-000427,2011,10500047,,,,10,11,21
HND-000428,2011,10500048,,,,11,13,24
HND-000429,2011,10500049,,,,4,2,6
HND-000430,2011,10500050,,,,5,6,11
,2011,10500051,,,,4,6,10
HND-000431,2011,10500052,,,,6,6,12
,2011,10500053,,,,7,6,13
HND-000436,2011,10500059,,,,11,12,23
,2011,10500071,,,,7,4,11
HND-000442,2011,10500075,,,,10,5,15
HND-000443,2011,10500076,,,,7,5,12
,2011,10500077,,,,2,4,6
HND-000444,2011,10500078,,,,3,3,6
HND-000451,2011,10500095,,,,7,2,9
HND-000458,2011,10500122,,,,11,6,17
HND-000459,2011,10500123,,,,4,5,9
,2011,10500125,,,,4,3,7
HND-000460,2011,10500126,,,,1,3,4
HND-000462,2011,10500129,,,,4,1,5
,2011,10500141,,,,7,6,13
HND-000385,2011,10500001,,,,4,7,11
HND-000423,2011,10500043,,,,32,22,54
HND-000424,2011,10500044,,,,10,9,19
HND-000425,2011,10500045,,,,21,12,33
HND-000426,2011,10500046,,,,5,8,13
HND-000432,2011,10500055,,,,10,6,16
,2011,10500060,,,,7,9,16
HND-000440,2011,10500072,,,,3,2,5
HND-000441,2011,10500073,,,,4,6,10
,2011,10500074,,,,4,3,7
HND-000448,2011,10500090,,,,1,0,1
HND-000457,2011,10500121,,,,6,3,9
,2011,10500124,,,,12,12,24
HND-000463,2011,10500130,,,,2,6,8
HND-000464,2011,10500132,,,,6,1,7
HND-000387,2011,10500003,,,,43,36,79
HND-000389,2011,10500005,,,,2,0,2
HND-000390,2011,10500006,,,,9,5,14
HND-000391,2011,10500007,,,,4,1,5
HND-000392,2011,10500008,,,,8,5,13
HND-000394,2011,10500010,,,,7,7,14
HND-000395,2011,10500013,,,,8,8,16
HND-000400,2011,10500018,,,,5,1,6
HND-000401,2011,10500019,,,,12,12,24
HND-000403,2011,10500022,,,,8,4,12
HND-000404,2011,10500023,,,,34,30,64
HND-000405,2011,10500024,,,,21,13,34
HND-000410,2011,10500029,,,,3,1,4
HND-000415,2011,10500034,,,,14,12,26
,2011,10500036,,,,7,9,16
HND-000418,2011,10500037,,,,1,1,2
HND-000421,2011,10500041,,,,2,1,3
HND-000432,2011,10500055,,,,16,19,35
HND-000438,2011,10500064,,,,11,13,24
HND-000439,2011,10500065,,,,4,3,7
,2011,10500074,,,,6,0,6
HND-000446,2011,10500083,,,,2,4,6
,2011,10500085,,,,6,3,9
,2011,10500093,,,,1,0,1
HND-000450,2011,10500094,,,,5,3,8
HND-000456,2011,10500118,,,,11,9,20
HND-000468,2011,10500143,,,,53,41,94
HND-000469,2011,10500144,,,,1,1,2
,2011,10500155,,,,5,6,11
,2011,10500002,,,,1,4,5
HND-000388,2011,10500004,,,,6,7,13
HND-000393,2011,10500009,,,,14,7,21
HND-000396,2011,10500014,,,,5,9,14
HND-000397,2011,10500015,,,,12,16,28
HND-000398,2011,10500016,,,,7,5,12
HND-000399,2011,10500017,,,,14,11,25
HND-000402,2011,10500021,,,,10,7,17
HND-000406,2011,10500025,,,,4,5,9
HND-000407,2011,10500026,,,,1,1,2
HND-000408,2011,10500027,,,,6,5,11
HND-000409,2011,10500028,,,,2,0,2
HND-000411,2011,10500030,,,,2,0,2
HND-000412,2011,10500031,,,,2,3,5
HND-000413,2011,10500032,,,,2,2,4
HND-000414,2011,10500033,,,,6,6,12
HND-000416,2011,10500035,,,,26,23,49
HND-000419,2011,10500038,,,,1,0,1
HND-000420,2011,10500040,,,,0,3,3
HND-000422,2011,10500042,,,,6,4,10
HND-000437,2011,10500061,,,,8,4,12
,2011,10500062,,,,3,9,12
,2011,10500063,,,,4,5,9
HND-000445,2011,10500080,,,,17,21,38
HND-000452,2011,10500096,,,,1,1,2
HND-000454,2011,10500116,,,,19,15,34
HND-000455,2011,10500117,,,,4,6,10
,2011,10500131,,,,9,9,18
,2011,10500141,,,,10,13,23
HND-000467,2011,10500142,,,,0,2,2
HND-000387,2011,10500003,,,,29,23,52
HND-000388,2011,10500004,,,,2,5,7
HND-000389,2011,10500005,,,,2,0,2
HND-000390,2011,10500006,,,,2,4,6
HND-000391,2011,10500007,,,,1,3,4
HND-000397,2011,10500015,,,,19,8,27
HND-000398,2011,10500016,,,,9,8,17
HND-000399,2011,10500017,,,,10,13,23
HND-000400,2011,10500018,,,,3,1,4
HND-000402,2011,10500021,,,,10,11,21
HND-000403,2011,10500022,,,,16,7,23
HND-000404,2011,10500023,,,,22,29,51
HND-000409,2011,10500028,,,,5,3,8
HND-000410,2011,10500029,,,,3,1,4
HND-000411,2011,10500030,,,,3,1,4
HND-000412,2011,10500031,,,,5,5,10
HND-000414,2011,10500033,,,,4,9,13
,2011,10500036,,,,4,2,6
HND-000419,2011,10500038,,,,2,1,3
HND-000420,2011,10500040,,,,3,2,5
HND-000421,2011,10500041,,,,1,1,2
HND-000422,2011,10500042,,,,9,3,12
HND-000438,2011,10500064,,,,10,10,20
HND-000445,2011,10500080,,,,27,17,44
,2011,10500085,,,,2,3,5
HND-000450,2011,10500094,,,,4,1,5
HND-000452,2011,10500096,,,,7,3,10
HND-000454,2011,10500116,,,,7,10,17
HND-000456,2011,10500118,,,,3,5,8
,2011,10500141,,,,4,6,10
HND-000469,2011,10500144,,,,0,2,2
,2011,10500002,,,,2,4,6
HND-000392,2011,10500008,,,,4,6,10
HND-000393,2011,10500009,,,,9,9,18
HND-000394,2011,10500010,,,,3,5,8
HND-000395,2011,10500013,,,,10,7,17
HND-000396,2011,10500014,,,,5,5,10
HND-000401,2011,10500019,,,,5,13,18
HND-000405,2011,10500024,,,,30,15,45
HND-000406,2011,10500025,,,,2,6,8
HND-000407,2011,10500026,,,,2,2,4
HND-000408,2011,10500027,,,,6,3,9
HND-000413,2011,10500032,,,,2,3,5
HND-000415,2011,10500034,,,,15,13,28
HND-000416,2011,10500035,,,,48,23,71
HND-000418,2011,10500037,,,,0,1,1
HND-000432,2011,10500055,,,,18,18,36
HND-000437,2011,10500061,,,,2,4,6
,2011,10500062,,,,3,5,8
,2011,10500063,,,,5,4,9
HND-000439,2011,10500065,,,,6,4,10
,2011,10500074,,,,3,2,5
HND-000446,2011,10500083,,,,3,8,11
,2011,10500093,,,,2,0,2
HND-000455,2011,10500117,,,,4,2,6
,2011,10500131,,,,13,21,34
HND-000468,2011,10500143,,,,40,50,90
HND-000387,2011,10500003,,,,33,36,69
HND-000389,2011,10500005,,,,2,2,4
HND-000390,2011,10500006,,,,4,1,5
HND-000391,2011,10500007,,,,3,1,4
HND-000392,2011,10500008,,,,8,6,14
HND-000394,2011,10500010,,,,3,6,9
HND-000395,2011,10500013,,,,13,4,17
HND-000400,2011,10500018,,,,3,4,7
HND-000401,2011,10500019,,,,13,6,19
HND-000403,2011,10500022,,,,6,9,15
HND-000404,2011,10500023,,,,37,29,66
HND-000405,2011,10500024,,,,13,17,30
HND-000410,2011,10500029,,,,2,0,2
HND-000411,2011,10500030,,,,3,6,9
HND-000413,2011,10500032,,,,0,1,1
HND-000414,2011,10500033,,,,3,5,8
HND-000416,2011,10500035,,,,33,26,59
HND-000419,2011,10500038,,,,5,0,5
HND-000420,2011,10500040,,,,2,3,5
HND-000422,2011,10500042,,,,10,3,13
HND-000438,2011,10500064,,,,6,10,16
HND-000439,2011,10500065,,,,6,3,9
HND-000445,2011,10500080,,,,21,11,32
HND-000452,2011,10500096,,,,5,3,8
HND-000456,2011,10500118,,,,5,10,15
,2011,10500131,,,,13,18,31
,2011,10500141,,,,5,8,13
HND-000467,2011,10500142,,,,2,3,5
,2011,10500002,,,,0,1,1
HND-000388,2011,10500004,,,,6,9,15
HND-000393,2011,10500009,,,,12,9,21
HND-000396,2011,10500014,,,,4,5,9
HND-000397,2011,10500015,,,,8,13,21
HND-000398,2011,10500016,,,,6,6,12
HND-000399,2011,10500017,,,,23,12,35
HND-000402,2011,10500021,,,,12,4,16
HND-000406,2011,10500025,,,,2,3,5
HND-000407,2011,10500026,,,,0,3,3
HND-000408,2011,10500027,,,,6,5,11
HND-000409,2011,10500028,,,,2,5,7
HND-000415,2011,10500034,,,,15,11,26
,2011,10500036,,,,2,1,3
HND-000418,2011,10500037,,,,1,3,4
HND-000421,2011,10500041,,,,2,1,3
HND-000432,2011,10500055,,,,7,14,21
HND-000437,2011,10500061,,,,3,2,5
,2011,10500062,,,,7,10,17
,2011,10500063,,,,6,5,11
,2011,10500074,,,,2,2,4
HND-000446,2011,10500083,,,,5,4,9
,2011,10500085,,,,3,0,3
,2011,10500093,,,,2,2,4
HND-000450,2011,10500094,,,,1,1,2
HND-000454,2011,10500116,,,,3,7,10
HND-000455,2011,10500117,,,,3,1,4
HND-000468,2011,10500143,,,,45,48,93
HND-000469,2011,10500144,,,,2,2,4
,2011,10500002,,,,2,3,5
HND-000388,2011,10500004,,,,6,3,9
HND-000391,2011,10500007,,,,3,2,5
HND-000393,2011,10500009,,,,6,6,12
HND-000397,2011,10500015,,,,15,14,29
HND-000398,2011,10500016,,,,5,7,12
HND-000399,2011,10500017,,,,15,9,24
HND-000400,2011,10500018,,,,1,2,3
HND-000402,2011,10500021,,,,6,15,21
HND-000403,2011,10500022,,,,6,5,11
HND-000404,2011,10500023,,,,38,30,68
HND-000409,2011,10500028,,,,0,8,8
HND-000410,2011,10500029,,,,0,1,1
HND-000412,2011,10500031,,,,1,1,2
,2011,10500036,,,,3,0,3
HND-000418,2011,10500037,,,,2,1,3
HND-000419,2011,10500038,,,,4,0,4
HND-000420,2011,10500040,,,,0,1,1
HND-000421,2011,10500041,,,,3,0,3
HND-000438,2011,10500064,,,,5,4,9
,2011,10500074,,,,4,2,6
,2011,10500085,,,,4,1,5
HND-000450,2011,10500094,,,,0,1,1
HND-000452,2011,10500096,,,,3,4,7
HND-000454,2011,10500116,,,,10,6,16
HND-000455,2011,10500117,,,,1,3,4
HND-000456,2011,10500118,,,,3,6,9
,2011,10500141,,,,9,7,16
HND-000469,2011,10500144,,,,1,3,4
HND-000387,2011,10500003,,,,38,32,70
HND-000389,2011,10500005,,,,3,0,3
HND-000390,2011,10500006,,,,10,3,13
HND-000392,2011,10500008,,,,6,10,16
HND-000394,2011,10500010,,,,6,6,12
HND-000395,2011,10500013,,,,5,7,12
HND-000396,2011,10500014,,,,6,6,12
HND-000401,2011,10500019,,,,9,11,20
HND-000405,2011,10500024,,,,18,20,38
HND-000406,2011,10500025,,,,3,8,11
HND-000407,2011,10500026,,,,1,2,3
HND-000408,2011,10500027,,,,5,0,5
HND-000411,2011,10500030,,,,1,0,1
HND-000413,2011,10500032,,,,6,1,7
HND-000414,2011,10500033,,,,5,7,12
HND-000415,2011,10500034,,,,10,13,23
HND-000416,2011,10500035,,,,35,26,61
HND-000422,2011,10500042,,,,5,1,6
HND-000432,2011,10500055,,,,21,7,28
HND-000437,2011,10500061,,,,1,2,3
,2011,10500062,,,,5,4,9
,2011,10500063,,,,1,3,4
HND-000439,2011,10500065,,,,5,5,10
HND-000445,2011,10500080,,,,16,10,26
HND-000446,2011,10500083,,,,5,8,13
,2011,10500093,,,,1,1,2
,2011,10500131,,,,10,21,31
HND-000467,2011,10500142,,,,1,2,3
HND-000468,2011,10500143,,,,49,50,99
,2011,10500002,,,,2,1,3
HND-000388,2011,10500004,,,,3,9,12
HND-000393,2011,10500009,,,,5,4,9
HND-000396,2011,10500014,,,,2,4,6
HND-000397,2011,10500015,,,,15,11,26
HND-000398,2011,10500016,,,,11,7,18
HND-000399,2011,10500017,,,,13,16,29
HND-000402,2011,10500021,,,,4,7,11
HND-000404,2011,10500023,,,,40,39,79
HND-000406,2011,10500025,,,,3,0,3
HND-000407,2011,10500026,,,,3,1,4
HND-000409,2011,10500028,,,,2,3,5
HND-000418,2011,10500037,,,,3,1,4
HND-000419,2011,10500038,,,,0,1,1
HND-000420,2011,10500040,,,,5,2,7
HND-000421,2011,10500041,,,,0,2,2
HND-000437,2011,10500061,,,,7,2,9
,2011,10500062,,,,3,9,12
,2011,10500074,,,,1,3,4
HND-000446,2011,10500083,,,,5,6,11
HND-000450,2011,10500094,,,,4,2,6
HND-000454,2011,10500116,,,,3,7,10
HND-000455,2011,10500117,,,,2,1,3
HND-000456,2011,10500118,,,,3,4,7
HND-000469,2011,10500144,,,,1,0,1
HND-000387,2011,10500003,,,,38,33,71
HND-000389,2011,10500005,,,,3,1,4
HND-000390,2011,10500006,,,,3,4,7
HND-000391,2011,10500007,,,,1,1,2
HND-000392,2011,10500008,,,,5,3,8
HND-000394,2011,10500010,,,,6,6,12
HND-000395,2011,10500013,,,,6,5,11
HND-000400,2011,10500018,,,,3,2,5
HND-000401,2011,10500019,,,,14,11,25
HND-000403,2011,10500022,,,,4,8,12
HND-000405,2011,10500024,,,,13,12,25
HND-000408,2011,10500027,,,,0,2,2
HND-000410,2011,10500029,,,,3,0,3
HND-000411,2011,10500030,,,,0,1,1
HND-000413,2011,10500032,,,,1,2,3
HND-000414,2011,10500033,,,,5,4,9
HND-000415,2011,10500034,,,,8,9,17
HND-000416,2011,10500035,,,,27,26,53
HND-000422,2011,10500042,,,,5,5,10
HND-000432,2011,10500055,,,,17,15,32
,2011,10500063,,,,2,4,6
HND-000438,2011,10500064,,,,14,9,23
HND-000439,2011,10500065,,,,2,4,6
HND-000445,2011,10500080,,,,5,16,21
HND-000452,2011,10500096,,,,8,2,10
,2011,10500131,,,,15,9,24
HND-000467,2011,10500142,,,,2,0,2
HND-000468,2011,10500143,,,,48,57,105
,2011,10500002,,,,1,1,2
HND-000392,2011,10500008,,,,3,4,7
HND-000393,2011,10500009,,,,10,5,15
HND-000395,2011,10500013,,,,2,9,11
HND-000396,2011,10500014,,,,7,1,8
HND-000401,2011,10500019,,,,10,10,20
HND-000405,2011,10500024,,,,18,17,35
HND-000406,2011,10500025,,,,3,6,9
HND-000407,2011,10500026,,,,1,0,1
HND-000408,2011,10500027,,,,3,5,8
HND-000413,2011,10500032,,,,4,0,4
HND-000415,2011,10500034,,,,10,3,13
HND-000416,2011,10500035,,,,37,28,65
HND-000418,2011,10500037,,,,2,1,3
HND-000432,2011,10500055,,,,14,18,32
HND-000437,2011,10500061,,,,3,1,4
,2011,10500062,,,,4,3,7
,2011,10500063,,,,4,3,7
HND-000439,2011,10500065,,,,3,1,4
,2011,10500074,,,,2,8,10
HND-000446,2011,10500083,,,,6,4,10
HND-000455,2011,10500117,,,,0,2,2
,2011,10500131,,,,8,11,19
HND-000467,2011,10500142,,,,0,4,4
HND-000468,2011,10500143,,,,56,61,117
HND-000387,2011,10500003,,,,29,38,67
HND-000388,2011,10500004,,,,5,4,9
HND-000389,2011,10500005,,,,2,0,2
HND-000390,2011,10500006,,,,4,3,7
HND-000394,2011,10500010,,,,2,1,3
HND-000397,2011,10500015,,,,9,13,22
HND-000398,2011,10500016,,,,5,9,14
HND-000399,2011,10500017,,,,12,9,21
HND-000400,2011,10500018,,,,1,0,1
HND-000402,2011,10500021,,,,4,2,6
HND-000403,2011,10500022,,,,0,6,6
HND-000404,2011,10500023,,,,40,40,80
HND-000409,2011,10500028,,,,2,3,5
HND-000410,2011,10500029,,,,0,1,1
HND-000411,2011,10500030,,,,2,4,6
HND-000412,2011,10500031,,,,0,2,2
HND-000414,2011,10500033,,,,2,2,4
HND-000419,2011,10500038,,,,0,1,1
HND-000420,2011,10500040,,,,6,2,8
HND-000421,2011,10500041,,,,2,1,3
HND-000422,2011,10500042,,,,5,9,14
HND-000438,2011,10500064,,,,6,2,8
HND-000445,2011,10500080,,,,8,10,18
,2011,10500085,,,,0,2,2
HND-000450,2011,10500094,,,,1,1,2
HND-000452,2011,10500096,,,,0,2,2
HND-000454,2011,10500116,,,,2,4,6
HND-000456,2011,10500118,,,,8,7,15
HND-000469,2011,10500144,,,,2,0,2
HND-000397,2011,10500015,,,,11,12,23
HND-000433,2011,10500056,,,,88,71,159
,2011,10500119,,,,9,2,11
,2011,10500131,,,,17,17,34
,2011,10500154,,,,5,3,8
HND-000395,2011,10500013,,,,22,21,43
HND-000434,2011,10500057,,,,46,52,98
HND-000435,2011,10500058,,,,182,199,381
,2011,10500074,,,,2,1,3
,2011,10500098,,,,1,2,3
HND-000397,2011,10500015,,,,5,8,13
HND-000435,2011,10500058,,,,164,178,342
,2011,10500062,,,,1,1,2
,2011,10500074,,,,0,2,2
HND-000395,2011,10500013,,,,28,19,47
HND-000433,2011,10500056,,,,67,77,144
HND-000434,2011,10500057,,,,49,35,84
,2011,10500098,,,,3,6,9
,2011,10500119,,,,2,3,5
,2011,10500131,,,,13,16,29
,2011,10500154,,,,3,6,9
HND-000397,2011,10500015,,,,5,7,12
HND-000434,2011,10500057,,,,58,48,106
HND-000435,2011,10500058,,,,135,173,308
,2011,10500074,,,,5,6,11
,2011,10500098,,,,1,1,2
,2011,10500119,,,,2,2,4
HND-000395,2011,10500013,,,,23,18,41
HND-000433,2011,10500056,,,,74,72,146
,2011,10500062,,,,1,2,3
,2011,10500154,,,,1,0,1
HND-000435,2011,10500058,,,,111,148,259
HND-000397,2011,10500015,,,,9,8,17
HND-000433,2011,10500056,,,,76,106,182
HND-000434,2011,10500057,,,,31,45,76
,2011,10500098,,,,1,5,6
,2011,10500119,,,,11,28,39
HND-000397,2011,10500015,,,,6,4,10
HND-000433,2011,10500056,,,,59,54,113
HND-000435,2011,10500058,,,,94,127,221
HND-000434,2011,10500057,,,,27,28,55
,2011,10500098,,,,5,3,8
HND-000397,2011,10500015,,,,1,6,7
HND-000433,2011,10500056,,,,53,63,116
HND-000434,2011,10500057,,,,21,31,52
HND-000435,2011,10500058,,,,95,83,178
,2011,10600025,,,,2,5,7
,2011,10600037,,,,2,3,5
,2011,10600039,,,,3,4,7
HND-000495,2011,10600044,,,,6,7,13
,2011,10600024,,,,10,5,15
,2011,10600036,,,,5,4,9
,2011,10600038,,,,3,5,8
HND-000493,2011,10600040,,,,4,1,5
,2011,10600041,,,,4,4,8
HND-000494,2011,10600042,,,,6,5,11
,2011,10600043,,,,2,5,7
HND-000486,2011,10600013,,,,13,3,16
HND-000475,2011,10600002,,,,2,1,3
HND-000486,2011,10600013,,,,6,5,11
HND-000475,2011,10600002,,,,0,3,3
,2011,10600015,,,,14,12,26
,2011,10600018,,,,9,14,23
,2011,10600015,,,,31,29,60
,2011,10600018,,,,12,13,25
HND-000475,2011,10600002,,,,8,3,11
HND-000486,2011,10600013,,,,9,10,19
,2011,10600014,,,,41,31,72
,2011,10600019,,,,10,10,20
,2011,10600004,,,,4,4,8
HND-000478,2011,10600005,,,,15,9,24
HND-000479,2011,10600006,,,,5,6,11
HND-000480,2011,10600007,,,,9,9,18
,2011,10600012,,,,1,3,4
,2011,10600001,,,,51,26,77
HND-000475,2011,10600002,,,,37,39,76
,2011,10600003,,,,4,9,13
,2011,10600008,,,,1,3,4
,2011,10600009,,,,3,6,9
HND-000483,2011,10600010,,,,8,10,18
,2011,10600011,,,,8,2,10
HND-000486,2011,10600013,,,,58,61,119
,2011,10600001,,,,34,35,69
HND-000475,2011,10600002,,,,42,46,88
HND-000478,2011,10600005,,,,12,2,14
HND-000479,2011,10600006,,,,12,1,13
,2011,10600008,,,,3,3,6
,2011,10600011,,,,5,3,8
,2011,10600003,,,,11,6,17
,2011,10600004,,,,5,4,9
HND-000480,2011,10600007,,,,6,12,18
,2011,10600009,,,,2,3,5
HND-000483,2011,10600010,,,,6,6,12
,2011,10600012,,,,2,4,6
HND-000486,2011,10600013,,,,66,41,107
,2011,10600001,,,,39,29,68
HND-000475,2011,10600002,,,,45,52,97
,2011,10600003,,,,6,11,17
,2011,10600008,,,,4,2,6
,2011,10600009,,,,5,1,6
HND-000483,2011,10600010,,,,4,6,10
,2011,10600011,,,,10,2,12
HND-000486,2011,10600013,,,,68,51,119
,2011,10600004,,,,4,5,9
HND-000478,2011,10600005,,,,8,9,17
HND-000479,2011,10600006,,,,1,4,5
HND-000480,2011,10600007,,,,5,2,7
,2011,10600012,,,,2,4,6
,2011,10600001,,,,34,26,60
HND-000475,2011,10600002,,,,66,52,118
HND-000478,2011,10600005,,,,9,7,16
HND-000479,2011,10600006,,,,7,7,14
HND-000480,2011,10600007,,,,3,1,4
,2011,10600008,,,,5,2,7
,2011,10600003,,,,6,12,18
,2011,10600004,,,,0,3,3
,2011,10600009,,,,2,1,3
HND-000483,2011,10600010,,,,5,6,11
,2011,10600011,,,,2,3,5
,2011,10600012,,,,3,3,6
HND-000486,2011,10600013,,,,53,48,101
HND-000475,2011,10600002,,,,50,48,98
,2011,10600004,,,,2,3,5
HND-000478,2011,10600005,,,,8,12,20
HND-000479,2011,10600006,,,,4,2,6
HND-000480,2011,10600007,,,,3,3,6
,2011,10600008,,,,2,1,3
,2011,10600001,,,,31,30,61
,2011,10600003,,,,3,5,8
,2011,10600009,,,,4,0,4
HND-000483,2011,10600010,,,,6,7,13
,2011,10600011,,,,1,6,7
,2011,10600012,,,,9,5,14
HND-000486,2011,10600013,,,,74,46,120
,2011,10600003,,,,8,4,12
,2011,10600004,,,,6,4,10
HND-000480,2011,10600007,,,,4,5,9
,2011,10600009,,,,4,2,6
HND-000483,2011,10600010,,,,6,12,18
,2011,10600012,,,,6,3,9
HND-000486,2011,10600013,,,,61,59,120
,2011,10600001,,,,24,22,46
HND-000475,2011,10600002,,,,66,51,117
HND-000478,2011,10600005,,,,8,6,14
HND-000479,2011,10600006,,,,5,5,10
,2011,10600008,,,,2,2,4
,2011,10600011,,,,3,4,7
HND-000490,2011,10600020,,,,73,61,134
,2011,10600022,,,,86,83,169
,2011,10600022,,,,80,80,160
HND-000490,2011,10600020,,,,50,52,102
HND-000490,2011,10600020,,,,34,40,74
,2011,10600022,,,,68,60,128
,2011,10600022,,,,34,39,73
HND-000490,2011,10600020,,,,27,36,63
,2011,10600021,,,,74,4,78
,2011,10600021,,,,77,2,79
,2011,10600022,,,,15,25,40
HND-000490,2011,10600020,,,,17,36,53
HND-000490,2011,10600020,,,,33,30,63
,2011,10600021,,,,52,3,55
,2011,10600022,,,,11,19,30
HND-000509,2011,10700016,,,,5,6,11
HND-000522,2011,10700029,,,,6,5,11
HND-000524,2011,10700031,,,,7,10,17
HND-000529,2011,10700036,,,,6,5,11
HND-000530,2011,10700037,,,,3,7,10
HND-000533,2011,10700040,,,,8,7,15
HND-000534,2011,10700041,,,,10,9,19
HND-000545,2011,10700052,,,,4,3,7
HND-000552,2011,10700059,,,,3,10,13
HND-000558,2011,10700066,,,,4,1,5
HND-000561,2011,10700070,,,,7,9,16
HND-000566,2011,10700075,,,,2,5,7
HND-000577,2011,10700086,,,,10,9,19
HND-000609,2011,10700124,,,,4,10,14
HND-000630,2011,10700167,,,,5,2,7
HND-000636,2011,10700190,,,,14,8,22
,2011,10700196,,,,5,3,8
HND-000640,2011,10700200,,,,4,4,8
,2011,10700204,,,,6,7,13
,2011,10700210,,,,3,7,10
,2011,10700237,,,,5,2,7
,2011,10700240,,,,2,1,3
,2011,10700242,,,,0,4,4
,2011,10700243,,,,3,1,4
,2011,10700244,,,,2,2,4
,2011,10700250,,,,2,3,5
,2011,10700251,,,,4,0,4
,2011,10700252,,,,5,1,6
,2011,10700253,,,,5,1,6
HND-000499,2011,10700005,,,,8,4,12
HND-000512,2011,10700019,,,,8,6,14
HND-000519,2011,10700026,,,,2,2,4
HND-000523,2011,10700030,,,,4,1,5
,2011,10700032,,,,2,2,4
HND-000526,2011,10700033,,,,0,3,3
HND-000532,2011,10700039,,,,3,2,5
HND-000539,2011,10700046,,,,3,5,8
HND-000550,2011,10700057,,,,2,2,4
HND-000554,2011,10700062,,,,3,1,4
HND-000555,2011,10700063,,,,15,12,27
HND-000564,2011,10700073,,,,0,5,5
HND-000565,2011,10700074,,,,2,2,4
HND-000568,2011,10700077,,,,7,2,9
HND-000571,2011,10700080,,,,7,3,10
HND-000573,2011,10700082,,,,6,7,13
HND-000580,2011,10700089,,,,4,0,4
HND-000582,2011,10700091,,,,4,2,6
HND-000587,2011,10700096,,,,5,2,7
HND-000589,2011,10700098,,,,5,3,8
HND-000591,2011,10700100,,,,2,5,7
HND-000596,2011,10700106,,,,6,4,10
HND-000598,2011,10700108,,,,3,5,8
,2011,10700112,,,,2,2,4
HND-000603,2011,10700115,,,,4,4,8
HND-000604,2011,10700116,,,,5,4,9
HND-000606,2011,10700118,,,,2,3,5
,2011,10700182,,,,2,3,5
,2011,10700184,,,,6,2,8
,2011,10700187,,,,7,10,17
,2011,10700206,,,,6,4,10
HND-000641,2011,10700208,,,,3,7,10
HND-000654,2011,10700241,,,,8,9,17
HND-000655,2011,10700248,,,,2,6,8
,2011,10700254,,,,4,0,4
,2011,10700255,,,,5,1,6
,2011,10700148,,,,1,2,3
HND-000650,2011,10700225,,,,2,0,2
,2011,10700238,,,,5,4,9
,2011,10700002,,,,13,7,20
,2011,10700133,,,,0,1,1
,2011,10700164,,,,4,4,8
,2011,10700176,,,,2,1,3
,2011,10700223,,,,1,2,3
,2011,10700245,,,,1,2,3
,2011,10700246,,,,3,1,4
,2011,10700002,,,,14,14,28
HND-000503,2011,10700010,,,,9,4,13
HND-000506,2011,10700013,,,,8,13,21
HND-000517,2011,10700024,,,,2,4,6
,2011,10700120,,,,4,2,6
HND-000611,2011,10700126,,,,2,4,6
,2011,10700133,,,,9,14,23
HND-000617,2011,10700137,,,,13,12,25
HND-000618,2011,10700138,,,,4,5,9
,2011,10700140,,,,7,3,10
HND-000621,2011,10700145,,,,3,2,5
,2011,10700148,,,,11,7,18
,2011,10700154,,,,2,7,9
,2011,10700162,,,,4,3,7
HND-000632,2011,10700170,,,,2,1,3
,2011,10700174,,,,3,1,4
,2011,10700216,,,,7,4,11
HND-000649,2011,10700222,,,,2,2,4
,2011,10700226,,,,5,3,8
HND-000652,2011,10700228,,,,3,10,13
,2011,10700238,,,,1,5,6
,2011,10700245,,,,7,4,11
,2011,10700246,,,,3,1,4
HND-000497,2011,10700003,,,,1,1,2
HND-000504,2011,10700011,,,,7,2,9
HND-000540,2011,10700047,,,,10,3,13
HND-000572,2011,10700081,,,,2,1,3
,2011,10700112,,,,3,2,5
,2011,10700129,,,,8,5,13
HND-000615,2011,10700134,,,,4,11,15
HND-000616,2011,10700135,,,,2,3,5
HND-000620,2011,10700142,,,,6,8,14
,2011,10700146,,,,8,5,13
HND-000623,2011,10700153,,,,1,2,3
HND-000624,2011,10700155,,,,2,8,10
,2011,10700157,,,,13,13,26
,2011,10700164,,,,12,10,22
HND-000634,2011,10700175,,,,12,7,19
,2011,10700176,,,,3,0,3
HND-000635,2011,10700183,,,,14,8,22
,2011,10700201,,,,3,6,9
,2011,10700203,,,,11,10,21
,2011,10700223,,,,2,1,3
,2011,10700224,,,,4,2,6
HND-000650,2011,10700225,,,,4,4,8
HND-000651,2011,10700227,,,,9,10,19
,2011,10700229,,,,7,1,8
,2011,10700239,,,,3,5,8
HND-000497,2011,10700003,,,,10,13,23
HND-000517,2011,10700024,,,,8,12,20
HND-000521,2011,10700028,,,,9,10,19
HND-000527,2011,10700034,,,,12,18,30
HND-000572,2011,10700081,,,,9,11,20
,2011,10700112,,,,5,3,8
,2011,10700129,,,,11,12,23
,2011,10700133,,,,16,22,38
HND-000616,2011,10700135,,,,11,8,19
,2011,10700152,,,,6,5,11
HND-000623,2011,10700153,,,,8,5,13
,2011,10700158,,,,8,12,20
,2011,10700162,,,,3,7,10
,2011,10700164,,,,6,11,17
HND-000634,2011,10700175,,,,8,6,14
,2011,10700176,,,,8,1,9
,2011,10700201,,,,3,9,12
,2011,10700203,,,,14,9,23
,2011,10700223,,,,2,7,9
,2011,10700224,,,,4,6,10
HND-000651,2011,10700227,,,,22,14,36
,2011,10700229,,,,4,3,7
,2011,10700239,,,,4,7,11
HND-000496,2011,10700001,,,,11,18,29
,2011,10700002,,,,10,15,25
HND-000503,2011,10700010,,,,16,15,31
HND-000504,2011,10700011,,,,6,9,15
HND-000505,2011,10700012,,,,5,10,15
HND-000506,2011,10700013,,,,17,11,28
HND-000540,2011,10700047,,,,14,10,24
HND-000546,2011,10700053,,,,5,16,21
,2011,10700120,,,,4,6,10
HND-000611,2011,10700126,,,,5,12,17
HND-000615,2011,10700134,,,,17,16,33
HND-000617,2011,10700137,,,,18,18,36
HND-000618,2011,10700138,,,,17,17,34
,2011,10700140,,,,0,4,4
HND-000619,2011,10700141,,,,5,16,21
HND-000620,2011,10700142,,,,18,10,28
,2011,10700143,,,,10,10,20
HND-000621,2011,10700145,,,,14,7,21
,2011,10700146,,,,4,7,11
,2011,10700148,,,,6,11,17
,2011,10700150,,,,14,7,21
,2011,10700151,,,,13,13,26
,2011,10700154,,,,7,5,12
HND-000624,2011,10700155,,,,13,8,21
,2011,10700157,,,,20,14,34
HND-000632,2011,10700170,,,,7,14,21
,2011,10700174,,,,9,7,16
HND-000635,2011,10700183,,,,5,2,7
,2011,10700216,,,,4,2,6
HND-000649,2011,10700222,,,,14,13,27
HND-000650,2011,10700225,,,,5,4,9
,2011,10700226,,,,2,4,6
HND-000652,2011,10700228,,,,2,10,12
,2011,10700238,,,,3,7,10
,2011,10700245,,,,1,3,4
,2011,10700246,,,,5,5,10
HND-000498,2011,10700004,,,,1,2,3
HND-000505,2011,10700012,,,,14,11,25
HND-000506,2011,10700013,,,,32,18,50
HND-000507,2011,10700014,,,,5,10,15
HND-000511,2011,10700018,,,,24,30,54
HND-000512,2011,10700019,,,,5,9,14
HND-000514,2011,10700021,,,,2,1,3
HND-000515,2011,10700022,,,,82,70,152
HND-000516,2011,10700023,,,,23,20,43
HND-000517,2011,10700024,,,,13,12,25
HND-000522,2011,10700029,,,,6,6,12
,2011,10700032,,,,2,6,8
HND-000527,2011,10700034,,,,18,12,30
HND-000530,2011,10700037,,,,13,12,25
HND-000532,2011,10700039,,,,1,3,4
HND-000534,2011,10700041,,,,11,6,17
HND-000539,2011,10700046,,,,2,3,5
HND-000541,2011,10700048,,,,3,0,3
HND-000544,2011,10700051,,,,5,1,6
HND-000548,2011,10700055,,,,2,3,5
HND-000550,2011,10700057,,,,1,9,10
HND-000551,2011,10700058,,,,7,5,12
HND-000557,2011,10700065,,,,9,11,20
HND-000558,2011,10700066,,,,6,3,9
HND-000559,2011,10700067,,,,4,2,6
HND-000560,2011,10700068,,,,1,1,2
HND-000565,2011,10700074,,,,5,1,6
HND-000566,2011,10700075,,,,3,4,7
HND-000567,2011,10700076,,,,3,0,3
HND-000568,2011,10700077,,,,4,9,13
HND-000573,2011,10700082,,,,2,9,11
HND-000575,2011,10700084,,,,2,3,5
HND-000578,2011,10700087,,,,7,2,9
HND-000580,2011,10700089,,,,2,1,3
HND-000581,2011,10700090,,,,4,7,11
HND-000582,2011,10700091,,,,1,3,4
HND-000583,2011,10700092,,,,4,2,6
HND-000584,2011,10700093,,,,2,1,3
HND-000589,2011,10700098,,,,2,10,12
HND-000590,2011,10700099,,,,3,1,4
HND-000594,2011,10700104,,,,5,1,6
HND-000595,2011,10700105,,,,6,4,10
HND-000596,2011,10700106,,,,13,6,19
HND-000597,2011,10700107,,,,11,6,17
HND-000598,2011,10700108,,,,0,2,2
HND-000600,2011,10700110,,,,55,34,89
HND-000601,2011,10700111,,,,20,22,42
HND-000602,2011,10700114,,,,0,1,1
HND-000605,2011,10700117,,,,5,6,11
HND-000608,2011,10700121,,,,6,5,11
HND-000609,2011,10700124,,,,2,5,7
HND-000610,2011,10700125,,,,4,7,11
HND-000612,2011,10700127,,,,17,17,34
,2011,10700130,,,,3,2,5
,2011,10700133,,,,42,31,73
HND-000625,2011,10700159,,,,10,12,22
,2011,10700160,,,,4,4,8
,2011,10700162,,,,7,9,16
,2011,10700164,,,,8,14,22
HND-000633,2011,10700172,,,,10,10,20
HND-000635,2011,10700183,,,,6,7,13
HND-000637,2011,10700194,,,,1,1,2
HND-000639,2011,10700199,,,,1,1,2
HND-000640,2011,10700200,,,,2,1,3
,2011,10700206,,,,0,4,4
HND-000645,2011,10700217,,,,2,1,3
HND-000646,2011,10700218,,,,4,2,6
HND-000647,2011,10700219,,,,1,1,2
,2011,10700238,,,,7,7,14
,2011,10700239,,,,7,6,13
,2011,10700245,,,,3,2,5
,2011,10700246,,,,9,4,13
HND-000497,2011,10700003,,,,26,25,51
HND-000499,2011,10700005,,,,3,3,6
HND-000500,2011,10700007,,,,1,4,5
HND-000501,2011,10700008,,,,3,2,5
HND-000502,2011,10700009,,,,35,37,72
HND-000503,2011,10700010,,,,34,42,76
HND-000504,2011,10700011,,,,15,8,23
HND-000508,2011,10700015,,,,10,11,21
HND-000509,2011,10700016,,,,12,9,21
HND-000510,2011,10700017,,,,40,42,82
HND-000513,2011,10700020,,,,6,9,15
HND-000518,2011,10700025,,,,6,8,14
HND-000519,2011,10700026,,,,7,5,12
HND-000520,2011,10700027,,,,10,8,18
HND-000521,2011,10700028,,,,17,13,30
HND-000523,2011,10700030,,,,8,9,17
HND-000524,2011,10700031,,,,4,6,10
HND-000526,2011,10700033,,,,6,7,13
HND-000528,2011,10700035,,,,4,2,6
HND-000529,2011,10700036,,,,12,9,21
HND-000531,2011,10700038,,,,8,11,19
HND-000533,2011,10700040,,,,8,4,12
HND-000535,2011,10700042,,,,8,9,17
HND-000536,2011,10700043,,,,4,8,12
HND-000537,2011,10700044,,,,4,12,16
HND-000540,2011,10700047,,,,28,17,45
HND-000542,2011,10700049,,,,2,0,2
HND-000543,2011,10700050,,,,1,2,3
HND-000545,2011,10700052,,,,6,3,9
HND-000546,2011,10700053,,,,21,12,33
HND-000547,2011,10700054,,,,6,5,11
HND-000549,2011,10700056,,,,28,20,48
HND-000552,2011,10700059,,,,8,2,10
HND-000553,2011,10700060,,,,1,4,5
HND-000554,2011,10700062,,,,3,2,5
HND-000555,2011,10700063,,,,9,13,22
HND-000556,2011,10700064,,,,5,4,9
HND-000561,2011,10700070,,,,8,3,11
HND-000562,2011,10700071,,,,1,1,2
HND-000564,2011,10700073,,,,5,2,7
HND-000569,2011,10700078,,,,3,5,8
HND-000570,2011,10700079,,,,3,3,6
HND-000571,2011,10700080,,,,5,4,9
HND-000572,2011,10700081,,,,7,14,21
HND-000574,2011,10700083,,,,5,1,6
HND-000576,2011,10700085,,,,3,2,5
HND-000577,2011,10700086,,,,23,19,42
HND-000579,2011,10700088,,,,1,1,2
HND-000585,2011,10700094,,,,1,3,4
HND-000586,2011,10700095,,,,2,4,6
HND-000587,2011,10700096,,,,6,6,12
HND-000588,2011,10700097,,,,4,0,4
HND-000591,2011,10700100,,,,1,2,3
HND-000592,2011,10700102,,,,1,0,1
HND-000599,2011,10700109,,,,25,31,56
,2011,10700112,,,,3,2,5
,2011,10700113,,,,6,14,20
HND-000603,2011,10700115,,,,9,4,13
HND-000604,2011,10700116,,,,9,5,14
HND-000606,2011,10700118,,,,6,7,13
HND-000607,2011,10700119,,,,3,2,5
,2011,10700122,,,,7,3,10
HND-000611,2011,10700126,,,,20,20,40
,2011,10700128,,,,20,9,29
,2011,10700129,,,,15,10,25
HND-000614,2011,10700132,,,,7,3,10
,2011,10700144,,,,1,4,5
HND-000622,2011,10700149,,,,6,11,17
,2011,10700157,,,,30,30,60
HND-000626,2011,10700161,,,,4,4,8
HND-000630,2011,10700167,,,,3,4,7
,2011,10700179,,,,9,11,20
HND-000636,2011,10700190,,,,27,24,51
HND-000638,2011,10700195,,,,18,12,30
,2011,10700201,,,,10,4,14
HND-000642,2011,10700213,,,,1,0,1
HND-000643,2011,10700214,,,,4,4,8
HND-000644,2011,10700215,,,,5,6,11
HND-000648,2011,10700220,,,,13,8,21
HND-000655,2011,10700248,,,,7,4,11
HND-000497,2011,10700003,,,,25,25,50
HND-000498,2011,10700004,,,,1,1,2
HND-000499,2011,10700005,,,,3,1,4
HND-000500,2011,10700007,,,,0,3,3
HND-000502,2011,10700009,,,,31,22,53
HND-000507,2011,10700014,,,,14,11,25
HND-000512,2011,10700019,,,,3,7,10
HND-000514,2011,10700021,,,,2,0,2
HND-000517,2011,10700024,,,,17,5,22
HND-000518,2011,10700025,,,,8,8,16
HND-000519,2011,10700026,,,,3,7,10
HND-000520,2011,10700027,,,,9,8,17
HND-000521,2011,10700028,,,,26,19,45
HND-000523,2011,10700030,,,,9,6,15
HND-000524,2011,10700031,,,,6,8,14
,2011,10700032,,,,7,4,11
HND-000526,2011,10700033,,,,5,6,11
HND-000527,2011,10700034,,,,7,15,22
HND-000532,2011,10700039,,,,2,4,6
HND-000537,2011,10700044,,,,7,4,11
HND-000539,2011,10700046,,,,1,2,3
HND-000547,2011,10700054,,,,10,12,22
HND-000548,2011,10700055,,,,0,2,2
HND-000549,2011,10700056,,,,22,17,39
HND-000550,2011,10700057,,,,8,3,11
HND-000553,2011,10700060,,,,3,2,5
HND-000554,2011,10700062,,,,4,1,5
HND-000555,2011,10700063,,,,16,18,34
HND-000564,2011,10700073,,,,1,2,3
HND-000565,2011,10700074,,,,7,4,11
HND-000570,2011,10700079,,,,1,3,4
HND-000571,2011,10700080,,,,11,1,12
HND-000572,2011,10700081,,,,5,13,18
HND-000573,2011,10700082,,,,8,4,12
HND-000574,2011,10700083,,,,2,1,3
HND-000575,2011,10700084,,,,2,1,3
HND-000580,2011,10700089,,,,3,2,5
HND-000582,2011,10700091,,,,3,2,5
HND-000587,2011,10700096,,,,9,8,17
HND-000588,2011,10700097,,,,4,1,5
HND-000589,2011,10700098,,,,5,8,13
HND-000591,2011,10700100,,,,1,1,2
HND-000592,2011,10700102,,,,1,1,2
HND-000595,2011,10700105,,,,4,3,7
HND-000596,2011,10700106,,,,8,7,15
HND-000597,2011,10700107,,,,10,11,21
,2011,10700112,,,,1,7,8
,2011,10700113,,,,4,2,6
HND-000603,2011,10700115,,,,4,8,12
HND-000604,2011,10700116,,,,6,3,9
HND-000605,2011,10700117,,,,3,1,4
HND-000606,2011,10700118,,,,5,3,8
,2011,10700122,,,,6,6,12
HND-000610,2011,10700125,,,,4,0,4
,2011,10700128,,,,9,10,19
,2011,10700129,,,,14,13,27
,2011,10700133,,,,32,35,67
,2011,10700144,,,,3,2,5
HND-000622,2011,10700149,,,,10,6,16
HND-000625,2011,10700159,,,,12,8,20
,2011,10700162,,,,6,6,12
,2011,10700164,,,,6,8,14
,2011,10700179,,,,8,14,22
HND-000639,2011,10700199,,,,5,2,7
HND-000640,2011,10700200,,,,2,3,5
,2011,10700201,,,,3,8,11
HND-000642,2011,10700213,,,,4,1,5
HND-000644,2011,10700215,,,,2,5,7
HND-000647,2011,10700219,,,,6,2,8
HND-000648,2011,10700220,,,,13,13,26
,2011,10700239,,,,2,3,5
HND-000655,2011,10700248,,,,7,5,12
HND-000501,2011,10700008,,,,6,2,8
HND-000503,2011,10700010,,,,33,46,79
HND-000504,2011,10700011,,,,12,7,19
HND-000505,2011,10700012,,,,12,13,25
HND-000506,2011,10700013,,,,30,19,49
HND-000508,2011,10700015,,,,17,8,25
HND-000509,2011,10700016,,,,9,5,14
HND-000510,2011,10700017,,,,33,30,63
HND-000511,2011,10700018,,,,32,17,49
HND-000513,2011,10700020,,,,8,6,14
HND-000515,2011,10700022,,,,47,47,94
HND-000516,2011,10700023,,,,18,16,34
HND-000522,2011,10700029,,,,6,6,12
HND-000528,2011,10700035,,,,5,4,9
HND-000529,2011,10700036,,,,10,12,22
HND-000530,2011,10700037,,,,12,11,23
HND-000531,2011,10700038,,,,17,14,31
HND-000533,2011,10700040,,,,8,4,12
HND-000534,2011,10700041,,,,9,5,14
HND-000535,2011,10700042,,,,6,6,12
HND-000536,2011,10700043,,,,11,5,16
,2011,10700045,,,,3,4,7
HND-000540,2011,10700047,,,,23,20,43
HND-000541,2011,10700048,,,,1,1,2
HND-000542,2011,10700049,,,,0,6,6
HND-000543,2011,10700050,,,,2,2,4
HND-000544,2011,10700051,,,,0,1,1
HND-000545,2011,10700052,,,,3,5,8
HND-000546,2011,10700053,,,,25,13,38
HND-000551,2011,10700058,,,,4,6,10
HND-000552,2011,10700059,,,,10,6,16
HND-000556,2011,10700064,,,,2,2,4
HND-000557,2011,10700065,,,,12,5,17
HND-000558,2011,10700066,,,,1,6,7
HND-000559,2011,10700067,,,,3,0,3
HND-000561,2011,10700070,,,,10,7,17
HND-000562,2011,10700071,,,,1,1,2
HND-000566,2011,10700075,,,,2,5,7
HND-000567,2011,10700076,,,,1,3,4
HND-000568,2011,10700077,,,,0,5,5
HND-000569,2011,10700078,,,,1,0,1
HND-000576,2011,10700085,,,,3,0,3
HND-000577,2011,10700086,,,,21,14,35
HND-000578,2011,10700087,,,,2,5,7
HND-000579,2011,10700088,,,,2,1,3
HND-000581,2011,10700090,,,,8,11,19
HND-000583,2011,10700092,,,,4,2,6
HND-000584,2011,10700093,,,,2,3,5
HND-000585,2011,10700094,,,,3,2,5
HND-000590,2011,10700099,,,,6,5,11
HND-000594,2011,10700104,,,,3,2,5
HND-000598,2011,10700108,,,,3,1,4
HND-000599,2011,10700109,,,,12,14,26
HND-000600,2011,10700110,,,,39,33,72
HND-000601,2011,10700111,,,,14,16,30
HND-000602,2011,10700114,,,,1,1,2
HND-000607,2011,10700119,,,,2,1,3
HND-000608,2011,10700121,,,,5,5,10
HND-000609,2011,10700124,,,,4,5,9
HND-000611,2011,10700126,,,,19,20,39
HND-000612,2011,10700127,,,,25,8,33
,2011,10700130,,,,6,4,10
HND-000614,2011,10700132,,,,3,1,4
,2011,10700157,,,,30,17,47
,2011,10700160,,,,2,1,3
HND-000626,2011,10700161,,,,2,1,3
HND-000630,2011,10700167,,,,4,3,7
HND-000633,2011,10700172,,,,8,2,10
HND-000635,2011,10700183,,,,9,5,14
HND-000636,2011,10700190,,,,15,18,33
HND-000637,2011,10700194,,,,3,1,4
HND-000638,2011,10700195,,,,14,24,38
,2011,10700206,,,,3,1,4
HND-000646,2011,10700218,,,,3,0,3
,2011,10700238,,,,3,4,7
,2011,10700245,,,,1,1,2
,2011,10700246,,,,5,6,11
HND-000497,2011,10700003,,,,21,17,38
HND-000499,2011,10700005,,,,6,5,11
HND-000500,2011,10700007,,,,4,2,6
HND-000501,2011,10700008,,,,3,1,4
HND-000502,2011,10700009,,,,35,34,69
HND-000504,2011,10700011,,,,11,10,21
HND-000508,2011,10700015,,,,7,3,10
HND-000509,2011,10700016,,,,8,7,15
HND-000510,2011,10700017,,,,35,36,71
HND-000518,2011,10700025,,,,5,8,13
HND-000519,2011,10700026,,,,4,7,11
HND-000520,2011,10700027,,,,11,6,17
HND-000521,2011,10700028,,,,25,16,41
,2011,10700032,,,,8,3,11
HND-000526,2011,10700033,,,,8,7,15
HND-000527,2011,10700034,,,,25,13,38
HND-000530,2011,10700037,,,,7,5,12
HND-000532,2011,10700039,,,,2,1,3
HND-000534,2011,10700041,,,,7,9,16
HND-000539,2011,10700046,,,,3,2,5
HND-000541,2011,10700048,,,,2,0,2
HND-000548,2011,10700055,,,,2,3,5
HND-000550,2011,10700057,,,,9,7,16
HND-000551,2011,10700058,,,,2,0,2
HND-000553,2011,10700060,,,,1,5,6
HND-000554,2011,10700062,,,,1,5,6
HND-000555,2011,10700063,,,,8,15,23
HND-000556,2011,10700064,,,,1,3,4
HND-000565,2011,10700074,,,,6,1,7
HND-000566,2011,10700075,,,,7,3,10
HND-000567,2011,10700076,,,,2,2,4
HND-000568,2011,10700077,,,,2,3,5
HND-000573,2011,10700082,,,,8,6,14
HND-000574,2011,10700083,,,,1,1,2
HND-000575,2011,10700084,,,,1,1,2
HND-000580,2011,10700089,,,,2,4,6
HND-000581,2011,10700090,,,,6,7,13
HND-000582,2011,10700091,,,,3,0,3
HND-000583,2011,10700092,,,,3,3,6
HND-000584,2011,10700093,,,,2,2,4
HND-000589,2011,10700098,,,,8,4,12
HND-000590,2011,10700099,,,,2,4,6
HND-000591,2011,10700100,,,,1,1,2
HND-000592,2011,10700102,,,,2,1,3
HND-000593,2011,10700103,,,,3,2,5
HND-000595,2011,10700105,,,,3,3,6
HND-000596,2011,10700106,,,,16,6,22
,2011,10700112,,,,2,4,6
,2011,10700113,,,,8,3,11
HND-000603,2011,10700115,,,,1,5,6
HND-000604,2011,10700116,,,,7,4,11
HND-000606,2011,10700118,,,,8,5,13
,2011,10700122,,,,7,7,14
,2011,10700128,,,,7,13,20
,2011,10700129,,,,16,7,23
HND-000614,2011,10700132,,,,4,2,6
,2011,10700144,,,,1,3,4
HND-000622,2011,10700149,,,,6,6,12
,2011,10700157,,,,23,36,59
HND-000626,2011,10700161,,,,3,1,4
,2011,10700164,,,,8,9,17
HND-000630,2011,10700167,,,,4,5,9
,2011,10700179,,,,8,17,25
HND-000636,2011,10700190,,,,22,23,45
HND-000638,2011,10700195,,,,8,18,26
,2011,10700201,,,,4,5,9
HND-000642,2011,10700213,,,,2,1,3
HND-000643,2011,10700214,,,,4,1,5
HND-000644,2011,10700215,,,,4,2,6
HND-000647,2011,10700219,,,,6,6,12
HND-000648,2011,10700220,,,,9,9,18
HND-000655,2011,10700248,,,,6,7,13
HND-000503,2011,10700010,,,,43,37,80
HND-000505,2011,10700012,,,,20,20,40
HND-000506,2011,10700013,,,,29,23,52
HND-000507,2011,10700014,,,,11,11,22
HND-000511,2011,10700018,,,,28,23,51
HND-000512,2011,10700019,,,,4,9,13
HND-000513,2011,10700020,,,,7,7,14
HND-000514,2011,10700021,,,,3,0,3
HND-000515,2011,10700022,,,,81,110,191
HND-000516,2011,10700023,,,,24,15,39
HND-000517,2011,10700024,,,,14,14,28
HND-000522,2011,10700029,,,,7,6,13
HND-000523,2011,10700030,,,,6,8,14
HND-000524,2011,10700031,,,,6,5,11
HND-000528,2011,10700035,,,,8,6,14
HND-000529,2011,10700036,,,,7,11,18
HND-000531,2011,10700038,,,,11,13,24
HND-000533,2011,10700040,,,,11,5,16
HND-000535,2011,10700042,,,,8,7,15
HND-000536,2011,10700043,,,,17,8,25
HND-000537,2011,10700044,,,,9,4,13
,2011,10700045,,,,0,5,5
HND-000540,2011,10700047,,,,30,31,61
HND-000542,2011,10700049,,,,3,0,3
HND-000543,2011,10700050,,,,0,2,2
HND-000544,2011,10700051,,,,0,3,3
HND-000545,2011,10700052,,,,5,7,12
HND-000546,2011,10700053,,,,16,16,32
HND-000547,2011,10700054,,,,4,5,9
HND-000549,2011,10700056,,,,20,18,38
HND-000552,2011,10700059,,,,6,3,9
HND-000557,2011,10700065,,,,11,9,20
HND-000558,2011,10700066,,,,5,4,9
HND-000559,2011,10700067,,,,3,1,4
HND-000560,2011,10700068,,,,1,4,5
HND-000561,2011,10700070,,,,14,7,21
HND-000562,2011,10700071,,,,2,1,3
HND-000564,2011,10700073,,,,1,2,3
HND-000569,2011,10700078,,,,3,0,3
HND-000570,2011,10700079,,,,2,4,6
HND-000571,2011,10700080,,,,3,4,7
HND-000572,2011,10700081,,,,11,10,21
HND-000576,2011,10700085,,,,3,3,6
HND-000577,2011,10700086,,,,16,13,29
HND-000578,2011,10700087,,,,4,4,8
HND-000579,2011,10700088,,,,0,2,2
HND-000585,2011,10700094,,,,3,4,7
HND-000586,2011,10700095,,,,0,5,5
HND-000587,2011,10700096,,,,13,10,23
HND-000588,2011,10700097,,,,3,2,5
HND-000597,2011,10700107,,,,13,13,26
HND-000598,2011,10700108,,,,1,2,3
HND-000599,2011,10700109,,,,14,22,36
HND-000600,2011,10700110,,,,45,23,68
HND-000601,2011,10700111,,,,27,14,41
HND-000605,2011,10700117,,,,5,2,7
HND-000607,2011,10700119,,,,3,3,6
HND-000608,2011,10700121,,,,5,5,10
HND-000609,2011,10700124,,,,7,2,9
HND-000610,2011,10700125,,,,0,2,2
HND-000611,2011,10700126,,,,19,17,36
HND-000612,2011,10700127,,,,10,10,20
,2011,10700130,,,,1,1,2
,2011,10700133,,,,35,32,67
HND-000625,2011,10700159,,,,10,12,22
,2011,10700160,,,,4,1,5
,2011,10700162,,,,4,6,10
HND-000633,2011,10700172,,,,1,4,5
HND-000635,2011,10700183,,,,8,9,17
HND-000637,2011,10700194,,,,2,1,3
HND-000639,2011,10700199,,,,5,2,7
HND-000640,2011,10700200,,,,3,3,6
,2011,10700206,,,,3,4,7
HND-000645,2011,10700217,,,,1,2,3
HND-000646,2011,10700218,,,,4,0,4
,2011,10700238,,,,1,6,7
,2011,10700239,,,,3,1,4
,2011,10700245,,,,0,5,5
,2011,10700246,,,,2,0,2
HND-000498,2011,10700004,,,,2,2,4
HND-000499,2011,10700005,,,,4,5,9
HND-000500,2011,10700007,,,,1,1,2
HND-000507,2011,10700014,,,,27,18,45
HND-000512,2011,10700019,,,,9,5,14
HND-000517,2011,10700024,,,,14,8,22
HND-000518,2011,10700025,,,,3,9,12
HND-000519,2011,10700026,,,,8,5,13
HND-000520,2011,10700027,,,,5,7,12
HND-000523,2011,10700030,,,,7,2,9
HND-000524,2011,10700031,,,,6,10,16
,2011,10700032,,,,4,5,9
HND-000526,2011,10700033,,,,7,5,12
HND-000531,2011,10700038,,,,15,12,27
HND-000532,2011,10700039,,,,3,4,7
HND-000535,2011,10700042,,,,8,4,12
HND-000537,2011,10700044,,,,8,8,16
,2011,10700045,,,,1,3,4
HND-000540,2011,10700047,,,,15,22,37
HND-000545,2011,10700052,,,,3,6,9
HND-000547,2011,10700054,,,,2,2,4
HND-000549,2011,10700056,,,,17,13,30
HND-000550,2011,10700057,,,,7,3,10
HND-000552,2011,10700059,,,,10,2,12
HND-000553,2011,10700060,,,,3,4,7
HND-000555,2011,10700063,,,,15,13,28
HND-000557,2011,10700065,,,,8,8,16
HND-000558,2011,10700066,,,,3,7,10
HND-000560,2011,10700068,,,,0,2,2
HND-000561,2011,10700070,,,,8,9,17
HND-000564,2011,10700073,,,,1,4,5
HND-000565,2011,10700074,,,,6,8,14
HND-000570,2011,10700079,,,,2,1,3
HND-000571,2011,10700080,,,,2,3,5
HND-000572,2011,10700081,,,,6,9,15
HND-000573,2011,10700082,,,,6,3,9
HND-000574,2011,10700083,,,,1,0,1
HND-000579,2011,10700088,,,,3,5,8
HND-000580,2011,10700089,,,,2,1,3
HND-000582,2011,10700091,,,,3,1,4
HND-000586,2011,10700095,,,,2,5,7
HND-000587,2011,10700096,,,,7,12,19
HND-000588,2011,10700097,,,,3,0,3
HND-000589,2011,10700098,,,,3,9,12
HND-000591,2011,10700100,,,,3,5,8
HND-000594,2011,10700104,,,,2,1,3
HND-000595,2011,10700105,,,,4,1,5
HND-000596,2011,10700106,,,,11,11,22
HND-000597,2011,10700107,,,,8,6,14
HND-000598,2011,10700108,,,,0,2,2
HND-000600,2011,10700110,,,,24,30,54
HND-000602,2011,10700114,,,,0,2,2
HND-000603,2011,10700115,,,,8,4,12
HND-000604,2011,10700116,,,,2,3,5
HND-000605,2011,10700117,,,,1,2,3
HND-000608,2011,10700121,,,,5,7,12
,2011,10700122,,,,6,3,9
HND-000610,2011,10700125,,,,3,2,5
HND-000612,2011,10700127,,,,11,14,25
,2011,10700129,,,,11,9,20
,2011,10700133,,,,30,35,65
,2011,10700144,,,,6,7,13
HND-000622,2011,10700149,,,,5,8,13
HND-000625,2011,10700159,,,,17,10,27
,2011,10700162,,,,1,4,5
,2011,10700164,,,,6,7,13
,2011,10700179,,,,8,10,18
HND-000639,2011,10700199,,,,2,1,3
HND-000640,2011,10700200,,,,4,1,5
,2011,10700201,,,,8,8,16
,2011,10700206,,,,3,6,9
HND-000644,2011,10700215,,,,4,2,6
HND-000645,2011,10700217,,,,3,4,7
HND-000646,2011,10700218,,,,2,3,5
HND-000647,2011,10700219,,,,1,2,3
HND-000648,2011,10700220,,,,6,10,16
,2011,10700246,,,,4,1,5
HND-000655,2011,10700248,,,,8,5,13
HND-000497,2011,10700003,,,,22,21,43
HND-000501,2011,10700008,,,,4,2,6
HND-000502,2011,10700009,,,,46,32,78
HND-000503,2011,10700010,,,,40,44,84
HND-000504,2011,10700011,,,,13,12,25
HND-000505,2011,10700012,,,,26,20,46
HND-000506,2011,10700013,,,,24,16,40
HND-000508,2011,10700015,,,,17,5,22
HND-000509,2011,10700016,,,,7,4,11
HND-000510,2011,10700017,,,,27,37,64
HND-000511,2011,10700018,,,,30,22,52
HND-000513,2011,10700020,,,,6,7,13
HND-000515,2011,10700022,,,,88,87,175
HND-000516,2011,10700023,,,,15,30,45
HND-000521,2011,10700028,,,,12,10,22
HND-000522,2011,10700029,,,,3,8,11
HND-000527,2011,10700034,,,,17,14,31
HND-000528,2011,10700035,,,,7,5,12
HND-000529,2011,10700036,,,,16,7,23
HND-000530,2011,10700037,,,,8,9,17
HND-000533,2011,10700040,,,,11,5,16
HND-000534,2011,10700041,,,,5,8,13
HND-000536,2011,10700043,,,,8,5,13
HND-000539,2011,10700046,,,,2,0,2
HND-000541,2011,10700048,,,,1,2,3
HND-000542,2011,10700049,,,,2,1,3
HND-000543,2011,10700050,,,,2,2,4
HND-000546,2011,10700053,,,,16,13,29
HND-000548,2011,10700055,,,,4,0,4
HND-000551,2011,10700058,,,,3,2,5
HND-000554,2011,10700062,,,,0,4,4
HND-000556,2011,10700064,,,,2,3,5
HND-000559,2011,10700067,,,,3,1,4
HND-000562,2011,10700071,,,,2,2,4
HND-000566,2011,10700075,,,,5,2,7
HND-000567,2011,10700076,,,,3,6,9
HND-000568,2011,10700077,,,,4,1,5
HND-000569,2011,10700078,,,,5,2,7
HND-000575,2011,10700084,,,,3,4,7
HND-000576,2011,10700085,,,,7,1,8
HND-000577,2011,10700086,,,,8,12,20
HND-000578,2011,10700087,,,,6,5,11
HND-000581,2011,10700090,,,,9,6,15
HND-000583,2011,10700092,,,,1,0,1
HND-000584,2011,10700093,,,,6,3,9
HND-000585,2011,10700094,,,,4,2,6
HND-000590,2011,10700099,,,,6,5,11
HND-000593,2011,10700103,,,,1,1,2
HND-000599,2011,10700109,,,,18,16,34
HND-000601,2011,10700111,,,,26,18,44
,2011,10700112,,,,4,1,5
,2011,10700113,,,,7,8,15
HND-000606,2011,10700118,,,,2,4,6
HND-000607,2011,10700119,,,,2,0,2
HND-000609,2011,10700124,,,,6,1,7
HND-000611,2011,10700126,,,,13,9,22
,2011,10700128,,,,21,9,30
,2011,10700130,,,,3,2,5
HND-000614,2011,10700132,,,,4,2,6
,2011,10700157,,,,22,23,45
,2011,10700160,,,,0,4,4
HND-000626,2011,10700161,,,,1,4,5
HND-000630,2011,10700167,,,,6,1,7
HND-000633,2011,10700172,,,,4,6,10
HND-000635,2011,10700183,,,,11,6,17
HND-000636,2011,10700190,,,,13,23,36
HND-000638,2011,10700195,,,,15,9,24
HND-000642,2011,10700213,,,,2,2,4
HND-000643,2011,10700214,,,,4,2,6
HND-000498,2011,10700004,,,,1,2,3
HND-000500,2011,10700007,,,,3,0,3
HND-000505,2011,10700012,,,,18,22,40
HND-000507,2011,10700014,,,,9,7,16
HND-000511,2011,10700018,,,,31,25,56
HND-000512,2011,10700019,,,,5,8,13
HND-000514,2011,10700021,,,,1,2,3
HND-000515,2011,10700022,,,,87,81,168
HND-000517,2011,10700024,,,,15,5,20
HND-000520,2011,10700027,,,,8,6,14
HND-000523,2011,10700030,,,,3,5,8
HND-000524,2011,10700031,,,,4,2,6
HND-000526,2011,10700033,,,,5,4,9
HND-000531,2011,10700038,,,,10,13,23
HND-000532,2011,10700039,,,,4,4,8
HND-000533,2011,10700040,,,,13,13,26
HND-000535,2011,10700042,,,,10,5,15
HND-000536,2011,10700043,,,,11,2,13
HND-000537,2011,10700044,,,,5,6,11
,2011,10700045,,,,2,0,2
HND-000540,2011,10700047,,,,40,24,64
HND-000542,2011,10700049,,,,3,3,6
HND-000543,2011,10700050,,,,3,2,5
HND-000545,2011,10700052,,,,7,4,11
HND-000546,2011,10700053,,,,17,11,28
HND-000547,2011,10700054,,,,1,1,2
HND-000549,2011,10700056,,,,7,17,24
HND-000552,2011,10700059,,,,11,9,20
HND-000557,2011,10700065,,,,9,9,18
HND-000558,2011,10700066,,,,3,2,5
HND-000559,2011,10700067,,,,3,2,5
HND-000560,2011,10700068,,,,0,2,2
HND-000561,2011,10700070,,,,10,5,15
HND-000562,2011,10700071,,,,1,0,1
HND-000564,2011,10700073,,,,5,4,9
HND-000569,2011,10700078,,,,3,1,4
HND-000570,2011,10700079,,,,1,3,4
HND-000571,2011,10700080,,,,6,4,10
HND-000572,2011,10700081,,,,8,16,24
HND-000574,2011,10700083,,,,1,0,1
HND-000579,2011,10700088,,,,0,3,3
HND-000580,2011,10700089,,,,2,2,4
HND-000585,2011,10700094,,,,3,0,3
HND-000586,2011,10700095,,,,1,3,4
HND-000587,2011,10700096,,,,9,3,12
HND-000588,2011,10700097,,,,1,1,2
HND-000591,2011,10700100,,,,2,7,9
HND-000594,2011,10700104,,,,0,1,1
HND-000595,2011,10700105,,,,3,5,8
HND-000596,2011,10700106,,,,8,8,16
HND-000597,2011,10700107,,,,2,6,8
HND-000598,2011,10700108,,,,1,2,3
HND-000600,2011,10700110,,,,27,25,52
HND-000602,2011,10700114,,,,1,3,4
HND-000603,2011,10700115,,,,2,1,3
HND-000604,2011,10700116,,,,1,4,5
HND-000605,2011,10700117,,,,1,2,3
HND-000608,2011,10700121,,,,3,7,10
,2011,10700122,,,,4,8,12
HND-000609,2011,10700124,,,,6,4,10
HND-000610,2011,10700125,,,,1,2,3
HND-000612,2011,10700127,,,,10,16,26
HND-000614,2011,10700132,,,,2,4,6
,2011,10700157,,,,33,29,62
,2011,10700162,,,,5,2,7
,2011,10700164,,,,4,12,16
,2011,10700179,,,,6,9,15
HND-000635,2011,10700183,,,,5,6,11
HND-000636,2011,10700190,,,,13,20,33
HND-000638,2011,10700195,,,,21,16,37
HND-000642,2011,10700213,,,,1,0,1
HND-000643,2011,10700214,,,,3,5,8
HND-000497,2011,10700003,,,,25,26,51
HND-000499,2011,10700005,,,,6,4,10
HND-000501,2011,10700008,,,,2,3,5
HND-000502,2011,10700009,,,,42,36,78
HND-000503,2011,10700010,,,,49,43,92
HND-000504,2011,10700011,,,,9,7,16
HND-000506,2011,10700013,,,,28,26,54
HND-000508,2011,10700015,,,,6,7,13
HND-000509,2011,10700016,,,,1,11,12
HND-000510,2011,10700017,,,,33,48,81
HND-000513,2011,10700020,,,,11,12,23
HND-000516,2011,10700023,,,,12,16,28
HND-000518,2011,10700025,,,,3,4,7
HND-000519,2011,10700026,,,,4,1,5
HND-000521,2011,10700028,,,,15,13,28
HND-000522,2011,10700029,,,,8,4,12
,2011,10700032,,,,9,3,12
HND-000527,2011,10700034,,,,13,12,25
HND-000528,2011,10700035,,,,3,1,4
HND-000529,2011,10700036,,,,3,6,9
HND-000530,2011,10700037,,,,9,10,19
HND-000534,2011,10700041,,,,14,3,17
HND-000539,2011,10700046,,,,3,4,7
HND-000541,2011,10700048,,,,2,1,3
HND-000544,2011,10700051,,,,1,3,4
HND-000548,2011,10700055,,,,1,3,4
HND-000550,2011,10700057,,,,5,3,8
HND-000551,2011,10700058,,,,4,2,6
HND-000553,2011,10700060,,,,1,5,6
HND-000554,2011,10700062,,,,3,3,6
HND-000555,2011,10700063,,,,11,13,24
HND-000556,2011,10700064,,,,2,4,6
HND-000565,2011,10700074,,,,3,5,8
HND-000566,2011,10700075,,,,2,7,9
HND-000567,2011,10700076,,,,1,1,2
HND-000568,2011,10700077,,,,1,3,4
HND-000573,2011,10700082,,,,4,7,11
HND-000575,2011,10700084,,,,3,4,7
HND-000576,2011,10700085,,,,1,3,4
HND-000577,2011,10700086,,,,14,12,26
HND-000578,2011,10700087,,,,4,6,10
HND-000581,2011,10700090,,,,7,8,15
HND-000582,2011,10700091,,,,3,0,3
HND-000583,2011,10700092,,,,3,3,6
HND-000584,2011,10700093,,,,4,3,7
HND-000589,2011,10700098,,,,6,4,10
HND-000590,2011,10700099,,,,5,4,9
HND-000593,2011,10700103,,,,1,0,1
HND-000599,2011,10700109,,,,14,20,34
HND-000601,2011,10700111,,,,21,14,35
,2011,10700112,,,,3,3,6
,2011,10700113,,,,7,4,11
HND-000606,2011,10700118,,,,1,1,2
HND-000607,2011,10700119,,,,0,2,2
HND-000611,2011,10700126,,,,13,17,30
,2011,10700128,,,,5,12,17
,2011,10700129,,,,7,12,19
,2011,10700130,,,,3,3,6
,2011,10700133,,,,30,35,65
,2011,10700144,,,,2,0,2
HND-000622,2011,10700149,,,,7,6,13
HND-000625,2011,10700159,,,,14,3,17
,2011,10700160,,,,4,1,5
HND-000626,2011,10700161,,,,3,1,4
HND-000630,2011,10700167,,,,6,3,9
HND-000633,2011,10700172,,,,0,10,10
HND-000637,2011,10700194,,,,3,3,6
HND-000639,2011,10700199,,,,3,1,4
,2011,10700201,,,,6,0,6
,2011,10700206,,,,5,5,10
HND-000644,2011,10700215,,,,5,1,6
HND-000646,2011,10700218,,,,3,4,7
HND-000647,2011,10700219,,,,6,10,16
HND-000648,2011,10700220,,,,9,10,19
HND-000655,2011,10700248,,,,4,4,8
HND-000501,2011,10700008,,,,3,1,4
HND-000503,2011,10700010,,,,33,43,76
HND-000504,2011,10700011,,,,10,15,25
HND-000505,2011,10700012,,,,21,23,44
HND-000506,2011,10700013,,,,34,22,56
HND-000508,2011,10700015,,,,10,11,21
HND-000509,2011,10700016,,,,1,1,2
HND-000510,2011,10700017,,,,42,41,83
HND-000511,2011,10700018,,,,20,31,51
HND-000513,2011,10700020,,,,4,10,14
HND-000515,2011,10700022,,,,69,77,146
HND-000516,2011,10700023,,,,21,22,43
HND-000522,2011,10700029,,,,8,6,14
HND-000528,2011,10700035,,,,9,5,14
HND-000529,2011,10700036,,,,11,7,18
HND-000530,2011,10700037,,,,7,7,14
HND-000531,2011,10700038,,,,11,8,19
HND-000533,2011,10700040,,,,13,13,26
HND-000534,2011,10700041,,,,6,6,12
HND-000535,2011,10700042,,,,4,5,9
HND-000536,2011,10700043,,,,4,4,8
,2011,10700045,,,,1,2,3
HND-000540,2011,10700047,,,,27,30,57
HND-000541,2011,10700048,,,,3,0,3
HND-000542,2011,10700049,,,,2,4,6
HND-000543,2011,10700050,,,,4,2,6
HND-000545,2011,10700052,,,,4,4,8
HND-000546,2011,10700053,,,,21,15,36
HND-000551,2011,10700058,,,,5,0,5
HND-000552,2011,10700059,,,,7,6,13
HND-000556,2011,10700064,,,,1,0,1
HND-000557,2011,10700065,,,,18,11,29
HND-000558,2011,10700066,,,,2,5,7
HND-000559,2011,10700067,,,,2,2,4
HND-000561,2011,10700070,,,,15,9,24
HND-000562,2011,10700071,,,,0,1,1
HND-000566,2011,10700075,,,,3,4,7
HND-000567,2011,10700076,,,,1,1,2
HND-000569,2011,10700078,,,,3,2,5
HND-000576,2011,10700085,,,,1,0,1
HND-000577,2011,10700086,,,,17,14,31
HND-000578,2011,10700087,,,,4,3,7
HND-000579,2011,10700088,,,,0,2,2
HND-000581,2011,10700090,,,,13,8,21
HND-000583,2011,10700092,,,,2,3,5
HND-000584,2011,10700093,,,,1,1,2
HND-000585,2011,10700094,,,,4,0,4
HND-000590,2011,10700099,,,,8,4,12
HND-000593,2011,10700103,,,,2,0,2
HND-000594,2011,10700104,,,,0,4,4
HND-000598,2011,10700108,,,,0,1,1
HND-000599,2011,10700109,,,,16,14,30
HND-000600,2011,10700110,,,,26,30,56
HND-000601,2011,10700111,,,,15,14,29
HND-000607,2011,10700119,,,,1,1,2
HND-000608,2011,10700121,,,,3,5,8
HND-000609,2011,10700124,,,,2,5,7
HND-000611,2011,10700126,,,,12,17,29
HND-000612,2011,10700127,,,,13,7,20
,2011,10700133,,,,38,39,77
,2011,10700144,,,,3,3,6
HND-000622,2011,10700149,,,,5,6,11
HND-000625,2011,10700159,,,,8,6,14
,2011,10700160,,,,0,1,1
HND-000626,2011,10700161,,,,1,1,2
HND-000630,2011,10700167,,,,2,3,5
,2011,10700179,,,,5,11,16
HND-000639,2011,10700199,,,,1,1,2
,2011,10700201,,,,0,1,1
HND-000642,2011,10700213,,,,0,5,5
HND-000643,2011,10700214,,,,2,2,4
HND-000644,2011,10700215,,,,1,2,3
HND-000645,2011,10700217,,,,2,4,6
HND-000647,2011,10700219,,,,4,8,12
HND-000648,2011,10700220,,,,5,6,11
HND-000497,2011,10700003,,,,24,30,54
HND-000499,2011,10700005,,,,3,7,10
HND-000500,2011,10700007,,,,3,6,9
HND-000502,2011,10700009,,,,26,25,51
HND-000507,2011,10700014,,,,15,22,37
HND-000512,2011,10700019,,,,12,1,13
HND-000514,2011,10700021,,,,2,3,5
HND-000517,2011,10700024,,,,9,12,21
HND-000518,2011,10700025,,,,5,2,7
HND-000519,2011,10700026,,,,1,6,7
HND-000520,2011,10700027,,,,5,1,6
HND-000521,2011,10700028,,,,19,27,46
HND-000523,2011,10700030,,,,5,5,10
HND-000524,2011,10700031,,,,3,2,5
,2011,10700032,,,,3,0,3
HND-000526,2011,10700033,,,,9,6,15
HND-000527,2011,10700034,,,,14,15,29
HND-000532,2011,10700039,,,,3,3,6
HND-000537,2011,10700044,,,,2,3,5
HND-000539,2011,10700046,,,,3,4,7
HND-000547,2011,10700054,,,,1,0,1
HND-000548,2011,10700055,,,,0,3,3
HND-000549,2011,10700056,,,,12,11,23
HND-000550,2011,10700057,,,,6,6,12
HND-000553,2011,10700060,,,,6,1,7
HND-000554,2011,10700062,,,,8,7,15
HND-000555,2011,10700063,,,,7,11,18
HND-000560,2011,10700068,,,,0,5,5
HND-000564,2011,10700073,,,,5,3,8
HND-000565,2011,10700074,,,,0,3,3
HND-000568,2011,10700077,,,,3,1,4
HND-000570,2011,10700079,,,,2,4,6
HND-000571,2011,10700080,,,,2,5,7
HND-000572,2011,10700081,,,,8,7,15
HND-000573,2011,10700082,,,,1,4,5
HND-000574,2011,10700083,,,,0,1,1
HND-000575,2011,10700084,,,,3,2,5
HND-000580,2011,10700089,,,,1,1,2
HND-000582,2011,10700091,,,,2,3,5
HND-000586,2011,10700095,,,,1,0,1
HND-000587,2011,10700096,,,,3,8,11
HND-000588,2011,10700097,,,,0,1,1
HND-000589,2011,10700098,,,,4,6,10
HND-000591,2011,10700100,,,,2,3,5
HND-000595,2011,10700105,,,,2,2,4
HND-000596,2011,10700106,,,,10,7,17
HND-000597,2011,10700107,,,,2,2,4
,2011,10700112,,,,8,2,10
,2011,10700113,,,,8,3,11
HND-000603,2011,10700115,,,,6,5,11
HND-000604,2011,10700116,,,,5,2,7
HND-000605,2011,10700117,,,,1,4,5
HND-000606,2011,10700118,,,,8,0,8
,2011,10700122,,,,5,0,5
HND-000610,2011,10700125,,,,0,1,1
,2011,10700128,,,,7,7,14
,2011,10700129,,,,11,13,24
,2011,10700130,,,,3,5,8
HND-000614,2011,10700132,,,,1,1,2
,2011,10700157,,,,19,24,43
,2011,10700162,,,,6,4,10
,2011,10700164,,,,8,9,17
HND-000633,2011,10700172,,,,6,3,9
HND-000635,2011,10700183,,,,2,3,5
HND-000636,2011,10700190,,,,20,20,40
HND-000637,2011,10700194,,,,3,0,3
HND-000638,2011,10700195,,,,19,19,38
,2011,10700206,,,,3,3,6
HND-000646,2011,10700218,,,,2,1,3
HND-000655,2011,10700248,,,,4,4,8
HND-000511,2011,10700018,,,,20,29,49
HND-000523,2011,10700030,,,,4,7,11
HND-000531,2011,10700038,,,,10,16,26
HND-000537,2011,10700044,,,,16,14,30
HND-000540,2011,10700047,,,,28,31,59
HND-000561,2011,10700070,,,,4,10,14
HND-000600,2011,10700110,,,,33,41,74
HND-000612,2011,10700127,,,,4,10,14
,2011,10700129,,,,14,9,23
,2011,10700164,,,,13,6,19
,2011,10700201,,,,3,2,5
,2011,10700211,,,,21,34,55
,2011,10700212,,,,17,9,26
HND-000497,2011,10700003,,,,41,39,80
HND-000502,2011,10700009,,,,17,23,40
HND-000504,2011,10700011,,,,8,16,24
HND-000506,2011,10700013,,,,28,37,65
HND-000510,2011,10700017,,,,50,34,84
HND-000527,2011,10700034,,,,11,16,27
HND-000534,2011,10700041,,,,16,15,31
HND-000555,2011,10700063,,,,8,16,24
HND-000599,2011,10700109,,,,17,18,35
,2011,10700140,,,,44,35,79
,2011,10700165,,,,37,23,60
HND-000629,2011,10700166,,,,74,86,160
HND-000631,2011,10700168,,,,146,190,336
,2011,10700173,,,,175,139,314
,2011,10700179,,,,4,8,12
,2011,10700180,,,,44,53,97
,2011,10700206,,,,13,19,32
HND-000497,2011,10700003,,,,27,34,61
HND-000502,2011,10700009,,,,24,20,44
HND-000523,2011,10700030,,,,5,5,10
HND-000527,2011,10700034,,,,17,22,39
HND-000537,2011,10700044,,,,8,13,21
HND-000555,2011,10700063,,,,6,13,19
HND-000561,2011,10700070,,,,7,8,15
,2011,10700164,,,,4,12,16
HND-000631,2011,10700168,,,,145,150,295
,2011,10700173,,,,134,167,301
,2011,10700180,,,,44,51,95
,2011,10700206,,,,11,14,25
,2011,10700211,,,,13,28,41
HND-000504,2011,10700011,,,,12,14,26
HND-000506,2011,10700013,,,,15,21,36
HND-000510,2011,10700017,,,,28,33,61
HND-000511,2011,10700018,,,,18,28,46
HND-000531,2011,10700038,,,,11,11,22
HND-000534,2011,10700041,,,,13,15,28
HND-000540,2011,10700047,,,,16,25,41
HND-000599,2011,10700109,,,,21,18,39
HND-000600,2011,10700110,,,,35,32,67
HND-000612,2011,10700127,,,,7,10,17
,2011,10700129,,,,9,12,21
,2011,10700140,,,,27,36,63
,2011,10700165,,,,23,26,49
HND-000629,2011,10700166,,,,57,70,127
,2011,10700179,,,,1,3,4
,2011,10700212,,,,17,6,23
HND-000497,2011,10700003,,,,21,44,65
HND-000523,2011,10700030,,,,2,4,6
HND-000531,2011,10700038,,,,11,12,23
HND-000537,2011,10700044,,,,15,19,34
HND-000540,2011,10700047,,,,16,18,34
HND-000555,2011,10700063,,,,3,8,11
HND-000561,2011,10700070,,,,7,5,12
HND-000612,2011,10700127,,,,5,3,8
,2011,10700140,,,,30,21,51
,2011,10700165,,,,13,24,37
HND-000629,2011,10700166,,,,39,54,93
HND-000631,2011,10700168,,,,117,111,228
,2011,10700206,,,,13,10,23
HND-000502,2011,10700009,,,,19,14,33
HND-000504,2011,10700011,,,,4,19,23
HND-000506,2011,10700013,,,,13,12,25
HND-000510,2011,10700017,,,,25,25,50
HND-000511,2011,10700018,,,,9,23,32
HND-000527,2011,10700034,,,,8,13,21
HND-000534,2011,10700041,,,,13,10,23
HND-000599,2011,10700109,,,,18,14,32
HND-000600,2011,10700110,,,,19,29,48
,2011,10700129,,,,12,12,24
,2011,10700164,,,,9,14,23
,2011,10700173,,,,126,169,295
,2011,10700179,,,,3,4,7
,2011,10700180,,,,39,55,94
,2011,10700211,,,,9,15,24
,2011,10700212,,,,10,9,19
HND-000627,2011,10700163,,,,143,268,411
,2011,10700165,,,,12,1,13
HND-000629,2011,10700166,,,,22,42,64
,2011,10700173,,,,289,351,640
,2011,10700180,,,,39,46,85
,2011,10700206,,,,10,11,21
,2011,10700211,,,,3,15,18
,2011,10700129,,,,6,6,12
,2011,10700140,,,,70,73,143
,2011,10700164,,,,6,13,19
HND-000631,2011,10700168,,,,71,93,164
,2011,10700179,,,,2,4,6
,2011,10700212,,,,8,20,28
,2011,10700129,,,,5,10,15
,2011,10700164,,,,8,4,12
,2011,10700173,,,,156,272,428
,2011,10700179,,,,4,3,7
,2011,10700180,,,,26,29,55
,2011,10700206,,,,16,20,36
,2011,10700140,,,,67,57,124
HND-000627,2011,10700163,,,,124,336,460
,2011,10700165,,,,4,1,5
HND-000629,2011,10700166,,,,24,44,68
HND-000631,2011,10700168,,,,57,72,129
,2011,10700212,,,,5,8,13
,2011,10700140,,,,36,57,93
HND-000627,2011,10700163,,,,99,264,363
,2011,10700165,,,,13,0,13
HND-000629,2011,10700166,,,,21,39,60
,2011,10700212,,,,0,4,4
HND-000631,2011,10700168,,,,35,51,86
,2011,10700173,,,,129,204,333
,2011,10700180,,,,5,15,20
,2011,10700206,,,,5,6,11
HND-000702,2011,10800049,,,,8,7,15
HND-000705,2011,10800057,,,,1,2,3
HND-000708,2011,10800066,,,,4,3,7
,2011,10800067,,,,6,2,8
,2011,10800075,,,,2,2,4
,2011,10800076,,,,3,1,4
HND-000713,2011,10800077,,,,4,3,7
,2011,10800078,,,,4,11,15
,2011,10800084,,,,8,2,10
,2011,10800085,,,,9,6,15
,2011,10800052,,,,5,6,11
,2011,10800062,,,,1,4,5
,2011,10800068,,,,3,7,10
HND-000709,2011,10800069,,,,7,8,15
,2011,10800070,,,,3,2,5
,2011,10800074,,,,2,3,5
HND-000714,2011,10800079,,,,2,3,5
,2011,10800080,,,,6,2,8
,2011,10800081,,,,6,3,9
HND-000715,2011,10800082,,,,5,3,8
,2011,10800083,,,,3,3,6
HND-000700,2011,10800047,,,,1,3,4
,2011,10800050,,,,8,12,20
,2011,10800059,,,,2,3,5
,2011,10800060,,,,5,3,8
HND-000706,2011,10800061,,,,2,0,2
HND-000707,2011,10800063,,,,1,6,7
,2011,10800065,,,,2,4,6
,2011,10800073,,,,2,3,5
HND-000688,2011,10800034,,,,8,9,17
HND-000691,2011,10800037,,,,12,17,29
HND-000686,2011,10800032,,,,8,14,22
HND-000687,2011,10800033,,,,20,31,51
HND-000688,2011,10800034,,,,19,14,33
HND-000691,2011,10800037,,,,20,19,39
,2011,10800039,,,,14,9,23
HND-000701,2011,10800048,,,,8,2,10
,2011,10800060,,,,2,6,8
HND-000706,2011,10800061,,,,8,5,13
HND-000707,2011,10800063,,,,2,6,8
HND-000689,2011,10800035,,,,9,9,18
HND-000690,2011,10800036,,,,14,10,24
HND-000692,2011,10800038,,,,15,20,35
HND-000697,2011,10800044,,,,14,7,21
HND-000700,2011,10800047,,,,5,3,8
,2011,10800050,,,,7,8,15
,2011,10800059,,,,4,4,8
,2011,10800065,,,,3,4,7
,2011,10800073,,,,6,4,10
HND-000656,2011,10800001,,,,4,1,5
HND-000657,2011,10800002,,,,3,3,6
HND-000658,2011,10800003,,,,0,5,5
HND-000663,2011,10800008,,,,3,7,10
HND-000664,2011,10800009,,,,2,3,5
HND-000665,2011,10800010,,,,2,3,5
HND-000667,2011,10800012,,,,3,1,4
HND-000668,2011,10800013,,,,3,1,4
HND-000669,2011,10800014,,,,46,34,80
HND-000671,2011,10800016,,,,30,18,48
HND-000674,2011,10800019,,,,6,7,13
HND-000675,2011,10800020,,,,13,10,23
HND-000676,2011,10800021,,,,13,21,34
HND-000677,2011,10800022,,,,6,2,8
HND-000678,2011,10800023,,,,14,12,26
HND-000679,2011,10800024,,,,10,20,30
HND-000683,2011,10800029,,,,6,5,11
HND-000684,2011,10800030,,,,2,4,6
HND-000685,2011,10800031,,,,19,3,22
,2011,10800043,,,,18,32,50
HND-000699,2011,10800046,,,,1,2,3
HND-000704,2011,10800056,,,,1,6,7
HND-000705,2011,10800057,,,,4,1,5
HND-000712,2011,10800072,,,,2,1,3
HND-000659,2011,10800004,,,,6,1,7
HND-000660,2011,10800005,,,,3,10,13
HND-000661,2011,10800006,,,,8,8,16
HND-000662,2011,10800007,,,,26,23,49
HND-000666,2011,10800011,,,,1,2,3
HND-000670,2011,10800015,,,,7,12,19
HND-000672,2011,10800017,,,,23,27,50
HND-000673,2011,10800018,,,,9,13,22
HND-000680,2011,10800025,,,,8,4,12
HND-000681,2011,10800026,,,,1,1,2
HND-000682,2011,10800027,,,,13,9,22
HND-000711,2011,10800071,,,,1,3,4
HND-000716,2011,10800087,,,,5,2,7
HND-000656,2011,10800001,,,,3,2,5
HND-000660,2011,10800005,,,,4,5,9
HND-000661,2011,10800006,,,,7,6,13
HND-000662,2011,10800007,,,,23,25,48
HND-000663,2011,10800008,,,,3,5,8
HND-000665,2011,10800010,,,,2,3,5
HND-000666,2011,10800011,,,,2,3,5
HND-000667,2011,10800012,,,,4,2,6
HND-000668,2011,10800013,,,,4,3,7
HND-000669,2011,10800014,,,,39,38,77
HND-000673,2011,10800018,,,,9,9,18
HND-000674,2011,10800019,,,,10,8,18
HND-000675,2011,10800020,,,,8,8,16
HND-000676,2011,10800021,,,,12,18,30
HND-000677,2011,10800022,,,,4,5,9
HND-000678,2011,10800023,,,,14,12,26
HND-000683,2011,10800029,,,,7,8,15
HND-000684,2011,10800030,,,,1,5,6
HND-000704,2011,10800056,,,,3,2,5
HND-000711,2011,10800071,,,,2,0,2
HND-000716,2011,10800087,,,,0,5,5
HND-000657,2011,10800002,,,,7,6,13
HND-000658,2011,10800003,,,,3,2,5
HND-000659,2011,10800004,,,,2,4,6
HND-000664,2011,10800009,,,,5,2,7
HND-000670,2011,10800015,,,,3,2,5
HND-000671,2011,10800016,,,,27,26,53
HND-000672,2011,10800017,,,,23,24,47
HND-000679,2011,10800024,,,,11,10,21
HND-000680,2011,10800025,,,,5,4,9
HND-000681,2011,10800026,,,,4,2,6
HND-000682,2011,10800027,,,,8,12,20
HND-000685,2011,10800031,,,,18,8,26
HND-000699,2011,10800046,,,,1,3,4
HND-000712,2011,10800072,,,,3,0,3
HND-000656,2011,10800001,,,,1,0,1
HND-000657,2011,10800002,,,,4,4,8
HND-000658,2011,10800003,,,,1,1,2
HND-000663,2011,10800008,,,,9,0,9
HND-000664,2011,10800009,,,,1,1,2
HND-000665,2011,10800010,,,,1,0,1
HND-000666,2011,10800011,,,,2,0,2
HND-000667,2011,10800012,,,,1,1,2
HND-000668,2011,10800013,,,,5,8,13
HND-000669,2011,10800014,,,,33,33,66
HND-000671,2011,10800016,,,,39,32,71
HND-000674,2011,10800019,,,,10,10,20
HND-000675,2011,10800020,,,,13,18,31
HND-000676,2011,10800021,,,,16,15,31
HND-000677,2011,10800022,,,,8,2,10
HND-000678,2011,10800023,,,,18,17,35
HND-000683,2011,10800029,,,,7,7,14
HND-000704,2011,10800056,,,,1,1,2
HND-000711,2011,10800071,,,,4,6,10
HND-000716,2011,10800087,,,,1,4,5
HND-000659,2011,10800004,,,,7,2,9
HND-000660,2011,10800005,,,,6,6,12
HND-000661,2011,10800006,,,,4,3,7
HND-000662,2011,10800007,,,,25,27,52
HND-000670,2011,10800015,,,,3,3,6
HND-000672,2011,10800017,,,,18,24,42
HND-000673,2011,10800018,,,,16,12,28
HND-000679,2011,10800024,,,,20,15,35
HND-000680,2011,10800025,,,,7,4,11
HND-000681,2011,10800026,,,,2,0,2
HND-000682,2011,10800027,,,,11,8,19
HND-000684,2011,10800030,,,,4,5,9
HND-000685,2011,10800031,,,,15,11,26
,2011,10800043,,,,16,31,47
HND-000699,2011,10800046,,,,3,0,3
HND-000705,2011,10800057,,,,1,1,2
HND-000712,2011,10800072,,,,0,1,1
HND-000656,2011,10800001,,,,0,1,1
HND-000660,2011,10800005,,,,2,5,7
HND-000661,2011,10800006,,,,9,9,18
HND-000662,2011,10800007,,,,21,21,42
HND-000663,2011,10800008,,,,2,5,7
HND-000665,2011,10800010,,,,2,2,4
HND-000666,2011,10800011,,,,2,1,3
HND-000669,2011,10800014,,,,34,41,75
HND-000670,2011,10800015,,,,5,1,6
HND-000673,2011,10800018,,,,19,17,36
HND-000675,2011,10800020,,,,14,11,25
HND-000676,2011,10800021,,,,17,26,43
HND-000680,2011,10800025,,,,9,4,13
HND-000681,2011,10800026,,,,1,2,3
HND-000684,2011,10800030,,,,4,2,6
HND-000685,2011,10800031,,,,13,13,26
HND-000699,2011,10800046,,,,1,1,2
HND-000704,2011,10800056,,,,4,3,7
HND-000705,2011,10800057,,,,2,0,2
HND-000716,2011,10800087,,,,4,6,10
HND-000657,2011,10800002,,,,5,2,7
HND-000658,2011,10800003,,,,1,6,7
HND-000659,2011,10800004,,,,2,7,9
HND-000664,2011,10800009,,,,7,3,10
HND-000667,2011,10800012,,,,2,0,2
HND-000668,2011,10800013,,,,3,6,9
HND-000671,2011,10800016,,,,46,34,80
HND-000672,2011,10800017,,,,26,27,53
HND-000674,2011,10800019,,,,7,7,14
HND-000677,2011,10800022,,,,6,5,11
HND-000678,2011,10800023,,,,31,25,56
HND-000679,2011,10800024,,,,7,11,18
HND-000682,2011,10800027,,,,8,15,23
HND-000683,2011,10800029,,,,7,1,8
HND-000711,2011,10800071,,,,2,1,3
HND-000712,2011,10800072,,,,3,1,4
HND-000659,2011,10800004,,,,3,0,3
HND-000660,2011,10800005,,,,3,1,4
HND-000661,2011,10800006,,,,7,3,10
HND-000662,2011,10800007,,,,17,30,47
HND-000666,2011,10800011,,,,4,0,4
HND-000670,2011,10800015,,,,2,2,4
HND-000672,2011,10800017,,,,23,23,46
HND-000673,2011,10800018,,,,11,15,26
HND-000676,2011,10800021,,,,20,7,27
HND-000680,2011,10800025,,,,2,3,5
HND-000681,2011,10800026,,,,2,4,6
HND-000682,2011,10800027,,,,14,9,23
HND-000684,2011,10800030,,,,2,10,12
HND-000685,2011,10800031,,,,19,14,33
HND-000699,2011,10800046,,,,2,1,3
HND-000704,2011,10800056,,,,9,15,24
HND-000705,2011,10800057,,,,2,3,5
HND-000656,2011,10800001,,,,1,1,2
HND-000657,2011,10800002,,,,2,6,8
HND-000658,2011,10800003,,,,2,2,4
HND-000663,2011,10800008,,,,4,3,7
HND-000664,2011,10800009,,,,3,0,3
HND-000665,2011,10800010,,,,1,2,3
HND-000667,2011,10800012,,,,2,1,3
HND-000668,2011,10800013,,,,4,5,9
HND-000669,2011,10800014,,,,43,59,102
HND-000671,2011,10800016,,,,25,27,52
HND-000674,2011,10800019,,,,9,11,20
HND-000675,2011,10800020,,,,18,18,36
HND-000677,2011,10800022,,,,4,6,10
HND-000678,2011,10800023,,,,15,12,27
HND-000679,2011,10800024,,,,13,11,24
HND-000683,2011,10800029,,,,3,6,9
HND-000711,2011,10800071,,,,3,10,13
HND-000712,2011,10800072,,,,2,0,2
HND-000716,2011,10800087,,,,0,3,3
HND-000657,2011,10800002,,,,4,6,10
HND-000658,2011,10800003,,,,4,1,5
HND-000659,2011,10800004,,,,3,6,9
HND-000664,2011,10800009,,,,5,2,7
HND-000670,2011,10800015,,,,2,0,2
HND-000671,2011,10800016,,,,33,24,57
HND-000672,2011,10800017,,,,26,25,51
HND-000679,2011,10800024,,,,7,13,20
HND-000680,2011,10800025,,,,11,7,18
HND-000681,2011,10800026,,,,1,2,3
HND-000682,2011,10800027,,,,12,8,20
HND-000685,2011,10800031,,,,8,20,28
HND-000712,2011,10800072,,,,1,3,4
HND-000656,2011,10800001,,,,0,1,1
HND-000660,2011,10800005,,,,6,7,13
HND-000661,2011,10800006,,,,7,4,11
HND-000662,2011,10800007,,,,17,17,34
HND-000663,2011,10800008,,,,5,4,9
HND-000665,2011,10800010,,,,5,2,7
HND-000666,2011,10800011,,,,2,1,3
HND-000667,2011,10800012,,,,6,4,10
HND-000668,2011,10800013,,,,4,1,5
HND-000669,2011,10800014,,,,31,29,60
HND-000673,2011,10800018,,,,15,18,33
HND-000674,2011,10800019,,,,4,11,15
HND-000675,2011,10800020,,,,11,15,26
HND-000676,2011,10800021,,,,18,21,39
HND-000677,2011,10800022,,,,1,4,5
HND-000678,2011,10800023,,,,17,18,35
HND-000683,2011,10800029,,,,2,4,6
HND-000684,2011,10800030,,,,1,2,3
,2011,10800043,,,,19,22,41
HND-000704,2011,10800056,,,,3,2,5
HND-000705,2011,10800057,,,,13,15,28
HND-000711,2011,10800071,,,,3,3,6
HND-000716,2011,10800087,,,,2,4,6
HND-000675,2011,10800020,,,,13,23,36
HND-000678,2011,10800023,,,,17,15,32
HND-000679,2011,10800024,,,,12,8,20
HND-000695,2011,10800041,,,,26,39,65
HND-000696,2011,10800042,,,,35,60,95
HND-000662,2011,10800007,,,,15,12,27
HND-000676,2011,10800021,,,,13,7,20
HND-000694,2011,10800040,,,,53,44,97
,2011,10800043,,,,52,70,122
HND-000662,2011,10800007,,,,14,19,33
HND-000675,2011,10800020,,,,6,12,18
HND-000676,2011,10800021,,,,8,20,28
HND-000678,2011,10800023,,,,7,13,20
HND-000694,2011,10800040,,,,39,63,102
HND-000695,2011,10800041,,,,26,32,58
,2011,10800043,,,,34,45,79
HND-000679,2011,10800024,,,,7,9,16
HND-000696,2011,10800042,,,,32,46,78
HND-000662,2011,10800007,,,,10,11,21
HND-000675,2011,10800020,,,,12,12,24
HND-000676,2011,10800021,,,,5,15,20
HND-000678,2011,10800023,,,,13,13,26
HND-000694,2011,10800040,,,,33,57,90
HND-000679,2011,10800024,,,,9,12,21
HND-000695,2011,10800041,,,,25,28,53
HND-000696,2011,10800042,,,,35,39,74
,2011,10800043,,,,25,38,63
HND-000694,2011,10800040,,,,22,47,69
HND-000695,2011,10800041,,,,26,23,49
,2011,10800043,,,,50,123,173
HND-000696,2011,10800042,,,,24,33,57
HND-000695,2011,10800041,,,,19,21,40
HND-000696,2011,10800042,,,,23,23,46
,2011,10800043,,,,29,72,101
HND-000694,2011,10800040,,,,20,28,48
HND-000696,2011,10800042,,,,13,11,24
HND-000694,2011,10800040,,,,18,24,42
HND-000695,2011,10800041,,,,8,19,27
,2011,20100153,,,,4,7,11
HND-000825,2011,20100154,,,,4,5,9
,2011,20100159,,,,9,5,14
,2011,20100161,,,,3,6,9
HND-000827,2011,20100164,,,,6,5,11
,2011,20100166,,,,6,6,12
,2011,20100167,,,,4,8,12
HND-000830,2011,20100170,,,,5,7,12
HND-000832,2011,20100172,,,,15,12,27
,2011,20100173,,,,7,5,12
,2011,20100178,,,,7,10,17
HND-000834,2011,20100180,,,,7,8,15
HND-000835,2011,20100181,,,,8,4,12
,2011,20100200,,,,14,20,34
HND-000852,2011,20100211,,,,6,5,11
,2011,20100155,,,,6,4,10
,2011,20100156,,,,3,7,10
,2011,20100157,,,,5,6,11
,2011,20100158,,,,6,4,10
,2011,20100160,,,,6,4,10
,2011,20100162,,,,6,5,11
HND-000826,2011,20100163,,,,14,13,27
HND-000828,2011,20100165,,,,8,8,16
HND-000829,2011,20100168,,,,2,7,9
HND-000831,2011,20100171,,,,6,4,10
,2011,20100174,,,,7,4,11
HND-000833,2011,20100175,,,,12,10,22
,2011,20100176,,,,15,20,35
,2011,20100196,,,,6,5,11
HND-000846,2011,20100197,,,,10,10,20
HND-000847,2011,20100198,,,,11,10,21
HND-000849,2011,20100208,,,,6,9,15
HND-000850,2011,20100209,,,,6,6,12
,2011,20100216,,,,4,3,7
HND-000773,2011,20100067,,,,4,4,8
HND-000774,2011,20100068,,,,2,1,3
HND-000781,2011,20100077,,,,1,1,2
HND-000785,2011,20100083,,,,4,7,11
HND-000789,2011,20100089,,,,4,6,10
HND-000800,2011,20100100,,,,1,1,2
HND-000802,2011,20100102,,,,4,3,7
HND-000806,2011,20100106,,,,1,1,2
HND-000812,2011,20100114,,,,1,1,2
HND-000828,2011,20100165,,,,0,1,1
HND-000838,2011,20100184,,,,0,1,1
HND-000844,2011,20100192,,,,0,2,2
,2011,20100205,,,,3,3,6
HND-000848,2011,20100206,,,,2,2,4
,2011,20100207,,,,2,2,4
,2011,20100048,,,,2,4,6
,2011,20100063,,,,4,3,7
HND-000770,2011,20100064,,,,14,15,29
HND-000771,2011,20100065,,,,15,8,23
HND-000772,2011,20100066,,,,3,4,7
HND-000776,2011,20100072,,,,2,5,7
HND-000782,2011,20100079,,,,1,2,3
HND-000787,2011,20100086,,,,4,3,7
HND-000791,2011,20100091,,,,1,0,1
HND-000797,2011,20100097,,,,6,4,10
HND-000798,2011,20100098,,,,0,1,1
HND-000803,2011,20100103,,,,0,3,3
HND-000819,2011,20100122,,,,3,1,4
HND-000837,2011,20100183,,,,6,7,13
,2011,20100204,,,,2,1,3
,2011,20100047,,,,1,2,3
,2011,20100063,,,,0,3,3
HND-000770,2011,20100064,,,,17,16,33
HND-000774,2011,20100068,,,,3,4,7
,2011,20100069,,,,14,12,26
,2011,20100070,,,,2,1,3
HND-000775,2011,20100071,,,,29,18,47
HND-000779,2011,20100075,,,,2,7,9
HND-000780,2011,20100076,,,,5,7,12
HND-000781,2011,20100077,,,,2,9,11
HND-000786,2011,20100084,,,,3,6,9
HND-000787,2011,20100086,,,,5,5,10
HND-000788,2011,20100087,,,,7,6,13
HND-000796,2011,20100096,,,,6,9,15
HND-000797,2011,20100097,,,,2,1,3
HND-000816,2011,20100118,,,,11,7,18
HND-000819,2011,20100122,,,,3,2,5
HND-000822,2011,20100126,,,,3,1,4
HND-000828,2011,20100165,,,,4,5,9
HND-000838,2011,20100184,,,,6,3,9
,2011,20100203,,,,2,2,4
,2011,20100205,,,,3,8,11
HND-000848,2011,20100206,,,,2,6,8
,2011,20100048,,,,5,6,11
HND-000771,2011,20100065,,,,16,13,29
HND-000772,2011,20100066,,,,9,7,16
HND-000773,2011,20100067,,,,7,5,12
HND-000776,2011,20100072,,,,9,5,14
HND-000777,2011,20100073,,,,8,5,13
HND-000778,2011,20100074,,,,3,2,5
HND-000782,2011,20100079,,,,3,1,4
HND-000783,2011,20100080,,,,9,10,19
HND-000784,2011,20100081,,,,3,6,9
HND-000785,2011,20100083,,,,9,8,17
HND-000789,2011,20100089,,,,11,15,26
HND-000790,2011,20100090,,,,10,5,15
HND-000791,2011,20100091,,,,2,3,5
HND-000798,2011,20100098,,,,1,1,2
HND-000799,2011,20100099,,,,3,0,3
HND-000800,2011,20100100,,,,2,3,5
HND-000802,2011,20100102,,,,13,23,36
HND-000803,2011,20100103,,,,2,4,6
HND-000806,2011,20100106,,,,1,1,2
HND-000812,2011,20100114,,,,4,4,8
HND-000814,2011,20100116,,,,2,2,4
HND-000837,2011,20100183,,,,8,5,13
HND-000844,2011,20100192,,,,6,4,10
,2011,20100204,,,,4,3,7
,2011,20100207,,,,1,1,2
,2011,20100048,,,,1,5,6
,2011,20100063,,,,5,8,13
HND-000771,2011,20100065,,,,13,17,30
HND-000773,2011,20100067,,,,17,9,26
HND-000776,2011,20100072,,,,12,10,22
HND-000777,2011,20100073,,,,11,8,19
HND-000782,2011,20100079,,,,8,5,13
HND-000783,2011,20100080,,,,13,13,26
HND-000784,2011,20100081,,,,5,9,14
HND-000785,2011,20100083,,,,8,13,21
HND-000789,2011,20100089,,,,22,14,36
HND-000790,2011,20100090,,,,15,17,32
HND-000791,2011,20100091,,,,12,17,29
HND-000796,2011,20100096,,,,21,16,37
HND-000798,2011,20100098,,,,5,7,12
HND-000800,2011,20100100,,,,4,2,6
HND-000802,2011,20100102,,,,33,30,63
HND-000806,2011,20100106,,,,9,7,16
HND-000812,2011,20100114,,,,3,7,10
HND-000828,2011,20100165,,,,4,6,10
HND-000837,2011,20100183,,,,23,17,40
HND-000844,2011,20100192,,,,2,3,5
,2011,20100204,,,,1,1,2
,2011,20100047,,,,2,4,6
HND-000770,2011,20100064,,,,21,21,42
HND-000774,2011,20100068,,,,3,4,7
,2011,20100069,,,,21,14,35
,2011,20100070,,,,15,17,32
HND-000775,2011,20100071,,,,27,29,56
HND-000778,2011,20100074,,,,5,7,12
HND-000779,2011,20100075,,,,10,5,15
HND-000780,2011,20100076,,,,6,6,12
HND-000781,2011,20100077,,,,10,9,19
HND-000786,2011,20100084,,,,18,16,34
HND-000787,2011,20100086,,,,6,11,17
HND-000788,2011,20100087,,,,6,2,8
HND-000797,2011,20100097,,,,4,1,5
HND-000799,2011,20100099,,,,7,7,14
HND-000803,2011,20100103,,,,8,13,21
HND-000814,2011,20100116,,,,9,12,21
HND-000816,2011,20100118,,,,1,1,2
HND-000819,2011,20100122,,,,4,4,8
HND-000822,2011,20100126,,,,1,3,4
HND-000838,2011,20100184,,,,8,4,12
,2011,20100203,,,,1,3,4
,2011,20100205,,,,7,9,16
HND-000848,2011,20100206,,,,4,5,9
,2011,20100207,,,,3,2,5
HND-000718,2011,20100002,,,,17,25,42
HND-000719,2011,20100004,,,,3,4,7
HND-000722,2011,20100007,,,,8,10,18
HND-000727,2011,20100012,,,,30,27,57
HND-000729,2011,20100014,,,,12,14,26
HND-000731,2011,20100016,,,,26,23,49
HND-000732,2011,20100017,,,,26,10,36
HND-000734,2011,20100019,,,,8,7,15
HND-000735,2011,20100020,,,,7,13,20
HND-000737,2011,20100022,,,,4,10,14
HND-000738,2011,20100023,,,,20,13,33
HND-000739,2011,20100024,,,,8,5,13
HND-000741,2011,20100026,,,,13,14,27
HND-000744,2011,20100029,,,,6,3,9
HND-000747,2011,20100032,,,,11,11,22
HND-000748,2011,20100034,,,,20,8,28
HND-000749,2011,20100035,,,,8,10,18
HND-000750,2011,20100036,,,,6,3,9
HND-000751,2011,20100037,,,,21,22,43
HND-000752,2011,20100038,,,,46,44,90
HND-000754,2011,20100041,,,,29,24,53
HND-000757,2011,20100045,,,,3,9,12
HND-000758,2011,20100046,,,,27,13,40
,2011,20100048,,,,11,5,16
HND-000762,2011,20100054,,,,25,24,49
HND-000763,2011,20100055,,,,1,2,3
HND-000764,2011,20100057,,,,3,4,7
,2011,20100058,,,,19,20,39
HND-000767,2011,20100060,,,,24,18,42
HND-000768,2011,20100061,,,,4,8,12
,2011,20100062,,,,6,3,9
HND-000801,2011,20100101,,,,2,5,7
HND-000804,2011,20100104,,,,9,3,12
HND-000811,2011,20100112,,,,1,1,2
,2011,20100113,,,,5,9,14
HND-000817,2011,20100119,,,,17,12,29
HND-000819,2011,20100122,,,,9,9,18
HND-000836,2011,20100182,,,,11,5,16
HND-000839,2011,20100185,,,,7,13,20
HND-000840,2011,20100188,,,,4,0,4
HND-000843,2011,20100191,,,,16,8,24
,2011,20100203,,,,7,2,9
HND-000851,2011,20100210,,,,7,12,19
HND-000853,2011,20100213,,,,13,10,23
HND-000717,2011,20100001,,,,13,12,25
HND-000720,2011,20100005,,,,10,6,16
HND-000721,2011,20100006,,,,11,2,13
HND-000723,2011,20100008,,,,11,6,17
HND-000724,2011,20100009,,,,3,4,7
HND-000725,2011,20100010,,,,12,12,24
HND-000726,2011,20100011,,,,16,9,25
HND-000728,2011,20100013,,,,21,16,37
HND-000730,2011,20100015,,,,17,13,30
HND-000733,2011,20100018,,,,20,20,40
HND-000736,2011,20100021,,,,8,10,18
HND-000740,2011,20100025,,,,5,3,8
HND-000742,2011,20100027,,,,13,10,23
HND-000743,2011,20100028,,,,31,23,54
HND-000745,2011,20100030,,,,6,8,14
HND-000746,2011,20100031,,,,5,7,12
,2011,20100033,,,,8,11,19
HND-000753,2011,20100039,,,,10,11,21
,2011,20100042,,,,14,17,31
,2011,20100043,,,,50,32,82
HND-000756,2011,20100044,,,,35,27,62
,2011,20100047,,,,5,3,8
,2011,20100049,,,,6,3,9
HND-000759,2011,20100050,,,,7,0,7
HND-000760,2011,20100051,,,,42,31,73
HND-000761,2011,20100052,,,,3,3,6
HND-000766,2011,20100059,,,,26,14,40
HND-000807,2011,20100108,,,,9,9,18
HND-000808,2011,20100109,,,,1,2,3
HND-000809,2011,20100110,,,,13,20,33
HND-000810,2011,20100111,,,,4,0,4
HND-000813,2011,20100115,,,,0,2,2
HND-000815,2011,20100117,,,,8,6,14
HND-000818,2011,20100120,,,,20,14,34
HND-000821,2011,20100125,,,,3,1,4
HND-000823,2011,20100127,,,,1,1,2
HND-000824,2011,20100148,,,,6,8,14
HND-000841,2011,20100189,,,,3,4,7
HND-000842,2011,20100190,,,,4,1,5
HND-000845,2011,20100193,,,,0,1,1
HND-000854,2011,20100214,,,,2,3,5
HND-000855,2011,20100215,,,,5,2,7
HND-000718,2011,20100002,,,,18,11,29
HND-000719,2011,20100004,,,,2,2,4
HND-000724,2011,20100009,,,,2,3,5
HND-000725,2011,20100010,,,,8,8,16
HND-000727,2011,20100012,,,,18,17,35
HND-000728,2011,20100013,,,,12,19,31
HND-000729,2011,20100014,,,,4,13,17
HND-000731,2011,20100016,,,,23,25,48
HND-000734,2011,20100019,,,,11,7,18
HND-000735,2011,20100020,,,,12,5,17
HND-000736,2011,20100021,,,,13,6,19
HND-000737,2011,20100022,,,,9,8,17
HND-000738,2011,20100023,,,,15,17,32
HND-000741,2011,20100026,,,,8,7,15
HND-000743,2011,20100028,,,,12,14,26
HND-000744,2011,20100029,,,,6,6,12
HND-000746,2011,20100031,,,,7,7,14
HND-000749,2011,20100035,,,,11,10,21
HND-000750,2011,20100036,,,,6,11,17
HND-000752,2011,20100038,,,,28,29,57
HND-000754,2011,20100041,,,,20,15,35
,2011,20100042,,,,13,9,22
,2011,20100043,,,,45,30,75
HND-000756,2011,20100044,,,,32,24,56
HND-000760,2011,20100051,,,,58,45,103
HND-000763,2011,20100055,,,,2,3,5
HND-000764,2011,20100057,,,,3,2,5
,2011,20100058,,,,16,18,34
HND-000767,2011,20100060,,,,12,15,27
HND-000768,2011,20100061,,,,5,14,19
HND-000792,2011,20100092,,,,11,10,21
HND-000801,2011,20100101,,,,4,3,7
HND-000807,2011,20100108,,,,11,10,21
HND-000810,2011,20100111,,,,5,2,7
,2011,20100113,,,,7,5,12
HND-000815,2011,20100117,,,,3,3,6
HND-000817,2011,20100119,,,,10,8,18
HND-000836,2011,20100182,,,,4,9,13
HND-000840,2011,20100188,,,,5,4,9
HND-000841,2011,20100189,,,,2,2,4
HND-000842,2011,20100190,,,,6,4,10
HND-000843,2011,20100191,,,,7,13,20
HND-000854,2011,20100214,,,,2,1,3
HND-000717,2011,20100001,,,,10,7,17
HND-000720,2011,20100005,,,,10,4,14
HND-000721,2011,20100006,,,,1,6,7
HND-000722,2011,20100007,,,,9,10,19
HND-000723,2011,20100008,,,,7,8,15
HND-000726,2011,20100011,,,,17,9,26
HND-000730,2011,20100015,,,,20,11,31
HND-000732,2011,20100017,,,,11,7,18
HND-000733,2011,20100018,,,,13,18,31
HND-000739,2011,20100024,,,,5,11,16
HND-000740,2011,20100025,,,,3,2,5
HND-000742,2011,20100027,,,,8,13,21
HND-000745,2011,20100030,,,,4,4,8
HND-000747,2011,20100032,,,,9,7,16
,2011,20100033,,,,6,13,19
HND-000748,2011,20100034,,,,8,5,13
HND-000751,2011,20100037,,,,26,7,33
HND-000753,2011,20100039,,,,8,5,13
HND-000757,2011,20100045,,,,5,5,10
HND-000758,2011,20100046,,,,19,17,36
,2011,20100047,,,,3,2,5
,2011,20100048,,,,6,8,14
,2011,20100049,,,,3,5,8
HND-000759,2011,20100050,,,,2,1,3
HND-000761,2011,20100052,,,,9,10,19
HND-000762,2011,20100054,,,,24,13,37
HND-000766,2011,20100059,,,,24,24,48
,2011,20100062,,,,4,7,11
HND-000804,2011,20100104,,,,6,5,11
HND-000808,2011,20100109,,,,2,1,3
HND-000809,2011,20100110,,,,16,12,28
HND-000813,2011,20100115,,,,1,1,2
HND-000818,2011,20100120,,,,8,9,17
HND-000819,2011,20100122,,,,7,4,11
HND-000821,2011,20100125,,,,3,0,3
HND-000823,2011,20100127,,,,2,0,2
HND-000824,2011,20100148,,,,8,8,16
HND-000839,2011,20100185,,,,2,2,4
HND-000845,2011,20100193,,,,0,2,2
,2011,20100203,,,,1,2,3
HND-000851,2011,20100210,,,,9,7,16
HND-000853,2011,20100213,,,,8,14,22
HND-000855,2011,20100215,,,,4,4,8
HND-000717,2011,20100001,,,,4,10,14
HND-000720,2011,20100005,,,,8,7,15
HND-000721,2011,20100006,,,,5,1,6
HND-000723,2011,20100008,,,,6,5,11
HND-000725,2011,20100010,,,,6,10,16
HND-000726,2011,20100011,,,,13,6,19
HND-000730,2011,20100015,,,,17,13,30
HND-000733,2011,20100018,,,,21,18,39
HND-000736,2011,20100021,,,,9,3,12
HND-000740,2011,20100025,,,,5,1,6
HND-000742,2011,20100027,,,,7,9,16
HND-000743,2011,20100028,,,,22,14,36
HND-000745,2011,20100030,,,,12,6,18
HND-000746,2011,20100031,,,,8,4,12
,2011,20100033,,,,7,12,19
HND-000749,2011,20100035,,,,10,9,19
HND-000750,2011,20100036,,,,5,1,6
HND-000753,2011,20100039,,,,13,8,21
HND-000754,2011,20100041,,,,31,20,51
,2011,20100042,,,,18,5,23
,2011,20100043,,,,36,29,65
HND-000756,2011,20100044,,,,39,29,68
,2011,20100047,,,,1,2,3
,2011,20100049,,,,3,7,10
HND-000759,2011,20100050,,,,2,2,4
HND-000760,2011,20100051,,,,55,43,98
HND-000766,2011,20100059,,,,27,20,47
HND-000792,2011,20100092,,,,13,14,27
HND-000807,2011,20100108,,,,4,6,10
HND-000808,2011,20100109,,,,4,4,8
HND-000809,2011,20100110,,,,12,17,29
HND-000810,2011,20100111,,,,3,2,5
HND-000813,2011,20100115,,,,7,3,10
HND-000815,2011,20100117,,,,4,5,9
HND-000821,2011,20100125,,,,0,3,3
HND-000823,2011,20100127,,,,0,2,2
HND-000824,2011,20100148,,,,7,5,12
HND-000841,2011,20100189,,,,1,2,3
HND-000842,2011,20100190,,,,9,9,18
HND-000854,2011,20100214,,,,1,2,3
HND-000855,2011,20100215,,,,5,3,8
HND-000718,2011,20100002,,,,19,17,36
HND-000719,2011,20100004,,,,9,3,12
HND-000722,2011,20100007,,,,11,4,15
HND-000724,2011,20100009,,,,7,1,8
HND-000727,2011,20100012,,,,22,17,39
HND-000728,2011,20100013,,,,17,23,40
HND-000729,2011,20100014,,,,10,5,15
HND-000731,2011,20100016,,,,32,18,50
HND-000732,2011,20100017,,,,6,3,9
HND-000734,2011,20100019,,,,5,5,10
HND-000735,2011,20100020,,,,10,12,22
HND-000737,2011,20100022,,,,11,10,21
HND-000738,2011,20100023,,,,24,20,44
HND-000739,2011,20100024,,,,7,9,16
HND-000741,2011,20100026,,,,12,8,20
HND-000744,2011,20100029,,,,8,3,11
HND-000747,2011,20100032,,,,14,18,32
HND-000748,2011,20100034,,,,10,10,20
HND-000751,2011,20100037,,,,16,6,22
HND-000752,2011,20100038,,,,30,33,63
HND-000757,2011,20100045,,,,1,3,4
HND-000758,2011,20100046,,,,12,13,25
,2011,20100048,,,,4,15,19
HND-000762,2011,20100054,,,,13,18,31
HND-000763,2011,20100055,,,,2,0,2
HND-000764,2011,20100057,,,,7,5,12
,2011,20100058,,,,14,20,34
HND-000767,2011,20100060,,,,25,17,42
HND-000768,2011,20100061,,,,5,3,8
,2011,20100062,,,,6,1,7
HND-000801,2011,20100101,,,,1,2,3
HND-000804,2011,20100104,,,,7,3,10
HND-000811,2011,20100112,,,,1,2,3
,2011,20100113,,,,6,3,9
HND-000817,2011,20100119,,,,3,7,10
HND-000818,2011,20100120,,,,15,16,31
HND-000819,2011,20100122,,,,4,6,10
HND-000836,2011,20100182,,,,7,9,16
HND-000839,2011,20100185,,,,2,1,3
HND-000840,2011,20100188,,,,4,1,5
HND-000843,2011,20100191,,,,5,6,11
HND-000845,2011,20100193,,,,0,1,1
,2011,20100203,,,,2,1,3
HND-000851,2011,20100210,,,,9,6,15
HND-000853,2011,20100213,,,,8,7,15
HND-000717,2011,20100001,,,,10,13,23
HND-000718,2011,20100002,,,,23,21,44
HND-000723,2011,20100008,,,,11,12,23
HND-000724,2011,20100009,,,,3,8,11
HND-000725,2011,20100010,,,,12,5,17
HND-000726,2011,20100011,,,,7,11,18
HND-000727,2011,20100012,,,,16,16,32
HND-000728,2011,20100013,,,,11,13,24
HND-000731,2011,20100016,,,,24,21,45
HND-000733,2011,20100018,,,,14,22,36
HND-000734,2011,20100019,,,,7,4,11
HND-000735,2011,20100020,,,,7,5,12
HND-000736,2011,20100021,,,,11,5,16
HND-000737,2011,20100022,,,,9,10,19
HND-000738,2011,20100023,,,,14,13,27
HND-000743,2011,20100028,,,,25,15,40
HND-000744,2011,20100029,,,,5,5,10
HND-000748,2011,20100034,,,,7,8,15
HND-000749,2011,20100035,,,,11,12,23
HND-000750,2011,20100036,,,,2,6,8
HND-000752,2011,20100038,,,,24,37,61
HND-000754,2011,20100041,,,,22,20,42
HND-000756,2011,20100044,,,,27,26,53
HND-000757,2011,20100045,,,,2,4,6
HND-000758,2011,20100046,,,,20,13,33
,2011,20100048,,,,8,4,12
HND-000763,2011,20100055,,,,1,4,5
HND-000764,2011,20100057,,,,9,5,14
,2011,20100058,,,,17,11,28
HND-000768,2011,20100061,,,,3,5,8
HND-000792,2011,20100092,,,,13,12,25
HND-000801,2011,20100101,,,,2,1,3
HND-000807,2011,20100108,,,,14,10,24
,2011,20100113,,,,3,8,11
HND-000817,2011,20100119,,,,8,7,15
HND-000836,2011,20100182,,,,9,4,13
HND-000839,2011,20100185,,,,2,4,6
HND-000840,2011,20100188,,,,3,4,7
HND-000841,2011,20100189,,,,1,2,3
HND-000842,2011,20100190,,,,0,4,4
HND-000843,2011,20100191,,,,8,9,17
HND-000851,2011,20100210,,,,7,7,14
HND-000853,2011,20100213,,,,9,13,22
HND-000854,2011,20100214,,,,1,1,2
HND-000719,2011,20100004,,,,8,7,15
HND-000720,2011,20100005,,,,10,8,18
HND-000721,2011,20100006,,,,4,3,7
HND-000722,2011,20100007,,,,9,6,15
HND-000729,2011,20100014,,,,11,14,25
HND-000730,2011,20100015,,,,22,19,41
HND-000732,2011,20100017,,,,8,7,15
HND-000739,2011,20100024,,,,11,2,13
HND-000740,2011,20100025,,,,4,4,8
HND-000741,2011,20100026,,,,18,9,27
HND-000742,2011,20100027,,,,10,11,21
HND-000745,2011,20100030,,,,3,3,6
HND-000746,2011,20100031,,,,4,4,8
HND-000747,2011,20100032,,,,8,13,21
,2011,20100033,,,,10,6,16
HND-000751,2011,20100037,,,,9,10,19
HND-000753,2011,20100039,,,,5,6,11
,2011,20100042,,,,9,7,16
,2011,20100043,,,,44,32,76
,2011,20100047,,,,0,3,3
,2011,20100049,,,,5,2,7
HND-000759,2011,20100050,,,,6,3,9
HND-000760,2011,20100051,,,,51,33,84
HND-000761,2011,20100052,,,,0,1,1
HND-000762,2011,20100054,,,,11,17,28
HND-000766,2011,20100059,,,,21,18,39
HND-000767,2011,20100060,,,,14,16,30
,2011,20100062,,,,0,3,3
HND-000804,2011,20100104,,,,7,5,12
HND-000808,2011,20100109,,,,4,5,9
HND-000809,2011,20100110,,,,22,16,38
HND-000810,2011,20100111,,,,3,1,4
HND-000813,2011,20100115,,,,2,2,4
HND-000815,2011,20100117,,,,13,8,21
HND-000818,2011,20100120,,,,12,24,36
HND-000819,2011,20100122,,,,13,9,22
HND-000821,2011,20100125,,,,1,1,2
HND-000823,2011,20100127,,,,3,2,5
HND-000824,2011,20100148,,,,10,6,16
HND-000845,2011,20100193,,,,2,1,3
,2011,20100203,,,,1,0,1
HND-000855,2011,20100215,,,,3,2,5
HND-000717,2011,20100001,,,,2,9,11
HND-000718,2011,20100002,,,,14,17,31
HND-000723,2011,20100008,,,,10,14,24
HND-000724,2011,20100009,,,,2,4,6
HND-000725,2011,20100010,,,,10,7,17
HND-000726,2011,20100011,,,,12,5,17
HND-000728,2011,20100013,,,,11,11,22
HND-000733,2011,20100018,,,,17,22,39
HND-000734,2011,20100019,,,,7,5,12
HND-000735,2011,20100020,,,,11,16,27
HND-000736,2011,20100021,,,,10,2,12
HND-000740,2011,20100025,,,,0,5,5
HND-000743,2011,20100028,,,,15,9,24
HND-000748,2011,20100034,,,,12,10,22
HND-000749,2011,20100035,,,,5,8,13
HND-000750,2011,20100036,,,,5,5,10
HND-000752,2011,20100038,,,,41,36,77
HND-000754,2011,20100041,,,,21,32,53
HND-000757,2011,20100045,,,,1,2,3
HND-000758,2011,20100046,,,,18,17,35
,2011,20100048,,,,9,2,11
HND-000762,2011,20100054,,,,10,21,31
HND-000763,2011,20100055,,,,0,1,1
HND-000764,2011,20100057,,,,3,8,11
,2011,20100058,,,,21,11,32
HND-000792,2011,20100092,,,,14,12,26
HND-000801,2011,20100101,,,,2,5,7
HND-000804,2011,20100104,,,,9,4,13
,2011,20100113,,,,6,5,11
HND-000817,2011,20100119,,,,8,3,11
HND-000819,2011,20100122,,,,9,6,15
HND-000836,2011,20100182,,,,5,5,10
HND-000839,2011,20100185,,,,5,7,12
HND-000840,2011,20100188,,,,3,4,7
HND-000843,2011,20100191,,,,8,7,15
,2011,20100203,,,,3,3,6
HND-000851,2011,20100210,,,,5,2,7
HND-000853,2011,20100213,,,,12,10,22
HND-000854,2011,20100214,,,,1,2,3
HND-000719,2011,20100004,,,,6,3,9
HND-000720,2011,20100005,,,,12,12,24
HND-000721,2011,20100006,,,,2,6,8
HND-000722,2011,20100007,,,,7,7,14
HND-000727,2011,20100012,,,,15,19,34
HND-000729,2011,20100014,,,,6,6,12
HND-000730,2011,20100015,,,,21,17,38
HND-000731,2011,20100016,,,,34,22,56
HND-000732,2011,20100017,,,,4,8,12
HND-000737,2011,20100022,,,,10,9,19
HND-000738,2011,20100023,,,,29,12,41
HND-000739,2011,20100024,,,,7,7,14
HND-000741,2011,20100026,,,,15,11,26
HND-000742,2011,20100027,,,,5,13,18
HND-000744,2011,20100029,,,,12,6,18
HND-000745,2011,20100030,,,,6,5,11
HND-000746,2011,20100031,,,,4,4,8
HND-000747,2011,20100032,,,,12,8,20
,2011,20100033,,,,7,5,12
HND-000751,2011,20100037,,,,15,6,21
HND-000753,2011,20100039,,,,8,5,13
,2011,20100042,,,,9,13,22
,2011,20100043,,,,27,32,59
HND-000756,2011,20100044,,,,35,26,61
,2011,20100047,,,,1,5,6
,2011,20100049,,,,4,3,7
HND-000759,2011,20100050,,,,4,0,4
HND-000760,2011,20100051,,,,40,40,80
HND-000761,2011,20100052,,,,1,1,2
HND-000766,2011,20100059,,,,22,23,45
HND-000767,2011,20100060,,,,9,14,23
HND-000768,2011,20100061,,,,7,5,12
,2011,20100062,,,,4,1,5
HND-000807,2011,20100108,,,,16,18,34
HND-000808,2011,20100109,,,,4,5,9
HND-000809,2011,20100110,,,,16,20,36
HND-000810,2011,20100111,,,,0,4,4
HND-000811,2011,20100112,,,,4,2,6
HND-000813,2011,20100115,,,,4,3,7
HND-000815,2011,20100117,,,,6,5,11
HND-000818,2011,20100120,,,,6,7,13
HND-000823,2011,20100127,,,,3,0,3
HND-000824,2011,20100148,,,,14,2,16
HND-000841,2011,20100189,,,,0,1,1
HND-000842,2011,20100190,,,,2,3,5
HND-000845,2011,20100193,,,,1,3,4
HND-000717,2011,20100001,,,,10,13,23
HND-000720,2011,20100005,,,,8,5,13
HND-000721,2011,20100006,,,,5,4,9
HND-000722,2011,20100007,,,,9,7,16
HND-000723,2011,20100008,,,,6,12,18
HND-000726,2011,20100011,,,,11,3,14
HND-000730,2011,20100015,,,,16,17,33
HND-000732,2011,20100017,,,,6,6,12
HND-000733,2011,20100018,,,,24,18,42
HND-000739,2011,20100024,,,,5,4,9
HND-000740,2011,20100025,,,,1,2,3
HND-000742,2011,20100027,,,,8,7,15
HND-000745,2011,20100030,,,,1,2,3
HND-000747,2011,20100032,,,,14,13,27
,2011,20100033,,,,7,10,17
HND-000748,2011,20100034,,,,11,9,20
HND-000751,2011,20100037,,,,5,11,16
HND-000753,2011,20100039,,,,7,7,14
HND-000757,2011,20100045,,,,4,2,6
HND-000758,2011,20100046,,,,15,20,35
,2011,20100047,,,,2,1,3
,2011,20100048,,,,6,10,16
,2011,20100049,,,,5,4,9
HND-000759,2011,20100050,,,,3,3,6
HND-000762,2011,20100054,,,,16,16,32
HND-000766,2011,20100059,,,,18,13,31
,2011,20100062,,,,6,4,10
HND-000804,2011,20100104,,,,8,4,12
HND-000808,2011,20100109,,,,4,3,7
HND-000809,2011,20100110,,,,13,16,29
HND-000813,2011,20100115,,,,1,1,2
HND-000818,2011,20100120,,,,4,4,8
HND-000819,2011,20100122,,,,4,7,11
HND-000821,2011,20100125,,,,2,0,2
HND-000823,2011,20100127,,,,2,1,3
HND-000824,2011,20100148,,,,5,9,14
HND-000839,2011,20100185,,,,3,2,5
HND-000845,2011,20100193,,,,0,1,1
,2011,20100203,,,,6,2,8
HND-000851,2011,20100210,,,,2,5,7
HND-000853,2011,20100213,,,,7,5,12
HND-000718,2011,20100002,,,,7,11,18
HND-000719,2011,20100004,,,,1,4,5
HND-000724,2011,20100009,,,,2,1,3
HND-000725,2011,20100010,,,,6,10,16
HND-000727,2011,20100012,,,,28,19,47
HND-000728,2011,20100013,,,,11,14,25
HND-000729,2011,20100014,,,,4,7,11
HND-000731,2011,20100016,,,,15,35,50
HND-000734,2011,20100019,,,,7,9,16
HND-000735,2011,20100020,,,,12,9,21
HND-000736,2011,20100021,,,,5,4,9
HND-000737,2011,20100022,,,,10,4,14
HND-000738,2011,20100023,,,,21,27,48
HND-000741,2011,20100026,,,,16,12,28
HND-000743,2011,20100028,,,,11,13,24
HND-000744,2011,20100029,,,,4,10,14
HND-000746,2011,20100031,,,,6,4,10
HND-000749,2011,20100035,,,,13,7,20
HND-000750,2011,20100036,,,,1,7,8
HND-000752,2011,20100038,,,,26,28,54
HND-000754,2011,20100041,,,,28,25,53
,2011,20100042,,,,7,8,15
,2011,20100043,,,,19,28,47
HND-000756,2011,20100044,,,,40,25,65
HND-000760,2011,20100051,,,,34,42,76
HND-000763,2011,20100055,,,,4,2,6
HND-000764,2011,20100057,,,,10,6,16
,2011,20100058,,,,16,18,34
HND-000767,2011,20100060,,,,11,23,34
HND-000768,2011,20100061,,,,4,8,12
HND-000792,2011,20100092,,,,17,13,30
HND-000801,2011,20100101,,,,1,4,5
HND-000807,2011,20100108,,,,8,5,13
HND-000810,2011,20100111,,,,1,1,2
,2011,20100113,,,,5,4,9
HND-000815,2011,20100117,,,,3,4,7
HND-000817,2011,20100119,,,,5,2,7
HND-000836,2011,20100182,,,,0,6,6
HND-000840,2011,20100188,,,,1,2,3
HND-000841,2011,20100189,,,,1,2,3
HND-000842,2011,20100190,,,,0,3,3
HND-000843,2011,20100191,,,,3,2,5
HND-000854,2011,20100214,,,,2,1,3
HND-000738,2011,20100023,,,,8,23,31
HND-000754,2011,20100041,,,,30,35,65
,2011,20100048,,,,6,8,14
,2011,20100049,,,,5,7,12
HND-000767,2011,20100060,,,,19,29,48
HND-000792,2011,20100092,,,,23,35,58
HND-000793,2011,20100093,,,,78,80,158
HND-000794,2011,20100094,,,,218,221,439
HND-000805,2011,20100105,,,,36,45,81
HND-000820,2011,20100124,,,,7,4,11
HND-000730,2011,20100015,,,,19,23,42
,2011,20100043,,,,24,42,66
HND-000760,2011,20100051,,,,21,50,71
HND-000766,2011,20100059,,,,14,19,33
HND-000795,2011,20100095,,,,46,49,95
HND-000809,2011,20100110,,,,24,23,47
,2011,20100123,,,,6,18,24
,2011,20100186,,,,17,18,35
,2011,20100202,,,,2,1,3
,2011,20100203,,,,2,16,18
HND-000738,2011,20100023,,,,8,11,19
HND-000754,2011,20100041,,,,28,27,55
,2011,20100043,,,,28,30,58
HND-000760,2011,20100051,,,,28,18,46
HND-000767,2011,20100060,,,,24,17,41
HND-000792,2011,20100092,,,,24,47,71
HND-000795,2011,20100095,,,,36,38,74
HND-000805,2011,20100105,,,,19,24,43
,2011,20100123,,,,1,21,22
,2011,20100202,,,,2,2,4
HND-000730,2011,20100015,,,,12,18,30
,2011,20100048,,,,5,8,13
,2011,20100049,,,,4,3,7
HND-000766,2011,20100059,,,,10,13,23
HND-000793,2011,20100093,,,,46,63,109
HND-000794,2011,20100094,,,,107,122,229
HND-000809,2011,20100110,,,,17,18,35
HND-000820,2011,20100124,,,,5,4,9
,2011,20100186,,,,13,13,26
HND-000738,2011,20100023,,,,3,13,16
HND-000754,2011,20100041,,,,19,24,43
,2011,20100043,,,,26,13,39
,2011,20100049,,,,3,4,7
HND-000760,2011,20100051,,,,13,14,27
HND-000792,2011,20100092,,,,17,37,54
HND-000805,2011,20100105,,,,26,31,57
HND-000820,2011,20100124,,,,1,3,4
,2011,20100186,,,,10,13,23
,2011,20100202,,,,1,1,2
,2011,20100203,,,,0,2,2
HND-000730,2011,20100015,,,,10,15,25
,2011,20100048,,,,3,5,8
HND-000766,2011,20100059,,,,10,13,23
HND-000767,2011,20100060,,,,24,18,42
HND-000793,2011,20100093,,,,49,64,113
HND-000794,2011,20100094,,,,73,97,170
HND-000795,2011,20100095,,,,25,39,64
HND-000809,2011,20100110,,,,14,19,33
,2011,20100123,,,,11,25,36
HND-000792,2011,20100092,,,,165,391,556
HND-000795,2011,20100095,,,,27,34,61
,2011,20100123,,,,34,63,97
HND-000793,2011,20100093,,,,85,81,166
HND-000794,2011,20100094,,,,175,184,359
HND-000805,2011,20100105,,,,13,8,21
,2011,20100202,,,,3,0,3
HND-000792,2011,20100092,,,,149,395,544
HND-000794,2011,20100094,,,,62,106,168
HND-000795,2011,20100095,,,,30,37,67
HND-000805,2011,20100105,,,,13,8,21
HND-000793,2011,20100093,,,,56,37,93
,2011,20100123,,,,25,66,91
,2011,20100202,,,,0,1,1
HND-000793,2011,20100093,,,,44,26,70
HND-000794,2011,20100094,,,,48,62,110
HND-000805,2011,20100105,,,,2,11,13
,2011,20100202,,,,5,6,11
HND-000792,2011,20100092,,,,126,319,445
HND-000795,2011,20100095,,,,31,27,58
,2011,20100123,,,,7,21,28
HND-000899,2011,20200064,,,,2,4,6
,2011,20200072,,,,2,2,4
,2011,20200074,,,,4,2,6
,2011,20200085,,,,4,2,6
,2011,20200086,,,,4,4,8
HND-000907,2011,20200087,,,,2,3,5
,2011,20200091,,,,2,3,5
HND-000911,2011,20200095,,,,2,3,5
HND-000880,2011,20200025,,,,8,4,12
,2011,20200068,,,,2,5,7
,2011,20200069,,,,4,3,7
HND-000900,2011,20200070,,,,1,5,6
HND-000901,2011,20200071,,,,0,4,4
,2011,20200073,,,,2,8,10
,2011,20200080,,,,0,4,4
,2011,20200081,,,,2,6,8
HND-000906,2011,20200083,,,,2,3,5
,2011,20200088,,,,6,6,12
HND-000908,2011,20200089,,,,2,5,7
HND-000909,2011,20200090,,,,7,0,7
HND-000910,2011,20200092,,,,1,10,11
,2011,20200093,,,,2,4,6
,2011,20200094,,,,1,4,5
HND-000881,2011,20200027,,,,5,0,5
HND-000889,2011,20200036,,,,8,12,20
,2011,20200084,,,,1,1,2
HND-000913,2011,20200098,,,,2,5,7
,2011,20200041,,,,4,3,7
,2011,20200026,,,,2,3,5
HND-000881,2011,20200027,,,,5,6,11
HND-000882,2011,20200028,,,,4,10,14
HND-000884,2011,20200031,,,,2,0,2
HND-000889,2011,20200036,,,,14,6,20
,2011,20200041,,,,3,6,9
,2011,20200084,,,,2,2,4
HND-000913,2011,20200098,,,,1,2,3
HND-000886,2011,20200033,,,,2,2,4
HND-000894,2011,20200044,,,,2,2,4
,2011,20200026,,,,2,3,5
HND-000881,2011,20200027,,,,3,4,7
HND-000882,2011,20200028,,,,4,6,10
HND-000886,2011,20200033,,,,16,16,32
HND-000894,2011,20200044,,,,8,19,27
HND-000880,2011,20200025,,,,10,12,22
HND-000884,2011,20200031,,,,10,8,18
HND-000889,2011,20200036,,,,11,14,25
,2011,20200041,,,,10,7,17
,2011,20200084,,,,3,3,6
,2011,20200096,,,,4,3,7
HND-000913,2011,20200098,,,,5,3,8
HND-000857,2011,20200002,,,,4,8,12
HND-000858,2011,20200003,,,,3,3,6
HND-000859,2011,20200004,,,,26,14,40
HND-000864,2011,20200009,,,,22,18,40
HND-000869,2011,20200014,,,,10,12,22
HND-000870,2011,20200015,,,,7,16,23
HND-000871,2011,20200016,,,,7,5,12
HND-000872,2011,20200017,,,,1,3,4
HND-000873,2011,20200018,,,,3,4,7
HND-000875,2011,20200020,,,,1,2,3
HND-000876,2011,20200021,,,,10,8,18
HND-000885,2011,20200032,,,,0,2,2
HND-000887,2011,20200034,,,,6,4,10
,2011,20200037,,,,2,0,2
,2011,20200042,,,,3,6,9
HND-000893,2011,20200043,,,,0,2,2
HND-000896,2011,20200046,,,,1,0,1
HND-000898,2011,20200048,,,,6,1,7
HND-000905,2011,20200079,,,,8,1,9
,2011,20200096,,,,11,8,19
HND-000912,2011,20200097,,,,5,1,6
HND-000856,2011,20200001,,,,22,11,33
HND-000861,2011,20200006,,,,5,1,6
HND-000862,2011,20200007,,,,5,9,14
HND-000863,2011,20200008,,,,14,6,20
HND-000865,2011,20200010,,,,5,3,8
HND-000866,2011,20200011,,,,20,21,41
HND-000867,2011,20200012,,,,4,7,11
HND-000868,2011,20200013,,,,19,18,37
HND-000874,2011,20200019,,,,8,2,10
HND-000877,2011,20200022,,,,1,1,2
,2011,20200030,,,,3,2,5
HND-000888,2011,20200035,,,,11,10,21
HND-000890,2011,20200039,,,,6,4,10
HND-000891,2011,20200040,,,,4,1,5
HND-000895,2011,20200045,,,,0,1,1
HND-000897,2011,20200047,,,,4,4,8
HND-000902,2011,20200076,,,,3,3,6
HND-000903,2011,20200077,,,,3,2,5
HND-000904,2011,20200078,,,,4,2,6
HND-000856,2011,20200001,,,,13,13,26
HND-000857,2011,20200002,,,,3,4,7
HND-000858,2011,20200003,,,,2,4,6
HND-000859,2011,20200004,,,,19,21,40
HND-000863,2011,20200008,,,,23,12,35
HND-000864,2011,20200009,,,,11,4,15
HND-000867,2011,20200012,,,,4,5,9
HND-000869,2011,20200014,,,,10,9,19
HND-000870,2011,20200015,,,,16,7,23
HND-000871,2011,20200016,,,,7,4,11
HND-000872,2011,20200017,,,,4,3,7
HND-000885,2011,20200032,,,,0,2,2
,2011,20200037,,,,3,3,6
,2011,20200042,,,,2,0,2
HND-000893,2011,20200043,,,,4,0,4
HND-000896,2011,20200046,,,,2,1,3
HND-000903,2011,20200077,,,,1,2,3
HND-000904,2011,20200078,,,,2,2,4
HND-000905,2011,20200079,,,,2,2,4
HND-000860,2011,20200005,,,,1,2,3
HND-000861,2011,20200006,,,,3,1,4
HND-000862,2011,20200007,,,,2,0,2
HND-000865,2011,20200010,,,,2,3,5
HND-000866,2011,20200011,,,,14,10,24
HND-000868,2011,20200013,,,,10,16,26
HND-000873,2011,20200018,,,,6,2,8
HND-000874,2011,20200019,,,,5,2,7
HND-000875,2011,20200020,,,,2,1,3
HND-000876,2011,20200021,,,,5,7,12
HND-000877,2011,20200022,,,,1,1,2
,2011,20200030,,,,1,3,4
HND-000887,2011,20200034,,,,3,0,3
HND-000888,2011,20200035,,,,8,3,11
HND-000890,2011,20200039,,,,3,4,7
HND-000891,2011,20200040,,,,1,2,3
HND-000895,2011,20200045,,,,1,0,1
HND-000897,2011,20200047,,,,3,4,7
HND-000898,2011,20200048,,,,8,2,10
HND-000902,2011,20200076,,,,1,1,2
,2011,20200096,,,,3,10,13
HND-000912,2011,20200097,,,,3,4,7
HND-000856,2011,20200001,,,,15,24,39
HND-000857,2011,20200002,,,,7,4,11
HND-000858,2011,20200003,,,,4,4,8
HND-000859,2011,20200004,,,,16,12,28
HND-000864,2011,20200009,,,,4,8,12
HND-000869,2011,20200014,,,,12,14,26
HND-000870,2011,20200015,,,,9,6,15
HND-000871,2011,20200016,,,,7,2,9
HND-000872,2011,20200017,,,,3,2,5
HND-000876,2011,20200021,,,,5,2,7
,2011,20200030,,,,1,5,6
HND-000890,2011,20200039,,,,3,2,5
HND-000891,2011,20200040,,,,0,2,2
HND-000895,2011,20200045,,,,3,0,3
HND-000897,2011,20200047,,,,5,3,8
HND-000902,2011,20200076,,,,4,4,8
HND-000903,2011,20200077,,,,0,2,2
HND-000904,2011,20200078,,,,2,0,2
HND-000860,2011,20200005,,,,2,0,2
HND-000861,2011,20200006,,,,3,2,5
HND-000862,2011,20200007,,,,8,3,11
HND-000863,2011,20200008,,,,15,9,24
HND-000865,2011,20200010,,,,3,0,3
HND-000866,2011,20200011,,,,8,14,22
HND-000867,2011,20200012,,,,2,3,5
HND-000868,2011,20200013,,,,14,9,23
HND-000873,2011,20200018,,,,2,1,3
HND-000874,2011,20200019,,,,3,4,7
HND-000875,2011,20200020,,,,0,1,1
HND-000877,2011,20200022,,,,1,1,2
HND-000887,2011,20200034,,,,5,4,9
HND-000888,2011,20200035,,,,4,4,8
,2011,20200037,,,,6,0,6
,2011,20200042,,,,4,2,6
HND-000893,2011,20200043,,,,1,3,4
HND-000896,2011,20200046,,,,1,1,2
HND-000898,2011,20200048,,,,8,8,16
HND-000905,2011,20200079,,,,4,2,6
,2011,20200096,,,,4,7,11
HND-000912,2011,20200097,,,,3,5,8
HND-000856,2011,20200001,,,,22,15,37
HND-000859,2011,20200004,,,,12,17,29
HND-000860,2011,20200005,,,,4,2,6
HND-000861,2011,20200006,,,,4,6,10
HND-000863,2011,20200008,,,,5,16,21
HND-000865,2011,20200010,,,,2,4,6
HND-000867,2011,20200012,,,,5,5,10
HND-000868,2011,20200013,,,,20,18,38
HND-000869,2011,20200014,,,,6,11,17
HND-000874,2011,20200019,,,,4,3,7
HND-000885,2011,20200032,,,,3,2,5
HND-000887,2011,20200034,,,,2,3,5
,2011,20200037,,,,0,2,2
,2011,20200042,,,,2,1,3
HND-000893,2011,20200043,,,,4,4,8
HND-000896,2011,20200046,,,,1,4,5
HND-000904,2011,20200078,,,,1,2,3
HND-000905,2011,20200079,,,,3,6,9
HND-000912,2011,20200097,,,,1,1,2
HND-000857,2011,20200002,,,,4,5,9
HND-000858,2011,20200003,,,,3,3,6
HND-000862,2011,20200007,,,,5,4,9
HND-000864,2011,20200009,,,,4,8,12
HND-000866,2011,20200011,,,,14,11,25
HND-000870,2011,20200015,,,,5,5,10
HND-000871,2011,20200016,,,,5,4,9
HND-000872,2011,20200017,,,,3,1,4
HND-000873,2011,20200018,,,,0,1,1
HND-000875,2011,20200020,,,,1,2,3
HND-000876,2011,20200021,,,,2,2,4
HND-000877,2011,20200022,,,,1,1,2
,2011,20200030,,,,2,3,5
HND-000888,2011,20200035,,,,4,9,13
HND-000890,2011,20200039,,,,1,1,2
HND-000891,2011,20200040,,,,2,0,2
HND-000897,2011,20200047,,,,4,3,7
HND-000898,2011,20200048,,,,1,9,10
HND-000902,2011,20200076,,,,2,1,3
HND-000903,2011,20200077,,,,4,0,4
,2011,20200096,,,,4,1,5
HND-000856,2011,20200001,,,,22,23,45
HND-000860,2011,20200005,,,,4,2,6
HND-000861,2011,20200006,,,,4,3,7
HND-000862,2011,20200007,,,,2,4,6
HND-000863,2011,20200008,,,,13,18,31
HND-000865,2011,20200010,,,,3,2,5
HND-000867,2011,20200012,,,,4,1,5
HND-000868,2011,20200013,,,,14,14,28
HND-000869,2011,20200014,,,,6,12,18
HND-000874,2011,20200019,,,,3,0,3
HND-000885,2011,20200032,,,,3,2,5
HND-000887,2011,20200034,,,,7,8,15
,2011,20200037,,,,1,1,2
,2011,20200042,,,,3,1,4
HND-000893,2011,20200043,,,,6,3,9
HND-000898,2011,20200048,,,,2,2,4
HND-000904,2011,20200078,,,,4,2,6
HND-000905,2011,20200079,,,,4,0,4
HND-000912,2011,20200097,,,,0,1,1
HND-000857,2011,20200002,,,,2,6,8
HND-000858,2011,20200003,,,,3,3,6
HND-000859,2011,20200004,,,,34,23,57
HND-000864,2011,20200009,,,,5,2,7
HND-000866,2011,20200011,,,,18,20,38
HND-000870,2011,20200015,,,,10,11,21
HND-000871,2011,20200016,,,,3,1,4
HND-000872,2011,20200017,,,,3,3,6
HND-000873,2011,20200018,,,,0,3,3
HND-000875,2011,20200020,,,,5,4,9
HND-000876,2011,20200021,,,,2,2,4
,2011,20200030,,,,2,2,4
HND-000888,2011,20200035,,,,6,7,13
HND-000890,2011,20200039,,,,1,4,5
HND-000891,2011,20200040,,,,3,1,4
HND-000895,2011,20200045,,,,6,1,7
HND-000897,2011,20200047,,,,3,4,7
HND-000902,2011,20200076,,,,1,3,4
HND-000903,2011,20200077,,,,0,2,2
,2011,20200096,,,,3,2,5
HND-000860,2011,20200005,,,,1,2,3
HND-000861,2011,20200006,,,,0,4,4
HND-000862,2011,20200007,,,,2,2,4
HND-000866,2011,20200011,,,,11,9,20
HND-000868,2011,20200013,,,,12,24,36
HND-000874,2011,20200019,,,,3,0,3
HND-000875,2011,20200020,,,,3,0,3
HND-000876,2011,20200021,,,,3,2,5
HND-000877,2011,20200022,,,,2,0,2
HND-000887,2011,20200034,,,,4,1,5
HND-000888,2011,20200035,,,,3,3,6
HND-000890,2011,20200039,,,,2,1,3
HND-000891,2011,20200040,,,,0,1,1
HND-000895,2011,20200045,,,,1,1,2
HND-000897,2011,20200047,,,,3,3,6
HND-000898,2011,20200048,,,,0,3,3
HND-000902,2011,20200076,,,,1,1,2
,2011,20200096,,,,5,3,8
HND-000912,2011,20200097,,,,0,1,1
HND-000856,2011,20200001,,,,26,17,43
HND-000857,2011,20200002,,,,5,2,7
HND-000858,2011,20200003,,,,2,3,5
HND-000859,2011,20200004,,,,15,13,28
HND-000863,2011,20200008,,,,11,9,20
HND-000864,2011,20200009,,,,4,5,9
HND-000867,2011,20200012,,,,2,1,3
HND-000869,2011,20200014,,,,9,8,17
HND-000870,2011,20200015,,,,6,7,13
HND-000871,2011,20200016,,,,2,5,7
HND-000872,2011,20200017,,,,3,1,4
HND-000885,2011,20200032,,,,2,0,2
,2011,20200037,,,,2,2,4
,2011,20200042,,,,4,3,7
HND-000893,2011,20200043,,,,6,1,7
HND-000896,2011,20200046,,,,2,2,4
HND-000903,2011,20200077,,,,1,0,1
HND-000904,2011,20200078,,,,3,1,4
HND-000870,2011,20200015,,,,10,10,20
HND-000863,2011,20200008,,,,8,13,21
HND-000867,2011,20200012,,,,11,5,16
HND-000868,2011,20200013,,,,8,16,24
HND-000878,2011,20200023,,,,29,42,71
HND-000879,2011,20200024,,,,36,34,70
HND-000863,2011,20200008,,,,9,12,21
HND-000867,2011,20200012,,,,1,7,8
HND-000868,2011,20200013,,,,7,5,12
HND-000870,2011,20200015,,,,5,7,12
HND-000878,2011,20200023,,,,33,29,62
HND-000879,2011,20200024,,,,16,19,35
HND-000863,2011,20200008,,,,1,2,3
HND-000867,2011,20200012,,,,4,8,12
HND-000868,2011,20200013,,,,9,8,17
HND-000870,2011,20200015,,,,6,5,11
HND-000878,2011,20200023,,,,25,33,58
HND-000879,2011,20200024,,,,9,21,30
HND-000878,2011,20200023,,,,8,18,26
HND-000879,2011,20200024,,,,12,20,32
HND-000878,2011,20200023,,,,8,17,25
HND-000879,2011,20200024,,,,15,12,27
HND-000878,2011,20200023,,,,7,23,30
HND-000879,2011,20200024,,,,3,11,14
HND-000979,2011,20300082,,,,5,9,14
,2011,20300110,,,,4,5,9
HND-000949,2011,20300037,,,,11,12,23
,2011,20300094,,,,6,1,7
,2011,20300095,,,,7,6,13
,2011,20300108,,,,7,4,11
,2011,20300032,,,,5,5,10
HND-000945,2011,20300033,,,,11,12,23
HND-000946,2011,20300034,,,,14,13,27
HND-000951,2011,20300039,,,,4,1,5
HND-000975,2011,20300073,,,,3,4,7
,2011,20300075,,,,1,4,5
HND-000976,2011,20300076,,,,4,1,5
HND-000978,2011,20300078,,,,0,3,3
,2011,20300104,,,,2,4,6
HND-000943,2011,20300031,,,,5,4,9
HND-000950,2011,20300038,,,,3,1,4
,2011,20300072,,,,1,2,3
HND-000977,2011,20300077,,,,6,1,7
,2011,20300079,,,,2,3,5
,2011,20300102,,,,3,6,9
,2011,20300103,,,,4,6,10
HND-000946,2011,20300034,,,,16,17,33
HND-000947,2011,20300035,,,,8,7,15
HND-000948,2011,20300036,,,,6,6,12
HND-000949,2011,20300037,,,,1,7,8
HND-000954,2011,20300042,,,,5,7,12
HND-000955,2011,20300043,,,,3,3,6
HND-000956,2011,20300044,,,,3,2,5
,2011,20300072,,,,3,3,6
HND-000975,2011,20300073,,,,4,3,7
HND-000978,2011,20300078,,,,7,5,12
,2011,20300079,,,,7,2,9
,2011,20300104,,,,4,3,7
,2011,20300106,,,,8,4,12
,2011,20300030,,,,20,12,32
HND-000943,2011,20300031,,,,10,10,20
,2011,20300032,,,,10,10,20
HND-000945,2011,20300033,,,,10,11,21
HND-000950,2011,20300038,,,,3,5,8
HND-000951,2011,20300039,,,,4,3,7
HND-000957,2011,20300046,,,,4,3,7
,2011,20300075,,,,6,3,9
HND-000976,2011,20300076,,,,1,2,3
HND-000977,2011,20300077,,,,2,4,6
,2011,20300102,,,,7,3,10
,2011,20300103,,,,3,6,9
HND-000946,2011,20300034,,,,20,20,40
HND-000947,2011,20300035,,,,10,15,25
HND-000948,2011,20300036,,,,6,6,12
HND-000949,2011,20300037,,,,3,2,5
HND-000954,2011,20300042,,,,4,4,8
HND-000955,2011,20300043,,,,6,6,12
,2011,20300072,,,,1,3,4
HND-000975,2011,20300073,,,,1,1,2
HND-000978,2011,20300078,,,,8,11,19
,2011,20300079,,,,1,1,2
,2011,20300102,,,,2,4,6
,2011,20300103,,,,3,2,5
,2011,20300030,,,,11,7,18
HND-000943,2011,20300031,,,,4,10,14
,2011,20300032,,,,17,15,32
HND-000945,2011,20300033,,,,24,14,38
HND-000950,2011,20300038,,,,4,3,7
HND-000951,2011,20300039,,,,4,6,10
HND-000956,2011,20300044,,,,4,7,11
HND-000957,2011,20300046,,,,3,2,5
,2011,20300075,,,,9,3,12
HND-000976,2011,20300076,,,,7,7,14
HND-000977,2011,20300077,,,,2,4,6
,2011,20300104,,,,1,1,2
,2011,20300106,,,,7,4,11
HND-000915,2011,20300002,,,,15,8,23
HND-000916,2011,20300003,,,,10,7,17
HND-000917,2011,20300004,,,,2,8,10
HND-000920,2011,20300007,,,,10,6,16
HND-000922,2011,20300009,,,,16,12,28
HND-000923,2011,20300010,,,,18,11,29
HND-000925,2011,20300012,,,,18,20,38
HND-000926,2011,20300013,,,,23,24,47
HND-000927,2011,20300014,,,,40,19,59
HND-000932,2011,20300019,,,,5,3,8
HND-000935,2011,20300022,,,,9,7,16
HND-000937,2011,20300024,,,,7,5,12
HND-000940,2011,20300027,,,,2,2,4
HND-000956,2011,20300044,,,,8,10,18
HND-000958,2011,20300047,,,,10,11,21
HND-000960,2011,20300049,,,,5,2,7
HND-000961,2011,20300050,,,,6,1,7
HND-000962,2011,20300051,,,,3,9,12
HND-000963,2011,20300053,,,,11,4,15
HND-000964,2011,20300054,,,,8,3,11
HND-000967,2011,20300057,,,,7,10,17
HND-000969,2011,20300059,,,,4,3,7
,2011,20300061,,,,11,6,17
HND-000970,2011,20300062,,,,10,7,17
HND-000973,2011,20300065,,,,5,8,13
HND-000974,2011,20300066,,,,1,1,2
HND-000981,2011,20300091,,,,5,2,7
HND-000983,2011,20300093,,,,4,1,5
HND-000987,2011,20300099,,,,2,4,6
HND-000914,2011,20300001,,,,23,22,45
HND-000918,2011,20300005,,,,2,0,2
HND-000919,2011,20300006,,,,2,5,7
HND-000924,2011,20300011,,,,15,9,24
HND-000928,2011,20300015,,,,11,15,26
HND-000929,2011,20300016,,,,15,16,31
HND-000930,2011,20300017,,,,7,2,9
HND-000931,2011,20300018,,,,5,8,13
HND-000933,2011,20300020,,,,7,10,17
HND-000934,2011,20300021,,,,3,7,10
HND-000936,2011,20300023,,,,14,7,21
HND-000938,2011,20300025,,,,14,10,24
HND-000939,2011,20300026,,,,3,5,8
HND-000941,2011,20300029,,,,3,2,5
HND-000959,2011,20300048,,,,3,1,4
HND-000965,2011,20300055,,,,6,5,11
HND-000966,2011,20300056,,,,6,5,11
HND-000968,2011,20300058,,,,3,3,6
,2011,20300063,,,,8,4,12
HND-000972,2011,20300064,,,,16,3,19
HND-000982,2011,20300092,,,,21,15,36
HND-000984,2011,20300096,,,,5,9,14
HND-000985,2011,20300097,,,,4,5,9
HND-000986,2011,20300098,,,,4,1,5
HND-000988,2011,20300100,,,,4,0,4
HND-000917,2011,20300004,,,,3,3,6
HND-000918,2011,20300005,,,,6,6,12
HND-000919,2011,20300006,,,,2,5,7
HND-000927,2011,20300014,,,,32,21,53
HND-000928,2011,20300015,,,,18,19,37
HND-000929,2011,20300016,,,,10,16,26
HND-000930,2011,20300017,,,,7,0,7
HND-000934,2011,20300021,,,,4,1,5
HND-000938,2011,20300025,,,,8,7,15
HND-000939,2011,20300026,,,,2,2,4
HND-000940,2011,20300027,,,,1,1,2
HND-000958,2011,20300047,,,,8,8,16
HND-000959,2011,20300048,,,,4,1,5
HND-000960,2011,20300049,,,,2,4,6
HND-000963,2011,20300053,,,,3,4,7
HND-000965,2011,20300055,,,,4,3,7
HND-000969,2011,20300059,,,,1,1,2
,2011,20300061,,,,1,2,3
,2011,20300063,,,,6,4,10
HND-000983,2011,20300093,,,,1,2,3
HND-000986,2011,20300098,,,,1,1,2
HND-000987,2011,20300099,,,,3,1,4
HND-000988,2011,20300100,,,,2,0,2
HND-000914,2011,20300001,,,,14,20,34
HND-000915,2011,20300002,,,,6,6,12
HND-000916,2011,20300003,,,,9,14,23
HND-000920,2011,20300007,,,,4,4,8
HND-000922,2011,20300009,,,,9,7,16
HND-000923,2011,20300010,,,,15,13,28
HND-000924,2011,20300011,,,,8,13,21
HND-000925,2011,20300012,,,,15,18,33
HND-000926,2011,20300013,,,,19,13,32
HND-000931,2011,20300018,,,,7,7,14
HND-000932,2011,20300019,,,,3,2,5
HND-000933,2011,20300020,,,,9,18,27
HND-000935,2011,20300022,,,,8,4,12
HND-000936,2011,20300023,,,,5,4,9
HND-000937,2011,20300024,,,,8,4,12
HND-000941,2011,20300029,,,,3,1,4
HND-000956,2011,20300044,,,,5,5,10
HND-000961,2011,20300050,,,,4,9,13
HND-000962,2011,20300051,,,,2,4,6
HND-000964,2011,20300054,,,,3,3,6
HND-000966,2011,20300056,,,,2,2,4
HND-000967,2011,20300057,,,,2,2,4
HND-000968,2011,20300058,,,,1,1,2
HND-000970,2011,20300062,,,,5,4,9
HND-000972,2011,20300064,,,,12,9,21
HND-000973,2011,20300065,,,,4,3,7
HND-000974,2011,20300066,,,,2,2,4
HND-000981,2011,20300091,,,,3,1,4
HND-000984,2011,20300096,,,,9,5,14
HND-000985,2011,20300097,,,,5,3,8
HND-000914,2011,20300001,,,,14,13,27
HND-000918,2011,20300005,,,,5,0,5
HND-000919,2011,20300006,,,,5,4,9
HND-000924,2011,20300011,,,,7,7,14
HND-000928,2011,20300015,,,,20,22,42
HND-000929,2011,20300016,,,,15,17,32
HND-000930,2011,20300017,,,,2,6,8
HND-000931,2011,20300018,,,,2,4,6
HND-000933,2011,20300020,,,,11,0,11
HND-000934,2011,20300021,,,,0,2,2
HND-000936,2011,20300023,,,,5,3,8
HND-000938,2011,20300025,,,,9,4,13
HND-000939,2011,20300026,,,,1,1,2
HND-000956,2011,20300044,,,,6,12,18
HND-000958,2011,20300047,,,,10,12,22
HND-000960,2011,20300049,,,,1,5,6
HND-000962,2011,20300051,,,,4,2,6
HND-000963,2011,20300053,,,,4,7,11
HND-000964,2011,20300054,,,,6,3,9
HND-000969,2011,20300059,,,,2,1,3
,2011,20300063,,,,4,10,14
HND-000972,2011,20300064,,,,3,5,8
HND-000983,2011,20300093,,,,2,1,3
HND-000987,2011,20300099,,,,2,2,4
HND-000988,2011,20300100,,,,1,1,2
HND-000915,2011,20300002,,,,5,5,10
HND-000916,2011,20300003,,,,9,4,13
HND-000917,2011,20300004,,,,1,4,5
HND-000920,2011,20300007,,,,0,3,3
HND-000922,2011,20300009,,,,10,6,16
HND-000923,2011,20300010,,,,11,9,20
HND-000925,2011,20300012,,,,14,16,30
HND-000926,2011,20300013,,,,21,15,36
HND-000927,2011,20300014,,,,23,19,42
HND-000932,2011,20300019,,,,1,3,4
HND-000935,2011,20300022,,,,3,3,6
HND-000937,2011,20300024,,,,4,4,8
HND-000940,2011,20300027,,,,2,0,2
HND-000941,2011,20300029,,,,0,1,1
HND-000959,2011,20300048,,,,2,1,3
HND-000961,2011,20300050,,,,5,6,11
HND-000965,2011,20300055,,,,2,9,11
HND-000966,2011,20300056,,,,5,5,10
HND-000967,2011,20300057,,,,3,2,5
HND-000968,2011,20300058,,,,1,0,1
,2011,20300061,,,,0,2,2
HND-000970,2011,20300062,,,,4,3,7
HND-000973,2011,20300065,,,,4,6,10
HND-000974,2011,20300066,,,,4,1,5
HND-000981,2011,20300091,,,,7,1,8
HND-000982,2011,20300092,,,,3,4,7
HND-000984,2011,20300096,,,,5,2,7
HND-000985,2011,20300097,,,,6,4,10
HND-000986,2011,20300098,,,,2,0,2
HND-000915,2011,20300002,,,,4,6,10
HND-000917,2011,20300004,,,,1,1,2
HND-000919,2011,20300006,,,,2,2,4
HND-000920,2011,20300007,,,,6,6,12
HND-000925,2011,20300012,,,,19,28,47
HND-000927,2011,20300014,,,,23,29,52
HND-000930,2011,20300017,,,,0,4,4
HND-000932,2011,20300019,,,,4,0,4
HND-000937,2011,20300024,,,,4,0,4
HND-000938,2011,20300025,,,,7,6,13
HND-000939,2011,20300026,,,,4,2,6
HND-000940,2011,20300027,,,,1,2,3
HND-000958,2011,20300047,,,,8,5,13
HND-000959,2011,20300048,,,,4,2,6
HND-000960,2011,20300049,,,,5,5,10
HND-000963,2011,20300053,,,,5,5,10
HND-000965,2011,20300055,,,,8,6,14
HND-000968,2011,20300058,,,,2,1,3
HND-000969,2011,20300059,,,,4,4,8
,2011,20300061,,,,2,1,3
HND-000982,2011,20300092,,,,8,6,14
HND-000984,2011,20300096,,,,1,2,3
HND-000986,2011,20300098,,,,5,3,8
HND-000914,2011,20300001,,,,24,20,44
HND-000916,2011,20300003,,,,11,10,21
HND-000918,2011,20300005,,,,5,2,7
HND-000922,2011,20300009,,,,9,6,15
HND-000923,2011,20300010,,,,16,7,23
HND-000924,2011,20300011,,,,10,8,18
HND-000926,2011,20300013,,,,19,17,36
HND-000928,2011,20300015,,,,20,19,39
HND-000929,2011,20300016,,,,13,12,25
HND-000931,2011,20300018,,,,9,2,11
HND-000933,2011,20300020,,,,9,10,19
HND-000934,2011,20300021,,,,4,2,6
HND-000935,2011,20300022,,,,11,5,16
HND-000936,2011,20300023,,,,9,4,13
HND-000941,2011,20300029,,,,1,0,1
HND-000956,2011,20300044,,,,8,8,16
HND-000961,2011,20300050,,,,5,2,7
HND-000964,2011,20300054,,,,5,4,9
HND-000966,2011,20300056,,,,2,3,5
HND-000967,2011,20300057,,,,2,2,4
HND-000970,2011,20300062,,,,2,4,6
HND-000972,2011,20300064,,,,5,4,9
HND-000973,2011,20300065,,,,1,4,5
HND-000981,2011,20300091,,,,1,1,2
HND-000983,2011,20300093,,,,3,3,6
HND-000985,2011,20300097,,,,5,7,12
HND-000987,2011,20300099,,,,1,0,1
HND-000988,2011,20300100,,,,3,1,4
HND-000915,2011,20300002,,,,7,6,13
HND-000916,2011,20300003,,,,16,13,29
HND-000917,2011,20300004,,,,4,3,7
HND-000920,2011,20300007,,,,2,3,5
HND-000922,2011,20300009,,,,7,11,18
HND-000923,2011,20300010,,,,9,11,20
HND-000925,2011,20300012,,,,13,18,31
HND-000926,2011,20300013,,,,21,14,35
HND-000927,2011,20300014,,,,19,20,39
HND-000932,2011,20300019,,,,2,3,5
HND-000937,2011,20300024,,,,2,3,5
HND-000938,2011,20300025,,,,4,2,6
HND-000939,2011,20300026,,,,1,2,3
HND-000940,2011,20300027,,,,0,3,3
HND-000958,2011,20300047,,,,8,10,18
HND-000959,2011,20300048,,,,4,10,14
HND-000963,2011,20300053,,,,7,3,10
HND-000965,2011,20300055,,,,5,2,7
HND-000966,2011,20300056,,,,4,1,5
HND-000968,2011,20300058,,,,2,0,2
HND-000970,2011,20300062,,,,2,3,5
HND-000973,2011,20300065,,,,1,3,4
HND-000982,2011,20300092,,,,1,2,3
HND-000984,2011,20300096,,,,3,4,7
HND-000985,2011,20300097,,,,10,4,14
HND-000986,2011,20300098,,,,3,1,4
HND-000914,2011,20300001,,,,26,17,43
HND-000918,2011,20300005,,,,1,1,2
HND-000919,2011,20300006,,,,2,3,5
HND-000924,2011,20300011,,,,26,6,32
HND-000928,2011,20300015,,,,28,21,49
HND-000929,2011,20300016,,,,9,9,18
HND-000930,2011,20300017,,,,3,4,7
HND-000931,2011,20300018,,,,4,7,11
HND-000933,2011,20300020,,,,12,4,16
HND-000934,2011,20300021,,,,0,2,2
HND-000935,2011,20300022,,,,7,5,12
HND-000936,2011,20300023,,,,2,10,12
HND-000941,2011,20300029,,,,2,1,3
HND-000956,2011,20300044,,,,3,7,10
HND-000960,2011,20300049,,,,6,3,9
HND-000961,2011,20300050,,,,5,3,8
HND-000962,2011,20300051,,,,1,1,2
HND-000964,2011,20300054,,,,4,3,7
HND-000967,2011,20300057,,,,1,3,4
HND-000972,2011,20300064,,,,2,5,7
HND-000981,2011,20300091,,,,1,1,2
HND-000983,2011,20300093,,,,0,1,1
HND-000987,2011,20300099,,,,2,2,4
HND-000988,2011,20300100,,,,2,2,4
HND-000914,2011,20300001,,,,32,32,64
HND-000915,2011,20300002,,,,4,5,9
HND-000916,2011,20300003,,,,19,13,32
HND-000920,2011,20300007,,,,4,5,9
HND-000922,2011,20300009,,,,1,7,8
HND-000923,2011,20300010,,,,18,9,27
HND-000924,2011,20300011,,,,16,14,30
HND-000925,2011,20300012,,,,21,24,45
HND-000926,2011,20300013,,,,16,17,33
HND-000931,2011,20300018,,,,4,3,7
HND-000932,2011,20300019,,,,3,1,4
HND-000933,2011,20300020,,,,6,8,14
HND-000935,2011,20300022,,,,4,3,7
HND-000936,2011,20300023,,,,2,3,5
HND-000937,2011,20300024,,,,6,3,9
HND-000941,2011,20300029,,,,4,2,6
HND-000956,2011,20300044,,,,4,1,5
HND-000961,2011,20300050,,,,4,5,9
HND-000962,2011,20300051,,,,4,8,12
HND-000964,2011,20300054,,,,1,3,4
HND-000966,2011,20300056,,,,5,1,6
HND-000967,2011,20300057,,,,3,2,5
HND-000968,2011,20300058,,,,2,3,5
HND-000970,2011,20300062,,,,4,1,5
HND-000972,2011,20300064,,,,3,4,7
HND-000973,2011,20300065,,,,1,2,3
HND-000974,2011,20300066,,,,1,3,4
HND-000981,2011,20300091,,,,3,0,3
HND-000982,2011,20300092,,,,0,5,5
HND-000984,2011,20300096,,,,2,2,4
HND-000985,2011,20300097,,,,0,1,1
HND-000917,2011,20300004,,,,4,6,10
HND-000918,2011,20300005,,,,1,2,3
HND-000919,2011,20300006,,,,1,1,2
HND-000927,2011,20300014,,,,14,26,40
HND-000928,2011,20300015,,,,34,25,59
HND-000929,2011,20300016,,,,13,14,27
HND-000930,2011,20300017,,,,1,1,2
HND-000938,2011,20300025,,,,8,2,10
HND-000939,2011,20300026,,,,1,1,2
HND-000940,2011,20300027,,,,0,1,1
HND-000958,2011,20300047,,,,3,2,5
HND-000960,2011,20300049,,,,1,1,2
HND-000963,2011,20300053,,,,1,3,4
HND-000965,2011,20300055,,,,2,1,3
HND-000969,2011,20300059,,,,0,2,2
HND-000983,2011,20300093,,,,3,0,3
HND-000986,2011,20300098,,,,4,2,6
HND-000987,2011,20300099,,,,1,2,3
HND-000988,2011,20300100,,,,2,2,4
HND-000916,2011,20300003,,,,9,11,20
HND-000922,2011,20300009,,,,6,9,15
HND-000923,2011,20300010,,,,13,8,21
HND-000925,2011,20300012,,,,23,14,37
HND-000952,2011,20300040,,,,18,26,44
HND-000914,2011,20300001,,,,39,20,59
HND-000924,2011,20300011,,,,23,21,44
HND-000928,2011,20300015,,,,29,20,49
HND-000929,2011,20300016,,,,21,30,51
HND-000953,2011,20300041,,,,26,31,57
HND-000961,2011,20300050,,,,10,3,13
HND-000928,2011,20300015,,,,13,17,30
HND-000929,2011,20300016,,,,16,13,29
HND-000953,2011,20300041,,,,15,11,26
HND-000914,2011,20300001,,,,15,18,33
HND-000916,2011,20300003,,,,13,7,20
HND-000922,2011,20300009,,,,6,3,9
HND-000923,2011,20300010,,,,6,8,14
HND-000924,2011,20300011,,,,12,7,19
HND-000925,2011,20300012,,,,14,28,42
HND-000952,2011,20300040,,,,17,22,39
HND-000961,2011,20300050,,,,4,1,5
HND-000925,2011,20300012,,,,16,14,30
HND-000952,2011,20300040,,,,18,15,33
HND-000953,2011,20300041,,,,7,10,17
HND-000914,2011,20300001,,,,18,24,42
HND-000916,2011,20300003,,,,10,4,14
HND-000922,2011,20300009,,,,6,6,12
HND-000923,2011,20300010,,,,6,6,12
HND-000924,2011,20300011,,,,17,13,30
HND-000928,2011,20300015,,,,23,19,42
HND-000929,2011,20300016,,,,9,8,17
HND-000961,2011,20300050,,,,9,4,13
HND-000952,2011,20300040,,,,13,7,20
HND-000953,2011,20300041,,,,6,5,11
HND-000952,2011,20300040,,,,10,11,21
HND-000953,2011,20300041,,,,7,4,11
HND-000953,2011,20300041,,,,8,7,15
,2011,20400051,,,,5,5,10
,2011,20400071,,,,5,5,10
,2011,20400072,,,,4,5,9
,2011,20400034,,,,4,7,11
,2011,20400049,,,,5,5,10
,2011,20400053,,,,4,6,10
HND-001013,2011,20400054,,,,4,6,10
,2011,20400059,,,,5,5,10
,2011,20400061,,,,4,4,8
HND-001021,2011,20400068,,,,3,4,7
,2011,20400069,,,,4,4,8
,2011,20400074,,,,5,5,10
HND-001000,2011,20400014,,,,3,4,7
,2011,20400028,,,,4,8,12
HND-001012,2011,20400045,,,,5,2,7
,2011,20400046,,,,7,5,12
,2011,20400048,,,,3,2,5
,2011,20400064,,,,4,1,5
,2011,20400025,,,,1,6,7
HND-001010,2011,20400031,,,,0,4,4
HND-000999,2011,20400013,,,,40,34,74
,2011,20400020,,,,4,10,14
HND-001010,2011,20400031,,,,3,5,8
HND-001012,2011,20400045,,,,1,0,1
,2011,20400046,,,,14,13,27
,2011,20400048,,,,1,5,6
,2011,20400064,,,,3,4,7
HND-001000,2011,20400014,,,,4,5,9
,2011,20400025,,,,3,4,7
,2011,20400028,,,,1,1,2
,2011,20400047,,,,11,4,15
,2011,20400025,,,,4,5,9
,2011,20400028,,,,6,5,11
HND-000999,2011,20400013,,,,44,26,70
HND-001000,2011,20400014,,,,7,13,20
,2011,20400020,,,,15,14,29
HND-001010,2011,20400031,,,,12,10,22
HND-001012,2011,20400045,,,,1,3,4
,2011,20400046,,,,16,8,24
,2011,20400047,,,,10,5,15
,2011,20400048,,,,8,4,12
,2011,20400064,,,,8,5,13
HND-000993,2011,20400005,,,,30,31,61
HND-000994,2011,20400006,,,,10,7,17
HND-000995,2011,20400007,,,,6,8,14
HND-000998,2011,20400011,,,,3,2,5
,2011,20400016,,,,1,2,3
,2011,20400018,,,,3,4,7
HND-001006,2011,20400024,,,,3,4,7
,2011,20400027,,,,12,8,20
HND-001009,2011,20400030,,,,37,33,70
HND-001011,2011,20400033,,,,6,12,18
HND-001014,2011,20400055,,,,11,12,23
HND-001015,2011,20400056,,,,7,10,17
,2011,20400066,,,,10,11,21
HND-001020,2011,20400067,,,,7,13,20
,2011,20400070,,,,1,4,5
,2011,20400073,,,,6,7,13
HND-000989,2011,20400001,,,,22,15,37
HND-000990,2011,20400002,,,,17,6,23
,2011,20400003,,,,15,19,34
,2011,20400004,,,,38,42,80
HND-000996,2011,20400008,,,,22,24,46
,2011,20400009,,,,3,5,8
HND-001004,2011,20400021,,,,8,13,21
HND-001005,2011,20400023,,,,6,2,8
HND-001008,2011,20400029,,,,5,4,9
HND-001016,2011,20400057,,,,1,6,7
,2011,20400058,,,,11,6,17
,2011,20400059,,,,2,4,6
,2011,20400062,,,,7,13,20
,2011,20400063,,,,7,6,13
HND-000989,2011,20400001,,,,10,19,29
,2011,20400004,,,,68,36,104
HND-000993,2011,20400005,,,,21,17,38
HND-000994,2011,20400006,,,,13,13,26
HND-000995,2011,20400007,,,,4,9,13
HND-000996,2011,20400008,,,,21,22,43
HND-000998,2011,20400011,,,,1,2,3
,2011,20400018,,,,3,2,5
HND-001004,2011,20400021,,,,11,13,24
,2011,20400027,,,,8,3,11
HND-001009,2011,20400030,,,,24,12,36
HND-001011,2011,20400033,,,,6,6,12
,2011,20400058,,,,5,8,13
,2011,20400059,,,,10,2,12
,2011,20400062,,,,9,8,17
,2011,20400063,,,,3,4,7
HND-000990,2011,20400002,,,,21,4,25
,2011,20400003,,,,17,12,29
,2011,20400009,,,,1,2,3
,2011,20400016,,,,6,6,12
HND-001005,2011,20400023,,,,3,3,6
HND-001006,2011,20400024,,,,4,3,7
HND-001008,2011,20400029,,,,4,0,4
HND-001014,2011,20400055,,,,16,15,31
HND-001015,2011,20400056,,,,4,5,9
HND-001016,2011,20400057,,,,5,1,6
,2011,20400066,,,,8,7,15
HND-001020,2011,20400067,,,,9,8,17
,2011,20400070,,,,1,3,4
,2011,20400073,,,,4,3,7
HND-000989,2011,20400001,,,,19,16,35
HND-000990,2011,20400002,,,,13,10,23
,2011,20400003,,,,9,9,18
,2011,20400004,,,,31,41,72
HND-000996,2011,20400008,,,,15,17,32
,2011,20400009,,,,5,1,6
HND-001004,2011,20400021,,,,21,14,35
HND-001005,2011,20400023,,,,3,3,6
,2011,20400058,,,,5,2,7
,2011,20400059,,,,5,6,11
,2011,20400062,,,,3,5,8
,2011,20400063,,,,3,3,6
HND-000993,2011,20400005,,,,30,27,57
HND-000994,2011,20400006,,,,14,10,24
HND-000995,2011,20400007,,,,2,6,8
HND-000998,2011,20400011,,,,0,1,1
,2011,20400016,,,,9,8,17
,2011,20400018,,,,2,5,7
HND-001006,2011,20400024,,,,3,6,9
,2011,20400027,,,,3,0,3
HND-001008,2011,20400029,,,,1,4,5
HND-001009,2011,20400030,,,,17,20,37
HND-001011,2011,20400033,,,,2,2,4
HND-001014,2011,20400055,,,,7,8,15
HND-001015,2011,20400056,,,,3,4,7
HND-001016,2011,20400057,,,,3,4,7
HND-001020,2011,20400067,,,,3,5,8
,2011,20400073,,,,0,2,2
HND-000989,2011,20400001,,,,10,11,21
HND-000993,2011,20400005,,,,23,24,47
HND-000994,2011,20400006,,,,2,3,5
HND-000995,2011,20400007,,,,5,4,9
HND-000996,2011,20400008,,,,15,9,24
HND-000998,2011,20400011,,,,1,3,4
,2011,20400018,,,,1,1,2
HND-001006,2011,20400024,,,,4,4,8
,2011,20400027,,,,2,4,6
HND-001009,2011,20400030,,,,13,10,23
HND-001011,2011,20400033,,,,4,2,6
,2011,20400059,,,,1,2,3
,2011,20400063,,,,1,1,2
HND-000990,2011,20400002,,,,8,4,12
,2011,20400003,,,,8,9,17
,2011,20400004,,,,49,40,89
,2011,20400009,,,,10,4,14
,2011,20400016,,,,9,5,14
HND-001004,2011,20400021,,,,10,12,22
HND-001005,2011,20400023,,,,1,2,3
HND-001014,2011,20400055,,,,6,6,12
HND-001015,2011,20400056,,,,1,1,2
HND-001016,2011,20400057,,,,6,3,9
,2011,20400058,,,,4,3,7
,2011,20400062,,,,9,10,19
HND-001020,2011,20400067,,,,9,10,19
,2011,20400070,,,,0,1,1
HND-000989,2011,20400001,,,,18,11,29
HND-000990,2011,20400002,,,,9,5,14
,2011,20400003,,,,7,6,13
,2011,20400004,,,,29,33,62
HND-000996,2011,20400008,,,,3,11,14
,2011,20400009,,,,4,4,8
HND-001004,2011,20400021,,,,13,14,27
HND-001005,2011,20400023,,,,4,3,7
HND-001008,2011,20400029,,,,1,0,1
HND-001009,2011,20400030,,,,13,8,21
HND-001011,2011,20400033,,,,2,2,4
,2011,20400059,,,,6,5,11
,2011,20400062,,,,2,3,5
HND-000993,2011,20400005,,,,19,15,34
HND-000994,2011,20400006,,,,6,1,7
HND-000995,2011,20400007,,,,3,3,6
HND-000998,2011,20400011,,,,1,3,4
,2011,20400016,,,,5,1,6
,2011,20400018,,,,2,0,2
HND-001006,2011,20400024,,,,4,6,10
,2011,20400027,,,,2,2,4
HND-001014,2011,20400055,,,,7,5,12
HND-001016,2011,20400057,,,,0,3,3
,2011,20400058,,,,2,2,4
HND-001020,2011,20400067,,,,2,3,5
,2011,20400070,,,,0,1,1
HND-000989,2011,20400001,,,,4,4,8
,2011,20400004,,,,33,32,65
HND-000993,2011,20400005,,,,24,19,43
HND-000994,2011,20400006,,,,1,3,4
HND-000995,2011,20400007,,,,2,1,3
HND-000996,2011,20400008,,,,3,7,10
HND-000998,2011,20400011,,,,3,2,5
,2011,20400018,,,,1,1,2
HND-001004,2011,20400021,,,,11,7,18
,2011,20400027,,,,3,1,4
HND-001014,2011,20400055,,,,7,4,11
HND-001016,2011,20400057,,,,1,4,5
,2011,20400062,,,,1,1,2
,2011,20400063,,,,2,0,2
,2011,20400070,,,,1,2,3
HND-000990,2011,20400002,,,,7,1,8
,2011,20400003,,,,3,4,7
,2011,20400009,,,,7,2,9
,2011,20400016,,,,1,3,4
HND-001006,2011,20400024,,,,5,4,9
HND-001008,2011,20400029,,,,1,2,3
HND-001009,2011,20400030,,,,2,3,5
HND-001011,2011,20400033,,,,1,2,3
,2011,20400058,,,,1,0,1
,2011,20400059,,,,3,4,7
HND-000993,2011,20400005,,,,14,27,41
HND-001001,2011,20400015,,,,56,63,119
HND-001001,2011,20400015,,,,41,55,96
HND-000993,2011,20400005,,,,6,19,25
HND-001001,2011,20400015,,,,30,36,66
HND-000993,2011,20400005,,,,5,11,16
HND-001001,2011,20400015,,,,0,10,10
,2011,20400060,,,,5,1,6
HND-001001,2011,20400015,,,,5,10,15
,2011,20400060,,,,1,4,5
HND-001001,2011,20400015,,,,3,5,8
HND-001037,2011,20500017,,,,6,4,10
HND-001062,2011,20500051,,,,2,4,6
,2011,20500065,,,,8,3,11
,2011,20500066,,,,7,6,13
,2011,20500067,,,,8,7,15
,2011,20500081,,,,9,10,19
HND-001073,2011,20500083,,,,8,6,14
,2011,20500086,,,,5,8,13
,2011,20500088,,,,6,5,11
,2011,20500092,,,,8,7,15
,2011,20500094,,,,3,3,6
HND-001079,2011,20500099,,,,3,7,10
HND-001080,2011,20500100,,,,3,7,10
,2011,20500101,,,,4,5,9
,2011,20500102,,,,3,6,9
,2011,20500060,,,,5,6,11
HND-001069,2011,20500062,,,,11,5,16
,2011,20500063,,,,6,3,9
HND-001070,2011,20500064,,,,11,6,17
HND-001071,2011,20500080,,,,2,5,7
HND-001072,2011,20500082,,,,13,9,22
,2011,20500084,,,,5,5,10
HND-001074,2011,20500085,,,,3,4,7
HND-001075,2011,20500089,,,,7,12,19
,2011,20500095,,,,6,2,8
,2011,20500096,,,,10,12,22
,2011,20500097,,,,3,4,7
HND-001078,2011,20500098,,,,4,4,8
,2011,20500103,,,,6,1,7
,2011,20500024,,,,0,1,1
HND-001042,2011,20500025,,,,6,3,9
HND-001043,2011,20500026,,,,1,1,2
,2011,20500035,,,,5,5,10
HND-001057,2011,20500046,,,,2,4,6
HND-001058,2011,20500047,,,,0,1,1
HND-001069,2011,20500062,,,,8,9,17
,2011,20500077,,,,3,0,3
,2011,20500090,,,,5,5,10
HND-001024,2011,20500001,,,,5,5,10
HND-001026,2011,20500005,,,,1,4,5
HND-001037,2011,20500017,,,,13,7,20
HND-001040,2011,20500022,,,,3,3,6
HND-001041,2011,20500023,,,,4,3,7
,2011,20500029,,,,10,2,12
HND-001045,2011,20500030,,,,1,7,8
HND-001048,2011,20500034,,,,3,1,4
HND-001052,2011,20500040,,,,0,2,2
HND-001060,2011,20500049,,,,0,2,2
HND-001065,2011,20500054,,,,5,3,8
,2011,20500059,,,,5,6,11
,2011,20500078,,,,5,5,10
,2011,20500079,,,,8,3,11
HND-001083,2011,20500106,,,,2,2,4
HND-001026,2011,20500005,,,,5,4,9
HND-001037,2011,20500017,,,,12,18,30
HND-001042,2011,20500025,,,,7,4,11
HND-001043,2011,20500026,,,,4,2,6
,2011,20500029,,,,8,8,16
,2011,20500035,,,,15,20,35
HND-001057,2011,20500046,,,,3,5,8
HND-001058,2011,20500047,,,,8,2,10
,2011,20500059,,,,8,7,15
HND-001069,2011,20500062,,,,3,4,7
,2011,20500077,,,,7,4,11
HND-001024,2011,20500001,,,,4,6,10
HND-001040,2011,20500022,,,,9,7,16
HND-001041,2011,20500023,,,,1,2,3
,2011,20500024,,,,3,4,7
HND-001045,2011,20500030,,,,3,5,8
HND-001048,2011,20500034,,,,8,9,17
HND-001052,2011,20500040,,,,9,5,14
HND-001053,2011,20500041,,,,35,38,73
HND-001060,2011,20500049,,,,4,8,12
HND-001065,2011,20500054,,,,3,2,5
,2011,20500078,,,,9,14,23
,2011,20500090,,,,9,14,23
HND-001083,2011,20500106,,,,7,9,16
HND-001026,2011,20500005,,,,5,3,8
,2011,20500024,,,,15,10,25
HND-001042,2011,20500025,,,,10,11,21
HND-001043,2011,20500026,,,,14,12,26
HND-001045,2011,20500030,,,,4,8,12
HND-001048,2011,20500034,,,,9,14,23
HND-001052,2011,20500040,,,,8,13,21
HND-001060,2011,20500049,,,,7,4,11
HND-001065,2011,20500054,,,,6,4,10
,2011,20500059,,,,6,6,12
HND-001069,2011,20500062,,,,7,4,11
,2011,20500078,,,,8,6,14
,2011,20500090,,,,8,6,14
HND-001083,2011,20500106,,,,11,7,18
HND-001024,2011,20500001,,,,3,4,7
HND-001037,2011,20500017,,,,29,29,58
HND-001040,2011,20500022,,,,21,17,38
HND-001041,2011,20500023,,,,5,4,9
,2011,20500029,,,,11,12,23
,2011,20500035,,,,8,10,18
HND-001053,2011,20500041,,,,43,49,92
HND-001057,2011,20500046,,,,10,6,16
HND-001058,2011,20500047,,,,0,8,8
,2011,20500077,,,,6,10,16
,2011,20500079,,,,6,5,11
HND-001026,2011,20500005,,,,6,5,11
HND-001027,2011,20500006,,,,7,16,23
HND-001028,2011,20500007,,,,7,5,12
HND-001029,2011,20500008,,,,6,21,27
HND-001034,2011,20500014,,,,8,12,20
HND-001035,2011,20500015,,,,19,9,28
HND-001036,2011,20500016,,,,20,20,40
HND-001044,2011,20500028,,,,39,37,76
,2011,20500031,,,,26,27,53
,2011,20500036,,,,4,15,19
HND-001050,2011,20500037,,,,15,10,25
HND-001051,2011,20500038,,,,13,14,27
HND-001054,2011,20500042,,,,48,43,91
HND-001055,2011,20500043,,,,5,10,15
HND-001059,2011,20500048,,,,25,24,49
HND-001062,2011,20500051,,,,3,5,8
HND-001063,2011,20500052,,,,16,14,30
HND-001064,2011,20500053,,,,4,0,4
HND-001068,2011,20500058,,,,17,17,34
HND-001076,2011,20500091,,,,11,11,22
HND-001077,2011,20500093,,,,4,1,5
HND-001081,2011,20500104,,,,9,4,13
HND-001025,2011,20500004,,,,76,52,128
HND-001030,2011,20500009,,,,4,2,6
HND-001031,2011,20500010,,,,7,8,15
HND-001032,2011,20500011,,,,13,14,27
HND-001033,2011,20500012,,,,15,13,28
HND-001038,2011,20500019,,,,35,17,52
HND-001039,2011,20500020,,,,18,15,33
HND-001046,2011,20500032,,,,4,6,10
HND-001047,2011,20500033,,,,6,3,9
HND-001066,2011,20500055,,,,4,6,10
HND-001067,2011,20500056,,,,12,7,19
,2011,20500057,,,,11,11,22
,2011,20500078,,,,4,8,12
HND-001082,2011,20500105,,,,14,12,26
HND-001083,2011,20500106,,,,13,4,17
HND-001026,2011,20500005,,,,4,4,8
HND-001027,2011,20500006,,,,7,6,13
HND-001028,2011,20500007,,,,3,3,6
HND-001031,2011,20500010,,,,3,5,8
HND-001033,2011,20500012,,,,15,13,28
HND-001034,2011,20500014,,,,8,5,13
HND-001046,2011,20500032,,,,2,3,5
HND-001047,2011,20500033,,,,4,3,7
HND-001051,2011,20500038,,,,7,15,22
HND-001055,2011,20500043,,,,5,5,10
HND-001063,2011,20500052,,,,16,17,33
HND-001064,2011,20500053,,,,1,1,2
,2011,20500078,,,,7,7,14
HND-001076,2011,20500091,,,,8,11,19
HND-001025,2011,20500004,,,,58,42,100
HND-001029,2011,20500008,,,,17,15,32
HND-001030,2011,20500009,,,,4,3,7
HND-001032,2011,20500011,,,,9,14,23
HND-001035,2011,20500015,,,,8,9,17
HND-001036,2011,20500016,,,,15,15,30
HND-001038,2011,20500019,,,,30,28,58
HND-001039,2011,20500020,,,,16,12,28
HND-001044,2011,20500028,,,,45,33,78
,2011,20500031,,,,22,19,41
,2011,20500036,,,,12,17,29
HND-001050,2011,20500037,,,,13,10,23
HND-001054,2011,20500042,,,,51,30,81
HND-001059,2011,20500048,,,,16,23,39
HND-001062,2011,20500051,,,,6,9,15
HND-001066,2011,20500055,,,,4,4,8
HND-001067,2011,20500056,,,,10,15,25
,2011,20500057,,,,11,6,17
HND-001068,2011,20500058,,,,21,15,36
HND-001077,2011,20500093,,,,5,1,6
HND-001081,2011,20500104,,,,2,0,2
HND-001082,2011,20500105,,,,2,3,5
HND-001083,2011,20500106,,,,9,17,26
HND-001026,2011,20500005,,,,2,6,8
HND-001027,2011,20500006,,,,3,4,7
HND-001028,2011,20500007,,,,7,5,12
HND-001029,2011,20500008,,,,15,15,30
HND-001034,2011,20500014,,,,5,3,8
HND-001035,2011,20500015,,,,8,11,19
HND-001036,2011,20500016,,,,8,10,18
HND-001044,2011,20500028,,,,42,29,71
HND-001046,2011,20500032,,,,2,1,3
HND-001047,2011,20500033,,,,5,4,9
HND-001066,2011,20500055,,,,5,5,10
HND-001067,2011,20500056,,,,4,5,9
,2011,20500057,,,,6,14,20
,2011,20500078,,,,3,7,10
HND-001081,2011,20500104,,,,4,4,8
HND-001025,2011,20500004,,,,51,54,105
HND-001030,2011,20500009,,,,3,4,7
HND-001031,2011,20500010,,,,6,5,11
HND-001032,2011,20500011,,,,16,11,27
HND-001033,2011,20500012,,,,23,19,42
HND-001038,2011,20500019,,,,28,25,53
HND-001039,2011,20500020,,,,15,15,30
,2011,20500031,,,,20,20,40
,2011,20500036,,,,14,13,27
HND-001050,2011,20500037,,,,11,15,26
HND-001051,2011,20500038,,,,13,15,28
HND-001054,2011,20500042,,,,39,32,71
HND-001055,2011,20500043,,,,8,10,18
HND-001059,2011,20500048,,,,17,15,32
HND-001062,2011,20500051,,,,5,9,14
HND-001063,2011,20500052,,,,10,15,25
HND-001064,2011,20500053,,,,3,0,3
HND-001068,2011,20500058,,,,4,9,13
HND-001076,2011,20500091,,,,4,10,14
HND-001082,2011,20500105,,,,1,1,2
HND-001083,2011,20500106,,,,5,3,8
HND-001028,2011,20500007,,,,3,5,8
HND-001031,2011,20500010,,,,7,4,11
HND-001033,2011,20500012,,,,8,12,20
HND-001034,2011,20500014,,,,2,2,4
HND-001046,2011,20500032,,,,1,4,5
HND-001047,2011,20500033,,,,4,8,12
HND-001051,2011,20500038,,,,7,9,16
HND-001055,2011,20500043,,,,10,4,14
HND-001063,2011,20500052,,,,22,18,40
HND-001064,2011,20500053,,,,2,2,4
,2011,20500078,,,,8,6,14
HND-001076,2011,20500091,,,,7,3,10
HND-001025,2011,20500004,,,,52,57,109
HND-001026,2011,20500005,,,,5,7,12
HND-001027,2011,20500006,,,,11,0,11
HND-001029,2011,20500008,,,,13,14,27
HND-001030,2011,20500009,,,,5,3,8
HND-001032,2011,20500011,,,,11,15,26
HND-001035,2011,20500015,,,,6,10,16
HND-001036,2011,20500016,,,,8,8,16
HND-001038,2011,20500019,,,,20,27,47
HND-001039,2011,20500020,,,,8,14,22
HND-001044,2011,20500028,,,,42,41,83
,2011,20500031,,,,28,17,45
,2011,20500036,,,,16,13,29
HND-001050,2011,20500037,,,,16,12,28
HND-001054,2011,20500042,,,,43,41,84
HND-001059,2011,20500048,,,,24,20,44
HND-001062,2011,20500051,,,,6,6,12
HND-001067,2011,20500056,,,,6,7,13
,2011,20500057,,,,14,7,21
HND-001068,2011,20500058,,,,12,7,19
HND-001077,2011,20500093,,,,2,1,3
HND-001081,2011,20500104,,,,4,1,5
HND-001082,2011,20500105,,,,2,6,8
HND-001083,2011,20500106,,,,15,8,23
HND-001030,2011,20500009,,,,5,7,12
HND-001031,2011,20500010,,,,5,2,7
HND-001032,2011,20500011,,,,13,10,23
HND-001033,2011,20500012,,,,13,13,26
,2011,20500031,,,,20,20,40
HND-001047,2011,20500033,,,,5,3,8
,2011,20500036,,,,10,15,25
HND-001051,2011,20500038,,,,13,7,20
HND-001054,2011,20500042,,,,46,45,91
HND-001055,2011,20500043,,,,4,5,9
HND-001059,2011,20500048,,,,13,14,27
HND-001062,2011,20500051,,,,7,6,13
HND-001063,2011,20500052,,,,6,10,16
HND-001064,2011,20500053,,,,8,0,8
,2011,20500078,,,,4,2,6
HND-001076,2011,20500091,,,,11,3,14
HND-001082,2011,20500105,,,,1,0,1
HND-001083,2011,20500106,,,,8,7,15
HND-001025,2011,20500004,,,,52,57,109
HND-001026,2011,20500005,,,,5,1,6
HND-001027,2011,20500006,,,,4,3,7
HND-001028,2011,20500007,,,,0,4,4
HND-001029,2011,20500008,,,,18,28,46
HND-001034,2011,20500014,,,,7,3,10
HND-001035,2011,20500015,,,,7,4,11
HND-001036,2011,20500016,,,,18,20,38
HND-001038,2011,20500019,,,,24,26,50
HND-001039,2011,20500020,,,,7,8,15
HND-001044,2011,20500028,,,,52,54,106
HND-001046,2011,20500032,,,,5,2,7
HND-001050,2011,20500037,,,,5,15,20
HND-001066,2011,20500055,,,,3,5,8
HND-001067,2011,20500056,,,,5,5,10
,2011,20500057,,,,20,17,37
HND-001068,2011,20500058,,,,6,8,14
HND-001077,2011,20500093,,,,1,2,3
HND-001081,2011,20500104,,,,0,1,1
HND-001025,2011,20500004,,,,63,67,130
HND-001029,2011,20500008,,,,7,12,19
HND-001030,2011,20500009,,,,4,7,11
HND-001032,2011,20500011,,,,13,15,28
HND-001035,2011,20500015,,,,10,14,24
HND-001036,2011,20500016,,,,6,10,16
HND-001038,2011,20500019,,,,27,30,57
HND-001039,2011,20500020,,,,15,10,25
HND-001044,2011,20500028,,,,35,31,66
,2011,20500031,,,,26,27,53
,2011,20500036,,,,12,15,27
HND-001050,2011,20500037,,,,16,7,23
HND-001054,2011,20500042,,,,35,22,57
HND-001059,2011,20500048,,,,19,14,33
HND-001062,2011,20500051,,,,4,6,10
HND-001066,2011,20500055,,,,1,3,4
HND-001067,2011,20500056,,,,6,12,18
,2011,20500057,,,,19,20,39
HND-001068,2011,20500058,,,,11,10,21
HND-001077,2011,20500093,,,,0,2,2
HND-001081,2011,20500104,,,,1,0,1
HND-001083,2011,20500106,,,,3,7,10
HND-001026,2011,20500005,,,,3,4,7
HND-001027,2011,20500006,,,,2,1,3
HND-001028,2011,20500007,,,,0,6,6
HND-001031,2011,20500010,,,,6,5,11
HND-001033,2011,20500012,,,,13,14,27
HND-001034,2011,20500014,,,,3,2,5
HND-001046,2011,20500032,,,,2,2,4
HND-001047,2011,20500033,,,,3,2,5
HND-001051,2011,20500038,,,,10,15,25
HND-001055,2011,20500043,,,,8,3,11
HND-001063,2011,20500052,,,,18,19,37
HND-001064,2011,20500053,,,,3,0,3
HND-001076,2011,20500091,,,,5,3,8
,2011,20500013,,,,5,6,11
,2011,20500021,,,,17,27,44
,2011,20500036,,,,16,19,35
HND-001059,2011,20500048,,,,25,28,53
HND-001061,2011,20500050,,,,294,278,572
,2011,20500057,,,,26,36,62
HND-001029,2011,20500008,,,,17,18,35
HND-001050,2011,20500037,,,,7,13,20
HND-001056,2011,20500045,,,,61,62,123
,2011,20500013,,,,6,8,14
HND-001029,2011,20500008,,,,7,11,18
,2011,20500021,,,,21,27,48
,2011,20500036,,,,17,12,29
HND-001050,2011,20500037,,,,6,6,12
HND-001056,2011,20500045,,,,42,52,94
HND-001059,2011,20500048,,,,12,14,26
HND-001061,2011,20500050,,,,141,201,342
,2011,20500057,,,,38,33,71
,2011,20500013,,,,5,10,15
,2011,20500021,,,,24,25,49
HND-001056,2011,20500045,,,,29,26,55
HND-001061,2011,20500050,,,,143,176,319
,2011,20500057,,,,28,31,59
HND-001029,2011,20500008,,,,6,10,16
,2011,20500036,,,,8,6,14
HND-001050,2011,20500037,,,,5,3,8
HND-001059,2011,20500048,,,,18,23,41
,2011,20500013,,,,7,14,21
,2011,20500021,,,,26,42,68
HND-001056,2011,20500045,,,,38,51,89
HND-001061,2011,20500050,,,,160,170,330
,2011,20500057,,,,60,98,158
,2011,20500013,,,,11,13,24
,2011,20500021,,,,16,32,48
HND-001056,2011,20500045,,,,14,24,38
HND-001061,2011,20500050,,,,94,135,229
,2011,20500057,,,,24,37,61
,2011,20500013,,,,2,6,8
,2011,20500021,,,,15,26,41
HND-001056,2011,20500045,,,,17,23,40
HND-001061,2011,20500050,,,,57,119,176
,2011,20500057,,,,22,31,53
HND-001103,2011,20600021,,,,7,5,12
HND-001105,2011,20600023,,,,9,5,14
,2011,20600042,,,,4,3,7
HND-001108,2011,20600043,,,,3,4,7
,2011,20600048,,,,5,6,11
HND-001119,2011,20600054,,,,4,2,6
HND-001101,2011,20600019,,,,3,7,10
HND-001104,2011,20600022,,,,4,6,10
HND-001106,2011,20600024,,,,8,6,14
,2011,20600044,,,,4,4,8
HND-001110,2011,20600045,,,,8,6,14
HND-001111,2011,20600046,,,,12,11,23
HND-001112,2011,20600047,,,,3,7,10
HND-001117,2011,20600052,,,,0,5,5
HND-001118,2011,20600053,,,,5,0,5
HND-001086,2011,20600004,,,,5,5,10
HND-001089,2011,20600007,,,,3,7,10
HND-001099,2011,20600017,,,,3,4,7
HND-001095,2011,20600013,,,,4,2,6
HND-001086,2011,20600004,,,,4,7,11
HND-001095,2011,20600013,,,,4,6,10
HND-001089,2011,20600007,,,,13,8,21
HND-001099,2011,20600017,,,,7,3,10
HND-001089,2011,20600007,,,,13,12,25
HND-001099,2011,20600017,,,,3,2,5
HND-001086,2011,20600004,,,,6,6,12
HND-001095,2011,20600013,,,,2,5,7
HND-001084,2011,20600002,,,,1,2,3
,2011,20600005,,,,9,12,21
HND-001088,2011,20600006,,,,3,8,11
HND-001090,2011,20600008,,,,9,8,17
,2011,20600010,,,,6,5,11
HND-001094,2011,20600012,,,,6,6,12
HND-001097,2011,20600015,,,,22,23,45
HND-001114,2011,20600049,,,,1,1,2
HND-001116,2011,20600051,,,,1,0,1
HND-001085,2011,20600003,,,,6,2,8
HND-001091,2011,20600009,,,,1,2,3
HND-001096,2011,20600014,,,,12,11,23
HND-001098,2011,20600016,,,,9,9,18
,2011,20600018,,,,0,3,3
HND-001107,2011,20600037,,,,2,2,4
,2011,20600050,,,,6,9,15
HND-001085,2011,20600003,,,,4,4,8
HND-001090,2011,20600008,,,,8,9,17
HND-001091,2011,20600009,,,,2,2,4
HND-001094,2011,20600012,,,,3,2,5
HND-001096,2011,20600014,,,,9,9,18
HND-001097,2011,20600015,,,,10,13,23
,2011,20600018,,,,12,7,19
,2011,20600050,,,,3,5,8
HND-001116,2011,20600051,,,,1,1,2
HND-001084,2011,20600002,,,,4,2,6
,2011,20600005,,,,5,4,9
HND-001088,2011,20600006,,,,16,3,19
,2011,20600010,,,,9,2,11
HND-001098,2011,20600016,,,,7,5,12
HND-001107,2011,20600037,,,,6,4,10
HND-001114,2011,20600049,,,,3,0,3
HND-001085,2011,20600003,,,,2,5,7
HND-001091,2011,20600009,,,,2,1,3
HND-001096,2011,20600014,,,,10,4,14
HND-001097,2011,20600015,,,,18,13,31
HND-001098,2011,20600016,,,,1,11,12
,2011,20600018,,,,9,9,18
,2011,20600050,,,,5,6,11
HND-001084,2011,20600002,,,,4,1,5
,2011,20600005,,,,3,3,6
HND-001088,2011,20600006,,,,7,9,16
HND-001090,2011,20600008,,,,3,4,7
,2011,20600010,,,,4,2,6
HND-001094,2011,20600012,,,,2,5,7
HND-001107,2011,20600037,,,,3,5,8
HND-001114,2011,20600049,,,,2,2,4
HND-001084,2011,20600002,,,,2,2,4
HND-001085,2011,20600003,,,,3,2,5
,2011,20600005,,,,2,2,4
HND-001088,2011,20600006,,,,3,9,12
HND-001090,2011,20600008,,,,2,5,7
,2011,20600010,,,,5,6,11
HND-001094,2011,20600012,,,,5,6,11
HND-001096,2011,20600014,,,,8,3,11
HND-001097,2011,20600015,,,,15,19,34
,2011,20600018,,,,2,10,12
,2011,20600050,,,,3,3,6
HND-001116,2011,20600051,,,,1,1,2
HND-001091,2011,20600009,,,,1,1,2
HND-001098,2011,20600016,,,,2,1,3
HND-001107,2011,20600037,,,,0,6,6
HND-001084,2011,20600002,,,,2,2,4
,2011,20600005,,,,4,4,8
HND-001088,2011,20600006,,,,5,10,15
HND-001090,2011,20600008,,,,5,5,10
,2011,20600010,,,,14,4,18
HND-001094,2011,20600012,,,,2,6,8
HND-001096,2011,20600014,,,,2,6,8
HND-001097,2011,20600015,,,,14,13,27
,2011,20600018,,,,3,10,13
HND-001114,2011,20600049,,,,1,3,4
HND-001085,2011,20600003,,,,3,1,4
HND-001091,2011,20600009,,,,4,2,6
HND-001098,2011,20600016,,,,1,3,4
HND-001107,2011,20600037,,,,7,7,14
,2011,20600050,,,,6,5,11
HND-001084,2011,20600002,,,,2,1,3
,2011,20600005,,,,6,7,13
HND-001088,2011,20600006,,,,4,13,17
,2011,20600010,,,,0,3,3
HND-001098,2011,20600016,,,,2,3,5
HND-001107,2011,20600037,,,,4,3,7
HND-001114,2011,20600049,,,,1,1,2
HND-001085,2011,20600003,,,,2,3,5
HND-001090,2011,20600008,,,,3,2,5
HND-001094,2011,20600012,,,,3,3,6
HND-001096,2011,20600014,,,,6,2,8
HND-001097,2011,20600015,,,,13,16,29
,2011,20600018,,,,3,4,7
HND-001116,2011,20600051,,,,2,2,4
HND-001093,2011,20600011,,,,30,19,49
HND-001094,2011,20600012,,,,7,5,12
HND-001093,2011,20600011,,,,22,30,52
HND-001094,2011,20600012,,,,11,6,17
HND-001093,2011,20600011,,,,14,12,26
HND-001094,2011,20600012,,,,5,5,10
HND-001093,2011,20600011,,,,2,6,8
HND-001093,2011,20600011,,,,1,5,6
HND-001093,2011,20600011,,,,2,11,13
HND-001131,2011,20700029,,,,4,5,9
,2011,20700031,,,,7,9,16
,2011,20700033,,,,10,13,23
,2011,20700028,,,,8,14,22
,2011,20700030,,,,4,9,13
HND-001132,2011,20700032,,,,15,9,24
,2011,20700007,,,,1,4,5
HND-001128,2011,20700011,,,,7,8,15
HND-001129,2011,20700013,,,,1,1,2
HND-001128,2011,20700011,,,,9,11,20
,2011,20700015,,,,4,3,7
HND-001124,2011,20700006,,,,12,8,20
,2011,20700007,,,,3,2,5
HND-001125,2011,20700008,,,,12,13,25
HND-001129,2011,20700013,,,,7,2,9
HND-001124,2011,20700006,,,,8,5,13
,2011,20700007,,,,4,1,5
HND-001125,2011,20700008,,,,6,6,12
HND-001128,2011,20700011,,,,38,34,72
HND-001129,2011,20700013,,,,7,8,15
,2011,20700015,,,,3,4,7
HND-001126,2011,20700009,,,,6,3,9
HND-001127,2011,20700010,,,,24,20,44
HND-001120,2011,20700001,,,,11,12,23
HND-001121,2011,20700002,,,,11,13,24
HND-001123,2011,20700005,,,,34,44,78
HND-001130,2011,20700014,,,,4,7,11
HND-001123,2011,20700005,,,,34,50,84
HND-001127,2011,20700010,,,,24,15,39
HND-001120,2011,20700001,,,,11,7,18
HND-001121,2011,20700002,,,,18,10,28
HND-001126,2011,20700009,,,,1,4,5
HND-001130,2011,20700014,,,,9,11,20
HND-001121,2011,20700002,,,,16,10,26
HND-001123,2011,20700005,,,,42,29,71
HND-001127,2011,20700010,,,,26,16,42
HND-001130,2011,20700014,,,,8,5,13
HND-001120,2011,20700001,,,,16,14,30
HND-001126,2011,20700009,,,,5,1,6
HND-001126,2011,20700009,,,,2,5,7
HND-001127,2011,20700010,,,,8,9,17
HND-001120,2011,20700001,,,,8,10,18
HND-001121,2011,20700002,,,,13,9,22
HND-001123,2011,20700005,,,,39,31,70
HND-001130,2011,20700014,,,,12,6,18
HND-001126,2011,20700009,,,,4,2,6
HND-001127,2011,20700010,,,,15,18,33
HND-001120,2011,20700001,,,,7,12,19
HND-001121,2011,20700002,,,,13,13,26
HND-001123,2011,20700005,,,,21,34,55
HND-001130,2011,20700014,,,,10,8,18
HND-001120,2011,20700001,,,,7,10,17
HND-001121,2011,20700002,,,,9,10,19
HND-001126,2011,20700009,,,,2,1,3
HND-001130,2011,20700014,,,,5,6,11
HND-001123,2011,20700005,,,,17,23,40
HND-001127,2011,20700010,,,,7,10,17
HND-001122,2011,20700004,,,,27,24,51
HND-001123,2011,20700005,,,,18,22,40
HND-001122,2011,20700004,,,,19,30,49
HND-001123,2011,20700005,,,,12,14,26
HND-001122,2011,20700004,,,,18,17,35
HND-001123,2011,20700005,,,,12,6,18
HND-001122,2011,20700004,,,,8,9,17
HND-001122,2011,20700004,,,,7,8,15
HND-001122,2011,20700004,,,,2,5,7
HND-001226,2011,20800138,,,,8,4,12
,2011,20800141,,,,3,5,8
,2011,20800142,,,,2,4,6
,2011,20800145,,,,6,9,15
,2011,20800147,,,,7,8,15
HND-001228,2011,20800148,,,,6,4,10
HND-001230,2011,20800151,,,,9,3,12
,2011,20800154,,,,7,6,13
,2011,20800155,,,,5,7,12
,2011,20800157,,,,6,3,9
,2011,20800161,,,,4,4,8
,2011,20800174,,,,17,3,20
,2011,20800175,,,,3,4,7
HND-001237,2011,20800178,,,,4,2,6
,2011,20800114,,,,5,9,14
,2011,20800137,,,,17,17,34
,2011,20800139,,,,1,4,5
,2011,20800140,,,,14,16,30
,2011,20800143,,,,13,13,26
HND-001227,2011,20800146,,,,3,3,6
HND-001229,2011,20800149,,,,6,7,13
,2011,20800150,,,,4,1,5
,2011,20800152,,,,13,13,26
,2011,20800153,,,,4,5,9
,2011,20800156,,,,6,1,7
,2011,20800160,,,,4,4,8
,2011,20800162,,,,1,5,6
,2011,20800163,,,,2,2,4
,2011,20800176,,,,4,7,11
,2011,20800177,,,,14,8,22
HND-001238,2011,20800179,,,,7,8,15
HND-001183,2011,20800055,,,,2,2,4
HND-001185,2011,20800060,,,,1,3,4
,2011,20800075,,,,1,2,3
HND-001198,2011,20800082,,,,2,2,4
HND-001199,2011,20800083,,,,3,3,6
HND-001209,2011,20800100,,,,2,3,5
,2011,20800107,,,,1,1,2
HND-001217,2011,20800111,,,,8,7,15
HND-001218,2011,20800112,,,,0,2,2
,2011,20800113,,,,9,7,16
HND-001220,2011,20800120,,,,5,6,11
HND-001222,2011,20800128,,,,6,2,8
HND-001223,2011,20800131,,,,3,2,5
,2011,20800132,,,,2,0,2
HND-001224,2011,20800134,,,,2,2,4
HND-001225,2011,20800135,,,,0,2,2
,2011,20800136,,,,4,2,6
HND-001233,2011,20800167,,,,0,3,3
HND-001180,2011,20800052,,,,3,1,4
HND-001182,2011,20800054,,,,3,6,9
HND-001195,2011,20800076,,,,0,1,1
HND-001201,2011,20800088,,,,2,5,7
HND-001205,2011,20800093,,,,0,1,1
HND-001212,2011,20800103,,,,0,2,2
,2011,20800127,,,,1,3,4
,2011,20800143,,,,3,3,6
,2011,20800164,,,,0,5,5
HND-001234,2011,20800169,,,,5,1,6
,2011,20800019,,,,3,0,3
HND-001179,2011,20800050,,,,1,1,2
HND-001181,2011,20800053,,,,3,4,7
HND-001183,2011,20800055,,,,1,3,4
,2011,20800056,,,,8,8,16
HND-001190,2011,20800066,,,,5,3,8
,2011,20800070,,,,4,5,9
,2011,20800071,,,,0,1,1
,2011,20800072,,,,6,4,10
,2011,20800079,,,,5,1,6
HND-001198,2011,20800082,,,,4,7,11
HND-001209,2011,20800100,,,,8,4,12
HND-001212,2011,20800103,,,,3,3,6
,2011,20800107,,,,1,4,5
HND-001217,2011,20800111,,,,5,8,13
HND-001220,2011,20800120,,,,5,6,11
HND-001221,2011,20800126,,,,11,13,24
,2011,20800127,,,,3,7,10
HND-001222,2011,20800128,,,,13,4,17
,2011,20800132,,,,1,1,2
HND-001225,2011,20800135,,,,5,3,8
,2011,20800136,,,,3,2,5
,2011,20800164,,,,4,7,11
,2011,20800165,,,,2,1,3
HND-001233,2011,20800167,,,,5,1,6
HND-001235,2011,20800170,,,,2,4,6
HND-001178,2011,20800049,,,,17,22,39
HND-001180,2011,20800052,,,,10,7,17
HND-001182,2011,20800054,,,,3,5,8
,2011,20800057,,,,3,6,9
HND-001184,2011,20800059,,,,5,11,16
HND-001185,2011,20800060,,,,2,1,3
HND-001192,2011,20800069,,,,1,4,5
,2011,20800075,,,,2,4,6
HND-001195,2011,20800076,,,,3,1,4
,2011,20800077,,,,4,2,6
HND-001196,2011,20800078,,,,10,14,24
HND-001199,2011,20800083,,,,0,4,4
HND-001201,2011,20800088,,,,2,2,4
HND-001205,2011,20800093,,,,2,3,5
HND-001208,2011,20800098,,,,9,14,23
,2011,20800099,,,,5,5,10
HND-001210,2011,20800101,,,,5,3,8
,2011,20800109,,,,4,6,10
HND-001218,2011,20800112,,,,1,3,4
,2011,20800113,,,,7,7,14
HND-001223,2011,20800131,,,,6,5,11
,2011,20800133,,,,1,2,3
HND-001224,2011,20800134,,,,2,0,2
,2011,20800143,,,,12,4,16
,2011,20800168,,,,4,2,6
HND-001234,2011,20800169,,,,0,3,3
,2011,20800019,,,,2,0,2
HND-001178,2011,20800049,,,,20,32,52
HND-001179,2011,20800050,,,,14,14,28
HND-001180,2011,20800052,,,,14,12,26
HND-001181,2011,20800053,,,,5,5,10
HND-001182,2011,20800054,,,,2,3,5
,2011,20800057,,,,6,3,9
HND-001184,2011,20800059,,,,19,9,28
,2011,20800075,,,,6,6,12
HND-001195,2011,20800076,,,,3,3,6
,2011,20800077,,,,7,5,12
HND-001196,2011,20800078,,,,20,17,37
HND-001201,2011,20800088,,,,2,1,3
HND-001205,2011,20800093,,,,6,3,9
,2011,20800099,,,,2,3,5
HND-001210,2011,20800101,,,,3,8,11
,2011,20800109,,,,7,8,15
HND-001218,2011,20800112,,,,6,4,10
,2011,20800113,,,,5,9,14
HND-001222,2011,20800128,,,,10,12,22
,2011,20800133,,,,2,3,5
HND-001224,2011,20800134,,,,5,1,6
,2011,20800143,,,,1,5,6
,2011,20800168,,,,12,8,20
HND-001234,2011,20800169,,,,1,3,4
HND-001183,2011,20800055,,,,8,5,13
,2011,20800056,,,,8,8,16
HND-001185,2011,20800060,,,,6,4,10
HND-001190,2011,20800066,,,,7,10,17
HND-001192,2011,20800069,,,,9,4,13
,2011,20800070,,,,8,6,14
,2011,20800071,,,,10,12,22
,2011,20800072,,,,12,10,22
,2011,20800079,,,,4,6,10
HND-001198,2011,20800082,,,,9,10,19
HND-001199,2011,20800083,,,,4,2,6
HND-001208,2011,20800098,,,,11,14,25
HND-001209,2011,20800100,,,,10,11,21
HND-001212,2011,20800103,,,,3,3,6
,2011,20800107,,,,4,4,8
HND-001217,2011,20800111,,,,12,10,22
HND-001220,2011,20800120,,,,9,11,20
HND-001221,2011,20800126,,,,3,5,8
,2011,20800127,,,,8,2,10
,2011,20800132,,,,6,2,8
HND-001225,2011,20800135,,,,7,4,11
,2011,20800136,,,,2,2,4
,2011,20800164,,,,9,8,17
,2011,20800165,,,,5,8,13
HND-001233,2011,20800167,,,,8,11,19
HND-001235,2011,20800170,,,,5,2,7
HND-001137,2011,20800005,,,,22,17,39
HND-001138,2011,20800006,,,,21,16,37
HND-001139,2011,20800007,,,,4,7,11
HND-001140,2011,20800008,,,,6,4,10
HND-001146,2011,20800014,,,,10,12,22
HND-001147,2011,20800015,,,,16,20,36
HND-001148,2011,20800016,,,,3,2,5
HND-001149,2011,20800017,,,,4,7,11
HND-001155,2011,20800025,,,,27,35,62
HND-001156,2011,20800026,,,,4,6,10
HND-001158,2011,20800028,,,,30,30,60
HND-001160,2011,20800030,,,,10,10,20
,2011,20800032,,,,8,2,10
HND-001163,2011,20800033,,,,10,15,25
HND-001164,2011,20800034,,,,7,8,15
HND-001169,2011,20800039,,,,0,3,3
HND-001172,2011,20800042,,,,13,11,24
HND-001174,2011,20800045,,,,19,14,33
HND-001175,2011,20800046,,,,12,10,22
HND-001176,2011,20800047,,,,25,20,45
HND-001189,2011,20800064,,,,20,12,32
HND-001191,2011,20800068,,,,4,2,6
HND-001193,2011,20800073,,,,12,8,20
HND-001198,2011,20800082,,,,5,10,15
HND-001200,2011,20800087,,,,5,2,7
HND-001203,2011,20800090,,,,3,0,3
HND-001205,2011,20800093,,,,6,9,15
HND-001213,2011,20800104,,,,2,0,2
,2011,20800107,,,,5,4,9
HND-001216,2011,20800110,,,,12,6,18
HND-001219,2011,20800115,,,,5,7,12
HND-001236,2011,20800172,,,,2,1,3
HND-001134,2011,20800002,,,,8,10,18
HND-001135,2011,20800003,,,,27,21,48
HND-001136,2011,20800004,,,,20,14,34
HND-001141,2011,20800009,,,,6,6,12
HND-001142,2011,20800010,,,,14,14,28
HND-001143,2011,20800011,,,,28,14,42
HND-001144,2011,20800012,,,,23,13,36
HND-001145,2011,20800013,,,,12,8,20
HND-001150,2011,20800018,,,,11,9,20
,2011,20800019,,,,4,1,5
HND-001151,2011,20800020,,,,16,11,27
HND-001152,2011,20800022,,,,6,5,11
HND-001153,2011,20800023,,,,5,1,6
HND-001154,2011,20800024,,,,7,12,19
HND-001157,2011,20800027,,,,16,11,27
HND-001159,2011,20800029,,,,9,9,18
HND-001161,2011,20800031,,,,16,18,34
HND-001165,2011,20800035,,,,7,11,18
HND-001166,2011,20800036,,,,5,6,11
HND-001167,2011,20800037,,,,8,7,15
HND-001168,2011,20800038,,,,13,11,24
HND-001170,2011,20800040,,,,18,15,33
HND-001171,2011,20800041,,,,7,4,11
HND-001173,2011,20800044,,,,25,14,39
HND-001177,2011,20800048,,,,10,11,21
,2011,20800057,,,,4,2,6
HND-001194,2011,20800074,,,,20,27,47
HND-001195,2011,20800076,,,,3,3,6
HND-001197,2011,20800081,,,,6,0,6
HND-001201,2011,20800088,,,,2,2,4
HND-001202,2011,20800089,,,,5,4,9
HND-001204,2011,20800092,,,,2,5,7
HND-001206,2011,20800094,,,,3,5,8
HND-001207,2011,20800096,,,,7,0,7
,2011,20800097,,,,4,2,6
HND-001211,2011,20800102,,,,10,8,18
HND-001215,2011,20800108,,,,12,8,20
,2011,20800109,,,,4,8,12
HND-001231,2011,20800158,,,,5,2,7
HND-001232,2011,20800159,,,,6,9,15
HND-001136,2011,20800004,,,,11,13,24
HND-001137,2011,20800005,,,,18,12,30
HND-001138,2011,20800006,,,,14,15,29
HND-001139,2011,20800007,,,,3,2,5
HND-001144,2011,20800012,,,,15,10,25
HND-001145,2011,20800013,,,,7,3,10
HND-001146,2011,20800014,,,,15,13,28
HND-001149,2011,20800017,,,,8,3,11
,2011,20800019,,,,3,2,5
HND-001154,2011,20800024,,,,3,1,4
HND-001155,2011,20800025,,,,33,38,71
HND-001156,2011,20800026,,,,10,10,20
HND-001161,2011,20800031,,,,22,18,40
HND-001164,2011,20800034,,,,12,10,22
HND-001165,2011,20800035,,,,15,12,27
HND-001166,2011,20800036,,,,5,5,10
HND-001167,2011,20800037,,,,11,6,17
HND-001171,2011,20800041,,,,11,9,20
HND-001175,2011,20800046,,,,13,15,28
HND-001176,2011,20800047,,,,28,26,54
HND-001177,2011,20800048,,,,8,11,19
,2011,20800057,,,,9,2,11
HND-001189,2011,20800064,,,,9,14,23
HND-001195,2011,20800076,,,,9,5,14
HND-001197,2011,20800081,,,,5,3,8
HND-001198,2011,20800082,,,,15,12,27
HND-001201,2011,20800088,,,,2,0,2
HND-001203,2011,20800090,,,,0,2,2
HND-001204,2011,20800092,,,,0,2,2
HND-001205,2011,20800093,,,,0,1,1
HND-001206,2011,20800094,,,,4,3,7
HND-001211,2011,20800102,,,,4,5,9
HND-001215,2011,20800108,,,,9,13,22
,2011,20800109,,,,4,12,16
HND-001216,2011,20800110,,,,7,6,13
HND-001219,2011,20800115,,,,6,2,8
HND-001231,2011,20800158,,,,10,3,13
HND-001236,2011,20800172,,,,2,2,4
HND-001134,2011,20800002,,,,12,9,21
HND-001135,2011,20800003,,,,38,22,60
HND-001140,2011,20800008,,,,5,4,9
HND-001141,2011,20800009,,,,10,11,21
HND-001142,2011,20800010,,,,14,12,26
HND-001143,2011,20800011,,,,19,17,36
HND-001147,2011,20800015,,,,19,15,34
HND-001148,2011,20800016,,,,1,2,3
HND-001150,2011,20800018,,,,8,8,16
HND-001151,2011,20800020,,,,9,13,22
HND-001152,2011,20800022,,,,11,5,16
HND-001153,2011,20800023,,,,4,5,9
HND-001157,2011,20800027,,,,13,7,20
HND-001158,2011,20800028,,,,30,30,60
HND-001159,2011,20800029,,,,10,13,23
HND-001160,2011,20800030,,,,8,3,11
,2011,20800032,,,,8,5,13
HND-001163,2011,20800033,,,,14,7,21
HND-001168,2011,20800038,,,,9,7,16
HND-001169,2011,20800039,,,,1,5,6
HND-001170,2011,20800040,,,,8,16,24
HND-001172,2011,20800042,,,,5,9,14
HND-001173,2011,20800044,,,,13,18,31
HND-001174,2011,20800045,,,,22,14,36
HND-001191,2011,20800068,,,,6,0,6
HND-001193,2011,20800073,,,,9,13,22
HND-001194,2011,20800074,,,,33,28,61
HND-001200,2011,20800087,,,,0,4,4
HND-001202,2011,20800089,,,,7,1,8
HND-001207,2011,20800096,,,,3,5,8
,2011,20800097,,,,0,1,1
HND-001213,2011,20800104,,,,2,4,6
,2011,20800107,,,,9,8,17
HND-001232,2011,20800159,,,,7,7,14
HND-001137,2011,20800005,,,,25,18,43
HND-001138,2011,20800006,,,,14,18,32
HND-001139,2011,20800007,,,,2,2,4
HND-001140,2011,20800008,,,,0,3,3
HND-001146,2011,20800014,,,,14,10,24
HND-001147,2011,20800015,,,,11,19,30
HND-001148,2011,20800016,,,,8,2,10
HND-001149,2011,20800017,,,,4,3,7
,2011,20800019,,,,5,1,6
HND-001155,2011,20800025,,,,36,32,68
HND-001156,2011,20800026,,,,4,7,11
HND-001158,2011,20800028,,,,34,21,55
HND-001161,2011,20800031,,,,18,25,43
HND-001165,2011,20800035,,,,20,15,35
HND-001166,2011,20800036,,,,10,5,15
HND-001167,2011,20800037,,,,2,5,7
HND-001168,2011,20800038,,,,5,11,16
HND-001170,2011,20800040,,,,14,18,32
HND-001171,2011,20800041,,,,6,4,10
HND-001173,2011,20800044,,,,16,22,38
HND-001175,2011,20800046,,,,16,9,25
HND-001177,2011,20800048,,,,7,5,12
,2011,20800057,,,,4,8,12
HND-001189,2011,20800064,,,,9,9,18
HND-001195,2011,20800076,,,,3,2,5
HND-001197,2011,20800081,,,,5,0,5
HND-001201,2011,20800088,,,,3,0,3
HND-001202,2011,20800089,,,,3,3,6
HND-001204,2011,20800092,,,,3,1,4
HND-001206,2011,20800094,,,,7,3,10
,2011,20800097,,,,3,0,3
HND-001211,2011,20800102,,,,0,5,5
HND-001215,2011,20800108,,,,8,13,21
,2011,20800109,,,,10,4,14
HND-001231,2011,20800158,,,,4,4,8
HND-001232,2011,20800159,,,,7,5,12
HND-001134,2011,20800002,,,,14,9,23
HND-001135,2011,20800003,,,,46,38,84
HND-001136,2011,20800004,,,,14,9,23
HND-001141,2011,20800009,,,,12,11,23
HND-001142,2011,20800010,,,,16,23,39
HND-001143,2011,20800011,,,,22,13,35
HND-001144,2011,20800012,,,,14,20,34
HND-001145,2011,20800013,,,,3,1,4
HND-001150,2011,20800018,,,,10,5,15
HND-001151,2011,20800020,,,,14,6,20
HND-001152,2011,20800022,,,,3,2,5
HND-001153,2011,20800023,,,,2,0,2
HND-001154,2011,20800024,,,,3,8,11
HND-001157,2011,20800027,,,,11,14,25
HND-001159,2011,20800029,,,,7,9,16
HND-001160,2011,20800030,,,,6,13,19
,2011,20800032,,,,6,4,10
HND-001163,2011,20800033,,,,14,10,24
HND-001164,2011,20800034,,,,13,12,25
HND-001169,2011,20800039,,,,6,2,8
HND-001172,2011,20800042,,,,11,9,20
HND-001174,2011,20800045,,,,24,18,42
HND-001176,2011,20800047,,,,30,30,60
HND-001191,2011,20800068,,,,0,4,4
HND-001193,2011,20800073,,,,8,13,21
HND-001194,2011,20800074,,,,36,24,60
HND-001198,2011,20800082,,,,5,10,15
HND-001200,2011,20800087,,,,8,2,10
HND-001203,2011,20800090,,,,0,2,2
HND-001205,2011,20800093,,,,0,7,7
HND-001207,2011,20800096,,,,4,7,11
HND-001213,2011,20800104,,,,3,6,9
,2011,20800107,,,,4,10,14
HND-001216,2011,20800110,,,,6,7,13
HND-001219,2011,20800115,,,,7,8,15
HND-001236,2011,20800172,,,,3,0,3
HND-001134,2011,20800002,,,,15,16,31
HND-001136,2011,20800004,,,,9,11,20
HND-001139,2011,20800007,,,,1,0,1
HND-001142,2011,20800010,,,,14,10,24
HND-001144,2011,20800012,,,,16,13,29
HND-001145,2011,20800013,,,,2,5,7
HND-001146,2011,20800014,,,,9,14,23
,2011,20800019,,,,1,0,1
HND-001152,2011,20800022,,,,3,4,7
HND-001154,2011,20800024,,,,5,5,10
HND-001156,2011,20800026,,,,8,4,12
HND-001157,2011,20800027,,,,13,15,28
HND-001161,2011,20800031,,,,17,17,34
,2011,20800032,,,,3,6,9
HND-001164,2011,20800034,,,,6,6,12
HND-001167,2011,20800037,,,,7,6,13
HND-001175,2011,20800046,,,,10,14,24
HND-001176,2011,20800047,,,,25,28,53
,2011,20800057,,,,2,3,5
HND-001189,2011,20800064,,,,6,7,13
HND-001195,2011,20800076,,,,2,6,8
HND-001197,2011,20800081,,,,1,1,2
HND-001198,2011,20800082,,,,4,7,11
HND-001200,2011,20800087,,,,4,0,4
HND-001201,2011,20800088,,,,2,0,2
HND-001203,2011,20800090,,,,2,0,2
HND-001205,2011,20800093,,,,1,0,1
HND-001213,2011,20800104,,,,5,8,13
,2011,20800107,,,,3,5,8
HND-001216,2011,20800110,,,,5,7,12
HND-001219,2011,20800115,,,,5,3,8
HND-001231,2011,20800158,,,,0,2,2
HND-001236,2011,20800172,,,,3,2,5
HND-001135,2011,20800003,,,,22,27,49
HND-001137,2011,20800005,,,,19,14,33
HND-001138,2011,20800006,,,,10,15,25
HND-001140,2011,20800008,,,,3,3,6
HND-001141,2011,20800009,,,,12,3,15
HND-001143,2011,20800011,,,,22,16,38
HND-001147,2011,20800015,,,,15,20,35
HND-001148,2011,20800016,,,,0,4,4
HND-001149,2011,20800017,,,,4,6,10
HND-001150,2011,20800018,,,,12,14,26
HND-001151,2011,20800020,,,,8,8,16
HND-001153,2011,20800023,,,,3,3,6
HND-001155,2011,20800025,,,,37,43,80
HND-001158,2011,20800028,,,,31,25,56
HND-001159,2011,20800029,,,,17,13,30
HND-001160,2011,20800030,,,,7,7,14
HND-001163,2011,20800033,,,,16,15,31
HND-001165,2011,20800035,,,,10,5,15
HND-001166,2011,20800036,,,,10,9,19
HND-001168,2011,20800038,,,,11,9,20
HND-001169,2011,20800039,,,,4,6,10
HND-001170,2011,20800040,,,,15,13,28
HND-001171,2011,20800041,,,,7,6,13
HND-001172,2011,20800042,,,,8,6,14
HND-001173,2011,20800044,,,,21,26,47
HND-001174,2011,20800045,,,,16,18,34
HND-001177,2011,20800048,,,,4,9,13
HND-001191,2011,20800068,,,,2,2,4
HND-001193,2011,20800073,,,,20,15,35
HND-001194,2011,20800074,,,,22,40,62
HND-001202,2011,20800089,,,,4,0,4
HND-001206,2011,20800094,,,,5,5,10
HND-001207,2011,20800096,,,,3,0,3
,2011,20800097,,,,2,0,2
HND-001211,2011,20800102,,,,3,1,4
HND-001215,2011,20800108,,,,18,17,35
,2011,20800109,,,,10,5,15
HND-001232,2011,20800159,,,,12,12,24
HND-001134,2011,20800002,,,,5,11,16
HND-001135,2011,20800003,,,,30,32,62
HND-001136,2011,20800004,,,,7,12,19
HND-001141,2011,20800009,,,,7,9,16
HND-001142,2011,20800010,,,,20,14,34
HND-001143,2011,20800011,,,,20,17,37
HND-001144,2011,20800012,,,,5,16,21
HND-001145,2011,20800013,,,,1,5,6
,2011,20800019,,,,4,3,7
HND-001151,2011,20800020,,,,16,10,26
HND-001152,2011,20800022,,,,9,6,15
HND-001153,2011,20800023,,,,0,1,1
HND-001154,2011,20800024,,,,6,7,13
HND-001157,2011,20800027,,,,13,13,26
HND-001159,2011,20800029,,,,3,12,15
HND-001160,2011,20800030,,,,4,8,12
HND-001161,2011,20800031,,,,20,20,40
,2011,20800032,,,,4,5,9
HND-001163,2011,20800033,,,,10,20,30
HND-001164,2011,20800034,,,,6,5,11
HND-001169,2011,20800039,,,,10,5,15
HND-001174,2011,20800045,,,,22,12,34
HND-001175,2011,20800046,,,,16,14,30
HND-001176,2011,20800047,,,,29,14,43
HND-001189,2011,20800064,,,,10,9,19
HND-001193,2011,20800073,,,,7,10,17
HND-001198,2011,20800082,,,,5,9,14
HND-001200,2011,20800087,,,,1,1,2
HND-001201,2011,20800088,,,,0,2,2
HND-001203,2011,20800090,,,,2,2,4
HND-001204,2011,20800092,,,,5,2,7
HND-001205,2011,20800093,,,,1,0,1
HND-001213,2011,20800104,,,,2,5,7
,2011,20800107,,,,5,7,12
HND-001216,2011,20800110,,,,4,5,9
HND-001219,2011,20800115,,,,4,7,11
HND-001231,2011,20800158,,,,5,3,8
HND-001236,2011,20800172,,,,0,1,1
HND-001137,2011,20800005,,,,21,18,39
HND-001138,2011,20800006,,,,9,14,23
HND-001139,2011,20800007,,,,1,1,2
HND-001146,2011,20800014,,,,10,15,25
HND-001147,2011,20800015,,,,10,21,31
HND-001148,2011,20800016,,,,1,4,5
HND-001149,2011,20800017,,,,2,1,3
HND-001150,2011,20800018,,,,8,10,18
HND-001155,2011,20800025,,,,57,28,85
HND-001156,2011,20800026,,,,5,4,9
HND-001158,2011,20800028,,,,43,33,76
HND-001165,2011,20800035,,,,5,6,11
HND-001166,2011,20800036,,,,9,1,10
HND-001167,2011,20800037,,,,4,5,9
HND-001168,2011,20800038,,,,8,8,16
HND-001170,2011,20800040,,,,10,20,30
HND-001171,2011,20800041,,,,6,0,6
HND-001172,2011,20800042,,,,11,5,16
HND-001173,2011,20800044,,,,14,26,40
HND-001177,2011,20800048,,,,9,5,14
,2011,20800057,,,,4,1,5
HND-001191,2011,20800068,,,,1,2,3
HND-001194,2011,20800074,,,,44,51,95
HND-001195,2011,20800076,,,,4,9,13
HND-001197,2011,20800081,,,,1,4,5
HND-001202,2011,20800089,,,,1,6,7
HND-001206,2011,20800094,,,,3,5,8
HND-001207,2011,20800096,,,,3,0,3
,2011,20800097,,,,0,2,2
HND-001215,2011,20800108,,,,7,13,20
,2011,20800109,,,,11,11,22
HND-001232,2011,20800159,,,,6,3,9
HND-001134,2011,20800002,,,,5,7,12
HND-001135,2011,20800003,,,,22,27,49
HND-001141,2011,20800009,,,,7,8,15
HND-001142,2011,20800010,,,,18,17,35
HND-001143,2011,20800011,,,,15,18,33
HND-001147,2011,20800015,,,,12,13,25
HND-001148,2011,20800016,,,,2,2,4
HND-001150,2011,20800018,,,,11,7,18
HND-001151,2011,20800020,,,,9,9,18
HND-001152,2011,20800022,,,,3,0,3
HND-001153,2011,20800023,,,,1,0,1
HND-001157,2011,20800027,,,,7,10,17
HND-001158,2011,20800028,,,,13,26,39
HND-001159,2011,20800029,,,,14,7,21
HND-001160,2011,20800030,,,,8,7,15
,2011,20800032,,,,3,0,3
HND-001163,2011,20800033,,,,11,16,27
HND-001168,2011,20800038,,,,8,7,15
HND-001169,2011,20800039,,,,2,6,8
HND-001170,2011,20800040,,,,20,13,33
HND-001172,2011,20800042,,,,6,5,11
HND-001173,2011,20800044,,,,15,18,33
HND-001174,2011,20800045,,,,15,17,32
HND-001191,2011,20800068,,,,2,4,6
HND-001193,2011,20800073,,,,8,8,16
HND-001194,2011,20800074,,,,62,67,129
HND-001200,2011,20800087,,,,3,4,7
HND-001202,2011,20800089,,,,4,3,7
HND-001207,2011,20800096,,,,3,3,6
,2011,20800097,,,,3,1,4
HND-001213,2011,20800104,,,,2,2,4
,2011,20800107,,,,6,4,10
HND-001232,2011,20800159,,,,1,4,5
HND-001236,2011,20800172,,,,1,1,2
HND-001136,2011,20800004,,,,6,8,14
HND-001137,2011,20800005,,,,6,9,15
HND-001138,2011,20800006,,,,13,26,39
HND-001139,2011,20800007,,,,1,1,2
HND-001144,2011,20800012,,,,13,14,27
HND-001145,2011,20800013,,,,3,1,4
HND-001146,2011,20800014,,,,10,15,25
HND-001149,2011,20800017,,,,2,8,10
,2011,20800019,,,,1,0,1
HND-001154,2011,20800024,,,,5,4,9
HND-001155,2011,20800025,,,,20,19,39
HND-001156,2011,20800026,,,,2,3,5
HND-001161,2011,20800031,,,,17,19,36
HND-001164,2011,20800034,,,,8,8,16
HND-001165,2011,20800035,,,,10,4,14
HND-001166,2011,20800036,,,,9,6,15
HND-001167,2011,20800037,,,,2,3,5
HND-001171,2011,20800041,,,,5,1,6
HND-001175,2011,20800046,,,,16,11,27
HND-001176,2011,20800047,,,,25,25,50
HND-001177,2011,20800048,,,,7,4,11
,2011,20800057,,,,5,5,10
HND-001189,2011,20800064,,,,5,9,14
HND-001195,2011,20800076,,,,7,1,8
HND-001197,2011,20800081,,,,2,1,3
HND-001198,2011,20800082,,,,3,5,8
HND-001201,2011,20800088,,,,2,2,4
HND-001203,2011,20800090,,,,1,0,1
HND-001205,2011,20800093,,,,3,5,8
HND-001206,2011,20800094,,,,2,4,6
HND-001215,2011,20800108,,,,8,7,15
,2011,20800109,,,,10,7,17
HND-001216,2011,20800110,,,,5,6,11
HND-001219,2011,20800115,,,,1,2,3
HND-001231,2011,20800158,,,,4,1,5
HND-001142,2011,20800010,,,,20,22,42
HND-001144,2011,20800012,,,,13,12,25
HND-001163,2011,20800033,,,,12,14,26
,2011,20800057,,,,7,4,11
HND-001188,2011,20800063,,,,222,230,452
HND-001193,2011,20800073,,,,19,20,39
HND-001214,2011,20800106,,,,42,36,78
,2011,20800109,,,,8,13,21
HND-001138,2011,20800006,,,,31,26,57
HND-001146,2011,20800014,,,,12,14,26
HND-001147,2011,20800015,,,,11,23,34
HND-001158,2011,20800028,,,,23,30,53
HND-001186,2011,20800061,,,,43,48,91
HND-001187,2011,20800062,,,,43,37,80
,2011,20800107,,,,10,10,20
HND-001215,2011,20800108,,,,20,20,40
HND-001138,2011,20800006,,,,17,30,47
HND-001144,2011,20800012,,,,8,7,15
HND-001146,2011,20800014,,,,16,19,35
HND-001186,2011,20800061,,,,28,38,66
HND-001187,2011,20800062,,,,49,34,83
,2011,20800107,,,,6,10,16
HND-001215,2011,20800108,,,,7,22,29
HND-001142,2011,20800010,,,,13,16,29
HND-001147,2011,20800015,,,,11,15,26
HND-001158,2011,20800028,,,,18,23,41
HND-001163,2011,20800033,,,,7,14,21
,2011,20800057,,,,4,1,5
HND-001188,2011,20800063,,,,140,175,315
HND-001193,2011,20800073,,,,5,20,25
HND-001214,2011,20800106,,,,23,22,45
,2011,20800109,,,,7,7,14
HND-001138,2011,20800006,,,,20,17,37
HND-001142,2011,20800010,,,,13,15,28
HND-001144,2011,20800012,,,,4,10,14
HND-001146,2011,20800014,,,,13,12,25
HND-001187,2011,20800062,,,,23,36,59
HND-001214,2011,20800106,,,,21,24,45
,2011,20800109,,,,8,7,15
HND-001147,2011,20800015,,,,5,12,17
HND-001158,2011,20800028,,,,15,20,35
HND-001163,2011,20800033,,,,2,13,15
,2011,20800057,,,,4,6,10
HND-001186,2011,20800061,,,,27,26,53
HND-001188,2011,20800063,,,,109,140,249
HND-001193,2011,20800073,,,,10,10,20
,2011,20800107,,,,6,6,12
HND-001215,2011,20800108,,,,10,10,20
HND-001186,2011,20800061,,,,46,44,90
HND-001188,2011,20800063,,,,191,213,404
,2011,20800109,,,,5,2,7
HND-001187,2011,20800062,,,,27,46,73
HND-001214,2011,20800106,,,,3,16,19
,2011,20800107,,,,8,6,14
,2011,20800180,,,,11,16,27
HND-001187,2011,20800062,,,,24,44,68
HND-001214,2011,20800106,,,,4,14,18
HND-001186,2011,20800061,,,,14,16,30
HND-001188,2011,20800063,,,,116,186,302
,2011,20800107,,,,6,15,21
,2011,20800109,,,,4,10,14
HND-001187,2011,20800062,,,,17,12,29
HND-001214,2011,20800106,,,,10,14,24
,2011,20800107,,,,2,5,7
HND-001186,2011,20800061,,,,15,28,43
HND-001188,2011,20800063,,,,86,119,205
HND-001321,2011,20900093,,,,6,5,11
HND-001351,2011,20900135,,,,6,20,26
HND-001352,2011,20900137,,,,6,8,14
,2011,20900139,,,,7,5,12
HND-001353,2011,20900173,,,,2,5,7
,2011,20900176,,,,3,2,5
,2011,20900179,,,,2,4,6
,2011,20900180,,,,4,6,10
HND-001355,2011,20900181,,,,9,8,17
,2011,20900185,,,,4,8,12
,2011,20900194,,,,0,5,5
,2011,20900195,,,,3,0,3
,2011,20900196,,,,3,6,9
,2011,20900198,,,,5,1,6
,2011,20900204,,,,6,9,15
,2011,20900205,,,,6,5,11
,2011,20900206,,,,10,2,12
,2011,20900207,,,,7,3,10
,2011,20900208,,,,6,4,10
HND-001240,2011,20900001,,,,3,1,4
HND-001266,2011,20900028,,,,6,5,11
HND-001282,2011,20900045,,,,5,8,13
HND-001284,2011,20900047,,,,2,3,5
HND-001287,2011,20900051,,,,3,6,9
HND-001288,2011,20900052,,,,6,3,9
,2011,20900134,,,,7,3,10
,2011,20900136,,,,19,10,29
,2011,20900138,,,,4,6,10
,2011,20900172,,,,7,5,12
,2011,20900174,,,,8,8,16
,2011,20900175,,,,4,4,8
HND-001354,2011,20900177,,,,6,2,8
,2011,20900178,,,,5,8,13
HND-001357,2011,20900187,,,,2,7,9
,2011,20900189,,,,5,5,10
,2011,20900197,,,,7,0,7
HND-001360,2011,20900199,,,,2,3,5
,2011,20900200,,,,6,4,10
,2011,20900201,,,,2,4,6
HND-001361,2011,20900202,,,,3,1,4
,2011,20900203,,,,13,3,16
,2011,20900209,,,,3,4,7
HND-001292,2011,20900056,,,,2,3,5
HND-001299,2011,20900064,,,,13,8,21
HND-001301,2011,20900066,,,,2,3,5
HND-001305,2011,20900071,,,,6,3,9
HND-001306,2011,20900072,,,,1,2,3
,2011,20900086,,,,9,9,18
HND-001323,2011,20900095,,,,3,3,6
,2011,20900096,,,,0,1,1
,2011,20900109,,,,1,3,4
,2011,20900111,,,,9,8,17
,2011,20900122,,,,4,2,6
,2011,20900193,,,,1,6,7
HND-001300,2011,20900065,,,,2,3,5
HND-001304,2011,20900070,,,,3,1,4
,2011,20900110,,,,9,6,15
HND-001361,2011,20900202,,,,0,1,1
HND-001292,2011,20900056,,,,17,8,25
HND-001293,2011,20900057,,,,7,5,12
,2011,20900058,,,,10,3,13
HND-001296,2011,20900061,,,,10,13,23
HND-001297,2011,20900062,,,,4,9,13
HND-001301,2011,20900066,,,,10,11,21
HND-001303,2011,20900069,,,,1,1,2
HND-001304,2011,20900070,,,,6,6,12
HND-001305,2011,20900071,,,,7,12,19
HND-001310,2011,20900079,,,,7,8,15
HND-001317,2011,20900089,,,,0,1,1
HND-001318,2011,20900090,,,,8,14,22
HND-001325,2011,20900098,,,,3,1,4
,2011,20900104,,,,6,4,10
HND-001350,2011,20900133,,,,5,7,12
,2011,20900193,,,,11,7,18
,2011,20900036,,,,6,6,12
HND-001278,2011,20900041,,,,3,3,6
HND-001291,2011,20900055,,,,26,35,61
HND-001294,2011,20900059,,,,8,4,12
HND-001295,2011,20900060,,,,21,24,45
HND-001298,2011,20900063,,,,6,0,6
HND-001299,2011,20900064,,,,16,13,29
HND-001300,2011,20900065,,,,2,2,4
HND-001302,2011,20900067,,,,3,5,8
,2011,20900068,,,,3,5,8
HND-001306,2011,20900072,,,,5,5,10
HND-001311,2011,20900080,,,,11,6,17
,2011,20900084,,,,4,3,7
HND-001314,2011,20900085,,,,8,2,10
,2011,20900086,,,,20,12,32
HND-001320,2011,20900092,,,,3,2,5
HND-001322,2011,20900094,,,,0,3,3
HND-001323,2011,20900095,,,,8,4,12
,2011,20900096,,,,3,6,9
HND-001324,2011,20900097,,,,4,3,7
,2011,20900109,,,,7,7,14
,2011,20900111,,,,9,9,18
HND-001336,2011,20900114,,,,6,4,10
HND-001337,2011,20900115,,,,2,2,4
,2011,20900122,,,,2,0,2
HND-001345,2011,20900127,,,,7,2,9
HND-001361,2011,20900202,,,,0,4,4
,2011,20900036,,,,6,4,10
HND-001291,2011,20900055,,,,75,57,132
,2011,20900058,,,,6,7,13
HND-001294,2011,20900059,,,,15,8,23
HND-001297,2011,20900062,,,,10,11,21
HND-001299,2011,20900064,,,,25,25,50
HND-001301,2011,20900066,,,,35,35,70
HND-001303,2011,20900069,,,,12,10,22
HND-001304,2011,20900070,,,,24,16,40
HND-001310,2011,20900079,,,,11,11,22
HND-001311,2011,20900080,,,,18,16,34
,2011,20900084,,,,11,11,22
HND-001314,2011,20900085,,,,14,17,31
,2011,20900086,,,,26,26,52
HND-001320,2011,20900092,,,,14,17,31
HND-001322,2011,20900094,,,,14,13,27
HND-001324,2011,20900097,,,,3,6,9
,2011,20900109,,,,10,12,22
,2011,20900111,,,,12,12,24
HND-001336,2011,20900114,,,,5,9,14
HND-001337,2011,20900115,,,,10,6,16
,2011,20900122,,,,3,6,9
HND-001345,2011,20900127,,,,9,9,18
HND-001350,2011,20900133,,,,4,4,8
,2011,20900193,,,,11,6,17
HND-001361,2011,20900202,,,,11,10,21
HND-001278,2011,20900041,,,,7,4,11
HND-001292,2011,20900056,,,,35,38,73
HND-001293,2011,20900057,,,,23,9,32
HND-001295,2011,20900060,,,,74,73,147
HND-001296,2011,20900061,,,,27,33,60
HND-001298,2011,20900063,,,,22,14,36
HND-001300,2011,20900065,,,,13,9,22
HND-001302,2011,20900067,,,,12,12,24
,2011,20900068,,,,4,10,14
HND-001305,2011,20900071,,,,13,14,27
HND-001306,2011,20900072,,,,36,39,75
HND-001317,2011,20900089,,,,6,12,18
HND-001318,2011,20900090,,,,51,44,95
HND-001323,2011,20900095,,,,13,14,27
,2011,20900096,,,,13,6,19
HND-001325,2011,20900098,,,,4,6,10
,2011,20900104,,,,17,9,26
,2011,20900192,,,,2,2,4
HND-001240,2011,20900001,,,,15,18,33
HND-001242,2011,20900003,,,,10,10,20
HND-001252,2011,20900014,,,,6,2,8
HND-001253,2011,20900015,,,,12,10,22
HND-001254,2011,20900016,,,,21,9,30
HND-001255,2011,20900017,,,,13,16,29
HND-001259,2011,20900021,,,,19,25,44
HND-001260,2011,20900022,,,,10,10,20
HND-001262,2011,20900024,,,,7,14,21
HND-001263,2011,20900025,,,,8,11,19
HND-001265,2011,20900027,,,,9,10,19
HND-001266,2011,20900028,,,,4,4,8
HND-001269,2011,20900031,,,,14,15,29
HND-001270,2011,20900032,,,,10,4,14
HND-001271,2011,20900033,,,,11,7,18
HND-001277,2011,20900040,,,,5,2,7
HND-001279,2011,20900042,,,,7,8,15
HND-001280,2011,20900043,,,,12,4,16
HND-001281,2011,20900044,,,,46,40,86
HND-001285,2011,20900049,,,,8,6,14
HND-001286,2011,20900050,,,,53,43,96
HND-001287,2011,20900051,,,,3,6,9
HND-001313,2011,20900083,,,,1,5,6
HND-001319,2011,20900091,,,,11,6,17
HND-001326,2011,20900099,,,,8,2,10
HND-001328,2011,20900101,,,,5,4,9
HND-001335,2011,20900113,,,,6,2,8
HND-001340,2011,20900119,,,,2,1,3
HND-001343,2011,20900123,,,,11,4,15
HND-001347,2011,20900129,,,,3,5,8
,2011,20900131,,,,1,2,3
,2011,20900186,,,,3,3,6
HND-001358,2011,20900188,,,,3,8,11
HND-001241,2011,20900002,,,,61,39,100
HND-001243,2011,20900004,,,,29,37,66
HND-001244,2011,20900005,,,,25,19,44
HND-001245,2011,20900007,,,,58,55,113
HND-001246,2011,20900008,,,,51,45,96
HND-001247,2011,20900009,,,,127,102,229
HND-001248,2011,20900010,,,,53,49,102
HND-001249,2011,20900011,,,,24,18,42
HND-001250,2011,20900012,,,,23,14,37
HND-001251,2011,20900013,,,,8,5,13
HND-001256,2011,20900018,,,,48,36,84
HND-001257,2011,20900019,,,,41,43,84
HND-001258,2011,20900020,,,,31,20,51
HND-001261,2011,20900023,,,,19,21,40
HND-001264,2011,20900026,,,,9,6,15
HND-001267,2011,20900029,,,,23,12,35
HND-001268,2011,20900030,,,,45,34,79
HND-001272,2011,20900034,,,,33,21,54
HND-001273,2011,20900035,,,,34,44,78
,2011,20900036,,,,15,21,36
HND-001274,2011,20900037,,,,8,7,15
HND-001275,2011,20900038,,,,34,39,73
HND-001276,2011,20900039,,,,32,38,70
HND-001278,2011,20900041,,,,9,7,16
HND-001282,2011,20900045,,,,6,4,10
HND-001283,2011,20900046,,,,11,5,16
HND-001284,2011,20900047,,,,1,5,6
,2011,20900048,,,,4,4,8
HND-001288,2011,20900052,,,,4,5,9
HND-001289,2011,20900053,,,,4,3,7
HND-001290,2011,20900054,,,,6,2,8
HND-001312,2011,20900081,,,,3,2,5
HND-001315,2011,20900087,,,,20,3,23
HND-001316,2011,20900088,,,,5,5,10
HND-001327,2011,20900100,,,,5,4,9
HND-001329,2011,20900102,,,,2,11,13
HND-001330,2011,20900103,,,,5,11,16
,2011,20900104,,,,19,11,30
HND-001331,2011,20900106,,,,1,0,1
HND-001333,2011,20900108,,,,20,15,35
,2011,20900109,,,,16,18,34
HND-001334,2011,20900112,,,,2,4,6
HND-001338,2011,20900117,,,,3,3,6
HND-001339,2011,20900118,,,,2,3,5
HND-001341,2011,20900120,,,,1,1,2
HND-001342,2011,20900121,,,,11,11,22
,2011,20900122,,,,14,9,23
HND-001344,2011,20900126,,,,20,17,37
HND-001346,2011,20900128,,,,4,3,7
HND-001348,2011,20900130,,,,13,12,25
HND-001349,2011,20900132,,,,2,2,4
HND-001356,2011,20900184,,,,2,9,11
HND-001357,2011,20900187,,,,8,4,12
,2011,20900192,,,,2,6,8
HND-001240,2011,20900001,,,,4,5,9
HND-001241,2011,20900002,,,,55,46,101
HND-001242,2011,20900003,,,,11,9,20
HND-001244,2011,20900005,,,,18,21,39
HND-001247,2011,20900009,,,,112,98,210
HND-001248,2011,20900010,,,,45,33,78
HND-001250,2011,20900012,,,,24,12,36
HND-001251,2011,20900013,,,,10,4,14
HND-001252,2011,20900014,,,,8,8,16
HND-001254,2011,20900016,,,,9,12,21
HND-001257,2011,20900019,,,,41,38,79
HND-001258,2011,20900020,,,,16,17,33
HND-001260,2011,20900022,,,,5,8,13
HND-001261,2011,20900023,,,,14,5,19
HND-001262,2011,20900024,,,,6,5,11
HND-001263,2011,20900025,,,,4,3,7
HND-001266,2011,20900028,,,,1,7,8
HND-001270,2011,20900032,,,,8,5,13
HND-001272,2011,20900034,,,,23,17,40
,2011,20900036,,,,16,12,28
HND-001274,2011,20900037,,,,5,4,9
HND-001275,2011,20900038,,,,46,38,84
HND-001279,2011,20900042,,,,6,3,9
HND-001284,2011,20900047,,,,4,5,9
HND-001287,2011,20900051,,,,6,7,13
HND-001288,2011,20900052,,,,6,4,10
HND-001289,2011,20900053,,,,3,0,3
HND-001315,2011,20900087,,,,8,14,22
HND-001316,2011,20900088,,,,8,3,11
HND-001326,2011,20900099,,,,6,6,12
HND-001327,2011,20900100,,,,3,6,9
HND-001328,2011,20900101,,,,3,2,5
HND-001329,2011,20900102,,,,4,4,8
HND-001333,2011,20900108,,,,15,10,25
,2011,20900109,,,,20,19,39
HND-001338,2011,20900117,,,,4,3,7
HND-001341,2011,20900120,,,,4,1,5
HND-001342,2011,20900121,,,,5,4,9
,2011,20900122,,,,16,14,30
HND-001344,2011,20900126,,,,24,19,43
HND-001356,2011,20900184,,,,2,2,4
,2011,20900186,,,,7,3,10
HND-001243,2011,20900004,,,,37,26,63
HND-001245,2011,20900007,,,,57,46,103
HND-001246,2011,20900008,,,,40,51,91
HND-001249,2011,20900011,,,,10,12,22
HND-001253,2011,20900015,,,,12,7,19
HND-001255,2011,20900017,,,,5,6,11
HND-001256,2011,20900018,,,,38,31,69
HND-001259,2011,20900021,,,,14,15,29
HND-001264,2011,20900026,,,,9,12,21
HND-001265,2011,20900027,,,,9,9,18
HND-001267,2011,20900029,,,,8,21,29
HND-001268,2011,20900030,,,,50,40,90
HND-001269,2011,20900031,,,,24,7,31
HND-001271,2011,20900033,,,,5,3,8
HND-001273,2011,20900035,,,,24,31,55
HND-001276,2011,20900039,,,,32,40,72
HND-001277,2011,20900040,,,,4,1,5
HND-001278,2011,20900041,,,,8,12,20
HND-001280,2011,20900043,,,,4,5,9
HND-001281,2011,20900044,,,,25,32,57
HND-001282,2011,20900045,,,,11,7,18
HND-001283,2011,20900046,,,,3,3,6
,2011,20900048,,,,4,3,7
HND-001285,2011,20900049,,,,7,9,16
HND-001286,2011,20900050,,,,42,39,81
HND-001290,2011,20900054,,,,3,5,8
HND-001312,2011,20900081,,,,1,1,2
HND-001313,2011,20900083,,,,3,2,5
HND-001319,2011,20900091,,,,14,11,25
HND-001330,2011,20900103,,,,2,3,5
,2011,20900104,,,,20,18,38
HND-001331,2011,20900106,,,,1,2,3
HND-001334,2011,20900112,,,,2,3,5
HND-001335,2011,20900113,,,,2,5,7
HND-001339,2011,20900118,,,,8,6,14
HND-001340,2011,20900119,,,,0,2,2
HND-001343,2011,20900123,,,,4,6,10
HND-001346,2011,20900128,,,,6,1,7
HND-001347,2011,20900129,,,,7,4,11
HND-001348,2011,20900130,,,,5,4,9
,2011,20900131,,,,2,2,4
HND-001349,2011,20900132,,,,1,6,7
HND-001358,2011,20900188,,,,6,4,10
HND-001240,2011,20900001,,,,3,4,7
HND-001242,2011,20900003,,,,7,5,12
HND-001252,2011,20900014,,,,9,6,15
HND-001253,2011,20900015,,,,19,12,31
HND-001254,2011,20900016,,,,13,15,28
HND-001255,2011,20900017,,,,15,17,32
HND-001259,2011,20900021,,,,15,17,32
HND-001260,2011,20900022,,,,10,13,23
HND-001262,2011,20900024,,,,1,1,2
HND-001263,2011,20900025,,,,5,10,15
HND-001265,2011,20900027,,,,11,10,21
HND-001266,2011,20900028,,,,3,2,5
HND-001268,2011,20900030,,,,44,64,108
HND-001272,2011,20900034,,,,20,26,46
HND-001273,2011,20900035,,,,22,29,51
,2011,20900036,,,,8,13,21
HND-001274,2011,20900037,,,,14,5,19
HND-001275,2011,20900038,,,,36,30,66
HND-001276,2011,20900039,,,,26,30,56
HND-001278,2011,20900041,,,,7,12,19
HND-001282,2011,20900045,,,,5,8,13
HND-001283,2011,20900046,,,,4,6,10
HND-001284,2011,20900047,,,,3,2,5
HND-001288,2011,20900052,,,,2,1,3
HND-001289,2011,20900053,,,,0,1,1
HND-001290,2011,20900054,,,,4,5,9
HND-001312,2011,20900081,,,,1,4,5
HND-001315,2011,20900087,,,,19,8,27
HND-001316,2011,20900088,,,,1,4,5
HND-001327,2011,20900100,,,,3,3,6
HND-001329,2011,20900102,,,,0,5,5
HND-001330,2011,20900103,,,,5,5,10
,2011,20900104,,,,14,23,37
HND-001333,2011,20900108,,,,16,16,32
,2011,20900109,,,,7,13,20
HND-001334,2011,20900112,,,,2,2,4
HND-001338,2011,20900117,,,,4,4,8
HND-001339,2011,20900118,,,,1,2,3
HND-001342,2011,20900121,,,,2,1,3
,2011,20900122,,,,15,14,29
HND-001344,2011,20900126,,,,13,14,27
HND-001346,2011,20900128,,,,3,0,3
HND-001348,2011,20900130,,,,1,1,2
,2011,20900131,,,,2,2,4
HND-001349,2011,20900132,,,,2,1,3
HND-001356,2011,20900184,,,,3,5,8
HND-001357,2011,20900187,,,,2,1,3
,2011,20900192,,,,1,0,1
HND-001241,2011,20900002,,,,45,51,96
HND-001243,2011,20900004,,,,28,27,55
HND-001244,2011,20900005,,,,18,20,38
HND-001245,2011,20900007,,,,42,49,91
HND-001246,2011,20900008,,,,47,37,84
HND-001247,2011,20900009,,,,111,120,231
HND-001248,2011,20900010,,,,42,36,78
HND-001249,2011,20900011,,,,20,12,32
HND-001250,2011,20900012,,,,17,16,33
HND-001251,2011,20900013,,,,2,8,10
HND-001256,2011,20900018,,,,33,33,66
HND-001257,2011,20900019,,,,42,42,84
HND-001258,2011,20900020,,,,17,29,46
HND-001261,2011,20900023,,,,18,13,31
HND-001264,2011,20900026,,,,5,5,10
HND-001267,2011,20900029,,,,11,13,24
HND-001269,2011,20900031,,,,15,7,22
HND-001270,2011,20900032,,,,2,3,5
HND-001271,2011,20900033,,,,9,8,17
HND-001277,2011,20900040,,,,1,0,1
HND-001279,2011,20900042,,,,4,3,7
HND-001280,2011,20900043,,,,1,1,2
HND-001281,2011,20900044,,,,25,16,41
,2011,20900048,,,,1,2,3
HND-001285,2011,20900049,,,,6,3,9
HND-001286,2011,20900050,,,,36,40,76
HND-001287,2011,20900051,,,,8,6,14
HND-001313,2011,20900083,,,,3,3,6
HND-001319,2011,20900091,,,,11,5,16
HND-001326,2011,20900099,,,,8,1,9
HND-001328,2011,20900101,,,,2,2,4
HND-001335,2011,20900113,,,,2,3,5
HND-001340,2011,20900119,,,,3,0,3
HND-001343,2011,20900123,,,,2,4,6
HND-001347,2011,20900129,,,,11,2,13
,2011,20900186,,,,4,4,8
HND-001358,2011,20900188,,,,4,2,6
HND-001240,2011,20900001,,,,7,8,15
HND-001241,2011,20900002,,,,48,63,111
HND-001244,2011,20900005,,,,16,19,35
HND-001245,2011,20900007,,,,32,50,82
HND-001247,2011,20900009,,,,117,114,231
HND-001248,2011,20900010,,,,36,36,72
HND-001249,2011,20900011,,,,16,13,29
HND-001250,2011,20900012,,,,15,7,22
HND-001251,2011,20900013,,,,7,4,11
HND-001252,2011,20900014,,,,8,6,14
HND-001254,2011,20900016,,,,11,12,23
HND-001257,2011,20900019,,,,39,43,82
HND-001258,2011,20900020,,,,14,26,40
HND-001260,2011,20900022,,,,7,7,14
HND-001261,2011,20900023,,,,10,10,20
HND-001263,2011,20900025,,,,4,4,8
HND-001270,2011,20900032,,,,1,1,2
HND-001271,2011,20900033,,,,8,1,9
HND-001272,2011,20900034,,,,18,27,45
,2011,20900036,,,,16,16,32
HND-001275,2011,20900038,,,,28,35,63
HND-001277,2011,20900040,,,,2,2,4
HND-001279,2011,20900042,,,,5,6,11
HND-001280,2011,20900043,,,,0,3,3
HND-001285,2011,20900049,,,,13,7,20
HND-001287,2011,20900051,,,,6,8,14
HND-001288,2011,20900052,,,,8,6,14
HND-001289,2011,20900053,,,,2,0,2
HND-001315,2011,20900087,,,,12,7,19
HND-001316,2011,20900088,,,,3,6,9
HND-001326,2011,20900099,,,,4,2,6
HND-001327,2011,20900100,,,,4,3,7
HND-001328,2011,20900101,,,,1,2,3
HND-001329,2011,20900102,,,,6,3,9
HND-001333,2011,20900108,,,,15,15,30
HND-001338,2011,20900117,,,,6,6,12
HND-001342,2011,20900121,,,,3,0,3
,2011,20900122,,,,11,16,27
HND-001347,2011,20900129,,,,1,7,8
HND-001349,2011,20900132,,,,3,2,5
HND-001356,2011,20900184,,,,2,4,6
HND-001242,2011,20900003,,,,11,6,17
HND-001243,2011,20900004,,,,35,27,62
HND-001246,2011,20900008,,,,44,35,79
HND-001253,2011,20900015,,,,13,12,25
HND-001255,2011,20900017,,,,16,9,25
HND-001256,2011,20900018,,,,34,31,65
HND-001259,2011,20900021,,,,20,10,30
HND-001262,2011,20900024,,,,3,2,5
HND-001264,2011,20900026,,,,5,8,13
HND-001265,2011,20900027,,,,11,16,27
HND-001266,2011,20900028,,,,9,3,12
HND-001267,2011,20900029,,,,8,13,21
HND-001268,2011,20900030,,,,57,40,97
HND-001269,2011,20900031,,,,10,13,23
HND-001273,2011,20900035,,,,27,21,48
HND-001274,2011,20900037,,,,7,6,13
HND-001276,2011,20900039,,,,28,33,61
HND-001278,2011,20900041,,,,7,8,15
HND-001281,2011,20900044,,,,27,24,51
HND-001282,2011,20900045,,,,5,7,12
HND-001283,2011,20900046,,,,2,5,7
HND-001284,2011,20900047,,,,1,5,6
,2011,20900048,,,,2,4,6
HND-001286,2011,20900050,,,,40,40,80
HND-001290,2011,20900054,,,,3,5,8
HND-001312,2011,20900081,,,,1,2,3
HND-001313,2011,20900083,,,,3,2,5
HND-001319,2011,20900091,,,,7,3,10
HND-001330,2011,20900103,,,,2,1,3
,2011,20900104,,,,16,23,39
HND-001331,2011,20900106,,,,3,2,5
,2011,20900109,,,,19,12,31
HND-001334,2011,20900112,,,,3,2,5
HND-001335,2011,20900113,,,,0,1,1
HND-001339,2011,20900118,,,,4,4,8
HND-001340,2011,20900119,,,,1,2,3
HND-001341,2011,20900120,,,,2,4,6
HND-001343,2011,20900123,,,,1,3,4
HND-001344,2011,20900126,,,,8,10,18
HND-001346,2011,20900128,,,,1,2,3
HND-001348,2011,20900130,,,,3,2,5
,2011,20900131,,,,2,1,3
,2011,20900186,,,,10,6,16
HND-001357,2011,20900187,,,,2,2,4
HND-001358,2011,20900188,,,,5,7,12
HND-001240,2011,20900001,,,,7,6,13
HND-001241,2011,20900002,,,,56,61,117
HND-001244,2011,20900005,,,,13,15,28
HND-001245,2011,20900007,,,,40,26,66
HND-001246,2011,20900008,,,,47,50,97
HND-001247,2011,20900009,,,,108,102,210
HND-001248,2011,20900010,,,,40,39,79
HND-001249,2011,20900011,,,,6,9,15
HND-001250,2011,20900012,,,,23,17,40
HND-001251,2011,20900013,,,,7,4,11
HND-001254,2011,20900016,,,,20,16,36
HND-001256,2011,20900018,,,,43,32,75
HND-001257,2011,20900019,,,,32,29,61
HND-001258,2011,20900020,,,,13,17,30
HND-001260,2011,20900022,,,,8,10,18
HND-001261,2011,20900023,,,,13,15,28
HND-001267,2011,20900029,,,,9,10,19
HND-001270,2011,20900032,,,,2,1,3
HND-001271,2011,20900033,,,,2,7,9
HND-001272,2011,20900034,,,,22,24,46
,2011,20900036,,,,14,9,23
HND-001277,2011,20900040,,,,1,1,2
HND-001279,2011,20900042,,,,5,3,8
HND-001280,2011,20900043,,,,1,4,5
HND-001281,2011,20900044,,,,18,17,35
HND-001285,2011,20900049,,,,8,6,14
HND-001286,2011,20900050,,,,37,37,74
HND-001287,2011,20900051,,,,3,2,5
HND-001289,2011,20900053,,,,1,2,3
HND-001316,2011,20900088,,,,6,4,10
HND-001319,2011,20900091,,,,6,6,12
HND-001326,2011,20900099,,,,1,5,6
HND-001327,2011,20900100,,,,4,2,6
HND-001328,2011,20900101,,,,4,1,5
HND-001335,2011,20900113,,,,0,2,2
HND-001340,2011,20900119,,,,0,5,5
HND-001343,2011,20900123,,,,3,1,4
HND-001347,2011,20900129,,,,4,4,8
HND-001349,2011,20900132,,,,1,2,3
HND-001356,2011,20900184,,,,8,3,11
HND-001357,2011,20900187,,,,1,1,2
,2011,20900192,,,,0,1,1
HND-001242,2011,20900003,,,,12,3,15
HND-001243,2011,20900004,,,,27,23,50
HND-001252,2011,20900014,,,,8,8,16
HND-001253,2011,20900015,,,,10,8,18
HND-001255,2011,20900017,,,,8,9,17
HND-001259,2011,20900021,,,,13,27,40
HND-001262,2011,20900024,,,,2,1,3
HND-001263,2011,20900025,,,,6,8,14
HND-001264,2011,20900026,,,,7,5,12
HND-001265,2011,20900027,,,,17,8,25
HND-001266,2011,20900028,,,,7,9,16
HND-001268,2011,20900030,,,,55,59,114
HND-001269,2011,20900031,,,,15,17,32
HND-001273,2011,20900035,,,,16,22,38
HND-001274,2011,20900037,,,,4,3,7
HND-001275,2011,20900038,,,,26,37,63
HND-001276,2011,20900039,,,,20,26,46
HND-001278,2011,20900041,,,,6,10,16
HND-001282,2011,20900045,,,,3,2,5
HND-001283,2011,20900046,,,,2,5,7
HND-001284,2011,20900047,,,,5,3,8
,2011,20900048,,,,0,1,1
HND-001288,2011,20900052,,,,2,0,2
HND-001290,2011,20900054,,,,3,4,7
HND-001312,2011,20900081,,,,3,2,5
HND-001315,2011,20900087,,,,4,9,13
HND-001329,2011,20900102,,,,4,5,9
HND-001330,2011,20900103,,,,2,2,4
,2011,20900104,,,,21,20,41
HND-001333,2011,20900108,,,,11,14,25
,2011,20900109,,,,14,8,22
HND-001334,2011,20900112,,,,2,3,5
HND-001338,2011,20900117,,,,3,2,5
HND-001339,2011,20900118,,,,0,1,1
HND-001341,2011,20900120,,,,2,0,2
HND-001342,2011,20900121,,,,0,2,2
,2011,20900122,,,,13,15,28
HND-001344,2011,20900126,,,,13,16,29
HND-001346,2011,20900128,,,,3,1,4
,2011,20900131,,,,2,3,5
,2011,20900186,,,,2,2,4
HND-001358,2011,20900188,,,,0,2,2
HND-001243,2011,20900004,,,,28,21,49
HND-001245,2011,20900007,,,,30,45,75
HND-001246,2011,20900008,,,,38,32,70
HND-001249,2011,20900011,,,,11,10,21
HND-001253,2011,20900015,,,,7,10,17
HND-001255,2011,20900017,,,,11,5,16
HND-001256,2011,20900018,,,,37,33,70
HND-001259,2011,20900021,,,,15,12,27
HND-001264,2011,20900026,,,,6,4,10
HND-001265,2011,20900027,,,,5,16,21
HND-001267,2011,20900029,,,,3,10,13
HND-001268,2011,20900030,,,,58,65,123
HND-001269,2011,20900031,,,,3,10,13
HND-001271,2011,20900033,,,,6,7,13
HND-001273,2011,20900035,,,,23,22,45
HND-001276,2011,20900039,,,,22,24,46
HND-001277,2011,20900040,,,,1,0,1
HND-001278,2011,20900041,,,,4,14,18
HND-001280,2011,20900043,,,,1,2,3
HND-001281,2011,20900044,,,,24,37,61
HND-001282,2011,20900045,,,,10,1,11
HND-001283,2011,20900046,,,,2,1,3
HND-001285,2011,20900049,,,,8,11,19
HND-001286,2011,20900050,,,,38,41,79
HND-001290,2011,20900054,,,,6,5,11
HND-001312,2011,20900081,,,,2,1,3
HND-001313,2011,20900083,,,,1,2,3
HND-001319,2011,20900091,,,,2,1,3
HND-001330,2011,20900103,,,,3,1,4
,2011,20900104,,,,15,18,33
HND-001331,2011,20900106,,,,2,0,2
HND-001334,2011,20900112,,,,3,0,3
HND-001335,2011,20900113,,,,1,0,1
HND-001339,2011,20900118,,,,4,6,10
HND-001343,2011,20900123,,,,2,4,6
HND-001347,2011,20900129,,,,2,5,7
HND-001348,2011,20900130,,,,3,0,3
HND-001240,2011,20900001,,,,1,3,4
HND-001241,2011,20900002,,,,67,52,119
HND-001242,2011,20900003,,,,11,3,14
HND-001244,2011,20900005,,,,22,31,53
HND-001247,2011,20900009,,,,101,112,213
HND-001248,2011,20900010,,,,50,46,96
HND-001250,2011,20900012,,,,19,10,29
HND-001251,2011,20900013,,,,3,7,10
HND-001252,2011,20900014,,,,5,8,13
HND-001254,2011,20900016,,,,14,13,27
HND-001257,2011,20900019,,,,43,40,83
HND-001258,2011,20900020,,,,13,15,28
HND-001260,2011,20900022,,,,8,10,18
HND-001261,2011,20900023,,,,10,15,25
HND-001262,2011,20900024,,,,3,3,6
HND-001263,2011,20900025,,,,4,3,7
HND-001266,2011,20900028,,,,8,6,14
HND-001270,2011,20900032,,,,2,1,3
HND-001272,2011,20900034,,,,13,14,27
,2011,20900036,,,,24,16,40
HND-001274,2011,20900037,,,,2,4,6
HND-001275,2011,20900038,,,,26,27,53
HND-001279,2011,20900042,,,,4,2,6
HND-001284,2011,20900047,,,,6,6,12
HND-001287,2011,20900051,,,,3,2,5
HND-001288,2011,20900052,,,,3,2,5
HND-001289,2011,20900053,,,,3,1,4
HND-001315,2011,20900087,,,,7,9,16
HND-001316,2011,20900088,,,,1,5,6
HND-001326,2011,20900099,,,,1,1,2
HND-001327,2011,20900100,,,,2,3,5
HND-001328,2011,20900101,,,,3,2,5
HND-001329,2011,20900102,,,,3,3,6
HND-001333,2011,20900108,,,,17,13,30
,2011,20900109,,,,11,15,26
HND-001338,2011,20900117,,,,3,1,4
HND-001341,2011,20900120,,,,2,2,4
HND-001342,2011,20900121,,,,2,1,3
,2011,20900122,,,,10,10,20
HND-001344,2011,20900126,,,,9,13,22
HND-001356,2011,20900184,,,,2,2,4
,2011,20900186,,,,1,0,1
HND-001245,2011,20900007,,,,26,35,61
HND-001246,2011,20900008,,,,33,42,75
HND-001249,2011,20900011,,,,16,19,35
HND-001258,2011,20900020,,,,39,22,61
HND-001261,2011,20900023,,,,1,7,8
,2011,20900076,,,,290,309,599
,2011,20900109,,,,5,12,17
,2011,20900116,,,,25,38,63
HND-001243,2011,20900004,,,,30,31,61
HND-001259,2011,20900021,,,,11,17,28
HND-001264,2011,20900026,,,,6,9,15
HND-001272,2011,20900034,,,,21,31,52
HND-001275,2011,20900038,,,,18,22,40
HND-001278,2011,20900041,,,,7,11,18
HND-001307,2011,20900073,,,,257,250,507
HND-001308,2011,20900074,,,,31,24,55
HND-001309,2011,20900075,,,,135,159,294
,2011,20900077,,,,12,15,27
,2011,20900078,,,,12,20,32
,2011,20900104,,,,13,16,29
HND-001332,2011,20900107,,,,49,48,97
HND-001344,2011,20900126,,,,10,15,25
,2011,20900192,,,,2,4,6
HND-001258,2011,20900020,,,,27,18,45
HND-001261,2011,20900023,,,,5,5,10
HND-001272,2011,20900034,,,,13,24,37
HND-001275,2011,20900038,,,,4,12,16
HND-001307,2011,20900073,,,,185,198,383
HND-001309,2011,20900075,,,,117,111,228
,2011,20900077,,,,12,12,24
,2011,20900078,,,,23,23,46
HND-001332,2011,20900107,,,,29,41,70
,2011,20900116,,,,35,64,99
HND-001344,2011,20900126,,,,8,16,24
HND-001243,2011,20900004,,,,15,17,32
HND-001245,2011,20900007,,,,22,34,56
HND-001246,2011,20900008,,,,21,28,49
HND-001249,2011,20900011,,,,9,17,26
HND-001259,2011,20900021,,,,5,11,16
HND-001264,2011,20900026,,,,10,12,22
HND-001278,2011,20900041,,,,5,10,15
HND-001308,2011,20900074,,,,13,23,36
,2011,20900076,,,,191,284,475
,2011,20900104,,,,15,17,32
,2011,20900109,,,,13,12,25
,2011,20900192,,,,8,9,17
HND-001258,2011,20900020,,,,22,29,51
HND-001261,2011,20900023,,,,0,1,1
HND-001272,2011,20900034,,,,12,17,29
HND-001275,2011,20900038,,,,4,20,24
HND-001308,2011,20900074,,,,12,11,23
HND-001309,2011,20900075,,,,86,98,184
,2011,20900076,,,,224,285,509
,2011,20900077,,,,25,12,37
,2011,20900078,,,,20,31,51
,2011,20900104,,,,19,17,36
,2011,20900192,,,,8,5,13
HND-001243,2011,20900004,,,,16,16,32
HND-001245,2011,20900007,,,,9,18,27
HND-001246,2011,20900008,,,,14,16,30
HND-001249,2011,20900011,,,,9,11,20
HND-001259,2011,20900021,,,,6,10,16
HND-001264,2011,20900026,,,,5,7,12
HND-001278,2011,20900041,,,,6,8,14
HND-001307,2011,20900073,,,,134,150,284
HND-001332,2011,20900107,,,,24,28,52
,2011,20900109,,,,5,4,9
,2011,20900116,,,,34,63,97
HND-001344,2011,20900126,,,,4,10,14
HND-001307,2011,20900073,,,,234,136,370
HND-001309,2011,20900075,,,,67,63,130
,2011,20900077,,,,31,15,46
,2011,20900078,,,,12,14,26
HND-001332,2011,20900107,,,,30,29,59
,2011,20900116,,,,30,112,142
HND-001308,2011,20900074,,,,9,11,20
,2011,20900076,,,,218,439,657
,2011,20900104,,,,17,32,49
,2011,20900109,,,,10,4,14
,2011,20900192,,,,14,14,28
HND-001307,2011,20900073,,,,169,114,283
HND-001309,2011,20900075,,,,33,64,97
HND-001332,2011,20900107,,,,20,16,36
,2011,20900109,,,,4,6,10
,2011,20900116,,,,27,47,74
HND-001308,2011,20900074,,,,5,15,20
,2011,20900076,,,,175,327,502
,2011,20900078,,,,13,20,33
,2011,20900104,,,,20,18,38
,2011,20900192,,,,21,41,62
HND-001308,2011,20900074,,,,2,7,9
,2011,20900076,,,,98,297,395
,2011,20900104,,,,9,6,15
,2011,20900192,,,,3,15,18
HND-001307,2011,20900073,,,,148,122,270
HND-001309,2011,20900075,,,,27,51,78
,2011,20900077,,,,11,10,21
HND-001332,2011,20900107,,,,18,16,34
,2011,20900116,,,,8,29,37
HND-001405,2011,21000048,,,,3,1,4
,2011,21000061,,,,3,2,5
,2011,21000107,,,,4,5,9
HND-001445,2011,21000127,,,,4,4,8
,2011,21000128,,,,2,6,8
,2011,21000132,,,,3,3,6
,2011,21000139,,,,2,10,12
,2011,21000147,,,,5,5,10
,2011,21000150,,,,5,5,10
,2011,21000158,,,,6,6,12
,2011,21000161,,,,0,6,6
HND-001451,2011,21000162,,,,3,5,8
HND-001441,2011,21000104,,,,3,3,6
HND-001442,2011,21000105,,,,6,4,10
HND-001443,2011,21000106,,,,4,3,7
,2011,21000109,,,,5,11,16
,2011,21000110,,,,5,5,10
,2011,21000131,,,,2,3,5
,2011,21000133,,,,3,3,6
,2011,21000134,,,,2,4,6
,2011,21000135,,,,4,2,6
,2011,21000136,,,,3,3,6
,2011,21000137,,,,5,5,10
,2011,21000138,,,,5,4,9
,2011,21000141,,,,4,5,9
,2011,21000146,,,,4,4,8
HND-001450,2011,21000148,,,,2,4,6
,2011,21000151,,,,6,4,10
,2011,21000152,,,,4,3,7
,2011,21000153,,,,1,6,7
,2011,21000154,,,,2,3,5
,2011,21000155,,,,4,6,10
,2011,21000156,,,,5,3,8
,2011,21000157,,,,3,5,8
,2011,21000159,,,,3,3,6
,2011,21000160,,,,3,5,8
,2011,21000175,,,,2,10,12
,2011,21000176,,,,3,3,6
HND-001453,2011,21000166,,,,0,1,1
HND-001452,2011,21000164,,,,4,3,7
HND-001396,2011,21000039,,,,7,10,17
HND-001397,2011,21000040,,,,8,8,16
HND-001398,2011,21000041,,,,9,7,16
HND-001399,2011,21000042,,,,3,6,9
HND-001400,2011,21000043,,,,1,1,2
HND-001401,2011,21000044,,,,4,5,9
HND-001402,2011,21000045,,,,7,5,12
,2011,21000056,,,,2,5,7
HND-001413,2011,21000062,,,,1,1,2
HND-001414,2011,21000063,,,,1,4,5
HND-001444,2011,21000123,,,,6,7,13
,2011,21000124,,,,2,1,3
,2011,21000125,,,,5,1,6
,2011,21000126,,,,2,0,2
,2011,21000163,,,,3,1,4
HND-001452,2011,21000164,,,,4,3,7
,2011,21000165,,,,6,2,8
HND-001453,2011,21000166,,,,2,1,3
,2011,21000168,,,,3,2,5
HND-001424,2011,21000074,,,,0,5,5
HND-001435,2011,21000086,,,,5,3,8
HND-001397,2011,21000040,,,,24,22,46
HND-001402,2011,21000045,,,,17,14,31
HND-001406,2011,21000049,,,,6,8,14
HND-001424,2011,21000074,,,,10,9,19
HND-001435,2011,21000086,,,,8,4,12
HND-001444,2011,21000123,,,,5,7,12
,2011,21000163,,,,10,3,13
HND-001396,2011,21000039,,,,32,26,58
HND-001398,2011,21000041,,,,17,14,31
HND-001399,2011,21000042,,,,9,6,15
HND-001400,2011,21000043,,,,11,18,29
HND-001401,2011,21000044,,,,7,7,14
,2011,21000056,,,,5,8,13
HND-001413,2011,21000062,,,,5,13,18
HND-001414,2011,21000063,,,,15,8,23
,2011,21000124,,,,10,7,17
,2011,21000125,,,,10,9,19
,2011,21000126,,,,4,4,8
HND-001452,2011,21000164,,,,1,2,3
,2011,21000165,,,,4,5,9
HND-001453,2011,21000166,,,,3,10,13
,2011,21000168,,,,5,4,9
HND-001363,2011,21000002,,,,30,38,68
HND-001364,2011,21000003,,,,43,41,84
HND-001365,2011,21000004,,,,16,15,31
HND-001367,2011,21000006,,,,18,15,33
HND-001369,2011,21000008,,,,15,15,30
HND-001371,2011,21000010,,,,13,7,20
HND-001372,2011,21000011,,,,7,5,12
HND-001373,2011,21000012,,,,8,7,15
HND-001375,2011,21000014,,,,6,7,13
HND-001376,2011,21000015,,,,1,5,6
HND-001377,2011,21000016,,,,25,21,46
HND-001378,2011,21000017,,,,15,6,21
HND-001379,2011,21000018,,,,11,4,15
HND-001390,2011,21000030,,,,5,5,10
,2011,21000035,,,,6,7,13
,2011,21000036,,,,6,2,8
HND-001395,2011,21000038,,,,12,6,18
HND-001404,2011,21000047,,,,11,8,19
HND-001405,2011,21000048,,,,1,0,1
HND-001408,2011,21000054,,,,0,3,3
HND-001410,2011,21000058,,,,2,2,4
HND-001411,2011,21000059,,,,1,3,4
HND-001412,2011,21000060,,,,0,2,2
HND-001415,2011,21000064,,,,7,5,12
,2011,21000066,,,,4,2,6
HND-001418,2011,21000068,,,,2,2,4
,2011,21000069,,,,4,3,7
,2011,21000071,,,,2,5,7
HND-001422,2011,21000072,,,,3,8,11
HND-001423,2011,21000073,,,,6,2,8
HND-001426,2011,21000076,,,,1,3,4
HND-001427,2011,21000077,,,,6,2,8
,2011,21000078,,,,2,2,4
,2011,21000081,,,,1,2,3
,2011,21000082,,,,7,10,17
HND-001432,2011,21000083,,,,8,8,16
HND-001433,2011,21000084,,,,13,6,19
HND-001437,2011,21000094,,,,3,1,4
HND-001447,2011,21000143,,,,5,3,8
,2011,21000144,,,,6,7,13
HND-001448,2011,21000145,,,,9,6,15
,2011,21000168,,,,3,1,4
HND-001455,2011,21000170,,,,17,10,27
HND-001362,2011,21000001,,,,51,34,85
HND-001366,2011,21000005,,,,5,3,8
HND-001368,2011,21000007,,,,3,6,9
HND-001370,2011,21000009,,,,4,4,8
HND-001380,2011,21000019,,,,3,2,5
HND-001381,2011,21000020,,,,10,6,16
HND-001382,2011,21000022,,,,8,13,21
HND-001383,2011,21000023,,,,27,34,61
HND-001384,2011,21000024,,,,2,3,5
HND-001385,2011,21000025,,,,5,5,10
HND-001386,2011,21000026,,,,0,1,1
,2011,21000027,,,,6,11,17
HND-001388,2011,21000028,,,,5,2,7
HND-001389,2011,21000029,,,,10,7,17
HND-001391,2011,21000031,,,,42,31,73
HND-001407,2011,21000053,,,,1,4,5
HND-001409,2011,21000057,,,,1,2,3
,2011,21000067,,,,1,0,1
HND-001420,2011,21000070,,,,3,2,5
HND-001425,2011,21000075,,,,1,7,8
,2011,21000079,,,,5,5,10
HND-001429,2011,21000080,,,,2,2,4
,2011,21000085,,,,1,4,5
HND-001436,2011,21000088,,,,2,2,4
HND-001438,2011,21000096,,,,4,4,8
,2011,21000100,,,,4,3,7
HND-001440,2011,21000101,,,,5,3,8
,2011,21000126,,,,6,7,13
HND-001454,2011,21000167,,,,3,2,5
,2011,21000171,,,,8,7,15
,2011,21000172,,,,2,3,5
,2011,21000173,,,,2,4,6
,2011,21000174,,,,3,0,3
HND-001363,2011,21000002,,,,24,31,55
HND-001365,2011,21000004,,,,11,6,17
HND-001366,2011,21000005,,,,1,2,3
HND-001367,2011,21000006,,,,7,14,21
HND-001368,2011,21000007,,,,1,3,4
HND-001369,2011,21000008,,,,12,4,16
HND-001370,2011,21000009,,,,3,2,5
HND-001371,2011,21000010,,,,7,16,23
HND-001375,2011,21000014,,,,5,3,8
HND-001376,2011,21000015,,,,2,5,7
HND-001377,2011,21000016,,,,26,26,52
HND-001379,2011,21000018,,,,4,8,12
HND-001380,2011,21000019,,,,2,2,4
HND-001382,2011,21000022,,,,5,9,14
HND-001383,2011,21000023,,,,31,21,52
HND-001384,2011,21000024,,,,4,3,7
HND-001386,2011,21000026,,,,1,2,3
,2011,21000027,,,,9,5,14
HND-001390,2011,21000030,,,,8,3,11
HND-001405,2011,21000048,,,,1,2,3
,2011,21000069,,,,4,2,6
HND-001420,2011,21000070,,,,2,0,2
HND-001422,2011,21000072,,,,5,2,7
HND-001426,2011,21000076,,,,3,6,9
,2011,21000079,,,,8,7,15
HND-001429,2011,21000080,,,,3,4,7
,2011,21000081,,,,1,5,6
HND-001432,2011,21000083,,,,10,9,19
,2011,21000085,,,,1,1,2
HND-001436,2011,21000088,,,,0,5,5
HND-001437,2011,21000094,,,,0,1,1
HND-001438,2011,21000096,,,,1,2,3
HND-001440,2011,21000101,,,,2,1,3
HND-001447,2011,21000143,,,,1,1,2
HND-001448,2011,21000145,,,,2,5,7
HND-001454,2011,21000167,,,,1,2,3
,2011,21000171,,,,4,4,8
,2011,21000173,,,,0,1,1
,2011,21000174,,,,1,1,2
HND-001362,2011,21000001,,,,35,44,79
HND-001364,2011,21000003,,,,46,44,90
HND-001372,2011,21000011,,,,8,5,13
HND-001373,2011,21000012,,,,13,3,16
HND-001378,2011,21000017,,,,0,2,2
HND-001381,2011,21000020,,,,8,8,16
HND-001385,2011,21000025,,,,7,5,12
HND-001388,2011,21000028,,,,1,1,2
HND-001389,2011,21000029,,,,5,11,16
HND-001391,2011,21000031,,,,28,22,50
,2011,21000032,,,,5,3,8
,2011,21000035,,,,3,3,6
,2011,21000036,,,,2,0,2
HND-001395,2011,21000038,,,,13,7,20
HND-001404,2011,21000047,,,,9,10,19
HND-001407,2011,21000053,,,,1,2,3
HND-001408,2011,21000054,,,,2,2,4
HND-001409,2011,21000057,,,,3,2,5
HND-001410,2011,21000058,,,,2,1,3
HND-001411,2011,21000059,,,,1,1,2
HND-001412,2011,21000060,,,,6,3,9
HND-001415,2011,21000064,,,,3,2,5
,2011,21000066,,,,1,3,4
,2011,21000067,,,,4,4,8
HND-001418,2011,21000068,,,,2,0,2
,2011,21000071,,,,0,5,5
HND-001423,2011,21000073,,,,6,3,9
HND-001427,2011,21000077,,,,1,2,3
,2011,21000078,,,,1,1,2
,2011,21000082,,,,0,2,2
HND-001433,2011,21000084,,,,21,7,28
,2011,21000126,,,,8,9,17
,2011,21000144,,,,8,9,17
,2011,21000168,,,,3,5,8
HND-001455,2011,21000170,,,,18,11,29
,2011,21000172,,,,4,3,7
HND-001362,2011,21000001,,,,37,47,84
HND-001366,2011,21000005,,,,1,2,3
HND-001368,2011,21000007,,,,2,5,7
HND-001369,2011,21000008,,,,7,10,17
HND-001370,2011,21000009,,,,7,5,12
HND-001380,2011,21000019,,,,2,2,4
HND-001381,2011,21000020,,,,10,8,18
HND-001382,2011,21000022,,,,10,13,23
HND-001383,2011,21000023,,,,20,24,44
HND-001384,2011,21000024,,,,1,2,3
HND-001385,2011,21000025,,,,2,4,6
HND-001386,2011,21000026,,,,1,2,3
,2011,21000027,,,,7,6,13
HND-001388,2011,21000028,,,,1,0,1
HND-001389,2011,21000029,,,,9,9,18
HND-001409,2011,21000057,,,,4,3,7
,2011,21000067,,,,2,3,5
HND-001420,2011,21000070,,,,6,4,10
HND-001425,2011,21000075,,,,5,6,11
,2011,21000079,,,,9,7,16
HND-001429,2011,21000080,,,,4,2,6
HND-001432,2011,21000083,,,,7,9,16
,2011,21000085,,,,1,2,3
HND-001436,2011,21000088,,,,0,3,3
HND-001437,2011,21000094,,,,2,1,3
HND-001438,2011,21000096,,,,4,2,6
,2011,21000100,,,,4,1,5
HND-001440,2011,21000101,,,,5,1,6
,2011,21000126,,,,11,8,19
HND-001447,2011,21000143,,,,3,1,4
HND-001454,2011,21000167,,,,0,1,1
,2011,21000171,,,,2,4,6
,2011,21000172,,,,1,0,1
,2011,21000173,,,,3,0,3
,2011,21000174,,,,5,1,6
HND-001363,2011,21000002,,,,27,19,46
HND-001364,2011,21000003,,,,34,35,69
HND-001365,2011,21000004,,,,9,9,18
HND-001367,2011,21000006,,,,9,18,27
HND-001371,2011,21000010,,,,11,5,16
HND-001372,2011,21000011,,,,9,0,9
HND-001373,2011,21000012,,,,7,9,16
HND-001375,2011,21000014,,,,2,8,10
HND-001376,2011,21000015,,,,3,7,10
HND-001377,2011,21000016,,,,25,26,51
HND-001378,2011,21000017,,,,2,2,4
HND-001379,2011,21000018,,,,3,4,7
HND-001390,2011,21000030,,,,4,6,10
HND-001391,2011,21000031,,,,19,15,34
,2011,21000032,,,,3,3,6
,2011,21000035,,,,4,4,8
,2011,21000036,,,,2,0,2
HND-001395,2011,21000038,,,,5,8,13
HND-001404,2011,21000047,,,,10,14,24
HND-001405,2011,21000048,,,,1,5,6
HND-001408,2011,21000054,,,,1,1,2
HND-001410,2011,21000058,,,,2,0,2
HND-001411,2011,21000059,,,,1,0,1
HND-001412,2011,21000060,,,,0,4,4
HND-001415,2011,21000064,,,,6,3,9
,2011,21000066,,,,2,6,8
HND-001418,2011,21000068,,,,2,4,6
,2011,21000069,,,,4,4,8
,2011,21000071,,,,3,4,7
HND-001422,2011,21000072,,,,4,1,5
HND-001423,2011,21000073,,,,2,4,6
HND-001426,2011,21000076,,,,3,3,6
HND-001427,2011,21000077,,,,4,3,7
,2011,21000081,,,,7,2,9
,2011,21000082,,,,2,5,7
HND-001433,2011,21000084,,,,11,5,16
,2011,21000144,,,,11,8,19
HND-001448,2011,21000145,,,,6,2,8
HND-001455,2011,21000170,,,,12,8,20
HND-001363,2011,21000002,,,,36,26,62
HND-001364,2011,21000003,,,,32,23,55
HND-001365,2011,21000004,,,,10,13,23
HND-001366,2011,21000005,,,,3,1,4
HND-001367,2011,21000006,,,,11,10,21
HND-001369,2011,21000008,,,,6,7,13
HND-001370,2011,21000009,,,,0,1,1
HND-001371,2011,21000010,,,,10,9,19
HND-001373,2011,21000012,,,,9,6,15
HND-001375,2011,21000014,,,,9,2,11
HND-001376,2011,21000015,,,,4,0,4
HND-001377,2011,21000016,,,,29,20,49
HND-001379,2011,21000018,,,,2,3,5
HND-001380,2011,21000019,,,,2,3,5
HND-001382,2011,21000022,,,,16,10,26
HND-001383,2011,21000023,,,,26,20,46
,2011,21000027,,,,14,10,24
HND-001390,2011,21000030,,,,4,4,8
,2011,21000035,,,,2,2,4
,2011,21000036,,,,4,4,8
HND-001395,2011,21000038,,,,12,7,19
HND-001405,2011,21000048,,,,2,2,4
HND-001411,2011,21000059,,,,2,4,6
HND-001412,2011,21000060,,,,1,2,3
,2011,21000066,,,,4,1,5
HND-001418,2011,21000068,,,,2,2,4
,2011,21000069,,,,5,5,10
HND-001420,2011,21000070,,,,6,1,7
,2011,21000071,,,,1,2,3
HND-001422,2011,21000072,,,,3,4,7
HND-001423,2011,21000073,,,,3,5,8
HND-001425,2011,21000075,,,,6,1,7
HND-001426,2011,21000076,,,,2,6,8
HND-001427,2011,21000077,,,,2,3,5
,2011,21000079,,,,4,6,10
HND-001429,2011,21000080,,,,8,4,12
,2011,21000081,,,,2,2,4
HND-001432,2011,21000083,,,,2,13,15
HND-001437,2011,21000094,,,,2,4,6
HND-001438,2011,21000096,,,,4,2,6
HND-001440,2011,21000101,,,,3,2,5
HND-001447,2011,21000143,,,,0,2,2
HND-001448,2011,21000145,,,,2,3,5
HND-001454,2011,21000167,,,,1,3,4
,2011,21000174,,,,0,1,1
HND-001362,2011,21000001,,,,34,33,67
HND-001368,2011,21000007,,,,3,2,5
HND-001372,2011,21000011,,,,5,4,9
HND-001378,2011,21000017,,,,5,1,6
HND-001381,2011,21000020,,,,12,13,25
HND-001384,2011,21000024,,,,6,7,13
HND-001385,2011,21000025,,,,3,3,6
HND-001386,2011,21000026,,,,3,0,3
HND-001388,2011,21000028,,,,2,0,2
HND-001389,2011,21000029,,,,5,4,9
HND-001391,2011,21000031,,,,16,30,46
,2011,21000032,,,,3,1,4
HND-001404,2011,21000047,,,,12,7,19
HND-001407,2011,21000053,,,,1,2,3
HND-001408,2011,21000054,,,,3,2,5
HND-001409,2011,21000057,,,,0,5,5
HND-001410,2011,21000058,,,,2,2,4
HND-001415,2011,21000064,,,,3,1,4
,2011,21000078,,,,5,0,5
,2011,21000082,,,,3,2,5
HND-001433,2011,21000084,,,,9,9,18
,2011,21000085,,,,2,1,3
,2011,21000100,,,,2,1,3
,2011,21000126,,,,7,10,17
,2011,21000144,,,,7,10,17
HND-001455,2011,21000170,,,,11,10,21
,2011,21000171,,,,3,2,5
,2011,21000172,,,,3,0,3
,2011,21000173,,,,1,2,3
HND-001362,2011,21000001,,,,41,42,83
HND-001368,2011,21000007,,,,1,2,3
HND-001370,2011,21000009,,,,2,4,6
HND-001381,2011,21000020,,,,8,9,17
HND-001382,2011,21000022,,,,10,14,24
HND-001384,2011,21000024,,,,2,3,5
HND-001385,2011,21000025,,,,4,2,6
HND-001386,2011,21000026,,,,3,1,4
HND-001388,2011,21000028,,,,0,1,1
HND-001389,2011,21000029,,,,6,5,11
HND-001390,2011,21000030,,,,5,5,10
,2011,21000032,,,,1,1,2
,2011,21000035,,,,3,6,9
,2011,21000036,,,,2,4,6
HND-001395,2011,21000038,,,,7,7,14
HND-001405,2011,21000048,,,,2,3,5
HND-001410,2011,21000058,,,,0,1,1
,2011,21000067,,,,0,4,4
HND-001420,2011,21000070,,,,5,6,11
,2011,21000071,,,,2,2,4
HND-001422,2011,21000072,,,,1,1,2
HND-001423,2011,21000073,,,,5,1,6
HND-001425,2011,21000075,,,,5,3,8
HND-001426,2011,21000076,,,,0,5,5
HND-001427,2011,21000077,,,,1,6,7
HND-001429,2011,21000080,,,,3,4,7
,2011,21000081,,,,2,0,2
,2011,21000082,,,,1,1,2
HND-001432,2011,21000083,,,,6,4,10
HND-001433,2011,21000084,,,,4,5,9
HND-001437,2011,21000094,,,,1,7,8
HND-001438,2011,21000096,,,,5,3,8
HND-001440,2011,21000101,,,,3,3,6
HND-001447,2011,21000143,,,,1,1,2
HND-001448,2011,21000145,,,,2,2,4
HND-001363,2011,21000002,,,,32,37,69
HND-001364,2011,21000003,,,,35,42,77
HND-001365,2011,21000004,,,,4,10,14
HND-001366,2011,21000005,,,,5,1,6
HND-001367,2011,21000006,,,,7,11,18
HND-001369,2011,21000008,,,,8,11,19
HND-001371,2011,21000010,,,,19,13,32
HND-001372,2011,21000011,,,,3,2,5
HND-001373,2011,21000012,,,,4,11,15
HND-001375,2011,21000014,,,,4,5,9
HND-001376,2011,21000015,,,,7,1,8
HND-001377,2011,21000016,,,,20,24,44
HND-001379,2011,21000018,,,,0,5,5
HND-001380,2011,21000019,,,,7,3,10
HND-001383,2011,21000023,,,,21,31,52
,2011,21000027,,,,2,3,5
HND-001391,2011,21000031,,,,17,15,32
HND-001404,2011,21000047,,,,3,4,7
HND-001407,2011,21000053,,,,1,3,4
HND-001408,2011,21000054,,,,0,2,2
HND-001409,2011,21000057,,,,0,1,1
HND-001412,2011,21000060,,,,0,2,2
HND-001415,2011,21000064,,,,2,3,5
,2011,21000066,,,,3,2,5
HND-001418,2011,21000068,,,,2,1,3
,2011,21000069,,,,4,5,9
,2011,21000078,,,,1,1,2
,2011,21000079,,,,5,2,7
,2011,21000085,,,,2,1,3
,2011,21000100,,,,4,0,4
,2011,21000126,,,,11,10,21
,2011,21000144,,,,11,10,21
HND-001454,2011,21000167,,,,1,3,4
HND-001455,2011,21000170,,,,12,15,27
,2011,21000171,,,,3,4,7
,2011,21000172,,,,1,0,1
,2011,21000173,,,,0,1,1
,2011,21000174,,,,1,4,5
HND-001363,2011,21000002,,,,29,37,66
HND-001365,2011,21000004,,,,6,10,16
HND-001366,2011,21000005,,,,0,3,3
HND-001367,2011,21000006,,,,5,9,14
HND-001368,2011,21000007,,,,1,3,4
HND-001369,2011,21000008,,,,15,9,24
HND-001370,2011,21000009,,,,6,4,10
HND-001371,2011,21000010,,,,4,9,13
HND-001375,2011,21000014,,,,3,2,5
HND-001376,2011,21000015,,,,2,4,6
HND-001377,2011,21000016,,,,26,21,47
HND-001379,2011,21000018,,,,0,4,4
HND-001380,2011,21000019,,,,3,3,6
HND-001382,2011,21000022,,,,6,12,18
HND-001383,2011,21000023,,,,25,36,61
HND-001384,2011,21000024,,,,6,4,10
HND-001386,2011,21000026,,,,1,0,1
,2011,21000027,,,,3,3,6
HND-001391,2011,21000031,,,,12,20,32
,2011,21000032,,,,3,0,3
,2011,21000035,,,,2,2,4
,2011,21000036,,,,2,3,5
HND-001395,2011,21000038,,,,5,9,14
HND-001404,2011,21000047,,,,3,4,7
HND-001407,2011,21000053,,,,1,3,4
HND-001408,2011,21000054,,,,1,2,3
HND-001409,2011,21000057,,,,3,3,6
HND-001410,2011,21000058,,,,0,1,1
HND-001411,2011,21000059,,,,2,3,5
,2011,21000069,,,,0,5,5
HND-001423,2011,21000073,,,,4,3,7
HND-001427,2011,21000077,,,,5,5,10
,2011,21000078,,,,1,0,1
,2011,21000082,,,,0,1,1
HND-001433,2011,21000084,,,,5,12,17
,2011,21000100,,,,4,0,4
,2011,21000126,,,,4,7,11
HND-001447,2011,21000143,,,,3,1,4
HND-001448,2011,21000145,,,,2,2,4
,2011,21000171,,,,1,4,5
,2011,21000173,,,,2,0,2
HND-001362,2011,21000001,,,,39,46,85
HND-001364,2011,21000003,,,,37,38,75
HND-001372,2011,21000011,,,,9,4,13
HND-001373,2011,21000012,,,,11,3,14
HND-001378,2011,21000017,,,,1,2,3
HND-001381,2011,21000020,,,,19,7,26
HND-001385,2011,21000025,,,,4,6,10
HND-001388,2011,21000028,,,,0,2,2
HND-001389,2011,21000029,,,,4,5,9
HND-001390,2011,21000030,,,,1,4,5
HND-001405,2011,21000048,,,,2,1,3
HND-001412,2011,21000060,,,,5,0,5
HND-001415,2011,21000064,,,,2,0,2
,2011,21000066,,,,3,2,5
,2011,21000067,,,,0,3,3
HND-001418,2011,21000068,,,,0,1,1
HND-001420,2011,21000070,,,,2,3,5
HND-001422,2011,21000072,,,,0,1,1
HND-001425,2011,21000075,,,,4,6,10
HND-001426,2011,21000076,,,,0,1,1
,2011,21000079,,,,2,5,7
HND-001429,2011,21000080,,,,3,3,6
,2011,21000081,,,,1,1,2
HND-001432,2011,21000083,,,,4,2,6
HND-001436,2011,21000088,,,,1,0,1
HND-001437,2011,21000094,,,,5,2,7
HND-001438,2011,21000096,,,,2,3,5
HND-001440,2011,21000101,,,,7,2,9
,2011,21000144,,,,4,7,11
HND-001454,2011,21000167,,,,3,2,5
HND-001455,2011,21000170,,,,4,9,13
,2011,21000172,,,,0,1,1
HND-001364,2011,21000003,,,,33,27,60
HND-001369,2011,21000008,,,,5,9,14
HND-001371,2011,21000010,,,,10,15,25
HND-001377,2011,21000016,,,,30,28,58
HND-001403,2011,21000046,,,,93,94,187
HND-001374,2011,21000013,,,,24,25,49
HND-001383,2011,21000023,,,,18,29,47
,2011,21000103,,,,23,17,40
HND-001364,2011,21000003,,,,15,34,49
HND-001374,2011,21000013,,,,36,44,80
,2011,21000103,,,,12,14,26
HND-001369,2011,21000008,,,,7,8,15
HND-001371,2011,21000010,,,,4,15,19
HND-001377,2011,21000016,,,,8,18,26
HND-001383,2011,21000023,,,,7,20,27
HND-001403,2011,21000046,,,,45,73,118
HND-001364,2011,21000003,,,,17,16,33
HND-001369,2011,21000008,,,,7,7,14
HND-001371,2011,21000010,,,,2,11,13
HND-001374,2011,21000013,,,,19,38,57
HND-001377,2011,21000016,,,,18,26,44
HND-001383,2011,21000023,,,,7,15,22
HND-001403,2011,21000046,,,,49,59,108
,2011,21000103,,,,19,29,48
HND-001374,2011,21000013,,,,26,26,52
HND-001403,2011,21000046,,,,19,45,64
,2011,21000103,,,,36,45,81
,2011,21000103,,,,22,55,77
HND-001374,2011,21000013,,,,16,17,33
HND-001403,2011,21000046,,,,14,48,62
HND-001374,2011,21000013,,,,6,16,22
HND-001403,2011,21000046,,,,10,40,50
,2011,21000103,,,,12,33,45
HND-001531,2011,30100079,,,,3,5,8
HND-001598,2011,30100165,,,,7,3,10
,2011,30100206,,,,4,4,8
HND-001631,2011,30100251,,,,5,0,5
HND-001645,2011,30100307,,,,9,6,15
,2011,30100312,,,,7,12,19
,2011,30100316,,,,7,2,9
HND-001652,2011,30100319,,,,17,17,34
HND-001653,2011,30100320,,,,8,2,10
HND-001654,2011,30100321,,,,4,5,9
,2011,30100322,,,,9,8,17
,2011,30100323,,,,8,10,18
HND-001656,2011,30100329,,,,7,5,12
HND-001661,2011,30100335,,,,4,8,12
HND-001662,2011,30100336,,,,1,9,10
HND-001664,2011,30100342,,,,5,5,10
HND-001667,2011,30100346,,,,9,8,17
HND-001668,2011,30100347,,,,6,6,12
HND-001669,2011,30100348,,,,11,14,25
HND-001671,2011,30100350,,,,4,9,13
HND-001672,2011,30100353,,,,11,8,19
,2011,30100358,,,,8,3,11
HND-001675,2011,30100368,,,,8,7,15
HND-001678,2011,30100371,,,,2,8,10
HND-001679,2011,30100372,,,,7,4,11
HND-001681,2011,30100374,,,,3,3,6
HND-001504,2011,30100050,,,,3,4,7
HND-001626,2011,30100230,,,,8,6,14
HND-001627,2011,30100232,,,,18,8,26
HND-001628,2011,30100233,,,,6,6,12
HND-001629,2011,30100234,,,,8,7,15
HND-001638,2011,30100278,,,,8,2,10
,2011,30100279,,,,13,14,27
,2011,30100286,,,,2,3,5
HND-001646,2011,30100308,,,,6,15,21
HND-001647,2011,30100309,,,,0,11,11
HND-001648,2011,30100310,,,,10,7,17
HND-001651,2011,30100317,,,,6,4,10
,2011,30100330,,,,7,2,9
HND-001658,2011,30100331,,,,4,4,8
HND-001659,2011,30100332,,,,8,6,14
,2011,30100333,,,,7,1,8
,2011,30100341,,,,4,8,12
HND-001665,2011,30100343,,,,5,6,11
HND-001666,2011,30100344,,,,9,5,14
HND-001670,2011,30100349,,,,5,5,10
,2011,30100351,,,,6,2,8
,2011,30100352,,,,11,5,16
,2011,30100355,,,,5,8,13
HND-001673,2011,30100356,,,,3,7,10
HND-001674,2011,30100357,,,,11,2,13
,2011,30100359,,,,4,7,11
,2011,30100363,,,,5,9,14
HND-001676,2011,30100369,,,,3,7,10
HND-001677,2011,30100370,,,,5,12,17
,2011,30100069,,,,1,3,4
HND-001549,2011,30100102,,,,12,8,20
HND-001563,2011,30100118,,,,0,1,1
HND-001584,2011,30100146,,,,1,4,5
,2011,30100158,,,,25,22,47
HND-001592,2011,30100159,,,,0,2,2
HND-001604,2011,30100173,,,,12,18,30
HND-001606,2011,30100178,,,,2,3,5
,2011,30100183,,,,1,0,1
HND-001611,2011,30100188,,,,0,1,1
HND-001613,2011,30100192,,,,6,1,7
,2011,30100196,,,,1,2,3
,2011,30100207,,,,0,2,2
HND-001625,2011,30100226,,,,1,1,2
,2011,30100227,,,,0,1,1
,2011,30100235,,,,2,3,5
HND-001632,2011,30100260,,,,0,3,3
,2011,30100268,,,,3,2,5
,2011,30100273,,,,2,3,5
,2011,30100306,,,,2,3,5
HND-001547,2011,30100099,,,,6,6,12
HND-001556,2011,30100109,,,,1,1,2
HND-001560,2011,30100114,,,,1,1,2
HND-001561,2011,30100115,,,,0,2,2
,2011,30100116,,,,17,23,40
HND-001565,2011,30100120,,,,0,2,2
HND-001569,2011,30100124,,,,1,2,3
,2011,30100135,,,,2,6,8
HND-001582,2011,30100143,,,,1,1,2
,2011,30100153,,,,5,3,8
HND-001616,2011,30100199,,,,0,1,1
,2011,30100204,,,,6,7,13
,2011,30100209,,,,7,4,11
,2011,30100211,,,,5,0,5
,2011,30100219,,,,1,2,3
,2011,30100224,,,,4,5,9
HND-001635,2011,30100264,,,,3,3,6
,2011,30100297,,,,3,0,3
HND-001644,2011,30100305,,,,1,2,3
,2011,30100338,,,,5,5,10
,2011,30100339,,,,8,6,14
,2011,30100360,,,,24,18,42
,2011,30100367,,,,0,1,1
,2011,30100069,,,,8,5,13
HND-001535,2011,30100083,,,,6,3,9
,2011,30100090,,,,10,5,15
HND-001549,2011,30100102,,,,17,18,35
HND-001551,2011,30100104,,,,1,0,1
HND-001554,2011,30100107,,,,6,1,7
HND-001555,2011,30100108,,,,12,15,27
HND-001556,2011,30100109,,,,1,9,10
HND-001561,2011,30100115,,,,4,9,13
HND-001563,2011,30100118,,,,4,7,11
HND-001568,2011,30100123,,,,6,5,11
HND-001569,2011,30100124,,,,7,1,8
HND-001575,2011,30100134,,,,2,4,6
,2011,30100135,,,,6,12,18
HND-001578,2011,30100138,,,,11,21,32
HND-001579,2011,30100140,,,,0,2,2
HND-001581,2011,30100142,,,,6,5,11
HND-001582,2011,30100143,,,,1,3,4
HND-001586,2011,30100148,,,,1,1,2
HND-001589,2011,30100152,,,,2,1,3
,2011,30100153,,,,2,3,5
,2011,30100155,,,,3,2,5
HND-001592,2011,30100159,,,,8,6,14
HND-001595,2011,30100162,,,,3,2,5
HND-001601,2011,30100169,,,,28,17,45
,2011,30100183,,,,9,9,18
HND-001608,2011,30100184,,,,3,5,8
HND-001609,2011,30100185,,,,1,2,3
HND-001610,2011,30100186,,,,6,10,16
HND-001613,2011,30100192,,,,1,1,2
HND-001616,2011,30100199,,,,5,4,9
,2011,30100203,,,,9,10,19
,2011,30100211,,,,10,0,10
,2011,30100219,,,,2,0,2
,2011,30100224,,,,9,15,24
,2011,30100235,,,,3,3,6
,2011,30100250,,,,0,2,2
HND-001632,2011,30100260,,,,0,3,3
HND-001635,2011,30100264,,,,6,3,9
HND-001637,2011,30100275,,,,1,5,6
,2011,30100297,,,,5,7,12
HND-001644,2011,30100305,,,,2,2,4
,2011,30100306,,,,13,13,26
,2011,30100337,,,,2,1,3
,2011,30100338,,,,11,3,14
,2011,30100360,,,,38,27,65
,2011,30100057,,,,10,12,22
HND-001547,2011,30100099,,,,15,21,36
HND-001548,2011,30100101,,,,15,15,30
HND-001550,2011,30100103,,,,3,1,4
HND-001552,2011,30100105,,,,14,14,28
HND-001553,2011,30100106,,,,10,10,20
HND-001557,2011,30100110,,,,11,10,21
HND-001559,2011,30100113,,,,6,7,13
HND-001560,2011,30100114,,,,3,3,6
,2011,30100116,,,,19,21,40
HND-001565,2011,30100120,,,,4,1,5
HND-001567,2011,30100122,,,,2,2,4
HND-001570,2011,30100125,,,,4,1,5
,2011,30100126,,,,1,1,2
HND-001584,2011,30100146,,,,4,4,8
HND-001585,2011,30100147,,,,16,11,27
,2011,30100158,,,,21,24,45
HND-001596,2011,30100163,,,,3,5,8
HND-001597,2011,30100164,,,,3,4,7
HND-001604,2011,30100173,,,,57,61,118
HND-001606,2011,30100178,,,,0,2,2
HND-001611,2011,30100188,,,,8,6,14
,2011,30100196,,,,2,8,10
HND-001618,2011,30100202,,,,3,5,8
,2011,30100204,,,,13,19,32
,2011,30100207,,,,3,2,5
,2011,30100209,,,,5,3,8
HND-001625,2011,30100226,,,,3,3,6
,2011,30100227,,,,0,1,1
,2011,30100268,,,,3,3,6
,2011,30100273,,,,3,1,4
,2011,30100302,,,,3,0,3
,2011,30100339,,,,10,8,18
,2011,30100367,,,,0,1,1
HND-001522,2011,30100070,,,,33,19,52
HND-001535,2011,30100083,,,,21,16,37
HND-001548,2011,30100101,,,,36,26,62
HND-001550,2011,30100103,,,,3,7,10
HND-001556,2011,30100109,,,,18,16,34
HND-001557,2011,30100110,,,,48,33,81
HND-001560,2011,30100114,,,,10,7,17
HND-001561,2011,30100115,,,,17,21,38
,2011,30100116,,,,31,22,53
HND-001565,2011,30100120,,,,5,4,9
HND-001566,2011,30100121,,,,14,14,28
HND-001567,2011,30100122,,,,7,7,14
HND-001570,2011,30100125,,,,17,18,35
,2011,30100126,,,,8,17,25
HND-001572,2011,30100128,,,,10,12,22
HND-001575,2011,30100134,,,,10,10,20
,2011,30100135,,,,8,8,16
HND-001578,2011,30100138,,,,38,34,72
HND-001579,2011,30100140,,,,7,13,20
HND-001581,2011,30100142,,,,5,5,10
HND-001584,2011,30100146,,,,9,3,12
HND-001586,2011,30100148,,,,10,15,25
HND-001589,2011,30100152,,,,6,6,12
,2011,30100155,,,,7,3,10
,2011,30100158,,,,23,22,45
HND-001592,2011,30100159,,,,14,6,20
HND-001596,2011,30100163,,,,20,8,28
HND-001597,2011,30100164,,,,9,4,13
HND-001606,2011,30100178,,,,2,1,3
,2011,30100183,,,,6,6,12
HND-001608,2011,30100184,,,,6,7,13
HND-001609,2011,30100185,,,,16,23,39
HND-001610,2011,30100186,,,,5,5,10
HND-001613,2011,30100192,,,,4,6,10
,2011,30100196,,,,3,11,14
HND-001616,2011,30100199,,,,7,2,9
HND-001618,2011,30100202,,,,11,11,22
,2011,30100204,,,,24,16,40
,2011,30100209,,,,3,5,8
,2011,30100224,,,,7,9,16
,2011,30100227,,,,3,2,5
,2011,30100250,,,,3,4,7
HND-001635,2011,30100264,,,,2,4,6
,2011,30100268,,,,2,3,5
,2011,30100273,,,,2,4,6
,2011,30100297,,,,3,5,8
,2011,30100339,,,,8,5,13
,2011,30100367,,,,1,1,2
,2011,30100057,,,,17,11,28
,2011,30100069,,,,8,9,17
,2011,30100090,,,,13,19,32
HND-001547,2011,30100099,,,,44,31,75
,2011,30100100,,,,0,61,61
HND-001549,2011,30100102,,,,15,17,32
HND-001551,2011,30100104,,,,18,11,29
HND-001552,2011,30100105,,,,27,17,44
HND-001553,2011,30100106,,,,21,14,35
HND-001554,2011,30100107,,,,11,2,13
HND-001555,2011,30100108,,,,26,20,46
HND-001558,2011,30100111,,,,13,13,26
HND-001559,2011,30100113,,,,3,10,13
HND-001563,2011,30100118,,,,13,18,31
HND-001568,2011,30100123,,,,6,8,14
HND-001569,2011,30100124,,,,9,9,18
HND-001576,2011,30100136,,,,3,3,6
HND-001577,2011,30100137,,,,6,0,6
HND-001582,2011,30100143,,,,10,11,21
HND-001585,2011,30100147,,,,25,18,43
,2011,30100153,,,,4,6,10
HND-001590,2011,30100154,,,,12,11,23
HND-001595,2011,30100162,,,,6,8,14
HND-001601,2011,30100169,,,,27,17,44
HND-001604,2011,30100173,,,,80,62,142
HND-001611,2011,30100188,,,,13,13,26
,2011,30100203,,,,14,10,24
,2011,30100207,,,,2,4,6
,2011,30100211,,,,4,2,6
,2011,30100219,,,,2,4,6
HND-001625,2011,30100226,,,,3,5,8
,2011,30100235,,,,2,5,7
HND-001632,2011,30100260,,,,3,0,3
HND-001637,2011,30100275,,,,2,0,2
,2011,30100302,,,,0,6,6
HND-001644,2011,30100305,,,,4,3,7
,2011,30100306,,,,11,7,18
,2011,30100337,,,,4,2,6
,2011,30100338,,,,8,6,14
,2011,30100360,,,,73,26,99
HND-001460,2011,30100005,,,,10,3,13
HND-001462,2011,30100007,,,,7,7,14
HND-001463,2011,30100008,,,,13,22,35
HND-001465,2011,30100010,,,,12,21,33
HND-001466,2011,30100011,,,,12,6,18
HND-001468,2011,30100013,,,,7,7,14
HND-001470,2011,30100015,,,,2,7,9
HND-001474,2011,30100019,,,,42,29,71
HND-001480,2011,30100025,,,,8,11,19
HND-001481,2011,30100026,,,,43,29,72
HND-001482,2011,30100027,,,,1,5,6
HND-001483,2011,30100028,,,,4,1,5
HND-001486,2011,30100031,,,,7,5,12
HND-001490,2011,30100036,,,,25,23,48
HND-001492,2011,30100038,,,,15,11,26
HND-001493,2011,30100039,,,,59,50,109
HND-001498,2011,30100044,,,,5,9,14
HND-001499,2011,30100045,,,,10,10,20
HND-001500,2011,30100046,,,,6,4,10
HND-001504,2011,30100050,,,,3,3,6
HND-001505,2011,30100051,,,,13,10,23
HND-001506,2011,30100052,,,,71,51,122
HND-001507,2011,30100053,,,,0,3,3
HND-001509,2011,30100055,,,,30,38,68
HND-001512,2011,30100059,,,,3,4,7
HND-001513,2011,30100060,,,,5,8,13
HND-001514,2011,30100061,,,,9,3,12
HND-001515,2011,30100062,,,,20,26,46
HND-001516,2011,30100063,,,,5,5,10
HND-001521,2011,30100068,,,,8,12,20
,2011,30100069,,,,8,5,13
HND-001522,2011,30100070,,,,56,57,113
HND-001523,2011,30100071,,,,7,2,9
HND-001525,2011,30100073,,,,27,25,52
HND-001531,2011,30100079,,,,10,7,17
HND-001532,2011,30100080,,,,27,18,45
HND-001533,2011,30100081,,,,5,3,8
HND-001534,2011,30100082,,,,13,12,25
HND-001535,2011,30100083,,,,25,16,41
HND-001537,2011,30100085,,,,10,4,14
HND-001538,2011,30100086,,,,7,9,16
,2011,30100088,,,,11,8,19
HND-001542,2011,30100094,,,,14,17,31
HND-001543,2011,30100095,,,,9,13,22
HND-001544,2011,30100096,,,,7,15,22
HND-001546,2011,30100098,,,,12,9,21
,2011,30100116,,,,23,20,43
HND-001569,2011,30100124,,,,42,44,86
,2011,30100135,,,,11,7,18
HND-001576,2011,30100136,,,,3,6,9
HND-001577,2011,30100137,,,,4,1,5
HND-001592,2011,30100159,,,,25,17,42
HND-001593,2011,30100160,,,,28,24,52
HND-001599,2011,30100166,,,,6,2,8
HND-001600,2011,30100168,,,,5,1,6
HND-001607,2011,30100182,,,,6,0,6
,2011,30100183,,,,6,6,12
HND-001614,2011,30100194,,,,9,7,16
,2011,30100204,,,,25,22,47
HND-001619,2011,30100212,,,,5,2,7
,2011,30100219,,,,3,1,4
HND-001621,2011,30100220,,,,11,6,17
HND-001623,2011,30100222,,,,4,5,9
,2011,30100224,,,,5,5,10
HND-001634,2011,30100262,,,,1,2,3
HND-001635,2011,30100264,,,,8,2,10
HND-001636,2011,30100269,,,,7,5,12
HND-001637,2011,30100275,,,,3,6,9
,2011,30100297,,,,20,16,36
HND-001641,2011,30100299,,,,8,8,16
HND-001644,2011,30100305,,,,10,3,13
HND-001663,2011,30100340,,,,7,5,12
,2011,30100364,,,,5,8,13
,2011,30100365,,,,0,1,1
,2011,30100366,,,,3,3,6
HND-001680,2011,30100373,,,,12,3,15
HND-001682,2011,30100375,,,,1,2,3
HND-001458,2011,30100002,,,,27,20,47
,2011,30100003,,,,6,3,9
HND-001459,2011,30100004,,,,15,13,28
HND-001464,2011,30100009,,,,32,33,65
HND-001467,2011,30100012,,,,22,18,40
HND-001469,2011,30100014,,,,6,1,7
HND-001471,2011,30100016,,,,74,57,131
HND-001472,2011,30100017,,,,83,49,132
HND-001473,2011,30100018,,,,94,56,150
HND-001475,2011,30100020,,,,17,17,34
HND-001476,2011,30100021,,,,25,12,37
HND-001477,2011,30100022,,,,7,4,11
HND-001478,2011,30100023,,,,11,8,19
HND-001479,2011,30100024,,,,0,6,6
HND-001484,2011,30100029,,,,8,14,22
HND-001485,2011,30100030,,,,23,27,50
HND-001487,2011,30100032,,,,10,10,20
HND-001488,2011,30100033,,,,19,11,30
HND-001489,2011,30100034,,,,31,18,49
HND-001491,2011,30100037,,,,59,51,110
HND-001494,2011,30100040,,,,15,10,25
HND-001495,2011,30100041,,,,17,3,20
HND-001496,2011,30100042,,,,24,23,47
HND-001497,2011,30100043,,,,7,7,14
HND-001501,2011,30100047,,,,16,10,26
HND-001502,2011,30100048,,,,4,1,5
HND-001503,2011,30100049,,,,1,4,5
HND-001508,2011,30100054,,,,5,6,11
HND-001510,2011,30100056,,,,10,8,18
,2011,30100057,,,,36,22,58
HND-001511,2011,30100058,,,,68,64,132
HND-001517,2011,30100064,,,,12,13,25
HND-001518,2011,30100065,,,,18,6,24
HND-001519,2011,30100066,,,,30,20,50
HND-001520,2011,30100067,,,,18,18,36
HND-001524,2011,30100072,,,,4,4,8
HND-001526,2011,30100074,,,,19,14,33
HND-001528,2011,30100076,,,,11,10,21
HND-001529,2011,30100077,,,,10,3,13
HND-001530,2011,30100078,,,,16,15,31
HND-001536,2011,30100084,,,,12,7,19
HND-001539,2011,30100089,,,,2,5,7
HND-001540,2011,30100091,,,,3,10,13
HND-001541,2011,30100092,,,,10,8,18
,2011,30100093,,,,30,30,60
HND-001545,2011,30100097,,,,45,29,74
,2011,30100112,,,,20,23,43
HND-001562,2011,30100117,,,,6,5,11
HND-001563,2011,30100118,,,,36,13,49
HND-001564,2011,30100119,,,,2,2,4
HND-001571,2011,30100127,,,,5,3,8
HND-001580,2011,30100141,,,,1,0,1
HND-001583,2011,30100144,,,,3,6,9
HND-001587,2011,30100150,,,,8,3,11
HND-001588,2011,30100151,,,,7,1,8
HND-001591,2011,30100156,,,,8,6,14
,2011,30100158,,,,22,22,44
HND-001594,2011,30100161,,,,0,108,108
HND-001602,2011,30100170,,,,6,7,13
HND-001603,2011,30100171,,,,3,9,12
HND-001606,2011,30100178,,,,4,1,5
HND-001612,2011,30100191,,,,5,7,12
HND-001613,2011,30100192,,,,5,3,8
HND-001615,2011,30100195,,,,7,5,12
HND-001620,2011,30100213,,,,4,3,7
,2011,30100216,,,,22,25,47
HND-001622,2011,30100221,,,,27,25,52
HND-001624,2011,30100225,,,,4,3,7
HND-001632,2011,30100260,,,,1,4,5
HND-001633,2011,30100261,,,,6,4,10
,2011,30100296,,,,14,13,27
,2011,30100302,,,,3,1,4
HND-001642,2011,30100303,,,,5,5,10
HND-001643,2011,30100304,,,,2,0,2
,2011,30100306,,,,10,20,30
HND-001651,2011,30100317,,,,13,8,21
,2011,30100339,,,,5,7,12
HND-001674,2011,30100357,,,,0,1,1
HND-001458,2011,30100002,,,,13,12,25
,2011,30100003,,,,2,2,4
HND-001463,2011,30100008,,,,19,17,36
HND-001464,2011,30100009,,,,14,18,32
HND-001465,2011,30100010,,,,12,11,23
HND-001466,2011,30100011,,,,22,19,41
HND-001467,2011,30100012,,,,16,10,26
HND-001468,2011,30100013,,,,5,8,13
HND-001469,2011,30100014,,,,5,4,9
HND-001471,2011,30100016,,,,53,59,112
HND-001472,2011,30100017,,,,74,39,113
HND-001475,2011,30100020,,,,11,10,21
HND-001477,2011,30100022,,,,3,6,9
HND-001478,2011,30100023,,,,6,6,12
HND-001483,2011,30100028,,,,4,1,5
HND-001484,2011,30100029,,,,10,5,15
HND-001489,2011,30100034,,,,21,12,33
HND-001490,2011,30100036,,,,10,8,18
HND-001493,2011,30100039,,,,55,47,102
HND-001496,2011,30100042,,,,13,20,33
HND-001498,2011,30100044,,,,8,11,19
HND-001501,2011,30100047,,,,15,11,26
HND-001503,2011,30100049,,,,2,3,5
HND-001504,2011,30100050,,,,5,3,8
HND-001505,2011,30100051,,,,5,5,10
HND-001506,2011,30100052,,,,42,42,84
HND-001510,2011,30100056,,,,12,11,23
HND-001515,2011,30100062,,,,8,14,22
HND-001517,2011,30100064,,,,10,10,20
HND-001520,2011,30100067,,,,10,16,26
HND-001522,2011,30100070,,,,60,43,103
HND-001523,2011,30100071,,,,5,11,16
HND-001525,2011,30100073,,,,13,20,33
HND-001528,2011,30100076,,,,4,5,9
HND-001529,2011,30100077,,,,2,4,6
HND-001530,2011,30100078,,,,14,10,24
HND-001533,2011,30100081,,,,4,3,7
HND-001534,2011,30100082,,,,8,8,16
HND-001535,2011,30100083,,,,20,20,40
HND-001537,2011,30100085,,,,7,2,9
HND-001538,2011,30100086,,,,6,7,13
,2011,30100088,,,,2,1,3
HND-001541,2011,30100092,,,,8,2,10
HND-001542,2011,30100094,,,,8,9,17
HND-001545,2011,30100097,,,,23,28,51
,2011,30100112,,,,36,18,54
,2011,30100116,,,,25,18,43
HND-001562,2011,30100117,,,,5,2,7
HND-001564,2011,30100119,,,,3,4,7
HND-001587,2011,30100150,,,,2,7,9
HND-001591,2011,30100156,,,,4,7,11
,2011,30100158,,,,22,24,46
HND-001594,2011,30100161,,,,0,132,132
HND-001606,2011,30100178,,,,0,4,4
HND-001607,2011,30100182,,,,3,2,5
,2011,30100183,,,,7,7,14
HND-001613,2011,30100192,,,,1,3,4
,2011,30100204,,,,24,26,50
,2011,30100216,,,,25,26,51
HND-001622,2011,30100221,,,,37,34,71
HND-001623,2011,30100222,,,,4,5,9
,2011,30100224,,,,5,4,9
HND-001635,2011,30100264,,,,0,1,1
,2011,30100296,,,,9,9,18
,2011,30100297,,,,9,13,22
,2011,30100339,,,,3,4,7
HND-001663,2011,30100340,,,,2,2,4
HND-001674,2011,30100357,,,,11,0,11
,2011,30100365,,,,1,1,2
,2011,30100366,,,,4,0,4
HND-001682,2011,30100375,,,,6,6,12
HND-001459,2011,30100004,,,,11,10,21
HND-001460,2011,30100005,,,,3,7,10
HND-001461,2011,30100006,,,,3,0,3
HND-001462,2011,30100007,,,,10,6,16
HND-001470,2011,30100015,,,,8,3,11
HND-001473,2011,30100018,,,,83,55,138
HND-001474,2011,30100019,,,,42,21,63
HND-001476,2011,30100021,,,,16,16,32
HND-001479,2011,30100024,,,,4,6,10
HND-001480,2011,30100025,,,,5,3,8
HND-001481,2011,30100026,,,,28,43,71
HND-001482,2011,30100027,,,,2,3,5
HND-001485,2011,30100030,,,,28,25,53
HND-001486,2011,30100031,,,,7,5,12
HND-001487,2011,30100032,,,,5,5,10
HND-001488,2011,30100033,,,,5,12,17
HND-001491,2011,30100037,,,,61,47,108
HND-001492,2011,30100038,,,,9,10,19
HND-001494,2011,30100040,,,,7,12,19
HND-001495,2011,30100041,,,,15,15,30
HND-001497,2011,30100043,,,,3,4,7
HND-001499,2011,30100045,,,,11,7,18
HND-001500,2011,30100046,,,,5,4,9
HND-001502,2011,30100048,,,,2,0,2
HND-001507,2011,30100053,,,,6,3,9
HND-001508,2011,30100054,,,,7,3,10
HND-001509,2011,30100055,,,,53,49,102
,2011,30100057,,,,31,24,55
HND-001511,2011,30100058,,,,62,52,114
HND-001512,2011,30100059,,,,8,2,10
HND-001513,2011,30100060,,,,7,5,12
HND-001514,2011,30100061,,,,3,9,12
HND-001516,2011,30100063,,,,8,8,16
HND-001518,2011,30100065,,,,7,3,10
HND-001519,2011,30100066,,,,22,14,36
HND-001521,2011,30100068,,,,12,9,21
,2011,30100069,,,,7,9,16
HND-001524,2011,30100072,,,,6,3,9
HND-001526,2011,30100074,,,,1,7,8
HND-001531,2011,30100079,,,,10,13,23
HND-001532,2011,30100080,,,,8,10,18
HND-001536,2011,30100084,,,,2,4,6
HND-001539,2011,30100089,,,,1,5,6
HND-001540,2011,30100091,,,,7,4,11
,2011,30100093,,,,31,25,56
HND-001543,2011,30100095,,,,12,7,19
HND-001544,2011,30100096,,,,13,15,28
HND-001546,2011,30100098,,,,4,7,11
HND-001563,2011,30100118,,,,20,19,39
HND-001569,2011,30100124,,,,31,29,60
HND-001571,2011,30100127,,,,4,1,5
,2011,30100135,,,,7,10,17
HND-001576,2011,30100136,,,,7,4,11
HND-001577,2011,30100137,,,,0,3,3
HND-001580,2011,30100141,,,,1,2,3
HND-001583,2011,30100144,,,,1,0,1
HND-001588,2011,30100151,,,,6,4,10
HND-001592,2011,30100159,,,,17,17,34
HND-001593,2011,30100160,,,,19,17,36
HND-001599,2011,30100166,,,,4,5,9
HND-001600,2011,30100168,,,,2,2,4
HND-001602,2011,30100170,,,,5,2,7
HND-001603,2011,30100171,,,,3,1,4
HND-001612,2011,30100191,,,,4,3,7
HND-001614,2011,30100194,,,,4,5,9
HND-001615,2011,30100195,,,,8,4,12
HND-001619,2011,30100212,,,,5,9,14
HND-001620,2011,30100213,,,,3,2,5
,2011,30100219,,,,1,3,4
HND-001621,2011,30100220,,,,9,10,19
HND-001624,2011,30100225,,,,3,2,5
HND-001632,2011,30100260,,,,7,8,15
HND-001633,2011,30100261,,,,5,2,7
HND-001634,2011,30100262,,,,2,4,6
HND-001636,2011,30100269,,,,3,3,6
HND-001637,2011,30100275,,,,0,4,4
HND-001641,2011,30100299,,,,13,8,21
,2011,30100302,,,,1,7,8
HND-001642,2011,30100303,,,,4,3,7
HND-001643,2011,30100304,,,,2,2,4
HND-001644,2011,30100305,,,,2,4,6
,2011,30100306,,,,14,10,24
HND-001651,2011,30100317,,,,7,5,12
,2011,30100364,,,,4,5,9
HND-001680,2011,30100373,,,,5,1,6
HND-001458,2011,30100002,,,,12,8,20
,2011,30100003,,,,2,2,4
HND-001459,2011,30100004,,,,7,10,17
HND-001464,2011,30100009,,,,13,18,31
HND-001467,2011,30100012,,,,9,6,15
HND-001468,2011,30100013,,,,3,2,5
HND-001469,2011,30100014,,,,6,7,13
HND-001471,2011,30100016,,,,62,45,107
HND-001472,2011,30100017,,,,81,44,125
HND-001473,2011,30100018,,,,68,77,145
HND-001475,2011,30100020,,,,6,14,20
HND-001477,2011,30100022,,,,4,6,10
HND-001478,2011,30100023,,,,4,6,10
HND-001479,2011,30100024,,,,3,3,6
HND-001484,2011,30100029,,,,8,5,13
HND-001486,2011,30100031,,,,4,5,9
HND-001490,2011,30100036,,,,9,5,14
HND-001492,2011,30100038,,,,12,16,28
HND-001493,2011,30100039,,,,48,43,91
HND-001498,2011,30100044,,,,6,7,13
HND-001499,2011,30100045,,,,7,9,16
HND-001500,2011,30100046,,,,8,5,13
HND-001504,2011,30100050,,,,5,6,11
HND-001505,2011,30100051,,,,10,6,16
HND-001506,2011,30100052,,,,53,39,92
HND-001507,2011,30100053,,,,1,5,6
HND-001512,2011,30100059,,,,0,4,4
HND-001517,2011,30100064,,,,10,11,21
HND-001518,2011,30100065,,,,4,7,11
HND-001519,2011,30100066,,,,9,17,26
HND-001520,2011,30100067,,,,9,13,22
HND-001522,2011,30100070,,,,45,46,91
HND-001523,2011,30100071,,,,3,2,5
HND-001525,2011,30100073,,,,14,16,30
HND-001528,2011,30100076,,,,10,4,14
HND-001532,2011,30100080,,,,6,4,10
HND-001533,2011,30100081,,,,2,6,8
HND-001534,2011,30100082,,,,14,10,24
HND-001535,2011,30100083,,,,23,18,41
HND-001537,2011,30100085,,,,5,0,5
HND-001538,2011,30100086,,,,3,4,7
,2011,30100088,,,,0,2,2
HND-001542,2011,30100094,,,,6,4,10
HND-001543,2011,30100095,,,,4,8,12
HND-001544,2011,30100096,,,,12,4,16
,2011,30100112,,,,16,16,32
,2011,30100116,,,,18,16,34
HND-001562,2011,30100117,,,,8,5,13
HND-001563,2011,30100118,,,,15,15,30
HND-001564,2011,30100119,,,,3,0,3
,2011,30100135,,,,4,7,11
HND-001576,2011,30100136,,,,8,9,17
HND-001577,2011,30100137,,,,5,3,8
HND-001592,2011,30100159,,,,20,12,32
HND-001594,2011,30100161,,,,0,112,112
HND-001607,2011,30100182,,,,3,2,5
,2011,30100183,,,,3,8,11
HND-001614,2011,30100194,,,,6,6,12
,2011,30100216,,,,31,20,51
HND-001622,2011,30100221,,,,43,17,60
HND-001624,2011,30100225,,,,1,2,3
HND-001633,2011,30100261,,,,3,1,4
,2011,30100296,,,,7,7,14
,2011,30100302,,,,8,4,12
HND-001642,2011,30100303,,,,2,5,7
HND-001643,2011,30100304,,,,3,3,6
,2011,30100306,,,,20,19,39
HND-001651,2011,30100317,,,,6,1,7
,2011,30100339,,,,3,4,7
HND-001674,2011,30100357,,,,0,1,1
HND-001460,2011,30100005,,,,5,2,7
HND-001462,2011,30100007,,,,11,13,24
HND-001463,2011,30100008,,,,8,8,16
HND-001465,2011,30100010,,,,8,7,15
HND-001466,2011,30100011,,,,16,11,27
HND-001470,2011,30100015,,,,3,2,5
HND-001474,2011,30100019,,,,34,22,56
HND-001476,2011,30100021,,,,23,16,39
HND-001480,2011,30100025,,,,2,7,9
HND-001481,2011,30100026,,,,40,34,74
HND-001482,2011,30100027,,,,1,3,4
HND-001483,2011,30100028,,,,2,0,2
HND-001485,2011,30100030,,,,25,25,50
HND-001487,2011,30100032,,,,4,5,9
HND-001488,2011,30100033,,,,8,8,16
HND-001489,2011,30100034,,,,28,28,56
HND-001491,2011,30100037,,,,65,56,121
HND-001494,2011,30100040,,,,1,1,2
HND-001495,2011,30100041,,,,8,12,20
HND-001496,2011,30100042,,,,24,19,43
HND-001497,2011,30100043,,,,4,4,8
HND-001501,2011,30100047,,,,12,9,21
HND-001502,2011,30100048,,,,1,1,2
HND-001503,2011,30100049,,,,2,8,10
HND-001508,2011,30100054,,,,6,5,11
HND-001509,2011,30100055,,,,38,28,66
HND-001510,2011,30100056,,,,7,5,12
,2011,30100057,,,,27,32,59
HND-001511,2011,30100058,,,,61,55,116
HND-001513,2011,30100060,,,,7,5,12
HND-001514,2011,30100061,,,,3,7,10
HND-001515,2011,30100062,,,,4,10,14
HND-001516,2011,30100063,,,,11,11,22
HND-001521,2011,30100068,,,,10,7,17
,2011,30100069,,,,17,8,25
HND-001524,2011,30100072,,,,6,3,9
HND-001526,2011,30100074,,,,4,7,11
HND-001529,2011,30100077,,,,7,3,10
HND-001530,2011,30100078,,,,12,4,16
HND-001531,2011,30100079,,,,11,8,19
HND-001536,2011,30100084,,,,9,2,11
HND-001539,2011,30100089,,,,1,2,3
HND-001540,2011,30100091,,,,2,3,5
HND-001541,2011,30100092,,,,6,10,16
,2011,30100093,,,,20,24,44
HND-001545,2011,30100097,,,,25,20,45
HND-001546,2011,30100098,,,,11,11,22
HND-001569,2011,30100124,,,,60,30,90
HND-001571,2011,30100127,,,,4,1,5
HND-001580,2011,30100141,,,,1,1,2
HND-001583,2011,30100144,,,,0,1,1
HND-001587,2011,30100150,,,,8,1,9
HND-001588,2011,30100151,,,,6,5,11
HND-001591,2011,30100156,,,,1,3,4
,2011,30100158,,,,20,27,47
HND-001593,2011,30100160,,,,20,20,40
HND-001599,2011,30100166,,,,3,0,3
HND-001600,2011,30100168,,,,6,3,9
HND-001602,2011,30100170,,,,2,0,2
HND-001603,2011,30100171,,,,3,0,3
HND-001606,2011,30100178,,,,7,1,8
HND-001612,2011,30100191,,,,4,4,8
HND-001613,2011,30100192,,,,6,2,8
HND-001615,2011,30100195,,,,0,3,3
,2011,30100204,,,,24,5,29
HND-001619,2011,30100212,,,,3,1,4
HND-001620,2011,30100213,,,,1,3,4
,2011,30100219,,,,3,2,5
HND-001621,2011,30100220,,,,4,4,8
HND-001623,2011,30100222,,,,2,1,3
,2011,30100224,,,,3,9,12
HND-001632,2011,30100260,,,,2,4,6
HND-001634,2011,30100262,,,,1,1,2
HND-001635,2011,30100264,,,,4,9,13
HND-001636,2011,30100269,,,,5,5,10
HND-001637,2011,30100275,,,,1,2,3
,2011,30100297,,,,13,11,24
HND-001641,2011,30100299,,,,6,5,11
HND-001644,2011,30100305,,,,1,4,5
HND-001663,2011,30100340,,,,0,1,1
,2011,30100366,,,,0,1,1
HND-001680,2011,30100373,,,,3,4,7
HND-001682,2011,30100375,,,,1,8,9
HND-001458,2011,30100002,,,,16,17,33
,2011,30100003,,,,1,2,3
HND-001463,2011,30100008,,,,9,10,19
HND-001464,2011,30100009,,,,21,18,39
HND-001465,2011,30100010,,,,7,17,24
HND-001466,2011,30100011,,,,8,12,20
HND-001467,2011,30100012,,,,7,15,22
HND-001468,2011,30100013,,,,8,4,12
HND-001472,2011,30100017,,,,84,55,139
HND-001475,2011,30100020,,,,11,8,19
HND-001477,2011,30100022,,,,8,7,15
HND-001478,2011,30100023,,,,5,3,8
HND-001483,2011,30100028,,,,2,4,6
HND-001484,2011,30100029,,,,2,3,5
HND-001489,2011,30100034,,,,21,26,47
HND-001490,2011,30100036,,,,8,5,13
HND-001494,2011,30100040,,,,5,1,6
HND-001496,2011,30100042,,,,13,15,28
HND-001497,2011,30100043,,,,3,6,9
HND-001498,2011,30100044,,,,5,5,10
HND-001501,2011,30100047,,,,21,12,33
HND-001503,2011,30100049,,,,7,2,9
HND-001505,2011,30100051,,,,7,12,19
HND-001506,2011,30100052,,,,49,52,101
HND-001510,2011,30100056,,,,9,10,19
HND-001511,2011,30100058,,,,65,55,120
HND-001513,2011,30100060,,,,4,11,15
HND-001515,2011,30100062,,,,10,12,22
HND-001516,2011,30100063,,,,2,8,10
HND-001517,2011,30100064,,,,6,11,17
HND-001522,2011,30100070,,,,55,51,106
HND-001525,2011,30100073,,,,18,18,36
HND-001526,2011,30100074,,,,0,1,1
HND-001528,2011,30100076,,,,7,2,9
HND-001529,2011,30100077,,,,0,4,4
HND-001530,2011,30100078,,,,11,9,20
HND-001535,2011,30100083,,,,15,15,30
HND-001536,2011,30100084,,,,4,6,10
HND-001537,2011,30100085,,,,7,4,11
HND-001538,2011,30100086,,,,4,5,9
HND-001541,2011,30100092,,,,10,3,13
,2011,30100093,,,,18,15,33
HND-001542,2011,30100094,,,,6,5,11
HND-001545,2011,30100097,,,,23,16,39
,2011,30100112,,,,29,27,56
,2011,30100116,,,,19,17,36
HND-001562,2011,30100117,,,,5,5,10
HND-001569,2011,30100124,,,,21,29,50
HND-001580,2011,30100141,,,,1,3,4
HND-001587,2011,30100150,,,,2,5,7
HND-001588,2011,30100151,,,,3,6,9
HND-001591,2011,30100156,,,,1,2,3
,2011,30100158,,,,17,36,53
HND-001594,2011,30100161,,,,0,99,99
HND-001600,2011,30100168,,,,1,0,1
HND-001602,2011,30100170,,,,5,3,8
HND-001606,2011,30100178,,,,5,2,7
HND-001607,2011,30100182,,,,3,3,6
,2011,30100183,,,,1,1,2
HND-001613,2011,30100192,,,,0,2,2
HND-001615,2011,30100195,,,,4,3,7
,2011,30100204,,,,17,25,42
HND-001619,2011,30100212,,,,1,2,3
,2011,30100219,,,,1,2,3
HND-001621,2011,30100220,,,,10,8,18
HND-001623,2011,30100222,,,,3,0,3
,2011,30100224,,,,5,5,10
HND-001635,2011,30100264,,,,5,4,9
HND-001637,2011,30100275,,,,3,6,9
,2011,30100296,,,,9,7,16
,2011,30100297,,,,10,14,24
,2011,30100339,,,,9,2,11
HND-001663,2011,30100340,,,,3,2,5
,2011,30100366,,,,0,2,2
HND-001682,2011,30100375,,,,1,5,6
HND-001459,2011,30100004,,,,12,13,25
HND-001460,2011,30100005,,,,3,1,4
HND-001461,2011,30100006,,,,3,3,6
HND-001462,2011,30100007,,,,12,9,21
HND-001469,2011,30100014,,,,4,1,5
HND-001470,2011,30100015,,,,8,9,17
HND-001471,2011,30100016,,,,57,44,101
HND-001473,2011,30100018,,,,92,74,166
HND-001474,2011,30100019,,,,56,23,79
HND-001476,2011,30100021,,,,23,7,30
HND-001479,2011,30100024,,,,3,3,6
HND-001480,2011,30100025,,,,1,5,6
HND-001481,2011,30100026,,,,20,28,48
HND-001482,2011,30100027,,,,1,4,5
HND-001485,2011,30100030,,,,14,16,30
HND-001486,2011,30100031,,,,5,2,7
HND-001487,2011,30100032,,,,5,3,8
HND-001488,2011,30100033,,,,8,6,14
HND-001491,2011,30100037,,,,61,51,112
HND-001492,2011,30100038,,,,7,15,22
HND-001493,2011,30100039,,,,44,50,94
HND-001495,2011,30100041,,,,6,10,16
HND-001499,2011,30100045,,,,13,4,17
HND-001500,2011,30100046,,,,3,7,10
HND-001502,2011,30100048,,,,3,0,3
HND-001504,2011,30100050,,,,1,1,2
HND-001507,2011,30100053,,,,3,1,4
HND-001508,2011,30100054,,,,3,6,9
HND-001509,2011,30100055,,,,35,37,72
,2011,30100057,,,,33,33,66
HND-001512,2011,30100059,,,,5,6,11
HND-001514,2011,30100061,,,,1,3,4
HND-001518,2011,30100065,,,,4,3,7
HND-001519,2011,30100066,,,,24,14,38
HND-001520,2011,30100067,,,,12,8,20
HND-001521,2011,30100068,,,,6,7,13
,2011,30100069,,,,4,14,18
HND-001523,2011,30100071,,,,8,4,12
HND-001524,2011,30100072,,,,4,5,9
HND-001531,2011,30100079,,,,5,9,14
HND-001532,2011,30100080,,,,6,9,15
HND-001533,2011,30100081,,,,2,7,9
HND-001534,2011,30100082,,,,11,10,21
,2011,30100088,,,,3,2,5
HND-001539,2011,30100089,,,,5,3,8
HND-001540,2011,30100091,,,,2,3,5
HND-001543,2011,30100095,,,,6,3,9
HND-001544,2011,30100096,,,,13,15,28
HND-001546,2011,30100098,,,,7,11,18
HND-001563,2011,30100118,,,,27,20,47
HND-001564,2011,30100119,,,,1,0,1
HND-001571,2011,30100127,,,,0,1,1
,2011,30100135,,,,5,11,16
HND-001576,2011,30100136,,,,2,3,5
HND-001577,2011,30100137,,,,1,2,3
HND-001583,2011,30100144,,,,1,0,1
HND-001592,2011,30100159,,,,17,15,32
HND-001593,2011,30100160,,,,20,18,38
HND-001599,2011,30100166,,,,2,5,7
HND-001603,2011,30100171,,,,0,2,2
HND-001612,2011,30100191,,,,2,4,6
HND-001614,2011,30100194,,,,7,10,17
HND-001620,2011,30100213,,,,1,6,7
,2011,30100216,,,,32,11,43
HND-001622,2011,30100221,,,,34,27,61
HND-001624,2011,30100225,,,,1,1,2
HND-001632,2011,30100260,,,,3,1,4
HND-001633,2011,30100261,,,,3,1,4
HND-001634,2011,30100262,,,,1,1,2
HND-001636,2011,30100269,,,,3,7,10
HND-001641,2011,30100299,,,,7,9,16
,2011,30100302,,,,5,3,8
HND-001642,2011,30100303,,,,2,4,6
HND-001643,2011,30100304,,,,8,1,9
,2011,30100306,,,,11,11,22
HND-001651,2011,30100317,,,,2,2,4
HND-001680,2011,30100373,,,,6,2,8
,2011,30100003,,,,0,1,1
HND-001460,2011,30100005,,,,4,4,8
HND-001461,2011,30100006,,,,1,3,4
HND-001463,2011,30100008,,,,10,6,16
HND-001465,2011,30100010,,,,15,5,20
HND-001466,2011,30100011,,,,12,19,31
HND-001468,2011,30100013,,,,6,6,12
HND-001474,2011,30100019,,,,51,33,84
HND-001475,2011,30100020,,,,12,12,24
HND-001478,2011,30100023,,,,4,5,9
HND-001480,2011,30100025,,,,5,3,8
HND-001481,2011,30100026,,,,14,24,38
HND-001483,2011,30100028,,,,0,2,2
HND-001487,2011,30100032,,,,1,2,3
HND-001489,2011,30100034,,,,28,26,54
HND-001491,2011,30100037,,,,61,51,112
HND-001494,2011,30100040,,,,3,0,3
HND-001496,2011,30100042,,,,15,17,32
HND-001497,2011,30100043,,,,3,1,4
HND-001498,2011,30100044,,,,5,5,10
HND-001501,2011,30100047,,,,14,13,27
HND-001503,2011,30100049,,,,5,2,7
HND-001506,2011,30100052,,,,41,58,99
HND-001508,2011,30100054,,,,5,7,12
HND-001510,2011,30100056,,,,12,9,21
HND-001511,2011,30100058,,,,73,52,125
HND-001513,2011,30100060,,,,7,4,11
HND-001515,2011,30100062,,,,5,11,16
HND-001516,2011,30100063,,,,6,5,11
HND-001517,2011,30100064,,,,10,9,19
HND-001522,2011,30100070,,,,47,49,96
HND-001525,2011,30100073,,,,16,15,31
HND-001526,2011,30100074,,,,2,5,7
HND-001528,2011,30100076,,,,3,9,12
HND-001529,2011,30100077,,,,2,4,6
HND-001530,2011,30100078,,,,15,6,21
HND-001536,2011,30100084,,,,4,5,9
HND-001537,2011,30100085,,,,3,4,7
HND-001538,2011,30100086,,,,7,2,9
HND-001541,2011,30100092,,,,2,4,6
,2011,30100093,,,,11,15,26
HND-001542,2011,30100094,,,,11,4,15
HND-001545,2011,30100097,,,,18,23,41
,2011,30100112,,,,15,16,31
,2011,30100116,,,,24,22,46
HND-001569,2011,30100124,,,,36,32,68
HND-001580,2011,30100141,,,,4,4,8
HND-001587,2011,30100150,,,,2,1,3
HND-001588,2011,30100151,,,,2,3,5
HND-001591,2011,30100156,,,,2,0,2
,2011,30100158,,,,19,20,39
HND-001593,2011,30100160,,,,20,17,37
HND-001594,2011,30100161,,,,0,129,129
HND-001600,2011,30100168,,,,1,0,1
HND-001602,2011,30100170,,,,0,4,4
HND-001606,2011,30100178,,,,3,2,5
HND-001612,2011,30100191,,,,4,6,10
HND-001613,2011,30100192,,,,4,2,6
HND-001615,2011,30100195,,,,2,3,5
,2011,30100204,,,,14,17,31
,2011,30100219,,,,1,4,5
HND-001621,2011,30100220,,,,11,8,19
HND-001623,2011,30100222,,,,1,4,5
,2011,30100224,,,,7,5,12
HND-001634,2011,30100262,,,,1,2,3
HND-001635,2011,30100264,,,,6,4,10
HND-001637,2011,30100275,,,,2,2,4
,2011,30100297,,,,17,22,39
HND-001641,2011,30100299,,,,3,12,15
,2011,30100302,,,,7,1,8
HND-001642,2011,30100303,,,,4,3,7
HND-001643,2011,30100304,,,,1,1,2
,2011,30100306,,,,11,9,20
HND-001651,2011,30100317,,,,3,0,3
,2011,30100339,,,,3,5,8
HND-001680,2011,30100373,,,,2,5,7
HND-001458,2011,30100002,,,,10,11,21
HND-001459,2011,30100004,,,,9,7,16
HND-001462,2011,30100007,,,,8,6,14
HND-001464,2011,30100009,,,,6,11,17
HND-001467,2011,30100012,,,,13,17,30
HND-001469,2011,30100014,,,,0,1,1
HND-001470,2011,30100015,,,,3,3,6
HND-001471,2011,30100016,,,,54,47,101
HND-001472,2011,30100017,,,,74,57,131
HND-001473,2011,30100018,,,,83,81,164
HND-001476,2011,30100021,,,,28,13,41
HND-001477,2011,30100022,,,,4,5,9
HND-001479,2011,30100024,,,,5,2,7
HND-001482,2011,30100027,,,,5,7,12
HND-001484,2011,30100029,,,,5,4,9
HND-001485,2011,30100030,,,,22,21,43
HND-001486,2011,30100031,,,,1,6,7
HND-001488,2011,30100033,,,,8,12,20
HND-001490,2011,30100036,,,,2,11,13
HND-001492,2011,30100038,,,,10,12,22
HND-001493,2011,30100039,,,,43,41,84
HND-001495,2011,30100041,,,,4,14,18
HND-001499,2011,30100045,,,,5,9,14
HND-001500,2011,30100046,,,,8,6,14
HND-001504,2011,30100050,,,,1,3,4
HND-001505,2011,30100051,,,,4,6,10
HND-001507,2011,30100053,,,,4,4,8
HND-001509,2011,30100055,,,,55,56,111
,2011,30100057,,,,28,22,50
HND-001512,2011,30100059,,,,2,7,9
HND-001514,2011,30100061,,,,4,6,10
HND-001518,2011,30100065,,,,5,3,8
HND-001519,2011,30100066,,,,14,14,28
HND-001520,2011,30100067,,,,12,8,20
HND-001521,2011,30100068,,,,5,5,10
,2011,30100069,,,,4,4,8
HND-001523,2011,30100071,,,,2,7,9
HND-001524,2011,30100072,,,,4,6,10
HND-001531,2011,30100079,,,,12,5,17
HND-001532,2011,30100080,,,,3,6,9
HND-001533,2011,30100081,,,,2,1,3
HND-001534,2011,30100082,,,,14,5,19
HND-001535,2011,30100083,,,,15,18,33
,2011,30100088,,,,3,1,4
HND-001539,2011,30100089,,,,1,5,6
HND-001540,2011,30100091,,,,0,4,4
HND-001543,2011,30100095,,,,7,4,11
HND-001544,2011,30100096,,,,6,6,12
HND-001546,2011,30100098,,,,10,6,16
HND-001562,2011,30100117,,,,5,4,9
HND-001563,2011,30100118,,,,14,15,29
HND-001564,2011,30100119,,,,3,1,4
HND-001571,2011,30100127,,,,0,1,1
,2011,30100135,,,,6,8,14
HND-001576,2011,30100136,,,,1,6,7
HND-001577,2011,30100137,,,,1,3,4
HND-001592,2011,30100159,,,,10,10,20
HND-001599,2011,30100166,,,,2,2,4
HND-001603,2011,30100171,,,,2,2,4
HND-001607,2011,30100182,,,,1,7,8
,2011,30100183,,,,6,2,8
HND-001614,2011,30100194,,,,3,0,3
HND-001620,2011,30100213,,,,1,1,2
,2011,30100216,,,,23,22,45
HND-001622,2011,30100221,,,,36,37,73
HND-001624,2011,30100225,,,,2,3,5
HND-001632,2011,30100260,,,,3,3,6
HND-001633,2011,30100261,,,,2,0,2
HND-001636,2011,30100269,,,,1,3,4
,2011,30100296,,,,2,4,6
HND-001644,2011,30100305,,,,1,2,3
HND-001674,2011,30100357,,,,2,1,3
HND-001459,2011,30100004,,,,8,3,11
HND-001460,2011,30100005,,,,4,1,5
HND-001461,2011,30100006,,,,2,0,2
HND-001462,2011,30100007,,,,4,2,6
HND-001470,2011,30100015,,,,1,5,6
HND-001473,2011,30100018,,,,100,85,185
HND-001474,2011,30100019,,,,57,40,97
HND-001476,2011,30100021,,,,15,17,32
HND-001479,2011,30100024,,,,2,3,5
HND-001480,2011,30100025,,,,8,4,12
HND-001481,2011,30100026,,,,17,21,38
HND-001482,2011,30100027,,,,2,2,4
HND-001485,2011,30100030,,,,18,24,42
HND-001486,2011,30100031,,,,7,3,10
HND-001487,2011,30100032,,,,8,11,19
HND-001488,2011,30100033,,,,11,6,17
HND-001491,2011,30100037,,,,63,49,112
HND-001492,2011,30100038,,,,12,16,28
HND-001495,2011,30100041,,,,9,13,22
HND-001497,2011,30100043,,,,1,2,3
HND-001499,2011,30100045,,,,7,7,14
HND-001500,2011,30100046,,,,8,12,20
HND-001502,2011,30100048,,,,2,1,3
HND-001507,2011,30100053,,,,3,2,5
HND-001508,2011,30100054,,,,2,6,8
HND-001509,2011,30100055,,,,42,44,86
,2011,30100057,,,,39,32,71
HND-001511,2011,30100058,,,,56,59,115
HND-001512,2011,30100059,,,,3,4,7
HND-001513,2011,30100060,,,,6,5,11
HND-001514,2011,30100061,,,,7,1,8
HND-001516,2011,30100063,,,,1,1,2
HND-001518,2011,30100065,,,,2,2,4
HND-001519,2011,30100066,,,,16,10,26
HND-001521,2011,30100068,,,,0,4,4
,2011,30100069,,,,8,6,14
HND-001524,2011,30100072,,,,3,4,7
HND-001526,2011,30100074,,,,1,2,3
HND-001531,2011,30100079,,,,6,8,14
HND-001532,2011,30100080,,,,4,7,11
HND-001536,2011,30100084,,,,5,2,7
HND-001539,2011,30100089,,,,4,2,6
HND-001540,2011,30100091,,,,0,4,4
,2011,30100093,,,,10,14,24
HND-001543,2011,30100095,,,,1,4,5
HND-001544,2011,30100096,,,,7,7,14
HND-001546,2011,30100098,,,,7,7,14
HND-001563,2011,30100118,,,,13,21,34
HND-001569,2011,30100124,,,,25,20,45
HND-001571,2011,30100127,,,,4,0,4
,2011,30100135,,,,7,5,12
HND-001576,2011,30100136,,,,2,1,3
HND-001577,2011,30100137,,,,2,1,3
HND-001580,2011,30100141,,,,2,2,4
HND-001588,2011,30100151,,,,3,2,5
HND-001592,2011,30100159,,,,15,7,22
HND-001593,2011,30100160,,,,16,14,30
HND-001599,2011,30100166,,,,5,0,5
HND-001600,2011,30100168,,,,0,2,2
HND-001602,2011,30100170,,,,1,3,4
HND-001603,2011,30100171,,,,1,2,3
HND-001612,2011,30100191,,,,3,8,11
HND-001614,2011,30100194,,,,7,3,10
HND-001615,2011,30100195,,,,4,2,6
,2011,30100204,,,,11,9,20
,2011,30100216,,,,23,25,48
HND-001622,2011,30100221,,,,37,30,67
HND-001623,2011,30100222,,,,4,4,8
HND-001635,2011,30100264,,,,2,3,5
HND-001637,2011,30100275,,,,4,2,6
HND-001641,2011,30100299,,,,2,2,4
,2011,30100366,,,,1,2,3
HND-001680,2011,30100373,,,,3,5,8
HND-001458,2011,30100002,,,,8,13,21
,2011,30100003,,,,1,0,1
HND-001463,2011,30100008,,,,6,10,16
HND-001464,2011,30100009,,,,7,9,16
HND-001465,2011,30100010,,,,7,9,16
HND-001466,2011,30100011,,,,11,13,24
HND-001467,2011,30100012,,,,10,11,21
HND-001468,2011,30100013,,,,5,3,8
HND-001469,2011,30100014,,,,3,0,3
HND-001471,2011,30100016,,,,43,54,97
HND-001472,2011,30100017,,,,83,54,137
HND-001475,2011,30100020,,,,8,5,13
HND-001477,2011,30100022,,,,6,6,12
HND-001478,2011,30100023,,,,3,2,5
HND-001483,2011,30100028,,,,0,2,2
HND-001484,2011,30100029,,,,1,5,6
HND-001489,2011,30100034,,,,22,17,39
HND-001490,2011,30100036,,,,5,4,9
HND-001493,2011,30100039,,,,55,33,88
HND-001496,2011,30100042,,,,12,9,21
HND-001498,2011,30100044,,,,6,8,14
HND-001501,2011,30100047,,,,14,8,22
HND-001503,2011,30100049,,,,5,6,11
HND-001504,2011,30100050,,,,5,8,13
HND-001505,2011,30100051,,,,4,2,6
HND-001506,2011,30100052,,,,45,46,91
HND-001510,2011,30100056,,,,10,3,13
HND-001515,2011,30100062,,,,0,2,2
HND-001517,2011,30100064,,,,8,10,18
HND-001520,2011,30100067,,,,7,9,16
HND-001522,2011,30100070,,,,32,38,70
HND-001523,2011,30100071,,,,3,4,7
HND-001525,2011,30100073,,,,18,24,42
HND-001528,2011,30100076,,,,2,5,7
HND-001529,2011,30100077,,,,2,3,5
HND-001530,2011,30100078,,,,12,12,24
HND-001533,2011,30100081,,,,1,4,5
HND-001534,2011,30100082,,,,9,4,13
HND-001535,2011,30100083,,,,20,16,36
HND-001537,2011,30100085,,,,2,4,6
HND-001538,2011,30100086,,,,4,3,7
,2011,30100088,,,,0,4,4
HND-001541,2011,30100092,,,,4,4,8
HND-001542,2011,30100094,,,,8,5,13
HND-001545,2011,30100097,,,,17,8,25
,2011,30100112,,,,16,23,39
,2011,30100116,,,,22,20,42
HND-001562,2011,30100117,,,,3,3,6
HND-001564,2011,30100119,,,,1,0,1
HND-001587,2011,30100150,,,,4,2,6
HND-001591,2011,30100156,,,,2,1,3
,2011,30100158,,,,19,15,34
HND-001594,2011,30100161,,,,0,127,127
HND-001606,2011,30100178,,,,1,1,2
HND-001607,2011,30100182,,,,3,5,8
,2011,30100183,,,,0,1,1
HND-001613,2011,30100192,,,,2,4,6
HND-001619,2011,30100212,,,,2,1,3
HND-001620,2011,30100213,,,,2,4,6
,2011,30100219,,,,0,1,1
HND-001621,2011,30100220,,,,6,7,13
HND-001624,2011,30100225,,,,2,1,3
HND-001632,2011,30100260,,,,1,1,2
HND-001633,2011,30100261,,,,1,3,4
HND-001634,2011,30100262,,,,2,0,2
HND-001636,2011,30100269,,,,1,2,3
,2011,30100296,,,,0,4,4
,2011,30100297,,,,15,12,27
,2011,30100302,,,,5,2,7
HND-001642,2011,30100303,,,,2,0,2
HND-001643,2011,30100304,,,,2,0,2
HND-001644,2011,30100305,,,,1,1,2
,2011,30100306,,,,5,6,11
HND-001651,2011,30100317,,,,3,4,7
HND-001682,2011,30100375,,,,1,1,2
HND-001480,2011,30100025,,,,7,7,14
HND-001481,2011,30100026,,,,21,14,35
HND-001489,2011,30100034,,,,11,18,29
HND-001501,2011,30100047,,,,11,23,34
HND-001506,2011,30100052,,,,18,34,52
,2011,30100116,,,,13,18,31
,2011,30100129,,,,61,77,138
HND-001573,2011,30100130,,,,378,363,741
HND-001617,2011,30100201,,,,233,66,299
,2011,30100250,,,,36,44,80
,2011,30100302,,,,5,8,13
HND-001459,2011,30100004,,,,9,10,19
HND-001471,2011,30100016,,,,44,58,102
HND-001485,2011,30100030,,,,25,18,43
,2011,30100057,,,,29,35,64
HND-001519,2011,30100066,,,,20,27,47
,2011,30100069,,,,17,7,24
HND-001574,2011,30100132,,,,20,23,43
,2011,30100158,,,,7,18,25
,2011,30100175,,,,75,93,168
,2011,30100179,,,,42,42,84
,2011,30100203,,,,14,19,33
,2011,30100204,,,,11,11,22
,2011,30100218,,,,57,69,126
,2011,30100219,,,,50,76,126
,2011,30100229,,,,5,7,12
,2011,30100280,,,,11,8,19
HND-001639,2011,30100289,,,,165,225,390
,2011,30100297,,,,19,24,43
HND-001471,2011,30100016,,,,21,29,50
HND-001489,2011,30100034,,,,10,9,19
HND-001501,2011,30100047,,,,5,10,15
HND-001506,2011,30100052,,,,19,23,42
,2011,30100069,,,,11,8,19
,2011,30100116,,,,19,13,32
HND-001574,2011,30100132,,,,16,24,40
,2011,30100158,,,,8,14,22
,2011,30100179,,,,41,49,90
,2011,30100203,,,,16,12,28
,2011,30100204,,,,6,4,10
,2011,30100219,,,,34,44,78
,2011,30100229,,,,5,9,14
,2011,30100280,,,,3,8,11
HND-001639,2011,30100289,,,,113,135,248
,2011,30100297,,,,14,20,34
HND-001459,2011,30100004,,,,5,7,12
HND-001480,2011,30100025,,,,7,5,12
HND-001481,2011,30100026,,,,14,5,19
HND-001485,2011,30100030,,,,7,12,19
,2011,30100057,,,,17,33,50
HND-001519,2011,30100066,,,,18,28,46
,2011,30100129,,,,56,67,123
HND-001573,2011,30100130,,,,208,303,511
,2011,30100175,,,,74,97,171
HND-001617,2011,30100201,,,,112,41,153
,2011,30100218,,,,41,63,104
,2011,30100250,,,,36,49,85
,2011,30100302,,,,1,1,2
HND-001471,2011,30100016,,,,13,28,41
HND-001489,2011,30100034,,,,5,5,10
HND-001501,2011,30100047,,,,4,8,12
HND-001506,2011,30100052,,,,8,32,40
,2011,30100069,,,,11,8,19
HND-001573,2011,30100130,,,,178,234,412
,2011,30100158,,,,10,12,22
,2011,30100179,,,,25,35,60
,2011,30100203,,,,12,14,26
,2011,30100218,,,,46,71,117
,2011,30100219,,,,39,40,79
,2011,30100229,,,,5,5,10
,2011,30100250,,,,34,73,107
,2011,30100280,,,,9,6,15
,2011,30100297,,,,18,13,31
HND-001459,2011,30100004,,,,10,9,19
HND-001480,2011,30100025,,,,11,11,22
HND-001481,2011,30100026,,,,2,10,12
HND-001485,2011,30100030,,,,4,10,14
,2011,30100057,,,,10,31,41
HND-001519,2011,30100066,,,,10,20,30
,2011,30100116,,,,5,17,22
,2011,30100129,,,,76,66,142
HND-001574,2011,30100132,,,,13,24,37
,2011,30100175,,,,55,104,159
HND-001617,2011,30100201,,,,92,23,115
,2011,30100204,,,,6,7,13
HND-001639,2011,30100289,,,,66,79,145
,2011,30100302,,,,3,4,7
,2011,30100057,,,,16,17,33
,2011,30100116,,,,12,18,30
,2011,30100175,,,,66,101,167
,2011,30100204,,,,3,7,10
,2011,30100219,,,,82,154,236
HND-001630,2011,30100244,,,,19,0,19
,2011,30100069,,,,9,7,16
,2011,30100129,,,,120,107,227
HND-001573,2011,30100130,,,,322,386,708
,2011,30100158,,,,11,11,22
HND-001605,2011,30100176,,,,168,369,537
,2011,30100179,,,,25,31,56
HND-001617,2011,30100201,,,,77,26,103
,2011,30100218,,,,124,201,325
,2011,30100229,,,,8,21,29
,2011,30100250,,,,37,81,118
,2011,30100280,,,,10,3,13
HND-001639,2011,30100289,,,,120,191,311
,2011,30100297,,,,5,12,17
,2011,30100302,,,,5,9,14
,2011,30100057,,,,2,7,9
,2011,30100116,,,,7,6,13
HND-001574,2011,30100132,,,,4,9,13
,2011,30100175,,,,48,85,133
HND-001605,2011,30100176,,,,147,327,474
,2011,30100219,,,,31,58,89
HND-001630,2011,30100244,,,,16,0,16
,2011,30100250,,,,25,67,92
,2011,30100280,,,,10,5,15
HND-001639,2011,30100289,,,,50,116,166
,2011,30100297,,,,2,4,6
,2011,30100069,,,,12,11,23
,2011,30100129,,,,80,82,162
HND-001573,2011,30100130,,,,217,212,429
,2011,30100158,,,,9,9,18
,2011,30100179,,,,15,9,24
,2011,30100200,,,,24,26,50
HND-001617,2011,30100201,,,,70,19,89
,2011,30100218,,,,115,222,337
,2011,30100229,,,,5,8,13
,2011,30100129,,,,49,77,126
HND-001573,2011,30100130,,,,132,207,339
,2011,30100179,,,,6,16,22
HND-001617,2011,30100201,,,,54,5,59
,2011,30100218,,,,65,152,217
,2011,30100229,,,,1,11,12
HND-001630,2011,30100244,,,,9,2,11
,2011,30100175,,,,36,76,112
HND-001605,2011,30100176,,,,97,235,332
,2011,30100219,,,,23,48,71
,2011,30100280,,,,3,5,8
HND-001639,2011,30100289,,,,21,76,97
,2011,30100297,,,,0,3,3
,2011,30100218,,,,0,29,29
,2011,30200030,,,,6,6,12
,2011,30200032,,,,4,2,6
HND-001721,2011,30200034,,,,0,10,10
,2011,30200035,,,,3,3,6
,2011,30200038,,,,5,4,9
HND-001712,2011,30200015,,,,5,9,14
,2011,30200028,,,,1,2,3
,2011,30200017,,,,1,0,1
HND-001715,2011,30200020,,,,1,0,1
HND-001717,2011,30200022,,,,0,1,1
HND-001722,2011,30200036,,,,2,3,5
HND-001712,2011,30200015,,,,20,22,42
HND-001713,2011,30200016,,,,14,14,28
,2011,30200017,,,,3,2,5
HND-001714,2011,30200019,,,,9,9,18
HND-001715,2011,30200020,,,,1,2,3
HND-001716,2011,30200021,,,,3,4,7
,2011,30200028,,,,2,1,3
HND-001717,2011,30200022,,,,6,4,10
HND-001722,2011,30200036,,,,6,6,12
,2011,30200037,,,,1,2,3
,2011,30200017,,,,9,8,17
HND-001715,2011,30200020,,,,2,3,5
HND-001717,2011,30200022,,,,7,2,9
,2011,30200037,,,,2,2,4
HND-001712,2011,30200015,,,,24,25,49
HND-001713,2011,30200016,,,,20,18,38
HND-001714,2011,30200019,,,,13,9,22
HND-001716,2011,30200021,,,,9,5,14
,2011,30200028,,,,4,4,8
HND-001722,2011,30200036,,,,11,11,22
HND-001699,2011,30200002,,,,9,11,20
,2011,30200003,,,,5,2,7
HND-001701,2011,30200004,,,,8,11,19
HND-001705,2011,30200008,,,,36,26,62
HND-001711,2011,30200014,,,,1,2,3
HND-001715,2011,30200020,,,,2,5,7
HND-001718,2011,30200023,,,,3,2,5
HND-001720,2011,30200029,,,,3,2,5
HND-001698,2011,30200001,,,,12,9,21
HND-001702,2011,30200005,,,,2,3,5
HND-001703,2011,30200006,,,,16,23,39
HND-001704,2011,30200007,,,,18,6,24
HND-001706,2011,30200009,,,,26,34,60
HND-001707,2011,30200010,,,,1,2,3
HND-001708,2011,30200011,,,,6,2,8
HND-001709,2011,30200012,,,,3,2,5
HND-001710,2011,30200013,,,,3,4,7
,2011,30200027,,,,4,2,6
HND-001701,2011,30200004,,,,3,1,4
HND-001702,2011,30200005,,,,8,3,11
HND-001703,2011,30200006,,,,11,12,23
HND-001704,2011,30200007,,,,10,16,26
HND-001705,2011,30200008,,,,38,35,73
HND-001706,2011,30200009,,,,30,25,55
HND-001708,2011,30200011,,,,10,3,13
HND-001715,2011,30200020,,,,3,3,6
HND-001718,2011,30200023,,,,2,1,3
HND-001720,2011,30200029,,,,2,6,8
HND-001698,2011,30200001,,,,9,9,18
HND-001699,2011,30200002,,,,9,4,13
,2011,30200003,,,,3,0,3
HND-001707,2011,30200010,,,,0,3,3
HND-001709,2011,30200012,,,,2,3,5
HND-001710,2011,30200013,,,,3,3,6
HND-001711,2011,30200014,,,,1,1,2
,2011,30200027,,,,1,2,3
HND-001698,2011,30200001,,,,3,4,7
HND-001702,2011,30200005,,,,3,6,9
HND-001703,2011,30200006,,,,15,6,21
HND-001704,2011,30200007,,,,10,10,20
HND-001706,2011,30200009,,,,37,22,59
HND-001707,2011,30200010,,,,3,2,5
HND-001708,2011,30200011,,,,5,5,10
HND-001710,2011,30200013,,,,5,2,7
,2011,30200027,,,,2,2,4
HND-001699,2011,30200002,,,,8,11,19
,2011,30200003,,,,2,5,7
HND-001701,2011,30200004,,,,6,4,10
HND-001705,2011,30200008,,,,33,32,65
HND-001709,2011,30200012,,,,3,3,6
HND-001711,2011,30200014,,,,2,1,3
HND-001715,2011,30200020,,,,3,4,7
HND-001718,2011,30200023,,,,2,6,8
HND-001720,2011,30200029,,,,2,1,3
HND-001701,2011,30200004,,,,8,5,13
HND-001702,2011,30200005,,,,2,3,5
HND-001703,2011,30200006,,,,13,11,24
HND-001704,2011,30200007,,,,12,13,25
HND-001705,2011,30200008,,,,43,19,62
HND-001711,2011,30200014,,,,0,2,2
HND-001715,2011,30200020,,,,2,2,4
HND-001718,2011,30200023,,,,3,0,3
HND-001720,2011,30200029,,,,6,0,6
HND-001698,2011,30200001,,,,6,2,8
HND-001699,2011,30200002,,,,11,5,16
,2011,30200003,,,,3,4,7
HND-001706,2011,30200009,,,,17,21,38
HND-001707,2011,30200010,,,,2,3,5
HND-001708,2011,30200011,,,,5,4,9
HND-001709,2011,30200012,,,,4,4,8
HND-001710,2011,30200013,,,,2,1,3
HND-001698,2011,30200001,,,,7,6,13
,2011,30200003,,,,1,2,3
HND-001702,2011,30200005,,,,4,2,6
HND-001703,2011,30200006,,,,9,11,20
HND-001706,2011,30200009,,,,17,37,54
HND-001707,2011,30200010,,,,0,3,3
HND-001708,2011,30200011,,,,3,2,5
HND-001709,2011,30200012,,,,4,2,6
HND-001710,2011,30200013,,,,3,3,6
,2011,30200027,,,,4,0,4
HND-001699,2011,30200002,,,,9,5,14
HND-001701,2011,30200004,,,,7,8,15
HND-001704,2011,30200007,,,,10,15,25
HND-001705,2011,30200008,,,,43,37,80
HND-001711,2011,30200014,,,,2,1,3
HND-001715,2011,30200020,,,,2,3,5
HND-001718,2011,30200023,,,,2,3,5
HND-001720,2011,30200029,,,,3,3,6
HND-001701,2011,30200004,,,,4,5,9
HND-001702,2011,30200005,,,,4,4,8
HND-001703,2011,30200006,,,,11,12,23
HND-001704,2011,30200007,,,,12,14,26
HND-001705,2011,30200008,,,,40,48,88
HND-001706,2011,30200009,,,,16,22,38
HND-001708,2011,30200011,,,,3,3,6
HND-001715,2011,30200020,,,,3,2,5
HND-001718,2011,30200023,,,,2,0,2
HND-001720,2011,30200029,,,,0,2,2
HND-001698,2011,30200001,,,,5,4,9
HND-001699,2011,30200002,,,,6,6,12
,2011,30200003,,,,1,7,8
HND-001709,2011,30200012,,,,5,5,10
HND-001710,2011,30200013,,,,2,1,3
HND-001711,2011,30200014,,,,0,1,1
,2011,30200027,,,,1,1,2
,2011,30200018,,,,95,103,198
,2011,30200018,,,,55,61,116
,2011,30200018,,,,54,63,117
,2011,30200018,,,,51,54,105
,2011,30200018,,,,34,30,64
,2011,30200018,,,,23,31,54
HND-001769,2011,30300047,,,,3,2,5
,2011,30300058,,,,4,2,6
,2011,30300060,,,,4,3,7
,2011,30300068,,,,6,6,12
,2011,30300069,,,,7,7,14
HND-001778,2011,30300071,,,,9,5,14
,2011,30300075,,,,2,5,7
,2011,30300077,,,,3,7,10
HND-001782,2011,30300078,,,,11,6,17
HND-001785,2011,30300081,,,,6,8,14
,2011,30300085,,,,10,13,23
HND-001788,2011,30300088,,,,2,4,6
,2011,30300070,,,,3,4,7
HND-001779,2011,30300072,,,,10,9,19
HND-001780,2011,30300073,,,,8,5,13
HND-001781,2011,30300074,,,,9,6,15
HND-001783,2011,30300079,,,,8,3,11
HND-001784,2011,30300080,,,,8,3,11
,2011,30300083,,,,5,5,10
HND-001786,2011,30300084,,,,7,2,9
HND-001787,2011,30300086,,,,6,7,13
,2011,30300087,,,,6,9,15
,2011,30300089,,,,7,3,10
HND-001789,2011,30300090,,,,5,4,9
,2011,30300091,,,,7,9,16
HND-001790,2011,30300092,,,,6,4,10
HND-001760,2011,30300038,,,,23,12,35
HND-001777,2011,30300067,,,,2,2,4
HND-001729,2011,30300006,,,,19,15,34
HND-001744,2011,30300021,,,,24,24,48
HND-001750,2011,30300027,,,,6,7,13
HND-001759,2011,30300037,,,,18,23,41
HND-001760,2011,30300038,,,,18,12,30
HND-001767,2011,30300045,,,,2,12,14
HND-001777,2011,30300067,,,,13,5,18
HND-001724,2011,30300001,,,,22,19,41
HND-001765,2011,30300043,,,,6,17,23
HND-001766,2011,30300044,,,,8,18,26
HND-001725,2011,30300002,,,,14,7,21
HND-001726,2011,30300003,,,,0,2,2
HND-001727,2011,30300004,,,,38,37,75
HND-001732,2011,30300009,,,,50,34,84
HND-001733,2011,30300010,,,,7,5,12
HND-001734,2011,30300011,,,,3,7,10
HND-001735,2011,30300012,,,,17,10,27
HND-001736,2011,30300013,,,,14,5,19
HND-001741,2011,30300018,,,,4,5,9
HND-001742,2011,30300019,,,,8,4,12
HND-001747,2011,30300024,,,,11,6,17
HND-001748,2011,30300025,,,,9,8,17
HND-001749,2011,30300026,,,,6,8,14
HND-001750,2011,30300027,,,,8,15,23
HND-001752,2011,30300030,,,,7,7,14
HND-001754,2011,30300032,,,,4,2,6
HND-001755,2011,30300033,,,,12,7,19
HND-001756,2011,30300034,,,,4,4,8
HND-001761,2011,30300039,,,,25,32,57
HND-001768,2011,30300046,,,,8,9,17
HND-001771,2011,30300050,,,,1,1,2
HND-001774,2011,30300053,,,,3,6,9
HND-001775,2011,30300056,,,,2,3,5
HND-001724,2011,30300001,,,,19,26,45
HND-001728,2011,30300005,,,,8,19,27
HND-001730,2011,30300007,,,,9,7,16
HND-001731,2011,30300008,,,,15,16,31
HND-001737,2011,30300014,,,,4,2,6
HND-001738,2011,30300015,,,,5,5,10
HND-001739,2011,30300016,,,,21,21,42
HND-001740,2011,30300017,,,,4,3,7
HND-001743,2011,30300020,,,,4,6,10
HND-001744,2011,30300021,,,,38,34,72
HND-001745,2011,30300022,,,,3,3,6
HND-001746,2011,30300023,,,,12,18,30
HND-001751,2011,30300029,,,,3,5,8
HND-001753,2011,30300031,,,,9,11,20
HND-001757,2011,30300035,,,,4,3,7
HND-001758,2011,30300036,,,,11,3,14
HND-001763,2011,30300041,,,,4,0,4
HND-001764,2011,30300042,,,,14,15,29
HND-001765,2011,30300043,,,,9,9,18
HND-001770,2011,30300048,,,,2,3,5
HND-001772,2011,30300051,,,,7,11,18
HND-001773,2011,30300052,,,,41,40,81
HND-001727,2011,30300004,,,,22,14,36
HND-001728,2011,30300005,,,,15,15,30
HND-001730,2011,30300007,,,,4,4,8
HND-001735,2011,30300012,,,,11,10,21
HND-001736,2011,30300013,,,,9,3,12
HND-001737,2011,30300014,,,,7,7,14
HND-001742,2011,30300019,,,,3,3,6
HND-001744,2011,30300021,,,,21,22,43
HND-001748,2011,30300025,,,,8,1,9
HND-001749,2011,30300026,,,,1,5,6
HND-001750,2011,30300027,,,,17,19,36
HND-001756,2011,30300034,,,,5,2,7
HND-001757,2011,30300035,,,,2,4,6
HND-001758,2011,30300036,,,,2,2,4
HND-001763,2011,30300041,,,,3,1,4
HND-001768,2011,30300046,,,,7,10,17
HND-001770,2011,30300048,,,,4,2,6
HND-001724,2011,30300001,,,,23,24,47
HND-001725,2011,30300002,,,,4,7,11
HND-001726,2011,30300003,,,,1,1,2
HND-001731,2011,30300008,,,,12,13,25
HND-001732,2011,30300009,,,,30,41,71
HND-001733,2011,30300010,,,,7,3,10
HND-001734,2011,30300011,,,,5,7,12
HND-001738,2011,30300015,,,,6,5,11
HND-001739,2011,30300016,,,,3,8,11
HND-001740,2011,30300017,,,,2,1,3
HND-001741,2011,30300018,,,,2,4,6
HND-001743,2011,30300020,,,,10,14,24
HND-001745,2011,30300022,,,,3,4,7
HND-001746,2011,30300023,,,,8,8,16
HND-001747,2011,30300024,,,,5,8,13
HND-001751,2011,30300029,,,,5,5,10
HND-001752,2011,30300030,,,,6,15,21
HND-001753,2011,30300031,,,,5,18,23
HND-001754,2011,30300032,,,,3,2,5
HND-001755,2011,30300033,,,,1,5,6
HND-001761,2011,30300039,,,,25,25,50
HND-001764,2011,30300042,,,,6,2,8
HND-001765,2011,30300043,,,,3,7,10
HND-001771,2011,30300050,,,,8,4,12
HND-001772,2011,30300051,,,,4,7,11
HND-001773,2011,30300052,,,,37,37,74
HND-001774,2011,30300053,,,,9,6,15
HND-001775,2011,30300056,,,,0,2,2
HND-001724,2011,30300001,,,,27,22,49
HND-001728,2011,30300005,,,,17,13,30
HND-001730,2011,30300007,,,,5,10,15
HND-001731,2011,30300008,,,,20,11,31
HND-001737,2011,30300014,,,,0,5,5
HND-001738,2011,30300015,,,,8,5,13
HND-001739,2011,30300016,,,,3,7,10
HND-001740,2011,30300017,,,,1,1,2
HND-001743,2011,30300020,,,,10,8,18
HND-001744,2011,30300021,,,,12,23,35
HND-001745,2011,30300022,,,,1,4,5
HND-001746,2011,30300023,,,,10,11,21
HND-001751,2011,30300029,,,,5,3,8
HND-001753,2011,30300031,,,,9,12,21
HND-001758,2011,30300036,,,,3,3,6
HND-001763,2011,30300041,,,,3,2,5
HND-001764,2011,30300042,,,,2,9,11
HND-001765,2011,30300043,,,,7,8,15
HND-001770,2011,30300048,,,,1,2,3
HND-001772,2011,30300051,,,,10,4,14
HND-001773,2011,30300052,,,,55,37,92
HND-001725,2011,30300002,,,,5,12,17
HND-001726,2011,30300003,,,,2,2,4
HND-001727,2011,30300004,,,,27,37,64
HND-001732,2011,30300009,,,,24,29,53
HND-001733,2011,30300010,,,,7,5,12
HND-001734,2011,30300011,,,,1,4,5
HND-001735,2011,30300012,,,,11,13,24
HND-001736,2011,30300013,,,,4,11,15
HND-001741,2011,30300018,,,,2,7,9
HND-001742,2011,30300019,,,,2,1,3
HND-001747,2011,30300024,,,,12,10,22
HND-001748,2011,30300025,,,,5,6,11
HND-001749,2011,30300026,,,,1,1,2
HND-001750,2011,30300027,,,,17,13,30
HND-001752,2011,30300030,,,,2,9,11
HND-001754,2011,30300032,,,,2,4,6
HND-001755,2011,30300033,,,,3,4,7
HND-001756,2011,30300034,,,,2,3,5
HND-001761,2011,30300039,,,,25,26,51
HND-001768,2011,30300046,,,,10,11,21
HND-001771,2011,30300050,,,,1,5,6
HND-001774,2011,30300053,,,,3,5,8
HND-001775,2011,30300056,,,,1,1,2
HND-001725,2011,30300002,,,,3,9,12
HND-001727,2011,30300004,,,,5,12,17
HND-001730,2011,30300007,,,,3,1,4
HND-001732,2011,30300009,,,,28,41,69
HND-001733,2011,30300010,,,,2,1,3
HND-001735,2011,30300012,,,,7,10,17
HND-001736,2011,30300013,,,,6,16,22
HND-001737,2011,30300014,,,,2,4,6
HND-001742,2011,30300019,,,,2,2,4
HND-001744,2011,30300021,,,,9,8,17
HND-001748,2011,30300025,,,,3,5,8
HND-001749,2011,30300026,,,,0,3,3
HND-001750,2011,30300027,,,,8,10,18
HND-001756,2011,30300034,,,,2,1,3
HND-001757,2011,30300035,,,,4,1,5
HND-001758,2011,30300036,,,,6,5,11
HND-001763,2011,30300041,,,,0,4,4
HND-001768,2011,30300046,,,,7,2,9
HND-001770,2011,30300048,,,,3,0,3
HND-001775,2011,30300056,,,,1,2,3
HND-001724,2011,30300001,,,,16,15,31
HND-001726,2011,30300003,,,,3,1,4
HND-001728,2011,30300005,,,,10,20,30
HND-001731,2011,30300008,,,,10,11,21
HND-001734,2011,30300011,,,,9,5,14
HND-001738,2011,30300015,,,,5,6,11
HND-001739,2011,30300016,,,,0,3,3
HND-001740,2011,30300017,,,,2,0,2
HND-001741,2011,30300018,,,,2,4,6
HND-001743,2011,30300020,,,,3,11,14
HND-001745,2011,30300022,,,,4,1,5
HND-001746,2011,30300023,,,,12,11,23
HND-001747,2011,30300024,,,,11,8,19
HND-001751,2011,30300029,,,,7,2,9
HND-001752,2011,30300030,,,,9,3,12
HND-001753,2011,30300031,,,,9,8,17
HND-001755,2011,30300033,,,,3,2,5
HND-001761,2011,30300039,,,,29,16,45
HND-001764,2011,30300042,,,,2,6,8
HND-001765,2011,30300043,,,,10,8,18
HND-001771,2011,30300050,,,,3,0,3
HND-001772,2011,30300051,,,,4,9,13
HND-001773,2011,30300052,,,,25,27,52
HND-001774,2011,30300053,,,,5,2,7
HND-001724,2011,30300001,,,,15,22,37
HND-001728,2011,30300005,,,,10,17,27
HND-001730,2011,30300007,,,,2,2,4
HND-001731,2011,30300008,,,,18,13,31
HND-001737,2011,30300014,,,,3,7,10
HND-001738,2011,30300015,,,,6,9,15
HND-001739,2011,30300016,,,,1,5,6
HND-001740,2011,30300017,,,,2,2,4
HND-001743,2011,30300020,,,,8,14,22
HND-001744,2011,30300021,,,,9,19,28
HND-001745,2011,30300022,,,,3,3,6
HND-001746,2011,30300023,,,,4,13,17
HND-001751,2011,30300029,,,,3,4,7
HND-001754,2011,30300032,,,,0,4,4
HND-001755,2011,30300033,,,,3,1,4
HND-001756,2011,30300034,,,,3,2,5
HND-001761,2011,30300039,,,,30,17,47
HND-001768,2011,30300046,,,,15,9,24
HND-001771,2011,30300050,,,,0,3,3
HND-001774,2011,30300053,,,,1,3,4
HND-001775,2011,30300056,,,,0,4,4
HND-001725,2011,30300002,,,,2,8,10
HND-001726,2011,30300003,,,,5,2,7
HND-001727,2011,30300004,,,,6,14,20
HND-001732,2011,30300009,,,,29,20,49
HND-001733,2011,30300010,,,,7,3,10
HND-001734,2011,30300011,,,,8,5,13
HND-001735,2011,30300012,,,,8,6,14
HND-001736,2011,30300013,,,,5,4,9
HND-001741,2011,30300018,,,,2,2,4
HND-001742,2011,30300019,,,,1,1,2
HND-001747,2011,30300024,,,,8,6,14
HND-001748,2011,30300025,,,,1,4,5
HND-001749,2011,30300026,,,,0,3,3
HND-001750,2011,30300027,,,,12,9,21
HND-001752,2011,30300030,,,,6,3,9
HND-001753,2011,30300031,,,,6,12,18
HND-001757,2011,30300035,,,,0,3,3
HND-001758,2011,30300036,,,,2,0,2
HND-001763,2011,30300041,,,,3,4,7
HND-001764,2011,30300042,,,,2,1,3
HND-001765,2011,30300043,,,,12,10,22
HND-001772,2011,30300051,,,,4,8,12
HND-001773,2011,30300052,,,,43,34,77
HND-001727,2011,30300004,,,,13,10,23
HND-001728,2011,30300005,,,,8,14,22
HND-001730,2011,30300007,,,,3,5,8
HND-001735,2011,30300012,,,,0,1,1
HND-001736,2011,30300013,,,,7,11,18
HND-001737,2011,30300014,,,,3,3,6
HND-001742,2011,30300019,,,,2,1,3
HND-001744,2011,30300021,,,,10,9,19
HND-001748,2011,30300025,,,,5,5,10
HND-001749,2011,30300026,,,,1,5,6
HND-001750,2011,30300027,,,,9,12,21
HND-001752,2011,30300030,,,,0,4,4
HND-001753,2011,30300031,,,,6,12,18
HND-001754,2011,30300032,,,,1,3,4
HND-001755,2011,30300033,,,,2,0,2
HND-001761,2011,30300039,,,,18,23,41
HND-001764,2011,30300042,,,,1,5,6
HND-001765,2011,30300043,,,,10,12,22
HND-001772,2011,30300051,,,,5,8,13
HND-001773,2011,30300052,,,,38,37,75
HND-001774,2011,30300053,,,,0,1,1
HND-001775,2011,30300056,,,,3,0,3
HND-001724,2011,30300001,,,,18,15,33
HND-001725,2011,30300002,,,,6,6,12
HND-001726,2011,30300003,,,,1,1,2
HND-001731,2011,30300008,,,,14,9,23
HND-001732,2011,30300009,,,,23,27,50
HND-001733,2011,30300010,,,,9,4,13
HND-001734,2011,30300011,,,,4,5,9
HND-001738,2011,30300015,,,,7,8,15
HND-001739,2011,30300016,,,,2,0,2
HND-001741,2011,30300018,,,,3,3,6
HND-001743,2011,30300020,,,,7,5,12
HND-001745,2011,30300022,,,,4,3,7
HND-001746,2011,30300023,,,,11,16,27
HND-001747,2011,30300024,,,,8,5,13
HND-001751,2011,30300029,,,,3,3,6
HND-001756,2011,30300034,,,,1,2,3
HND-001757,2011,30300035,,,,2,0,2
HND-001758,2011,30300036,,,,1,0,1
HND-001763,2011,30300041,,,,1,3,4
HND-001768,2011,30300046,,,,7,8,15
HND-001770,2011,30300048,,,,0,1,1
HND-001732,2011,30300009,,,,16,33,49
HND-001750,2011,30300027,,,,15,14,29
HND-001761,2011,30300039,,,,26,16,42
HND-001728,2011,30300005,,,,24,33,57
HND-001731,2011,30300008,,,,22,29,51
HND-001762,2011,30300040,,,,42,41,83
HND-001728,2011,30300005,,,,10,21,31
HND-001750,2011,30300027,,,,10,17,27
HND-001762,2011,30300040,,,,22,32,54
HND-001731,2011,30300008,,,,11,8,19
HND-001732,2011,30300009,,,,10,31,41
HND-001761,2011,30300039,,,,7,14,21
HND-001750,2011,30300027,,,,8,14,22
HND-001728,2011,30300005,,,,5,24,29
HND-001731,2011,30300008,,,,8,12,20
HND-001732,2011,30300009,,,,18,20,38
HND-001761,2011,30300039,,,,11,11,22
HND-001762,2011,30300040,,,,41,37,78
HND-001762,2011,30300040,,,,14,15,29
HND-001762,2011,30300040,,,,5,10,15
HND-001762,2011,30300040,,,,14,19,33
HND-001802,2011,30400006,,,,4,4,8
,2011,30400012,,,,3,2,5
HND-001818,2011,30400024,,,,6,10,16
HND-001826,2011,30400033,,,,4,5,9
HND-001852,2011,30400086,,,,3,3,6
HND-001853,2011,30400087,,,,4,5,9
HND-001854,2011,30400091,,,,4,5,9
,2011,30400097,,,,3,4,7
HND-001800,2011,30400004,,,,2,5,7
HND-001810,2011,30400015,,,,11,6,17
HND-001812,2011,30400018,,,,4,7,11
HND-001814,2011,30400020,,,,3,4,7
HND-001816,2011,30400022,,,,7,4,11
HND-001828,2011,30400035,,,,5,6,11
HND-001844,2011,30400059,,,,2,5,7
,2011,30400065,,,,2,8,10
,2011,30400072,,,,6,6,12
,2011,30400092,,,,4,6,10
,2011,30400093,,,,8,9,17
,2011,30400099,,,,5,1,6
,2011,30400064,,,,1,1,2
HND-001848,2011,30400069,,,,2,2,4
,2011,30400095,,,,1,3,4
HND-001832,2011,30400039,,,,2,4,6
HND-001840,2011,30400052,,,,0,1,1
,2011,30400071,,,,2,3,5
,2011,30400090,,,,3,4,7
HND-001819,2011,30400025,,,,6,7,13
HND-001829,2011,30400036,,,,15,15,30
HND-001831,2011,30400038,,,,6,8,14
HND-001832,2011,30400039,,,,0,3,3
,2011,30400046,,,,5,3,8
HND-001838,2011,30400047,,,,4,3,7
,2011,30400048,,,,4,5,9
,2011,30400064,,,,1,2,3
HND-001848,2011,30400069,,,,2,2,4
,2011,30400071,,,,5,2,7
,2011,30400073,,,,2,2,4
,2011,30400095,,,,1,1,2
HND-001856,2011,30400096,,,,3,3,6
HND-001857,2011,30400098,,,,1,6,7
HND-001834,2011,30400042,,,,4,6,10
HND-001835,2011,30400043,,,,3,1,4
HND-001836,2011,30400044,,,,5,5,10
HND-001839,2011,30400050,,,,4,10,14
HND-001840,2011,30400052,,,,2,1,3
HND-001847,2011,30400068,,,,2,2,4
,2011,30400090,,,,3,3,6
,2011,30400094,,,,0,1,1
HND-001829,2011,30400036,,,,12,15,27
HND-001830,2011,30400037,,,,21,17,38
HND-001834,2011,30400042,,,,7,4,11
HND-001835,2011,30400043,,,,1,3,4
,2011,30400048,,,,4,3,7
HND-001839,2011,30400050,,,,9,6,15
HND-001840,2011,30400052,,,,2,3,5
HND-001847,2011,30400068,,,,1,2,3
,2011,30400073,,,,12,8,20
,2011,30400090,,,,2,5,7
,2011,30400094,,,,8,12,20
HND-001819,2011,30400025,,,,6,6,12
HND-001831,2011,30400038,,,,6,7,13
HND-001832,2011,30400039,,,,6,3,9
HND-001836,2011,30400044,,,,6,4,10
HND-001837,2011,30400045,,,,12,15,27
,2011,30400046,,,,7,7,14
HND-001838,2011,30400047,,,,7,4,11
,2011,30400064,,,,1,1,2
HND-001848,2011,30400069,,,,1,2,3
,2011,30400071,,,,1,1,2
,2011,30400095,,,,3,5,8
HND-001856,2011,30400096,,,,5,6,11
HND-001857,2011,30400098,,,,6,3,9
,2011,30400002,,,,10,7,17
HND-001799,2011,30400003,,,,25,21,46
,2011,30400008,,,,1,2,3
HND-001805,2011,30400009,,,,6,3,9
HND-001809,2011,30400014,,,,9,10,19
HND-001810,2011,30400015,,,,6,8,14
,2011,30400016,,,,3,1,4
,2011,30400017,,,,11,8,19
HND-001815,2011,30400021,,,,6,5,11
HND-001819,2011,30400025,,,,14,11,25
HND-001820,2011,30400026,,,,2,5,7
HND-001821,2011,30400027,,,,16,6,22
HND-001822,2011,30400028,,,,0,3,3
HND-001825,2011,30400032,,,,7,7,14
HND-001826,2011,30400033,,,,4,2,6
HND-001827,2011,30400034,,,,2,6,8
HND-001842,2011,30400056,,,,6,4,10
HND-001843,2011,30400057,,,,3,5,8
HND-001845,2011,30400066,,,,4,7,11
,2011,30400067,,,,6,1,7
,2011,30400071,,,,4,3,7
HND-001851,2011,30400085,,,,3,1,4
HND-001797,2011,30400001,,,,19,27,46
HND-001800,2011,30400004,,,,4,4,8
HND-001801,2011,30400005,,,,9,5,14
HND-001802,2011,30400006,,,,3,5,8
,2011,30400007,,,,3,3,6
HND-001806,2011,30400010,,,,12,13,25
HND-001807,2011,30400011,,,,3,1,4
,2011,30400012,,,,3,2,5
,2011,30400013,,,,24,24,48
HND-001812,2011,30400018,,,,10,5,15
HND-001813,2011,30400019,,,,23,21,44
HND-001814,2011,30400020,,,,6,2,8
HND-001816,2011,30400022,,,,5,1,6
HND-001817,2011,30400023,,,,2,3,5
HND-001818,2011,30400024,,,,9,11,20
HND-001823,2011,30400029,,,,8,9,17
,2011,30400031,,,,3,2,5
HND-001828,2011,30400035,,,,6,7,13
HND-001835,2011,30400043,,,,2,3,5
HND-001841,2011,30400053,,,,4,4,8
HND-001847,2011,30400068,,,,5,4,9
HND-001848,2011,30400069,,,,9,2,11
HND-001850,2011,30400084,,,,9,3,12
HND-001797,2011,30400001,,,,26,25,51
,2011,30400002,,,,7,5,12
HND-001800,2011,30400004,,,,2,3,5
,2011,30400007,,,,0,2,2
HND-001805,2011,30400009,,,,8,7,15
HND-001806,2011,30400010,,,,12,11,23
HND-001807,2011,30400011,,,,8,3,11
,2011,30400013,,,,22,12,34
HND-001810,2011,30400015,,,,7,3,10
,2011,30400016,,,,1,4,5
HND-001812,2011,30400018,,,,3,5,8
HND-001814,2011,30400020,,,,3,3,6
HND-001815,2011,30400021,,,,4,8,12
HND-001816,2011,30400022,,,,5,4,9
HND-001817,2011,30400023,,,,3,2,5
HND-001822,2011,30400028,,,,2,2,4
HND-001823,2011,30400029,,,,4,8,12
HND-001827,2011,30400034,,,,5,3,8
HND-001828,2011,30400035,,,,8,12,20
HND-001835,2011,30400043,,,,3,1,4
HND-001841,2011,30400053,,,,5,1,6
HND-001845,2011,30400066,,,,2,2,4
,2011,30400067,,,,2,3,5
HND-001847,2011,30400068,,,,2,4,6
HND-001850,2011,30400084,,,,4,2,6
HND-001799,2011,30400003,,,,21,13,34
HND-001801,2011,30400005,,,,7,11,18
HND-001802,2011,30400006,,,,1,3,4
,2011,30400008,,,,1,1,2
,2011,30400012,,,,2,2,4
HND-001809,2011,30400014,,,,7,4,11
,2011,30400017,,,,3,6,9
HND-001813,2011,30400019,,,,4,15,19
HND-001818,2011,30400024,,,,4,5,9
HND-001819,2011,30400025,,,,8,8,16
HND-001820,2011,30400026,,,,1,2,3
HND-001821,2011,30400027,,,,12,3,15
,2011,30400031,,,,3,1,4
HND-001825,2011,30400032,,,,7,3,10
HND-001826,2011,30400033,,,,4,3,7
HND-001842,2011,30400056,,,,7,5,12
HND-001843,2011,30400057,,,,2,6,8
HND-001848,2011,30400069,,,,8,1,9
,2011,30400071,,,,3,3,6
HND-001851,2011,30400085,,,,2,1,3
HND-001797,2011,30400001,,,,19,17,36
HND-001800,2011,30400004,,,,6,3,9
HND-001801,2011,30400005,,,,7,12,19
HND-001802,2011,30400006,,,,2,5,7
,2011,30400007,,,,2,5,7
HND-001806,2011,30400010,,,,13,15,28
HND-001807,2011,30400011,,,,7,2,9
,2011,30400012,,,,5,3,8
,2011,30400013,,,,10,12,22
HND-001812,2011,30400018,,,,5,3,8
HND-001813,2011,30400019,,,,4,4,8
HND-001814,2011,30400020,,,,5,2,7
HND-001816,2011,30400022,,,,3,3,6
HND-001817,2011,30400023,,,,6,3,9
HND-001818,2011,30400024,,,,6,6,12
HND-001823,2011,30400029,,,,8,8,16
HND-001827,2011,30400034,,,,5,4,9
HND-001828,2011,30400035,,,,3,7,10
HND-001835,2011,30400043,,,,4,1,5
HND-001841,2011,30400053,,,,5,2,7
HND-001847,2011,30400068,,,,5,2,7
HND-001848,2011,30400069,,,,5,5,10
HND-001850,2011,30400084,,,,1,6,7
,2011,30400002,,,,11,4,15
HND-001799,2011,30400003,,,,20,20,40
,2011,30400008,,,,4,2,6
HND-001805,2011,30400009,,,,6,6,12
HND-001809,2011,30400014,,,,7,4,11
HND-001810,2011,30400015,,,,8,4,12
,2011,30400016,,,,6,1,7
,2011,30400017,,,,3,9,12
HND-001815,2011,30400021,,,,7,7,14
HND-001819,2011,30400025,,,,4,3,7
HND-001820,2011,30400026,,,,6,3,9
HND-001821,2011,30400027,,,,6,7,13
HND-001822,2011,30400028,,,,4,1,5
,2011,30400031,,,,2,2,4
HND-001825,2011,30400032,,,,4,1,5
HND-001826,2011,30400033,,,,1,4,5
HND-001842,2011,30400056,,,,3,3,6
HND-001843,2011,30400057,,,,2,1,3
HND-001845,2011,30400066,,,,3,4,7
,2011,30400067,,,,4,1,5
,2011,30400071,,,,3,2,5
HND-001851,2011,30400085,,,,3,4,7
HND-001797,2011,30400001,,,,26,17,43
HND-001801,2011,30400005,,,,9,7,16
HND-001805,2011,30400009,,,,3,2,5
HND-001806,2011,30400010,,,,18,12,30
,2011,30400012,,,,6,5,11
,2011,30400013,,,,9,21,30
HND-001809,2011,30400014,,,,4,1,5
,2011,30400016,,,,3,4,7
,2011,30400017,,,,5,4,9
HND-001812,2011,30400018,,,,3,4,7
HND-001816,2011,30400022,,,,2,2,4
HND-001818,2011,30400024,,,,7,3,10
HND-001820,2011,30400026,,,,1,4,5
HND-001822,2011,30400028,,,,0,2,2
HND-001823,2011,30400029,,,,2,10,12
HND-001825,2011,30400032,,,,5,9,14
HND-001826,2011,30400033,,,,2,2,4
HND-001827,2011,30400034,,,,7,3,10
HND-001835,2011,30400043,,,,3,5,8
HND-001841,2011,30400053,,,,2,5,7
HND-001845,2011,30400066,,,,2,2,4
,2011,30400067,,,,3,3,6
HND-001847,2011,30400068,,,,1,5,6
,2011,30400002,,,,11,6,17
HND-001799,2011,30400003,,,,17,23,40
HND-001800,2011,30400004,,,,3,6,9
HND-001802,2011,30400006,,,,4,4,8
,2011,30400007,,,,6,4,10
,2011,30400008,,,,7,1,8
HND-001807,2011,30400011,,,,2,8,10
HND-001810,2011,30400015,,,,4,3,7
HND-001813,2011,30400019,,,,4,1,5
HND-001814,2011,30400020,,,,2,3,5
HND-001815,2011,30400021,,,,3,4,7
HND-001817,2011,30400023,,,,4,4,8
HND-001819,2011,30400025,,,,4,6,10
HND-001821,2011,30400027,,,,7,7,14
,2011,30400031,,,,1,0,1
HND-001828,2011,30400035,,,,4,8,12
HND-001842,2011,30400056,,,,4,2,6
HND-001843,2011,30400057,,,,1,3,4
HND-001848,2011,30400069,,,,4,2,6
,2011,30400071,,,,3,3,6
HND-001850,2011,30400084,,,,3,1,4
HND-001851,2011,30400085,,,,5,3,8
HND-001797,2011,30400001,,,,23,18,41
HND-001801,2011,30400005,,,,8,5,13
HND-001802,2011,30400006,,,,5,3,8
,2011,30400007,,,,1,4,5
,2011,30400008,,,,3,3,6
HND-001806,2011,30400010,,,,6,9,15
HND-001807,2011,30400011,,,,1,7,8
,2011,30400012,,,,1,2,3
,2011,30400013,,,,8,20,28
HND-001809,2011,30400014,,,,5,2,7
HND-001813,2011,30400019,,,,3,9,12
HND-001814,2011,30400020,,,,4,3,7
HND-001816,2011,30400022,,,,1,1,2
HND-001817,2011,30400023,,,,7,2,9
HND-001818,2011,30400024,,,,3,3,6
HND-001823,2011,30400029,,,,2,4,6
HND-001825,2011,30400032,,,,6,3,9
HND-001826,2011,30400033,,,,1,5,6
HND-001827,2011,30400034,,,,5,5,10
HND-001835,2011,30400043,,,,2,2,4
HND-001841,2011,30400053,,,,2,2,4
HND-001842,2011,30400056,,,,4,2,6
HND-001847,2011,30400068,,,,0,1,1
HND-001848,2011,30400069,,,,1,5,6
,2011,30400071,,,,4,4,8
,2011,30400002,,,,8,11,19
HND-001799,2011,30400003,,,,18,19,37
HND-001800,2011,30400004,,,,4,4,8
HND-001805,2011,30400009,,,,3,5,8
HND-001810,2011,30400015,,,,6,13,19
,2011,30400016,,,,4,7,11
,2011,30400017,,,,4,9,13
HND-001812,2011,30400018,,,,6,3,9
HND-001815,2011,30400021,,,,6,5,11
HND-001819,2011,30400025,,,,3,5,8
HND-001820,2011,30400026,,,,3,5,8
HND-001821,2011,30400027,,,,6,11,17
HND-001822,2011,30400028,,,,1,2,3
,2011,30400031,,,,2,1,3
HND-001828,2011,30400035,,,,4,1,5
HND-001843,2011,30400057,,,,1,2,3
HND-001845,2011,30400066,,,,4,1,5
,2011,30400067,,,,3,1,4
HND-001850,2011,30400084,,,,0,3,3
HND-001851,2011,30400085,,,,0,4,4
HND-001797,2011,30400001,,,,24,19,43
,2011,30400002,,,,2,4,6
HND-001800,2011,30400004,,,,3,2,5
,2011,30400007,,,,2,3,5
HND-001805,2011,30400009,,,,4,6,10
HND-001806,2011,30400010,,,,8,14,22
HND-001807,2011,30400011,,,,0,2,2
,2011,30400013,,,,11,5,16
HND-001810,2011,30400015,,,,1,4,5
,2011,30400016,,,,3,6,9
HND-001812,2011,30400018,,,,4,5,9
HND-001814,2011,30400020,,,,1,4,5
HND-001815,2011,30400021,,,,3,4,7
HND-001816,2011,30400022,,,,2,5,7
HND-001817,2011,30400023,,,,4,5,9
HND-001822,2011,30400028,,,,0,4,4
HND-001823,2011,30400029,,,,3,4,7
,2011,30400031,,,,0,1,1
HND-001825,2011,30400032,,,,6,4,10
HND-001826,2011,30400033,,,,2,2,4
HND-001842,2011,30400056,,,,7,7,14
HND-001843,2011,30400057,,,,1,0,1
HND-001845,2011,30400066,,,,1,2,3
,2011,30400067,,,,3,1,4
HND-001847,2011,30400068,,,,2,2,4
,2011,30400071,,,,0,2,2
HND-001851,2011,30400085,,,,0,1,1
HND-001799,2011,30400003,,,,12,24,36
HND-001801,2011,30400005,,,,12,10,22
HND-001802,2011,30400006,,,,5,6,11
,2011,30400008,,,,4,4,8
,2011,30400012,,,,2,2,4
HND-001809,2011,30400014,,,,3,4,7
,2011,30400017,,,,2,6,8
HND-001813,2011,30400019,,,,3,5,8
HND-001818,2011,30400024,,,,0,2,2
HND-001819,2011,30400025,,,,5,9,14
HND-001820,2011,30400026,,,,6,3,9
HND-001821,2011,30400027,,,,6,9,15
HND-001827,2011,30400034,,,,5,3,8
HND-001828,2011,30400035,,,,5,5,10
HND-001835,2011,30400043,,,,3,2,5
HND-001841,2011,30400053,,,,1,3,4
HND-001848,2011,30400069,,,,2,5,7
HND-001850,2011,30400084,,,,0,3,3
HND-001799,2011,30400003,,,,24,33,57
,2011,30400017,,,,3,18,21
HND-001801,2011,30400005,,,,8,16,24
HND-001833,2011,30400040,,,,25,29,54
HND-001799,2011,30400003,,,,13,23,36
HND-001801,2011,30400005,,,,7,18,25
,2011,30400017,,,,8,9,17
HND-001833,2011,30400040,,,,23,27,50
HND-001799,2011,30400003,,,,17,31,48
,2011,30400017,,,,4,6,10
HND-001801,2011,30400005,,,,11,14,25
HND-001833,2011,30400040,,,,21,18,39
HND-001801,2011,30400005,,,,7,9,16
HND-001799,2011,30400003,,,,13,14,27
HND-001833,2011,30400040,,,,16,24,40
HND-001801,2011,30400005,,,,3,3,6
HND-001833,2011,30400040,,,,6,18,24
HND-001799,2011,30400003,,,,6,13,19
HND-001799,2011,30400003,,,,5,12,17
HND-001801,2011,30400005,,,,7,7,14
HND-001833,2011,30400040,,,,11,8,19
HND-001858,2011,30500001,,,,4,3,7
,2011,30500008,,,,4,1,5
HND-001862,2011,30500006,,,,4,2,6
HND-001860,2011,30500003,,,,2,1,3
HND-001860,2011,30500003,,,,7,7,14
HND-001858,2011,30500001,,,,2,4,6
HND-001859,2011,30500002,,,,11,7,18
HND-001863,2011,30500007,,,,3,2,5
HND-001861,2011,30500004,,,,1,1,2
HND-001858,2011,30500001,,,,2,2,4
HND-001859,2011,30500002,,,,4,2,6
HND-001861,2011,30500004,,,,1,1,2
HND-001863,2011,30500007,,,,3,2,5
HND-001861,2011,30500004,,,,3,4,7
HND-001858,2011,30500001,,,,5,2,7
HND-001859,2011,30500002,,,,12,5,17
HND-001863,2011,30500007,,,,0,3,3
HND-001858,2011,30500001,,,,3,3,6
HND-001859,2011,30500002,,,,7,4,11
HND-001863,2011,30500007,,,,1,1,2
HND-001861,2011,30500004,,,,0,2,2
HND-001858,2011,30500001,,,,7,6,13
HND-001859,2011,30500002,,,,11,7,18
HND-001858,2011,30500001,,,,4,7,11
HND-001859,2011,30500002,,,,7,16,23
HND-001861,2011,30500004,,,,3,1,4
HND-001863,2011,30500007,,,,2,2,4
HND-001859,2011,30500002,,,,11,15,26
HND-001859,2011,30500002,,,,11,13,24
HND-001859,2011,30500002,,,,5,9,14
HND-001871,2011,30600009,,,,6,3,9
,2011,30600064,,,,9,6,15
HND-001927,2011,30600078,,,,7,7,14
,2011,30600079,,,,5,11,16
HND-001928,2011,30600080,,,,14,11,25
,2011,30600094,,,,3,3,6
,2011,30600095,,,,10,7,17
,2011,30600096,,,,2,4,6
,2011,30600102,,,,3,6,9
,2011,30600105,,,,4,2,6
,2011,30600119,,,,9,6,15
,2011,30600124,,,,3,3,6
,2011,30600126,,,,3,4,7
,2011,30600128,,,,6,0,6
HND-001938,2011,30600130,,,,7,3,10
,2011,30600131,,,,5,1,6
,2011,30600135,,,,1,5,6
,2011,30600143,,,,5,0,5
,2011,30600144,,,,1,4,5
,2011,30600091,,,,4,1,5
,2011,30600092,,,,11,12,23
,2011,30600117,,,,11,4,15
HND-001936,2011,30600118,,,,3,8,11
HND-001937,2011,30600127,,,,8,4,12
,2011,30600129,,,,3,1,4
,2011,30600133,,,,6,4,10
,2011,30600139,,,,6,5,11
,2011,30600140,,,,10,7,17
,2011,30600141,,,,6,5,11
,2011,30600142,,,,2,3,5
,2011,30600145,,,,2,4,6
HND-001905,2011,30600043,,,,0,1,1
HND-001911,2011,30600049,,,,1,2,3
HND-001912,2011,30600050,,,,2,0,2
HND-001923,2011,30600069,,,,0,1,1
,2011,30600076,,,,2,1,3
,2011,30600051,,,,0,2,2
,2011,30600055,,,,1,4,5
,2011,30600090,,,,1,2,3
HND-001905,2011,30600043,,,,2,3,5
HND-001914,2011,30600054,,,,1,3,4
HND-001915,2011,30600056,,,,2,1,3
HND-001916,2011,30600057,,,,1,2,3
HND-001923,2011,30600069,,,,1,2,3
,2011,30600070,,,,1,3,4
HND-001925,2011,30600073,,,,0,1,1
,2011,30600120,,,,4,4,8
,2011,30600137,,,,5,9,14
,2011,30600006,,,,3,2,5
HND-001909,2011,30600047,,,,0,3,3
HND-001910,2011,30600048,,,,9,21,30
HND-001911,2011,30600049,,,,2,3,5
HND-001912,2011,30600050,,,,4,3,7
,2011,30600051,,,,3,2,5
,2011,30600055,,,,4,4,8
HND-001917,2011,30600058,,,,1,3,4
HND-001918,2011,30600059,,,,2,1,3
,2011,30600068,,,,3,0,3
,2011,30600074,,,,3,0,3
,2011,30600076,,,,4,3,7
,2011,30600090,,,,3,5,8
,2011,30600006,,,,3,3,6
HND-001909,2011,30600047,,,,5,10,15
HND-001910,2011,30600048,,,,27,17,44
HND-001911,2011,30600049,,,,4,2,6
HND-001912,2011,30600050,,,,2,6,8
,2011,30600051,,,,3,5,8
,2011,30600055,,,,3,5,8
HND-001915,2011,30600056,,,,9,13,22
HND-001917,2011,30600058,,,,4,3,7
,2011,30600068,,,,4,2,6
,2011,30600074,,,,15,7,22
,2011,30600090,,,,4,3,7
,2011,30600137,,,,5,9,14
HND-001905,2011,30600043,,,,3,2,5
HND-001914,2011,30600054,,,,3,6,9
HND-001916,2011,30600057,,,,6,5,11
HND-001918,2011,30600059,,,,11,9,20
HND-001923,2011,30600069,,,,4,7,11
,2011,30600070,,,,6,5,11
HND-001925,2011,30600073,,,,4,7,11
,2011,30600076,,,,2,2,4
,2011,30600120,,,,8,11,19
HND-001865,2011,30600003,,,,8,12,20
HND-001866,2011,30600004,,,,10,10,20
HND-001871,2011,30600009,,,,12,11,23
,2011,30600010,,,,9,6,15
,2011,30600012,,,,2,2,4
HND-001876,2011,30600014,,,,6,0,6
HND-001881,2011,30600019,,,,25,17,42
HND-001882,2011,30600020,,,,12,11,23
HND-001883,2011,30600021,,,,6,5,11
HND-001885,2011,30600023,,,,35,32,67
HND-001887,2011,30600025,,,,19,11,30
HND-001888,2011,30600026,,,,6,2,8
HND-001890,2011,30600028,,,,2,5,7
HND-001897,2011,30600035,,,,3,0,3
HND-001898,2011,30600036,,,,6,6,12
HND-001899,2011,30600037,,,,20,16,36
HND-001900,2011,30600038,,,,7,5,12
HND-001904,2011,30600042,,,,22,16,38
HND-001905,2011,30600043,,,,5,8,13
HND-001906,2011,30600044,,,,2,5,7
HND-001909,2011,30600047,,,,10,11,21
HND-001921,2011,30600066,,,,0,1,1
HND-001922,2011,30600067,,,,7,5,12
HND-001924,2011,30600071,,,,10,7,17
HND-001929,2011,30600082,,,,1,2,3
HND-001930,2011,30600083,,,,6,4,10
HND-001934,2011,30600109,,,,2,1,3
,2011,30600138,,,,3,4,7
HND-001864,2011,30600001,,,,4,3,7
HND-001867,2011,30600005,,,,8,6,14
,2011,30600006,,,,6,7,13
,2011,30600007,,,,2,1,3
,2011,30600008,,,,0,4,4
,2011,30600011,,,,6,1,7
HND-001875,2011,30600013,,,,9,6,15
,2011,30600015,,,,4,7,11
HND-001878,2011,30600016,,,,6,3,9
HND-001879,2011,30600017,,,,22,9,31
HND-001880,2011,30600018,,,,9,8,17
HND-001884,2011,30600022,,,,4,8,12
HND-001886,2011,30600024,,,,5,4,9
HND-001889,2011,30600027,,,,4,7,11
,2011,30600029,,,,4,6,10
HND-001892,2011,30600030,,,,7,11,18
,2011,30600031,,,,5,8,13
HND-001894,2011,30600032,,,,5,6,11
,2011,30600033,,,,11,8,19
HND-001896,2011,30600034,,,,14,17,31
HND-001901,2011,30600039,,,,1,1,2
HND-001902,2011,30600040,,,,6,1,7
HND-001903,2011,30600041,,,,7,5,12
HND-001907,2011,30600045,,,,8,7,15
HND-001908,2011,30600046,,,,5,3,8
,2011,30600051,,,,4,2,6
HND-001919,2011,30600060,,,,13,17,30
HND-001920,2011,30600061,,,,10,5,15
HND-001931,2011,30600085,,,,2,2,4
HND-001932,2011,30600087,,,,9,5,14
,2011,30600112,,,,3,5,8
HND-001866,2011,30600004,,,,3,7,10
HND-001867,2011,30600005,,,,3,4,7
,2011,30600006,,,,7,3,10
,2011,30600007,,,,3,0,3
HND-001875,2011,30600013,,,,4,6,10
HND-001876,2011,30600014,,,,3,1,4
,2011,30600015,,,,1,1,2
HND-001878,2011,30600016,,,,7,3,10
HND-001879,2011,30600017,,,,20,13,33
HND-001882,2011,30600020,,,,13,9,22
HND-001884,2011,30600022,,,,8,1,9
HND-001886,2011,30600024,,,,8,4,12
,2011,30600029,,,,4,7,11
HND-001892,2011,30600030,,,,7,6,13
HND-001894,2011,30600032,,,,15,3,18
,2011,30600033,,,,6,2,8
HND-001900,2011,30600038,,,,3,7,10
HND-001901,2011,30600039,,,,2,1,3
HND-001902,2011,30600040,,,,5,2,7
HND-001903,2011,30600041,,,,4,2,6
HND-001904,2011,30600042,,,,10,16,26
HND-001905,2011,30600043,,,,2,4,6
HND-001919,2011,30600060,,,,16,15,31
HND-001921,2011,30600066,,,,1,0,1
HND-001922,2011,30600067,,,,3,6,9
HND-001924,2011,30600071,,,,3,1,4
HND-001929,2011,30600082,,,,0,2,2
HND-001930,2011,30600083,,,,5,3,8
HND-001934,2011,30600109,,,,3,1,4
,2011,30600112,,,,2,4,6
HND-001864,2011,30600001,,,,3,2,5
HND-001865,2011,30600003,,,,9,15,24
,2011,30600008,,,,0,3,3
HND-001871,2011,30600009,,,,7,7,14
,2011,30600010,,,,4,3,7
,2011,30600011,,,,10,5,15
,2011,30600012,,,,0,1,1
HND-001880,2011,30600018,,,,6,4,10
HND-001881,2011,30600019,,,,19,11,30
HND-001883,2011,30600021,,,,7,2,9
HND-001885,2011,30600023,,,,30,30,60
HND-001887,2011,30600025,,,,5,12,17
HND-001888,2011,30600026,,,,3,1,4
HND-001889,2011,30600027,,,,4,5,9
HND-001890,2011,30600028,,,,1,4,5
,2011,30600031,,,,4,2,6
HND-001896,2011,30600034,,,,12,17,29
HND-001897,2011,30600035,,,,1,2,3
HND-001898,2011,30600036,,,,8,2,10
HND-001899,2011,30600037,,,,14,23,37
HND-001906,2011,30600044,,,,5,1,6
HND-001907,2011,30600045,,,,3,6,9
HND-001908,2011,30600046,,,,1,5,6
HND-001909,2011,30600047,,,,12,12,24
,2011,30600051,,,,3,5,8
HND-001920,2011,30600061,,,,17,11,28
HND-001931,2011,30600085,,,,1,2,3
HND-001932,2011,30600087,,,,3,2,5
HND-001864,2011,30600001,,,,7,6,13
HND-001867,2011,30600005,,,,6,5,11
,2011,30600006,,,,6,7,13
,2011,30600007,,,,2,3,5
,2011,30600011,,,,4,1,5
HND-001875,2011,30600013,,,,7,3,10
,2011,30600015,,,,3,0,3
HND-001878,2011,30600016,,,,5,1,6
HND-001879,2011,30600017,,,,9,11,20
HND-001880,2011,30600018,,,,9,4,13
HND-001884,2011,30600022,,,,4,6,10
HND-001886,2011,30600024,,,,1,7,8
HND-001889,2011,30600027,,,,4,5,9
,2011,30600029,,,,3,7,10
HND-001892,2011,30600030,,,,4,4,8
,2011,30600031,,,,8,6,14
HND-001894,2011,30600032,,,,8,8,16
,2011,30600033,,,,4,4,8
HND-001896,2011,30600034,,,,10,9,19
HND-001901,2011,30600039,,,,1,0,1
HND-001903,2011,30600041,,,,2,8,10
HND-001907,2011,30600045,,,,2,2,4
HND-001908,2011,30600046,,,,6,0,6
HND-001909,2011,30600047,,,,8,9,17
,2011,30600051,,,,3,3,6
HND-001919,2011,30600060,,,,5,10,15
HND-001920,2011,30600061,,,,8,10,18
HND-001922,2011,30600067,,,,5,7,12
HND-001931,2011,30600085,,,,6,1,7
HND-001932,2011,30600087,,,,1,5,6
,2011,30600112,,,,5,3,8
HND-001865,2011,30600003,,,,13,11,24
HND-001866,2011,30600004,,,,7,10,17
HND-001871,2011,30600009,,,,7,7,14
,2011,30600010,,,,3,2,5
,2011,30600012,,,,2,2,4
HND-001876,2011,30600014,,,,2,0,2
HND-001881,2011,30600019,,,,10,14,24
HND-001882,2011,30600020,,,,5,7,12
HND-001883,2011,30600021,,,,4,8,12
HND-001885,2011,30600023,,,,32,36,68
HND-001887,2011,30600025,,,,5,6,11
HND-001888,2011,30600026,,,,6,2,8
HND-001890,2011,30600028,,,,2,0,2
HND-001897,2011,30600035,,,,3,3,6
HND-001898,2011,30600036,,,,2,6,8
HND-001899,2011,30600037,,,,16,10,26
HND-001900,2011,30600038,,,,3,4,7
HND-001902,2011,30600040,,,,2,4,6
HND-001904,2011,30600042,,,,11,12,23
HND-001905,2011,30600043,,,,6,6,12
HND-001906,2011,30600044,,,,1,4,5
HND-001921,2011,30600066,,,,1,1,2
HND-001924,2011,30600071,,,,10,5,15
HND-001929,2011,30600082,,,,3,3,6
HND-001930,2011,30600083,,,,3,5,8
HND-001934,2011,30600109,,,,1,4,5
HND-001866,2011,30600004,,,,7,1,8
HND-001867,2011,30600005,,,,3,6,9
,2011,30600006,,,,4,2,6
,2011,30600012,,,,2,1,3
HND-001876,2011,30600014,,,,1,5,6
HND-001879,2011,30600017,,,,11,13,24
HND-001881,2011,30600019,,,,16,16,32
HND-001882,2011,30600020,,,,6,9,15
HND-001883,2011,30600021,,,,5,5,10
HND-001884,2011,30600022,,,,5,9,14
HND-001890,2011,30600028,,,,2,1,3
,2011,30600029,,,,7,5,12
HND-001892,2011,30600030,,,,6,9,15
HND-001894,2011,30600032,,,,5,2,7
,2011,30600033,,,,4,2,6
HND-001896,2011,30600034,,,,14,15,29
HND-001901,2011,30600039,,,,2,2,4
HND-001902,2011,30600040,,,,7,3,10
HND-001903,2011,30600041,,,,5,4,9
HND-001904,2011,30600042,,,,13,6,19
HND-001905,2011,30600043,,,,2,9,11
HND-001919,2011,30600060,,,,13,11,24
HND-001921,2011,30600066,,,,2,1,3
HND-001922,2011,30600067,,,,1,2,3
HND-001924,2011,30600071,,,,6,8,14
HND-001930,2011,30600083,,,,10,3,13
HND-001931,2011,30600085,,,,2,4,6
HND-001934,2011,30600109,,,,6,1,7
,2011,30600112,,,,1,3,4
HND-001864,2011,30600001,,,,6,4,10
HND-001865,2011,30600003,,,,9,21,30
,2011,30600008,,,,1,1,2
HND-001871,2011,30600009,,,,4,10,14
,2011,30600010,,,,5,0,5
,2011,30600011,,,,6,1,7
HND-001875,2011,30600013,,,,8,9,17
,2011,30600015,,,,0,1,1
HND-001878,2011,30600016,,,,3,2,5
HND-001880,2011,30600018,,,,4,7,11
HND-001885,2011,30600023,,,,37,43,80
HND-001886,2011,30600024,,,,8,11,19
HND-001887,2011,30600025,,,,8,10,18
HND-001888,2011,30600026,,,,0,3,3
HND-001889,2011,30600027,,,,6,5,11
,2011,30600031,,,,7,5,12
HND-001897,2011,30600035,,,,2,5,7
HND-001898,2011,30600036,,,,3,3,6
HND-001899,2011,30600037,,,,18,15,33
HND-001900,2011,30600038,,,,5,3,8
HND-001906,2011,30600044,,,,5,3,8
HND-001907,2011,30600045,,,,4,3,7
HND-001908,2011,30600046,,,,2,1,3
HND-001909,2011,30600047,,,,18,12,30
,2011,30600051,,,,5,3,8
HND-001920,2011,30600061,,,,6,13,19
HND-001929,2011,30600082,,,,3,1,4
HND-001932,2011,30600087,,,,2,7,9
HND-001865,2011,30600003,,,,13,8,21
HND-001866,2011,30600004,,,,4,9,13
,2011,30600007,,,,1,2,3
HND-001871,2011,30600009,,,,10,6,16
,2011,30600010,,,,3,4,7
,2011,30600012,,,,0,2,2
HND-001876,2011,30600014,,,,1,1,2
HND-001881,2011,30600019,,,,17,8,25
HND-001882,2011,30600020,,,,7,9,16
HND-001883,2011,30600021,,,,4,5,9
HND-001884,2011,30600022,,,,3,5,8
HND-001885,2011,30600023,,,,36,40,76
HND-001890,2011,30600028,,,,0,4,4
,2011,30600029,,,,5,7,12
HND-001892,2011,30600030,,,,5,3,8
,2011,30600031,,,,7,3,10
HND-001894,2011,30600032,,,,3,1,4
,2011,30600033,,,,4,7,11
HND-001896,2011,30600034,,,,15,15,30
HND-001901,2011,30600039,,,,0,2,2
HND-001902,2011,30600040,,,,3,7,10
HND-001903,2011,30600041,,,,2,5,7
HND-001905,2011,30600043,,,,3,3,6
HND-001907,2011,30600045,,,,4,1,5
,2011,30600051,,,,5,3,8
HND-001921,2011,30600066,,,,1,0,1
HND-001922,2011,30600067,,,,3,3,6
HND-001924,2011,30600071,,,,10,9,19
HND-001931,2011,30600085,,,,1,2,3
HND-001932,2011,30600087,,,,3,5,8
HND-001934,2011,30600109,,,,1,2,3
HND-001864,2011,30600001,,,,2,7,9
HND-001867,2011,30600005,,,,2,6,8
,2011,30600006,,,,7,7,14
,2011,30600008,,,,3,3,6
,2011,30600011,,,,2,2,4
HND-001875,2011,30600013,,,,6,4,10
,2011,30600015,,,,1,2,3
HND-001878,2011,30600016,,,,5,2,7
HND-001879,2011,30600017,,,,11,10,21
HND-001880,2011,30600018,,,,6,5,11
HND-001886,2011,30600024,,,,6,3,9
HND-001887,2011,30600025,,,,7,7,14
HND-001888,2011,30600026,,,,2,3,5
HND-001889,2011,30600027,,,,6,7,13
HND-001897,2011,30600035,,,,0,2,2
HND-001898,2011,30600036,,,,2,0,2
HND-001899,2011,30600037,,,,14,16,30
HND-001900,2011,30600038,,,,2,1,3
HND-001904,2011,30600042,,,,14,7,21
HND-001906,2011,30600044,,,,4,6,10
HND-001908,2011,30600046,,,,2,0,2
HND-001909,2011,30600047,,,,9,14,23
HND-001919,2011,30600060,,,,8,14,22
HND-001920,2011,30600061,,,,7,5,12
HND-001930,2011,30600083,,,,6,5,11
,2011,30600112,,,,4,3,7
HND-001864,2011,30600001,,,,3,2,5
HND-001865,2011,30600003,,,,12,10,22
,2011,30600008,,,,3,2,5
HND-001871,2011,30600009,,,,5,6,11
,2011,30600010,,,,2,2,4
,2011,30600011,,,,3,2,5
,2011,30600012,,,,1,3,4
HND-001880,2011,30600018,,,,5,2,7
HND-001881,2011,30600019,,,,12,8,20
HND-001883,2011,30600021,,,,4,9,13
HND-001885,2011,30600023,,,,35,42,77
HND-001887,2011,30600025,,,,9,1,10
HND-001888,2011,30600026,,,,3,1,4
HND-001889,2011,30600027,,,,9,4,13
HND-001890,2011,30600028,,,,2,1,3
,2011,30600031,,,,8,7,15
HND-001896,2011,30600034,,,,11,12,23
HND-001897,2011,30600035,,,,1,1,2
HND-001898,2011,30600036,,,,3,1,4
HND-001899,2011,30600037,,,,10,15,25
HND-001906,2011,30600044,,,,2,2,4
HND-001907,2011,30600045,,,,8,4,12
HND-001908,2011,30600046,,,,10,3,13
HND-001909,2011,30600047,,,,9,6,15
,2011,30600051,,,,4,2,6
HND-001920,2011,30600061,,,,8,5,13
HND-001931,2011,30600085,,,,1,3,4
HND-001932,2011,30600087,,,,1,1,2
HND-001866,2011,30600004,,,,6,5,11
HND-001867,2011,30600005,,,,5,3,8
,2011,30600006,,,,2,6,8
,2011,30600007,,,,1,1,2
HND-001875,2011,30600013,,,,7,3,10
HND-001876,2011,30600014,,,,1,2,3
,2011,30600015,,,,0,1,1
HND-001878,2011,30600016,,,,3,2,5
HND-001879,2011,30600017,,,,3,10,13
HND-001882,2011,30600020,,,,14,7,21
HND-001884,2011,30600022,,,,5,5,10
HND-001886,2011,30600024,,,,4,7,11
,2011,30600029,,,,5,2,7
HND-001892,2011,30600030,,,,1,5,6
HND-001894,2011,30600032,,,,6,4,10
,2011,30600033,,,,5,5,10
HND-001900,2011,30600038,,,,2,4,6
HND-001901,2011,30600039,,,,3,1,4
HND-001902,2011,30600040,,,,2,4,6
HND-001903,2011,30600041,,,,7,4,11
HND-001904,2011,30600042,,,,13,5,18
HND-001905,2011,30600043,,,,3,3,6
HND-001919,2011,30600060,,,,4,8,12
HND-001921,2011,30600066,,,,3,1,4
HND-001922,2011,30600067,,,,3,3,6
HND-001924,2011,30600071,,,,7,7,14
HND-001929,2011,30600082,,,,3,1,4
HND-001930,2011,30600083,,,,1,1,2
HND-001934,2011,30600109,,,,1,2,3
,2011,30600112,,,,1,3,4
HND-001865,2011,30600003,,,,8,15,23
HND-001871,2011,30600009,,,,8,16,24
HND-001875,2011,30600013,,,,67,61,128
HND-001881,2011,30600019,,,,11,12,23
HND-001899,2011,30600037,,,,45,51,96
HND-001909,2011,30600047,,,,11,18,29
,2011,30600136,,,,62,60,122
,2011,30600086,,,,48,63,111
,2011,30600086,,,,37,37,74
HND-001865,2011,30600003,,,,12,9,21
HND-001871,2011,30600009,,,,21,20,41
HND-001875,2011,30600013,,,,60,60,120
HND-001881,2011,30600019,,,,7,5,12
HND-001899,2011,30600037,,,,27,30,57
HND-001909,2011,30600047,,,,17,21,38
,2011,30600136,,,,42,60,102
,2011,30600136,,,,40,29,69
HND-001865,2011,30600003,,,,11,12,23
HND-001871,2011,30600009,,,,15,16,31
HND-001875,2011,30600013,,,,48,40,88
HND-001881,2011,30600019,,,,8,6,14
HND-001899,2011,30600037,,,,22,28,50
HND-001909,2011,30600047,,,,8,13,21
,2011,30600086,,,,21,58,79
,2011,30600086,,,,34,62,96
,2011,30600136,,,,15,26,41
HND-001875,2011,30600013,,,,71,71,142
,2011,30600086,,,,22,32,54
HND-001875,2011,30600013,,,,68,48,116
,2011,30600136,,,,8,14,22
HND-001875,2011,30600013,,,,41,47,88
,2011,30600086,,,,22,47,69
HND-001963,2011,30700042,,,,8,5,13
,2011,30700043,,,,2,2,4
,2011,30700044,,,,6,4,10
,2011,30700020,,,,1,0,1
HND-001961,2011,30700040,,,,0,3,3
HND-001952,2011,30700019,,,,0,2,2
HND-001949,2011,30700012,,,,11,11,22
,2011,30700020,,,,6,4,10
,2011,30700033,,,,7,6,13
HND-001951,2011,30700017,,,,2,0,2
HND-001952,2011,30700019,,,,1,6,7
HND-001954,2011,30700021,,,,2,6,8
HND-001957,2011,30700027,,,,6,6,12
HND-001961,2011,30700040,,,,7,7,14
HND-001949,2011,30700012,,,,23,16,39
HND-001951,2011,30700017,,,,5,4,9
,2011,30700020,,,,4,0,4
HND-001961,2011,30700040,,,,13,3,16
HND-001952,2011,30700019,,,,8,6,14
HND-001954,2011,30700021,,,,6,5,11
HND-001957,2011,30700027,,,,3,5,8
,2011,30700033,,,,5,5,10
HND-001939,2011,30700001,,,,6,4,10
HND-001940,2011,30700002,,,,35,20,55
HND-001942,2011,30700005,,,,2,2,4
HND-001943,2011,30700006,,,,6,2,8
HND-001944,2011,30700007,,,,5,5,10
HND-001945,2011,30700008,,,,14,14,28
HND-001947,2011,30700010,,,,5,2,7
HND-001948,2011,30700011,,,,1,0,1
HND-001955,2011,30700022,,,,1,2,3
HND-001956,2011,30700024,,,,8,4,12
HND-001962,2011,30700041,,,,1,1,2
HND-001941,2011,30700003,,,,15,11,26
HND-001946,2011,30700009,,,,3,4,7
HND-001954,2011,30700021,,,,12,9,21
HND-001958,2011,30700028,,,,3,5,8
,2011,30700029,,,,3,2,5
HND-001960,2011,30700031,,,,9,4,13
HND-001943,2011,30700006,,,,1,4,5
HND-001944,2011,30700007,,,,2,5,7
HND-001948,2011,30700011,,,,2,1,3
HND-001955,2011,30700022,,,,3,2,5
HND-001956,2011,30700024,,,,6,5,11
,2011,30700029,,,,3,0,3
HND-001960,2011,30700031,,,,8,5,13
HND-001962,2011,30700041,,,,0,1,1
HND-001939,2011,30700001,,,,6,7,13
HND-001940,2011,30700002,,,,24,24,48
HND-001941,2011,30700003,,,,14,8,22
HND-001945,2011,30700008,,,,15,8,23
HND-001946,2011,30700009,,,,2,2,4
HND-001947,2011,30700010,,,,3,1,4
HND-001954,2011,30700021,,,,4,6,10
HND-001958,2011,30700028,,,,5,2,7
HND-001941,2011,30700003,,,,11,7,18
HND-001946,2011,30700009,,,,5,6,11
HND-001954,2011,30700021,,,,5,6,11
HND-001958,2011,30700028,,,,2,0,2
HND-001960,2011,30700031,,,,9,10,19
HND-001962,2011,30700041,,,,3,3,6
HND-001939,2011,30700001,,,,8,6,14
HND-001940,2011,30700002,,,,18,26,44
HND-001942,2011,30700005,,,,1,2,3
HND-001943,2011,30700006,,,,1,4,5
HND-001944,2011,30700007,,,,2,6,8
HND-001945,2011,30700008,,,,3,10,13
HND-001947,2011,30700010,,,,4,2,6
HND-001948,2011,30700011,,,,0,1,1
HND-001955,2011,30700022,,,,2,2,4
HND-001956,2011,30700024,,,,4,2,6
,2011,30700029,,,,1,0,1
HND-001943,2011,30700006,,,,2,2,4
HND-001944,2011,30700007,,,,9,9,18
HND-001948,2011,30700011,,,,3,8,11
HND-001954,2011,30700021,,,,6,6,12
HND-001955,2011,30700022,,,,4,2,6
HND-001958,2011,30700028,,,,0,1,1
,2011,30700029,,,,1,2,3
HND-001962,2011,30700041,,,,1,2,3
HND-001939,2011,30700001,,,,8,6,14
HND-001940,2011,30700002,,,,16,32,48
HND-001941,2011,30700003,,,,6,8,14
HND-001942,2011,30700005,,,,1,2,3
HND-001945,2011,30700008,,,,4,11,15
HND-001946,2011,30700009,,,,4,3,7
HND-001947,2011,30700010,,,,4,3,7
HND-001956,2011,30700024,,,,1,4,5
HND-001960,2011,30700031,,,,8,7,15
HND-001941,2011,30700003,,,,12,9,21
HND-001944,2011,30700007,,,,6,6,12
HND-001946,2011,30700009,,,,7,6,13
HND-001954,2011,30700021,,,,3,4,7
HND-001955,2011,30700022,,,,2,3,5
HND-001958,2011,30700028,,,,1,3,4
HND-001962,2011,30700041,,,,1,5,6
HND-001939,2011,30700001,,,,10,6,16
HND-001940,2011,30700002,,,,21,28,49
HND-001942,2011,30700005,,,,1,0,1
HND-001943,2011,30700006,,,,2,1,3
HND-001945,2011,30700008,,,,4,9,13
HND-001947,2011,30700010,,,,2,1,3
HND-001948,2011,30700011,,,,4,3,7
HND-001956,2011,30700024,,,,2,2,4
HND-001960,2011,30700031,,,,8,5,13
HND-001939,2011,30700001,,,,6,3,9
HND-001940,2011,30700002,,,,15,22,37
HND-001941,2011,30700003,,,,8,4,12
HND-001945,2011,30700008,,,,5,7,12
HND-001946,2011,30700009,,,,5,3,8
HND-001947,2011,30700010,,,,1,2,3
HND-001954,2011,30700021,,,,5,4,9
HND-001942,2011,30700005,,,,0,1,1
HND-001943,2011,30700006,,,,1,1,2
HND-001944,2011,30700007,,,,5,10,15
HND-001948,2011,30700011,,,,1,2,3
HND-001955,2011,30700022,,,,2,0,2
HND-001956,2011,30700024,,,,0,1,1
,2011,30700029,,,,0,1,1
HND-001960,2011,30700031,,,,11,12,23
HND-001962,2011,30700041,,,,1,1,2
HND-001950,2011,30700013,,,,34,46,80
HND-001950,2011,30700013,,,,24,42,66
HND-001950,2011,30700013,,,,23,41,64
HND-001950,2011,30700013,,,,31,16,47
HND-001950,2011,30700013,,,,17,9,26
HND-001950,2011,30700013,,,,22,12,34
HND-001971,2011,30800009,,,,2,6,8
,2011,30800012,,,,6,3,9
,2011,30800022,,,,2,6,8
HND-001976,2011,30800016,,,,11,4,15
HND-001978,2011,30800018,,,,2,4,6
HND-001974,2011,30800014,,,,3,4,7
HND-001974,2011,30800014,,,,3,2,5
HND-001968,2011,30800006,,,,13,11,24
HND-001972,2011,30800011,,,,9,11,20
HND-001974,2011,30800014,,,,1,4,5
HND-001977,2011,30800017,,,,9,3,12
HND-001965,2011,30800002,,,,6,3,9
HND-001966,2011,30800003,,,,0,1,1
HND-001970,2011,30800008,,,,6,7,13
HND-001981,2011,30800023,,,,7,2,9
HND-001964,2011,30800001,,,,15,13,28
HND-001967,2011,30800004,,,,7,5,12
,2011,30800005,,,,2,5,7
HND-001968,2011,30800006,,,,22,22,44
,2011,30800007,,,,5,7,12
,2011,30800013,,,,4,4,8
HND-001975,2011,30800015,,,,9,6,15
HND-001980,2011,30800020,,,,0,1,1
HND-001964,2011,30800001,,,,16,11,27
HND-001965,2011,30800002,,,,0,5,5
HND-001966,2011,30800003,,,,4,0,4
HND-001967,2011,30800004,,,,8,0,8
,2011,30800007,,,,6,7,13
,2011,30800013,,,,0,1,1
HND-001975,2011,30800015,,,,6,12,18
,2011,30800005,,,,6,1,7
HND-001968,2011,30800006,,,,24,16,40
HND-001970,2011,30800008,,,,2,6,8
HND-001980,2011,30800020,,,,4,2,6
HND-001981,2011,30800023,,,,4,9,13
HND-001964,2011,30800001,,,,14,17,31
HND-001967,2011,30800004,,,,8,2,10
,2011,30800005,,,,2,5,7
HND-001968,2011,30800006,,,,17,14,31
,2011,30800007,,,,9,2,11
,2011,30800013,,,,0,2,2
HND-001975,2011,30800015,,,,7,4,11
HND-001965,2011,30800002,,,,2,4,6
HND-001966,2011,30800003,,,,1,2,3
HND-001970,2011,30800008,,,,5,7,12
HND-001980,2011,30800020,,,,1,2,3
HND-001981,2011,30800023,,,,2,2,4
HND-001965,2011,30800002,,,,2,3,5
HND-001967,2011,30800004,,,,4,2,6
HND-001975,2011,30800015,,,,5,4,9
HND-001964,2011,30800001,,,,18,16,34
,2011,30800005,,,,4,4,8
HND-001968,2011,30800006,,,,17,19,36
,2011,30800007,,,,6,5,11
HND-001970,2011,30800008,,,,7,4,11
HND-001980,2011,30800020,,,,0,1,1
HND-001981,2011,30800023,,,,1,0,1
HND-001965,2011,30800002,,,,3,3,6
HND-001966,2011,30800003,,,,2,6,8
,2011,30800013,,,,1,1,2
HND-001964,2011,30800001,,,,14,17,31
HND-001967,2011,30800004,,,,4,3,7
,2011,30800005,,,,9,6,15
HND-001968,2011,30800006,,,,17,12,29
,2011,30800007,,,,11,7,18
HND-001970,2011,30800008,,,,6,13,19
HND-001975,2011,30800015,,,,3,2,5
HND-001980,2011,30800020,,,,2,3,5
HND-001981,2011,30800023,,,,1,1,2
,2011,30800005,,,,0,4,4
HND-001968,2011,30800006,,,,13,9,22
HND-001980,2011,30800020,,,,2,3,5
HND-001964,2011,30800001,,,,12,20,32
HND-001965,2011,30800002,,,,1,7,8
HND-001966,2011,30800003,,,,5,0,5
HND-001967,2011,30800004,,,,3,3,6
,2011,30800007,,,,11,13,24
,2011,30800013,,,,0,1,1
HND-001975,2011,30800015,,,,1,2,3
HND-001964,2011,30800001,,,,13,11,24
HND-001968,2011,30800006,,,,16,13,29
HND-001964,2011,30800001,,,,12,21,33
HND-001968,2011,30800006,,,,10,12,22
HND-001964,2011,30800001,,,,24,14,38
HND-001968,2011,30800006,,,,4,13,17
HND-001979,2011,30800019,,,,10,21,31
HND-001979,2011,30800019,,,,6,10,16
HND-001979,2011,30800019,,,,10,9,19
,2011,30900004,,,,1,1,2
,2011,30900007,,,,1,1,2
HND-001984,2011,30900003,,,,25,23,48
,2011,30900004,,,,1,7,8
,2011,30900007,,,,1,0,1
HND-001984,2011,30900003,,,,38,38,76
,2011,30900007,,,,4,1,5
,2011,30900004,,,,4,6,10
HND-001983,2011,30900002,,,,6,8,14
HND-001986,2011,30900009,,,,5,3,8
HND-001982,2011,30900001,,,,54,42,96
HND-001987,2011,30900010,,,,5,4,9
HND-001988,2011,30900011,,,,9,3,12
HND-001986,2011,30900009,,,,3,2,5
HND-001988,2011,30900011,,,,4,11,15
HND-001982,2011,30900001,,,,44,49,93
HND-001983,2011,30900002,,,,4,5,9
HND-001987,2011,30900010,,,,0,3,3
HND-001983,2011,30900002,,,,6,9,15
HND-001986,2011,30900009,,,,5,1,6
HND-001988,2011,30900011,,,,5,4,9
HND-001982,2011,30900001,,,,40,47,87
HND-001987,2011,30900010,,,,2,4,6
HND-001988,2011,30900011,,,,7,5,12
HND-001982,2011,30900001,,,,38,47,85
HND-001983,2011,30900002,,,,6,6,12
HND-001986,2011,30900009,,,,6,4,10
HND-001987,2011,30900010,,,,3,7,10
HND-001982,2011,30900001,,,,60,68,128
HND-001988,2011,30900011,,,,1,1,2
HND-001983,2011,30900002,,,,10,7,17
HND-001986,2011,30900009,,,,2,3,5
HND-001987,2011,30900010,,,,3,2,5
HND-001982,2011,30900001,,,,46,45,91
HND-001983,2011,30900002,,,,6,7,13
HND-001987,2011,30900010,,,,0,2,2
HND-001986,2011,30900009,,,,1,3,4
HND-001985,2011,30900006,,,,64,43,107
HND-001985,2011,30900006,,,,48,34,82
HND-001985,2011,30900006,,,,55,36,91
HND-001985,2011,30900006,,,,3,8,11
HND-001985,2011,30900006,,,,4,6,10
HND-001985,2011,30900006,,,,0,7,7
HND-002004,2011,31000018,,,,2,4,6
,2011,31000055,,,,4,4,8
,2011,31000056,,,,6,7,13
,2011,31000066,,,,8,10,18
HND-002034,2011,31000073,,,,4,7,11
HND-002035,2011,31000074,,,,5,3,8
HND-002036,2011,31000075,,,,14,7,21
,2011,31000076,,,,5,3,8
HND-002037,2011,31000077,,,,4,3,7
HND-002038,2011,31000078,,,,7,10,17
,2011,31000081,,,,2,9,11
,2011,31000082,,,,7,5,12
,2011,31000083,,,,5,9,14
HND-002041,2011,31000084,,,,4,6,10
,2011,31000086,,,,3,4,7
,2011,31000091,,,,7,5,12
HND-002046,2011,31000092,,,,6,3,9
HND-002047,2011,31000093,,,,6,9,15
,2011,31000094,,,,5,4,9
HND-002048,2011,31000095,,,,5,8,13
HND-002050,2011,31000097,,,,5,2,7
HND-002051,2011,31000098,,,,6,3,9
HND-002011,2011,31000027,,,,5,5,10
,2011,31000052,,,,3,7,10
HND-002039,2011,31000079,,,,24,24,48
HND-002040,2011,31000080,,,,2,5,7
HND-002042,2011,31000085,,,,6,6,12
,2011,31000087,,,,6,2,8
HND-002043,2011,31000088,,,,4,3,7
,2011,31000089,,,,7,3,10
HND-002045,2011,31000090,,,,4,4,8
,2011,31000099,,,,2,2,4
HND-002027,2011,31000046,,,,2,0,2
HND-002028,2011,31000048,,,,2,3,5
HND-002029,2011,31000049,,,,2,1,3
HND-002024,2011,31000042,,,,4,3,7
HND-002026,2011,31000044,,,,0,2,2
HND-002027,2011,31000046,,,,2,1,3
HND-002028,2011,31000048,,,,5,9,14
HND-002029,2011,31000049,,,,0,2,2
HND-002026,2011,31000044,,,,20,11,31
HND-002027,2011,31000046,,,,8,4,12
HND-002028,2011,31000048,,,,6,2,8
HND-002029,2011,31000049,,,,2,3,5
HND-002024,2011,31000042,,,,4,7,11
HND-001989,2011,31000001,,,,10,8,18
HND-001990,2011,31000002,,,,25,12,37
HND-001991,2011,31000003,,,,4,4,8
HND-002007,2011,31000021,,,,0,5,5
HND-002008,2011,31000022,,,,7,1,8
HND-002009,2011,31000023,,,,6,8,14
HND-002011,2011,31000027,,,,2,0,2
HND-002023,2011,31000041,,,,3,0,3
HND-002030,2011,31000050,,,,7,0,7
HND-002031,2011,31000051,,,,4,3,7
HND-002032,2011,31000067,,,,3,5,8
HND-002033,2011,31000072,,,,20,18,38
HND-002049,2011,31000096,,,,4,3,7
HND-001992,2011,31000004,,,,7,12,19
HND-001993,2011,31000005,,,,7,7,14
HND-001994,2011,31000006,,,,10,8,18
HND-001995,2011,31000008,,,,6,10,16
HND-001996,2011,31000009,,,,5,3,8
HND-001997,2011,31000010,,,,6,7,13
HND-001998,2011,31000011,,,,4,6,10
HND-001999,2011,31000012,,,,3,1,4
HND-002000,2011,31000013,,,,5,9,14
HND-002001,2011,31000014,,,,6,4,10
HND-002002,2011,31000015,,,,6,6,12
HND-002003,2011,31000016,,,,4,1,5
HND-002004,2011,31000018,,,,5,8,13
HND-002005,2011,31000019,,,,7,4,11
HND-002006,2011,31000020,,,,3,7,10
HND-002010,2011,31000024,,,,4,2,6
HND-002012,2011,31000028,,,,6,1,7
HND-002013,2011,31000029,,,,12,7,19
HND-002014,2011,31000030,,,,1,7,8
HND-002015,2011,31000031,,,,7,6,13
HND-002016,2011,31000033,,,,1,7,8
HND-002017,2011,31000034,,,,1,3,4
HND-002018,2011,31000035,,,,8,4,12
HND-002019,2011,31000036,,,,2,8,10
HND-002020,2011,31000037,,,,3,7,10
HND-002021,2011,31000038,,,,8,8,16
HND-002022,2011,31000040,,,,9,10,19
,2011,31000057,,,,4,0,4
HND-001989,2011,31000001,,,,11,8,19
HND-001991,2011,31000003,,,,0,3,3
HND-001992,2011,31000004,,,,3,12,15
HND-001993,2011,31000005,,,,6,5,11
HND-001994,2011,31000006,,,,6,6,12
HND-001995,2011,31000008,,,,8,6,14
HND-001996,2011,31000009,,,,1,3,4
HND-001998,2011,31000011,,,,4,4,8
HND-001999,2011,31000012,,,,2,1,3
HND-002000,2011,31000013,,,,5,6,11
HND-002001,2011,31000014,,,,6,10,16
HND-002003,2011,31000016,,,,5,3,8
HND-002006,2011,31000020,,,,4,4,8
HND-002009,2011,31000023,,,,3,4,7
HND-002010,2011,31000024,,,,5,5,10
HND-002011,2011,31000027,,,,5,1,6
HND-002012,2011,31000028,,,,2,2,4
HND-002015,2011,31000031,,,,8,8,16
HND-002016,2011,31000033,,,,2,2,4
HND-002020,2011,31000037,,,,6,6,12
HND-002022,2011,31000040,,,,3,3,6
HND-002031,2011,31000051,,,,0,2,2
,2011,31000057,,,,5,2,7
HND-001990,2011,31000002,,,,22,16,38
HND-001997,2011,31000010,,,,5,4,9
HND-002002,2011,31000015,,,,9,1,10
HND-002004,2011,31000018,,,,5,1,6
HND-002005,2011,31000019,,,,3,6,9
HND-002008,2011,31000022,,,,5,1,6
HND-002013,2011,31000029,,,,11,17,28
HND-002014,2011,31000030,,,,2,2,4
HND-002017,2011,31000034,,,,1,4,5
HND-002018,2011,31000035,,,,4,3,7
HND-002019,2011,31000036,,,,3,3,6
HND-002023,2011,31000041,,,,2,5,7
HND-002032,2011,31000067,,,,5,3,8
HND-002033,2011,31000072,,,,16,11,27
HND-002049,2011,31000096,,,,0,1,1
HND-001992,2011,31000004,,,,8,10,18
HND-001993,2011,31000005,,,,8,8,16
HND-001994,2011,31000006,,,,8,8,16
HND-001995,2011,31000008,,,,6,4,10
HND-001996,2011,31000009,,,,4,3,7
HND-001997,2011,31000010,,,,8,5,13
HND-001998,2011,31000011,,,,7,4,11
HND-001999,2011,31000012,,,,4,2,6
HND-002000,2011,31000013,,,,6,3,9
HND-002001,2011,31000014,,,,2,1,3
HND-002002,2011,31000015,,,,3,2,5
HND-002003,2011,31000016,,,,2,2,4
HND-002004,2011,31000018,,,,7,4,11
HND-002005,2011,31000019,,,,2,3,5
HND-002006,2011,31000020,,,,3,2,5
HND-002010,2011,31000024,,,,6,3,9
HND-002012,2011,31000028,,,,1,3,4
HND-002013,2011,31000029,,,,9,10,19
HND-002015,2011,31000031,,,,3,1,4
HND-002016,2011,31000033,,,,2,3,5
HND-002017,2011,31000034,,,,0,3,3
HND-002019,2011,31000036,,,,0,3,3
HND-002020,2011,31000037,,,,3,9,12
HND-002021,2011,31000038,,,,2,0,2
HND-002022,2011,31000040,,,,4,2,6
HND-002030,2011,31000050,,,,2,2,4
,2011,31000057,,,,4,0,4
HND-001989,2011,31000001,,,,8,10,18
HND-001990,2011,31000002,,,,17,8,25
HND-001991,2011,31000003,,,,4,0,4
HND-002007,2011,31000021,,,,2,3,5
HND-002008,2011,31000022,,,,2,4,6
HND-002009,2011,31000023,,,,4,4,8
HND-002011,2011,31000027,,,,4,3,7
HND-002014,2011,31000030,,,,2,3,5
HND-002018,2011,31000035,,,,1,4,5
HND-002023,2011,31000041,,,,2,4,6
HND-002031,2011,31000051,,,,1,0,1
HND-002032,2011,31000067,,,,5,2,7
HND-002033,2011,31000072,,,,8,12,20
HND-002049,2011,31000096,,,,0,6,6
HND-001989,2011,31000001,,,,12,5,17
HND-001991,2011,31000003,,,,5,2,7
HND-001992,2011,31000004,,,,5,10,15
HND-001993,2011,31000005,,,,7,11,18
HND-001994,2011,31000006,,,,9,9,18
HND-001995,2011,31000008,,,,2,2,4
HND-001998,2011,31000011,,,,5,1,6
HND-001999,2011,31000012,,,,3,1,4
HND-002000,2011,31000013,,,,4,5,9
HND-002007,2011,31000021,,,,2,5,7
HND-002009,2011,31000023,,,,3,4,7
HND-002010,2011,31000024,,,,1,4,5
HND-002011,2011,31000027,,,,4,7,11
HND-002015,2011,31000031,,,,1,4,5
HND-002020,2011,31000037,,,,8,5,13
HND-002022,2011,31000040,,,,4,6,10
HND-002023,2011,31000041,,,,5,3,8
HND-002030,2011,31000050,,,,3,2,5
HND-002031,2011,31000051,,,,2,1,3
HND-001990,2011,31000002,,,,11,19,30
HND-001996,2011,31000009,,,,1,3,4
HND-001997,2011,31000010,,,,5,5,10
HND-002001,2011,31000014,,,,0,1,1
HND-002002,2011,31000015,,,,1,8,9
HND-002003,2011,31000016,,,,6,2,8
HND-002004,2011,31000018,,,,3,5,8
HND-002005,2011,31000019,,,,5,7,12
HND-002006,2011,31000020,,,,3,2,5
HND-002008,2011,31000022,,,,3,2,5
HND-002012,2011,31000028,,,,4,1,5
HND-002013,2011,31000029,,,,10,8,18
HND-002014,2011,31000030,,,,0,2,2
HND-002016,2011,31000033,,,,2,0,2
HND-002017,2011,31000034,,,,3,4,7
HND-002018,2011,31000035,,,,3,4,7
HND-002019,2011,31000036,,,,2,2,4
HND-002021,2011,31000038,,,,10,4,14
HND-002032,2011,31000067,,,,5,4,9
HND-002033,2011,31000072,,,,4,8,12
HND-001990,2011,31000002,,,,18,19,37
HND-001993,2011,31000005,,,,12,9,21
HND-001995,2011,31000008,,,,3,1,4
HND-001996,2011,31000009,,,,4,2,6
HND-001997,2011,31000010,,,,4,3,7
HND-001999,2011,31000012,,,,3,4,7
HND-002001,2011,31000014,,,,2,5,7
HND-002002,2011,31000015,,,,4,3,7
HND-002003,2011,31000016,,,,2,2,4
HND-002004,2011,31000018,,,,9,1,10
HND-002005,2011,31000019,,,,5,2,7
HND-002006,2011,31000020,,,,5,3,8
HND-002010,2011,31000024,,,,2,5,7
HND-002012,2011,31000028,,,,2,2,4
HND-002013,2011,31000029,,,,8,10,18
HND-002022,2011,31000040,,,,12,5,17
HND-002023,2011,31000041,,,,3,2,5
HND-002030,2011,31000050,,,,1,5,6
HND-002031,2011,31000051,,,,0,1,1
HND-002032,2011,31000067,,,,1,1,2
HND-001989,2011,31000001,,,,5,5,10
HND-001991,2011,31000003,,,,1,3,4
HND-001992,2011,31000004,,,,6,12,18
HND-001994,2011,31000006,,,,6,3,9
HND-001998,2011,31000011,,,,5,7,12
HND-002000,2011,31000013,,,,7,6,13
HND-002007,2011,31000021,,,,1,2,3
HND-002008,2011,31000022,,,,3,6,9
HND-002009,2011,31000023,,,,9,3,12
HND-002011,2011,31000027,,,,5,7,12
HND-002014,2011,31000030,,,,5,0,5
HND-002015,2011,31000031,,,,4,3,7
HND-002016,2011,31000033,,,,5,0,5
HND-002017,2011,31000034,,,,3,1,4
HND-002018,2011,31000035,,,,2,1,3
HND-002019,2011,31000036,,,,2,4,6
HND-002020,2011,31000037,,,,1,2,3
,2011,31000057,,,,2,6,8
HND-002033,2011,31000072,,,,8,8,16
HND-001989,2011,31000001,,,,4,5,9
HND-001991,2011,31000003,,,,4,6,10
HND-001992,2011,31000004,,,,11,7,18
HND-001993,2011,31000005,,,,17,14,31
HND-001994,2011,31000006,,,,9,5,14
HND-001995,2011,31000008,,,,1,9,10
HND-001996,2011,31000009,,,,6,2,8
HND-001998,2011,31000011,,,,4,1,5
HND-001999,2011,31000012,,,,0,2,2
HND-002000,2011,31000013,,,,2,8,10
HND-002001,2011,31000014,,,,5,7,12
HND-002003,2011,31000016,,,,4,0,4
HND-002006,2011,31000020,,,,3,3,6
HND-002007,2011,31000021,,,,3,3,6
HND-002009,2011,31000023,,,,3,3,6
HND-002010,2011,31000024,,,,0,5,5
HND-002011,2011,31000027,,,,0,1,1
HND-002012,2011,31000028,,,,1,4,5
HND-002014,2011,31000030,,,,0,3,3
HND-002017,2011,31000034,,,,3,3,6
HND-002018,2011,31000035,,,,0,2,2
HND-002019,2011,31000036,,,,1,5,6
HND-002021,2011,31000038,,,,7,2,9
HND-002023,2011,31000041,,,,2,2,4
HND-002033,2011,31000072,,,,2,7,9
HND-001990,2011,31000002,,,,20,14,34
HND-001997,2011,31000010,,,,2,6,8
HND-002002,2011,31000015,,,,2,2,4
HND-002004,2011,31000018,,,,3,2,5
HND-002005,2011,31000019,,,,3,5,8
HND-002008,2011,31000022,,,,3,1,4
HND-002013,2011,31000029,,,,11,7,18
HND-002015,2011,31000031,,,,3,4,7
HND-002016,2011,31000033,,,,0,3,3
HND-002020,2011,31000037,,,,2,2,4
HND-002022,2011,31000040,,,,7,6,13
HND-002030,2011,31000050,,,,3,1,4
HND-002031,2011,31000051,,,,2,1,3
,2011,31000057,,,,6,0,6
HND-002032,2011,31000067,,,,3,2,5
HND-001989,2011,31000001,,,,3,15,18
HND-002025,2011,31000043,,,,32,31,63
HND-002025,2011,31000043,,,,27,27,54
HND-001989,2011,31000001,,,,10,6,16
HND-001989,2011,31000001,,,,11,2,13
HND-002025,2011,31000043,,,,18,33,51
HND-002025,2011,31000043,,,,6,1,7
HND-002025,2011,31000043,,,,10,4,14
HND-002025,2011,31000043,,,,3,3,6
,2011,31100050,,,,4,2,6
HND-002109,2011,31100055,,,,6,7,13
,2011,31100056,,,,4,5,9
HND-002110,2011,31100058,,,,5,2,7
HND-002111,2011,31100063,,,,9,11,20
,2011,31100067,,,,5,1,6
HND-002113,2011,31100076,,,,6,2,8
HND-002115,2011,31100078,,,,3,3,6
HND-002116,2011,31100079,,,,2,6,8
,2011,31100081,,,,6,2,8
,2011,31100082,,,,5,1,6
,2011,31100083,,,,0,8,8
,2011,31100038,,,,12,10,22
HND-002107,2011,31100051,,,,9,10,19
,2011,31100052,,,,9,2,11
,2011,31100064,,,,7,0,7
,2011,31100065,,,,7,3,10
,2011,31100066,,,,1,5,6
,2011,31100068,,,,8,3,11
HND-002112,2011,31100073,,,,4,3,7
HND-002114,2011,31100077,,,,5,3,8
HND-002117,2011,31100085,,,,5,6,11
,2011,31100090,,,,0,5,5
HND-002119,2011,31100087,,,,5,4,9
HND-002120,2011,31100088,,,,1,2,3
HND-002072,2011,31100008,,,,16,17,33
HND-002099,2011,31100037,,,,3,3,6
HND-002103,2011,31100043,,,,10,14,24
HND-002106,2011,31100049,,,,11,4,15
HND-002119,2011,31100087,,,,4,2,6
HND-002097,2011,31100035,,,,6,2,8
HND-002100,2011,31100039,,,,2,0,2
HND-002101,2011,31100040,,,,7,5,12
HND-002102,2011,31100042,,,,3,5,8
HND-002120,2011,31100088,,,,4,1,5
HND-002096,2011,31100034,,,,6,8,14
HND-002097,2011,31100035,,,,6,3,9
HND-002099,2011,31100037,,,,6,9,15
HND-002100,2011,31100039,,,,11,8,19
HND-002101,2011,31100040,,,,10,4,14
HND-002102,2011,31100042,,,,5,5,10
HND-002120,2011,31100088,,,,1,4,5
HND-002072,2011,31100008,,,,6,19,25
HND-002103,2011,31100043,,,,11,13,24
HND-002106,2011,31100049,,,,7,6,13
HND-002119,2011,31100087,,,,5,0,5
HND-002065,2011,31100001,,,,2,4,6
HND-002067,2011,31100003,,,,5,4,9
HND-002068,2011,31100004,,,,6,6,12
HND-002070,2011,31100006,,,,11,7,18
HND-002071,2011,31100007,,,,11,7,18
HND-002072,2011,31100008,,,,25,17,42
HND-002083,2011,31100019,,,,16,10,26
HND-002084,2011,31100020,,,,5,7,12
HND-002087,2011,31100024,,,,2,2,4
HND-002088,2011,31100025,,,,3,0,3
HND-002089,2011,31100026,,,,3,3,6
HND-002091,2011,31100028,,,,9,7,16
HND-002093,2011,31100031,,,,1,2,3
HND-002094,2011,31100032,,,,3,0,3
HND-002095,2011,31100033,,,,3,1,4
HND-002104,2011,31100047,,,,0,1,1
HND-002118,2011,31100086,,,,8,4,12
HND-002066,2011,31100002,,,,13,14,27
HND-002069,2011,31100005,,,,4,10,14
HND-002073,2011,31100009,,,,2,1,3
HND-002074,2011,31100010,,,,16,6,22
HND-002075,2011,31100011,,,,4,1,5
HND-002076,2011,31100012,,,,5,6,11
HND-002077,2011,31100013,,,,1,1,2
HND-002078,2011,31100014,,,,12,8,20
HND-002079,2011,31100015,,,,5,8,13
HND-002080,2011,31100016,,,,3,5,8
HND-002081,2011,31100017,,,,7,3,10
HND-002082,2011,31100018,,,,2,6,8
HND-002085,2011,31100021,,,,5,4,9
,2011,31100022,,,,4,2,6
HND-002086,2011,31100023,,,,2,3,5
HND-002090,2011,31100027,,,,3,3,6
HND-002092,2011,31100029,,,,5,5,10
,2011,31100030,,,,2,0,2
HND-002105,2011,31100048,,,,5,3,8
,2011,31100053,,,,2,1,3
HND-002108,2011,31100054,,,,4,2,6
HND-002110,2011,31100058,,,,2,1,3
HND-002121,2011,31100089,,,,0,2,2
HND-002065,2011,31100001,,,,3,2,5
HND-002066,2011,31100002,,,,11,25,36
HND-002067,2011,31100003,,,,2,2,4
HND-002071,2011,31100007,,,,5,8,13
HND-002072,2011,31100008,,,,20,16,36
HND-002079,2011,31100015,,,,5,6,11
HND-002080,2011,31100016,,,,5,1,6
HND-002082,2011,31100018,,,,5,2,7
HND-002083,2011,31100019,,,,9,5,14
HND-002084,2011,31100020,,,,7,5,12
HND-002085,2011,31100021,,,,1,2,3
,2011,31100022,,,,1,1,2
HND-002086,2011,31100023,,,,2,3,5
HND-002087,2011,31100024,,,,2,3,5
HND-002088,2011,31100025,,,,2,1,3
HND-002089,2011,31100026,,,,4,0,4
HND-002090,2011,31100027,,,,5,0,5
HND-002091,2011,31100028,,,,10,10,20
,2011,31100030,,,,2,1,3
HND-002093,2011,31100031,,,,0,1,1
HND-002094,2011,31100032,,,,0,1,1
HND-002095,2011,31100033,,,,2,0,2
,2011,31100053,,,,4,4,8
HND-002118,2011,31100086,,,,2,3,5
HND-002121,2011,31100089,,,,2,0,2
HND-002068,2011,31100004,,,,11,9,20
HND-002069,2011,31100005,,,,7,9,16
HND-002070,2011,31100006,,,,14,13,27
HND-002073,2011,31100009,,,,2,1,3
HND-002074,2011,31100010,,,,3,6,9
HND-002075,2011,31100011,,,,5,8,13
HND-002076,2011,31100012,,,,4,4,8
HND-002077,2011,31100013,,,,2,1,3
HND-002078,2011,31100014,,,,6,3,9
HND-002081,2011,31100017,,,,8,6,14
HND-002092,2011,31100029,,,,3,1,4
HND-002104,2011,31100047,,,,2,0,2
HND-002105,2011,31100048,,,,3,3,6
HND-002108,2011,31100054,,,,2,4,6
HND-002110,2011,31100058,,,,2,0,2
HND-002069,2011,31100005,,,,8,5,13
HND-002070,2011,31100006,,,,17,11,28
HND-002073,2011,31100009,,,,5,2,7
HND-002074,2011,31100010,,,,10,9,19
HND-002075,2011,31100011,,,,2,5,7
HND-002076,2011,31100012,,,,4,4,8
HND-002077,2011,31100013,,,,2,0,2
HND-002078,2011,31100014,,,,8,5,13
HND-002079,2011,31100015,,,,2,6,8
HND-002080,2011,31100016,,,,2,3,5
HND-002081,2011,31100017,,,,2,4,6
HND-002082,2011,31100018,,,,5,2,7
HND-002085,2011,31100021,,,,3,5,8
,2011,31100022,,,,2,3,5
HND-002086,2011,31100023,,,,2,2,4
HND-002090,2011,31100027,,,,2,3,5
HND-002092,2011,31100029,,,,0,3,3
,2011,31100030,,,,0,1,1
HND-002105,2011,31100048,,,,1,4,5
,2011,31100053,,,,1,2,3
HND-002108,2011,31100054,,,,4,1,5
HND-002110,2011,31100058,,,,1,0,1
HND-002121,2011,31100089,,,,0,1,1
HND-002065,2011,31100001,,,,4,1,5
HND-002066,2011,31100002,,,,13,7,20
HND-002067,2011,31100003,,,,2,1,3
HND-002068,2011,31100004,,,,10,5,15
HND-002071,2011,31100007,,,,7,7,14
HND-002072,2011,31100008,,,,17,14,31
HND-002083,2011,31100019,,,,11,5,16
HND-002084,2011,31100020,,,,4,9,13
HND-002087,2011,31100024,,,,2,3,5
HND-002088,2011,31100025,,,,2,3,5
HND-002089,2011,31100026,,,,3,4,7
HND-002091,2011,31100028,,,,10,7,17
HND-002093,2011,31100031,,,,0,1,1
HND-002095,2011,31100033,,,,3,0,3
HND-002104,2011,31100047,,,,2,1,3
HND-002118,2011,31100086,,,,3,1,4
HND-002066,2011,31100002,,,,7,6,13
HND-002072,2011,31100008,,,,12,16,28
HND-002076,2011,31100012,,,,5,5,10
HND-002078,2011,31100014,,,,7,8,15
HND-002079,2011,31100015,,,,7,8,15
HND-002080,2011,31100016,,,,5,2,7
HND-002082,2011,31100018,,,,1,5,6
HND-002083,2011,31100019,,,,6,6,12
HND-002084,2011,31100020,,,,3,3,6
HND-002085,2011,31100021,,,,2,0,2
,2011,31100022,,,,4,7,11
HND-002086,2011,31100023,,,,2,6,8
HND-002087,2011,31100024,,,,1,0,1
HND-002088,2011,31100025,,,,3,0,3
HND-002089,2011,31100026,,,,2,1,3
HND-002090,2011,31100027,,,,1,2,3
HND-002091,2011,31100028,,,,4,17,21
HND-002092,2011,31100029,,,,1,3,4
HND-002093,2011,31100031,,,,2,1,3
HND-002095,2011,31100033,,,,2,0,2
,2011,31100053,,,,1,0,1
HND-002118,2011,31100086,,,,1,2,3
HND-002121,2011,31100089,,,,2,2,4
HND-002065,2011,31100001,,,,4,1,5
HND-002067,2011,31100003,,,,3,5,8
HND-002068,2011,31100004,,,,4,5,9
HND-002069,2011,31100005,,,,12,9,21
HND-002070,2011,31100006,,,,5,6,11
HND-002071,2011,31100007,,,,8,2,10
HND-002073,2011,31100009,,,,2,1,3
HND-002074,2011,31100010,,,,5,8,13
HND-002075,2011,31100011,,,,2,3,5
HND-002077,2011,31100013,,,,1,1,2
HND-002081,2011,31100017,,,,3,3,6
HND-002104,2011,31100047,,,,2,0,2
HND-002105,2011,31100048,,,,3,1,4
HND-002108,2011,31100054,,,,1,0,1
HND-002110,2011,31100058,,,,2,1,3
HND-002066,2011,31100002,,,,16,13,29
HND-002075,2011,31100011,,,,1,4,5
HND-002076,2011,31100012,,,,4,2,6
HND-002077,2011,31100013,,,,0,1,1
HND-002078,2011,31100014,,,,4,7,11
HND-002079,2011,31100015,,,,3,7,10
HND-002080,2011,31100016,,,,1,3,4
HND-002081,2011,31100017,,,,1,5,6
HND-002082,2011,31100018,,,,1,0,1
HND-002083,2011,31100019,,,,4,10,14
HND-002085,2011,31100021,,,,1,1,2
,2011,31100022,,,,0,5,5
HND-002086,2011,31100023,,,,3,2,5
HND-002087,2011,31100024,,,,2,0,2
HND-002089,2011,31100026,,,,2,3,5
HND-002090,2011,31100027,,,,0,4,4
HND-002092,2011,31100029,,,,3,1,4
HND-002093,2011,31100031,,,,0,1,1
HND-002094,2011,31100032,,,,1,1,2
HND-002104,2011,31100047,,,,5,3,8
HND-002118,2011,31100086,,,,1,2,3
HND-002065,2011,31100001,,,,1,1,2
HND-002067,2011,31100003,,,,1,0,1
HND-002068,2011,31100004,,,,6,11,17
HND-002069,2011,31100005,,,,12,10,22
HND-002070,2011,31100006,,,,12,9,21
HND-002071,2011,31100007,,,,9,9,18
HND-002072,2011,31100008,,,,16,24,40
HND-002074,2011,31100010,,,,5,13,18
HND-002084,2011,31100020,,,,7,9,16
HND-002088,2011,31100025,,,,1,3,4
HND-002091,2011,31100028,,,,7,7,14
,2011,31100030,,,,3,2,5
HND-002105,2011,31100048,,,,1,2,3
,2011,31100053,,,,1,0,1
HND-002108,2011,31100054,,,,2,1,3
HND-002110,2011,31100058,,,,1,2,3
HND-002121,2011,31100089,,,,0,3,3
HND-002068,2011,31100004,,,,7,11,18
HND-002069,2011,31100005,,,,10,8,18
HND-002070,2011,31100006,,,,9,7,16
HND-002073,2011,31100009,,,,3,1,4
HND-002074,2011,31100010,,,,8,5,13
HND-002075,2011,31100011,,,,5,2,7
HND-002076,2011,31100012,,,,3,3,6
HND-002077,2011,31100013,,,,0,1,1
HND-002078,2011,31100014,,,,16,9,25
HND-002081,2011,31100017,,,,5,0,5
HND-002092,2011,31100029,,,,1,2,3
HND-002104,2011,31100047,,,,0,4,4
HND-002105,2011,31100048,,,,1,0,1
HND-002108,2011,31100054,,,,0,1,1
HND-002110,2011,31100058,,,,1,0,1
HND-002065,2011,31100001,,,,3,0,3
HND-002066,2011,31100002,,,,13,12,25
HND-002067,2011,31100003,,,,1,1,2
HND-002071,2011,31100007,,,,5,7,12
HND-002072,2011,31100008,,,,19,34,53
HND-002079,2011,31100015,,,,0,1,1
HND-002080,2011,31100016,,,,1,2,3
HND-002082,2011,31100018,,,,1,5,6
HND-002083,2011,31100019,,,,6,7,13
HND-002084,2011,31100020,,,,5,6,11
HND-002085,2011,31100021,,,,2,1,3
,2011,31100022,,,,2,1,3
HND-002086,2011,31100023,,,,1,3,4
HND-002087,2011,31100024,,,,1,2,3
HND-002088,2011,31100025,,,,1,0,1
HND-002089,2011,31100026,,,,0,1,1
HND-002090,2011,31100027,,,,1,1,2
HND-002091,2011,31100028,,,,14,5,19
HND-002093,2011,31100031,,,,3,0,3
HND-002095,2011,31100033,,,,2,2,4
HND-002121,2011,31100089,,,,3,1,4
HND-002083,2011,31100019,,,,21,15,36
HND-002098,2011,31100036,,,,94,78,172
HND-002083,2011,31100019,,,,11,16,27
HND-002098,2011,31100036,,,,69,72,141
HND-002083,2011,31100019,,,,20,8,28
HND-002098,2011,31100036,,,,59,53,112
HND-002098,2011,31100036,,,,85,57,142
HND-002098,2011,31100036,,,,56,63,119
HND-002098,2011,31100036,,,,40,38,78
HND-002126,2011,31200006,,,,4,8,12
HND-002131,2011,31200011,,,,5,3,8
HND-002135,2011,31200015,,,,7,4,11
HND-002143,2011,31200023,,,,7,9,16
HND-002148,2011,31200029,,,,5,7,12
,2011,31200069,,,,8,4,12
HND-002164,2011,31200070,,,,8,7,15
,2011,31200074,,,,5,3,8
,2011,31200078,,,,4,2,6
HND-002167,2011,31200083,,,,6,10,16
HND-002127,2011,31200007,,,,1,4,5
HND-002149,2011,31200030,,,,8,10,18
HND-002151,2011,31200032,,,,6,8,14
,2011,31200034,,,,6,5,11
,2011,31200036,,,,4,8,12
,2011,31200067,,,,7,7,14
,2011,31200071,,,,3,5,8
,2011,31200077,,,,3,3,6
,2011,31200085,,,,3,6,9
,2011,31200088,,,,1,4,5
HND-002147,2011,31200027,,,,1,1,2
HND-002154,2011,31200042,,,,4,4,8
,2011,31200089,,,,1,3,4
HND-002154,2011,31200042,,,,4,3,7
HND-002146,2011,31200026,,,,10,8,18
HND-002147,2011,31200027,,,,1,3,4
HND-002152,2011,31200035,,,,1,1,2
HND-002165,2011,31200073,,,,3,1,4
,2011,31200089,,,,1,2,3
HND-002147,2011,31200027,,,,2,3,5
HND-002152,2011,31200035,,,,1,5,6
HND-002153,2011,31200037,,,,15,16,31
HND-002165,2011,31200073,,,,7,5,12
,2011,31200089,,,,3,4,7
HND-002146,2011,31200026,,,,13,16,29
HND-002154,2011,31200042,,,,1,1,2
HND-002125,2011,31200005,,,,4,8,12
HND-002128,2011,31200008,,,,11,15,26
HND-002129,2011,31200009,,,,2,1,3
HND-002130,2011,31200010,,,,4,4,8
HND-002132,2011,31200012,,,,8,6,14
HND-002134,2011,31200014,,,,8,3,11
HND-002135,2011,31200015,,,,6,7,13
HND-002136,2011,31200016,,,,4,6,10
HND-002138,2011,31200018,,,,4,4,8
HND-002139,2011,31200019,,,,3,5,8
HND-002140,2011,31200020,,,,1,2,3
HND-002145,2011,31200025,,,,6,8,14
HND-002150,2011,31200031,,,,3,2,5
HND-002154,2011,31200042,,,,8,4,12
HND-002156,2011,31200044,,,,5,7,12
HND-002158,2011,31200049,,,,7,7,14
HND-002161,2011,31200056,,,,2,3,5
HND-002122,2011,31200002,,,,23,20,43
HND-002123,2011,31200003,,,,10,6,16
HND-002124,2011,31200004,,,,13,10,23
HND-002127,2011,31200007,,,,1,5,6
HND-002131,2011,31200011,,,,4,2,6
HND-002133,2011,31200013,,,,6,5,11
HND-002137,2011,31200017,,,,8,2,10
HND-002141,2011,31200021,,,,6,3,9
HND-002142,2011,31200022,,,,9,3,12
HND-002143,2011,31200023,,,,7,7,14
HND-002144,2011,31200024,,,,3,2,5
HND-002147,2011,31200027,,,,4,5,9
HND-002155,2011,31200043,,,,0,2,2
HND-002159,2011,31200051,,,,3,3,6
HND-002160,2011,31200053,,,,1,2,3
HND-002162,2011,31200064,,,,1,1,2
HND-002163,2011,31200066,,,,4,3,7
HND-002168,2011,31200090,,,,2,3,5
HND-002169,2011,31200091,,,,4,3,7
HND-002123,2011,31200003,,,,9,3,12
HND-002124,2011,31200004,,,,12,12,24
HND-002125,2011,31200005,,,,3,7,10
HND-002127,2011,31200007,,,,4,2,6
HND-002128,2011,31200008,,,,11,13,24
HND-002129,2011,31200009,,,,2,2,4
HND-002130,2011,31200010,,,,6,0,6
HND-002131,2011,31200011,,,,4,2,6
HND-002132,2011,31200012,,,,9,5,14
HND-002133,2011,31200013,,,,6,6,12
HND-002134,2011,31200014,,,,3,2,5
HND-002135,2011,31200015,,,,10,7,17
HND-002136,2011,31200016,,,,5,1,6
HND-002137,2011,31200017,,,,9,7,16
HND-002138,2011,31200018,,,,3,0,3
HND-002140,2011,31200020,,,,6,3,9
HND-002141,2011,31200021,,,,8,8,16
HND-002142,2011,31200022,,,,4,7,11
HND-002143,2011,31200023,,,,5,7,12
HND-002144,2011,31200024,,,,3,4,7
HND-002145,2011,31200025,,,,1,0,1
HND-002147,2011,31200027,,,,1,5,6
HND-002150,2011,31200031,,,,3,1,4
HND-002158,2011,31200049,,,,4,2,6
HND-002122,2011,31200002,,,,21,19,40
HND-002139,2011,31200019,,,,1,1,2
HND-002154,2011,31200042,,,,6,2,8
HND-002155,2011,31200043,,,,4,1,5
HND-002156,2011,31200044,,,,1,5,6
HND-002159,2011,31200051,,,,1,2,3
HND-002161,2011,31200056,,,,2,0,2
HND-002162,2011,31200064,,,,0,1,1
HND-002163,2011,31200066,,,,3,5,8
HND-002168,2011,31200090,,,,5,0,5
HND-002124,2011,31200004,,,,13,11,24
HND-002125,2011,31200005,,,,6,3,9
HND-002128,2011,31200008,,,,7,4,11
HND-002130,2011,31200010,,,,6,5,11
HND-002132,2011,31200012,,,,10,6,16
HND-002133,2011,31200013,,,,4,7,11
HND-002134,2011,31200014,,,,6,2,8
HND-002135,2011,31200015,,,,13,8,21
HND-002136,2011,31200016,,,,2,3,5
HND-002138,2011,31200018,,,,4,4,8
HND-002139,2011,31200019,,,,0,2,2
HND-002140,2011,31200020,,,,3,3,6
HND-002144,2011,31200024,,,,1,1,2
HND-002145,2011,31200025,,,,1,7,8
HND-002155,2011,31200043,,,,3,0,3
HND-002159,2011,31200051,,,,1,0,1
HND-002160,2011,31200053,,,,2,2,4
HND-002168,2011,31200090,,,,1,3,4
HND-002122,2011,31200002,,,,12,18,30
HND-002123,2011,31200003,,,,8,8,16
HND-002127,2011,31200007,,,,1,3,4
HND-002131,2011,31200011,,,,2,1,3
HND-002137,2011,31200017,,,,3,4,7
HND-002141,2011,31200021,,,,5,2,7
HND-002142,2011,31200022,,,,2,7,9
HND-002143,2011,31200023,,,,6,5,11
HND-002147,2011,31200027,,,,4,3,7
HND-002150,2011,31200031,,,,2,2,4
HND-002154,2011,31200042,,,,3,1,4
HND-002156,2011,31200044,,,,3,2,5
HND-002158,2011,31200049,,,,4,10,14
HND-002162,2011,31200064,,,,3,0,3
HND-002163,2011,31200066,,,,5,2,7
HND-002123,2011,31200003,,,,2,6,8
HND-002124,2011,31200004,,,,22,8,30
HND-002125,2011,31200005,,,,6,4,10
HND-002127,2011,31200007,,,,2,5,7
HND-002128,2011,31200008,,,,12,7,19
HND-002131,2011,31200011,,,,5,1,6
HND-002132,2011,31200012,,,,5,8,13
HND-002133,2011,31200013,,,,9,7,16
HND-002134,2011,31200014,,,,9,5,14
HND-002137,2011,31200017,,,,3,3,6
HND-002140,2011,31200020,,,,3,2,5
HND-002141,2011,31200021,,,,5,2,7
HND-002142,2011,31200022,,,,3,5,8
HND-002143,2011,31200023,,,,6,7,13
HND-002144,2011,31200024,,,,1,2,3
HND-002145,2011,31200025,,,,1,6,7
HND-002147,2011,31200027,,,,1,3,4
HND-002150,2011,31200031,,,,2,0,2
HND-002158,2011,31200049,,,,4,5,9
HND-002169,2011,31200091,,,,1,1,2
HND-002122,2011,31200002,,,,23,24,47
HND-002129,2011,31200009,,,,2,3,5
HND-002130,2011,31200010,,,,2,3,5
HND-002135,2011,31200015,,,,5,8,13
HND-002136,2011,31200016,,,,5,2,7
HND-002138,2011,31200018,,,,3,3,6
HND-002139,2011,31200019,,,,1,2,3
HND-002154,2011,31200042,,,,0,2,2
HND-002155,2011,31200043,,,,4,2,6
HND-002156,2011,31200044,,,,1,1,2
HND-002159,2011,31200051,,,,1,0,1
HND-002160,2011,31200053,,,,0,2,2
HND-002161,2011,31200056,,,,2,6,8
HND-002162,2011,31200064,,,,3,0,3
HND-002163,2011,31200066,,,,4,5,9
HND-002123,2011,31200003,,,,7,5,12
HND-002124,2011,31200004,,,,14,9,23
HND-002127,2011,31200007,,,,5,1,6
HND-002131,2011,31200011,,,,3,2,5
HND-002133,2011,31200013,,,,8,7,15
HND-002137,2011,31200017,,,,6,2,8
HND-002141,2011,31200021,,,,6,8,14
HND-002142,2011,31200022,,,,8,2,10
HND-002143,2011,31200023,,,,12,3,15
HND-002144,2011,31200024,,,,0,4,4
HND-002147,2011,31200027,,,,2,2,4
HND-002150,2011,31200031,,,,2,4,6
HND-002156,2011,31200044,,,,4,1,5
HND-002158,2011,31200049,,,,9,4,13
HND-002162,2011,31200064,,,,2,3,5
HND-002163,2011,31200066,,,,2,2,4
HND-002122,2011,31200002,,,,25,13,38
HND-002125,2011,31200005,,,,2,3,5
HND-002128,2011,31200008,,,,9,5,14
HND-002130,2011,31200010,,,,5,6,11
HND-002132,2011,31200012,,,,3,8,11
HND-002134,2011,31200014,,,,11,7,18
HND-002135,2011,31200015,,,,8,4,12
HND-002136,2011,31200016,,,,0,2,2
HND-002138,2011,31200018,,,,2,2,4
HND-002139,2011,31200019,,,,1,0,1
HND-002140,2011,31200020,,,,5,7,12
HND-002145,2011,31200025,,,,2,0,2
HND-002154,2011,31200042,,,,2,7,9
HND-002155,2011,31200043,,,,2,1,3
HND-002159,2011,31200051,,,,2,1,3
HND-002160,2011,31200053,,,,1,1,2
HND-002161,2011,31200056,,,,1,0,1
HND-002169,2011,31200091,,,,1,1,2
HND-002122,2011,31200002,,,,19,21,40
HND-002139,2011,31200019,,,,1,0,1
HND-002154,2011,31200042,,,,3,2,5
HND-002155,2011,31200043,,,,1,1,2
HND-002156,2011,31200044,,,,0,4,4
HND-002159,2011,31200051,,,,2,1,3
HND-002160,2011,31200053,,,,0,1,1
HND-002162,2011,31200064,,,,2,2,4
HND-002163,2011,31200066,,,,4,0,4
HND-002168,2011,31200090,,,,2,2,4
HND-002123,2011,31200003,,,,9,3,12
HND-002124,2011,31200004,,,,14,12,26
HND-002125,2011,31200005,,,,6,8,14
HND-002127,2011,31200007,,,,4,4,8
HND-002128,2011,31200008,,,,8,10,18
HND-002129,2011,31200009,,,,0,4,4
HND-002130,2011,31200010,,,,4,2,6
HND-002131,2011,31200011,,,,1,3,4
HND-002132,2011,31200012,,,,8,11,19
HND-002133,2011,31200013,,,,4,4,8
HND-002134,2011,31200014,,,,6,8,14
HND-002135,2011,31200015,,,,4,5,9
HND-002136,2011,31200016,,,,2,4,6
HND-002137,2011,31200017,,,,2,5,7
HND-002138,2011,31200018,,,,0,3,3
HND-002140,2011,31200020,,,,2,0,2
HND-002141,2011,31200021,,,,5,2,7
HND-002142,2011,31200022,,,,6,8,14
HND-002143,2011,31200023,,,,6,7,13
HND-002144,2011,31200024,,,,2,1,3
HND-002145,2011,31200025,,,,2,3,5
HND-002150,2011,31200031,,,,3,5,8
HND-002158,2011,31200049,,,,4,8,12
HND-002122,2011,31200002,,,,13,19,32
HND-002129,2011,31200009,,,,6,4,10
HND-002130,2011,31200010,,,,11,15,26
HND-002132,2011,31200012,,,,9,18,27
HND-002124,2011,31200004,,,,21,7,28
HND-002124,2011,31200004,,,,6,8,14
HND-002129,2011,31200009,,,,11,3,14
HND-002130,2011,31200010,,,,7,13,20
HND-002132,2011,31200012,,,,8,8,16
HND-002122,2011,31200002,,,,16,22,38
HND-002124,2011,31200004,,,,7,15,22
HND-002129,2011,31200009,,,,2,6,8
HND-002132,2011,31200012,,,,7,4,11
HND-002122,2011,31200002,,,,21,15,36
HND-002130,2011,31200010,,,,7,10,17
HND-002157,2011,31200045,,,,14,14,28
HND-002157,2011,31200045,,,,21,15,36
HND-002157,2011,31200045,,,,22,12,34
HND-002220,2011,31300058,,,,7,5,12
,2011,31300066,,,,18,9,27
HND-002230,2011,31300071,,,,9,12,21
HND-002242,2011,31300085,,,,6,9,15
,2011,31300088,,,,10,9,19
,2011,31300089,,,,4,5,9
HND-002248,2011,31300119,,,,6,8,14
,2011,31300120,,,,4,3,7
,2011,31300122,,,,8,8,16
HND-002252,2011,31300130,,,,4,8,12
,2011,31300131,,,,3,3,6
HND-002175,2011,31300006,,,,5,7,12
HND-002199,2011,31300030,,,,3,4,7
HND-002241,2011,31300084,,,,7,14,21
,2011,31300086,,,,7,6,13
,2011,31300087,,,,9,11,20
,2011,31300112,,,,5,5,10
,2011,31300115,,,,5,7,12
HND-002246,2011,31300117,,,,6,6,12
HND-002247,2011,31300118,,,,10,8,18
,2011,31300123,,,,4,3,7
,2011,31300124,,,,7,6,13
,2011,31300125,,,,6,3,9
HND-002251,2011,31300126,,,,3,7,10
,2011,31300127,,,,6,5,11
,2011,31300128,,,,5,4,9
,2011,31300129,,,,7,6,13
,2011,31300134,,,,5,4,9
HND-002202,2011,31300033,,,,3,3,6
HND-002206,2011,31300038,,,,0,2,2
HND-002207,2011,31300039,,,,2,5,7
,2011,31300042,,,,0,2,2
HND-002212,2011,31300044,,,,1,0,1
HND-002214,2011,31300046,,,,2,4,6
HND-002224,2011,31300062,,,,1,3,4
HND-002221,2011,31300059,,,,1,1,2
HND-002226,2011,31300067,,,,2,0,2
HND-002202,2011,31300033,,,,5,1,6
HND-002207,2011,31300039,,,,13,15,28
HND-002209,2011,31300041,,,,1,2,3
,2011,31300042,,,,4,4,8
HND-002211,2011,31300043,,,,0,4,4
HND-002221,2011,31300059,,,,1,2,3
HND-002225,2011,31300065,,,,4,5,9
HND-002227,2011,31300068,,,,0,1,1
HND-002232,2011,31300074,,,,5,10,15
HND-002249,2011,31300121,,,,4,2,6
HND-002206,2011,31300038,,,,1,2,3
HND-002208,2011,31300040,,,,2,0,2
HND-002213,2011,31300045,,,,0,1,1
HND-002214,2011,31300046,,,,2,2,4
HND-002215,2011,31300048,,,,9,8,17
HND-002216,2011,31300049,,,,3,1,4
HND-002223,2011,31300061,,,,3,4,7
HND-002224,2011,31300062,,,,3,5,8
HND-002226,2011,31300067,,,,5,4,9
HND-002202,2011,31300033,,,,6,4,10
HND-002206,2011,31300038,,,,4,2,6
HND-002207,2011,31300039,,,,24,21,45
HND-002208,2011,31300040,,,,13,7,20
,2011,31300042,,,,6,3,9
HND-002212,2011,31300044,,,,4,5,9
HND-002213,2011,31300045,,,,4,0,4
HND-002214,2011,31300046,,,,3,1,4
HND-002215,2011,31300048,,,,13,10,23
HND-002216,2011,31300049,,,,12,12,24
HND-002223,2011,31300061,,,,6,8,14
HND-002224,2011,31300062,,,,2,7,9
HND-002226,2011,31300067,,,,5,3,8
HND-002249,2011,31300121,,,,8,13,21
HND-002209,2011,31300041,,,,1,2,3
HND-002211,2011,31300043,,,,3,7,10
HND-002221,2011,31300059,,,,0,2,2
HND-002225,2011,31300065,,,,6,8,14
HND-002227,2011,31300068,,,,4,7,11
HND-002232,2011,31300074,,,,1,6,7
HND-002171,2011,31300001,,,,3,2,5
HND-002172,2011,31300002,,,,6,6,12
HND-002173,2011,31300003,,,,3,1,4
HND-002180,2011,31300011,,,,5,6,11
HND-002182,2011,31300013,,,,8,3,11
HND-002185,2011,31300016,,,,7,2,9
HND-002186,2011,31300017,,,,4,14,18
HND-002190,2011,31300021,,,,10,5,15
HND-002191,2011,31300022,,,,16,15,31
HND-002192,2011,31300023,,,,3,2,5
HND-002193,2011,31300024,,,,8,7,15
HND-002195,2011,31300026,,,,3,2,5
HND-002196,2011,31300027,,,,7,11,18
HND-002200,2011,31300031,,,,3,2,5
HND-002201,2011,31300032,,,,1,1,2
HND-002202,2011,31300033,,,,11,11,22
HND-002203,2011,31300034,,,,7,5,12
HND-002205,2011,31300037,,,,10,6,16
HND-002209,2011,31300041,,,,5,5,10
HND-002212,2011,31300044,,,,3,7,10
HND-002214,2011,31300046,,,,1,5,6
HND-002228,2011,31300069,,,,5,5,10
HND-002229,2011,31300070,,,,1,2,3
HND-002231,2011,31300072,,,,7,6,13
HND-002233,2011,31300075,,,,3,0,3
HND-002234,2011,31300076,,,,2,2,4
HND-002243,2011,31300090,,,,2,2,4
HND-002245,2011,31300109,,,,3,10,13
HND-002253,2011,31300132,,,,5,7,12
HND-002174,2011,31300004,,,,0,2,2
HND-002175,2011,31300006,,,,3,3,6
HND-002176,2011,31300007,,,,29,25,54
HND-002177,2011,31300008,,,,24,23,47
HND-002178,2011,31300009,,,,15,11,26
HND-002179,2011,31300010,,,,9,10,19
HND-002181,2011,31300012,,,,7,6,13
HND-002183,2011,31300014,,,,4,4,8
HND-002184,2011,31300015,,,,4,3,7
HND-002187,2011,31300018,,,,11,12,23
HND-002188,2011,31300019,,,,3,2,5
HND-002189,2011,31300020,,,,4,13,17
HND-002194,2011,31300025,,,,6,6,12
HND-002197,2011,31300028,,,,5,7,12
HND-002198,2011,31300029,,,,12,9,21
HND-002199,2011,31300030,,,,5,4,9
HND-002204,2011,31300035,,,,2,4,6
HND-002206,2011,31300038,,,,5,9,14
HND-002211,2011,31300043,,,,5,6,11
HND-002213,2011,31300045,,,,4,3,7
HND-002218,2011,31300056,,,,5,5,10
HND-002219,2011,31300057,,,,6,5,11
HND-002221,2011,31300059,,,,2,3,5
HND-002222,2011,31300060,,,,5,1,6
HND-002227,2011,31300068,,,,11,7,18
HND-002237,2011,31300079,,,,9,8,17
HND-002238,2011,31300080,,,,9,9,18
HND-002239,2011,31300081,,,,6,7,13
HND-002240,2011,31300082,,,,5,2,7
HND-002244,2011,31300104,,,,1,4,5
HND-002254,2011,31300133,,,,2,2,4
HND-002171,2011,31300001,,,,9,3,12
HND-002172,2011,31300002,,,,6,3,9
HND-002173,2011,31300003,,,,3,3,6
HND-002174,2011,31300004,,,,4,4,8
HND-002175,2011,31300006,,,,6,5,11
HND-002177,2011,31300008,,,,15,14,29
HND-002178,2011,31300009,,,,12,9,21
HND-002179,2011,31300010,,,,7,7,14
HND-002180,2011,31300011,,,,6,2,8
HND-002181,2011,31300012,,,,7,8,15
HND-002182,2011,31300013,,,,6,0,6
HND-002183,2011,31300014,,,,3,8,11
HND-002184,2011,31300015,,,,6,7,13
HND-002186,2011,31300017,,,,10,7,17
HND-002187,2011,31300018,,,,13,16,29
HND-002189,2011,31300020,,,,10,13,23
HND-002191,2011,31300022,,,,12,10,22
HND-002192,2011,31300023,,,,5,4,9
HND-002193,2011,31300024,,,,2,4,6
HND-002194,2011,31300025,,,,1,2,3
HND-002195,2011,31300026,,,,6,1,7
HND-002197,2011,31300028,,,,2,7,9
HND-002198,2011,31300029,,,,5,3,8
HND-002199,2011,31300030,,,,7,2,9
HND-002201,2011,31300032,,,,3,6,9
HND-002202,2011,31300033,,,,4,5,9
HND-002203,2011,31300034,,,,3,1,4
HND-002204,2011,31300035,,,,0,1,1
HND-002206,2011,31300038,,,,4,4,8
HND-002211,2011,31300043,,,,6,3,9
HND-002212,2011,31300044,,,,3,7,10
HND-002213,2011,31300045,,,,4,3,7
HND-002214,2011,31300046,,,,4,1,5
HND-002219,2011,31300057,,,,9,3,12
HND-002235,2011,31300077,,,,2,1,3
HND-002239,2011,31300081,,,,1,4,5
HND-002240,2011,31300082,,,,4,1,5
HND-002245,2011,31300109,,,,3,4,7
HND-002176,2011,31300007,,,,32,22,54
HND-002185,2011,31300016,,,,3,3,6
HND-002188,2011,31300019,,,,7,6,13
HND-002190,2011,31300021,,,,13,8,21
HND-002196,2011,31300027,,,,7,5,12
HND-002200,2011,31300031,,,,6,1,7
HND-002205,2011,31300037,,,,10,3,13
HND-002209,2011,31300041,,,,5,1,6
HND-002218,2011,31300056,,,,4,2,6
HND-002221,2011,31300059,,,,3,2,5
HND-002222,2011,31300060,,,,2,2,4
HND-002227,2011,31300068,,,,7,7,14
HND-002228,2011,31300069,,,,2,3,5
HND-002229,2011,31300070,,,,3,1,4
HND-002231,2011,31300072,,,,5,5,10
HND-002233,2011,31300075,,,,2,2,4
HND-002234,2011,31300076,,,,2,2,4
HND-002237,2011,31300079,,,,13,10,23
HND-002238,2011,31300080,,,,13,8,21
HND-002243,2011,31300090,,,,3,3,6
HND-002244,2011,31300104,,,,0,7,7
HND-002253,2011,31300132,,,,1,4,5
HND-002254,2011,31300133,,,,1,2,3
HND-002174,2011,31300004,,,,5,2,7
HND-002175,2011,31300006,,,,4,2,6
HND-002176,2011,31300007,,,,21,22,43
HND-002177,2011,31300008,,,,18,13,31
HND-002178,2011,31300009,,,,6,9,15
HND-002179,2011,31300010,,,,8,11,19
HND-002181,2011,31300012,,,,9,5,14
HND-002183,2011,31300014,,,,9,7,16
HND-002184,2011,31300015,,,,3,7,10
HND-002187,2011,31300018,,,,5,4,9
HND-002188,2011,31300019,,,,4,3,7
HND-002189,2011,31300020,,,,12,6,18
HND-002193,2011,31300024,,,,3,2,5
HND-002194,2011,31300025,,,,2,3,5
HND-002195,2011,31300026,,,,3,1,4
HND-002197,2011,31300028,,,,2,2,4
HND-002198,2011,31300029,,,,6,4,10
HND-002199,2011,31300030,,,,1,1,2
HND-002203,2011,31300034,,,,0,1,1
HND-002204,2011,31300035,,,,1,1,2
HND-002206,2011,31300038,,,,6,6,12
HND-002211,2011,31300043,,,,5,5,10
HND-002213,2011,31300045,,,,2,5,7
HND-002218,2011,31300056,,,,2,2,4
HND-002219,2011,31300057,,,,4,7,11
HND-002222,2011,31300060,,,,0,2,2
HND-002227,2011,31300068,,,,3,10,13
HND-002237,2011,31300079,,,,5,14,19
HND-002238,2011,31300080,,,,10,14,24
HND-002239,2011,31300081,,,,0,1,1
HND-002240,2011,31300082,,,,2,2,4
HND-002244,2011,31300104,,,,1,1,2
HND-002245,2011,31300109,,,,1,3,4
HND-002171,2011,31300001,,,,1,2,3
HND-002172,2011,31300002,,,,6,10,16
HND-002173,2011,31300003,,,,3,1,4
HND-002180,2011,31300011,,,,2,3,5
HND-002182,2011,31300013,,,,5,2,7
HND-002185,2011,31300016,,,,5,6,11
HND-002186,2011,31300017,,,,6,2,8
HND-002190,2011,31300021,,,,5,7,12
HND-002191,2011,31300022,,,,19,11,30
HND-002192,2011,31300023,,,,5,1,6
HND-002196,2011,31300027,,,,7,11,18
HND-002200,2011,31300031,,,,6,1,7
HND-002201,2011,31300032,,,,2,4,6
HND-002202,2011,31300033,,,,10,6,16
HND-002205,2011,31300037,,,,11,6,17
HND-002209,2011,31300041,,,,2,2,4
HND-002212,2011,31300044,,,,4,4,8
HND-002214,2011,31300046,,,,1,1,2
HND-002221,2011,31300059,,,,4,1,5
HND-002228,2011,31300069,,,,5,2,7
HND-002229,2011,31300070,,,,2,2,4
HND-002231,2011,31300072,,,,6,4,10
HND-002234,2011,31300076,,,,4,6,10
HND-002235,2011,31300077,,,,1,1,2
HND-002243,2011,31300090,,,,1,0,1
HND-002253,2011,31300132,,,,4,5,9
HND-002254,2011,31300133,,,,3,0,3
HND-002171,2011,31300001,,,,0,1,1
HND-002173,2011,31300003,,,,0,1,1
HND-002174,2011,31300004,,,,2,2,4
HND-002175,2011,31300006,,,,8,5,13
HND-002177,2011,31300008,,,,11,22,33
HND-002180,2011,31300011,,,,0,4,4
HND-002181,2011,31300012,,,,16,17,33
HND-002182,2011,31300013,,,,3,2,5
HND-002183,2011,31300014,,,,4,1,5
HND-002185,2011,31300016,,,,5,4,9
HND-002186,2011,31300017,,,,4,5,9
HND-002189,2011,31300020,,,,22,14,36
HND-002190,2011,31300021,,,,4,8,12
HND-002191,2011,31300022,,,,16,17,33
HND-002192,2011,31300023,,,,1,1,2
HND-002193,2011,31300024,,,,1,2,3
HND-002194,2011,31300025,,,,1,1,2
HND-002195,2011,31300026,,,,5,8,13
HND-002196,2011,31300027,,,,9,6,15
HND-002197,2011,31300028,,,,2,6,8
HND-002199,2011,31300030,,,,2,2,4
HND-002200,2011,31300031,,,,1,2,3
HND-002201,2011,31300032,,,,2,3,5
HND-002202,2011,31300033,,,,4,3,7
HND-002203,2011,31300034,,,,3,2,5
HND-002204,2011,31300035,,,,4,9,13
HND-002205,2011,31300037,,,,12,5,17
HND-002206,2011,31300038,,,,8,8,16
HND-002209,2011,31300041,,,,2,2,4
HND-002212,2011,31300044,,,,10,2,12
HND-002213,2011,31300045,,,,4,1,5
HND-002214,2011,31300046,,,,4,3,7
HND-002219,2011,31300057,,,,2,6,8
HND-002229,2011,31300070,,,,2,2,4
HND-002233,2011,31300075,,,,0,5,5
HND-002235,2011,31300077,,,,2,1,3
HND-002239,2011,31300081,,,,1,0,1
HND-002245,2011,31300109,,,,1,4,5
HND-002253,2011,31300132,,,,3,1,4
HND-002254,2011,31300133,,,,1,2,3
HND-002176,2011,31300007,,,,21,25,46
HND-002178,2011,31300009,,,,10,9,19
HND-002179,2011,31300010,,,,10,12,22
HND-002184,2011,31300015,,,,4,6,10
HND-002187,2011,31300018,,,,7,9,16
HND-002188,2011,31300019,,,,4,4,8
HND-002198,2011,31300029,,,,8,5,13
HND-002211,2011,31300043,,,,4,1,5
HND-002218,2011,31300056,,,,0,4,4
HND-002221,2011,31300059,,,,1,6,7
HND-002222,2011,31300060,,,,1,0,1
HND-002227,2011,31300068,,,,3,1,4
HND-002228,2011,31300069,,,,3,3,6
HND-002231,2011,31300072,,,,3,3,6
HND-002234,2011,31300076,,,,2,0,2
HND-002237,2011,31300079,,,,7,15,22
HND-002238,2011,31300080,,,,5,8,13
HND-002240,2011,31300082,,,,6,5,11
HND-002243,2011,31300090,,,,6,3,9
HND-002244,2011,31300104,,,,0,2,2
HND-002171,2011,31300001,,,,1,1,2
HND-002172,2011,31300002,,,,8,2,10
HND-002173,2011,31300003,,,,2,4,6
HND-002174,2011,31300004,,,,0,3,3
HND-002175,2011,31300006,,,,6,5,11
HND-002180,2011,31300011,,,,2,1,3
HND-002181,2011,31300012,,,,3,8,11
HND-002182,2011,31300013,,,,3,2,5
HND-002185,2011,31300016,,,,3,4,7
HND-002186,2011,31300017,,,,8,7,15
HND-002190,2011,31300021,,,,2,10,12
HND-002191,2011,31300022,,,,25,20,45
HND-002192,2011,31300023,,,,2,3,5
HND-002193,2011,31300024,,,,3,1,4
HND-002195,2011,31300026,,,,1,0,1
HND-002196,2011,31300027,,,,10,8,18
HND-002197,2011,31300028,,,,2,9,11
HND-002200,2011,31300031,,,,1,0,1
HND-002201,2011,31300032,,,,4,6,10
HND-002202,2011,31300033,,,,5,4,9
HND-002203,2011,31300034,,,,2,0,2
HND-002205,2011,31300037,,,,6,5,11
HND-002206,2011,31300038,,,,5,2,7
HND-002209,2011,31300041,,,,6,1,7
HND-002212,2011,31300044,,,,5,8,13
HND-002213,2011,31300045,,,,1,2,3
HND-002214,2011,31300046,,,,4,1,5
HND-002229,2011,31300070,,,,4,2,6
HND-002233,2011,31300075,,,,3,1,4
HND-002234,2011,31300076,,,,1,2,3
HND-002235,2011,31300077,,,,1,0,1
HND-002239,2011,31300081,,,,2,0,2
HND-002243,2011,31300090,,,,1,4,5
HND-002245,2011,31300109,,,,1,0,1
HND-002254,2011,31300133,,,,0,3,3
HND-002176,2011,31300007,,,,24,20,44
HND-002177,2011,31300008,,,,17,30,47
HND-002178,2011,31300009,,,,9,10,19
HND-002179,2011,31300010,,,,10,11,21
HND-002183,2011,31300014,,,,0,5,5
HND-002184,2011,31300015,,,,5,9,14
HND-002187,2011,31300018,,,,12,11,23
HND-002188,2011,31300019,,,,11,5,16
HND-002189,2011,31300020,,,,9,7,16
HND-002194,2011,31300025,,,,3,2,5
HND-002198,2011,31300029,,,,3,3,6
HND-002199,2011,31300030,,,,5,0,5
HND-002204,2011,31300035,,,,0,3,3
HND-002211,2011,31300043,,,,4,0,4
HND-002218,2011,31300056,,,,4,6,10
HND-002219,2011,31300057,,,,1,6,7
HND-002221,2011,31300059,,,,4,4,8
HND-002222,2011,31300060,,,,4,1,5
HND-002227,2011,31300068,,,,1,3,4
HND-002228,2011,31300069,,,,2,3,5
HND-002231,2011,31300072,,,,2,1,3
HND-002237,2011,31300079,,,,11,13,24
HND-002238,2011,31300080,,,,7,7,14
HND-002240,2011,31300082,,,,3,1,4
HND-002244,2011,31300104,,,,2,3,5
HND-002253,2011,31300132,,,,2,3,5
HND-002176,2011,31300007,,,,19,30,49
HND-002185,2011,31300016,,,,3,5,8
HND-002188,2011,31300019,,,,7,4,11
HND-002190,2011,31300021,,,,8,8,16
HND-002196,2011,31300027,,,,14,6,20
HND-002200,2011,31300031,,,,2,0,2
HND-002205,2011,31300037,,,,9,8,17
HND-002209,2011,31300041,,,,2,2,4
HND-002218,2011,31300056,,,,5,1,6
HND-002221,2011,31300059,,,,2,7,9
HND-002222,2011,31300060,,,,1,2,3
HND-002227,2011,31300068,,,,6,4,10
HND-002228,2011,31300069,,,,3,4,7
HND-002229,2011,31300070,,,,2,2,4
HND-002231,2011,31300072,,,,4,0,4
HND-002233,2011,31300075,,,,1,0,1
HND-002234,2011,31300076,,,,1,1,2
HND-002237,2011,31300079,,,,9,5,14
HND-002238,2011,31300080,,,,5,12,17
HND-002243,2011,31300090,,,,1,0,1
HND-002244,2011,31300104,,,,1,4,5
HND-002171,2011,31300001,,,,1,3,4
HND-002172,2011,31300002,,,,6,6,12
HND-002173,2011,31300003,,,,0,2,2
HND-002174,2011,31300004,,,,2,1,3
HND-002175,2011,31300006,,,,1,1,2
HND-002177,2011,31300008,,,,25,15,40
HND-002178,2011,31300009,,,,6,18,24
HND-002179,2011,31300010,,,,9,9,18
HND-002180,2011,31300011,,,,2,0,2
HND-002181,2011,31300012,,,,3,5,8
HND-002182,2011,31300013,,,,1,3,4
HND-002183,2011,31300014,,,,3,3,6
HND-002184,2011,31300015,,,,6,5,11
HND-002186,2011,31300017,,,,5,6,11
HND-002187,2011,31300018,,,,3,5,8
HND-002189,2011,31300020,,,,8,10,18
HND-002191,2011,31300022,,,,21,18,39
HND-002192,2011,31300023,,,,8,1,9
HND-002193,2011,31300024,,,,1,5,6
HND-002194,2011,31300025,,,,4,0,4
HND-002195,2011,31300026,,,,1,0,1
HND-002197,2011,31300028,,,,6,9,15
HND-002198,2011,31300029,,,,6,2,8
HND-002199,2011,31300030,,,,2,0,2
HND-002201,2011,31300032,,,,4,2,6
HND-002202,2011,31300033,,,,4,6,10
HND-002203,2011,31300034,,,,2,2,4
HND-002204,2011,31300035,,,,3,3,6
HND-002206,2011,31300038,,,,5,3,8
HND-002211,2011,31300043,,,,1,4,5
HND-002212,2011,31300044,,,,3,8,11
HND-002213,2011,31300045,,,,0,3,3
HND-002214,2011,31300046,,,,2,6,8
HND-002219,2011,31300057,,,,4,3,7
HND-002235,2011,31300077,,,,2,0,2
HND-002239,2011,31300081,,,,2,1,3
HND-002240,2011,31300082,,,,1,3,4
HND-002253,2011,31300132,,,,1,0,1
HND-002254,2011,31300133,,,,0,1,1
HND-002190,2011,31300021,,,,13,12,25
HND-002217,2011,31300050,,,,75,62,137
HND-002236,2011,31300078,,,,36,45,81
HND-002189,2011,31300020,,,,17,20,37
HND-002189,2011,31300020,,,,21,23,44
HND-002190,2011,31300021,,,,7,12,19
HND-002217,2011,31300050,,,,46,53,99
HND-002236,2011,31300078,,,,37,34,71
HND-002189,2011,31300020,,,,15,20,35
HND-002190,2011,31300021,,,,11,11,22
HND-002236,2011,31300078,,,,25,35,60
HND-002217,2011,31300050,,,,34,38,72
HND-002189,2011,31300020,,,,10,11,21
HND-002190,2011,31300021,,,,2,9,11
HND-002217,2011,31300050,,,,31,25,56
HND-002236,2011,31300078,,,,13,21,34
HND-002217,2011,31300050,,,,16,15,31
HND-002236,2011,31300078,,,,16,27,43
HND-002189,2011,31300020,,,,2,5,7
HND-002190,2011,31300021,,,,2,5,7
HND-002189,2011,31300020,,,,3,8,11
HND-002190,2011,31300021,,,,3,3,6
HND-002217,2011,31300050,,,,16,19,35
HND-002236,2011,31300078,,,,7,23,30
HND-002280,2011,31400026,,,,3,3,6
HND-002287,2011,31400036,,,,4,5,9
,2011,31400037,,,,8,6,14
HND-002288,2011,31400038,,,,9,4,13
HND-002289,2011,31400040,,,,1,8,9
HND-002293,2011,31400045,,,,2,5,7
,2011,31400046,,,,6,6,12
HND-002296,2011,31400049,,,,5,5,10
HND-002275,2011,31400020,,,,5,5,10
,2011,31400039,,,,2,3,5
HND-002294,2011,31400047,,,,3,8,11
,2011,31400027,,,,4,1,5
HND-002281,2011,31400028,,,,5,0,5
HND-002286,2011,31400035,,,,1,3,4
HND-002279,2011,31400024,,,,2,5,7
,2011,31400025,,,,1,3,4
,2011,31400027,,,,0,3,3
HND-002281,2011,31400028,,,,1,2,3
,2011,31400034,,,,5,4,9
HND-002286,2011,31400035,,,,3,2,5
HND-002272,2011,31400015,,,,2,1,3
HND-002272,2011,31400015,,,,12,7,19
HND-002281,2011,31400028,,,,2,4,6
HND-002286,2011,31400035,,,,4,7,11
HND-002277,2011,31400022,,,,21,26,47
HND-002279,2011,31400024,,,,5,2,7
,2011,31400025,,,,5,5,10
,2011,31400027,,,,1,1,2
,2011,31400034,,,,8,3,11
HND-002260,2011,31400002,,,,5,1,6
HND-002261,2011,31400003,,,,3,6,9
HND-002263,2011,31400005,,,,4,12,16
HND-002264,2011,31400006,,,,3,2,5
HND-002265,2011,31400007,,,,6,3,9
HND-002267,2011,31400010,,,,6,7,13
HND-002271,2011,31400014,,,,4,4,8
,2011,31400019,,,,7,4,11
HND-002278,2011,31400023,,,,5,2,7
HND-002282,2011,31400029,,,,1,2,3
HND-002283,2011,31400030,,,,6,10,16
HND-002284,2011,31400032,,,,1,2,3
HND-002285,2011,31400033,,,,12,5,17
HND-002262,2011,31400004,,,,35,14,49
HND-002266,2011,31400009,,,,9,7,16
HND-002268,2011,31400011,,,,6,3,9
HND-002270,2011,31400013,,,,2,3,5
HND-002274,2011,31400017,,,,11,6,17
HND-002290,2011,31400041,,,,1,4,5
HND-002291,2011,31400042,,,,37,33,70
HND-002292,2011,31400044,,,,5,3,8
HND-002295,2011,31400048,,,,2,3,5
HND-002263,2011,31400005,,,,7,7,14
HND-002264,2011,31400006,,,,0,3,3
HND-002266,2011,31400009,,,,10,5,15
HND-002282,2011,31400029,,,,3,3,6
HND-002283,2011,31400030,,,,4,6,10
HND-002290,2011,31400041,,,,2,2,4
HND-002291,2011,31400042,,,,31,35,66
HND-002260,2011,31400002,,,,8,3,11
HND-002261,2011,31400003,,,,2,6,8
HND-002262,2011,31400004,,,,11,11,22
HND-002265,2011,31400007,,,,4,3,7
HND-002267,2011,31400010,,,,8,5,13
HND-002268,2011,31400011,,,,4,5,9
HND-002270,2011,31400013,,,,4,3,7
HND-002271,2011,31400014,,,,10,2,12
HND-002274,2011,31400017,,,,4,4,8
,2011,31400019,,,,4,6,10
HND-002278,2011,31400023,,,,1,3,4
HND-002284,2011,31400032,,,,1,1,2
HND-002285,2011,31400033,,,,2,5,7
HND-002292,2011,31400044,,,,6,2,8
HND-002295,2011,31400048,,,,2,3,5
HND-002262,2011,31400004,,,,10,12,22
HND-002266,2011,31400009,,,,4,4,8
HND-002268,2011,31400011,,,,3,7,10
HND-002270,2011,31400013,,,,4,0,4
HND-002274,2011,31400017,,,,6,1,7
HND-002290,2011,31400041,,,,0,2,2
HND-002291,2011,31400042,,,,49,44,93
HND-002292,2011,31400044,,,,6,4,10
HND-002295,2011,31400048,,,,1,0,1
HND-002260,2011,31400002,,,,5,4,9
HND-002261,2011,31400003,,,,4,3,7
HND-002263,2011,31400005,,,,5,8,13
HND-002264,2011,31400006,,,,0,2,2
HND-002265,2011,31400007,,,,2,3,5
HND-002267,2011,31400010,,,,5,5,10
HND-002271,2011,31400014,,,,2,6,8
,2011,31400019,,,,4,5,9
HND-002278,2011,31400023,,,,3,4,7
HND-002282,2011,31400029,,,,5,0,5
HND-002283,2011,31400030,,,,9,5,14
HND-002284,2011,31400032,,,,1,2,3
HND-002285,2011,31400033,,,,5,5,10
HND-002260,2011,31400002,,,,3,4,7
HND-002263,2011,31400005,,,,5,3,8
HND-002264,2011,31400006,,,,2,0,2
HND-002266,2011,31400009,,,,8,3,11
,2011,31400019,,,,6,3,9
HND-002282,2011,31400029,,,,2,1,3
HND-002283,2011,31400030,,,,8,7,15
HND-002290,2011,31400041,,,,2,4,6
HND-002261,2011,31400003,,,,4,3,7
HND-002262,2011,31400004,,,,18,16,34
HND-002265,2011,31400007,,,,2,1,3
HND-002267,2011,31400010,,,,7,2,9
HND-002268,2011,31400011,,,,2,4,6
HND-002270,2011,31400013,,,,0,6,6
HND-002271,2011,31400014,,,,8,4,12
HND-002274,2011,31400017,,,,1,2,3
HND-002278,2011,31400023,,,,3,1,4
HND-002284,2011,31400032,,,,3,2,5
HND-002285,2011,31400033,,,,3,2,5
HND-002291,2011,31400042,,,,22,27,49
HND-002292,2011,31400044,,,,4,1,5
HND-002262,2011,31400004,,,,11,14,25
HND-002268,2011,31400011,,,,4,8,12
HND-002270,2011,31400013,,,,2,4,6
HND-002271,2011,31400014,,,,10,2,12
HND-002274,2011,31400017,,,,1,6,7
HND-002278,2011,31400023,,,,0,5,5
HND-002283,2011,31400030,,,,7,6,13
HND-002284,2011,31400032,,,,2,5,7
HND-002260,2011,31400002,,,,4,1,5
HND-002261,2011,31400003,,,,2,3,5
HND-002263,2011,31400005,,,,5,2,7
HND-002264,2011,31400006,,,,1,4,5
HND-002265,2011,31400007,,,,5,3,8
HND-002266,2011,31400009,,,,3,4,7
HND-002267,2011,31400010,,,,6,4,10
,2011,31400019,,,,4,3,7
HND-002285,2011,31400033,,,,3,5,8
HND-002290,2011,31400041,,,,2,4,6
HND-002291,2011,31400042,,,,22,33,55
HND-002292,2011,31400044,,,,5,3,8
HND-002263,2011,31400005,,,,9,3,12
HND-002264,2011,31400006,,,,2,1,3
HND-002266,2011,31400009,,,,5,8,13
HND-002282,2011,31400029,,,,2,3,5
HND-002284,2011,31400032,,,,1,1,2
HND-002285,2011,31400033,,,,4,9,13
HND-002292,2011,31400044,,,,5,3,8
HND-002295,2011,31400048,,,,0,2,2
HND-002260,2011,31400002,,,,6,5,11
HND-002261,2011,31400003,,,,0,2,2
HND-002262,2011,31400004,,,,20,17,37
HND-002265,2011,31400007,,,,0,7,7
HND-002267,2011,31400010,,,,4,3,7
HND-002268,2011,31400011,,,,6,5,11
HND-002270,2011,31400013,,,,4,1,5
HND-002271,2011,31400014,,,,1,4,5
HND-002274,2011,31400017,,,,1,2,3
,2011,31400019,,,,1,7,8
HND-002278,2011,31400023,,,,3,1,4
HND-002283,2011,31400030,,,,7,7,14
HND-002290,2011,31400041,,,,2,4,6
HND-002291,2011,31400042,,,,23,21,44
HND-002273,2011,31400016,,,,31,24,55
HND-002291,2011,31400042,,,,8,12,20
HND-002291,2011,31400042,,,,12,18,30
HND-002273,2011,31400016,,,,24,23,47
HND-002273,2011,31400016,,,,12,26,38
HND-002291,2011,31400042,,,,10,10,20
HND-002273,2011,31400016,,,,11,19,30
HND-002273,2011,31400016,,,,6,9,15
HND-002273,2011,31400016,,,,4,14,18
,2011,31500037,,,,6,3,9
HND-002327,2011,31500040,,,,10,10,20
,2011,31500042,,,,2,3,5
HND-002330,2011,31500046,,,,8,6,14
HND-002331,2011,31500048,,,,7,2,9
,2011,31500049,,,,6,3,9
HND-002333,2011,31500056,,,,4,1,5
HND-002335,2011,31500060,,,,5,1,6
HND-002325,2011,31500038,,,,5,1,6
HND-002326,2011,31500039,,,,6,9,15
,2011,31500052,,,,6,1,7
,2011,31500054,,,,5,10,15
,2011,31500055,,,,9,1,10
HND-002334,2011,31500057,,,,6,3,9
,2011,31500058,,,,5,3,8
,2011,31500059,,,,2,6,8
HND-002332,2011,31500050,,,,1,2,3
HND-002323,2011,31500032,,,,1,1,2
HND-002314,2011,31500019,,,,14,7,21
HND-002323,2011,31500032,,,,5,3,8
HND-002324,2011,31500033,,,,5,6,11
,2011,31500020,,,,6,6,12
,2011,31500022,,,,7,6,13
HND-002317,2011,31500023,,,,3,3,6
HND-002319,2011,31500027,,,,6,0,6
HND-002332,2011,31500050,,,,4,5,9
,2011,31500022,,,,9,4,13
HND-002317,2011,31500023,,,,3,5,8
HND-002319,2011,31500027,,,,2,5,7
HND-002324,2011,31500033,,,,9,7,16
HND-002314,2011,31500019,,,,11,10,21
,2011,31500020,,,,4,5,9
HND-002323,2011,31500032,,,,1,3,4
HND-002332,2011,31500050,,,,4,7,11
HND-002299,2011,31500002,,,,1,3,4
,2011,31500004,,,,4,7,11
HND-002302,2011,31500005,,,,2,5,7
HND-002303,2011,31500006,,,,1,2,3
HND-002304,2011,31500008,,,,3,4,7
HND-002305,2011,31500009,,,,3,0,3
HND-002306,2011,31500010,,,,1,3,4
HND-002310,2011,31500014,,,,5,7,12
HND-002311,2011,31500015,,,,4,1,5
,2011,31500016,,,,4,4,8
HND-002322,2011,31500031,,,,7,4,11
HND-002329,2011,31500044,,,,0,2,2
HND-002298,2011,31500001,,,,16,19,35
HND-002300,2011,31500003,,,,5,6,11
,2011,31500007,,,,2,5,7
HND-002307,2011,31500011,,,,5,6,11
HND-002308,2011,31500012,,,,6,3,9
HND-002309,2011,31500013,,,,7,7,14
HND-002313,2011,31500017,,,,0,4,4
HND-002318,2011,31500026,,,,2,1,3
HND-002320,2011,31500028,,,,5,7,12
HND-002321,2011,31500029,,,,9,9,18
,2011,31500043,,,,3,4,7
HND-002298,2011,31500001,,,,19,16,35
HND-002305,2011,31500009,,,,2,1,3
HND-002318,2011,31500026,,,,2,3,5
HND-002320,2011,31500028,,,,1,3,4
HND-002322,2011,31500031,,,,2,3,5
,2011,31500043,,,,0,1,1
HND-002329,2011,31500044,,,,1,0,1
HND-002299,2011,31500002,,,,4,5,9
HND-002300,2011,31500003,,,,3,1,4
,2011,31500004,,,,7,8,15
HND-002302,2011,31500005,,,,4,2,6
HND-002303,2011,31500006,,,,1,3,4
,2011,31500007,,,,3,5,8
HND-002304,2011,31500008,,,,5,9,14
HND-002306,2011,31500010,,,,5,2,7
HND-002307,2011,31500011,,,,0,5,5
HND-002308,2011,31500012,,,,2,2,4
HND-002309,2011,31500013,,,,6,8,14
HND-002310,2011,31500014,,,,8,9,17
HND-002311,2011,31500015,,,,6,4,10
,2011,31500016,,,,0,5,5
HND-002313,2011,31500017,,,,3,2,5
HND-002321,2011,31500029,,,,14,8,22
HND-002298,2011,31500001,,,,18,13,31
,2011,31500007,,,,4,2,6
HND-002307,2011,31500011,,,,3,1,4
HND-002309,2011,31500013,,,,7,6,13
HND-002313,2011,31500017,,,,1,2,3
HND-002318,2011,31500026,,,,2,1,3
HND-002320,2011,31500028,,,,6,4,10
HND-002321,2011,31500029,,,,10,7,17
,2011,31500043,,,,5,8,13
HND-002299,2011,31500002,,,,3,7,10
HND-002300,2011,31500003,,,,1,1,2
,2011,31500004,,,,9,3,12
HND-002302,2011,31500005,,,,5,6,11
HND-002303,2011,31500006,,,,2,3,5
HND-002304,2011,31500008,,,,1,4,5
HND-002305,2011,31500009,,,,2,0,2
HND-002306,2011,31500010,,,,4,1,5
HND-002308,2011,31500012,,,,5,6,11
HND-002310,2011,31500014,,,,5,4,9
HND-002311,2011,31500015,,,,6,3,9
,2011,31500016,,,,4,4,8
HND-002322,2011,31500031,,,,4,6,10
HND-002298,2011,31500001,,,,16,11,27
HND-002302,2011,31500005,,,,3,3,6
HND-002304,2011,31500008,,,,7,4,11
HND-002305,2011,31500009,,,,0,1,1
HND-002306,2011,31500010,,,,3,2,5
HND-002311,2011,31500015,,,,2,3,5
HND-002329,2011,31500044,,,,2,6,8
HND-002299,2011,31500002,,,,2,1,3
HND-002300,2011,31500003,,,,8,2,10
,2011,31500004,,,,7,5,12
HND-002303,2011,31500006,,,,5,2,7
,2011,31500007,,,,3,5,8
HND-002307,2011,31500011,,,,2,2,4
HND-002308,2011,31500012,,,,4,4,8
HND-002309,2011,31500013,,,,6,5,11
HND-002310,2011,31500014,,,,3,10,13
,2011,31500016,,,,1,3,4
HND-002313,2011,31500017,,,,5,1,6
HND-002320,2011,31500028,,,,8,8,16
HND-002321,2011,31500029,,,,3,10,13
HND-002322,2011,31500031,,,,1,5,6
HND-002298,2011,31500001,,,,7,9,16
,2011,31500004,,,,5,3,8
HND-002302,2011,31500005,,,,1,4,5
HND-002303,2011,31500006,,,,1,1,2
HND-002304,2011,31500008,,,,7,4,11
HND-002305,2011,31500009,,,,2,1,3
HND-002306,2011,31500010,,,,3,4,7
HND-002311,2011,31500015,,,,2,6,8
,2011,31500016,,,,5,1,6
,2011,31500043,,,,3,3,6
HND-002329,2011,31500044,,,,2,1,3
HND-002299,2011,31500002,,,,2,6,8
HND-002300,2011,31500003,,,,4,5,9
,2011,31500007,,,,3,3,6
HND-002307,2011,31500011,,,,0,4,4
HND-002308,2011,31500012,,,,6,4,10
HND-002309,2011,31500013,,,,12,10,22
HND-002310,2011,31500014,,,,8,4,12
HND-002313,2011,31500017,,,,0,1,1
HND-002318,2011,31500026,,,,1,4,5
HND-002320,2011,31500028,,,,4,5,9
HND-002321,2011,31500029,,,,11,8,19
HND-002322,2011,31500031,,,,1,3,4
HND-002299,2011,31500002,,,,5,3,8
HND-002300,2011,31500003,,,,1,6,7
,2011,31500004,,,,4,4,8
HND-002302,2011,31500005,,,,5,3,8
HND-002303,2011,31500006,,,,2,5,7
,2011,31500007,,,,1,1,2
HND-002304,2011,31500008,,,,6,6,12
HND-002306,2011,31500010,,,,2,0,2
HND-002307,2011,31500011,,,,4,4,8
HND-002308,2011,31500012,,,,6,1,7
HND-002309,2011,31500013,,,,2,4,6
HND-002310,2011,31500014,,,,9,3,12
HND-002311,2011,31500015,,,,1,3,4
,2011,31500016,,,,3,5,8
HND-002313,2011,31500017,,,,0,3,3
HND-002321,2011,31500029,,,,9,8,17
HND-002298,2011,31500001,,,,14,18,32
HND-002305,2011,31500009,,,,1,4,5
HND-002318,2011,31500026,,,,2,2,4
HND-002320,2011,31500028,,,,6,3,9
HND-002322,2011,31500031,,,,2,4,6
,2011,31500043,,,,3,3,6
HND-002329,2011,31500044,,,,0,5,5
HND-002304,2011,31500008,,,,11,6,17
HND-002316,2011,31500021,,,,52,41,93
HND-002321,2011,31500029,,,,12,7,19
,2011,31500043,,,,4,5,9
HND-002316,2011,31500021,,,,24,18,42
,2011,31500043,,,,8,11,19
HND-002304,2011,31500008,,,,0,6,6
HND-002321,2011,31500029,,,,8,4,12
HND-002304,2011,31500008,,,,5,5,10
HND-002316,2011,31500021,,,,28,22,50
,2011,31500043,,,,4,3,7
HND-002321,2011,31500029,,,,6,4,10
HND-002316,2011,31500021,,,,13,10,23
HND-002316,2011,31500021,,,,12,10,22
HND-002316,2011,31500021,,,,14,4,18
,2011,31600041,,,,6,2,8
,2011,31600052,,,,6,3,9
,2011,31600053,,,,6,0,6
,2011,31600057,,,,6,1,7
,2011,31600036,,,,5,10,15
,2011,31600038,,,,3,5,8
,2011,31600039,,,,4,5,9
,2011,31600040,,,,4,4,8
,2011,31600045,,,,2,3,5
HND-002369,2011,31600054,,,,3,4,7
HND-002370,2011,31600056,,,,6,5,11
,2011,31600058,,,,4,4,8
HND-002347,2011,31600012,,,,2,2,4
,2011,31600019,,,,1,0,1
,2011,31600024,,,,0,4,4
,2011,31600031,,,,1,0,1
,2011,31600033,,,,1,0,1
HND-002364,2011,31600034,,,,0,1,1
,2011,31600035,,,,1,0,1
HND-002367,2011,31600048,,,,0,1,1
HND-002347,2011,31600012,,,,1,2,3
HND-002355,2011,31600022,,,,24,22,46
HND-002356,2011,31600023,,,,4,2,6
,2011,31600027,,,,8,3,11
,2011,31600031,,,,5,4,9
HND-002363,2011,31600032,,,,3,4,7
,2011,31600033,,,,2,3,5
,2011,31600037,,,,2,0,2
,2011,31600019,,,,1,0,1
,2011,31600024,,,,4,2,6
HND-002357,2011,31600025,,,,4,6,10
HND-002361,2011,31600030,,,,5,3,8
HND-002364,2011,31600034,,,,4,2,6
,2011,31600035,,,,6,2,8
HND-002367,2011,31600048,,,,7,4,11
HND-002355,2011,31600022,,,,18,21,39
,2011,31600024,,,,3,8,11
HND-002357,2011,31600025,,,,8,5,13
HND-002361,2011,31600030,,,,7,10,17
HND-002363,2011,31600032,,,,4,5,9
HND-002364,2011,31600034,,,,8,6,14
,2011,31600035,,,,2,2,4
HND-002367,2011,31600048,,,,6,3,9
HND-002347,2011,31600012,,,,1,7,8
HND-002356,2011,31600023,,,,8,4,12
,2011,31600027,,,,7,14,21
,2011,31600031,,,,2,2,4
,2011,31600033,,,,3,8,11
,2011,31600037,,,,2,2,4
HND-002337,2011,31600002,,,,10,8,18
HND-002338,2011,31600003,,,,10,8,18
,2011,31600004,,,,2,13,15
HND-002340,2011,31600005,,,,3,3,6
HND-002341,2011,31600006,,,,10,7,17
HND-002343,2011,31600008,,,,6,6,12
HND-002344,2011,31600009,,,,3,4,7
HND-002345,2011,31600010,,,,5,3,8
HND-002346,2011,31600011,,,,6,6,12
HND-002348,2011,31600013,,,,6,11,17
,2011,31600014,,,,2,3,5
HND-002350,2011,31600015,,,,7,6,13
HND-002351,2011,31600017,,,,2,3,5
,2011,31600019,,,,1,0,1
,2011,31600021,,,,2,0,2
HND-002360,2011,31600028,,,,1,0,1
HND-002365,2011,31600042,,,,0,7,7
,2011,31600043,,,,11,11,22
,2011,31600001,,,,4,1,5
HND-002342,2011,31600007,,,,11,8,19
HND-002347,2011,31600012,,,,27,22,49
HND-002353,2011,31600020,,,,9,1,10
,2011,31600051,,,,4,5,9
HND-002340,2011,31600005,,,,3,3,6
HND-002344,2011,31600009,,,,1,2,3
HND-002345,2011,31600010,,,,7,1,8
HND-002350,2011,31600015,,,,8,8,16
,2011,31600019,,,,0,1,1
HND-002353,2011,31600020,,,,3,2,5
HND-002360,2011,31600028,,,,1,1,2
HND-002365,2011,31600042,,,,8,4,12
,2011,31600043,,,,10,8,18
,2011,31600051,,,,2,8,10
,2011,31600001,,,,1,5,6
HND-002337,2011,31600002,,,,7,2,9
HND-002338,2011,31600003,,,,10,12,22
,2011,31600004,,,,8,10,18
HND-002341,2011,31600006,,,,9,5,14
HND-002342,2011,31600007,,,,12,9,21
HND-002343,2011,31600008,,,,5,9,14
HND-002346,2011,31600011,,,,10,6,16
HND-002347,2011,31600012,,,,21,28,49
HND-002348,2011,31600013,,,,6,3,9
,2011,31600014,,,,4,1,5
HND-002351,2011,31600017,,,,7,3,10
,2011,31600021,,,,1,2,3
HND-002347,2011,31600012,,,,30,24,54
HND-002353,2011,31600020,,,,4,1,5
,2011,31600051,,,,1,1,2
,2011,31600001,,,,2,3,5
HND-002337,2011,31600002,,,,7,9,16
HND-002338,2011,31600003,,,,13,14,27
,2011,31600004,,,,5,7,12
HND-002340,2011,31600005,,,,3,3,6
HND-002341,2011,31600006,,,,8,9,17
HND-002342,2011,31600007,,,,7,6,13
HND-002343,2011,31600008,,,,5,3,8
HND-002344,2011,31600009,,,,1,0,1
HND-002345,2011,31600010,,,,6,6,12
HND-002346,2011,31600011,,,,8,3,11
HND-002348,2011,31600013,,,,10,6,16
,2011,31600014,,,,7,2,9
HND-002350,2011,31600015,,,,8,5,13
HND-002351,2011,31600017,,,,7,4,11
,2011,31600021,,,,1,0,1
HND-002365,2011,31600042,,,,5,8,13
,2011,31600043,,,,1,5,6
HND-002340,2011,31600005,,,,3,4,7
HND-002341,2011,31600006,,,,13,9,22
HND-002343,2011,31600008,,,,11,1,12
HND-002344,2011,31600009,,,,1,0,1
HND-002345,2011,31600010,,,,2,7,9
,2011,31600014,,,,2,1,3
HND-002350,2011,31600015,,,,7,11,18
,2011,31600019,,,,0,1,1
HND-002353,2011,31600020,,,,4,1,5
,2011,31600021,,,,2,4,6
HND-002360,2011,31600028,,,,1,2,3
HND-002365,2011,31600042,,,,2,9,11
,2011,31600043,,,,4,3,7
,2011,31600051,,,,1,0,1
,2011,31600001,,,,6,6,12
HND-002337,2011,31600002,,,,8,7,15
HND-002338,2011,31600003,,,,9,11,20
,2011,31600004,,,,8,7,15
HND-002342,2011,31600007,,,,11,20,31
HND-002346,2011,31600011,,,,7,2,9
HND-002347,2011,31600012,,,,29,27,56
HND-002348,2011,31600013,,,,4,4,8
HND-002351,2011,31600017,,,,6,1,7
,2011,31600001,,,,1,5,6
HND-002338,2011,31600003,,,,7,9,16
HND-002342,2011,31600007,,,,5,5,10
HND-002347,2011,31600012,,,,31,28,59
HND-002365,2011,31600042,,,,3,4,7
,2011,31600043,,,,2,8,10
,2011,31600051,,,,4,3,7
HND-002337,2011,31600002,,,,6,8,14
,2011,31600004,,,,3,9,12
HND-002340,2011,31600005,,,,1,2,3
HND-002341,2011,31600006,,,,5,3,8
HND-002343,2011,31600008,,,,4,6,10
HND-002344,2011,31600009,,,,2,4,6
HND-002345,2011,31600010,,,,2,4,6
HND-002346,2011,31600011,,,,1,7,8
HND-002348,2011,31600013,,,,6,7,13
,2011,31600014,,,,0,2,2
HND-002350,2011,31600015,,,,4,11,15
HND-002351,2011,31600017,,,,1,2,3
HND-002353,2011,31600020,,,,3,0,3
,2011,31600021,,,,3,2,5
HND-002360,2011,31600028,,,,0,3,3
HND-002340,2011,31600005,,,,1,4,5
HND-002344,2011,31600009,,,,3,0,3
HND-002345,2011,31600010,,,,6,6,12
HND-002350,2011,31600015,,,,10,11,21
,2011,31600019,,,,0,3,3
HND-002353,2011,31600020,,,,3,1,4
HND-002360,2011,31600028,,,,1,1,2
,2011,31600001,,,,5,1,6
HND-002337,2011,31600002,,,,5,5,10
HND-002338,2011,31600003,,,,7,13,20
,2011,31600004,,,,14,9,23
HND-002341,2011,31600006,,,,9,5,14
HND-002342,2011,31600007,,,,5,1,6
HND-002343,2011,31600008,,,,2,6,8
HND-002346,2011,31600011,,,,6,3,9
HND-002347,2011,31600012,,,,34,42,76
HND-002348,2011,31600013,,,,7,4,11
,2011,31600014,,,,3,1,4
HND-002351,2011,31600017,,,,1,0,1
,2011,31600021,,,,1,3,4
HND-002365,2011,31600042,,,,3,4,7
,2011,31600043,,,,1,5,6
,2011,31600051,,,,1,3,4
HND-002338,2011,31600003,,,,9,9,18
HND-002358,2011,31600026,,,,43,49,92
HND-002338,2011,31600003,,,,7,12,19
HND-002358,2011,31600026,,,,29,36,65
HND-002358,2011,31600026,,,,29,36,65
HND-002338,2011,31600003,,,,5,11,16
HND-002358,2011,31600026,,,,20,19,39
HND-002358,2011,31600026,,,,8,14,22
HND-002358,2011,31600026,,,,22,13,35
HND-002376,2011,31700004,,,,4,3,7
,2011,31700022,,,,3,7,10
,2011,31700023,,,,0,6,6
,2011,31700024,,,,1,5,6
,2011,31700027,,,,3,4,7
HND-002382,2011,31700011,,,,6,5,11
HND-002389,2011,31700026,,,,5,5,10
,2011,31700028,,,,0,5,5
HND-002380,2011,31700009,,,,3,6,9
,2011,31700008,,,,5,0,5
,2011,31700025,,,,2,3,5
HND-002380,2011,31700009,,,,4,6,10
,2011,31700008,,,,2,7,9
,2011,31700025,,,,2,5,7
HND-002380,2011,31700009,,,,14,13,27
,2011,31700008,,,,2,3,5
,2011,31700025,,,,1,2,3
HND-002373,2011,31700001,,,,2,2,4
HND-002374,2011,31700002,,,,2,4,6
HND-002376,2011,31700004,,,,4,2,6
HND-002377,2011,31700005,,,,6,9,15
HND-002379,2011,31700007,,,,2,7,9
HND-002386,2011,31700017,,,,3,4,7
HND-002388,2011,31700020,,,,5,1,6
HND-002378,2011,31700006,,,,17,17,34
HND-002383,2011,31700014,,,,0,2,2
HND-002384,2011,31700015,,,,3,1,4
HND-002385,2011,31700016,,,,2,1,3
HND-002387,2011,31700019,,,,1,0,1
HND-002373,2011,31700001,,,,4,2,6
HND-002374,2011,31700002,,,,2,2,4
HND-002375,2011,31700003,,,,1,3,4
HND-002378,2011,31700006,,,,16,12,28
HND-002379,2011,31700007,,,,3,0,3
HND-002386,2011,31700017,,,,1,4,5
HND-002376,2011,31700004,,,,0,2,2
HND-002377,2011,31700005,,,,2,5,7
HND-002384,2011,31700015,,,,1,3,4
HND-002385,2011,31700016,,,,1,0,1
HND-002387,2011,31700019,,,,2,1,3
HND-002388,2011,31700020,,,,3,4,7
HND-002378,2011,31700006,,,,21,18,39
HND-002383,2011,31700014,,,,2,1,3
HND-002384,2011,31700015,,,,0,2,2
HND-002385,2011,31700016,,,,0,1,1
HND-002387,2011,31700019,,,,1,4,5
HND-002373,2011,31700001,,,,1,0,1
HND-002374,2011,31700002,,,,3,3,6
HND-002375,2011,31700003,,,,3,2,5
HND-002376,2011,31700004,,,,2,1,3
HND-002377,2011,31700005,,,,4,7,11
HND-002379,2011,31700007,,,,5,4,9
HND-002386,2011,31700017,,,,2,1,3
HND-002388,2011,31700020,,,,2,6,8
HND-002373,2011,31700001,,,,1,0,1
HND-002375,2011,31700003,,,,1,2,3
HND-002378,2011,31700006,,,,13,18,31
HND-002379,2011,31700007,,,,1,6,7
HND-002384,2011,31700015,,,,1,2,3
HND-002386,2011,31700017,,,,2,1,3
HND-002387,2011,31700019,,,,1,1,2
HND-002374,2011,31700002,,,,4,3,7
HND-002376,2011,31700004,,,,4,1,5
HND-002377,2011,31700005,,,,0,1,1
HND-002383,2011,31700014,,,,1,1,2
HND-002385,2011,31700016,,,,1,1,2
HND-002388,2011,31700020,,,,6,3,9
HND-002378,2011,31700006,,,,21,22,43
HND-002384,2011,31700015,,,,1,4,5
HND-002385,2011,31700016,,,,1,2,3
HND-002387,2011,31700019,,,,4,4,8
HND-002373,2011,31700001,,,,3,1,4
HND-002374,2011,31700002,,,,5,7,12
HND-002375,2011,31700003,,,,1,1,2
HND-002376,2011,31700004,,,,3,2,5
HND-002377,2011,31700005,,,,3,2,5
HND-002379,2011,31700007,,,,1,3,4
HND-002383,2011,31700014,,,,2,1,3
HND-002386,2011,31700017,,,,0,2,2
HND-002388,2011,31700020,,,,2,3,5
HND-002377,2011,31700005,,,,1,2,3
HND-002385,2011,31700016,,,,1,1,2
HND-002387,2011,31700019,,,,0,1,1
HND-002388,2011,31700020,,,,5,5,10
HND-002374,2011,31700002,,,,4,4,8
HND-002375,2011,31700003,,,,1,3,4
HND-002376,2011,31700004,,,,4,1,5
HND-002378,2011,31700006,,,,23,21,44
HND-002379,2011,31700007,,,,1,2,3
HND-002386,2011,31700017,,,,1,4,5
HND-002381,2011,31700010,,,,39,46,85
HND-002381,2011,31700010,,,,32,29,61
HND-002381,2011,31700010,,,,31,37,68
HND-002381,2011,31700010,,,,3,4,7
HND-002381,2011,31700010,,,,2,3,5
HND-002381,2011,31700010,,,,3,4,7
HND-002472,2011,31800113,,,,5,6,11
,2011,31800145,,,,5,8,13
,2011,31800147,,,,4,4,8
,2011,31800150,,,,5,3,8
HND-002483,2011,31800153,,,,3,8,11
,2011,31800156,,,,9,4,13
HND-002485,2011,31800160,,,,9,12,21
HND-002486,2011,31800161,,,,8,11,19
,2011,31800162,,,,8,13,21
HND-002487,2011,31800163,,,,5,1,6
,2011,31800169,,,,2,6,8
HND-002496,2011,31800204,,,,12,15,27
HND-002498,2011,31800207,,,,8,7,15
,2011,31800213,,,,5,7,12
,2011,31800219,,,,5,1,6
HND-002504,2011,31800230,,,,1,5,6
HND-002507,2011,31800234,,,,5,5,10
,2011,31800238,,,,3,3,6
HND-002482,2011,31800149,,,,10,6,16
HND-002484,2011,31800154,,,,5,9,14
,2011,31800157,,,,1,6,7
HND-002488,2011,31800165,,,,4,6,10
HND-002489,2011,31800166,,,,5,4,9
HND-002490,2011,31800170,,,,5,7,12
,2011,31800171,,,,11,9,20
,2011,31800185,,,,2,6,8
HND-002497,2011,31800205,,,,5,12,17
,2011,31800206,,,,10,5,15
HND-002499,2011,31800210,,,,8,6,14
,2011,31800215,,,,4,4,8
,2011,31800227,,,,4,4,8
,2011,31800228,,,,7,6,13
HND-002503,2011,31800229,,,,4,5,9
,2011,31800232,,,,3,7,10
,2011,31800233,,,,4,2,6
HND-002508,2011,31800235,,,,5,1,6
HND-002509,2011,31800236,,,,10,6,16
,2011,31800237,,,,5,2,7
,2011,31800242,,,,5,3,8
HND-002512,2011,31800243,,,,3,5,8
HND-002431,2011,31800046,,,,1,0,1
,2011,31800066,,,,6,6,12
,2011,31800076,,,,1,1,2
HND-002445,2011,31800077,,,,1,1,2
,2011,31800091,,,,6,5,11
HND-002458,2011,31800092,,,,8,6,14
,2011,31800117,,,,3,2,5
,2011,31800126,,,,13,8,21
,2011,31800139,,,,5,12,17
,2011,31800223,,,,6,0,6
,2011,31800225,,,,1,0,1
,2011,31800053,,,,0,1,1
,2011,31800058,,,,4,11,15
,2011,31800099,,,,2,4,6
HND-002423,2011,31800037,,,,29,42,71
HND-002433,2011,31800048,,,,6,4,10
,2011,31800053,,,,1,1,2
,2011,31800075,,,,4,7,11
,2011,31800076,,,,5,2,7
HND-002445,2011,31800077,,,,4,3,7
HND-002446,2011,31800078,,,,4,6,10
,2011,31800091,,,,6,5,11
HND-002458,2011,31800092,,,,8,7,15
,2011,31800094,,,,14,0,14
HND-002463,2011,31800102,,,,5,6,11
HND-002468,2011,31800109,,,,4,1,5
,2011,31800115,,,,4,10,14
HND-002473,2011,31800116,,,,6,10,16
,2011,31800117,,,,10,12,22
HND-002477,2011,31800122,,,,7,8,15
,2011,31800146,,,,4,7,11
HND-002494,2011,31800202,,,,6,2,8
HND-002500,2011,31800220,,,,4,4,8
,2011,31800221,,,,10,6,16
HND-002501,2011,31800222,,,,4,2,6
,2011,31800225,,,,3,0,3
,2011,31800033,,,,2,2,4
HND-002421,2011,31800035,,,,17,15,32
HND-002422,2011,31800036,,,,16,13,29
HND-002424,2011,31800038,,,,10,7,17
HND-002425,2011,31800039,,,,14,14,28
HND-002426,2011,31800040,,,,16,16,32
HND-002431,2011,31800046,,,,5,6,11
,2011,31800049,,,,7,5,12
,2011,31800052,,,,14,12,26
,2011,31800058,,,,19,24,43
,2011,31800066,,,,10,14,24
,2011,31800099,,,,7,5,12
HND-002476,2011,31800120,,,,23,21,44
,2011,31800121,,,,2,2,4
,2011,31800126,,,,12,10,22
,2011,31800139,,,,9,9,18
,2011,31800143,,,,14,16,30
HND-002493,2011,31800201,,,,4,9,13
HND-002495,2011,31800203,,,,6,2,8
,2011,31800223,,,,3,2,5
HND-002505,2011,31800231,,,,6,3,9
,2011,31800033,,,,11,7,18
HND-002421,2011,31800035,,,,30,31,61
HND-002422,2011,31800036,,,,42,28,70
HND-002423,2011,31800037,,,,48,47,95
HND-002424,2011,31800038,,,,42,41,83
HND-002425,2011,31800039,,,,11,9,20
HND-002426,2011,31800040,,,,29,31,60
HND-002430,2011,31800045,,,,30,25,55
,2011,31800052,,,,11,14,25
,2011,31800053,,,,6,6,12
,2011,31800058,,,,26,27,53
,2011,31800066,,,,12,10,22
HND-002449,2011,31800081,,,,14,13,27
HND-002458,2011,31800092,,,,14,6,20
,2011,31800094,,,,11,0,11
,2011,31800099,,,,4,10,14
HND-002471,2011,31800112,,,,27,23,50
,2011,31800115,,,,11,7,18
HND-002474,2011,31800118,,,,12,7,19
HND-002475,2011,31800119,,,,18,22,40
HND-002476,2011,31800120,,,,43,47,90
,2011,31800121,,,,10,10,20
,2011,31800126,,,,15,12,27
,2011,31800139,,,,12,11,23
,2011,31800146,,,,19,18,37
HND-002494,2011,31800202,,,,10,7,17
HND-002495,2011,31800203,,,,2,9,11
HND-002500,2011,31800220,,,,8,4,12
,2011,31800221,,,,7,8,15
HND-002501,2011,31800222,,,,10,13,23
,2011,31800225,,,,2,0,2
HND-002505,2011,31800231,,,,7,17,24
HND-002427,2011,31800041,,,,31,32,63
HND-002429,2011,31800044,,,,19,21,40
HND-002431,2011,31800046,,,,5,2,7
HND-002432,2011,31800047,,,,19,12,31
HND-002433,2011,31800048,,,,9,7,16
,2011,31800049,,,,9,13,22
,2011,31800075,,,,6,10,16
,2011,31800076,,,,4,4,8
HND-002445,2011,31800077,,,,11,8,19
HND-002446,2011,31800078,,,,7,9,16
HND-002456,2011,31800089,,,,15,18,33
,2011,31800091,,,,14,10,24
HND-002463,2011,31800102,,,,8,6,14
HND-002464,2011,31800104,,,,40,23,63
HND-002468,2011,31800109,,,,5,10,15
HND-002473,2011,31800116,,,,25,26,51
,2011,31800117,,,,11,20,31
HND-002477,2011,31800122,,,,6,6,12
,2011,31800143,,,,12,18,30
HND-002493,2011,31800201,,,,10,13,23
,2011,31800223,,,,6,3,9
HND-002390,2011,31800001,,,,29,22,51
HND-002392,2011,31800003,,,,60,53,113
HND-002395,2011,31800006,,,,27,19,46
HND-002396,2011,31800007,,,,41,35,76
HND-002398,2011,31800009,,,,7,6,13
HND-002399,2011,31800010,,,,15,11,26
HND-002401,2011,31800012,,,,42,48,90
HND-002402,2011,31800013,,,,29,31,60
HND-002404,2011,31800015,,,,23,18,41
HND-002407,2011,31800019,,,,11,10,21
HND-002410,2011,31800022,,,,10,6,16
HND-002414,2011,31800026,,,,12,11,23
HND-002417,2011,31800029,,,,7,7,14
HND-002418,2011,31800030,,,,6,3,9
,2011,31800033,,,,20,20,40
HND-002434,2011,31800050,,,,5,5,10
,2011,31800052,,,,13,10,23
,2011,31800053,,,,5,5,10
HND-002435,2011,31800056,,,,4,5,9
,2011,31800064,,,,21,17,38
HND-002439,2011,31800067,,,,9,13,22
HND-002441,2011,31800070,,,,8,10,18
HND-002442,2011,31800072,,,,14,10,24
,2011,31800075,,,,18,10,28
HND-002447,2011,31800079,,,,12,8,20
HND-002451,2011,31800083,,,,13,20,33
HND-002457,2011,31800090,,,,0,47,47
HND-002459,2011,31800093,,,,5,3,8
HND-002461,2011,31800097,,,,5,12,17
,2011,31800099,,,,8,8,16
HND-002462,2011,31800101,,,,4,3,7
,2011,31800103,,,,17,12,29
HND-002465,2011,31800106,,,,17,14,31
HND-002467,2011,31800108,,,,7,9,16
HND-002470,2011,31800111,,,,22,13,35
,2011,31800115,,,,7,10,17
,2011,31800127,,,,1,3,4
HND-002480,2011,31800136,,,,12,6,18
,2011,31800137,,,,16,9,25
HND-002481,2011,31800144,,,,7,11,18
HND-002491,2011,31800188,,,,3,3,6
HND-002492,2011,31800200,,,,8,3,11
,2011,31800224,,,,4,8,12
HND-002502,2011,31800226,,,,5,2,7
HND-002510,2011,31800239,,,,12,4,16
HND-002511,2011,31800241,,,,2,8,10
HND-002514,2011,31800245,,,,2,2,4
HND-002391,2011,31800002,,,,18,9,27
HND-002393,2011,31800004,,,,36,26,62
HND-002394,2011,31800005,,,,45,41,86
HND-002397,2011,31800008,,,,42,22,64
HND-002400,2011,31800011,,,,28,22,50
HND-002403,2011,31800014,,,,20,6,26
HND-002405,2011,31800016,,,,11,11,22
HND-002406,2011,31800017,,,,3,7,10
HND-002408,2011,31800020,,,,41,28,69
HND-002409,2011,31800021,,,,13,8,21
HND-002411,2011,31800023,,,,13,8,21
HND-002412,2011,31800024,,,,27,18,45
HND-002413,2011,31800025,,,,49,29,78
HND-002415,2011,31800027,,,,7,7,14
HND-002416,2011,31800028,,,,41,27,68
HND-002419,2011,31800031,,,,6,4,10
HND-002420,2011,31800032,,,,17,20,37
HND-002428,2011,31800043,,,,5,4,9
,2011,31800058,,,,16,24,40
HND-002438,2011,31800065,,,,13,7,20
HND-002440,2011,31800068,,,,13,13,26
HND-002443,2011,31800073,,,,7,5,12
HND-002444,2011,31800074,,,,21,19,40
,2011,31800076,,,,7,7,14
HND-002448,2011,31800080,,,,3,3,6
HND-002450,2011,31800082,,,,13,6,19
,2011,31800084,,,,3,3,6
HND-002452,2011,31800085,,,,15,10,25
HND-002453,2011,31800086,,,,9,7,16
HND-002454,2011,31800087,,,,14,20,34
HND-002455,2011,31800088,,,,23,24,47
HND-002460,2011,31800095,,,,9,14,23
HND-002466,2011,31800107,,,,11,9,20
HND-002469,2011,31800110,,,,38,37,75
,2011,31800117,,,,14,10,24
HND-002478,2011,31800124,,,,11,12,23
,2011,31800143,,,,15,14,29
,2011,31800223,,,,0,1,1
,2011,31800225,,,,4,3,7
,2011,31800240,,,,2,3,5
HND-002513,2011,31800244,,,,7,5,12
HND-002391,2011,31800002,,,,16,8,24
HND-002395,2011,31800006,,,,11,14,25
HND-002398,2011,31800009,,,,2,2,4
HND-002399,2011,31800010,,,,12,14,26
HND-002403,2011,31800014,,,,8,4,12
HND-002404,2011,31800015,,,,17,17,34
HND-002407,2011,31800019,,,,13,11,24
HND-002408,2011,31800020,,,,39,33,72
HND-002409,2011,31800021,,,,13,11,24
HND-002410,2011,31800022,,,,8,8,16
HND-002411,2011,31800023,,,,7,7,14
HND-002413,2011,31800025,,,,24,37,61
HND-002414,2011,31800026,,,,10,7,17
HND-002415,2011,31800027,,,,10,2,12
HND-002416,2011,31800028,,,,25,15,40
HND-002419,2011,31800031,,,,6,2,8
,2011,31800033,,,,15,8,23
HND-002428,2011,31800043,,,,2,3,5
HND-002434,2011,31800050,,,,9,11,20
,2011,31800052,,,,12,11,23
,2011,31800053,,,,6,7,13
,2011,31800058,,,,19,14,33
HND-002443,2011,31800073,,,,3,8,11
HND-002444,2011,31800074,,,,26,27,53
HND-002447,2011,31800079,,,,15,5,20
HND-002450,2011,31800082,,,,12,16,28
HND-002454,2011,31800087,,,,10,8,18
HND-002459,2011,31800093,,,,5,6,11
HND-002460,2011,31800095,,,,11,8,19
HND-002461,2011,31800097,,,,7,4,11
,2011,31800099,,,,8,12,20
,2011,31800115,,,,3,11,14
HND-002478,2011,31800124,,,,10,10,20
,2011,31800127,,,,2,2,4
HND-002492,2011,31800200,,,,5,2,7
,2011,31800224,,,,5,6,11
HND-002502,2011,31800226,,,,3,1,4
,2011,31800240,,,,2,2,4
HND-002513,2011,31800244,,,,6,7,13
HND-002390,2011,31800001,,,,34,15,49
HND-002392,2011,31800003,,,,63,48,111
HND-002393,2011,31800004,,,,35,22,57
HND-002394,2011,31800005,,,,47,43,90
HND-002396,2011,31800007,,,,39,48,87
HND-002397,2011,31800008,,,,33,29,62
HND-002400,2011,31800011,,,,13,19,32
HND-002401,2011,31800012,,,,24,28,52
HND-002402,2011,31800013,,,,28,25,53
HND-002405,2011,31800016,,,,4,9,13
HND-002406,2011,31800017,,,,10,13,23
HND-002412,2011,31800024,,,,20,23,43
HND-002417,2011,31800029,,,,7,7,14
HND-002418,2011,31800030,,,,5,5,10
HND-002420,2011,31800032,,,,14,10,24
HND-002435,2011,31800056,,,,1,2,3
,2011,31800064,,,,8,14,22
HND-002438,2011,31800065,,,,14,11,25
HND-002439,2011,31800067,,,,9,7,16
HND-002440,2011,31800068,,,,5,25,30
HND-002441,2011,31800070,,,,7,4,11
HND-002442,2011,31800072,,,,16,10,26
,2011,31800075,,,,11,7,18
,2011,31800076,,,,4,2,6
HND-002448,2011,31800080,,,,6,0,6
HND-002451,2011,31800083,,,,31,18,49
,2011,31800084,,,,5,2,7
HND-002452,2011,31800085,,,,16,15,31
HND-002453,2011,31800086,,,,6,6,12
HND-002455,2011,31800088,,,,20,27,47
HND-002457,2011,31800090,,,,0,45,45
HND-002462,2011,31800101,,,,8,3,11
,2011,31800103,,,,7,6,13
HND-002465,2011,31800106,,,,17,20,37
HND-002466,2011,31800107,,,,20,20,40
HND-002467,2011,31800108,,,,5,4,9
HND-002469,2011,31800110,,,,39,45,84
HND-002470,2011,31800111,,,,26,25,51
,2011,31800117,,,,17,17,34
HND-002480,2011,31800136,,,,8,11,19
,2011,31800137,,,,11,9,20
,2011,31800143,,,,14,11,25
HND-002481,2011,31800144,,,,7,9,16
HND-002491,2011,31800188,,,,1,6,7
,2011,31800223,,,,7,0,7
HND-002511,2011,31800241,,,,3,3,6
HND-002514,2011,31800245,,,,4,2,6
HND-002390,2011,31800001,,,,37,22,59
HND-002395,2011,31800006,,,,11,17,28
HND-002398,2011,31800009,,,,4,2,6
HND-002399,2011,31800010,,,,9,16,25
HND-002401,2011,31800012,,,,28,25,53
HND-002402,2011,31800013,,,,36,27,63
HND-002404,2011,31800015,,,,24,33,57
HND-002407,2011,31800019,,,,9,8,17
HND-002410,2011,31800022,,,,8,8,16
HND-002411,2011,31800023,,,,9,13,22
HND-002414,2011,31800026,,,,4,1,5
HND-002415,2011,31800027,,,,6,3,9
HND-002417,2011,31800029,,,,4,9,13
HND-002419,2011,31800031,,,,6,0,6
HND-002420,2011,31800032,,,,17,14,31
HND-002428,2011,31800043,,,,4,3,7
HND-002434,2011,31800050,,,,10,15,25
,2011,31800058,,,,16,24,40
,2011,31800064,,,,10,9,19
HND-002439,2011,31800067,,,,8,8,16
HND-002443,2011,31800073,,,,8,9,17
HND-002444,2011,31800074,,,,22,30,52
,2011,31800076,,,,5,7,12
HND-002448,2011,31800080,,,,2,3,5
HND-002450,2011,31800082,,,,11,6,17
,2011,31800084,,,,4,3,7
HND-002452,2011,31800085,,,,10,7,17
HND-002453,2011,31800086,,,,7,10,17
HND-002454,2011,31800087,,,,8,4,12
HND-002455,2011,31800088,,,,27,37,64
HND-002460,2011,31800095,,,,9,6,15
,2011,31800099,,,,6,9,15
HND-002466,2011,31800107,,,,13,19,32
HND-002469,2011,31800110,,,,41,32,73
HND-002478,2011,31800124,,,,14,12,26
,2011,31800127,,,,3,2,5
HND-002480,2011,31800136,,,,4,6,10
,2011,31800137,,,,10,11,21
HND-002481,2011,31800144,,,,6,5,11
HND-002491,2011,31800188,,,,3,2,5
HND-002492,2011,31800200,,,,6,2,8
HND-002502,2011,31800226,,,,8,4,12
,2011,31800240,,,,3,2,5
HND-002513,2011,31800244,,,,2,2,4
HND-002391,2011,31800002,,,,12,14,26
HND-002392,2011,31800003,,,,60,50,110
HND-002393,2011,31800004,,,,48,37,85
HND-002394,2011,31800005,,,,54,44,98
HND-002396,2011,31800007,,,,59,51,110
HND-002397,2011,31800008,,,,23,20,43
HND-002400,2011,31800011,,,,26,12,38
HND-002403,2011,31800014,,,,11,5,16
HND-002405,2011,31800016,,,,6,8,14
HND-002406,2011,31800017,,,,12,5,17
HND-002408,2011,31800020,,,,33,22,55
HND-002409,2011,31800021,,,,9,13,22
HND-002412,2011,31800024,,,,28,25,53
HND-002413,2011,31800025,,,,31,43,74
HND-002416,2011,31800028,,,,14,16,30
HND-002418,2011,31800030,,,,8,2,10
,2011,31800033,,,,15,13,28
,2011,31800052,,,,6,6,12
,2011,31800053,,,,7,7,14
HND-002435,2011,31800056,,,,2,2,4
HND-002438,2011,31800065,,,,12,13,25
HND-002440,2011,31800068,,,,8,11,19
HND-002441,2011,31800070,,,,7,4,11
HND-002442,2011,31800072,,,,5,8,13
,2011,31800075,,,,13,13,26
HND-002447,2011,31800079,,,,20,9,29
HND-002451,2011,31800083,,,,28,25,53
HND-002457,2011,31800090,,,,0,52,52
HND-002459,2011,31800093,,,,5,5,10
HND-002461,2011,31800097,,,,9,11,20
HND-002462,2011,31800101,,,,7,5,12
,2011,31800103,,,,11,10,21
HND-002465,2011,31800106,,,,25,23,48
HND-002467,2011,31800108,,,,4,8,12
HND-002470,2011,31800111,,,,15,18,33
,2011,31800115,,,,8,4,12
,2011,31800117,,,,12,13,25
,2011,31800143,,,,10,15,25
,2011,31800223,,,,3,3,6
HND-002510,2011,31800239,,,,1,4,5
HND-002511,2011,31800241,,,,2,5,7
HND-002514,2011,31800245,,,,2,1,3
HND-002391,2011,31800002,,,,14,17,31
HND-002394,2011,31800005,,,,57,43,100
HND-002395,2011,31800006,,,,10,20,30
HND-002397,2011,31800008,,,,22,23,45
HND-002399,2011,31800010,,,,12,15,27
HND-002400,2011,31800011,,,,21,22,43
HND-002403,2011,31800014,,,,10,6,16
HND-002404,2011,31800015,,,,20,17,37
HND-002406,2011,31800017,,,,8,10,18
HND-002407,2011,31800019,,,,10,14,24
HND-002408,2011,31800020,,,,33,32,65
HND-002409,2011,31800021,,,,4,10,14
HND-002410,2011,31800022,,,,8,8,16
HND-002411,2011,31800023,,,,13,16,29
HND-002412,2011,31800024,,,,21,23,44
HND-002413,2011,31800025,,,,31,43,74
HND-002415,2011,31800027,,,,6,8,14
HND-002416,2011,31800028,,,,21,18,39
,2011,31800033,,,,12,16,28
HND-002428,2011,31800043,,,,5,3,8
HND-002434,2011,31800050,,,,2,6,8
,2011,31800052,,,,12,12,24
,2011,31800053,,,,11,10,21
HND-002435,2011,31800056,,,,2,2,4
,2011,31800058,,,,23,20,43
HND-002438,2011,31800065,,,,13,7,20
HND-002440,2011,31800068,,,,9,13,22
HND-002441,2011,31800070,,,,7,2,9
HND-002443,2011,31800073,,,,5,7,12
HND-002447,2011,31800079,,,,8,12,20
HND-002451,2011,31800083,,,,30,30,60
HND-002454,2011,31800087,,,,18,13,31
HND-002457,2011,31800090,,,,0,54,54
HND-002459,2011,31800093,,,,4,9,13
HND-002460,2011,31800095,,,,8,11,19
HND-002461,2011,31800097,,,,7,9,16
,2011,31800099,,,,11,6,17
,2011,31800103,,,,6,8,14
HND-002470,2011,31800111,,,,21,11,32
,2011,31800115,,,,7,8,15
HND-002478,2011,31800124,,,,20,13,33
,2011,31800127,,,,3,0,3
,2011,31800143,,,,10,18,28
HND-002492,2011,31800200,,,,2,3,5
HND-002502,2011,31800226,,,,2,2,4
HND-002513,2011,31800244,,,,1,5,6
HND-002390,2011,31800001,,,,34,15,49
HND-002392,2011,31800003,,,,49,47,96
HND-002393,2011,31800004,,,,52,28,80
HND-002396,2011,31800007,,,,66,45,111
HND-002398,2011,31800009,,,,2,3,5
HND-002401,2011,31800012,,,,24,22,46
HND-002402,2011,31800013,,,,55,32,87
HND-002405,2011,31800016,,,,12,6,18
HND-002414,2011,31800026,,,,11,3,14
HND-002417,2011,31800029,,,,7,7,14
HND-002418,2011,31800030,,,,7,6,13
HND-002419,2011,31800031,,,,3,4,7
HND-002420,2011,31800032,,,,15,11,26
,2011,31800064,,,,13,11,24
HND-002439,2011,31800067,,,,6,4,10
HND-002442,2011,31800072,,,,6,11,17
HND-002444,2011,31800074,,,,20,22,42
,2011,31800075,,,,19,14,33
,2011,31800076,,,,7,9,16
HND-002448,2011,31800080,,,,3,2,5
HND-002450,2011,31800082,,,,12,7,19
,2011,31800084,,,,1,2,3
HND-002452,2011,31800085,,,,8,8,16
HND-002453,2011,31800086,,,,10,11,21
HND-002455,2011,31800088,,,,35,19,54
HND-002462,2011,31800101,,,,9,6,15
HND-002465,2011,31800106,,,,17,25,42
HND-002466,2011,31800107,,,,15,14,29
HND-002467,2011,31800108,,,,8,5,13
HND-002469,2011,31800110,,,,29,20,49
,2011,31800117,,,,17,17,34
HND-002480,2011,31800136,,,,7,6,13
,2011,31800137,,,,9,11,20
HND-002481,2011,31800144,,,,8,8,16
HND-002491,2011,31800188,,,,3,1,4
,2011,31800223,,,,4,3,7
HND-002510,2011,31800239,,,,3,1,4
,2011,31800240,,,,2,2,4
HND-002511,2011,31800241,,,,9,10,19
HND-002514,2011,31800245,,,,1,0,1
HND-002391,2011,31800002,,,,9,11,20
HND-002393,2011,31800004,,,,43,37,80
HND-002394,2011,31800005,,,,45,59,104
HND-002395,2011,31800006,,,,9,12,21
HND-002397,2011,31800008,,,,25,30,55
HND-002399,2011,31800010,,,,8,13,21
HND-002400,2011,31800011,,,,21,29,50
HND-002403,2011,31800014,,,,9,5,14
HND-002404,2011,31800015,,,,15,20,35
HND-002406,2011,31800017,,,,7,5,12
HND-002408,2011,31800020,,,,27,33,60
HND-002409,2011,31800021,,,,8,12,20
HND-002411,2011,31800023,,,,12,14,26
HND-002412,2011,31800024,,,,21,15,36
HND-002413,2011,31800025,,,,44,40,84
HND-002415,2011,31800027,,,,3,14,17
HND-002416,2011,31800028,,,,15,20,35
,2011,31800033,,,,19,14,33
HND-002434,2011,31800050,,,,9,12,21
,2011,31800052,,,,9,6,15
,2011,31800053,,,,5,1,6
HND-002435,2011,31800056,,,,1,1,2
,2011,31800058,,,,19,20,39
HND-002438,2011,31800065,,,,24,9,33
HND-002440,2011,31800068,,,,7,8,15
HND-002441,2011,31800070,,,,3,2,5
HND-002447,2011,31800079,,,,1,5,6
HND-002451,2011,31800083,,,,36,27,63
HND-002457,2011,31800090,,,,0,65,65
HND-002459,2011,31800093,,,,2,3,5
HND-002461,2011,31800097,,,,4,4,8
,2011,31800099,,,,16,5,21
HND-002462,2011,31800101,,,,3,3,6
,2011,31800103,,,,4,2,6
HND-002467,2011,31800108,,,,3,3,6
HND-002470,2011,31800111,,,,28,19,47
,2011,31800115,,,,10,6,16
,2011,31800127,,,,0,2,2
,2011,31800143,,,,13,14,27
,2011,31800223,,,,3,1,4
HND-002514,2011,31800245,,,,5,3,8
HND-002390,2011,31800001,,,,42,15,57
HND-002392,2011,31800003,,,,48,52,100
HND-002396,2011,31800007,,,,54,46,100
HND-002398,2011,31800009,,,,1,2,3
HND-002401,2011,31800012,,,,15,20,35
HND-002402,2011,31800013,,,,34,40,74
HND-002405,2011,31800016,,,,11,6,17
HND-002407,2011,31800019,,,,7,12,19
HND-002410,2011,31800022,,,,3,9,12
HND-002414,2011,31800026,,,,6,3,9
HND-002417,2011,31800029,,,,6,7,13
HND-002418,2011,31800030,,,,4,5,9
HND-002419,2011,31800031,,,,3,5,8
HND-002420,2011,31800032,,,,5,16,21
HND-002428,2011,31800043,,,,3,3,6
,2011,31800064,,,,14,15,29
HND-002439,2011,31800067,,,,7,6,13
HND-002442,2011,31800072,,,,4,6,10
HND-002443,2011,31800073,,,,8,5,13
HND-002444,2011,31800074,,,,29,20,49
,2011,31800075,,,,16,15,31
,2011,31800076,,,,6,3,9
HND-002448,2011,31800080,,,,3,3,6
HND-002450,2011,31800082,,,,5,12,17
,2011,31800084,,,,2,2,4
HND-002452,2011,31800085,,,,2,6,8
HND-002453,2011,31800086,,,,3,5,8
HND-002454,2011,31800087,,,,4,16,20
HND-002455,2011,31800088,,,,26,29,55
HND-002460,2011,31800095,,,,10,8,18
HND-002465,2011,31800106,,,,2,2,4
HND-002466,2011,31800107,,,,16,15,31
HND-002469,2011,31800110,,,,29,20,49
,2011,31800117,,,,9,12,21
HND-002478,2011,31800124,,,,10,13,23
HND-002480,2011,31800136,,,,2,3,5
,2011,31800137,,,,6,9,15
HND-002481,2011,31800144,,,,8,12,20
HND-002491,2011,31800188,,,,0,2,2
HND-002492,2011,31800200,,,,2,0,2
HND-002502,2011,31800226,,,,2,1,3
HND-002510,2011,31800239,,,,2,1,3
,2011,31800240,,,,2,1,3
HND-002511,2011,31800241,,,,4,3,7
HND-002513,2011,31800244,,,,3,5,8
HND-002390,2011,31800001,,,,40,22,62
HND-002392,2011,31800003,,,,58,39,97
HND-002393,2011,31800004,,,,34,35,69
HND-002394,2011,31800005,,,,59,48,107
HND-002396,2011,31800007,,,,65,67,132
HND-002397,2011,31800008,,,,18,25,43
HND-002400,2011,31800011,,,,14,18,32
HND-002401,2011,31800012,,,,21,23,44
HND-002402,2011,31800013,,,,42,32,74
HND-002405,2011,31800016,,,,9,3,12
HND-002406,2011,31800017,,,,8,12,20
HND-002412,2011,31800024,,,,24,23,47
HND-002417,2011,31800029,,,,8,7,15
HND-002418,2011,31800030,,,,4,5,9
HND-002420,2011,31800032,,,,10,15,25
HND-002435,2011,31800056,,,,2,1,3
,2011,31800064,,,,15,7,22
HND-002438,2011,31800065,,,,14,20,34
HND-002439,2011,31800067,,,,7,9,16
HND-002440,2011,31800068,,,,8,11,19
HND-002441,2011,31800070,,,,3,2,5
HND-002442,2011,31800072,,,,5,8,13
,2011,31800075,,,,18,9,27
,2011,31800076,,,,7,9,16
HND-002448,2011,31800080,,,,1,1,2
HND-002451,2011,31800083,,,,29,20,49
,2011,31800084,,,,2,3,5
HND-002452,2011,31800085,,,,5,7,12
HND-002453,2011,31800086,,,,4,1,5
HND-002455,2011,31800088,,,,31,19,50
HND-002457,2011,31800090,,,,0,67,67
HND-002462,2011,31800101,,,,5,3,8
,2011,31800103,,,,4,9,13
HND-002465,2011,31800106,,,,37,38,75
HND-002466,2011,31800107,,,,7,14,21
HND-002467,2011,31800108,,,,4,5,9
HND-002469,2011,31800110,,,,27,21,48
HND-002470,2011,31800111,,,,20,16,36
,2011,31800117,,,,12,17,29
HND-002480,2011,31800136,,,,0,4,4
,2011,31800137,,,,9,6,15
,2011,31800143,,,,6,16,22
HND-002481,2011,31800144,,,,8,7,15
HND-002491,2011,31800188,,,,1,2,3
,2011,31800223,,,,5,1,6
HND-002510,2011,31800239,,,,1,3,4
HND-002511,2011,31800241,,,,4,5,9
HND-002514,2011,31800245,,,,0,4,4
HND-002391,2011,31800002,,,,11,8,19
HND-002395,2011,31800006,,,,14,16,30
HND-002398,2011,31800009,,,,0,1,1
HND-002399,2011,31800010,,,,17,19,36
HND-002403,2011,31800014,,,,11,7,18
HND-002404,2011,31800015,,,,7,14,21
HND-002407,2011,31800019,,,,9,2,11
HND-002408,2011,31800020,,,,31,29,60
HND-002409,2011,31800021,,,,6,9,15
HND-002410,2011,31800022,,,,6,5,11
HND-002411,2011,31800023,,,,14,11,25
HND-002413,2011,31800025,,,,45,61,106
HND-002414,2011,31800026,,,,5,6,11
HND-002415,2011,31800027,,,,5,2,7
HND-002416,2011,31800028,,,,12,14,26
HND-002419,2011,31800031,,,,4,4,8
,2011,31800033,,,,9,16,25
HND-002428,2011,31800043,,,,3,4,7
HND-002434,2011,31800050,,,,10,6,16
,2011,31800052,,,,9,11,20
,2011,31800053,,,,2,9,11
,2011,31800058,,,,13,23,36
HND-002443,2011,31800073,,,,5,4,9
HND-002444,2011,31800074,,,,27,17,44
HND-002447,2011,31800079,,,,1,4,5
HND-002450,2011,31800082,,,,6,10,16
HND-002454,2011,31800087,,,,2,11,13
HND-002459,2011,31800093,,,,3,4,7
HND-002460,2011,31800095,,,,8,8,16
HND-002461,2011,31800097,,,,7,7,14
,2011,31800099,,,,7,15,22
,2011,31800115,,,,4,5,9
HND-002478,2011,31800124,,,,16,12,28
,2011,31800127,,,,4,3,7
HND-002492,2011,31800200,,,,1,1,2
HND-002502,2011,31800226,,,,0,2,2
,2011,31800240,,,,3,1,4
HND-002513,2011,31800244,,,,0,1,1
HND-002394,2011,31800005,,,,22,21,43
HND-002400,2011,31800011,,,,30,29,59
HND-002404,2011,31800015,,,,16,14,30
HND-002408,2011,31800020,,,,11,13,24
HND-002413,2011,31800025,,,,23,22,45
,2011,31800058,,,,13,17,30
,2011,31800059,,,,8,26,34
,2011,31800061,,,,14,4,18
HND-002436,2011,31800062,,,,127,61,188
HND-002437,2011,31800063,,,,410,485,895
HND-002451,2011,31800083,,,,18,24,42
,2011,31800099,,,,5,5,10
,2011,31800105,,,,6,6,12
HND-002465,2011,31800106,,,,24,29,53
,2011,31800123,,,,41,34,75
,2011,31800135,,,,6,15,21
,2011,31800141,,,,7,11,18
,2011,31800173,,,,19,40,59
HND-002392,2011,31800003,,,,32,26,58
HND-002420,2011,31800032,,,,11,11,22
,2011,31800052,,,,5,9,14
,2011,31800057,,,,31,31,62
,2011,31800060,,,,23,21,44
HND-002444,2011,31800074,,,,43,38,81
,2011,31800075,,,,16,19,35
,2011,31800076,,,,5,8,13
HND-002469,2011,31800110,,,,20,26,46
,2011,31800117,,,,15,13,28
,2011,31800142,,,,10,7,17
HND-002404,2011,31800015,,,,6,15,21
HND-002408,2011,31800020,,,,7,13,20
HND-002413,2011,31800025,,,,18,22,40
,2011,31800052,,,,4,11,15
,2011,31800057,,,,7,24,31
HND-002444,2011,31800074,,,,24,19,43
,2011,31800099,,,,4,7,11
HND-002392,2011,31800003,,,,16,22,38
HND-002394,2011,31800005,,,,11,30,41
HND-002400,2011,31800011,,,,18,21,39
HND-002420,2011,31800032,,,,4,6,10
,2011,31800058,,,,13,16,29
,2011,31800059,,,,4,21,25
,2011,31800060,,,,22,19,41
,2011,31800061,,,,19,5,24
HND-002436,2011,31800062,,,,66,35,101
HND-002437,2011,31800063,,,,298,374,672
,2011,31800075,,,,12,6,18
,2011,31800076,,,,3,4,7
HND-002451,2011,31800083,,,,20,15,35
HND-002465,2011,31800106,,,,20,28,48
HND-002469,2011,31800110,,,,20,19,39
,2011,31800117,,,,11,8,19
,2011,31800123,,,,35,19,54
,2011,31800135,,,,6,5,11
,2011,31800141,,,,14,11,25
,2011,31800142,,,,13,8,21
,2011,31800173,,,,11,36,47
HND-002394,2011,31800005,,,,12,26,38
HND-002404,2011,31800015,,,,11,17,28
HND-002408,2011,31800020,,,,11,8,19
HND-002413,2011,31800025,,,,17,13,30
,2011,31800057,,,,18,22,40
,2011,31800061,,,,15,5,20
HND-002436,2011,31800062,,,,56,42,98
HND-002437,2011,31800063,,,,263,376,639
,2011,31800075,,,,6,10,16
,2011,31800076,,,,1,6,7
HND-002451,2011,31800083,,,,4,26,30
,2011,31800117,,,,15,10,25
,2011,31800135,,,,7,7,14
,2011,31800141,,,,6,14,20
,2011,31800173,,,,15,28,43
HND-002392,2011,31800003,,,,15,23,38
HND-002400,2011,31800011,,,,15,17,32
HND-002420,2011,31800032,,,,4,6,10
,2011,31800052,,,,5,15,20
,2011,31800058,,,,13,21,34
,2011,31800059,,,,8,14,22
,2011,31800060,,,,22,28,50
HND-002444,2011,31800074,,,,13,22,35
,2011,31800099,,,,6,5,11
HND-002465,2011,31800106,,,,15,30,45
HND-002469,2011,31800110,,,,10,15,25
,2011,31800123,,,,20,47,67
,2011,31800142,,,,11,9,20
,2011,31800052,,,,7,8,15
,2011,31800057,,,,19,49,68
,2011,31800058,,,,9,15,24
,2011,31800060,,,,27,36,63
,2011,31800061,,,,72,3,75
HND-002436,2011,31800062,,,,100,24,124
,2011,31800099,,,,6,6,12
,2011,31800123,,,,32,58,90
,2011,31800135,,,,11,20,31
,2011,31800141,,,,7,18,25
,2011,31800142,,,,15,16,31
,2011,31800059,,,,11,34,45
HND-002437,2011,31800063,,,,294,475,769
,2011,31800075,,,,10,4,14
,2011,31800076,,,,3,2,5
,2011,31800105,,,,8,12,20
,2011,31800117,,,,11,7,18
,2011,31800173,,,,17,33,50
,2011,31800052,,,,6,5,11
,2011,31800057,,,,16,27,43
,2011,31800058,,,,12,14,26
,2011,31800059,,,,3,14,17
,2011,31800060,,,,36,23,59
,2011,31800123,,,,37,59,96
,2011,31800135,,,,5,11,16
,2011,31800141,,,,11,19,30
,2011,31800142,,,,21,19,40
,2011,31800061,,,,71,4,75
HND-002436,2011,31800062,,,,50,11,61
HND-002437,2011,31800063,,,,191,323,514
,2011,31800075,,,,5,6,11
,2011,31800076,,,,1,4,5
,2011,31800105,,,,5,15,20
,2011,31800117,,,,5,5,10
,2011,31800173,,,,5,25,30
,2011,31800059,,,,7,14,21
HND-002436,2011,31800062,,,,81,6,87
HND-002437,2011,31800063,,,,108,245,353
,2011,31800105,,,,15,23,38
,2011,31800057,,,,13,17,30
,2011,31800060,,,,16,19,35
,2011,31800061,,,,30,3,33
,2011,31800123,,,,17,42,59
,2011,31800135,,,,4,6,10
,2011,31800141,,,,4,16,20
,2011,31800142,,,,0,9,9
HND-002537,2011,31900019,,,,6,3,9
,2011,31900040,,,,5,2,7
HND-002560,2011,31900061,,,,6,8,14
HND-002561,2011,31900063,,,,3,3,6
HND-002564,2011,31900067,,,,3,2,5
HND-002565,2011,31900068,,,,3,2,5
HND-002557,2011,31900052,,,,1,4,5
,2011,31900062,,,,4,5,9
,2011,31900064,,,,4,2,6
HND-002562,2011,31900065,,,,2,2,4
HND-002563,2011,31900066,,,,6,0,6
HND-002533,2011,31900015,,,,2,2,4
HND-002555,2011,31900049,,,,1,1,2
,2011,31900008,,,,3,2,5
HND-002531,2011,31900013,,,,2,0,2
HND-002542,2011,31900026,,,,10,11,21
HND-002543,2011,31900027,,,,5,2,7
HND-002546,2011,31900030,,,,3,4,7
HND-002550,2011,31900037,,,,8,1,9
HND-002553,2011,31900046,,,,3,2,5
HND-002558,2011,31900053,,,,1,2,3
HND-002528,2011,31900010,,,,5,1,6
HND-002533,2011,31900015,,,,3,3,6
HND-002542,2011,31900026,,,,10,8,18
HND-002545,2011,31900029,,,,1,2,3
HND-002550,2011,31900037,,,,6,10,16
HND-002551,2011,31900038,,,,23,21,44
HND-002558,2011,31900053,,,,7,5,12
,2011,31900070,,,,3,0,3
HND-002523,2011,31900004,,,,4,2,6
,2011,31900008,,,,2,5,7
HND-002531,2011,31900013,,,,6,5,11
HND-002532,2011,31900014,,,,2,1,3
HND-002538,2011,31900020,,,,9,3,12
HND-002543,2011,31900027,,,,7,11,18
HND-002544,2011,31900028,,,,4,3,7
HND-002546,2011,31900030,,,,6,7,13
,2011,31900039,,,,7,4,11
HND-002553,2011,31900046,,,,8,1,9
HND-002555,2011,31900049,,,,6,4,10
,2011,31900069,,,,5,2,7
HND-002523,2011,31900004,,,,13,10,23
,2011,31900008,,,,2,1,3
HND-002531,2011,31900013,,,,8,3,11
HND-002542,2011,31900026,,,,23,19,42
HND-002543,2011,31900027,,,,32,20,52
HND-002550,2011,31900037,,,,14,12,26
HND-002551,2011,31900038,,,,27,29,56
HND-002558,2011,31900053,,,,6,8,14
,2011,31900069,,,,3,2,5
HND-002528,2011,31900010,,,,9,15,24
HND-002532,2011,31900014,,,,7,12,19
HND-002533,2011,31900015,,,,5,6,11
HND-002538,2011,31900020,,,,5,6,11
HND-002544,2011,31900028,,,,6,7,13
HND-002545,2011,31900029,,,,11,7,18
,2011,31900039,,,,4,4,8
HND-002553,2011,31900046,,,,5,4,9
HND-002555,2011,31900049,,,,10,10,20
,2011,31900070,,,,2,1,3
HND-002522,2011,31900001,,,,10,10,20
,2011,31900002,,,,6,5,11
HND-002523,2011,31900004,,,,8,8,16
HND-002525,2011,31900007,,,,4,5,9
HND-002537,2011,31900019,,,,2,3,5
HND-002539,2011,31900021,,,,55,39,94
HND-002540,2011,31900022,,,,4,0,4
HND-002549,2011,31900036,,,,11,7,18
HND-002552,2011,31900041,,,,59,32,91
HND-002556,2011,31900051,,,,2,4,6
,2011,31900069,,,,5,2,7
HND-002566,2011,31900071,,,,4,6,10
HND-002524,2011,31900005,,,,2,6,8
,2011,31900008,,,,3,2,5
HND-002527,2011,31900009,,,,13,17,30
HND-002528,2011,31900010,,,,5,8,13
HND-002529,2011,31900011,,,,8,0,8
HND-002530,2011,31900012,,,,9,3,12
HND-002531,2011,31900013,,,,7,9,16
HND-002532,2011,31900014,,,,21,11,32
HND-002533,2011,31900015,,,,8,11,19
HND-002534,2011,31900016,,,,17,6,23
HND-002535,2011,31900017,,,,10,7,17
HND-002536,2011,31900018,,,,37,26,63
HND-002538,2011,31900020,,,,6,3,9
HND-002541,2011,31900024,,,,12,8,20
HND-002553,2011,31900046,,,,7,6,13
HND-002554,2011,31900047,,,,41,47,88
HND-002557,2011,31900052,,,,8,3,11
,2011,31900057,,,,4,5,9
,2011,31900002,,,,14,13,27
HND-002523,2011,31900004,,,,11,7,18
HND-002524,2011,31900005,,,,3,7,10
,2011,31900008,,,,5,5,10
HND-002527,2011,31900009,,,,17,18,35
HND-002529,2011,31900011,,,,5,8,13
HND-002530,2011,31900012,,,,5,4,9
HND-002531,2011,31900013,,,,5,6,11
HND-002535,2011,31900017,,,,4,8,12
HND-002541,2011,31900024,,,,15,5,20
HND-002552,2011,31900041,,,,47,33,80
HND-002553,2011,31900046,,,,6,10,16
HND-002554,2011,31900047,,,,36,35,71
HND-002556,2011,31900051,,,,3,2,5
,2011,31900069,,,,5,5,10
HND-002566,2011,31900071,,,,3,4,7
HND-002522,2011,31900001,,,,13,9,22
HND-002525,2011,31900007,,,,3,7,10
HND-002528,2011,31900010,,,,19,19,38
HND-002532,2011,31900014,,,,17,19,36
HND-002533,2011,31900015,,,,5,9,14
HND-002534,2011,31900016,,,,18,12,30
HND-002536,2011,31900018,,,,13,11,24
HND-002537,2011,31900019,,,,2,2,4
HND-002538,2011,31900020,,,,10,4,14
HND-002539,2011,31900021,,,,40,29,69
HND-002540,2011,31900022,,,,2,6,8
HND-002549,2011,31900036,,,,12,9,21
HND-002557,2011,31900052,,,,4,0,4
,2011,31900057,,,,1,0,1
,2011,31900002,,,,13,7,20
HND-002524,2011,31900005,,,,1,9,10
,2011,31900008,,,,5,6,11
HND-002527,2011,31900009,,,,15,13,28
HND-002528,2011,31900010,,,,13,17,30
HND-002529,2011,31900011,,,,4,6,10
HND-002530,2011,31900012,,,,8,3,11
HND-002531,2011,31900013,,,,7,6,13
HND-002532,2011,31900014,,,,3,6,9
HND-002533,2011,31900015,,,,5,9,14
HND-002534,2011,31900016,,,,7,9,16
HND-002535,2011,31900017,,,,6,1,7
HND-002536,2011,31900018,,,,20,17,37
HND-002538,2011,31900020,,,,13,3,16
HND-002541,2011,31900024,,,,2,12,14
HND-002549,2011,31900036,,,,10,10,20
HND-002552,2011,31900041,,,,39,32,71
HND-002553,2011,31900046,,,,7,3,10
HND-002556,2011,31900051,,,,3,4,7
HND-002566,2011,31900071,,,,1,3,4
HND-002522,2011,31900001,,,,10,12,22
HND-002523,2011,31900004,,,,4,14,18
HND-002525,2011,31900007,,,,6,5,11
HND-002537,2011,31900019,,,,0,3,3
HND-002539,2011,31900021,,,,51,39,90
HND-002540,2011,31900022,,,,3,7,10
HND-002554,2011,31900047,,,,48,34,82
HND-002557,2011,31900052,,,,0,2,2
,2011,31900057,,,,2,0,2
,2011,31900069,,,,2,5,7
HND-002522,2011,31900001,,,,10,10,20
,2011,31900002,,,,4,8,12
HND-002523,2011,31900004,,,,5,9,14
HND-002524,2011,31900005,,,,2,5,7
HND-002525,2011,31900007,,,,7,3,10
,2011,31900008,,,,3,4,7
HND-002527,2011,31900009,,,,16,13,29
HND-002531,2011,31900013,,,,4,5,9
HND-002535,2011,31900017,,,,3,8,11
HND-002540,2011,31900022,,,,6,3,9
HND-002553,2011,31900046,,,,7,7,14
HND-002554,2011,31900047,,,,42,26,68
HND-002556,2011,31900051,,,,1,1,2
HND-002557,2011,31900052,,,,1,0,1
,2011,31900069,,,,0,1,1
HND-002566,2011,31900071,,,,4,2,6
HND-002528,2011,31900010,,,,2,7,9
HND-002530,2011,31900012,,,,6,4,10
HND-002532,2011,31900014,,,,16,9,25
HND-002533,2011,31900015,,,,7,7,14
HND-002534,2011,31900016,,,,7,6,13
HND-002536,2011,31900018,,,,12,16,28
HND-002537,2011,31900019,,,,5,3,8
HND-002538,2011,31900020,,,,9,9,18
HND-002539,2011,31900021,,,,37,42,79
HND-002541,2011,31900024,,,,14,10,24
HND-002549,2011,31900036,,,,7,17,24
HND-002552,2011,31900041,,,,39,38,77
,2011,31900057,,,,5,4,9
HND-002522,2011,31900001,,,,14,8,22
,2011,31900002,,,,15,8,23
HND-002523,2011,31900004,,,,7,6,13
HND-002524,2011,31900005,,,,4,4,8
HND-002525,2011,31900007,,,,6,6,12
,2011,31900008,,,,1,4,5
HND-002539,2011,31900021,,,,37,39,76
HND-002540,2011,31900022,,,,1,6,7
HND-002553,2011,31900046,,,,4,4,8
HND-002554,2011,31900047,,,,38,44,82
HND-002556,2011,31900051,,,,5,6,11
HND-002557,2011,31900052,,,,1,4,5
,2011,31900069,,,,5,2,7
HND-002527,2011,31900009,,,,11,12,23
HND-002528,2011,31900010,,,,6,2,8
HND-002529,2011,31900011,,,,7,4,11
HND-002530,2011,31900012,,,,0,3,3
HND-002531,2011,31900013,,,,7,12,19
HND-002532,2011,31900014,,,,13,11,24
HND-002533,2011,31900015,,,,9,4,13
HND-002534,2011,31900016,,,,6,7,13
HND-002535,2011,31900017,,,,2,4,6
HND-002536,2011,31900018,,,,13,14,27
HND-002537,2011,31900019,,,,3,1,4
HND-002538,2011,31900020,,,,9,9,18
HND-002541,2011,31900024,,,,5,7,12
HND-002549,2011,31900036,,,,11,8,19
HND-002552,2011,31900041,,,,37,40,77
,2011,31900057,,,,2,0,2
HND-002566,2011,31900071,,,,6,2,8
HND-002522,2011,31900001,,,,6,15,21
HND-002525,2011,31900007,,,,4,5,9
HND-002528,2011,31900010,,,,11,9,20
HND-002532,2011,31900014,,,,16,9,25
HND-002533,2011,31900015,,,,12,4,16
HND-002534,2011,31900016,,,,8,5,13
HND-002536,2011,31900018,,,,17,21,38
HND-002537,2011,31900019,,,,3,3,6
HND-002538,2011,31900020,,,,9,6,15
HND-002539,2011,31900021,,,,41,41,82
HND-002540,2011,31900022,,,,3,2,5
HND-002549,2011,31900036,,,,13,12,25
,2011,31900057,,,,5,0,5
,2011,31900002,,,,17,11,28
HND-002523,2011,31900004,,,,4,11,15
HND-002524,2011,31900005,,,,0,2,2
,2011,31900008,,,,4,3,7
HND-002527,2011,31900009,,,,14,15,29
HND-002529,2011,31900011,,,,6,2,8
HND-002530,2011,31900012,,,,2,4,6
HND-002531,2011,31900013,,,,11,6,17
HND-002535,2011,31900017,,,,0,3,3
HND-002541,2011,31900024,,,,12,5,17
HND-002552,2011,31900041,,,,52,39,91
HND-002553,2011,31900046,,,,3,4,7
HND-002554,2011,31900047,,,,41,40,81
HND-002556,2011,31900051,,,,4,3,7
,2011,31900069,,,,2,0,2
HND-002566,2011,31900071,,,,6,1,7
HND-002548,2011,31900034,,,,48,41,89
HND-002552,2011,31900041,,,,51,45,96
HND-002527,2011,31900009,,,,25,33,58
HND-002547,2011,31900033,,,,105,130,235
HND-002527,2011,31900009,,,,16,13,29
HND-002547,2011,31900033,,,,67,101,168
HND-002552,2011,31900041,,,,29,46,75
HND-002548,2011,31900034,,,,28,28,56
HND-002527,2011,31900009,,,,12,11,23
HND-002547,2011,31900033,,,,77,94,171
HND-002548,2011,31900034,,,,27,31,58
HND-002552,2011,31900041,,,,22,19,41
HND-002547,2011,31900033,,,,44,75,119
HND-002548,2011,31900034,,,,44,34,78
HND-002547,2011,31900033,,,,26,51,77
HND-002548,2011,31900034,,,,20,5,25
HND-002547,2011,31900033,,,,38,56,94
HND-002567,2011,32000001,,,,12,7,19
,2011,32000009,,,,9,3,12
HND-002581,2011,32000016,,,,7,5,12
,2011,32000030,,,,6,6,12
,2011,32000040,,,,8,4,12
,2011,32000041,,,,5,10,15
HND-002596,2011,32000044,,,,9,7,16
HND-002597,2011,32000045,,,,11,9,20
,2011,32000048,,,,5,4,9
HND-002599,2011,32000050,,,,4,7,11
,2011,32000051,,,,5,8,13
,2011,32000053,,,,0,6,6
,2011,32000054,,,,0,5,5
HND-002594,2011,32000034,,,,12,16,28
,2011,32000035,,,,4,3,7
,2011,32000036,,,,6,9,15
,2011,32000043,,,,3,8,11
,2011,32000046,,,,6,4,10
,2011,32000047,,,,5,8,13
,2011,32000049,,,,4,4,8
,2011,32000052,,,,5,3,8
,2011,32000055,,,,2,3,5
,2011,32000056,,,,5,0,5
HND-002582,2011,32000017,,,,0,1,1
HND-002590,2011,32000025,,,,2,1,3
HND-002585,2011,32000020,,,,1,1,2
HND-002581,2011,32000016,,,,16,18,34
HND-002583,2011,32000018,,,,6,6,12
HND-002585,2011,32000020,,,,8,12,20
HND-002593,2011,32000033,,,,18,16,34
HND-002580,2011,32000014,,,,15,19,34
HND-002582,2011,32000017,,,,9,10,19
HND-002590,2011,32000025,,,,1,5,6
HND-002567,2011,32000001,,,,6,10,16
HND-002568,2011,32000002,,,,31,29,60
,2011,32000009,,,,5,3,8
HND-002576,2011,32000010,,,,9,5,14
HND-002577,2011,32000011,,,,10,26,36
HND-002586,2011,32000021,,,,40,29,69
HND-002590,2011,32000025,,,,3,5,8
HND-002591,2011,32000026,,,,9,13,22
HND-002595,2011,32000042,,,,13,8,21
HND-002569,2011,32000003,,,,7,12,19
HND-002570,2011,32000004,,,,7,3,10
HND-002571,2011,32000005,,,,13,17,30
HND-002572,2011,32000006,,,,17,14,31
HND-002573,2011,32000007,,,,6,9,15
HND-002574,2011,32000008,,,,12,9,21
HND-002578,2011,32000012,,,,4,5,9
HND-002579,2011,32000013,,,,5,7,12
HND-002583,2011,32000018,,,,7,3,10
HND-002587,2011,32000022,,,,33,31,64
HND-002588,2011,32000023,,,,0,1,1
,2011,32000024,,,,7,9,16
HND-002567,2011,32000001,,,,14,8,22
HND-002568,2011,32000002,,,,32,30,62
HND-002569,2011,32000003,,,,7,8,15
HND-002570,2011,32000004,,,,2,4,6
HND-002574,2011,32000008,,,,3,4,7
,2011,32000009,,,,2,2,4
HND-002577,2011,32000011,,,,8,15,23
HND-002578,2011,32000012,,,,1,0,1
HND-002579,2011,32000013,,,,4,3,7
HND-002583,2011,32000018,,,,5,3,8
HND-002587,2011,32000022,,,,25,17,42
HND-002571,2011,32000005,,,,9,9,18
HND-002572,2011,32000006,,,,15,6,21
HND-002573,2011,32000007,,,,6,4,10
HND-002576,2011,32000010,,,,7,12,19
HND-002584,2011,32000019,,,,0,1,1
HND-002586,2011,32000021,,,,39,40,79
HND-002588,2011,32000023,,,,1,1,2
,2011,32000024,,,,4,3,7
HND-002590,2011,32000025,,,,2,3,5
HND-002591,2011,32000026,,,,2,4,6
HND-002595,2011,32000042,,,,4,2,6
HND-002569,2011,32000003,,,,7,4,11
HND-002570,2011,32000004,,,,3,2,5
HND-002571,2011,32000005,,,,11,10,21
HND-002572,2011,32000006,,,,15,11,26
,2011,32000009,,,,2,6,8
HND-002578,2011,32000012,,,,3,3,6
HND-002579,2011,32000013,,,,2,3,5
HND-002587,2011,32000022,,,,28,29,57
HND-002588,2011,32000023,,,,0,2,2
,2011,32000024,,,,3,0,3
HND-002567,2011,32000001,,,,6,9,15
HND-002568,2011,32000002,,,,24,31,55
HND-002573,2011,32000007,,,,8,4,12
HND-002574,2011,32000008,,,,4,9,13
HND-002576,2011,32000010,,,,2,2,4
HND-002577,2011,32000011,,,,8,10,18
HND-002583,2011,32000018,,,,2,5,7
HND-002584,2011,32000019,,,,0,3,3
HND-002586,2011,32000021,,,,35,43,78
HND-002590,2011,32000025,,,,3,0,3
HND-002591,2011,32000026,,,,4,4,8
HND-002595,2011,32000042,,,,5,5,10
HND-002567,2011,32000001,,,,9,2,11
HND-002568,2011,32000002,,,,38,35,73
HND-002569,2011,32000003,,,,3,11,14
HND-002570,2011,32000004,,,,1,4,5
HND-002574,2011,32000008,,,,6,5,11
,2011,32000009,,,,5,1,6
HND-002576,2011,32000010,,,,2,2,4
HND-002577,2011,32000011,,,,6,8,14
HND-002579,2011,32000013,,,,2,2,4
HND-002583,2011,32000018,,,,3,2,5
HND-002584,2011,32000019,,,,3,2,5
HND-002586,2011,32000021,,,,29,32,61
HND-002587,2011,32000022,,,,32,18,50
HND-002571,2011,32000005,,,,9,8,17
HND-002572,2011,32000006,,,,9,9,18
HND-002573,2011,32000007,,,,5,5,10
HND-002578,2011,32000012,,,,2,0,2
,2011,32000024,,,,3,6,9
HND-002590,2011,32000025,,,,4,1,5
HND-002591,2011,32000026,,,,1,2,3
HND-002595,2011,32000042,,,,6,6,12
HND-002567,2011,32000001,,,,9,12,21
HND-002568,2011,32000002,,,,19,44,63
HND-002570,2011,32000004,,,,5,1,6
HND-002574,2011,32000008,,,,4,3,7
HND-002576,2011,32000010,,,,1,0,1
HND-002577,2011,32000011,,,,4,3,7
HND-002583,2011,32000018,,,,1,5,6
HND-002584,2011,32000019,,,,2,2,4
HND-002586,2011,32000021,,,,29,32,61
HND-002587,2011,32000022,,,,27,25,52
HND-002590,2011,32000025,,,,1,3,4
HND-002591,2011,32000026,,,,1,5,6
HND-002569,2011,32000003,,,,9,10,19
HND-002571,2011,32000005,,,,13,7,20
HND-002572,2011,32000006,,,,11,6,17
HND-002573,2011,32000007,,,,9,6,15
,2011,32000009,,,,1,6,7
HND-002578,2011,32000012,,,,3,2,5
HND-002579,2011,32000013,,,,2,2,4
HND-002588,2011,32000023,,,,3,0,3
,2011,32000024,,,,2,0,2
HND-002595,2011,32000042,,,,7,4,11
HND-002571,2011,32000005,,,,9,8,17
HND-002572,2011,32000006,,,,17,8,25
HND-002573,2011,32000007,,,,5,6,11
HND-002576,2011,32000010,,,,2,1,3
HND-002586,2011,32000021,,,,24,31,55
HND-002588,2011,32000023,,,,0,1,1
,2011,32000024,,,,0,1,1
HND-002590,2011,32000025,,,,0,4,4
HND-002591,2011,32000026,,,,4,2,6
HND-002595,2011,32000042,,,,5,3,8
HND-002567,2011,32000001,,,,9,4,13
HND-002568,2011,32000002,,,,26,35,61
HND-002569,2011,32000003,,,,5,4,9
HND-002570,2011,32000004,,,,2,0,2
HND-002574,2011,32000008,,,,3,3,6
,2011,32000009,,,,2,2,4
HND-002577,2011,32000011,,,,1,4,5
HND-002578,2011,32000012,,,,1,1,2
HND-002579,2011,32000013,,,,3,1,4
HND-002583,2011,32000018,,,,6,3,9
HND-002587,2011,32000022,,,,19,27,46
HND-002572,2011,32000006,,,,34,30,64
HND-002592,2011,32000027,,,,83,100,183
HND-002572,2011,32000006,,,,28,33,61
HND-002592,2011,32000027,,,,57,74,131
HND-002572,2011,32000006,,,,8,26,34
HND-002592,2011,32000027,,,,49,55,104
HND-002592,2011,32000027,,,,36,43,79
HND-002592,2011,32000027,,,,24,33,57
HND-002592,2011,32000027,,,,20,25,45
,2011,32100060,,,,3,9,12
HND-002665,2011,32100070,,,,2,8,10
HND-002666,2011,32100072,,,,6,9,15
HND-002667,2011,32100075,,,,7,6,13
,2011,32100076,,,,6,5,11
,2011,32100077,,,,3,8,11
,2011,32100088,,,,6,4,10
HND-002671,2011,32100093,,,,7,10,17
,2011,32100094,,,,8,4,12
,2011,32100099,,,,2,5,7
HND-002662,2011,32100064,,,,9,6,15
,2011,32100066,,,,10,19,29
,2011,32100073,,,,13,10,23
,2011,32100074,,,,5,5,10
HND-002669,2011,32100078,,,,5,6,11
HND-002670,2011,32100079,,,,2,9,11
,2011,32100085,,,,3,8,11
,2011,32100090,,,,5,8,13
,2011,32100097,,,,10,7,17
HND-002642,2011,32100040,,,,4,7,11
,2011,32100045,,,,1,0,1
,2011,32100047,,,,1,5,6
HND-002650,2011,32100049,,,,2,1,3
HND-002643,2011,32100041,,,,1,2,3
HND-002642,2011,32100040,,,,18,30,48
HND-002644,2011,32100042,,,,1,2,3
,2011,32100045,,,,2,0,2
,2011,32100047,,,,9,10,19
HND-002651,2011,32100050,,,,3,3,6
HND-002660,2011,32100062,,,,4,4,8
HND-002661,2011,32100063,,,,2,3,5
,2011,32100065,,,,4,4,8
,2011,32100071,,,,2,0,2
HND-002643,2011,32100041,,,,3,4,7
HND-002649,2011,32100048,,,,0,2,2
HND-002650,2011,32100049,,,,2,4,6
,2011,32100051,,,,1,4,5
HND-002652,2011,32100052,,,,7,9,16
HND-002653,2011,32100053,,,,2,1,3
HND-002659,2011,32100061,,,,1,3,4
,2011,32100098,,,,3,2,5
HND-002643,2011,32100041,,,,6,6,12
HND-002649,2011,32100048,,,,16,12,28
,2011,32100051,,,,10,8,18
HND-002652,2011,32100052,,,,11,18,29
HND-002653,2011,32100053,,,,17,20,37
HND-002659,2011,32100061,,,,2,11,13
HND-002660,2011,32100062,,,,9,8,17
HND-002661,2011,32100063,,,,5,8,13
,2011,32100065,,,,8,6,14
,2011,32100098,,,,4,12,16
HND-002642,2011,32100040,,,,22,26,48
HND-002644,2011,32100042,,,,10,15,25
,2011,32100045,,,,3,4,7
,2011,32100047,,,,13,7,20
HND-002650,2011,32100049,,,,5,4,9
HND-002651,2011,32100050,,,,10,13,23
,2011,32100071,,,,1,2,3
HND-002607,2011,32100003,,,,14,8,22
HND-002608,2011,32100004,,,,10,8,18
HND-002609,2011,32100005,,,,32,20,52
HND-002610,2011,32100006,,,,10,10,20
HND-002613,2011,32100009,,,,6,5,11
HND-002614,2011,32100010,,,,5,7,12
HND-002615,2011,32100011,,,,8,4,12
HND-002621,2011,32100017,,,,5,4,9
HND-002622,2011,32100018,,,,2,1,3
HND-002626,2011,32100022,,,,2,1,3
HND-002627,2011,32100023,,,,9,5,14
HND-002628,2011,32100024,,,,8,12,20
HND-002629,2011,32100025,,,,2,5,7
HND-002630,2011,32100026,,,,3,6,9
HND-002633,2011,32100029,,,,3,3,6
HND-002634,2011,32100030,,,,2,4,6
HND-002639,2011,32100035,,,,14,9,23
HND-002647,2011,32100046,,,,0,2,2
HND-002656,2011,32100057,,,,4,1,5
HND-002657,2011,32100058,,,,3,1,4
HND-002664,2011,32100069,,,,8,3,11
,2011,32100071,,,,2,4,6
HND-002673,2011,32100096,,,,3,0,3
HND-002605,2011,32100001,,,,45,32,77
HND-002606,2011,32100002,,,,29,35,64
HND-002611,2011,32100007,,,,11,8,19
HND-002612,2011,32100008,,,,5,9,14
HND-002616,2011,32100012,,,,4,2,6
HND-002617,2011,32100013,,,,9,8,17
HND-002618,2011,32100014,,,,27,28,55
HND-002619,2011,32100015,,,,5,10,15
HND-002620,2011,32100016,,,,9,14,23
HND-002623,2011,32100019,,,,2,6,8
HND-002624,2011,32100020,,,,6,6,12
HND-002625,2011,32100021,,,,14,8,22
HND-002631,2011,32100027,,,,18,17,35
HND-002632,2011,32100028,,,,13,4,17
HND-002635,2011,32100031,,,,4,4,8
HND-002636,2011,32100032,,,,4,5,9
HND-002637,2011,32100033,,,,2,1,3
HND-002638,2011,32100034,,,,1,3,4
,2011,32100036,,,,13,10,23
HND-002641,2011,32100039,,,,3,2,5
HND-002646,2011,32100044,,,,6,2,8
HND-002654,2011,32100055,,,,15,15,30
HND-002655,2011,32100056,,,,4,2,6
HND-002658,2011,32100059,,,,2,2,4
HND-002663,2011,32100068,,,,8,14,22
HND-002606,2011,32100002,,,,29,33,62
HND-002607,2011,32100003,,,,13,14,27
HND-002608,2011,32100004,,,,12,10,22
HND-002612,2011,32100008,,,,7,5,12
HND-002613,2011,32100009,,,,5,6,11
HND-002614,2011,32100010,,,,12,3,15
HND-002619,2011,32100015,,,,7,5,12
HND-002620,2011,32100016,,,,8,6,14
HND-002621,2011,32100017,,,,7,4,11
HND-002625,2011,32100021,,,,6,10,16
HND-002626,2011,32100022,,,,1,2,3
HND-002627,2011,32100023,,,,2,5,7
HND-002628,2011,32100024,,,,6,11,17
HND-002632,2011,32100028,,,,9,6,15
HND-002633,2011,32100029,,,,2,3,5
HND-002634,2011,32100030,,,,2,4,6
HND-002635,2011,32100031,,,,1,4,5
HND-002637,2011,32100033,,,,2,2,4
HND-002638,2011,32100034,,,,2,0,2
,2011,32100036,,,,4,6,10
HND-002646,2011,32100044,,,,2,3,5
HND-002657,2011,32100058,,,,8,2,10
HND-002658,2011,32100059,,,,1,2,3
HND-002664,2011,32100069,,,,1,1,2
HND-002605,2011,32100001,,,,30,29,59
HND-002609,2011,32100005,,,,35,26,61
HND-002610,2011,32100006,,,,10,8,18
HND-002611,2011,32100007,,,,7,4,11
HND-002615,2011,32100011,,,,7,8,15
HND-002616,2011,32100012,,,,4,2,6
HND-002617,2011,32100013,,,,5,8,13
HND-002618,2011,32100014,,,,29,20,49
HND-002622,2011,32100018,,,,3,4,7
HND-002623,2011,32100019,,,,2,2,4
HND-002624,2011,32100020,,,,6,2,8
HND-002629,2011,32100025,,,,2,4,6
HND-002630,2011,32100026,,,,4,6,10
HND-002631,2011,32100027,,,,13,12,25
HND-002636,2011,32100032,,,,3,2,5
HND-002639,2011,32100035,,,,7,8,15
HND-002641,2011,32100039,,,,7,3,10
HND-002647,2011,32100046,,,,2,0,2
HND-002654,2011,32100055,,,,16,13,29
HND-002655,2011,32100056,,,,2,4,6
HND-002656,2011,32100057,,,,2,4,6
HND-002663,2011,32100068,,,,4,6,10
,2011,32100071,,,,3,7,10
HND-002672,2011,32100095,,,,1,2,3
HND-002673,2011,32100096,,,,0,1,1
HND-002607,2011,32100003,,,,9,12,21
HND-002608,2011,32100004,,,,5,8,13
HND-002609,2011,32100005,,,,21,19,40
HND-002610,2011,32100006,,,,4,5,9
HND-002613,2011,32100009,,,,7,5,12
HND-002614,2011,32100010,,,,6,10,16
HND-002615,2011,32100011,,,,3,7,10
HND-002621,2011,32100017,,,,6,7,13
HND-002622,2011,32100018,,,,1,8,9
HND-002626,2011,32100022,,,,4,2,6
HND-002627,2011,32100023,,,,6,3,9
HND-002628,2011,32100024,,,,5,5,10
HND-002629,2011,32100025,,,,5,1,6
HND-002630,2011,32100026,,,,5,4,9
HND-002633,2011,32100029,,,,4,4,8
HND-002635,2011,32100031,,,,2,4,6
HND-002637,2011,32100033,,,,2,2,4
HND-002638,2011,32100034,,,,1,2,3
,2011,32100036,,,,8,15,23
HND-002641,2011,32100039,,,,2,5,7
HND-002646,2011,32100044,,,,1,3,4
HND-002654,2011,32100055,,,,17,14,31
HND-002655,2011,32100056,,,,4,2,6
HND-002658,2011,32100059,,,,3,3,6
HND-002664,2011,32100069,,,,1,2,3
HND-002605,2011,32100001,,,,28,45,73
HND-002606,2011,32100002,,,,40,18,58
HND-002611,2011,32100007,,,,5,7,12
HND-002612,2011,32100008,,,,5,3,8
HND-002616,2011,32100012,,,,5,5,10
HND-002617,2011,32100013,,,,3,9,12
HND-002618,2011,32100014,,,,15,22,37
HND-002619,2011,32100015,,,,6,5,11
HND-002620,2011,32100016,,,,7,14,21
HND-002623,2011,32100019,,,,6,3,9
HND-002624,2011,32100020,,,,8,6,14
HND-002625,2011,32100021,,,,8,6,14
HND-002631,2011,32100027,,,,11,11,22
HND-002632,2011,32100028,,,,9,7,16
HND-002634,2011,32100030,,,,3,2,5
HND-002639,2011,32100035,,,,8,7,15
HND-002647,2011,32100046,,,,0,3,3
HND-002657,2011,32100058,,,,1,2,3
HND-002663,2011,32100068,,,,4,3,7
,2011,32100071,,,,1,2,3
HND-002672,2011,32100095,,,,2,0,2
HND-002673,2011,32100096,,,,1,2,3
HND-002606,2011,32100002,,,,34,25,59
HND-002607,2011,32100003,,,,8,13,21
HND-002608,2011,32100004,,,,12,8,20
HND-002612,2011,32100008,,,,7,7,14
HND-002616,2011,32100012,,,,5,8,13
HND-002619,2011,32100015,,,,3,3,6
HND-002620,2011,32100016,,,,6,5,11
HND-002621,2011,32100017,,,,1,9,10
HND-002624,2011,32100020,,,,5,4,9
HND-002625,2011,32100021,,,,11,7,18
HND-002626,2011,32100022,,,,5,0,5
HND-002627,2011,32100023,,,,3,4,7
HND-002628,2011,32100024,,,,4,8,12
HND-002632,2011,32100028,,,,10,10,20
HND-002633,2011,32100029,,,,4,5,9
HND-002634,2011,32100030,,,,2,1,3
HND-002635,2011,32100031,,,,4,4,8
HND-002657,2011,32100058,,,,4,2,6
HND-002658,2011,32100059,,,,2,0,2
HND-002663,2011,32100068,,,,3,7,10
HND-002664,2011,32100069,,,,3,3,6
HND-002672,2011,32100095,,,,1,1,2
HND-002673,2011,32100096,,,,0,1,1
HND-002605,2011,32100001,,,,28,29,57
HND-002609,2011,32100005,,,,21,21,42
HND-002610,2011,32100006,,,,13,8,21
HND-002611,2011,32100007,,,,3,7,10
HND-002613,2011,32100009,,,,8,5,13
HND-002614,2011,32100010,,,,9,9,18
HND-002615,2011,32100011,,,,3,5,8
HND-002617,2011,32100013,,,,9,1,10
HND-002618,2011,32100014,,,,25,21,46
HND-002622,2011,32100018,,,,4,3,7
HND-002623,2011,32100019,,,,3,3,6
HND-002629,2011,32100025,,,,2,2,4
HND-002630,2011,32100026,,,,6,8,14
HND-002631,2011,32100027,,,,12,8,20
HND-002636,2011,32100032,,,,0,2,2
HND-002637,2011,32100033,,,,3,4,7
HND-002638,2011,32100034,,,,1,3,4
HND-002639,2011,32100035,,,,10,4,14
,2011,32100036,,,,9,8,17
HND-002641,2011,32100039,,,,2,3,5
HND-002646,2011,32100044,,,,4,0,4
HND-002647,2011,32100046,,,,2,0,2
HND-002654,2011,32100055,,,,9,15,24
HND-002655,2011,32100056,,,,5,0,5
HND-002656,2011,32100057,,,,2,0,2
,2011,32100071,,,,0,8,8
HND-002605,2011,32100001,,,,40,30,70
HND-002606,2011,32100002,,,,36,28,64
HND-002611,2011,32100007,,,,6,4,10
HND-002612,2011,32100008,,,,7,5,12
HND-002616,2011,32100012,,,,5,4,9
HND-002617,2011,32100013,,,,5,5,10
HND-002619,2011,32100015,,,,1,5,6
HND-002620,2011,32100016,,,,8,9,17
HND-002623,2011,32100019,,,,1,1,2
HND-002624,2011,32100020,,,,7,5,12
HND-002625,2011,32100021,,,,7,11,18
HND-002628,2011,32100024,,,,6,9,15
HND-002632,2011,32100028,,,,12,10,22
HND-002634,2011,32100030,,,,3,3,6
HND-002657,2011,32100058,,,,1,2,3
HND-002663,2011,32100068,,,,3,5,8
,2011,32100071,,,,1,2,3
HND-002607,2011,32100003,,,,13,17,30
HND-002608,2011,32100004,,,,5,13,18
HND-002609,2011,32100005,,,,16,19,35
HND-002610,2011,32100006,,,,8,8,16
HND-002613,2011,32100009,,,,5,7,12
HND-002614,2011,32100010,,,,6,9,15
HND-002615,2011,32100011,,,,7,5,12
HND-002618,2011,32100014,,,,23,21,44
HND-002621,2011,32100017,,,,2,5,7
HND-002622,2011,32100018,,,,3,3,6
HND-002626,2011,32100022,,,,5,3,8
HND-002627,2011,32100023,,,,2,4,6
HND-002629,2011,32100025,,,,3,4,7
HND-002630,2011,32100026,,,,8,7,15
HND-002631,2011,32100027,,,,16,12,28
HND-002633,2011,32100029,,,,3,3,6
HND-002635,2011,32100031,,,,2,3,5
HND-002636,2011,32100032,,,,6,2,8
HND-002637,2011,32100033,,,,1,1,2
HND-002638,2011,32100034,,,,2,3,5
HND-002639,2011,32100035,,,,5,8,13
,2011,32100036,,,,10,11,21
HND-002641,2011,32100039,,,,2,4,6
HND-002646,2011,32100044,,,,2,2,4
HND-002647,2011,32100046,,,,1,2,3
HND-002654,2011,32100055,,,,14,15,29
HND-002655,2011,32100056,,,,3,2,5
HND-002656,2011,32100057,,,,2,2,4
HND-002658,2011,32100059,,,,2,1,3
HND-002605,2011,32100001,,,,29,39,68
HND-002609,2011,32100005,,,,25,14,39
HND-002610,2011,32100006,,,,7,7,14
HND-002611,2011,32100007,,,,3,1,4
HND-002615,2011,32100011,,,,1,5,6
HND-002616,2011,32100012,,,,10,2,12
HND-002617,2011,32100013,,,,13,6,19
HND-002618,2011,32100014,,,,21,14,35
HND-002622,2011,32100018,,,,3,3,6
HND-002623,2011,32100019,,,,2,2,4
HND-002624,2011,32100020,,,,4,7,11
HND-002629,2011,32100025,,,,2,2,4
HND-002630,2011,32100026,,,,5,5,10
HND-002631,2011,32100027,,,,5,12,17
HND-002636,2011,32100032,,,,3,4,7
HND-002639,2011,32100035,,,,6,6,12
HND-002641,2011,32100039,,,,4,5,9
HND-002647,2011,32100046,,,,2,1,3
HND-002654,2011,32100055,,,,16,13,29
HND-002655,2011,32100056,,,,5,6,11
HND-002656,2011,32100057,,,,0,5,5
HND-002663,2011,32100068,,,,7,7,14
,2011,32100071,,,,1,3,4
HND-002606,2011,32100002,,,,35,40,75
HND-002607,2011,32100003,,,,21,12,33
HND-002608,2011,32100004,,,,6,14,20
HND-002612,2011,32100008,,,,10,5,15
HND-002613,2011,32100009,,,,7,3,10
HND-002614,2011,32100010,,,,11,7,18
HND-002619,2011,32100015,,,,11,0,11
HND-002620,2011,32100016,,,,12,8,20
HND-002621,2011,32100017,,,,3,4,7
HND-002625,2011,32100021,,,,9,4,13
HND-002626,2011,32100022,,,,7,3,10
HND-002627,2011,32100023,,,,5,5,10
HND-002628,2011,32100024,,,,7,7,14
HND-002632,2011,32100028,,,,9,5,14
HND-002633,2011,32100029,,,,3,2,5
HND-002634,2011,32100030,,,,1,0,1
HND-002635,2011,32100031,,,,5,1,6
HND-002637,2011,32100033,,,,0,2,2
HND-002638,2011,32100034,,,,2,0,2
,2011,32100036,,,,7,12,19
HND-002646,2011,32100044,,,,2,3,5
HND-002657,2011,32100058,,,,6,3,9
HND-002658,2011,32100059,,,,1,2,3
HND-002664,2011,32100069,,,,1,2,3
HND-002618,2011,32100014,,,,11,21,32
HND-002631,2011,32100027,,,,9,16,25
HND-002645,2011,32100043,,,,111,148,259
HND-002607,2011,32100003,,,,14,15,29
HND-002609,2011,32100005,,,,9,24,33
HND-002615,2011,32100011,,,,2,9,11
HND-002654,2011,32100055,,,,31,29,60
,2011,32100071,,,,3,1,4
HND-002607,2011,32100003,,,,6,15,21
HND-002645,2011,32100043,,,,91,112,203
HND-002609,2011,32100005,,,,12,13,25
HND-002615,2011,32100011,,,,4,7,11
HND-002618,2011,32100014,,,,6,8,14
HND-002631,2011,32100027,,,,6,5,11
HND-002654,2011,32100055,,,,16,28,44
HND-002607,2011,32100003,,,,13,13,26
,2011,32100071,,,,2,0,2
HND-002609,2011,32100005,,,,5,12,17
HND-002615,2011,32100011,,,,3,9,12
HND-002618,2011,32100014,,,,7,6,13
HND-002631,2011,32100027,,,,7,10,17
HND-002645,2011,32100043,,,,106,74,180
HND-002654,2011,32100055,,,,10,24,34
HND-002645,2011,32100043,,,,72,105,177
HND-002645,2011,32100043,,,,44,53,97
HND-002645,2011,32100043,,,,64,61,125
HND-002711,2011,40100038,,,,10,6,16
HND-002733,2011,40100073,,,,7,4,11
,2011,40100090,,,,6,3,9
,2011,40100093,,,,8,12,20
HND-002744,2011,40100103,,,,4,6,10
,2011,40100126,,,,7,2,9
,2011,40100129,,,,5,4,9
HND-002747,2011,40100130,,,,5,5,10
HND-002748,2011,40100131,,,,5,6,11
HND-002749,2011,40100132,,,,8,11,19
,2011,40100143,,,,8,6,14
,2011,40100148,,,,6,5,11
,2011,40100158,,,,4,2,6
,2011,40100164,,,,5,4,9
,2011,40100165,,,,10,0,10
,2011,40100167,,,,6,6,12
HND-002758,2011,40100169,,,,7,5,12
,2011,40100171,,,,4,5,9
,2011,40100173,,,,8,6,14
,2011,40100174,,,,5,5,10
,2011,40100177,,,,6,5,11
,2011,40100184,,,,9,0,9
,2011,40100186,,,,3,7,10
,2011,40100187,,,,6,5,11
HND-002719,2011,40100048,,,,5,5,10
HND-002720,2011,40100049,,,,5,5,10
HND-002729,2011,40100066,,,,11,0,11
HND-002741,2011,40100085,,,,4,6,10
HND-002742,2011,40100086,,,,5,5,10
,2011,40100101,,,,9,0,9
,2011,40100125,,,,10,6,16
HND-002751,2011,40100147,,,,8,2,10
HND-002752,2011,40100151,,,,8,4,12
,2011,40100168,,,,5,4,9
,2011,40100170,,,,3,3,6
,2011,40100175,,,,6,3,9
HND-002759,2011,40100176,,,,5,5,10
HND-002760,2011,40100178,,,,5,1,6
,2011,40100179,,,,5,4,9
,2011,40100180,,,,6,4,10
,2011,40100181,,,,6,3,9
HND-002761,2011,40100182,,,,4,6,10
HND-002762,2011,40100183,,,,7,9,16
,2011,40100188,,,,5,5,10
,2011,40100189,,,,4,5,9
HND-002707,2011,40100034,,,,11,10,21
,2011,40100040,,,,7,6,13
,2011,40100045,,,,1,1,2
HND-002722,2011,40100052,,,,8,7,15
HND-002727,2011,40100058,,,,2,3,5
,2011,40100067,,,,9,5,14
HND-002735,2011,40100075,,,,20,0,20
,2011,40100078,,,,6,5,11
HND-002757,2011,40100162,,,,2,1,3
,2011,40100163,,,,13,12,25
HND-002714,2011,40100042,,,,13,18,31
HND-002718,2011,40100047,,,,3,3,6
HND-002720,2011,40100049,,,,10,12,22
HND-002724,2011,40100055,,,,2,4,6
HND-002730,2011,40100068,,,,5,5,10
HND-002732,2011,40100072,,,,4,6,10
HND-002734,2011,40100074,,,,4,6,10
,2011,40100076,,,,1,3,4
,2011,40100154,,,,10,6,16
HND-002756,2011,40100161,,,,4,3,7
,2011,40100166,,,,1,2,3
HND-002707,2011,40100034,,,,14,15,29
HND-002715,2011,40100043,,,,127,118,245
HND-002716,2011,40100044,,,,3,5,8
,2011,40100045,,,,3,4,7
HND-002717,2011,40100046,,,,27,27,54
HND-002718,2011,40100047,,,,10,12,22
HND-002722,2011,40100052,,,,18,19,37
HND-002723,2011,40100053,,,,13,9,22
,2011,40100067,,,,7,4,11
HND-002731,2011,40100071,,,,3,3,6
HND-002732,2011,40100072,,,,6,4,10
HND-002734,2011,40100074,,,,14,11,25
,2011,40100154,,,,7,5,12
HND-002756,2011,40100161,,,,5,4,9
,2011,40100166,,,,1,1,2
,2011,40100040,,,,15,6,21
HND-002714,2011,40100042,,,,20,10,30
HND-002719,2011,40100048,,,,7,9,16
HND-002720,2011,40100049,,,,21,15,36
HND-002721,2011,40100051,,,,20,6,26
HND-002724,2011,40100055,,,,1,3,4
HND-002725,2011,40100056,,,,12,11,23
HND-002727,2011,40100058,,,,12,6,18
HND-002728,2011,40100060,,,,4,5,9
HND-002730,2011,40100068,,,,8,7,15
HND-002735,2011,40100075,,,,12,0,12
,2011,40100076,,,,8,6,14
,2011,40100078,,,,8,5,13
HND-002738,2011,40100080,,,,4,9,13
HND-002743,2011,40100094,,,,8,3,11
HND-002750,2011,40100134,,,,16,12,28
HND-002757,2011,40100162,,,,3,5,8
,2011,40100163,,,,20,22,42
HND-002692,2011,40100018,,,,10,10,20
HND-002707,2011,40100034,,,,19,20,39
HND-002714,2011,40100042,,,,15,14,29
HND-002715,2011,40100043,,,,109,123,232
HND-002719,2011,40100048,,,,12,13,25
HND-002720,2011,40100049,,,,28,25,53
HND-002723,2011,40100053,,,,17,15,32
HND-002724,2011,40100055,,,,9,5,14
HND-002725,2011,40100056,,,,19,16,35
HND-002726,2011,40100057,,,,15,10,25
HND-002727,2011,40100058,,,,13,9,22
HND-002730,2011,40100068,,,,6,7,13
HND-002732,2011,40100072,,,,4,1,5
,2011,40100076,,,,8,5,13
,2011,40100078,,,,8,12,20
HND-002738,2011,40100080,,,,9,10,19
HND-002743,2011,40100094,,,,8,3,11
HND-002750,2011,40100134,,,,15,9,24
,2011,40100154,,,,11,6,17
HND-002756,2011,40100161,,,,2,7,9
HND-002757,2011,40100162,,,,4,3,7
,2011,40100163,,,,14,15,29
,2011,40100040,,,,13,10,23
HND-002716,2011,40100044,,,,11,12,23
,2011,40100045,,,,6,3,9
HND-002717,2011,40100046,,,,25,24,49
HND-002718,2011,40100047,,,,18,11,29
HND-002721,2011,40100051,,,,24,26,50
HND-002722,2011,40100052,,,,19,19,38
HND-002728,2011,40100060,,,,9,8,17
,2011,40100067,,,,9,6,15
HND-002731,2011,40100071,,,,5,5,10
HND-002734,2011,40100074,,,,11,15,26
HND-002735,2011,40100075,,,,24,1,25
,2011,40100166,,,,5,5,10
HND-002675,2011,40100001,,,,27,32,59
HND-002676,2011,40100002,,,,100,95,195
HND-002677,2011,40100003,,,,59,54,113
HND-002679,2011,40100005,,,,1,3,4
HND-002680,2011,40100006,,,,11,6,17
HND-002681,2011,40100007,,,,25,11,36
HND-002682,2011,40100008,,,,22,16,38
HND-002686,2011,40100012,,,,16,17,33
HND-002688,2011,40100014,,,,3,7,10
HND-002689,2011,40100015,,,,14,17,31
HND-002691,2011,40100017,,,,60,41,101
HND-002692,2011,40100018,,,,64,66,130
HND-002694,2011,40100020,,,,5,4,9
HND-002695,2011,40100021,,,,44,31,75
HND-002696,2011,40100022,,,,7,5,12
HND-002697,2011,40100023,,,,5,3,8
HND-002698,2011,40100024,,,,7,5,12
HND-002702,2011,40100029,,,,12,8,20
HND-002703,2011,40100030,,,,16,9,25
HND-002708,2011,40100035,,,,2,3,5
HND-002709,2011,40100036,,,,1,2,3
,2011,40100045,,,,3,16,19
HND-002745,2011,40100122,,,,3,2,5
HND-002746,2011,40100123,,,,3,2,5
HND-002678,2011,40100004,,,,4,8,12
HND-002683,2011,40100009,,,,15,5,20
HND-002684,2011,40100010,,,,13,3,16
HND-002685,2011,40100011,,,,7,8,15
HND-002687,2011,40100013,,,,9,3,12
HND-002690,2011,40100016,,,,29,26,55
HND-002693,2011,40100019,,,,7,3,10
HND-002699,2011,40100025,,,,4,4,8
HND-002700,2011,40100026,,,,3,4,7
HND-002701,2011,40100028,,,,10,20,30
HND-002704,2011,40100031,,,,4,3,7
HND-002705,2011,40100032,,,,10,12,22
HND-002706,2011,40100033,,,,7,3,10
HND-002710,2011,40100037,,,,20,9,29
HND-002711,2011,40100038,,,,8,5,13
HND-002712,2011,40100039,,,,0,11,11
,2011,40100040,,,,9,7,16
,2011,40100076,,,,14,16,30
HND-002739,2011,40100081,,,,6,7,13
HND-002753,2011,40100157,,,,1,2,3
HND-002754,2011,40100159,,,,11,11,22
HND-002755,2011,40100160,,,,8,3,11
,2011,40100163,,,,7,14,21
HND-002676,2011,40100002,,,,82,73,155
HND-002677,2011,40100003,,,,48,62,110
HND-002682,2011,40100008,,,,15,19,34
HND-002683,2011,40100009,,,,12,10,22
HND-002685,2011,40100011,,,,3,0,3
HND-002690,2011,40100016,,,,21,15,36
HND-002692,2011,40100018,,,,72,56,128
HND-002695,2011,40100021,,,,33,23,56
HND-002698,2011,40100024,,,,4,0,4
HND-002699,2011,40100025,,,,10,4,14
HND-002700,2011,40100026,,,,0,3,3
HND-002703,2011,40100030,,,,15,12,27
HND-002704,2011,40100031,,,,2,5,7
HND-002708,2011,40100035,,,,1,4,5
HND-002709,2011,40100036,,,,5,3,8
HND-002711,2011,40100038,,,,5,2,7
,2011,40100076,,,,24,8,32
HND-002739,2011,40100081,,,,6,5,11
HND-002745,2011,40100122,,,,1,2,3
HND-002753,2011,40100157,,,,1,1,2
HND-002755,2011,40100160,,,,10,7,17
,2011,40100163,,,,2,7,9
HND-002675,2011,40100001,,,,32,46,78
HND-002678,2011,40100004,,,,6,3,9
HND-002679,2011,40100005,,,,4,2,6
HND-002680,2011,40100006,,,,9,8,17
HND-002681,2011,40100007,,,,17,18,35
HND-002684,2011,40100010,,,,8,5,13
HND-002686,2011,40100012,,,,15,19,34
HND-002687,2011,40100013,,,,4,5,9
HND-002688,2011,40100014,,,,1,2,3
HND-002689,2011,40100015,,,,31,25,56
HND-002691,2011,40100017,,,,54,44,98
HND-002693,2011,40100019,,,,2,4,6
HND-002694,2011,40100020,,,,4,2,6
HND-002696,2011,40100022,,,,7,2,9
HND-002697,2011,40100023,,,,6,6,12
HND-002701,2011,40100028,,,,17,13,30
HND-002702,2011,40100029,,,,3,2,5
HND-002705,2011,40100032,,,,10,8,18
HND-002706,2011,40100033,,,,5,2,7
HND-002710,2011,40100037,,,,8,20,28
HND-002712,2011,40100039,,,,5,4,9
,2011,40100040,,,,11,13,24
,2011,40100045,,,,20,16,36
HND-002746,2011,40100123,,,,5,6,11
HND-002754,2011,40100159,,,,15,8,23
HND-002683,2011,40100009,,,,11,15,26
HND-002684,2011,40100010,,,,4,3,7
HND-002685,2011,40100011,,,,8,5,13
HND-002687,2011,40100013,,,,4,7,11
HND-002690,2011,40100016,,,,16,18,34
HND-002699,2011,40100025,,,,2,5,7
HND-002700,2011,40100026,,,,4,2,6
HND-002701,2011,40100028,,,,14,9,23
HND-002704,2011,40100031,,,,3,4,7
HND-002705,2011,40100032,,,,6,10,16
HND-002706,2011,40100033,,,,4,1,5
HND-002710,2011,40100037,,,,6,13,19
HND-002711,2011,40100038,,,,4,6,10
HND-002712,2011,40100039,,,,4,6,10
,2011,40100040,,,,9,16,25
,2011,40100076,,,,11,11,22
HND-002739,2011,40100081,,,,2,6,8
HND-002753,2011,40100157,,,,2,2,4
HND-002755,2011,40100160,,,,7,3,10
,2011,40100163,,,,3,8,11
HND-002675,2011,40100001,,,,40,33,73
HND-002676,2011,40100002,,,,78,92,170
HND-002677,2011,40100003,,,,65,49,114
HND-002678,2011,40100004,,,,8,6,14
HND-002679,2011,40100005,,,,3,3,6
HND-002680,2011,40100006,,,,10,17,27
HND-002681,2011,40100007,,,,22,11,33
HND-002682,2011,40100008,,,,16,13,29
HND-002686,2011,40100012,,,,5,15,20
HND-002688,2011,40100014,,,,6,4,10
HND-002689,2011,40100015,,,,28,22,50
HND-002691,2011,40100017,,,,65,57,122
HND-002692,2011,40100018,,,,47,58,105
HND-002693,2011,40100019,,,,3,0,3
HND-002694,2011,40100020,,,,3,3,6
HND-002695,2011,40100021,,,,25,26,51
HND-002696,2011,40100022,,,,8,6,14
HND-002697,2011,40100023,,,,5,4,9
HND-002698,2011,40100024,,,,3,3,6
HND-002702,2011,40100029,,,,6,2,8
HND-002703,2011,40100030,,,,8,7,15
HND-002708,2011,40100035,,,,0,4,4
HND-002709,2011,40100036,,,,5,2,7
,2011,40100045,,,,18,13,31
HND-002745,2011,40100122,,,,4,1,5
HND-002746,2011,40100123,,,,3,5,8
HND-002754,2011,40100159,,,,11,7,18
HND-002676,2011,40100002,,,,84,88,172
HND-002677,2011,40100003,,,,69,53,122
HND-002679,2011,40100005,,,,2,0,2
HND-002680,2011,40100006,,,,5,11,16
HND-002682,2011,40100008,,,,7,15,22
HND-002688,2011,40100014,,,,1,3,4
HND-002690,2011,40100016,,,,15,18,33
HND-002692,2011,40100018,,,,70,68,138
HND-002695,2011,40100021,,,,29,31,60
HND-002698,2011,40100024,,,,4,5,9
HND-002699,2011,40100025,,,,5,5,10
HND-002700,2011,40100026,,,,2,4,6
HND-002703,2011,40100030,,,,9,9,18
HND-002704,2011,40100031,,,,3,4,7
HND-002708,2011,40100035,,,,2,4,6
HND-002709,2011,40100036,,,,4,4,8
HND-002711,2011,40100038,,,,1,4,5
,2011,40100076,,,,15,21,36
HND-002739,2011,40100081,,,,1,2,3
HND-002745,2011,40100122,,,,2,1,3
HND-002755,2011,40100160,,,,7,12,19
,2011,40100163,,,,0,4,4
HND-002675,2011,40100001,,,,41,23,64
HND-002678,2011,40100004,,,,9,6,15
HND-002681,2011,40100007,,,,25,19,44
HND-002683,2011,40100009,,,,9,4,13
HND-002684,2011,40100010,,,,7,9,16
HND-002685,2011,40100011,,,,6,7,13
HND-002686,2011,40100012,,,,22,12,34
HND-002687,2011,40100013,,,,8,2,10
HND-002689,2011,40100015,,,,26,32,58
HND-002691,2011,40100017,,,,65,43,108
HND-002693,2011,40100019,,,,6,7,13
HND-002694,2011,40100020,,,,4,2,6
HND-002696,2011,40100022,,,,1,5,6
HND-002697,2011,40100023,,,,5,4,9
HND-002701,2011,40100028,,,,12,10,22
HND-002702,2011,40100029,,,,5,4,9
HND-002705,2011,40100032,,,,7,6,13
HND-002706,2011,40100033,,,,0,3,3
HND-002710,2011,40100037,,,,6,6,12
HND-002712,2011,40100039,,,,3,4,7
,2011,40100040,,,,9,13,22
,2011,40100045,,,,14,13,27
HND-002746,2011,40100123,,,,0,2,2
HND-002753,2011,40100157,,,,5,2,7
HND-002754,2011,40100159,,,,3,4,7
HND-002678,2011,40100004,,,,4,6,10
HND-002683,2011,40100009,,,,8,5,13
HND-002684,2011,40100010,,,,9,5,14
HND-002685,2011,40100011,,,,11,10,21
HND-002686,2011,40100012,,,,7,13,20
HND-002687,2011,40100013,,,,5,5,10
HND-002691,2011,40100017,,,,51,54,105
HND-002693,2011,40100019,,,,4,5,9
HND-002694,2011,40100020,,,,2,0,2
HND-002697,2011,40100023,,,,2,3,5
HND-002699,2011,40100025,,,,5,1,6
HND-002700,2011,40100026,,,,1,2,3
HND-002701,2011,40100028,,,,15,15,30
HND-002703,2011,40100030,,,,10,10,20
HND-002708,2011,40100035,,,,1,3,4
,2011,40100076,,,,17,18,35
HND-002745,2011,40100122,,,,3,2,5
HND-002746,2011,40100123,,,,0,2,2
HND-002755,2011,40100160,,,,9,8,17
HND-002675,2011,40100001,,,,35,41,76
HND-002676,2011,40100002,,,,90,84,174
HND-002677,2011,40100003,,,,64,46,110
HND-002680,2011,40100006,,,,8,5,13
HND-002681,2011,40100007,,,,15,13,28
HND-002682,2011,40100008,,,,8,20,28
HND-002688,2011,40100014,,,,5,4,9
HND-002689,2011,40100015,,,,33,25,58
HND-002690,2011,40100016,,,,7,20,27
HND-002692,2011,40100018,,,,59,69,128
HND-002695,2011,40100021,,,,26,26,52
HND-002696,2011,40100022,,,,9,3,12
HND-002698,2011,40100024,,,,4,2,6
HND-002702,2011,40100029,,,,3,1,4
HND-002704,2011,40100031,,,,1,2,3
HND-002705,2011,40100032,,,,6,5,11
HND-002706,2011,40100033,,,,0,3,3
HND-002710,2011,40100037,,,,7,6,13
HND-002711,2011,40100038,,,,7,2,9
HND-002712,2011,40100039,,,,4,2,6
,2011,40100040,,,,4,12,16
,2011,40100045,,,,6,12,18
HND-002739,2011,40100081,,,,3,1,4
HND-002753,2011,40100157,,,,1,1,2
HND-002754,2011,40100159,,,,3,7,10
,2011,40100163,,,,9,2,11
HND-002676,2011,40100002,,,,98,112,210
HND-002677,2011,40100003,,,,66,44,110
HND-002682,2011,40100008,,,,21,13,34
HND-002683,2011,40100009,,,,11,12,23
HND-002685,2011,40100011,,,,0,4,4
HND-002690,2011,40100016,,,,11,11,22
HND-002692,2011,40100018,,,,46,74,120
HND-002695,2011,40100021,,,,24,25,49
HND-002698,2011,40100024,,,,0,3,3
HND-002699,2011,40100025,,,,3,0,3
HND-002700,2011,40100026,,,,2,2,4
HND-002705,2011,40100032,,,,5,5,10
HND-002706,2011,40100033,,,,2,0,2
HND-002710,2011,40100037,,,,4,4,8
HND-002712,2011,40100039,,,,1,3,4
,2011,40100040,,,,6,6,12
,2011,40100045,,,,14,15,29
HND-002754,2011,40100159,,,,0,1,1
HND-002755,2011,40100160,,,,0,4,4
,2011,40100163,,,,3,2,5
HND-002675,2011,40100001,,,,38,40,78
HND-002678,2011,40100004,,,,4,9,13
HND-002679,2011,40100005,,,,2,2,4
HND-002680,2011,40100006,,,,2,8,10
HND-002681,2011,40100007,,,,15,12,27
HND-002684,2011,40100010,,,,7,7,14
HND-002686,2011,40100012,,,,2,7,9
HND-002687,2011,40100013,,,,11,6,17
HND-002688,2011,40100014,,,,3,2,5
HND-002689,2011,40100015,,,,36,27,63
HND-002691,2011,40100017,,,,45,58,103
HND-002693,2011,40100019,,,,6,3,9
HND-002694,2011,40100020,,,,4,4,8
HND-002696,2011,40100022,,,,3,4,7
HND-002697,2011,40100023,,,,5,5,10
HND-002701,2011,40100028,,,,9,11,20
HND-002702,2011,40100029,,,,0,5,5
HND-002703,2011,40100030,,,,8,5,13
HND-002704,2011,40100031,,,,0,4,4
HND-002708,2011,40100035,,,,3,2,5
HND-002709,2011,40100036,,,,2,3,5
HND-002711,2011,40100038,,,,2,1,3
,2011,40100076,,,,10,20,30
HND-002739,2011,40100081,,,,2,2,4
HND-002746,2011,40100123,,,,0,1,1
HND-002753,2011,40100157,,,,1,0,1
HND-002675,2011,40100001,,,,13,21,34
HND-002676,2011,40100002,,,,14,24,38
HND-002681,2011,40100007,,,,7,8,15
HND-002689,2011,40100015,,,,13,6,19
HND-002690,2011,40100016,,,,20,10,30
HND-002691,2011,40100017,,,,18,18,36
HND-002692,2011,40100018,,,,25,31,56
HND-002695,2011,40100021,,,,18,13,31
,2011,40100040,,,,6,6,12
,2011,40100061,,,,0,85,85
,2011,40100062,,,,24,22,46
,2011,40100076,,,,11,11,22
HND-002683,2011,40100009,,,,13,5,18
HND-002713,2011,40100041,,,,227,165,392
,2011,40100045,,,,29,15,44
HND-002736,2011,40100077,,,,216,146,362
,2011,40100185,,,,1,3,4
HND-002675,2011,40100001,,,,10,20,30
HND-002689,2011,40100015,,,,7,10,17
HND-002691,2011,40100017,,,,10,12,22
HND-002713,2011,40100041,,,,179,142,321
,2011,40100045,,,,18,13,31
,2011,40100061,,,,0,85,85
HND-002736,2011,40100077,,,,132,106,238
HND-002676,2011,40100002,,,,12,18,30
HND-002683,2011,40100009,,,,3,4,7
HND-002690,2011,40100016,,,,8,10,18
HND-002692,2011,40100018,,,,34,40,74
HND-002695,2011,40100021,,,,11,18,29
,2011,40100040,,,,6,11,17
,2011,40100062,,,,22,20,42
,2011,40100076,,,,11,17,28
HND-002676,2011,40100002,,,,12,12,24
HND-002690,2011,40100016,,,,12,10,22
HND-002692,2011,40100018,,,,22,22,44
HND-002695,2011,40100021,,,,11,12,23
HND-002713,2011,40100041,,,,151,173,324
,2011,40100045,,,,14,15,29
HND-002675,2011,40100001,,,,6,12,18
HND-002683,2011,40100009,,,,7,8,15
HND-002691,2011,40100017,,,,5,17,22
,2011,40100040,,,,8,15,23
,2011,40100061,,,,0,72,72
,2011,40100062,,,,23,27,50
,2011,40100076,,,,11,17,28
HND-002736,2011,40100077,,,,141,96,237
,2011,40100185,,,,1,3,4
,2011,40100040,,,,5,9,14
HND-002713,2011,40100041,,,,141,196,337
,2011,40100045,,,,13,32,45
,2011,40100061,,,,0,37,37
,2011,40100063,,,,18,3,21
,2011,40100062,,,,33,32,65
,2011,40100076,,,,10,6,16
HND-002736,2011,40100077,,,,283,372,655
,2011,40100061,,,,0,17,17
,2011,40100062,,,,81,89,170
,2011,40100063,,,,11,10,21
,2011,40100076,,,,13,9,22
HND-002736,2011,40100077,,,,217,266,483
,2011,40100040,,,,4,12,16
HND-002713,2011,40100041,,,,99,181,280
,2011,40100045,,,,11,22,33
HND-002713,2011,40100041,,,,55,122,177
,2011,40100062,,,,36,57,93
,2011,40100061,,,,0,20,20
,2011,40100063,,,,15,9,24
HND-002736,2011,40100077,,,,117,192,309
HND-002775,2011,40200016,,,,4,9,13
HND-002780,2011,40200022,,,,7,7,14
HND-002807,2011,40200059,,,,7,6,13
,2011,40200060,,,,3,9,12
,2011,40200061,,,,9,5,14
,2011,40200091,,,,3,7,10
HND-002811,2011,40200114,,,,8,7,15
,2011,40200128,,,,9,6,15
,2011,40200129,,,,17,8,25
,2011,40200130,,,,5,8,13
,2011,40200131,,,,6,5,11
,2011,40200132,,,,4,5,9
HND-002818,2011,40200136,,,,4,5,9
,2011,40200137,,,,6,9,15
,2011,40200138,,,,5,7,12
HND-002774,2011,40200014,,,,13,7,20
HND-002805,2011,40200056,,,,8,4,12
HND-002806,2011,40200058,,,,12,9,21
,2011,40200115,,,,5,10,15
,2011,40200116,,,,12,5,17
HND-002812,2011,40200118,,,,4,7,11
HND-002813,2011,40200125,,,,3,6,9
HND-002814,2011,40200126,,,,4,8,12
,2011,40200133,,,,5,10,15
HND-002816,2011,40200134,,,,6,6,12
,2011,40200139,,,,2,7,9
HND-002781,2011,40200025,,,,3,4,7
HND-002787,2011,40200031,,,,1,2,3
,2011,40200047,,,,5,5,10
HND-002803,2011,40200053,,,,1,7,8
HND-002793,2011,40200037,,,,4,3,7
HND-002795,2011,40200040,,,,4,3,7
HND-002796,2011,40200041,,,,3,2,5
HND-002797,2011,40200042,,,,4,4,8
HND-002788,2011,40200032,,,,2,6,8
HND-002793,2011,40200037,,,,3,3,6
HND-002794,2011,40200039,,,,3,6,9
HND-002796,2011,40200041,,,,4,2,6
,2011,40200047,,,,3,2,5
HND-002781,2011,40200025,,,,2,2,4
HND-002787,2011,40200031,,,,15,11,26
HND-002789,2011,40200033,,,,7,2,9
HND-002795,2011,40200040,,,,5,4,9
HND-002797,2011,40200042,,,,11,6,17
HND-002803,2011,40200053,,,,4,6,10
HND-002781,2011,40200025,,,,4,5,9
HND-002787,2011,40200031,,,,9,13,22
HND-002789,2011,40200033,,,,10,11,21
HND-002793,2011,40200037,,,,4,5,9
HND-002795,2011,40200040,,,,3,4,7
HND-002797,2011,40200042,,,,9,8,17
HND-002788,2011,40200032,,,,9,12,21
HND-002794,2011,40200039,,,,5,11,16
HND-002796,2011,40200041,,,,6,6,12
,2011,40200047,,,,6,4,10
HND-002803,2011,40200053,,,,1,3,4
HND-002765,2011,40200002,,,,5,10,15
HND-002766,2011,40200003,,,,18,11,29
,2011,40200004,,,,10,7,17
HND-002770,2011,40200009,,,,2,3,5
HND-002771,2011,40200010,,,,14,7,21
HND-002772,2011,40200011,,,,14,19,33
HND-002775,2011,40200016,,,,6,4,10
HND-002777,2011,40200018,,,,18,10,28
HND-002778,2011,40200019,,,,3,3,6
HND-002779,2011,40200021,,,,5,11,16
HND-002780,2011,40200022,,,,9,5,14
HND-002785,2011,40200029,,,,5,7,12
HND-002790,2011,40200034,,,,3,11,14
HND-002791,2011,40200035,,,,7,4,11
HND-002792,2011,40200036,,,,10,7,17
HND-002793,2011,40200037,,,,5,6,11
HND-002800,2011,40200048,,,,7,5,12
HND-002801,2011,40200049,,,,3,1,4
HND-002804,2011,40200055,,,,2,8,10
HND-002808,2011,40200073,,,,3,4,7
HND-002817,2011,40200135,,,,2,3,5
HND-002819,2011,40200140,,,,10,2,12
HND-002764,2011,40200001,,,,20,22,42
HND-002767,2011,40200005,,,,15,12,27
HND-002768,2011,40200006,,,,7,7,14
HND-002769,2011,40200007,,,,23,16,39
HND-002773,2011,40200012,,,,13,11,24
HND-002774,2011,40200014,,,,10,6,16
HND-002776,2011,40200017,,,,3,4,7
HND-002781,2011,40200025,,,,11,9,20
HND-002782,2011,40200026,,,,3,2,5
HND-002783,2011,40200027,,,,6,8,14
HND-002784,2011,40200028,,,,3,2,5
HND-002786,2011,40200030,,,,2,3,5
HND-002798,2011,40200044,,,,4,5,9
HND-002799,2011,40200045,,,,17,12,29
HND-002802,2011,40200050,,,,4,4,8
HND-002810,2011,40200107,,,,5,4,9
HND-002813,2011,40200125,,,,1,3,4
HND-002814,2011,40200126,,,,0,4,4
HND-002815,2011,40200127,,,,4,5,9
,2011,40200004,,,,17,8,25
HND-002767,2011,40200005,,,,10,10,20
HND-002768,2011,40200006,,,,5,4,9
HND-002769,2011,40200007,,,,1,6,7
HND-002771,2011,40200010,,,,7,7,14
HND-002773,2011,40200012,,,,6,6,12
HND-002774,2011,40200014,,,,11,4,15
HND-002778,2011,40200019,,,,3,1,4
HND-002780,2011,40200022,,,,4,4,8
HND-002781,2011,40200025,,,,3,6,9
HND-002782,2011,40200026,,,,1,2,3
HND-002783,2011,40200027,,,,5,6,11
HND-002791,2011,40200035,,,,9,5,14
HND-002792,2011,40200036,,,,6,0,6
HND-002793,2011,40200037,,,,3,7,10
HND-002798,2011,40200044,,,,2,5,7
HND-002801,2011,40200049,,,,3,3,6
HND-002804,2011,40200055,,,,1,1,2
HND-002813,2011,40200125,,,,6,3,9
HND-002814,2011,40200126,,,,3,4,7
HND-002815,2011,40200127,,,,4,8,12
HND-002764,2011,40200001,,,,24,26,50
HND-002765,2011,40200002,,,,4,8,12
HND-002766,2011,40200003,,,,1,6,7
HND-002770,2011,40200009,,,,3,5,8
HND-002772,2011,40200011,,,,17,13,30
HND-002775,2011,40200016,,,,6,3,9
HND-002776,2011,40200017,,,,5,1,6
HND-002777,2011,40200018,,,,12,11,23
HND-002779,2011,40200021,,,,6,7,13
HND-002785,2011,40200029,,,,1,7,8
HND-002786,2011,40200030,,,,3,3,6
HND-002790,2011,40200034,,,,5,2,7
HND-002799,2011,40200045,,,,2,2,4
HND-002800,2011,40200048,,,,1,0,1
HND-002802,2011,40200050,,,,3,9,12
HND-002808,2011,40200073,,,,4,4,8
HND-002810,2011,40200107,,,,0,1,1
HND-002817,2011,40200135,,,,2,5,7
HND-002819,2011,40200140,,,,2,2,4
HND-002767,2011,40200005,,,,12,12,24
HND-002768,2011,40200006,,,,2,6,8
HND-002769,2011,40200007,,,,12,12,24
HND-002773,2011,40200012,,,,7,7,14
HND-002774,2011,40200014,,,,2,4,6
HND-002776,2011,40200017,,,,1,6,7
HND-002778,2011,40200019,,,,2,1,3
HND-002781,2011,40200025,,,,4,4,8
HND-002782,2011,40200026,,,,1,3,4
HND-002783,2011,40200027,,,,5,4,9
HND-002784,2011,40200028,,,,1,5,6
HND-002786,2011,40200030,,,,2,2,4
HND-002798,2011,40200044,,,,3,1,4
HND-002802,2011,40200050,,,,2,4,6
HND-002810,2011,40200107,,,,3,4,7
HND-002813,2011,40200125,,,,1,7,8
HND-002814,2011,40200126,,,,4,0,4
HND-002815,2011,40200127,,,,0,4,4
HND-002764,2011,40200001,,,,22,27,49
HND-002765,2011,40200002,,,,7,7,14
HND-002766,2011,40200003,,,,2,4,6
,2011,40200004,,,,4,5,9
HND-002770,2011,40200009,,,,3,3,6
HND-002771,2011,40200010,,,,3,7,10
HND-002772,2011,40200011,,,,16,9,25
HND-002775,2011,40200016,,,,1,1,2
HND-002777,2011,40200018,,,,12,12,24
HND-002779,2011,40200021,,,,5,4,9
HND-002780,2011,40200022,,,,2,2,4
HND-002785,2011,40200029,,,,8,5,13
HND-002790,2011,40200034,,,,4,4,8
HND-002791,2011,40200035,,,,6,3,9
HND-002792,2011,40200036,,,,4,3,7
HND-002793,2011,40200037,,,,3,4,7
HND-002799,2011,40200045,,,,4,3,7
HND-002800,2011,40200048,,,,3,0,3
HND-002801,2011,40200049,,,,0,1,1
HND-002804,2011,40200055,,,,3,1,4
HND-002808,2011,40200073,,,,1,3,4
HND-002817,2011,40200135,,,,1,0,1
HND-002819,2011,40200140,,,,1,0,1
HND-002765,2011,40200002,,,,8,6,14
HND-002766,2011,40200003,,,,2,2,4
,2011,40200004,,,,2,7,9
HND-002769,2011,40200007,,,,12,15,27
HND-002770,2011,40200009,,,,3,1,4
HND-002771,2011,40200010,,,,4,2,6
HND-002772,2011,40200011,,,,3,7,10
HND-002773,2011,40200012,,,,7,7,14
HND-002777,2011,40200018,,,,10,10,20
HND-002778,2011,40200019,,,,1,4,5
HND-002780,2011,40200022,,,,4,2,6
HND-002785,2011,40200029,,,,2,5,7
HND-002791,2011,40200035,,,,1,1,2
HND-002792,2011,40200036,,,,0,4,4
HND-002793,2011,40200037,,,,3,5,8
HND-002800,2011,40200048,,,,0,1,1
HND-002801,2011,40200049,,,,1,2,3
HND-002808,2011,40200073,,,,6,2,8
HND-002815,2011,40200127,,,,2,4,6
HND-002764,2011,40200001,,,,24,25,49
HND-002767,2011,40200005,,,,6,7,13
HND-002774,2011,40200014,,,,3,3,6
HND-002775,2011,40200016,,,,1,2,3
HND-002776,2011,40200017,,,,3,5,8
HND-002779,2011,40200021,,,,5,6,11
HND-002781,2011,40200025,,,,2,6,8
HND-002782,2011,40200026,,,,1,2,3
HND-002783,2011,40200027,,,,5,3,8
HND-002784,2011,40200028,,,,3,4,7
HND-002786,2011,40200030,,,,3,2,5
HND-002790,2011,40200034,,,,3,3,6
HND-002798,2011,40200044,,,,4,3,7
HND-002799,2011,40200045,,,,3,3,6
HND-002802,2011,40200050,,,,7,2,9
HND-002810,2011,40200107,,,,2,0,2
HND-002813,2011,40200125,,,,0,1,1
HND-002814,2011,40200126,,,,3,1,4
HND-002817,2011,40200135,,,,3,0,3
HND-002819,2011,40200140,,,,1,1,2
HND-002765,2011,40200002,,,,5,6,11
HND-002766,2011,40200003,,,,4,8,12
,2011,40200004,,,,3,6,9
HND-002770,2011,40200009,,,,0,3,3
HND-002771,2011,40200010,,,,3,2,5
HND-002772,2011,40200011,,,,10,9,19
HND-002773,2011,40200012,,,,12,10,22
HND-002777,2011,40200018,,,,7,12,19
HND-002778,2011,40200019,,,,1,2,3
HND-002780,2011,40200022,,,,2,0,2
HND-002785,2011,40200029,,,,1,4,5
HND-002786,2011,40200030,,,,0,4,4
HND-002798,2011,40200044,,,,3,4,7
HND-002799,2011,40200045,,,,1,6,7
HND-002802,2011,40200050,,,,1,1,2
HND-002817,2011,40200135,,,,1,2,3
HND-002764,2011,40200001,,,,23,16,39
HND-002767,2011,40200005,,,,8,10,18
HND-002768,2011,40200006,,,,3,4,7
HND-002769,2011,40200007,,,,3,5,8
HND-002774,2011,40200014,,,,6,12,18
HND-002775,2011,40200016,,,,1,2,3
HND-002776,2011,40200017,,,,1,6,7
HND-002779,2011,40200021,,,,2,3,5
HND-002781,2011,40200025,,,,3,3,6
HND-002782,2011,40200026,,,,1,2,3
HND-002783,2011,40200027,,,,3,5,8
HND-002784,2011,40200028,,,,1,2,3
HND-002790,2011,40200034,,,,4,4,8
HND-002791,2011,40200035,,,,1,1,2
HND-002792,2011,40200036,,,,5,1,6
HND-002793,2011,40200037,,,,2,1,3
HND-002800,2011,40200048,,,,0,3,3
HND-002801,2011,40200049,,,,1,3,4
HND-002804,2011,40200055,,,,0,2,2
HND-002808,2011,40200073,,,,1,2,3
HND-002810,2011,40200107,,,,1,2,3
HND-002814,2011,40200126,,,,5,1,6
HND-002815,2011,40200127,,,,2,3,5
HND-002819,2011,40200140,,,,0,1,1
HND-002764,2011,40200001,,,,21,22,43
HND-002765,2011,40200002,,,,9,7,16
HND-002766,2011,40200003,,,,0,1,1
HND-002770,2011,40200009,,,,2,2,4
HND-002772,2011,40200011,,,,10,11,21
HND-002776,2011,40200017,,,,4,4,8
HND-002777,2011,40200018,,,,11,14,25
HND-002779,2011,40200021,,,,3,3,6
HND-002784,2011,40200028,,,,1,0,1
HND-002791,2011,40200035,,,,2,3,5
HND-002792,2011,40200036,,,,5,3,8
HND-002793,2011,40200037,,,,1,1,2
HND-002798,2011,40200044,,,,2,0,2
HND-002801,2011,40200049,,,,2,2,4
HND-002804,2011,40200055,,,,1,4,5
HND-002810,2011,40200107,,,,2,2,4
,2011,40200004,,,,5,7,12
HND-002767,2011,40200005,,,,16,5,21
HND-002768,2011,40200006,,,,3,0,3
HND-002769,2011,40200007,,,,2,5,7
HND-002771,2011,40200010,,,,3,3,6
HND-002773,2011,40200012,,,,2,8,10
HND-002774,2011,40200014,,,,0,1,1
HND-002778,2011,40200019,,,,3,1,4
HND-002780,2011,40200022,,,,2,0,2
HND-002781,2011,40200025,,,,2,6,8
HND-002782,2011,40200026,,,,1,1,2
HND-002786,2011,40200030,,,,1,3,4
HND-002790,2011,40200034,,,,2,2,4
HND-002799,2011,40200045,,,,1,2,3
HND-002800,2011,40200048,,,,0,1,1
HND-002802,2011,40200050,,,,1,4,5
HND-002808,2011,40200073,,,,1,1,2
HND-002815,2011,40200127,,,,2,0,2
HND-002819,2011,40200140,,,,1,1,2
HND-002764,2011,40200001,,,,19,27,46
HND-002767,2011,40200005,,,,13,12,25
HND-002767,2011,40200005,,,,8,9,17
HND-002764,2011,40200001,,,,6,18,24
HND-002764,2011,40200001,,,,9,18,27
HND-002767,2011,40200005,,,,2,5,7
HND-002842,2011,40300025,,,,3,7,10
HND-002843,2011,40300027,,,,6,6,12
HND-002844,2011,40300028,,,,7,7,14
HND-002849,2011,40300050,,,,9,3,12
HND-002850,2011,40300060,,,,5,6,11
HND-002852,2011,40300083,,,,5,8,13
,2011,40300088,,,,5,10,15
,2011,40300089,,,,7,7,14
HND-002861,2011,40300094,,,,5,4,9
HND-002841,2011,40300022,,,,3,8,11
HND-002848,2011,40300048,,,,8,2,10
HND-002853,2011,40300084,,,,4,7,11
HND-002854,2011,40300085,,,,9,6,15
HND-002855,2011,40300086,,,,6,4,10
HND-002856,2011,40300087,,,,5,2,7
,2011,40300090,,,,7,4,11
HND-002858,2011,40300091,,,,2,7,9
HND-002859,2011,40300092,,,,6,5,11
HND-002860,2011,40300093,,,,6,5,11
HND-002837,2011,40300016,,,,1,1,2
HND-002823,2011,40300002,,,,1,2,3
,2011,40300031,,,,6,4,10
HND-002837,2011,40300016,,,,2,0,2
HND-002823,2011,40300002,,,,5,7,12
HND-002838,2011,40300017,,,,10,6,16
,2011,40300031,,,,9,7,16
HND-002823,2011,40300002,,,,8,3,11
HND-002838,2011,40300017,,,,16,7,23
,2011,40300031,,,,6,9,15
HND-002837,2011,40300016,,,,9,5,14
HND-002822,2011,40300001,,,,7,10,17
HND-002824,2011,40300003,,,,13,14,27
HND-002829,2011,40300008,,,,13,6,19
HND-002830,2011,40300009,,,,7,2,9
HND-002831,2011,40300010,,,,10,6,16
HND-002833,2011,40300012,,,,10,9,19
HND-002834,2011,40300013,,,,10,5,15
HND-002835,2011,40300014,,,,6,6,12
HND-002836,2011,40300015,,,,9,2,11
HND-002839,2011,40300020,,,,8,10,18
HND-002840,2011,40300021,,,,7,3,10
HND-002825,2011,40300004,,,,9,13,22
HND-002826,2011,40300005,,,,12,6,18
HND-002827,2011,40300006,,,,2,6,8
HND-002828,2011,40300007,,,,14,16,30
HND-002832,2011,40300011,,,,6,5,11
HND-002845,2011,40300029,,,,5,3,8
HND-002846,2011,40300030,,,,6,6,12
HND-002824,2011,40300003,,,,9,7,16
HND-002825,2011,40300004,,,,6,3,9
HND-002828,2011,40300007,,,,8,8,16
HND-002830,2011,40300009,,,,0,1,1
HND-002835,2011,40300014,,,,7,5,12
HND-002839,2011,40300020,,,,9,10,19
HND-002840,2011,40300021,,,,4,5,9
HND-002845,2011,40300029,,,,3,6,9
HND-002846,2011,40300030,,,,2,0,2
HND-002822,2011,40300001,,,,12,13,25
HND-002826,2011,40300005,,,,9,5,14
HND-002827,2011,40300006,,,,9,10,19
HND-002829,2011,40300008,,,,8,6,14
HND-002831,2011,40300010,,,,9,4,13
HND-002832,2011,40300011,,,,3,7,10
HND-002833,2011,40300012,,,,7,3,10
HND-002834,2011,40300013,,,,6,2,8
HND-002836,2011,40300015,,,,2,2,4
HND-002825,2011,40300004,,,,12,11,23
HND-002826,2011,40300005,,,,2,10,12
HND-002827,2011,40300006,,,,10,12,22
HND-002828,2011,40300007,,,,9,21,30
HND-002832,2011,40300011,,,,6,1,7
HND-002839,2011,40300020,,,,3,8,11
HND-002845,2011,40300029,,,,2,2,4
HND-002846,2011,40300030,,,,0,2,2
HND-002822,2011,40300001,,,,9,11,20
HND-002824,2011,40300003,,,,11,6,17
HND-002829,2011,40300008,,,,4,5,9
HND-002830,2011,40300009,,,,2,3,5
HND-002831,2011,40300010,,,,6,6,12
HND-002833,2011,40300012,,,,3,5,8
HND-002834,2011,40300013,,,,3,3,6
HND-002835,2011,40300014,,,,3,7,10
HND-002836,2011,40300015,,,,3,0,3
HND-002840,2011,40300021,,,,4,6,10
HND-002824,2011,40300003,,,,10,6,16
HND-002825,2011,40300004,,,,16,11,27
HND-002830,2011,40300009,,,,3,1,4
HND-002835,2011,40300014,,,,4,3,7
HND-002839,2011,40300020,,,,7,8,15
HND-002840,2011,40300021,,,,6,1,7
HND-002845,2011,40300029,,,,1,3,4
HND-002846,2011,40300030,,,,3,1,4
HND-002822,2011,40300001,,,,7,8,15
HND-002826,2011,40300005,,,,7,5,12
HND-002827,2011,40300006,,,,7,4,11
HND-002828,2011,40300007,,,,14,16,30
HND-002829,2011,40300008,,,,4,3,7
HND-002831,2011,40300010,,,,4,10,14
HND-002832,2011,40300011,,,,4,3,7
HND-002833,2011,40300012,,,,4,2,6
HND-002834,2011,40300013,,,,3,3,6
HND-002822,2011,40300001,,,,7,12,19
HND-002824,2011,40300003,,,,7,6,13
HND-002830,2011,40300009,,,,1,2,3
HND-002833,2011,40300012,,,,3,7,10
HND-002835,2011,40300014,,,,1,3,4
HND-002839,2011,40300020,,,,10,5,15
HND-002840,2011,40300021,,,,3,4,7
HND-002845,2011,40300029,,,,4,4,8
HND-002825,2011,40300004,,,,9,11,20
HND-002826,2011,40300005,,,,4,7,11
HND-002827,2011,40300006,,,,9,6,15
HND-002828,2011,40300007,,,,9,5,14
HND-002829,2011,40300008,,,,1,1,2
HND-002831,2011,40300010,,,,0,2,2
HND-002832,2011,40300011,,,,5,6,11
HND-002834,2011,40300013,,,,4,4,8
HND-002846,2011,40300030,,,,0,1,1
HND-002822,2011,40300001,,,,6,9,15
HND-002826,2011,40300005,,,,2,1,3
HND-002827,2011,40300006,,,,6,5,11
HND-002829,2011,40300008,,,,4,0,4
HND-002831,2011,40300010,,,,4,0,4
HND-002832,2011,40300011,,,,1,3,4
HND-002833,2011,40300012,,,,0,2,2
HND-002834,2011,40300013,,,,5,0,5
HND-002836,2011,40300015,,,,2,0,2
HND-002846,2011,40300030,,,,0,1,1
HND-002824,2011,40300003,,,,11,10,21
HND-002825,2011,40300004,,,,6,6,12
HND-002828,2011,40300007,,,,16,14,30
HND-002830,2011,40300009,,,,2,0,2
HND-002835,2011,40300014,,,,1,2,3
HND-002839,2011,40300020,,,,6,1,7
HND-002840,2011,40300021,,,,5,3,8
HND-002845,2011,40300029,,,,4,2,6
HND-002828,2011,40300007,,,,11,9,20
HND-002828,2011,40300007,,,,7,3,10
HND-002828,2011,40300007,,,,4,8,12
HND-002920,2011,40400071,,,,4,6,10
HND-002937,2011,40400097,,,,4,8,12
HND-002950,2011,40400118,,,,6,6,12
HND-002957,2011,40400152,,,,8,9,17
HND-002961,2011,40400166,,,,9,16,25
,2011,40400192,,,,4,5,9
HND-002969,2011,40400193,,,,6,3,9
,2011,40400198,,,,6,5,11
,2011,40400199,,,,6,6,12
HND-002971,2011,40400201,,,,6,5,11
HND-002974,2011,40400205,,,,10,8,18
HND-002975,2011,40400206,,,,19,10,29
,2011,40400207,,,,6,3,9
,2011,40400208,,,,3,5,8
HND-002977,2011,40400212,,,,2,3,5
HND-002979,2011,40400214,,,,6,8,14
,2011,40400217,,,,8,7,15
,2011,40400219,,,,1,10,11
,2011,40400220,,,,11,10,21
HND-002983,2011,40400222,,,,5,4,9
,2011,40400223,,,,6,3,9
,2011,40400224,,,,4,4,8
,2011,40400229,,,,6,6,12
,2011,40400234,,,,0,5,5
,2011,40400235,,,,7,2,9
HND-002989,2011,40400236,,,,5,4,9
HND-002990,2011,40400237,,,,4,6,10
,2011,40400241,,,,12,1,13
HND-002995,2011,40400245,,,,7,3,10
,2011,40400246,,,,6,3,9
HND-002996,2011,40400247,,,,9,6,15
,2011,40400248,,,,4,9,13
,2011,40400250,,,,6,5,11
HND-002997,2011,40400252,,,,3,5,8
HND-002914,2011,40400060,,,,4,5,9
,2011,40400077,,,,4,5,9
HND-002929,2011,40400084,,,,5,4,9
HND-002942,2011,40400106,,,,3,6,9
HND-002956,2011,40400151,,,,7,5,12
HND-002959,2011,40400157,,,,6,6,12
,2011,40400169,,,,9,9,18
HND-002970,2011,40400194,,,,7,2,9
,2011,40400195,,,,6,2,8
,2011,40400196,,,,4,5,9
,2011,40400197,,,,4,3,7
,2011,40400200,,,,3,6,9
HND-002972,2011,40400202,,,,6,9,15
,2011,40400203,,,,8,3,11
HND-002973,2011,40400204,,,,4,5,9
HND-002976,2011,40400209,,,,3,6,9
,2011,40400210,,,,3,6,9
,2011,40400211,,,,5,4,9
HND-002978,2011,40400213,,,,8,7,15
,2011,40400215,,,,5,4,9
HND-002980,2011,40400216,,,,4,5,9
HND-002982,2011,40400218,,,,5,4,9
,2011,40400221,,,,5,5,10
HND-002984,2011,40400225,,,,4,6,10
,2011,40400226,,,,5,5,10
,2011,40400227,,,,0,9,9
,2011,40400228,,,,3,3,6
HND-002985,2011,40400230,,,,3,3,6
HND-002986,2011,40400231,,,,4,5,9
HND-002987,2011,40400232,,,,4,5,9
,2011,40400233,,,,3,5,8
,2011,40400238,,,,5,5,10
HND-002991,2011,40400239,,,,10,6,16
HND-002992,2011,40400240,,,,2,8,10
HND-002993,2011,40400242,,,,6,4,10
HND-002994,2011,40400243,,,,7,3,10
,2011,40400244,,,,6,3,9
,2011,40400249,,,,6,4,10
,2011,40400251,,,,3,6,9
HND-003003,2011,40400258,,,,5,5,10
,2011,40400062,,,,7,4,11
HND-002919,2011,40400070,,,,6,4,10
HND-002920,2011,40400071,,,,0,1,1
HND-002926,2011,40400078,,,,4,3,7
HND-002931,2011,40400086,,,,2,2,4
,2011,40400087,,,,3,0,3
HND-002952,2011,40400120,,,,1,5,6
HND-002962,2011,40400182,,,,2,3,5
,2011,40400188,,,,3,2,5
HND-002924,2011,40400075,,,,0,2,2
HND-002925,2011,40400076,,,,4,3,7
HND-002928,2011,40400083,,,,0,4,4
HND-002932,2011,40400088,,,,3,3,6
,2011,40400089,,,,1,0,1
HND-002946,2011,40400111,,,,4,5,9
HND-002949,2011,40400117,,,,3,1,4
,2011,40400121,,,,1,5,6
HND-002967,2011,40400189,,,,2,0,2
,2011,40400036,,,,5,7,12
HND-002902,2011,40400043,,,,2,4,6
HND-002914,2011,40400060,,,,7,6,13
HND-002917,2011,40400066,,,,28,12,40
HND-002918,2011,40400069,,,,7,4,11
HND-002919,2011,40400070,,,,3,4,7
HND-002921,2011,40400072,,,,3,10,13
HND-002927,2011,40400079,,,,4,6,10
HND-002931,2011,40400086,,,,4,5,9
,2011,40400087,,,,3,4,7
HND-002932,2011,40400088,,,,6,5,11
,2011,40400091,,,,16,17,33
HND-002962,2011,40400182,,,,3,3,6
,2011,40400188,,,,2,2,4
HND-002967,2011,40400189,,,,0,3,3
HND-002920,2011,40400071,,,,4,7,11
HND-002924,2011,40400075,,,,7,3,10
HND-002925,2011,40400076,,,,2,7,9
,2011,40400077,,,,5,7,12
HND-002926,2011,40400078,,,,2,3,5
HND-002928,2011,40400083,,,,3,8,11
HND-002929,2011,40400084,,,,8,5,13
,2011,40400089,,,,5,2,7
HND-002945,2011,40400110,,,,1,3,4
HND-002946,2011,40400111,,,,3,3,6
HND-002949,2011,40400117,,,,3,5,8
HND-002952,2011,40400120,,,,0,4,4
,2011,40400121,,,,3,1,4
HND-002968,2011,40400190,,,,8,5,13
HND-002902,2011,40400043,,,,8,2,10
HND-002914,2011,40400060,,,,7,6,13
,2011,40400062,,,,10,13,23
HND-002918,2011,40400069,,,,9,11,20
HND-002924,2011,40400075,,,,3,5,8
HND-002925,2011,40400076,,,,4,4,8
,2011,40400077,,,,11,16,27
HND-002926,2011,40400078,,,,5,2,7
HND-002928,2011,40400083,,,,7,14,21
HND-002929,2011,40400084,,,,16,12,28
,2011,40400089,,,,6,6,12
HND-002945,2011,40400110,,,,9,7,16
HND-002946,2011,40400111,,,,3,2,5
HND-002949,2011,40400117,,,,2,8,10
,2011,40400121,,,,2,7,9
,2011,40400036,,,,15,10,25
HND-002917,2011,40400066,,,,50,32,82
HND-002919,2011,40400070,,,,6,5,11
HND-002920,2011,40400071,,,,13,8,21
HND-002921,2011,40400072,,,,12,4,16
HND-002927,2011,40400079,,,,7,4,11
HND-002931,2011,40400086,,,,7,4,11
,2011,40400087,,,,6,4,10
HND-002932,2011,40400088,,,,7,4,11
,2011,40400091,,,,18,10,28
HND-002952,2011,40400120,,,,9,6,15
HND-002962,2011,40400182,,,,6,5,11
,2011,40400188,,,,6,4,10
HND-002967,2011,40400189,,,,14,6,20
HND-002968,2011,40400190,,,,10,15,25
HND-002864,2011,40400002,,,,12,11,23
HND-002865,2011,40400003,,,,90,84,174
HND-002870,2011,40400008,,,,15,15,30
HND-002871,2011,40400009,,,,5,10,15
HND-002873,2011,40400011,,,,22,11,33
HND-002877,2011,40400015,,,,6,8,14
HND-002878,2011,40400016,,,,4,9,13
HND-002879,2011,40400017,,,,9,7,16
HND-002880,2011,40400018,,,,14,16,30
HND-002884,2011,40400022,,,,22,14,36
HND-002886,2011,40400024,,,,9,6,15
HND-002887,2011,40400025,,,,8,3,11
HND-002888,2011,40400026,,,,14,6,20
HND-002889,2011,40400027,,,,3,4,7
HND-002895,2011,40400034,,,,9,3,12
HND-002896,2011,40400035,,,,8,11,19
HND-002897,2011,40400037,,,,3,6,9
HND-002899,2011,40400040,,,,7,7,14
HND-002900,2011,40400041,,,,9,7,16
HND-002901,2011,40400042,,,,11,10,21
HND-002902,2011,40400043,,,,10,8,18
HND-002905,2011,40400048,,,,7,6,13
HND-002906,2011,40400050,,,,8,10,18
HND-002907,2011,40400051,,,,24,12,36
HND-002908,2011,40400052,,,,10,5,15
HND-002909,2011,40400053,,,,21,19,40
HND-002915,2011,40400064,,,,3,8,11
HND-002923,2011,40400074,,,,7,10,17
HND-002930,2011,40400085,,,,6,7,13
HND-002934,2011,40400093,,,,7,9,16
HND-002938,2011,40400098,,,,4,2,6
HND-002940,2011,40400101,,,,13,10,23
HND-002942,2011,40400106,,,,8,5,13
HND-002943,2011,40400107,,,,10,4,14
HND-002947,2011,40400113,,,,3,3,6
HND-002948,2011,40400114,,,,11,6,17
HND-002951,2011,40400119,,,,3,6,9
HND-002955,2011,40400126,,,,5,6,11
HND-002958,2011,40400153,,,,5,3,8
HND-002963,2011,40400183,,,,7,6,13
HND-002964,2011,40400184,,,,11,5,16
HND-002999,2011,40400254,,,,4,3,7
HND-003000,2011,40400255,,,,14,9,23
HND-003001,2011,40400256,,,,4,2,6
HND-003002,2011,40400257,,,,2,5,7
HND-002866,2011,40400004,,,,17,18,35
HND-002867,2011,40400005,,,,10,8,18
HND-002868,2011,40400006,,,,7,8,15
HND-002869,2011,40400007,,,,7,6,13
HND-002872,2011,40400010,,,,15,20,35
HND-002874,2011,40400012,,,,25,10,35
HND-002875,2011,40400013,,,,4,9,13
HND-002876,2011,40400014,,,,7,4,11
HND-002881,2011,40400019,,,,29,43,72
HND-002882,2011,40400020,,,,7,3,10
HND-002883,2011,40400021,,,,1,5,6
HND-002885,2011,40400023,,,,16,10,26
HND-002890,2011,40400028,,,,9,10,19
,2011,40400029,,,,4,5,9
HND-002891,2011,40400030,,,,17,21,38
HND-002892,2011,40400031,,,,2,4,6
HND-002893,2011,40400032,,,,1,2,3
HND-002894,2011,40400033,,,,12,3,15
HND-002898,2011,40400038,,,,6,5,11
HND-002903,2011,40400044,,,,6,5,11
HND-002904,2011,40400045,,,,2,0,2
HND-002910,2011,40400054,,,,7,2,9
HND-002911,2011,40400055,,,,16,16,32
HND-002912,2011,40400056,,,,1,3,4
HND-002913,2011,40400057,,,,23,18,41
,2011,40400061,,,,9,17,26
,2011,40400062,,,,15,9,24
HND-002916,2011,40400065,,,,9,6,15
HND-002933,2011,40400092,,,,12,9,21
HND-002935,2011,40400094,,,,7,18,25
HND-002937,2011,40400097,,,,10,9,19
HND-002939,2011,40400099,,,,3,4,7
,2011,40400102,,,,11,7,18
HND-002941,2011,40400103,,,,19,18,37
HND-002944,2011,40400108,,,,10,11,21
,2011,40400116,,,,7,6,13
HND-002953,2011,40400122,,,,3,5,8
,2011,40400124,,,,6,4,10
HND-002954,2011,40400125,,,,7,8,15
HND-002965,2011,40400185,,,,3,4,7
,2011,40400186,,,,8,5,13
HND-002966,2011,40400187,,,,9,12,21
HND-002998,2011,40400253,,,,7,7,14
HND-002863,2011,40400001,,,,5,5,10
HND-002867,2011,40400005,,,,9,5,14
HND-002868,2011,40400006,,,,3,8,11
HND-002869,2011,40400007,,,,9,2,11
HND-002870,2011,40400008,,,,5,5,10
HND-002873,2011,40400011,,,,10,24,34
HND-002874,2011,40400012,,,,13,16,29
HND-002876,2011,40400014,,,,8,12,20
HND-002877,2011,40400015,,,,10,6,16
HND-002878,2011,40400016,,,,3,3,6
HND-002882,2011,40400020,,,,8,2,10
HND-002884,2011,40400022,,,,17,18,35
HND-002885,2011,40400023,,,,16,3,19
HND-002886,2011,40400024,,,,9,3,12
,2011,40400029,,,,5,3,8
HND-002892,2011,40400031,,,,4,2,6
HND-002896,2011,40400035,,,,9,4,13
HND-002897,2011,40400037,,,,3,4,7
HND-002898,2011,40400038,,,,4,6,10
HND-002901,2011,40400042,,,,15,7,22
HND-002902,2011,40400043,,,,5,7,12
HND-002903,2011,40400044,,,,6,9,15
HND-002906,2011,40400050,,,,10,9,19
HND-002908,2011,40400052,,,,6,3,9
HND-002909,2011,40400053,,,,15,15,30
HND-002910,2011,40400054,,,,7,9,16
,2011,40400062,,,,11,11,22
HND-002933,2011,40400092,,,,0,3,3
HND-002934,2011,40400093,,,,8,7,15
HND-002935,2011,40400094,,,,5,6,11
HND-002939,2011,40400099,,,,3,5,8
HND-002940,2011,40400101,,,,4,6,10
,2011,40400102,,,,7,5,12
HND-002942,2011,40400106,,,,2,3,5
HND-002943,2011,40400107,,,,5,2,7
HND-002944,2011,40400108,,,,12,11,23
HND-002948,2011,40400114,,,,9,3,12
,2011,40400116,,,,9,5,14
,2011,40400124,,,,7,2,9
HND-002954,2011,40400125,,,,2,4,6
HND-002964,2011,40400184,,,,3,3,6
HND-002965,2011,40400185,,,,2,2,4
,2011,40400186,,,,13,7,20
HND-003000,2011,40400255,,,,2,1,3
HND-003001,2011,40400256,,,,4,2,6
HND-003002,2011,40400257,,,,1,3,4
HND-002864,2011,40400002,,,,14,2,16
HND-002865,2011,40400003,,,,66,71,137
HND-002866,2011,40400004,,,,17,15,32
HND-002871,2011,40400009,,,,5,12,17
HND-002872,2011,40400010,,,,26,15,41
HND-002875,2011,40400013,,,,11,6,17
HND-002880,2011,40400018,,,,9,16,25
HND-002881,2011,40400019,,,,16,18,34
HND-002887,2011,40400025,,,,10,7,17
HND-002888,2011,40400026,,,,5,4,9
HND-002889,2011,40400027,,,,1,2,3
HND-002890,2011,40400028,,,,4,11,15
HND-002891,2011,40400030,,,,16,16,32
HND-002893,2011,40400032,,,,6,3,9
HND-002894,2011,40400033,,,,5,1,6
HND-002895,2011,40400034,,,,5,7,12
HND-002899,2011,40400040,,,,6,4,10
HND-002900,2011,40400041,,,,19,15,34
HND-002904,2011,40400045,,,,3,2,5
HND-002905,2011,40400048,,,,9,3,12
HND-002907,2011,40400051,,,,3,6,9
HND-002911,2011,40400055,,,,13,4,17
HND-002912,2011,40400056,,,,3,1,4
HND-002913,2011,40400057,,,,4,5,9
,2011,40400061,,,,13,9,22
HND-002915,2011,40400064,,,,8,5,13
HND-002916,2011,40400065,,,,3,6,9
HND-002930,2011,40400085,,,,6,8,14
HND-002936,2011,40400096,,,,0,2,2
HND-002937,2011,40400097,,,,3,5,8
HND-002938,2011,40400098,,,,6,3,9
HND-002941,2011,40400103,,,,6,8,14
HND-002947,2011,40400113,,,,6,3,9
HND-002951,2011,40400119,,,,3,3,6
HND-002953,2011,40400122,,,,5,6,11
HND-002955,2011,40400126,,,,0,2,2
HND-002958,2011,40400153,,,,6,4,10
HND-002963,2011,40400183,,,,5,2,7
HND-002998,2011,40400253,,,,2,4,6
HND-002999,2011,40400254,,,,3,2,5
HND-002863,2011,40400001,,,,9,11,20
HND-002864,2011,40400002,,,,7,11,18
HND-002865,2011,40400003,,,,86,73,159
HND-002870,2011,40400008,,,,3,7,10
HND-002871,2011,40400009,,,,6,7,13
HND-002873,2011,40400011,,,,21,14,35
HND-002876,2011,40400014,,,,1,5,6
HND-002877,2011,40400015,,,,7,8,15
HND-002878,2011,40400016,,,,3,1,4
HND-002879,2011,40400017,,,,2,1,3
HND-002880,2011,40400018,,,,16,6,22
HND-002884,2011,40400022,,,,15,15,30
HND-002886,2011,40400024,,,,3,3,6
HND-002889,2011,40400027,,,,3,2,5
HND-002891,2011,40400030,,,,7,15,22
HND-002892,2011,40400031,,,,9,3,12
HND-002894,2011,40400033,,,,1,1,2
HND-002896,2011,40400035,,,,4,8,12
HND-002898,2011,40400038,,,,7,8,15
HND-002903,2011,40400044,,,,4,4,8
HND-002904,2011,40400045,,,,6,2,8
HND-002910,2011,40400054,,,,4,3,7
HND-002911,2011,40400055,,,,16,7,23
HND-002912,2011,40400056,,,,0,3,3
HND-002913,2011,40400057,,,,2,3,5
,2011,40400062,,,,15,24,39
HND-002915,2011,40400064,,,,1,1,2
HND-002933,2011,40400092,,,,1,1,2
HND-002935,2011,40400094,,,,19,12,31
HND-002937,2011,40400097,,,,0,8,8
HND-002939,2011,40400099,,,,2,2,4
,2011,40400102,,,,6,12,18
HND-002941,2011,40400103,,,,13,7,20
HND-002944,2011,40400108,,,,14,7,21
,2011,40400116,,,,12,2,14
HND-002953,2011,40400122,,,,2,3,5
,2011,40400124,,,,3,4,7
HND-002954,2011,40400125,,,,8,3,11
HND-002965,2011,40400185,,,,2,1,3
,2011,40400186,,,,5,7,12
HND-002998,2011,40400253,,,,3,2,5
HND-003000,2011,40400255,,,,0,2,2
HND-003001,2011,40400256,,,,2,2,4
HND-002866,2011,40400004,,,,6,8,14
HND-002867,2011,40400005,,,,7,6,13
HND-002868,2011,40400006,,,,3,3,6
HND-002869,2011,40400007,,,,3,7,10
HND-002872,2011,40400010,,,,23,24,47
HND-002874,2011,40400012,,,,12,10,22
HND-002875,2011,40400013,,,,10,18,28
HND-002881,2011,40400019,,,,4,8,12
HND-002882,2011,40400020,,,,3,5,8
HND-002883,2011,40400021,,,,2,5,7
HND-002885,2011,40400023,,,,5,5,10
HND-002887,2011,40400025,,,,3,5,8
HND-002888,2011,40400026,,,,4,4,8
HND-002890,2011,40400028,,,,8,10,18
,2011,40400029,,,,0,4,4
HND-002893,2011,40400032,,,,1,5,6
HND-002895,2011,40400034,,,,3,5,8
HND-002897,2011,40400037,,,,5,4,9
HND-002899,2011,40400040,,,,2,7,9
HND-002900,2011,40400041,,,,17,10,27
HND-002901,2011,40400042,,,,8,8,16
HND-002902,2011,40400043,,,,4,3,7
HND-002905,2011,40400048,,,,7,5,12
HND-002906,2011,40400050,,,,8,5,13
HND-002907,2011,40400051,,,,10,9,19
HND-002909,2011,40400053,,,,4,4,8
,2011,40400061,,,,13,16,29
HND-002916,2011,40400065,,,,8,7,15
HND-002930,2011,40400085,,,,3,9,12
HND-002936,2011,40400096,,,,5,1,6
HND-002938,2011,40400098,,,,3,4,7
HND-002940,2011,40400101,,,,1,5,6
HND-002942,2011,40400106,,,,6,7,13
HND-002943,2011,40400107,,,,2,5,7
HND-002947,2011,40400113,,,,5,5,10
HND-002948,2011,40400114,,,,4,4,8
HND-002951,2011,40400119,,,,2,5,7
HND-002955,2011,40400126,,,,6,0,6
HND-002958,2011,40400153,,,,2,1,3
HND-002963,2011,40400183,,,,17,10,27
HND-002964,2011,40400184,,,,6,6,12
HND-002999,2011,40400254,,,,1,5,6
HND-003002,2011,40400257,,,,4,4,8
HND-002867,2011,40400005,,,,8,12,20
HND-002868,2011,40400006,,,,3,7,10
HND-002869,2011,40400007,,,,2,8,10
HND-002870,2011,40400008,,,,5,2,7
HND-002872,2011,40400010,,,,24,41,65
HND-002873,2011,40400011,,,,23,10,33
HND-002874,2011,40400012,,,,10,6,16
HND-002875,2011,40400013,,,,11,7,18
HND-002876,2011,40400014,,,,5,4,9
HND-002881,2011,40400019,,,,2,9,11
HND-002882,2011,40400020,,,,4,5,9
HND-002883,2011,40400021,,,,2,3,5
HND-002884,2011,40400022,,,,15,9,24
HND-002885,2011,40400023,,,,9,6,15
HND-002890,2011,40400028,,,,5,5,10
,2011,40400029,,,,2,3,5
HND-002896,2011,40400035,,,,4,3,7
HND-002897,2011,40400037,,,,4,2,6
HND-002898,2011,40400038,,,,4,0,4
HND-002899,2011,40400040,,,,3,2,5
HND-002901,2011,40400042,,,,4,8,12
HND-002902,2011,40400043,,,,8,4,12
HND-002903,2011,40400044,,,,8,3,11
HND-002906,2011,40400050,,,,1,7,8
HND-002907,2011,40400051,,,,7,7,14
HND-002909,2011,40400053,,,,5,6,11
,2011,40400062,,,,15,20,35
HND-002916,2011,40400065,,,,10,5,15
HND-002923,2011,40400074,,,,8,3,11
HND-002933,2011,40400092,,,,0,4,4
HND-002938,2011,40400098,,,,2,3,5
HND-002939,2011,40400099,,,,0,4,4
HND-002940,2011,40400101,,,,0,3,3
,2011,40400102,,,,9,8,17
HND-002942,2011,40400106,,,,6,5,11
HND-002943,2011,40400107,,,,3,1,4
HND-002944,2011,40400108,,,,6,7,13
HND-002948,2011,40400114,,,,3,0,3
HND-002951,2011,40400119,,,,3,3,6
,2011,40400124,,,,3,4,7
HND-002964,2011,40400184,,,,2,3,5
HND-003000,2011,40400255,,,,5,3,8
HND-003001,2011,40400256,,,,4,3,7
HND-002864,2011,40400002,,,,8,11,19
HND-002865,2011,40400003,,,,87,75,162
HND-002866,2011,40400004,,,,3,13,16
HND-002871,2011,40400009,,,,8,15,23
HND-002877,2011,40400015,,,,6,7,13
HND-002878,2011,40400016,,,,3,4,7
HND-002879,2011,40400017,,,,6,4,10
HND-002880,2011,40400018,,,,8,5,13
HND-002886,2011,40400024,,,,0,3,3
HND-002887,2011,40400025,,,,7,3,10
HND-002889,2011,40400027,,,,1,4,5
HND-002891,2011,40400030,,,,13,7,20
HND-002892,2011,40400031,,,,3,5,8
HND-002893,2011,40400032,,,,5,4,9
HND-002894,2011,40400033,,,,0,2,2
HND-002900,2011,40400041,,,,7,10,17
HND-002904,2011,40400045,,,,2,4,6
HND-002905,2011,40400048,,,,0,7,7
HND-002910,2011,40400054,,,,6,6,12
HND-002911,2011,40400055,,,,2,4,6
HND-002912,2011,40400056,,,,2,1,3
HND-002913,2011,40400057,,,,3,1,4
,2011,40400061,,,,22,9,31
HND-002915,2011,40400064,,,,1,4,5
HND-002930,2011,40400085,,,,7,7,14
HND-002935,2011,40400094,,,,7,5,12
HND-002936,2011,40400096,,,,2,2,4
HND-002937,2011,40400097,,,,2,3,5
HND-002941,2011,40400103,,,,5,3,8
HND-002947,2011,40400113,,,,5,4,9
,2011,40400116,,,,7,8,15
HND-002953,2011,40400122,,,,1,3,4
HND-002954,2011,40400125,,,,4,3,7
HND-002958,2011,40400153,,,,2,1,3
HND-002963,2011,40400183,,,,0,1,1
HND-002965,2011,40400185,,,,1,1,2
,2011,40400186,,,,4,4,8
HND-002866,2011,40400004,,,,3,8,11
HND-002867,2011,40400005,,,,9,7,16
HND-002868,2011,40400006,,,,1,2,3
HND-002869,2011,40400007,,,,1,5,6
HND-002872,2011,40400010,,,,9,24,33
HND-002874,2011,40400012,,,,2,4,6
HND-002875,2011,40400013,,,,9,4,13
HND-002876,2011,40400014,,,,0,2,2
HND-002881,2011,40400019,,,,5,2,7
HND-002882,2011,40400020,,,,3,4,7
HND-002883,2011,40400021,,,,3,3,6
HND-002884,2011,40400022,,,,5,7,12
HND-002885,2011,40400023,,,,2,4,6
HND-002890,2011,40400028,,,,3,9,12
,2011,40400029,,,,1,1,2
HND-002895,2011,40400034,,,,4,4,8
HND-002896,2011,40400035,,,,2,8,10
HND-002897,2011,40400037,,,,5,4,9
HND-002899,2011,40400040,,,,2,3,5
HND-002900,2011,40400041,,,,6,8,14
HND-002901,2011,40400042,,,,4,8,12
HND-002902,2011,40400043,,,,3,5,8
HND-002906,2011,40400050,,,,5,5,10
HND-002907,2011,40400051,,,,1,0,1
HND-002909,2011,40400053,,,,6,8,14
,2011,40400062,,,,14,12,26
HND-002916,2011,40400065,,,,2,2,4
HND-002923,2011,40400074,,,,3,3,6
HND-002930,2011,40400085,,,,2,4,6
HND-002938,2011,40400098,,,,4,2,6
HND-002939,2011,40400099,,,,2,1,3
HND-002940,2011,40400101,,,,0,4,4
HND-002942,2011,40400106,,,,1,2,3
HND-002943,2011,40400107,,,,1,4,5
HND-002947,2011,40400113,,,,0,1,1
HND-002948,2011,40400114,,,,1,1,2
HND-002951,2011,40400119,,,,1,2,3
HND-002958,2011,40400153,,,,1,2,3
HND-003001,2011,40400256,,,,1,2,3
HND-002864,2011,40400002,,,,10,3,13
HND-002865,2011,40400003,,,,71,86,157
HND-002870,2011,40400008,,,,3,4,7
HND-002871,2011,40400009,,,,6,4,10
HND-002873,2011,40400011,,,,13,14,27
HND-002877,2011,40400015,,,,8,7,15
HND-002878,2011,40400016,,,,1,0,1
HND-002879,2011,40400017,,,,2,3,5
HND-002880,2011,40400018,,,,11,13,24
HND-002886,2011,40400024,,,,2,2,4
HND-002887,2011,40400025,,,,1,1,2
HND-002888,2011,40400026,,,,3,1,4
HND-002889,2011,40400027,,,,3,0,3
HND-002891,2011,40400030,,,,2,9,11
HND-002892,2011,40400031,,,,5,5,10
HND-002893,2011,40400032,,,,2,6,8
HND-002894,2011,40400033,,,,1,1,2
HND-002898,2011,40400038,,,,5,4,9
HND-002903,2011,40400044,,,,3,3,6
HND-002905,2011,40400048,,,,3,1,4
HND-002910,2011,40400054,,,,2,1,3
HND-002911,2011,40400055,,,,4,7,11
HND-002912,2011,40400056,,,,1,2,3
,2011,40400061,,,,19,17,36
HND-002915,2011,40400064,,,,2,3,5
HND-002935,2011,40400094,,,,1,2,3
HND-002936,2011,40400096,,,,3,1,4
,2011,40400102,,,,7,3,10
HND-002941,2011,40400103,,,,3,0,3
HND-002944,2011,40400108,,,,1,0,1
,2011,40400116,,,,1,4,5
,2011,40400124,,,,3,2,5
HND-002954,2011,40400125,,,,4,6,10
HND-002965,2011,40400185,,,,1,0,1
,2011,40400186,,,,5,6,11
HND-002998,2011,40400253,,,,0,1,1
HND-002864,2011,40400002,,,,8,7,15
HND-002865,2011,40400003,,,,64,64,128
HND-002866,2011,40400004,,,,5,4,9
HND-002871,2011,40400009,,,,9,3,12
HND-002872,2011,40400010,,,,13,17,30
HND-002875,2011,40400013,,,,9,4,13
HND-002880,2011,40400018,,,,15,6,21
HND-002881,2011,40400019,,,,6,0,6
HND-002883,2011,40400021,,,,0,1,1
HND-002887,2011,40400025,,,,0,1,1
HND-002888,2011,40400026,,,,0,1,1
HND-002889,2011,40400027,,,,1,1,2
HND-002890,2011,40400028,,,,5,1,6
HND-002891,2011,40400030,,,,4,6,10
HND-002893,2011,40400032,,,,1,2,3
HND-002894,2011,40400033,,,,0,2,2
HND-002895,2011,40400034,,,,4,1,5
HND-002899,2011,40400040,,,,0,2,2
HND-002900,2011,40400041,,,,9,17,26
HND-002905,2011,40400048,,,,2,4,6
HND-002907,2011,40400051,,,,0,1,1
HND-002911,2011,40400055,,,,0,2,2
HND-002912,2011,40400056,,,,1,2,3
,2011,40400061,,,,15,11,26
HND-002915,2011,40400064,,,,0,2,2
HND-002916,2011,40400065,,,,0,1,1
HND-002930,2011,40400085,,,,0,4,4
HND-002936,2011,40400096,,,,4,2,6
HND-002938,2011,40400098,,,,2,0,2
HND-002940,2011,40400101,,,,0,1,1
,2011,40400102,,,,5,4,9
HND-002942,2011,40400106,,,,1,2,3
HND-002943,2011,40400107,,,,1,3,4
HND-002944,2011,40400108,,,,3,4,7
HND-002948,2011,40400114,,,,0,1,1
,2011,40400116,,,,2,2,4
,2011,40400124,,,,2,5,7
HND-002954,2011,40400125,,,,1,1,2
HND-002999,2011,40400254,,,,0,2,2
HND-002863,2011,40400001,,,,5,1,6
HND-002867,2011,40400005,,,,7,6,13
HND-002868,2011,40400006,,,,1,2,3
HND-002869,2011,40400007,,,,3,3,6
HND-002870,2011,40400008,,,,0,4,4
HND-002873,2011,40400011,,,,9,10,19
HND-002874,2011,40400012,,,,5,2,7
HND-002876,2011,40400014,,,,2,3,5
HND-002877,2011,40400015,,,,11,3,14
HND-002878,2011,40400016,,,,1,2,3
HND-002879,2011,40400017,,,,6,4,10
HND-002882,2011,40400020,,,,1,4,5
HND-002884,2011,40400022,,,,10,9,19
HND-002885,2011,40400023,,,,4,3,7
,2011,40400029,,,,3,0,3
HND-002892,2011,40400031,,,,0,2,2
HND-002896,2011,40400035,,,,1,3,4
HND-002897,2011,40400037,,,,10,5,15
HND-002898,2011,40400038,,,,8,4,12
HND-002901,2011,40400042,,,,3,2,5
HND-002903,2011,40400044,,,,2,1,3
HND-002906,2011,40400050,,,,2,5,7
HND-002909,2011,40400053,,,,4,4,8
HND-002910,2011,40400054,,,,6,1,7
,2011,40400062,,,,13,16,29
HND-002935,2011,40400094,,,,0,2,2
HND-002941,2011,40400103,,,,4,1,5
HND-002947,2011,40400113,,,,1,1,2
HND-002951,2011,40400119,,,,2,1,3
HND-002953,2011,40400122,,,,0,1,1
HND-002965,2011,40400185,,,,1,2,3
,2011,40400186,,,,1,3,4
HND-002900,2011,40400041,,,,12,13,25
,2011,40400062,,,,9,15,24
,2011,40400173,,,,4,8,12
,2011,40400181,,,,12,8,20
HND-002922,2011,40400073,,,,144,122,266
,2011,40400062,,,,12,13,25
,2011,40400173,,,,7,4,11
HND-002900,2011,40400041,,,,6,19,25
HND-002922,2011,40400073,,,,102,94,196
,2011,40400181,,,,9,8,17
,2011,40400062,,,,7,6,13
HND-002922,2011,40400073,,,,113,116,229
,2011,40400181,,,,5,9,14
HND-002900,2011,40400041,,,,11,14,25
,2011,40400062,,,,11,4,15
HND-002922,2011,40400073,,,,79,90,169
,2011,40400062,,,,3,3,6
HND-002922,2011,40400073,,,,67,79,146
HND-002922,2011,40400073,,,,62,72,134
,2011,40500045,,,,6,9,15
HND-003047,2011,40500046,,,,9,5,14
HND-003054,2011,40500058,,,,4,5,9
,2011,40500064,,,,3,8,11
HND-003055,2011,40500066,,,,9,5,14
HND-003056,2011,40500067,,,,5,8,13
HND-003060,2011,40500073,,,,5,6,11
,2011,40500078,,,,7,5,12
,2011,40500081,,,,6,7,13
,2011,40500082,,,,4,5,9
HND-003046,2011,40500044,,,,4,8,12
HND-003051,2011,40500052,,,,4,6,10
,2011,40500053,,,,2,10,12
HND-003052,2011,40500054,,,,6,9,15
,2011,40500057,,,,4,8,12
,2011,40500061,,,,4,9,13
,2011,40500062,,,,9,4,13
,2011,40500063,,,,6,5,11
HND-003061,2011,40500074,,,,8,4,12
,2011,40500075,,,,6,4,10
HND-003062,2011,40500076,,,,7,5,12
,2011,40500077,,,,4,6,10
HND-003034,2011,40500027,,,,1,0,1
HND-003035,2011,40500028,,,,13,14,27
HND-003036,2011,40500029,,,,6,11,17
HND-003038,2011,40500032,,,,2,1,3
HND-003040,2011,40500036,,,,0,1,1
HND-003041,2011,40500037,,,,0,3,3
HND-003057,2011,40500070,,,,3,4,7
HND-003037,2011,40500031,,,,2,2,4
HND-003042,2011,40500038,,,,3,0,3
HND-003044,2011,40500040,,,,0,2,2
HND-003049,2011,40500049,,,,1,2,3
,2011,40500068,,,,4,1,5
HND-003034,2011,40500027,,,,4,4,8
HND-003036,2011,40500029,,,,19,19,38
HND-003040,2011,40500036,,,,4,3,7
HND-003041,2011,40500037,,,,0,4,4
HND-003042,2011,40500038,,,,5,5,10
HND-003050,2011,40500050,,,,3,5,8
HND-003057,2011,40500070,,,,2,1,3
HND-003035,2011,40500028,,,,12,25,37
HND-003037,2011,40500031,,,,10,11,21
HND-003038,2011,40500032,,,,3,0,3
HND-003044,2011,40500040,,,,5,5,10
HND-003049,2011,40500049,,,,3,4,7
,2011,40500068,,,,0,4,4
HND-003037,2011,40500031,,,,9,5,14
HND-003038,2011,40500032,,,,3,5,8
HND-003042,2011,40500038,,,,4,4,8
HND-003044,2011,40500040,,,,3,3,6
HND-003049,2011,40500049,,,,3,3,6
HND-003050,2011,40500050,,,,5,7,12
,2011,40500068,,,,6,2,8
HND-003034,2011,40500027,,,,3,3,6
HND-003035,2011,40500028,,,,26,25,51
HND-003036,2011,40500029,,,,27,27,54
HND-003040,2011,40500036,,,,5,4,9
HND-003041,2011,40500037,,,,1,6,7
HND-003057,2011,40500070,,,,5,3,8
HND-003011,2011,40500002,,,,6,3,9
HND-003013,2011,40500004,,,,7,5,12
HND-003016,2011,40500007,,,,13,9,22
HND-003018,2011,40500009,,,,7,4,11
HND-003019,2011,40500010,,,,8,6,14
HND-003020,2011,40500011,,,,6,2,8
HND-003021,2011,40500012,,,,9,7,16
HND-003022,2011,40500013,,,,8,6,14
HND-003028,2011,40500019,,,,6,6,12
HND-003029,2011,40500020,,,,3,1,4
,2011,40500021,,,,3,4,7
HND-003032,2011,40500025,,,,3,4,7
HND-003033,2011,40500026,,,,2,2,4
HND-003048,2011,40500048,,,,3,1,4
HND-003059,2011,40500072,,,,2,3,5
HND-003010,2011,40500001,,,,3,2,5
HND-003012,2011,40500003,,,,53,46,99
HND-003014,2011,40500005,,,,8,11,19
HND-003015,2011,40500006,,,,1,4,5
HND-003017,2011,40500008,,,,3,4,7
HND-003023,2011,40500014,,,,5,4,9
HND-003024,2011,40500015,,,,2,4,6
HND-003025,2011,40500016,,,,8,2,10
HND-003026,2011,40500017,,,,3,3,6
HND-003027,2011,40500018,,,,7,3,10
HND-003030,2011,40500022,,,,0,3,3
HND-003031,2011,40500024,,,,5,3,8
HND-003034,2011,40500027,,,,4,5,9
HND-003038,2011,40500032,,,,2,1,3
HND-003043,2011,40500039,,,,5,1,6
HND-003045,2011,40500041,,,,9,5,14
HND-003058,2011,40500071,,,,4,3,7
HND-003010,2011,40500001,,,,2,2,4
HND-003012,2011,40500003,,,,59,54,113
HND-003014,2011,40500005,,,,4,3,7
HND-003015,2011,40500006,,,,6,10,16
HND-003016,2011,40500007,,,,8,9,17
HND-003017,2011,40500008,,,,3,4,7
HND-003021,2011,40500012,,,,7,6,13
HND-003023,2011,40500014,,,,2,4,6
HND-003026,2011,40500017,,,,2,3,5
HND-003029,2011,40500020,,,,4,5,9
HND-003030,2011,40500022,,,,2,2,4
HND-003031,2011,40500024,,,,8,5,13
HND-003038,2011,40500032,,,,2,0,2
HND-003043,2011,40500039,,,,1,6,7
HND-003011,2011,40500002,,,,6,3,9
HND-003013,2011,40500004,,,,8,4,12
HND-003018,2011,40500009,,,,4,3,7
HND-003019,2011,40500010,,,,5,5,10
HND-003020,2011,40500011,,,,6,0,6
HND-003022,2011,40500013,,,,8,7,15
HND-003024,2011,40500015,,,,2,3,5
HND-003025,2011,40500016,,,,5,2,7
HND-003027,2011,40500018,,,,3,2,5
HND-003028,2011,40500019,,,,1,4,5
,2011,40500021,,,,2,2,4
HND-003032,2011,40500025,,,,2,2,4
HND-003033,2011,40500026,,,,2,0,2
HND-003034,2011,40500027,,,,9,3,12
HND-003045,2011,40500041,,,,2,3,5
HND-003048,2011,40500048,,,,0,3,3
HND-003058,2011,40500071,,,,2,2,4
HND-003059,2011,40500072,,,,4,5,9
HND-003010,2011,40500001,,,,2,2,4
HND-003012,2011,40500003,,,,83,74,157
HND-003014,2011,40500005,,,,2,10,12
HND-003015,2011,40500006,,,,9,7,16
HND-003017,2011,40500008,,,,0,1,1
HND-003023,2011,40500014,,,,6,0,6
HND-003024,2011,40500015,,,,2,3,5
HND-003025,2011,40500016,,,,2,3,5
HND-003026,2011,40500017,,,,3,3,6
HND-003030,2011,40500022,,,,1,0,1
HND-003031,2011,40500024,,,,6,0,6
HND-003034,2011,40500027,,,,3,8,11
HND-003038,2011,40500032,,,,1,0,1
HND-003043,2011,40500039,,,,1,1,2
HND-003045,2011,40500041,,,,4,4,8
HND-003058,2011,40500071,,,,4,4,8
HND-003011,2011,40500002,,,,2,1,3
HND-003013,2011,40500004,,,,5,7,12
HND-003016,2011,40500007,,,,9,6,15
HND-003018,2011,40500009,,,,2,6,8
HND-003019,2011,40500010,,,,3,4,7
HND-003020,2011,40500011,,,,4,4,8
HND-003021,2011,40500012,,,,7,4,11
HND-003022,2011,40500013,,,,6,6,12
HND-003027,2011,40500018,,,,3,1,4
HND-003028,2011,40500019,,,,5,2,7
HND-003029,2011,40500020,,,,3,2,5
,2011,40500021,,,,2,0,2
HND-003032,2011,40500025,,,,2,0,2
HND-003033,2011,40500026,,,,3,3,6
HND-003048,2011,40500048,,,,1,3,4
HND-003059,2011,40500072,,,,2,8,10
HND-003012,2011,40500003,,,,57,74,131
HND-003013,2011,40500004,,,,9,8,17
HND-003014,2011,40500005,,,,7,3,10
HND-003015,2011,40500006,,,,4,17,21
HND-003016,2011,40500007,,,,13,13,26
HND-003019,2011,40500010,,,,2,3,5
HND-003021,2011,40500012,,,,15,4,19
HND-003022,2011,40500013,,,,2,7,9
HND-003023,2011,40500014,,,,10,3,13
HND-003028,2011,40500019,,,,2,4,6
HND-003029,2011,40500020,,,,1,1,2
,2011,40500021,,,,5,3,8
HND-003030,2011,40500022,,,,1,4,5
HND-003038,2011,40500032,,,,6,6,12
HND-003043,2011,40500039,,,,1,3,4
HND-003048,2011,40500048,,,,2,0,2
HND-003059,2011,40500072,,,,4,1,5
HND-003010,2011,40500001,,,,3,0,3
HND-003011,2011,40500002,,,,5,5,10
HND-003017,2011,40500008,,,,2,1,3
HND-003018,2011,40500009,,,,5,3,8
HND-003020,2011,40500011,,,,5,3,8
HND-003024,2011,40500015,,,,3,2,5
HND-003025,2011,40500016,,,,4,2,6
HND-003026,2011,40500017,,,,2,4,6
HND-003027,2011,40500018,,,,3,0,3
HND-003031,2011,40500024,,,,5,4,9
HND-003032,2011,40500025,,,,6,3,9
HND-003033,2011,40500026,,,,0,2,2
HND-003034,2011,40500027,,,,8,6,14
HND-003045,2011,40500041,,,,1,5,6
HND-003058,2011,40500071,,,,1,1,2
HND-003010,2011,40500001,,,,0,2,2
HND-003011,2011,40500002,,,,4,1,5
HND-003012,2011,40500003,,,,76,79,155
HND-003017,2011,40500008,,,,0,1,1
HND-003018,2011,40500009,,,,5,7,12
HND-003020,2011,40500011,,,,4,3,7
HND-003024,2011,40500015,,,,2,2,4
HND-003025,2011,40500016,,,,5,3,8
HND-003026,2011,40500017,,,,5,3,8
HND-003027,2011,40500018,,,,3,2,5
HND-003031,2011,40500024,,,,3,1,4
HND-003032,2011,40500025,,,,4,5,9
HND-003033,2011,40500026,,,,2,0,2
HND-003034,2011,40500027,,,,5,3,8
HND-003048,2011,40500048,,,,2,3,5
HND-003059,2011,40500072,,,,5,2,7
HND-003013,2011,40500004,,,,8,4,12
HND-003014,2011,40500005,,,,6,1,7
HND-003015,2011,40500006,,,,6,4,10
HND-003016,2011,40500007,,,,6,12,18
HND-003019,2011,40500010,,,,4,1,5
HND-003021,2011,40500012,,,,4,8,12
HND-003022,2011,40500013,,,,6,0,6
HND-003023,2011,40500014,,,,3,4,7
HND-003028,2011,40500019,,,,2,3,5
HND-003029,2011,40500020,,,,2,2,4
,2011,40500021,,,,2,4,6
HND-003030,2011,40500022,,,,1,2,3
HND-003038,2011,40500032,,,,3,1,4
HND-003043,2011,40500039,,,,1,1,2
HND-003045,2011,40500041,,,,3,2,5
HND-003058,2011,40500071,,,,2,2,4
HND-003010,2011,40500001,,,,3,2,5
HND-003012,2011,40500003,,,,71,71,142
HND-003014,2011,40500005,,,,5,5,10
HND-003015,2011,40500006,,,,5,9,14
HND-003016,2011,40500007,,,,16,10,26
HND-003017,2011,40500008,,,,1,1,2
HND-003021,2011,40500012,,,,1,9,10
HND-003023,2011,40500014,,,,5,5,10
HND-003026,2011,40500017,,,,4,3,7
HND-003029,2011,40500020,,,,3,1,4
HND-003030,2011,40500022,,,,2,1,3
HND-003031,2011,40500024,,,,6,7,13
HND-003045,2011,40500041,,,,3,1,4
HND-003048,2011,40500048,,,,1,2,3
HND-003058,2011,40500071,,,,1,1,2
HND-003059,2011,40500072,,,,1,1,2
HND-003011,2011,40500002,,,,2,6,8
HND-003013,2011,40500004,,,,5,7,12
HND-003018,2011,40500009,,,,4,2,6
HND-003019,2011,40500010,,,,2,2,4
HND-003020,2011,40500011,,,,5,2,7
HND-003022,2011,40500013,,,,6,4,10
HND-003024,2011,40500015,,,,2,1,3
HND-003025,2011,40500016,,,,3,1,4
HND-003027,2011,40500018,,,,4,2,6
HND-003028,2011,40500019,,,,1,7,8
,2011,40500021,,,,0,2,2
HND-003032,2011,40500025,,,,2,3,5
HND-003033,2011,40500026,,,,3,3,6
HND-003034,2011,40500027,,,,4,3,7
HND-003038,2011,40500032,,,,2,1,3
HND-003043,2011,40500039,,,,0,1,1
HND-003016,2011,40500007,,,,7,12,19
HND-003039,2011,40500035,,,,46,51,97
,2011,40500047,,,,2,5,7
HND-003016,2011,40500007,,,,14,12,26
HND-003039,2011,40500035,,,,35,38,73
,2011,40500047,,,,5,3,8
HND-003016,2011,40500007,,,,4,10,14
HND-003039,2011,40500035,,,,33,28,61
,2011,40500047,,,,3,7,10
HND-003039,2011,40500035,,,,13,33,46
,2011,40500047,,,,3,4,7
HND-003039,2011,40500035,,,,9,20,29
,2011,40500047,,,,5,11,16
HND-003039,2011,40500035,,,,16,19,35
,2011,40500047,,,,4,6,10
,2011,40600074,,,,7,6,13
HND-003112,2011,40600075,,,,5,4,9
,2011,40600076,,,,4,5,9
,2011,40600078,,,,5,5,10
,2011,40600081,,,,4,5,9
,2011,40600083,,,,4,5,9
HND-003115,2011,40600085,,,,4,5,9
HND-003116,2011,40600087,,,,3,6,9
,2011,40600088,,,,3,7,10
,2011,40600089,,,,5,5,10
,2011,40600094,,,,5,4,9
HND-003119,2011,40600095,,,,6,5,11
,2011,40600096,,,,7,9,16
,2011,40600103,,,,5,4,9
,2011,40600104,,,,5,5,10
,2011,40600109,,,,4,5,9
,2011,40600110,,,,4,5,9
,2011,40600111,,,,4,5,9
,2011,40600112,,,,5,4,9
,2011,40600114,,,,4,5,9
HND-003093,2011,40600031,,,,5,4,9
,2011,40600053,,,,4,5,9
,2011,40600058,,,,4,5,9
,2011,40600060,,,,5,5,10
HND-003109,2011,40600069,,,,6,6,12
,2011,40600070,,,,4,6,10
HND-003110,2011,40600071,,,,7,2,9
HND-003111,2011,40600073,,,,3,7,10
,2011,40600079,,,,4,5,9
HND-003113,2011,40600080,,,,3,7,10
HND-003114,2011,40600084,,,,4,5,9
,2011,40600086,,,,4,5,9
HND-003117,2011,40600090,,,,4,5,9
,2011,40600092,,,,5,4,9
,2011,40600093,,,,3,6,9
,2011,40600099,,,,4,5,9
,2011,40600100,,,,5,4,9
,2011,40600101,,,,5,4,9
,2011,40600102,,,,5,4,9
,2011,40600105,,,,4,5,9
,2011,40600106,,,,6,5,11
,2011,40600107,,,,4,8,12
,2011,40600108,,,,5,4,9
,2011,40600113,,,,5,5,10
HND-003090,2011,40600028,,,,1,8,9
HND-003092,2011,40600030,,,,19,13,32
HND-003096,2011,40600034,,,,3,2,5
HND-003097,2011,40600035,,,,0,1,1
HND-003098,2011,40600036,,,,2,5,7
HND-003099,2011,40600037,,,,4,3,7
HND-003102,2011,40600041,,,,2,6,8
HND-003106,2011,40600046,,,,2,1,3
HND-003107,2011,40600050,,,,0,1,1
HND-003120,2011,40600097,,,,5,0,5
HND-003093,2011,40600031,,,,8,4,12
HND-003094,2011,40600032,,,,1,2,3
HND-003095,2011,40600033,,,,2,3,5
HND-003103,2011,40600042,,,,2,2,4
HND-003104,2011,40600043,,,,2,3,5
HND-003108,2011,40600051,,,,2,6,8
HND-003091,2011,40600029,,,,13,7,20
HND-003092,2011,40600030,,,,21,27,48
HND-003093,2011,40600031,,,,8,4,12
HND-003097,2011,40600035,,,,5,2,7
HND-003098,2011,40600036,,,,8,3,11
HND-003099,2011,40600037,,,,8,4,12
HND-003102,2011,40600041,,,,0,7,7
HND-003103,2011,40600042,,,,2,5,7
HND-003104,2011,40600043,,,,2,5,7
HND-003090,2011,40600028,,,,3,1,4
HND-003094,2011,40600032,,,,4,10,14
HND-003095,2011,40600033,,,,5,4,9
HND-003096,2011,40600034,,,,7,5,12
HND-003106,2011,40600046,,,,11,5,16
,2011,40600047,,,,2,7,9
HND-003107,2011,40600050,,,,4,2,6
HND-003108,2011,40600051,,,,3,3,6
HND-003120,2011,40600097,,,,2,0,2
HND-003092,2011,40600030,,,,32,32,64
HND-003093,2011,40600031,,,,11,6,17
HND-003097,2011,40600035,,,,11,3,14
HND-003098,2011,40600036,,,,8,15,23
HND-003099,2011,40600037,,,,4,1,5
HND-003102,2011,40600041,,,,1,12,13
HND-003103,2011,40600042,,,,10,2,12
HND-003104,2011,40600043,,,,6,3,9
,2011,40600047,,,,7,9,16
HND-003107,2011,40600050,,,,1,6,7
HND-003120,2011,40600097,,,,8,0,8
HND-003090,2011,40600028,,,,8,3,11
HND-003091,2011,40600029,,,,10,11,21
HND-003094,2011,40600032,,,,11,23,34
HND-003095,2011,40600033,,,,1,5,6
HND-003096,2011,40600034,,,,11,2,13
HND-003106,2011,40600046,,,,11,4,15
HND-003108,2011,40600051,,,,4,8,12
HND-003067,2011,40600004,,,,8,8,16
HND-003068,2011,40600005,,,,25,30,55
HND-003069,2011,40600006,,,,11,16,27
HND-003070,2011,40600007,,,,9,6,15
HND-003073,2011,40600010,,,,8,8,16
HND-003074,2011,40600011,,,,10,11,21
HND-003078,2011,40600015,,,,3,4,7
HND-003079,2011,40600016,,,,16,15,31
HND-003081,2011,40600018,,,,6,7,13
HND-003085,2011,40600022,,,,17,13,30
HND-003086,2011,40600024,,,,1,0,1
HND-003101,2011,40600040,,,,3,1,4
HND-003064,2011,40600001,,,,7,6,13
HND-003065,2011,40600002,,,,46,44,90
HND-003066,2011,40600003,,,,13,17,30
HND-003071,2011,40600008,,,,7,1,8
HND-003072,2011,40600009,,,,7,6,13
HND-003075,2011,40600012,,,,3,12,15
HND-003076,2011,40600013,,,,7,2,9
HND-003077,2011,40600014,,,,6,5,11
HND-003080,2011,40600017,,,,3,2,5
HND-003082,2011,40600019,,,,10,10,20
HND-003083,2011,40600020,,,,1,7,8
HND-003084,2011,40600021,,,,5,1,6
HND-003087,2011,40600025,,,,8,2,10
HND-003088,2011,40600026,,,,1,1,2
HND-003089,2011,40600027,,,,1,2,3
HND-003105,2011,40600045,,,,7,3,10
HND-003121,2011,40600098,,,,3,0,3
HND-003064,2011,40600001,,,,8,5,13
HND-003065,2011,40600002,,,,38,26,64
HND-003068,2011,40600005,,,,12,20,32
HND-003069,2011,40600006,,,,15,6,21
HND-003070,2011,40600007,,,,6,6,12
HND-003071,2011,40600008,,,,3,7,10
HND-003073,2011,40600010,,,,3,13,16
HND-003074,2011,40600011,,,,14,14,28
HND-003075,2011,40600012,,,,4,7,11
HND-003076,2011,40600013,,,,1,2,3
HND-003082,2011,40600019,,,,7,6,13
HND-003083,2011,40600020,,,,8,1,9
HND-003086,2011,40600024,,,,1,1,2
HND-003087,2011,40600025,,,,11,6,17
HND-003088,2011,40600026,,,,1,0,1
HND-003089,2011,40600027,,,,2,2,4
HND-003101,2011,40600040,,,,2,3,5
HND-003066,2011,40600003,,,,14,12,26
HND-003067,2011,40600004,,,,12,9,21
HND-003072,2011,40600009,,,,9,7,16
HND-003077,2011,40600014,,,,5,6,11
HND-003078,2011,40600015,,,,4,3,7
HND-003079,2011,40600016,,,,8,5,13
HND-003080,2011,40600017,,,,2,7,9
HND-003081,2011,40600018,,,,4,6,10
HND-003084,2011,40600021,,,,3,2,5
HND-003085,2011,40600022,,,,19,11,30
HND-003105,2011,40600045,,,,3,5,8
HND-003064,2011,40600001,,,,3,4,7
HND-003065,2011,40600002,,,,37,40,77
HND-003066,2011,40600003,,,,9,10,19
HND-003068,2011,40600005,,,,19,21,40
HND-003069,2011,40600006,,,,16,22,38
HND-003071,2011,40600008,,,,4,7,11
HND-003072,2011,40600009,,,,8,5,13
HND-003073,2011,40600010,,,,3,5,8
HND-003075,2011,40600012,,,,5,6,11
HND-003076,2011,40600013,,,,7,1,8
HND-003077,2011,40600014,,,,7,6,13
HND-003082,2011,40600019,,,,10,6,16
HND-003083,2011,40600020,,,,1,4,5
HND-003084,2011,40600021,,,,3,3,6
HND-003087,2011,40600025,,,,8,5,13
HND-003088,2011,40600026,,,,4,0,4
HND-003089,2011,40600027,,,,1,3,4
HND-003101,2011,40600040,,,,1,1,2
HND-003067,2011,40600004,,,,8,13,21
HND-003070,2011,40600007,,,,10,7,17
HND-003074,2011,40600011,,,,10,9,19
HND-003078,2011,40600015,,,,1,2,3
HND-003079,2011,40600016,,,,7,9,16
HND-003080,2011,40600017,,,,2,4,6
HND-003081,2011,40600018,,,,10,3,13
HND-003085,2011,40600022,,,,15,18,33
HND-003086,2011,40600024,,,,2,0,2
HND-003105,2011,40600045,,,,5,4,9
HND-003121,2011,40600098,,,,6,3,9
HND-003065,2011,40600002,,,,43,45,88
HND-003067,2011,40600004,,,,8,5,13
HND-003068,2011,40600005,,,,15,18,33
HND-003069,2011,40600006,,,,11,12,23
HND-003070,2011,40600007,,,,8,5,13
HND-003071,2011,40600008,,,,3,3,6
HND-003073,2011,40600010,,,,3,5,8
HND-003074,2011,40600011,,,,9,10,19
HND-003075,2011,40600012,,,,5,2,7
HND-003076,2011,40600013,,,,4,3,7
HND-003081,2011,40600018,,,,2,4,6
HND-003082,2011,40600019,,,,7,6,13
HND-003085,2011,40600022,,,,12,13,25
HND-003086,2011,40600024,,,,2,0,2
HND-003088,2011,40600026,,,,2,2,4
HND-003089,2011,40600027,,,,0,1,1
HND-003101,2011,40600040,,,,2,0,2
HND-003105,2011,40600045,,,,9,3,12
HND-003121,2011,40600098,,,,1,0,1
HND-003064,2011,40600001,,,,5,4,9
HND-003066,2011,40600003,,,,8,11,19
HND-003072,2011,40600009,,,,8,2,10
HND-003077,2011,40600014,,,,7,9,16
HND-003078,2011,40600015,,,,2,2,4
HND-003079,2011,40600016,,,,1,1,2
HND-003080,2011,40600017,,,,3,3,6
HND-003083,2011,40600020,,,,3,3,6
HND-003084,2011,40600021,,,,4,2,6
HND-003087,2011,40600025,,,,12,15,27
HND-003067,2011,40600004,,,,5,7,12
HND-003068,2011,40600005,,,,15,14,29
HND-003069,2011,40600006,,,,18,17,35
HND-003070,2011,40600007,,,,8,4,12
HND-003073,2011,40600010,,,,5,5,10
HND-003074,2011,40600011,,,,2,9,11
HND-003076,2011,40600013,,,,2,6,8
HND-003078,2011,40600015,,,,2,3,5
HND-003079,2011,40600016,,,,1,1,2
HND-003081,2011,40600018,,,,7,4,11
HND-003082,2011,40600019,,,,8,7,15
HND-003085,2011,40600022,,,,10,15,25
HND-003086,2011,40600024,,,,3,1,4
HND-003089,2011,40600027,,,,4,2,6
HND-003105,2011,40600045,,,,1,5,6
HND-003121,2011,40600098,,,,6,2,8
HND-003064,2011,40600001,,,,5,2,7
HND-003065,2011,40600002,,,,35,37,72
HND-003066,2011,40600003,,,,14,4,18
HND-003071,2011,40600008,,,,5,10,15
HND-003072,2011,40600009,,,,6,5,11
HND-003075,2011,40600012,,,,6,4,10
HND-003077,2011,40600014,,,,2,3,5
HND-003080,2011,40600017,,,,2,6,8
HND-003083,2011,40600020,,,,6,3,9
HND-003084,2011,40600021,,,,4,3,7
HND-003087,2011,40600025,,,,7,6,13
HND-003088,2011,40600026,,,,1,2,3
HND-003101,2011,40600040,,,,2,1,3
HND-003066,2011,40600003,,,,6,11,17
HND-003067,2011,40600004,,,,4,9,13
HND-003072,2011,40600009,,,,5,4,9
HND-003077,2011,40600014,,,,6,5,11
HND-003078,2011,40600015,,,,1,2,3
HND-003079,2011,40600016,,,,2,0,2
HND-003080,2011,40600017,,,,3,4,7
HND-003081,2011,40600018,,,,1,8,9
HND-003084,2011,40600021,,,,4,2,6
HND-003085,2011,40600022,,,,9,8,17
HND-003105,2011,40600045,,,,3,1,4
HND-003064,2011,40600001,,,,4,2,6
HND-003065,2011,40600002,,,,32,40,72
HND-003068,2011,40600005,,,,12,12,24
HND-003069,2011,40600006,,,,14,7,21
HND-003070,2011,40600007,,,,6,6,12
HND-003071,2011,40600008,,,,3,4,7
HND-003073,2011,40600010,,,,4,3,7
HND-003074,2011,40600011,,,,5,9,14
HND-003075,2011,40600012,,,,2,5,7
HND-003076,2011,40600013,,,,5,3,8
HND-003082,2011,40600019,,,,7,8,15
HND-003083,2011,40600020,,,,6,2,8
HND-003086,2011,40600024,,,,3,0,3
HND-003087,2011,40600025,,,,4,7,11
HND-003088,2011,40600026,,,,1,1,2
HND-003089,2011,40600027,,,,3,2,5
HND-003101,2011,40600040,,,,1,0,1
HND-003121,2011,40600098,,,,1,2,3
HND-003085,2011,40600022,,,,9,7,16
HND-003100,2011,40600038,,,,64,95,159
HND-003100,2011,40600038,,,,65,55,120
HND-003085,2011,40600022,,,,5,12,17
HND-003085,2011,40600022,,,,2,10,12
HND-003100,2011,40600038,,,,50,68,118
HND-003100,2011,40600038,,,,32,38,70
HND-003100,2011,40600038,,,,35,26,61
HND-003100,2011,40600038,,,,5,15,20
HND-003138,2011,40700020,,,,4,7,11
HND-003139,2011,40700023,,,,6,6,12
,2011,40700031,,,,7,4,11
,2011,40700035,,,,5,4,9
HND-003142,2011,40700040,,,,5,5,10
HND-003143,2011,40700042,,,,7,2,9
,2011,40700044,,,,4,5,9
HND-003146,2011,40700049,,,,4,6,10
,2011,40700050,,,,3,4,7
HND-003147,2011,40700052,,,,4,5,9
,2011,40700053,,,,11,4,15
HND-003148,2011,40700054,,,,7,4,11
HND-003141,2011,40700034,,,,5,5,10
,2011,40700039,,,,11,9,20
,2011,40700041,,,,6,5,11
,2011,40700045,,,,8,8,16
,2011,40700046,,,,3,5,8
,2011,40700047,,,,3,6,9
HND-003145,2011,40700048,,,,5,4,9
,2011,40700051,,,,6,3,9
HND-003149,2011,40700055,,,,4,4,8
HND-003137,2011,40700019,,,,0,4,4
HND-003134,2011,40700015,,,,4,7,11
HND-003133,2011,40700014,,,,2,3,5
HND-003135,2011,40700016,,,,2,4,6
HND-003137,2011,40700019,,,,2,3,5
,2011,40700025,,,,2,5,7
HND-003133,2011,40700014,,,,8,9,17
HND-003135,2011,40700016,,,,11,12,23
HND-003137,2011,40700019,,,,6,3,9
,2011,40700025,,,,5,7,12
HND-003134,2011,40700015,,,,8,3,11
HND-003122,2011,40700001,,,,12,8,20
HND-003124,2011,40700004,,,,2,3,5
HND-003125,2011,40700005,,,,6,6,12
HND-003126,2011,40700006,,,,14,12,26
HND-003127,2011,40700007,,,,17,9,26
HND-003130,2011,40700010,,,,15,11,26
HND-003131,2011,40700011,,,,5,5,10
HND-003136,2011,40700018,,,,20,10,30
HND-003140,2011,40700024,,,,17,7,24
HND-003123,2011,40700003,,,,5,10,15
HND-003128,2011,40700008,,,,3,5,8
HND-003129,2011,40700009,,,,13,10,23
HND-003132,2011,40700012,,,,3,3,6
HND-003144,2011,40700043,,,,2,1,3
HND-003122,2011,40700001,,,,26,21,47
HND-003125,2011,40700005,,,,2,2,4
HND-003126,2011,40700006,,,,5,4,9
HND-003127,2011,40700007,,,,10,7,17
HND-003128,2011,40700008,,,,5,2,7
HND-003130,2011,40700010,,,,9,4,13
HND-003132,2011,40700012,,,,8,2,10
HND-003123,2011,40700003,,,,5,6,11
HND-003124,2011,40700004,,,,4,1,5
HND-003129,2011,40700009,,,,17,15,32
HND-003131,2011,40700011,,,,5,6,11
HND-003136,2011,40700018,,,,10,5,15
HND-003144,2011,40700043,,,,3,2,5
HND-003123,2011,40700003,,,,5,9,14
HND-003128,2011,40700008,,,,6,4,10
HND-003129,2011,40700009,,,,9,11,20
HND-003132,2011,40700012,,,,3,2,5
HND-003122,2011,40700001,,,,9,14,23
HND-003124,2011,40700004,,,,1,4,5
HND-003125,2011,40700005,,,,1,3,4
HND-003126,2011,40700006,,,,2,6,8
HND-003127,2011,40700007,,,,6,6,12
HND-003130,2011,40700010,,,,6,11,17
HND-003131,2011,40700011,,,,8,10,18
HND-003136,2011,40700018,,,,13,8,21
HND-003140,2011,40700024,,,,2,4,6
HND-003144,2011,40700043,,,,1,3,4
HND-003122,2011,40700001,,,,17,12,29
HND-003124,2011,40700004,,,,4,0,4
HND-003125,2011,40700005,,,,3,4,7
HND-003126,2011,40700006,,,,5,5,10
HND-003127,2011,40700007,,,,13,6,19
HND-003128,2011,40700008,,,,8,5,13
HND-003130,2011,40700010,,,,16,10,26
HND-003132,2011,40700012,,,,4,3,7
HND-003144,2011,40700043,,,,1,2,3
HND-003123,2011,40700003,,,,8,2,10
HND-003129,2011,40700009,,,,12,9,21
HND-003131,2011,40700011,,,,8,6,14
HND-003136,2011,40700018,,,,5,5,10
HND-003140,2011,40700024,,,,0,7,7
HND-003122,2011,40700001,,,,17,15,32
HND-003124,2011,40700004,,,,1,0,1
HND-003125,2011,40700005,,,,2,2,4
HND-003126,2011,40700006,,,,2,3,5
HND-003127,2011,40700007,,,,5,2,7
HND-003130,2011,40700010,,,,13,12,25
HND-003131,2011,40700011,,,,0,3,3
HND-003132,2011,40700012,,,,6,3,9
HND-003136,2011,40700018,,,,11,10,21
HND-003140,2011,40700024,,,,2,4,6
HND-003144,2011,40700043,,,,0,1,1
HND-003123,2011,40700003,,,,4,6,10
HND-003128,2011,40700008,,,,3,1,4
HND-003129,2011,40700009,,,,8,12,20
HND-003123,2011,40700003,,,,4,1,5
HND-003124,2011,40700004,,,,1,0,1
HND-003129,2011,40700009,,,,14,8,22
HND-003131,2011,40700011,,,,2,5,7
HND-003136,2011,40700018,,,,2,5,7
HND-003140,2011,40700024,,,,1,0,1
HND-003144,2011,40700043,,,,1,0,1
HND-003122,2011,40700001,,,,11,17,28
HND-003125,2011,40700005,,,,2,3,5
HND-003126,2011,40700006,,,,2,3,5
HND-003127,2011,40700007,,,,8,5,13
HND-003128,2011,40700008,,,,1,0,1
HND-003130,2011,40700010,,,,6,6,12
HND-003132,2011,40700012,,,,2,7,9
HND-003122,2011,40700001,,,,17,18,35
HND-003122,2011,40700001,,,,14,13,27
HND-003122,2011,40700001,,,,12,16,28
HND-003157,2011,40800008,,,,4,6,10
HND-003159,2011,40800010,,,,4,5,9
HND-003162,2011,40800015,,,,5,7,12
HND-003165,2011,40800035,,,,4,5,9
,2011,40800037,,,,4,5,9
,2011,40800038,,,,5,4,9
,2011,40800041,,,,4,5,9
,2011,40800044,,,,4,5,9
,2011,40800021,,,,3,6,9
HND-003164,2011,40800034,,,,4,5,9
,2011,40800039,,,,5,7,12
HND-003166,2011,40800040,,,,3,5,8
HND-003168,2011,40800045,,,,4,5,9
HND-003161,2011,40800014,,,,1,2,3
HND-003167,2011,40800043,,,,3,3,6
HND-003160,2011,40800012,,,,6,2,8
,2011,40800018,,,,2,3,5
HND-003158,2011,40800009,,,,23,24,47
HND-003160,2011,40800012,,,,7,6,13
,2011,40800018,,,,2,2,4
HND-003167,2011,40800043,,,,1,4,5
HND-003161,2011,40800014,,,,3,3,6
HND-003161,2011,40800014,,,,2,4,6
HND-003167,2011,40800043,,,,5,4,9
HND-003158,2011,40800009,,,,34,37,71
HND-003160,2011,40800012,,,,4,6,10
,2011,40800018,,,,2,2,4
HND-003152,2011,40800003,,,,9,4,13
HND-003154,2011,40800005,,,,4,7,11
HND-003155,2011,40800006,,,,6,6,12
HND-003163,2011,40800016,,,,1,4,5
HND-003150,2011,40800001,,,,44,42,86
HND-003151,2011,40800002,,,,10,8,18
HND-003153,2011,40800004,,,,3,2,5
HND-003156,2011,40800007,,,,2,2,4
HND-003151,2011,40800002,,,,6,8,14
HND-003152,2011,40800003,,,,11,7,18
HND-003153,2011,40800004,,,,0,3,3
HND-003150,2011,40800001,,,,43,54,97
HND-003154,2011,40800005,,,,4,5,9
HND-003155,2011,40800006,,,,4,3,7
HND-003156,2011,40800007,,,,2,2,4
HND-003163,2011,40800016,,,,4,2,6
HND-003150,2011,40800001,,,,44,47,91
HND-003151,2011,40800002,,,,7,5,12
HND-003153,2011,40800004,,,,3,1,4
HND-003156,2011,40800007,,,,3,2,5
HND-003152,2011,40800003,,,,5,3,8
HND-003154,2011,40800005,,,,7,2,9
HND-003155,2011,40800006,,,,7,5,12
HND-003163,2011,40800016,,,,1,4,5
HND-003151,2011,40800002,,,,9,7,16
HND-003152,2011,40800003,,,,5,7,12
HND-003150,2011,40800001,,,,42,53,95
HND-003153,2011,40800004,,,,1,0,1
HND-003154,2011,40800005,,,,4,1,5
HND-003155,2011,40800006,,,,3,8,11
HND-003163,2011,40800016,,,,2,1,3
HND-003151,2011,40800002,,,,2,2,4
HND-003152,2011,40800003,,,,1,4,5
HND-003163,2011,40800016,,,,3,1,4
HND-003150,2011,40800001,,,,32,47,79
HND-003153,2011,40800004,,,,1,1,2
HND-003154,2011,40800005,,,,2,1,3
HND-003155,2011,40800006,,,,3,1,4
HND-003156,2011,40800007,,,,2,4,6
HND-003150,2011,40800001,,,,40,31,71
HND-003154,2011,40800005,,,,4,1,5
HND-003155,2011,40800006,,,,0,5,5
HND-003156,2011,40800007,,,,2,3,5
HND-003163,2011,40800016,,,,1,2,3
HND-003151,2011,40800002,,,,0,2,2
HND-003152,2011,40800003,,,,1,5,6
HND-003153,2011,40800004,,,,2,0,2
HND-003159,2011,40800010,,,,41,42,83
HND-003159,2011,40800010,,,,33,33,66
HND-003159,2011,40800010,,,,23,26,49
HND-003159,2011,40800010,,,,5,17,22
HND-003159,2011,40800010,,,,5,6,11
HND-003159,2011,40800010,,,,9,16,25
,2011,40900055,,,,12,6,18
,2011,40900056,,,,9,7,16
,2011,40900087,,,,11,7,18
,2011,40900089,,,,3,7,10
,2011,40900094,,,,3,7,10
HND-003217,2011,40900095,,,,6,7,13
,2011,40900096,,,,3,5,8
,2011,40900097,,,,6,4,10
,2011,40900109,,,,7,3,10
,2011,40900112,,,,5,3,8
HND-003221,2011,40900114,,,,3,8,11
,2011,40900115,,,,9,6,15
HND-003211,2011,40900050,,,,4,6,10
,2011,40900058,,,,5,5,10
,2011,40900059,,,,7,12,19
HND-003212,2011,40900061,,,,5,8,13
HND-003213,2011,40900082,,,,5,8,13
HND-003215,2011,40900091,,,,8,1,9
HND-003216,2011,40900093,,,,7,3,10
,2011,40900098,,,,8,5,13
HND-003218,2011,40900100,,,,5,6,11
HND-003220,2011,40900106,,,,7,5,12
,2011,40900107,,,,4,6,10
,2011,40900108,,,,3,4,7
,2011,40900110,,,,5,5,10
,2011,40900111,,,,2,7,9
,2011,40900113,,,,3,10,13
,2011,40900116,,,,7,5,12
,2011,40900117,,,,7,5,12
HND-003199,2011,40900034,,,,6,16,22
HND-003200,2011,40900035,,,,8,7,15
HND-003201,2011,40900036,,,,18,14,32
HND-003202,2011,40900037,,,,7,5,12
HND-003219,2011,40900101,,,,2,9,11
,2011,40900102,,,,5,5,10
HND-003204,2011,40900039,,,,0,5,5
HND-003205,2011,40900041,,,,3,2,5
HND-003209,2011,40900046,,,,9,8,17
HND-003214,2011,40900084,,,,3,2,5
,2011,40900103,,,,6,6,12
,2011,40900104,,,,1,2,3
HND-003204,2011,40900039,,,,6,4,10
HND-003205,2011,40900041,,,,11,12,23
HND-003209,2011,40900046,,,,16,23,39
HND-003210,2011,40900047,,,,17,10,27
HND-003214,2011,40900084,,,,12,9,21
HND-003219,2011,40900101,,,,11,8,19
,2011,40900102,,,,7,3,10
HND-003199,2011,40900034,,,,19,23,42
HND-003200,2011,40900035,,,,5,5,10
HND-003201,2011,40900036,,,,25,17,42
HND-003202,2011,40900037,,,,2,3,5
,2011,40900103,,,,6,11,17
HND-003172,2011,40900004,,,,41,43,84
HND-003175,2011,40900007,,,,12,22,34
,2011,40900009,,,,12,6,18
HND-003177,2011,40900010,,,,11,12,23
HND-003178,2011,40900011,,,,7,2,9
HND-003179,2011,40900012,,,,17,21,38
HND-003180,2011,40900013,,,,20,9,29
HND-003185,2011,40900018,,,,21,26,47
HND-003186,2011,40900019,,,,17,19,36
HND-003191,2011,40900025,,,,6,5,11
HND-003192,2011,40900025,,,,6,5,11
HND-003193,2011,40900028,,,,5,8,13
HND-003196,2011,40900031,,,,4,3,7
HND-003206,2011,40900042,,,,13,6,19
HND-003207,2011,40900043,,,,4,5,9
HND-003209,2011,40900046,,,,29,22,51
HND-003169,2011,40900001,,,,6,10,16
HND-003170,2011,40900002,,,,63,41,104
HND-003171,2011,40900003,,,,4,9,13
HND-003173,2011,40900005,,,,2,9,11
HND-003174,2011,40900006,,,,26,12,38
HND-003176,2011,40900008,,,,22,33,55
HND-003181,2011,40900014,,,,22,20,42
HND-003182,2011,40900015,,,,6,5,11
HND-003183,2011,40900016,,,,8,10,18
HND-003187,2011,40900020,,,,12,4,16
HND-003188,2011,40900021,,,,2,4,6
HND-003189,2011,40900022,,,,4,6,10
HND-003190,2011,40900023,,,,7,5,12
HND-003194,2011,40900029,,,,4,0,4
HND-003195,2011,40900030,,,,14,16,30
HND-003197,2011,40900032,,,,13,16,29
HND-003198,2011,40900033,,,,15,11,26
,2011,40900104,,,,2,2,4
HND-003171,2011,40900003,,,,6,11,17
HND-003172,2011,40900004,,,,21,22,43
,2011,40900009,,,,5,9,14
HND-003177,2011,40900010,,,,10,13,23
HND-003178,2011,40900011,,,,8,5,13
HND-003182,2011,40900015,,,,7,10,17
HND-003183,2011,40900016,,,,12,6,18
HND-003185,2011,40900018,,,,17,12,29
HND-003189,2011,40900022,,,,8,9,17
HND-003195,2011,40900030,,,,11,6,17
HND-003197,2011,40900032,,,,6,2,8
HND-003198,2011,40900033,,,,3,8,11
HND-003206,2011,40900042,,,,5,4,9
HND-003208,2011,40900044,,,,6,10,16
HND-003209,2011,40900046,,,,13,14,27
HND-003169,2011,40900001,,,,5,2,7
HND-003170,2011,40900002,,,,55,62,117
HND-003173,2011,40900005,,,,5,6,11
HND-003174,2011,40900006,,,,18,12,30
HND-003175,2011,40900007,,,,12,8,20
HND-003176,2011,40900008,,,,22,15,37
HND-003179,2011,40900012,,,,36,21,57
HND-003180,2011,40900013,,,,16,9,25
HND-003181,2011,40900014,,,,23,15,38
HND-003186,2011,40900019,,,,22,17,39
HND-003187,2011,40900020,,,,12,4,16
HND-003188,2011,40900021,,,,3,5,8
HND-003190,2011,40900023,,,,6,7,13
HND-003191,2011,40900025,,,,6,6,12
HND-003192,2011,40900025,,,,6,6,12
HND-003193,2011,40900028,,,,1,3,4
HND-003194,2011,40900029,,,,2,3,5
HND-003196,2011,40900031,,,,10,9,19
HND-003207,2011,40900043,,,,5,7,12
,2011,40900104,,,,1,0,1
HND-003171,2011,40900003,,,,1,4,5
HND-003172,2011,40900004,,,,24,16,40
HND-003175,2011,40900007,,,,4,8,12
,2011,40900009,,,,9,5,14
HND-003177,2011,40900010,,,,20,12,32
HND-003178,2011,40900011,,,,7,3,10
HND-003179,2011,40900012,,,,18,22,40
HND-003180,2011,40900013,,,,8,8,16
HND-003185,2011,40900018,,,,21,19,40
HND-003186,2011,40900019,,,,15,16,31
HND-003191,2011,40900025,,,,6,4,10
HND-003192,2011,40900025,,,,6,4,10
HND-003195,2011,40900030,,,,8,5,13
HND-003197,2011,40900032,,,,6,4,10
HND-003198,2011,40900033,,,,5,3,8
HND-003208,2011,40900044,,,,7,13,20
HND-003169,2011,40900001,,,,2,2,4
HND-003170,2011,40900002,,,,49,60,109
HND-003173,2011,40900005,,,,7,6,13
HND-003174,2011,40900006,,,,19,14,33
HND-003176,2011,40900008,,,,11,8,19
HND-003181,2011,40900014,,,,25,15,40
HND-003182,2011,40900015,,,,6,3,9
HND-003183,2011,40900016,,,,8,1,9
HND-003187,2011,40900020,,,,9,11,20
HND-003188,2011,40900021,,,,2,3,5
HND-003189,2011,40900022,,,,7,6,13
HND-003190,2011,40900023,,,,5,3,8
HND-003193,2011,40900028,,,,2,10,12
HND-003194,2011,40900029,,,,2,2,4
HND-003196,2011,40900031,,,,16,11,27
HND-003207,2011,40900043,,,,3,5,8
HND-003209,2011,40900046,,,,10,12,22
HND-003169,2011,40900001,,,,2,2,4
HND-003170,2011,40900002,,,,49,49,98
HND-003171,2011,40900003,,,,6,6,12
HND-003176,2011,40900008,,,,11,10,21
,2011,40900009,,,,1,6,7
HND-003178,2011,40900011,,,,1,4,5
HND-003182,2011,40900015,,,,4,4,8
HND-003183,2011,40900016,,,,10,5,15
HND-003185,2011,40900018,,,,3,7,10
HND-003187,2011,40900020,,,,4,1,5
HND-003189,2011,40900022,,,,0,8,8
HND-003190,2011,40900023,,,,6,2,8
HND-003195,2011,40900030,,,,4,3,7
HND-003196,2011,40900031,,,,15,10,25
HND-003206,2011,40900042,,,,4,4,8
HND-003207,2011,40900043,,,,4,0,4
HND-003209,2011,40900046,,,,24,11,35
HND-003172,2011,40900004,,,,15,18,33
HND-003173,2011,40900005,,,,6,4,10
HND-003174,2011,40900006,,,,7,6,13
HND-003175,2011,40900007,,,,19,14,33
HND-003177,2011,40900010,,,,11,7,18
HND-003179,2011,40900012,,,,18,18,36
HND-003180,2011,40900013,,,,12,17,29
HND-003181,2011,40900014,,,,19,18,37
HND-003186,2011,40900019,,,,8,6,14
HND-003188,2011,40900021,,,,2,2,4
HND-003191,2011,40900025,,,,4,5,9
HND-003192,2011,40900025,,,,4,5,9
HND-003197,2011,40900032,,,,13,17,30
HND-003198,2011,40900033,,,,5,2,7
HND-003169,2011,40900001,,,,2,4,6
HND-003170,2011,40900002,,,,50,43,93
HND-003171,2011,40900003,,,,6,8,14
HND-003176,2011,40900008,,,,9,8,17
,2011,40900009,,,,2,7,9
HND-003181,2011,40900014,,,,12,16,28
HND-003182,2011,40900015,,,,1,3,4
HND-003183,2011,40900016,,,,2,4,6
HND-003185,2011,40900018,,,,8,3,11
HND-003187,2011,40900020,,,,4,3,7
HND-003189,2011,40900022,,,,3,6,9
HND-003190,2011,40900023,,,,2,1,3
HND-003194,2011,40900029,,,,2,2,4
HND-003196,2011,40900031,,,,2,4,6
HND-003207,2011,40900043,,,,1,0,1
HND-003209,2011,40900046,,,,15,14,29
HND-003172,2011,40900004,,,,19,21,40
HND-003173,2011,40900005,,,,7,5,12
HND-003174,2011,40900006,,,,7,8,15
HND-003175,2011,40900007,,,,14,7,21
HND-003177,2011,40900010,,,,13,15,28
HND-003178,2011,40900011,,,,4,5,9
HND-003179,2011,40900012,,,,15,10,25
HND-003180,2011,40900013,,,,5,5,10
HND-003186,2011,40900019,,,,8,8,16
HND-003191,2011,40900025,,,,6,2,8
HND-003192,2011,40900025,,,,6,2,8
HND-003193,2011,40900028,,,,1,2,3
HND-003195,2011,40900030,,,,10,5,15
HND-003197,2011,40900032,,,,4,4,8
HND-003198,2011,40900033,,,,5,2,7
HND-003169,2011,40900001,,,,4,1,5
HND-003170,2011,40900002,,,,34,48,82
HND-003173,2011,40900005,,,,2,6,8
HND-003174,2011,40900006,,,,9,1,10
HND-003175,2011,40900007,,,,6,10,16
HND-003179,2011,40900012,,,,3,13,16
HND-003180,2011,40900013,,,,3,4,7
HND-003181,2011,40900014,,,,5,1,6
HND-003186,2011,40900019,,,,11,12,23
HND-003187,2011,40900020,,,,4,7,11
HND-003188,2011,40900021,,,,2,3,5
HND-003190,2011,40900023,,,,3,2,5
HND-003191,2011,40900025,,,,5,1,6
HND-003192,2011,40900025,,,,5,1,6
HND-003193,2011,40900028,,,,1,0,1
HND-003194,2011,40900029,,,,1,2,3
HND-003196,2011,40900031,,,,5,6,11
HND-003171,2011,40900003,,,,2,0,2
HND-003172,2011,40900004,,,,10,11,21
,2011,40900009,,,,2,6,8
HND-003177,2011,40900010,,,,8,10,18
HND-003178,2011,40900011,,,,5,2,7
HND-003182,2011,40900015,,,,3,5,8
HND-003183,2011,40900016,,,,6,6,12
HND-003185,2011,40900018,,,,0,2,2
HND-003189,2011,40900022,,,,5,6,11
HND-003195,2011,40900030,,,,1,2,3
HND-003197,2011,40900032,,,,5,3,8
HND-003198,2011,40900033,,,,1,3,4
HND-003206,2011,40900042,,,,4,1,5
HND-003209,2011,40900046,,,,12,12,24
,2011,40900009,,,,7,3,10
HND-003172,2011,40900004,,,,22,13,35
HND-003179,2011,40900012,,,,7,14,21
HND-003203,2011,40900038,,,,57,63,120
HND-003172,2011,40900004,,,,6,12,18
,2011,40900009,,,,3,6,9
HND-003203,2011,40900038,,,,63,50,113
HND-003179,2011,40900012,,,,10,11,21
,2011,40900009,,,,8,8,16
HND-003203,2011,40900038,,,,54,51,105
HND-003172,2011,40900004,,,,5,11,16
HND-003179,2011,40900012,,,,7,9,16
HND-003203,2011,40900038,,,,61,69,130
HND-003288,2011,41000072,,,,8,8,16
,2011,41000084,,,,7,5,12
HND-003294,2011,41000085,,,,7,11,18
HND-003295,2011,41000089,,,,3,11,14
,2011,41000091,,,,9,5,14
HND-003296,2011,41000093,,,,8,4,12
HND-003298,2011,41000097,,,,5,4,9
HND-003299,2011,41000103,,,,10,2,12
HND-003300,2011,41000104,,,,8,2,10
,2011,41000108,,,,9,3,12
,2011,41000109,,,,4,7,11
HND-003304,2011,41000117,,,,6,9,15
,2011,41000123,,,,11,9,20
,2011,41000128,,,,3,5,8
,2011,41000130,,,,4,6,10
,2011,41000140,,,,4,5,9
,2011,41000151,,,,4,7,11
HND-003309,2011,41000152,,,,8,5,13
HND-003311,2011,41000154,,,,6,4,10
,2011,41000155,,,,3,7,10
,2011,41000158,,,,5,5,10
,2011,41000159,,,,8,7,15
,2011,41000167,,,,6,6,12
,2011,41000171,,,,9,5,14
,2011,41000175,,,,8,8,16
HND-003316,2011,41000176,,,,4,9,13
,2011,41000177,,,,6,4,10
,2011,41000178,,,,5,7,12
,2011,41000180,,,,7,5,12
,2011,41000181,,,,5,7,12
HND-003317,2011,41000182,,,,6,2,8
,2011,41000183,,,,7,5,12
HND-003320,2011,41000189,,,,3,9,12
HND-003251,2011,41000029,,,,9,4,13
HND-003289,2011,41000073,,,,6,10,16
,2011,41000083,,,,5,6,11
,2011,41000087,,,,4,6,10
,2011,41000095,,,,8,4,12
HND-003297,2011,41000096,,,,9,8,17
,2011,41000099,,,,4,5,9
,2011,41000120,,,,9,7,16
HND-003305,2011,41000133,,,,5,6,11
HND-003306,2011,41000136,,,,5,7,12
,2011,41000138,,,,9,10,19
,2011,41000146,,,,10,4,14
,2011,41000148,,,,2,8,10
,2011,41000149,,,,10,3,13
,2011,41000157,,,,4,7,11
,2011,41000160,,,,8,4,12
HND-003312,2011,41000162,,,,9,4,13
,2011,41000163,,,,7,5,12
HND-003314,2011,41000165,,,,5,6,11
,2011,41000166,,,,8,4,12
,2011,41000168,,,,6,5,11
,2011,41000169,,,,5,6,11
,2011,41000172,,,,7,6,13
HND-003315,2011,41000173,,,,4,6,10
,2011,41000184,,,,9,8,17
HND-003318,2011,41000185,,,,7,6,13
,2011,41000186,,,,6,4,10
HND-003319,2011,41000187,,,,4,8,12
,2011,41000188,,,,5,7,12
,2011,41000190,,,,3,7,10
HND-003270,2011,41000050,,,,4,2,6
HND-003270,2011,41000050,,,,8,11,19
HND-003279,2011,41000059,,,,21,22,43
HND-003280,2011,41000060,,,,15,15,30
,2011,41000061,,,,2,4,6
HND-003282,2011,41000063,,,,12,12,24
,2011,41000074,,,,3,4,7
HND-003293,2011,41000080,,,,3,1,4
HND-003303,2011,41000116,,,,7,3,10
HND-003302,2011,41000115,,,,12,20,32
HND-003303,2011,41000116,,,,8,7,15
HND-003270,2011,41000050,,,,19,7,26
HND-003279,2011,41000059,,,,17,28,45
HND-003280,2011,41000060,,,,31,25,56
,2011,41000061,,,,5,11,16
HND-003282,2011,41000063,,,,8,8,16
,2011,41000074,,,,6,11,17
HND-003293,2011,41000080,,,,8,12,20
HND-003226,2011,41000002,,,,58,54,112
HND-003227,2011,41000003,,,,14,10,24
HND-003230,2011,41000006,,,,7,3,10
HND-003231,2011,41000007,,,,25,18,43
HND-003235,2011,41000012,,,,7,7,14
HND-003236,2011,41000013,,,,12,11,23
HND-003237,2011,41000014,,,,16,15,31
HND-003238,2011,41000015,,,,9,13,22
HND-003239,2011,41000016,,,,25,32,57
HND-003240,2011,41000017,,,,9,4,13
HND-003241,2011,41000018,,,,10,2,12
HND-003242,2011,41000019,,,,6,12,18
HND-003243,2011,41000020,,,,11,10,21
HND-003244,2011,41000021,,,,10,15,25
HND-003245,2011,41000022,,,,15,7,22
HND-003246,2011,41000023,,,,5,10,15
HND-003247,2011,41000025,,,,7,5,12
HND-003248,2011,41000026,,,,3,1,4
HND-003249,2011,41000027,,,,23,18,41
HND-003250,2011,41000028,,,,10,6,16
HND-003251,2011,41000029,,,,17,11,28
HND-003262,2011,41000041,,,,3,3,6
HND-003264,2011,41000043,,,,2,2,4
HND-003265,2011,41000044,,,,6,6,12
HND-003267,2011,41000046,,,,2,6,8
HND-003274,2011,41000054,,,,8,7,15
HND-003275,2011,41000055,,,,2,2,4
HND-003276,2011,41000056,,,,8,7,15
HND-003283,2011,41000065,,,,7,1,8
HND-003284,2011,41000067,,,,7,2,9
HND-003285,2011,41000068,,,,2,3,5
HND-003286,2011,41000069,,,,6,3,9
HND-003287,2011,41000070,,,,6,5,11
HND-003291,2011,41000078,,,,2,2,4
HND-003292,2011,41000079,,,,7,3,10
HND-003301,2011,41000114,,,,4,6,10
HND-003229,2011,41000005,,,,6,9,15
HND-003232,2011,41000008,,,,9,14,23
HND-003233,2011,41000009,,,,7,4,11
HND-003234,2011,41000011,,,,3,5,8
HND-003252,2011,41000030,,,,28,34,62
HND-003253,2011,41000031,,,,8,5,13
HND-003254,2011,41000033,,,,7,6,13
HND-003255,2011,41000034,,,,6,6,12
HND-003256,2011,41000035,,,,5,2,7
HND-003257,2011,41000036,,,,4,4,8
HND-003258,2011,41000037,,,,12,16,28
HND-003259,2011,41000038,,,,2,7,9
HND-003260,2011,41000039,,,,8,6,14
HND-003261,2011,41000040,,,,4,2,6
HND-003266,2011,41000045,,,,11,5,16
HND-003268,2011,41000048,,,,4,3,7
HND-003271,2011,41000051,,,,10,15,25
HND-003272,2011,41000052,,,,11,2,13
HND-003273,2011,41000053,,,,4,6,10
HND-003277,2011,41000057,,,,5,3,8
HND-003278,2011,41000058,,,,48,56,104
HND-003290,2011,41000076,,,,10,4,14
,2011,41000143,,,,1,3,4
HND-003308,2011,41000144,,,,1,3,4
HND-003227,2011,41000003,,,,9,8,17
HND-003228,2011,41000004,,,,4,3,7
HND-003229,2011,41000005,,,,7,6,13
HND-003230,2011,41000006,,,,2,6,8
HND-003232,2011,41000008,,,,12,15,27
HND-003233,2011,41000009,,,,4,2,6
HND-003234,2011,41000011,,,,6,5,11
HND-003238,2011,41000015,,,,10,14,24
HND-003239,2011,41000016,,,,29,33,62
HND-003241,2011,41000018,,,,3,5,8
HND-003242,2011,41000019,,,,9,7,16
HND-003243,2011,41000020,,,,11,12,23
HND-003247,2011,41000025,,,,10,7,17
HND-003250,2011,41000028,,,,8,7,15
HND-003251,2011,41000029,,,,4,9,13
HND-003253,2011,41000031,,,,4,5,9
HND-003254,2011,41000033,,,,9,6,15
HND-003255,2011,41000034,,,,2,0,2
HND-003257,2011,41000036,,,,2,6,8
HND-003261,2011,41000040,,,,2,0,2
HND-003263,2011,41000042,,,,2,4,6
HND-003265,2011,41000044,,,,7,8,15
HND-003266,2011,41000045,,,,1,3,4
HND-003267,2011,41000046,,,,7,4,11
HND-003268,2011,41000048,,,,4,2,6
HND-003278,2011,41000058,,,,39,49,88
HND-003283,2011,41000065,,,,5,3,8
HND-003285,2011,41000068,,,,1,1,2
HND-003286,2011,41000069,,,,3,2,5
HND-003301,2011,41000114,,,,6,2,8
,2011,41000143,,,,6,5,11
HND-003308,2011,41000144,,,,0,1,1
HND-003226,2011,41000002,,,,47,43,90
HND-003231,2011,41000007,,,,8,10,18
HND-003235,2011,41000012,,,,6,11,17
HND-003236,2011,41000013,,,,11,11,22
HND-003237,2011,41000014,,,,16,12,28
HND-003240,2011,41000017,,,,10,9,19
HND-003244,2011,41000021,,,,7,12,19
HND-003245,2011,41000022,,,,8,6,14
HND-003246,2011,41000023,,,,12,1,13
HND-003248,2011,41000026,,,,2,1,3
HND-003249,2011,41000027,,,,3,6,9
HND-003252,2011,41000030,,,,13,18,31
HND-003256,2011,41000035,,,,2,3,5
HND-003259,2011,41000038,,,,8,4,12
HND-003260,2011,41000039,,,,3,3,6
HND-003262,2011,41000041,,,,4,2,6
HND-003264,2011,41000043,,,,4,3,7
HND-003271,2011,41000051,,,,6,10,16
HND-003272,2011,41000052,,,,7,5,12
HND-003273,2011,41000053,,,,8,1,9
HND-003274,2011,41000054,,,,4,4,8
HND-003275,2011,41000055,,,,0,3,3
HND-003276,2011,41000056,,,,5,10,15
HND-003277,2011,41000057,,,,4,0,4
HND-003284,2011,41000067,,,,1,4,5
HND-003287,2011,41000070,,,,3,3,6
HND-003290,2011,41000076,,,,11,6,17
HND-003291,2011,41000078,,,,3,3,6
HND-003292,2011,41000079,,,,4,2,6
HND-003307,2011,41000142,,,,10,4,14
HND-003229,2011,41000005,,,,11,9,20
HND-003230,2011,41000006,,,,4,4,8
HND-003232,2011,41000008,,,,13,11,24
HND-003233,2011,41000009,,,,7,6,13
HND-003234,2011,41000011,,,,8,3,11
HND-003242,2011,41000019,,,,6,7,13
HND-003251,2011,41000029,,,,3,3,6
HND-003252,2011,41000030,,,,19,18,37
HND-003253,2011,41000031,,,,5,4,9
HND-003254,2011,41000033,,,,4,5,9
HND-003255,2011,41000034,,,,5,3,8
HND-003256,2011,41000035,,,,2,0,2
HND-003257,2011,41000036,,,,4,3,7
HND-003258,2011,41000037,,,,2,4,6
HND-003259,2011,41000038,,,,5,7,12
HND-003261,2011,41000040,,,,1,2,3
HND-003266,2011,41000045,,,,3,2,5
HND-003268,2011,41000048,,,,3,2,5
HND-003271,2011,41000051,,,,10,9,19
HND-003273,2011,41000053,,,,1,2,3
HND-003277,2011,41000057,,,,3,1,4
HND-003278,2011,41000058,,,,52,33,85
HND-003286,2011,41000069,,,,0,4,4
HND-003290,2011,41000076,,,,11,6,17
,2011,41000143,,,,4,6,10
HND-003308,2011,41000144,,,,7,4,11
HND-003226,2011,41000002,,,,45,39,84
HND-003227,2011,41000003,,,,8,12,20
HND-003228,2011,41000004,,,,1,4,5
HND-003231,2011,41000007,,,,11,9,20
HND-003235,2011,41000012,,,,10,12,22
HND-003236,2011,41000013,,,,8,9,17
HND-003237,2011,41000014,,,,13,9,22
HND-003238,2011,41000015,,,,8,11,19
HND-003239,2011,41000016,,,,35,31,66
HND-003240,2011,41000017,,,,11,3,14
HND-003241,2011,41000018,,,,3,4,7
HND-003243,2011,41000020,,,,13,9,22
HND-003244,2011,41000021,,,,4,11,15
HND-003245,2011,41000022,,,,5,11,16
HND-003246,2011,41000023,,,,4,6,10
HND-003247,2011,41000025,,,,7,9,16
HND-003248,2011,41000026,,,,3,2,5
HND-003249,2011,41000027,,,,3,2,5
HND-003250,2011,41000028,,,,4,8,12
HND-003260,2011,41000039,,,,2,2,4
HND-003262,2011,41000041,,,,0,1,1
HND-003263,2011,41000042,,,,0,2,2
HND-003264,2011,41000043,,,,2,2,4
HND-003265,2011,41000044,,,,8,7,15
HND-003267,2011,41000046,,,,4,1,5
HND-003272,2011,41000052,,,,10,9,19
HND-003274,2011,41000054,,,,6,4,10
HND-003275,2011,41000055,,,,2,1,3
HND-003276,2011,41000056,,,,9,5,14
HND-003283,2011,41000065,,,,0,4,4
HND-003284,2011,41000067,,,,1,2,3
HND-003285,2011,41000068,,,,0,1,1
HND-003287,2011,41000070,,,,3,8,11
HND-003291,2011,41000078,,,,2,4,6
HND-003292,2011,41000079,,,,1,2,3
HND-003301,2011,41000114,,,,2,1,3
HND-003227,2011,41000003,,,,3,6,9
HND-003228,2011,41000004,,,,7,3,10
HND-003229,2011,41000005,,,,5,6,11
HND-003230,2011,41000006,,,,2,0,2
HND-003231,2011,41000007,,,,11,8,19
HND-003232,2011,41000008,,,,5,3,8
HND-003235,2011,41000012,,,,13,12,25
HND-003237,2011,41000014,,,,11,16,27
HND-003238,2011,41000015,,,,9,6,15
HND-003239,2011,41000016,,,,19,21,40
HND-003241,2011,41000018,,,,8,5,13
HND-003242,2011,41000019,,,,8,7,15
HND-003243,2011,41000020,,,,10,7,17
HND-003245,2011,41000022,,,,7,10,17
HND-003247,2011,41000025,,,,5,3,8
HND-003248,2011,41000026,,,,3,0,3
HND-003250,2011,41000028,,,,4,6,10
HND-003251,2011,41000029,,,,4,3,7
HND-003253,2011,41000031,,,,0,3,3
HND-003254,2011,41000033,,,,1,5,6
HND-003261,2011,41000040,,,,1,2,3
HND-003262,2011,41000041,,,,2,4,6
HND-003263,2011,41000042,,,,3,4,7
HND-003264,2011,41000043,,,,2,1,3
HND-003265,2011,41000044,,,,2,3,5
HND-003266,2011,41000045,,,,1,3,4
HND-003267,2011,41000046,,,,3,4,7
HND-003268,2011,41000048,,,,2,3,5
HND-003283,2011,41000065,,,,2,2,4
HND-003285,2011,41000068,,,,0,4,4
HND-003286,2011,41000069,,,,1,1,2
HND-003301,2011,41000114,,,,0,4,4
,2011,41000143,,,,2,2,4
HND-003308,2011,41000144,,,,5,4,9
HND-003226,2011,41000002,,,,37,48,85
HND-003233,2011,41000009,,,,0,6,6
HND-003234,2011,41000011,,,,6,6,12
HND-003236,2011,41000013,,,,2,6,8
HND-003240,2011,41000017,,,,3,4,7
HND-003244,2011,41000021,,,,4,7,11
HND-003246,2011,41000023,,,,4,6,10
HND-003249,2011,41000027,,,,12,5,17
HND-003252,2011,41000030,,,,28,20,48
HND-003255,2011,41000034,,,,3,5,8
HND-003256,2011,41000035,,,,2,4,6
HND-003257,2011,41000036,,,,2,5,7
HND-003259,2011,41000038,,,,4,8,12
HND-003260,2011,41000039,,,,1,4,5
HND-003271,2011,41000051,,,,5,8,13
HND-003272,2011,41000052,,,,13,5,18
HND-003273,2011,41000053,,,,1,3,4
HND-003274,2011,41000054,,,,1,7,8
HND-003275,2011,41000055,,,,2,2,4
HND-003276,2011,41000056,,,,5,8,13
HND-003277,2011,41000057,,,,1,3,4
HND-003278,2011,41000058,,,,44,42,86
HND-003284,2011,41000067,,,,1,1,2
HND-003287,2011,41000070,,,,3,6,9
HND-003290,2011,41000076,,,,4,3,7
HND-003291,2011,41000078,,,,1,1,2
HND-003292,2011,41000079,,,,2,2,4
HND-003307,2011,41000142,,,,0,1,1
HND-003227,2011,41000003,,,,11,13,24
HND-003228,2011,41000004,,,,3,5,8
HND-003230,2011,41000006,,,,3,1,4
HND-003231,2011,41000007,,,,7,5,12
HND-003232,2011,41000008,,,,6,11,17
HND-003235,2011,41000012,,,,10,14,24
HND-003236,2011,41000013,,,,6,3,9
HND-003237,2011,41000014,,,,10,7,17
HND-003238,2011,41000015,,,,3,10,13
HND-003239,2011,41000016,,,,28,19,47
HND-003240,2011,41000017,,,,1,8,9
HND-003241,2011,41000018,,,,5,4,9
HND-003242,2011,41000019,,,,3,5,8
HND-003243,2011,41000020,,,,3,6,9
HND-003245,2011,41000022,,,,1,2,3
HND-003246,2011,41000023,,,,7,7,14
HND-003247,2011,41000025,,,,4,3,7
HND-003248,2011,41000026,,,,0,1,1
HND-003250,2011,41000028,,,,3,8,11
HND-003251,2011,41000029,,,,2,1,3
HND-003253,2011,41000031,,,,1,5,6
HND-003258,2011,41000037,,,,1,2,3
HND-003261,2011,41000040,,,,2,1,3
HND-003262,2011,41000041,,,,1,1,2
HND-003263,2011,41000042,,,,6,2,8
HND-003264,2011,41000043,,,,5,3,8
HND-003265,2011,41000044,,,,8,5,13
HND-003266,2011,41000045,,,,2,2,4
HND-003267,2011,41000046,,,,2,2,4
HND-003268,2011,41000048,,,,3,3,6
HND-003275,2011,41000055,,,,1,1,2
HND-003283,2011,41000065,,,,1,4,5
HND-003284,2011,41000067,,,,1,1,2
HND-003285,2011,41000068,,,,3,5,8
HND-003286,2011,41000069,,,,0,1,1
HND-003292,2011,41000079,,,,9,2,11
HND-003308,2011,41000144,,,,3,0,3
HND-003226,2011,41000002,,,,39,44,83
HND-003229,2011,41000005,,,,13,5,18
HND-003233,2011,41000009,,,,1,4,5
HND-003234,2011,41000011,,,,5,4,9
HND-003244,2011,41000021,,,,3,3,6
HND-003249,2011,41000027,,,,7,8,15
HND-003252,2011,41000030,,,,24,12,36
HND-003254,2011,41000033,,,,3,2,5
HND-003255,2011,41000034,,,,1,4,5
HND-003256,2011,41000035,,,,1,3,4
HND-003257,2011,41000036,,,,2,2,4
HND-003259,2011,41000038,,,,7,7,14
HND-003260,2011,41000039,,,,3,3,6
HND-003271,2011,41000051,,,,9,1,10
HND-003272,2011,41000052,,,,10,7,17
HND-003273,2011,41000053,,,,2,1,3
HND-003274,2011,41000054,,,,5,6,11
HND-003276,2011,41000056,,,,13,9,22
HND-003278,2011,41000058,,,,37,34,71
HND-003290,2011,41000076,,,,6,4,10
HND-003301,2011,41000114,,,,1,4,5
HND-003307,2011,41000142,,,,2,5,7
HND-003226,2011,41000002,,,,32,36,68
HND-003231,2011,41000007,,,,11,12,23
HND-003235,2011,41000012,,,,9,4,13
HND-003236,2011,41000013,,,,9,1,10
HND-003237,2011,41000014,,,,7,5,12
HND-003240,2011,41000017,,,,4,3,7
HND-003244,2011,41000021,,,,2,4,6
HND-003245,2011,41000022,,,,1,7,8
HND-003246,2011,41000023,,,,4,0,4
HND-003248,2011,41000026,,,,1,3,4
HND-003249,2011,41000027,,,,1,8,9
HND-003254,2011,41000033,,,,2,6,8
HND-003255,2011,41000034,,,,1,2,3
HND-003257,2011,41000036,,,,3,5,8
HND-003261,2011,41000040,,,,2,1,3
HND-003263,2011,41000042,,,,0,2,2
HND-003265,2011,41000044,,,,0,1,1
HND-003266,2011,41000045,,,,0,1,1
HND-003267,2011,41000046,,,,7,1,8
HND-003278,2011,41000058,,,,39,35,74
HND-003284,2011,41000067,,,,2,3,5
HND-003307,2011,41000142,,,,8,5,13
HND-003227,2011,41000003,,,,2,3,5
HND-003228,2011,41000004,,,,2,1,3
HND-003229,2011,41000005,,,,5,9,14
HND-003230,2011,41000006,,,,2,1,3
HND-003232,2011,41000008,,,,7,7,14
HND-003233,2011,41000009,,,,4,1,5
HND-003234,2011,41000011,,,,4,8,12
HND-003238,2011,41000015,,,,6,5,11
HND-003239,2011,41000016,,,,23,26,49
HND-003241,2011,41000018,,,,10,2,12
HND-003242,2011,41000019,,,,2,7,9
HND-003243,2011,41000020,,,,5,3,8
HND-003247,2011,41000025,,,,5,3,8
HND-003250,2011,41000028,,,,3,5,8
HND-003251,2011,41000029,,,,1,1,2
HND-003252,2011,41000030,,,,6,14,20
HND-003259,2011,41000038,,,,4,3,7
HND-003260,2011,41000039,,,,1,2,3
HND-003262,2011,41000041,,,,1,2,3
HND-003264,2011,41000043,,,,1,3,4
HND-003271,2011,41000051,,,,6,8,14
HND-003272,2011,41000052,,,,10,5,15
HND-003274,2011,41000054,,,,2,3,5
HND-003275,2011,41000055,,,,0,2,2
HND-003276,2011,41000056,,,,7,2,9
HND-003277,2011,41000057,,,,1,6,7
HND-003283,2011,41000065,,,,0,2,2
HND-003287,2011,41000070,,,,2,3,5
HND-003290,2011,41000076,,,,3,7,10
HND-003292,2011,41000079,,,,1,6,7
,2011,41000143,,,,3,2,5
HND-003308,2011,41000144,,,,1,0,1
HND-003231,2011,41000007,,,,15,9,24
HND-003237,2011,41000014,,,,13,12,25
HND-003239,2011,41000016,,,,11,10,21
HND-003242,2011,41000019,,,,6,5,11
HND-003281,2011,41000062,,,,80,85,165
,2011,41000141,,,,9,14,23
HND-003252,2011,41000030,,,,7,15,22
HND-003239,2011,41000016,,,,5,7,12
HND-003242,2011,41000019,,,,2,8,10
,2011,41000141,,,,8,14,22
HND-003231,2011,41000007,,,,3,6,9
HND-003237,2011,41000014,,,,8,8,16
HND-003252,2011,41000030,,,,4,9,13
HND-003281,2011,41000062,,,,51,65,116
HND-003231,2011,41000007,,,,3,4,7
HND-003237,2011,41000014,,,,6,6,12
HND-003239,2011,41000016,,,,3,11,14
HND-003242,2011,41000019,,,,3,9,12
HND-003281,2011,41000062,,,,58,63,121
HND-003252,2011,41000030,,,,4,8,12
,2011,41000141,,,,9,16,25
HND-003281,2011,41000062,,,,43,56,99
,2011,41000141,,,,21,48,69
,2011,41000141,,,,6,8,14
HND-003281,2011,41000062,,,,37,31,68
HND-003281,2011,41000062,,,,26,38,64
,2011,41000141,,,,0,9,9
,2011,41100045,,,,4,7,11
,2011,41100046,,,,8,7,15
,2011,41100035,,,,5,10,15
HND-003348,2011,41100036,,,,13,9,22
,2011,41100037,,,,6,6,12
HND-003349,2011,41100041,,,,6,4,10
HND-003346,2011,41100027,,,,2,2,4
HND-003338,2011,41100017,,,,5,6,11
HND-003340,2011,41100019,,,,3,5,8
HND-003347,2011,41100031,,,,5,2,7
HND-003339,2011,41100018,,,,6,2,8
HND-003341,2011,41100020,,,,4,1,5
HND-003345,2011,41100026,,,,11,2,13
HND-003346,2011,41100027,,,,2,2,4
HND-003340,2011,41100019,,,,8,8,16
HND-003345,2011,41100026,,,,6,9,15
HND-003346,2011,41100027,,,,2,6,8
HND-003338,2011,41100017,,,,8,5,13
HND-003339,2011,41100018,,,,7,10,17
HND-003341,2011,41100020,,,,7,3,10
HND-003347,2011,41100031,,,,5,12,17
HND-003323,2011,41100001,,,,4,6,10
HND-003324,2011,41100002,,,,10,8,18
HND-003325,2011,41100003,,,,5,6,11
HND-003326,2011,41100004,,,,4,5,9
HND-003329,2011,41100007,,,,10,16,26
HND-003332,2011,41100010,,,,19,10,29
HND-003334,2011,41100012,,,,5,4,9
HND-003335,2011,41100014,,,,5,6,11
HND-003336,2011,41100015,,,,10,11,21
HND-003337,2011,41100016,,,,7,6,13
HND-003327,2011,41100005,,,,15,9,24
HND-003328,2011,41100006,,,,10,8,18
HND-003330,2011,41100008,,,,3,4,7
HND-003331,2011,41100009,,,,15,15,30
HND-003333,2011,41100011,,,,14,11,25
HND-003343,2011,41100023,,,,1,8,9
HND-003323,2011,41100001,,,,0,3,3
HND-003324,2011,41100002,,,,7,12,19
HND-003325,2011,41100003,,,,5,2,7
HND-003326,2011,41100004,,,,4,5,9
HND-003327,2011,41100005,,,,15,7,22
HND-003328,2011,41100006,,,,9,9,18
HND-003329,2011,41100007,,,,15,7,22
HND-003330,2011,41100008,,,,3,1,4
HND-003331,2011,41100009,,,,14,7,21
HND-003333,2011,41100011,,,,9,14,23
HND-003343,2011,41100023,,,,9,2,11
HND-003332,2011,41100010,,,,8,5,13
HND-003334,2011,41100012,,,,7,2,9
HND-003335,2011,41100014,,,,4,1,5
HND-003336,2011,41100015,,,,5,12,17
HND-003337,2011,41100016,,,,5,3,8
HND-003326,2011,41100004,,,,4,3,7
HND-003327,2011,41100005,,,,20,23,43
HND-003328,2011,41100006,,,,12,10,22
HND-003330,2011,41100008,,,,1,2,3
HND-003331,2011,41100009,,,,10,14,24
HND-003333,2011,41100011,,,,13,10,23
HND-003343,2011,41100023,,,,5,0,5
HND-003323,2011,41100001,,,,1,5,6
HND-003324,2011,41100002,,,,4,10,14
HND-003325,2011,41100003,,,,4,3,7
HND-003329,2011,41100007,,,,8,9,17
HND-003332,2011,41100010,,,,12,15,27
HND-003334,2011,41100012,,,,7,3,10
HND-003335,2011,41100014,,,,6,4,10
HND-003336,2011,41100015,,,,6,9,15
HND-003337,2011,41100016,,,,5,0,5
HND-003323,2011,41100001,,,,4,1,5
HND-003324,2011,41100002,,,,10,8,18
HND-003325,2011,41100003,,,,5,1,6
HND-003326,2011,41100004,,,,2,2,4
HND-003327,2011,41100005,,,,12,14,26
HND-003328,2011,41100006,,,,3,8,11
HND-003329,2011,41100007,,,,4,5,9
HND-003330,2011,41100008,,,,1,2,3
HND-003332,2011,41100010,,,,5,5,10
HND-003333,2011,41100011,,,,17,14,31
HND-003336,2011,41100015,,,,6,8,14
HND-003343,2011,41100023,,,,5,0,5
HND-003331,2011,41100009,,,,23,24,47
HND-003334,2011,41100012,,,,0,4,4
HND-003335,2011,41100014,,,,2,4,6
HND-003337,2011,41100016,,,,3,2,5
HND-003323,2011,41100001,,,,0,4,4
HND-003324,2011,41100002,,,,6,9,15
HND-003326,2011,41100004,,,,2,5,7
HND-003328,2011,41100006,,,,6,7,13
HND-003329,2011,41100007,,,,5,8,13
HND-003332,2011,41100010,,,,9,13,22
HND-003333,2011,41100011,,,,17,13,30
HND-003335,2011,41100014,,,,4,6,10
HND-003336,2011,41100015,,,,6,4,10
HND-003343,2011,41100023,,,,0,2,2
HND-003327,2011,41100005,,,,8,13,21
HND-003330,2011,41100008,,,,2,0,2
HND-003331,2011,41100009,,,,12,15,27
HND-003334,2011,41100012,,,,4,4,8
HND-003332,2011,41100010,,,,11,4,15
HND-003334,2011,41100012,,,,1,3,4
HND-003335,2011,41100014,,,,5,1,6
HND-003336,2011,41100015,,,,10,7,17
HND-003323,2011,41100001,,,,2,3,5
HND-003324,2011,41100002,,,,5,4,9
HND-003327,2011,41100005,,,,14,19,33
HND-003328,2011,41100006,,,,5,11,16
HND-003329,2011,41100007,,,,2,2,4
HND-003330,2011,41100008,,,,1,0,1
HND-003331,2011,41100009,,,,9,22,31
HND-003333,2011,41100011,,,,14,15,29
HND-003324,2011,41100002,,,,6,8,14
HND-003342,2011,41100022,,,,29,23,52
,2011,41100030,,,,44,57,101
HND-003324,2011,41100002,,,,2,6,8
HND-003342,2011,41100022,,,,14,19,33
,2011,41100030,,,,34,51,85
HND-003342,2011,41100022,,,,8,22,30
,2011,41100030,,,,25,49,74
HND-003324,2011,41100002,,,,6,10,16
HND-003342,2011,41100022,,,,15,16,31
,2011,41100030,,,,71,87,158
HND-003342,2011,41100022,,,,5,10,15
,2011,41100030,,,,64,74,138
HND-003342,2011,41100022,,,,13,17,30
,2011,41100030,,,,31,47,78
HND-003389,2011,41200062,,,,6,4,10
,2011,41200063,,,,4,6,10
HND-003390,2011,41200064,,,,4,7,11
HND-003391,2011,41200065,,,,9,3,12
HND-003392,2011,41200066,,,,4,5,9
,2011,41200072,,,,4,5,9
,2011,41200073,,,,7,5,12
,2011,41200077,,,,4,6,10
HND-003400,2011,41200099,,,,5,4,9
,2011,41200067,,,,5,7,12
,2011,41200070,,,,5,4,9
,2011,41200076,,,,9,3,12
,2011,41200078,,,,4,5,9
HND-003393,2011,41200079,,,,3,6,9
,2011,41200080,,,,5,4,9
,2011,41200081,,,,8,6,14
,2011,41200082,,,,7,3,10
HND-003394,2011,41200083,,,,7,3,10
,2011,41200084,,,,6,4,10
,2011,41200085,,,,6,4,10
,2011,41200086,,,,5,4,9
,2011,41200087,,,,6,4,10
,2011,41200088,,,,3,7,10
HND-003395,2011,41200089,,,,4,5,9
,2011,41200090,,,,4,5,9
,2011,41200092,,,,5,4,9
HND-003397,2011,41200093,,,,8,5,13
,2011,41200094,,,,5,4,9
HND-003398,2011,41200095,,,,6,4,10
HND-003399,2011,41200096,,,,8,7,15
,2011,41200097,,,,6,4,10
,2011,41200098,,,,4,5,9
HND-003379,2011,41200033,,,,10,8,18
HND-003388,2011,41200049,,,,6,4,10
HND-003374,2011,41200028,,,,5,5,10
HND-003377,2011,41200031,,,,4,5,9
HND-003378,2011,41200032,,,,4,8,12
HND-003380,2011,41200034,,,,2,6,8
HND-003381,2011,41200035,,,,4,9,13
HND-003387,2011,41200048,,,,6,4,10
HND-003374,2011,41200028,,,,10,12,22
HND-003377,2011,41200031,,,,8,9,17
HND-003378,2011,41200032,,,,10,6,16
HND-003379,2011,41200033,,,,16,16,32
HND-003380,2011,41200034,,,,9,18,27
HND-003382,2011,41200036,,,,5,5,10
HND-003387,2011,41200048,,,,2,2,4
HND-003388,2011,41200049,,,,2,3,5
,2011,41200074,,,,4,0,4
HND-003374,2011,41200028,,,,24,22,46
HND-003378,2011,41200032,,,,12,12,24
HND-003380,2011,41200034,,,,15,18,33
HND-003381,2011,41200035,,,,2,2,4
HND-003382,2011,41200036,,,,5,15,20
HND-003387,2011,41200048,,,,1,5,6
HND-003388,2011,41200049,,,,4,4,8
,2011,41200074,,,,4,3,7
HND-003377,2011,41200031,,,,9,15,24
HND-003379,2011,41200033,,,,19,18,37
HND-003354,2011,41200005,,,,12,19,31
HND-003357,2011,41200009,,,,19,23,42
HND-003359,2011,41200011,,,,14,17,31
HND-003360,2011,41200012,,,,14,7,21
HND-003361,2011,41200013,,,,3,4,7
HND-003364,2011,41200017,,,,5,1,6
HND-003367,2011,41200020,,,,10,5,15
HND-003369,2011,41200022,,,,3,3,6
,2011,41200024,,,,2,0,2
HND-003371,2011,41200025,,,,6,3,9
HND-003372,2011,41200026,,,,1,7,8
HND-003375,2011,41200029,,,,9,6,15
HND-003383,2011,41200037,,,,3,2,5
HND-003386,2011,41200047,,,,6,1,7
,2011,41200074,,,,6,4,10
HND-003396,2011,41200091,,,,0,3,3
HND-003402,2011,41200101,,,,10,6,16
HND-003350,2011,41200001,,,,10,5,15
HND-003351,2011,41200002,,,,4,2,6
HND-003352,2011,41200003,,,,3,5,8
HND-003353,2011,41200004,,,,15,4,19
HND-003355,2011,41200006,,,,22,17,39
HND-003356,2011,41200007,,,,8,13,21
HND-003358,2011,41200010,,,,15,14,29
HND-003362,2011,41200014,,,,9,4,13
HND-003363,2011,41200016,,,,3,5,8
HND-003365,2011,41200018,,,,3,2,5
HND-003366,2011,41200019,,,,4,4,8
HND-003368,2011,41200021,,,,1,3,4
HND-003370,2011,41200023,,,,3,5,8
HND-003373,2011,41200027,,,,24,20,44
HND-003376,2011,41200030,,,,6,4,10
HND-003384,2011,41200045,,,,2,6,8
HND-003401,2011,41200100,,,,6,3,9
HND-003351,2011,41200002,,,,4,1,5
HND-003352,2011,41200003,,,,2,4,6
HND-003353,2011,41200004,,,,4,3,7
HND-003354,2011,41200005,,,,14,10,24
HND-003355,2011,41200006,,,,15,16,31
HND-003357,2011,41200009,,,,11,16,27
HND-003367,2011,41200020,,,,2,1,3
HND-003368,2011,41200021,,,,2,3,5
HND-003369,2011,41200022,,,,3,3,6
HND-003370,2011,41200023,,,,2,1,3
,2011,41200024,,,,2,0,2
HND-003371,2011,41200025,,,,1,5,6
HND-003372,2011,41200026,,,,4,5,9
HND-003376,2011,41200030,,,,2,2,4
HND-003384,2011,41200045,,,,2,4,6
HND-003385,2011,41200046,,,,1,4,5
HND-003386,2011,41200047,,,,1,5,6
,2011,41200074,,,,0,5,5
HND-003396,2011,41200091,,,,0,2,2
HND-003401,2011,41200100,,,,2,1,3
HND-003402,2011,41200101,,,,0,3,3
HND-003350,2011,41200001,,,,7,4,11
HND-003356,2011,41200007,,,,9,9,18
HND-003358,2011,41200010,,,,13,11,24
HND-003359,2011,41200011,,,,23,11,34
HND-003360,2011,41200012,,,,5,12,17
HND-003361,2011,41200013,,,,5,2,7
HND-003362,2011,41200014,,,,3,5,8
HND-003363,2011,41200016,,,,4,2,6
HND-003364,2011,41200017,,,,3,1,4
HND-003365,2011,41200018,,,,2,2,4
HND-003366,2011,41200019,,,,5,3,8
HND-003373,2011,41200027,,,,30,17,47
HND-003375,2011,41200029,,,,7,1,8
HND-003354,2011,41200005,,,,19,9,28
HND-003355,2011,41200006,,,,28,26,54
HND-003357,2011,41200009,,,,16,12,28
HND-003359,2011,41200011,,,,17,25,42
HND-003360,2011,41200012,,,,9,9,18
HND-003361,2011,41200013,,,,7,1,8
HND-003364,2011,41200017,,,,0,2,2
HND-003367,2011,41200020,,,,3,3,6
HND-003369,2011,41200022,,,,3,2,5
,2011,41200024,,,,3,0,3
HND-003371,2011,41200025,,,,6,2,8
HND-003372,2011,41200026,,,,3,5,8
HND-003375,2011,41200029,,,,8,3,11
HND-003376,2011,41200030,,,,6,2,8
HND-003384,2011,41200045,,,,2,3,5
HND-003385,2011,41200046,,,,3,3,6
HND-003396,2011,41200091,,,,3,3,6
HND-003401,2011,41200100,,,,0,1,1
HND-003350,2011,41200001,,,,4,1,5
HND-003351,2011,41200002,,,,1,2,3
HND-003352,2011,41200003,,,,0,2,2
HND-003353,2011,41200004,,,,7,7,14
HND-003356,2011,41200007,,,,13,7,20
HND-003358,2011,41200010,,,,21,8,29
HND-003362,2011,41200014,,,,8,4,12
HND-003363,2011,41200016,,,,3,8,11
HND-003365,2011,41200018,,,,3,2,5
HND-003366,2011,41200019,,,,1,4,5
HND-003368,2011,41200021,,,,2,3,5
HND-003370,2011,41200023,,,,0,3,3
HND-003373,2011,41200027,,,,21,16,37
HND-003383,2011,41200037,,,,7,1,8
HND-003386,2011,41200047,,,,6,2,8
,2011,41200074,,,,3,3,6
HND-003402,2011,41200101,,,,1,4,5
HND-003350,2011,41200001,,,,7,7,14
HND-003351,2011,41200002,,,,3,5,8
HND-003352,2011,41200003,,,,0,4,4
HND-003353,2011,41200004,,,,1,6,7
HND-003354,2011,41200005,,,,20,10,30
HND-003355,2011,41200006,,,,19,18,37
HND-003356,2011,41200007,,,,6,3,9
HND-003366,2011,41200019,,,,6,6,12
HND-003368,2011,41200021,,,,2,2,4
HND-003369,2011,41200022,,,,1,4,5
HND-003370,2011,41200023,,,,3,3,6
,2011,41200024,,,,2,0,2
HND-003372,2011,41200026,,,,5,1,6
HND-003376,2011,41200030,,,,1,6,7
HND-003383,2011,41200037,,,,4,2,6
HND-003384,2011,41200045,,,,2,0,2
HND-003385,2011,41200046,,,,5,3,8
HND-003386,2011,41200047,,,,1,2,3
,2011,41200074,,,,3,3,6
HND-003396,2011,41200091,,,,1,3,4
HND-003401,2011,41200100,,,,1,0,1
HND-003357,2011,41200009,,,,8,15,23
HND-003358,2011,41200010,,,,16,19,35
HND-003359,2011,41200011,,,,18,16,34
HND-003360,2011,41200012,,,,10,13,23
HND-003361,2011,41200013,,,,1,2,3
HND-003362,2011,41200014,,,,4,9,13
HND-003363,2011,41200016,,,,5,3,8
HND-003364,2011,41200017,,,,2,2,4
HND-003365,2011,41200018,,,,2,1,3
HND-003367,2011,41200020,,,,5,2,7
HND-003371,2011,41200025,,,,6,5,11
HND-003373,2011,41200027,,,,22,18,40
HND-003375,2011,41200029,,,,5,2,7
HND-003350,2011,41200001,,,,6,2,8
HND-003351,2011,41200002,,,,0,1,1
HND-003352,2011,41200003,,,,4,1,5
HND-003353,2011,41200004,,,,3,1,4
HND-003355,2011,41200006,,,,15,9,24
HND-003356,2011,41200007,,,,8,8,16
HND-003358,2011,41200010,,,,8,14,22
HND-003365,2011,41200018,,,,2,2,4
HND-003366,2011,41200019,,,,3,2,5
HND-003368,2011,41200021,,,,4,2,6
HND-003369,2011,41200022,,,,3,1,4
HND-003376,2011,41200030,,,,5,3,8
HND-003383,2011,41200037,,,,3,4,7
HND-003385,2011,41200046,,,,1,2,3
HND-003386,2011,41200047,,,,4,2,6
HND-003396,2011,41200091,,,,3,4,7
HND-003354,2011,41200005,,,,14,8,22
HND-003357,2011,41200009,,,,15,14,29
HND-003359,2011,41200011,,,,11,14,25
HND-003360,2011,41200012,,,,9,4,13
HND-003361,2011,41200013,,,,2,4,6
HND-003362,2011,41200014,,,,18,4,22
HND-003363,2011,41200016,,,,3,3,6
HND-003364,2011,41200017,,,,2,1,3
HND-003367,2011,41200020,,,,3,4,7
,2011,41200024,,,,2,1,3
HND-003371,2011,41200025,,,,5,2,7
HND-003372,2011,41200026,,,,3,3,6
HND-003373,2011,41200027,,,,18,16,34
HND-003375,2011,41200029,,,,3,3,6
HND-003401,2011,41200100,,,,0,3,3
HND-003350,2011,41200001,,,,4,1,5
HND-003356,2011,41200007,,,,3,7,10
HND-003358,2011,41200010,,,,9,15,24
HND-003359,2011,41200011,,,,22,15,37
HND-003360,2011,41200012,,,,6,11,17
HND-003361,2011,41200013,,,,1,5,6
HND-003362,2011,41200014,,,,7,8,15
HND-003363,2011,41200016,,,,5,2,7
HND-003364,2011,41200017,,,,1,0,1
HND-003365,2011,41200018,,,,0,3,3
HND-003366,2011,41200019,,,,3,3,6
HND-003373,2011,41200027,,,,22,12,34
HND-003375,2011,41200029,,,,6,1,7
HND-003383,2011,41200037,,,,1,2,3
HND-003352,2011,41200003,,,,3,2,5
HND-003353,2011,41200004,,,,0,1,1
HND-003354,2011,41200005,,,,6,12,18
HND-003355,2011,41200006,,,,16,7,23
HND-003357,2011,41200009,,,,10,16,26
HND-003367,2011,41200020,,,,1,2,3
HND-003368,2011,41200021,,,,2,0,2
HND-003369,2011,41200022,,,,1,2,3
HND-003370,2011,41200023,,,,3,2,5
,2011,41200024,,,,1,3,4
HND-003371,2011,41200025,,,,1,3,4
HND-003372,2011,41200026,,,,3,3,6
HND-003376,2011,41200030,,,,0,6,6
HND-003385,2011,41200046,,,,0,1,1
HND-003386,2011,41200047,,,,4,1,5
HND-003396,2011,41200091,,,,3,0,3
HND-003358,2011,41200010,,,,19,12,31
HND-003373,2011,41200027,,,,33,31,64
HND-003358,2011,41200010,,,,12,12,24
HND-003373,2011,41200027,,,,16,27,43
HND-003358,2011,41200010,,,,10,13,23
HND-003373,2011,41200027,,,,22,23,45
HND-003450,2011,41300065,,,,7,4,11
HND-003453,2011,41300069,,,,3,6,9
,2011,41300097,,,,5,9,14
,2011,41300105,,,,6,4,10
HND-003456,2011,41300106,,,,4,6,10
,2011,41300107,,,,5,5,10
HND-003457,2011,41300108,,,,9,2,11
HND-003458,2011,41300112,,,,4,5,9
HND-003459,2011,41300113,,,,2,9,11
,2011,41300114,,,,7,4,11
HND-003460,2011,41300115,,,,4,8,12
HND-003461,2011,41300118,,,,8,3,11
HND-003462,2011,41300119,,,,4,5,9
,2011,41300123,,,,6,4,10
,2011,41300125,,,,5,5,10
HND-003465,2011,41300126,,,,6,3,9
HND-003451,2011,41300067,,,,5,10,15
,2011,41300071,,,,7,3,10
,2011,41300109,,,,3,5,8
,2011,41300110,,,,5,4,9
,2011,41300111,,,,4,5,9
,2011,41300121,,,,7,5,12
HND-003463,2011,41300122,,,,5,5,10
HND-003464,2011,41300124,,,,6,4,10
,2011,41300059,,,,38,32,70
,2011,41300025,,,,10,6,16
HND-003432,2011,41300034,,,,8,14,22
HND-003434,2011,41300036,,,,4,4,8
HND-003435,2011,41300037,,,,8,7,15
HND-003436,2011,41300038,,,,11,16,27
HND-003439,2011,41300043,,,,9,1,10
HND-003441,2011,41300045,,,,2,3,5
HND-003443,2011,41300049,,,,6,4,10
,2011,41300072,,,,2,2,4
,2011,41300120,,,,4,1,5
HND-003438,2011,41300041,,,,1,3,4
,2011,41300042,,,,2,7,9
HND-003440,2011,41300044,,,,1,5,6
HND-003442,2011,41300046,,,,1,12,13
HND-003445,2011,41300055,,,,3,3,6
,2011,41300059,,,,48,22,70
HND-003452,2011,41300068,,,,10,16,26
HND-003454,2011,41300073,,,,17,13,30
,2011,41300025,,,,4,6,10
HND-003431,2011,41300033,,,,34,21,55
HND-003433,2011,41300035,,,,19,14,33
HND-003438,2011,41300041,,,,11,10,21
,2011,41300042,,,,14,12,26
HND-003439,2011,41300043,,,,25,17,42
HND-003442,2011,41300046,,,,31,32,63
HND-003447,2011,41300058,,,,17,13,30
HND-003454,2011,41300073,,,,25,45,70
HND-003432,2011,41300034,,,,22,14,36
HND-003434,2011,41300036,,,,29,15,44
HND-003435,2011,41300037,,,,29,26,55
HND-003436,2011,41300038,,,,28,17,45
HND-003440,2011,41300044,,,,10,13,23
HND-003441,2011,41300045,,,,7,11,18
HND-003443,2011,41300049,,,,8,4,12
HND-003445,2011,41300055,,,,11,6,17
,2011,41300059,,,,38,33,71
HND-003452,2011,41300068,,,,29,33,62
,2011,41300072,,,,8,5,13
,2011,41300120,,,,4,0,4
HND-003405,2011,41300002,,,,49,29,78
HND-003406,2011,41300003,,,,17,16,33
HND-003407,2011,41300004,,,,4,3,7
HND-003409,2011,41300006,,,,15,14,29
HND-003411,2011,41300008,,,,72,71,143
HND-003413,2011,41300010,,,,41,34,75
HND-003414,2011,41300011,,,,12,12,24
HND-003415,2011,41300012,,,,9,7,16
HND-003416,2011,41300013,,,,10,10,20
HND-003417,2011,41300015,,,,39,39,78
HND-003418,2011,41300016,,,,28,36,64
HND-003419,2011,41300017,,,,13,9,22
HND-003421,2011,41300019,,,,2,5,7
HND-003422,2011,41300020,,,,56,46,102
HND-003423,2011,41300021,,,,10,10,20
HND-003424,2011,41300022,,,,2,2,4
HND-003425,2011,41300023,,,,2,4,6
,2011,41300025,,,,5,5,10
,2011,41300031,,,,8,5,13
HND-003430,2011,41300032,,,,7,3,10
HND-003439,2011,41300043,,,,26,24,50
,2011,41300054,,,,12,8,20
,2011,41300072,,,,9,3,12
HND-003455,2011,41300104,,,,2,5,7
,2011,41300120,,,,1,1,2
HND-003404,2011,41300001,,,,28,31,59
HND-003408,2011,41300005,,,,14,14,28
HND-003410,2011,41300007,,,,39,36,75
HND-003412,2011,41300009,,,,6,4,10
HND-003420,2011,41300018,,,,7,10,17
HND-003426,2011,41300024,,,,9,6,15
HND-003428,2011,41300029,,,,2,1,3
HND-003429,2011,41300030,,,,8,6,14
HND-003448,2011,41300060,,,,5,2,7
HND-003449,2011,41300062,,,,6,1,7
,2011,41300092,,,,23,15,38
HND-003404,2011,41300001,,,,34,19,53
HND-003406,2011,41300003,,,,16,13,29
HND-003410,2011,41300007,,,,34,28,62
HND-003411,2011,41300008,,,,81,82,163
HND-003413,2011,41300010,,,,42,31,73
HND-003414,2011,41300011,,,,13,7,20
HND-003416,2011,41300013,,,,9,14,23
HND-003417,2011,41300015,,,,26,34,60
HND-003419,2011,41300017,,,,11,6,17
HND-003421,2011,41300019,,,,6,3,9
HND-003422,2011,41300020,,,,35,39,74
HND-003423,2011,41300021,,,,7,7,14
HND-003425,2011,41300023,,,,5,3,8
HND-003426,2011,41300024,,,,1,4,5
,2011,41300025,,,,8,9,17
HND-003429,2011,41300030,,,,1,3,4
,2011,41300031,,,,2,7,9
HND-003430,2011,41300032,,,,4,6,10
HND-003439,2011,41300043,,,,18,18,36
,2011,41300054,,,,12,7,19
HND-003448,2011,41300060,,,,2,3,5
HND-003405,2011,41300002,,,,37,35,72
HND-003407,2011,41300004,,,,5,4,9
HND-003408,2011,41300005,,,,13,21,34
HND-003409,2011,41300006,,,,16,16,32
HND-003412,2011,41300009,,,,4,3,7
HND-003415,2011,41300012,,,,8,1,9
HND-003418,2011,41300016,,,,18,24,42
HND-003420,2011,41300018,,,,7,7,14
HND-003424,2011,41300022,,,,2,3,5
HND-003428,2011,41300029,,,,1,1,2
HND-003449,2011,41300062,,,,1,0,1
,2011,41300072,,,,4,9,13
,2011,41300092,,,,16,16,32
HND-003455,2011,41300104,,,,3,0,3
,2011,41300120,,,,3,0,3
HND-003405,2011,41300002,,,,45,39,84
HND-003406,2011,41300003,,,,23,17,40
HND-003407,2011,41300004,,,,2,2,4
HND-003409,2011,41300006,,,,21,18,39
HND-003411,2011,41300008,,,,61,45,106
HND-003413,2011,41300010,,,,33,30,63
HND-003414,2011,41300011,,,,6,6,12
HND-003415,2011,41300012,,,,8,5,13
HND-003416,2011,41300013,,,,11,13,24
HND-003417,2011,41300015,,,,37,26,63
HND-003418,2011,41300016,,,,23,27,50
HND-003419,2011,41300017,,,,12,15,27
HND-003421,2011,41300019,,,,2,0,2
HND-003422,2011,41300020,,,,43,39,82
HND-003423,2011,41300021,,,,8,7,15
HND-003424,2011,41300022,,,,3,0,3
HND-003425,2011,41300023,,,,1,1,2
HND-003426,2011,41300024,,,,2,5,7
,2011,41300025,,,,3,4,7
HND-003429,2011,41300030,,,,0,2,2
,2011,41300092,,,,12,15,27
HND-003404,2011,41300001,,,,19,21,40
HND-003408,2011,41300005,,,,11,12,23
HND-003410,2011,41300007,,,,29,29,58
HND-003412,2011,41300009,,,,2,0,2
HND-003420,2011,41300018,,,,9,6,15
HND-003428,2011,41300029,,,,2,2,4
,2011,41300031,,,,8,3,11
HND-003430,2011,41300032,,,,2,5,7
HND-003439,2011,41300043,,,,27,30,57
,2011,41300054,,,,10,16,26
HND-003448,2011,41300060,,,,2,3,5
HND-003449,2011,41300062,,,,3,1,4
,2011,41300072,,,,1,4,5
HND-003455,2011,41300104,,,,4,4,8
,2011,41300120,,,,0,3,3
HND-003404,2011,41300001,,,,19,16,35
HND-003410,2011,41300007,,,,24,44,68
HND-003411,2011,41300008,,,,76,53,129
HND-003417,2011,41300015,,,,36,30,66
HND-003422,2011,41300020,,,,48,37,85
HND-003426,2011,41300024,,,,2,1,3
HND-003429,2011,41300030,,,,2,2,4
,2011,41300031,,,,2,1,3
HND-003430,2011,41300032,,,,1,1,2
HND-003439,2011,41300043,,,,14,28,42
,2011,41300054,,,,16,4,20
HND-003448,2011,41300060,,,,2,0,2
HND-003449,2011,41300062,,,,0,1,1
,2011,41300072,,,,13,6,19
HND-003455,2011,41300104,,,,3,1,4
,2011,41300120,,,,2,1,3
HND-003405,2011,41300002,,,,36,22,58
HND-003406,2011,41300003,,,,15,18,33
HND-003407,2011,41300004,,,,3,4,7
HND-003408,2011,41300005,,,,8,10,18
HND-003409,2011,41300006,,,,21,11,32
HND-003412,2011,41300009,,,,2,3,5
HND-003413,2011,41300010,,,,40,40,80
HND-003414,2011,41300011,,,,13,9,22
HND-003415,2011,41300012,,,,7,3,10
HND-003416,2011,41300013,,,,15,5,20
HND-003418,2011,41300016,,,,20,17,37
HND-003419,2011,41300017,,,,7,13,20
HND-003420,2011,41300018,,,,8,10,18
HND-003421,2011,41300019,,,,9,4,13
HND-003423,2011,41300021,,,,11,5,16
HND-003424,2011,41300022,,,,2,1,3
HND-003425,2011,41300023,,,,0,4,4
,2011,41300025,,,,5,18,23
HND-003428,2011,41300029,,,,1,3,4
,2011,41300092,,,,14,19,33
HND-003404,2011,41300001,,,,27,23,50
HND-003410,2011,41300007,,,,34,37,71
HND-003412,2011,41300009,,,,0,2,2
HND-003426,2011,41300024,,,,2,1,3
HND-003428,2011,41300029,,,,5,5,10
,2011,41300031,,,,2,4,6
HND-003430,2011,41300032,,,,1,2,3
HND-003439,2011,41300043,,,,14,17,31
,2011,41300054,,,,7,8,15
HND-003448,2011,41300060,,,,0,1,1
HND-003449,2011,41300062,,,,0,1,1
,2011,41300072,,,,5,4,9
,2011,41300120,,,,1,2,3
HND-003405,2011,41300002,,,,30,27,57
HND-003406,2011,41300003,,,,15,15,30
HND-003407,2011,41300004,,,,3,2,5
HND-003408,2011,41300005,,,,7,6,13
HND-003409,2011,41300006,,,,21,15,36
HND-003411,2011,41300008,,,,72,80,152
HND-003413,2011,41300010,,,,30,43,73
HND-003414,2011,41300011,,,,5,8,13
HND-003415,2011,41300012,,,,4,8,12
HND-003416,2011,41300013,,,,13,10,23
HND-003417,2011,41300015,,,,28,34,62
HND-003418,2011,41300016,,,,22,27,49
HND-003419,2011,41300017,,,,4,3,7
HND-003420,2011,41300018,,,,9,10,19
HND-003421,2011,41300019,,,,7,3,10
HND-003422,2011,41300020,,,,38,33,71
HND-003423,2011,41300021,,,,15,11,26
HND-003424,2011,41300022,,,,3,2,5
HND-003425,2011,41300023,,,,2,1,3
,2011,41300025,,,,8,5,13
HND-003429,2011,41300030,,,,1,0,1
,2011,41300092,,,,11,10,21
HND-003455,2011,41300104,,,,0,2,2
HND-003405,2011,41300002,,,,44,24,68
HND-003407,2011,41300004,,,,3,4,7
HND-003408,2011,41300005,,,,6,10,16
HND-003409,2011,41300006,,,,13,13,26
HND-003412,2011,41300009,,,,1,1,2
HND-003415,2011,41300012,,,,5,7,12
HND-003418,2011,41300016,,,,13,17,30
HND-003420,2011,41300018,,,,3,11,14
HND-003424,2011,41300022,,,,4,6,10
HND-003428,2011,41300029,,,,4,2,6
HND-003449,2011,41300062,,,,1,2,3
,2011,41300072,,,,11,3,14
,2011,41300092,,,,11,11,22
HND-003404,2011,41300001,,,,21,15,36
HND-003406,2011,41300003,,,,21,14,35
HND-003410,2011,41300007,,,,38,19,57
HND-003411,2011,41300008,,,,70,68,138
HND-003413,2011,41300010,,,,38,23,61
HND-003414,2011,41300011,,,,6,9,15
HND-003416,2011,41300013,,,,11,8,19
HND-003417,2011,41300015,,,,16,29,45
HND-003419,2011,41300017,,,,7,5,12
HND-003421,2011,41300019,,,,2,0,2
HND-003422,2011,41300020,,,,35,29,64
HND-003423,2011,41300021,,,,0,5,5
HND-003425,2011,41300023,,,,2,1,3
HND-003426,2011,41300024,,,,1,1,2
,2011,41300025,,,,9,12,21
HND-003429,2011,41300030,,,,1,1,2
,2011,41300031,,,,5,3,8
HND-003430,2011,41300032,,,,1,0,1
HND-003439,2011,41300043,,,,12,22,34
,2011,41300054,,,,7,8,15
HND-003448,2011,41300060,,,,2,1,3
HND-003455,2011,41300104,,,,1,3,4
,2011,41300120,,,,1,5,6
HND-003405,2011,41300002,,,,15,15,30
HND-003406,2011,41300003,,,,10,11,21
HND-003418,2011,41300016,,,,14,13,27
,2011,41300047,,,,11,11,22
HND-003444,2011,41300050,,,,211,227,438
,2011,41300054,,,,12,17,29
,2011,41300051,,,,10,13,23
,2011,41300052,,,,17,6,23
,2011,41300072,,,,5,4,9
,2011,41300116,,,,435,483,918
,2011,41300120,,,,1,3,4
HND-003406,2011,41300003,,,,6,10,16
,2011,41300047,,,,8,6,14
HND-003444,2011,41300050,,,,122,163,285
,2011,41300051,,,,4,9,13
,2011,41300052,,,,13,14,27
,2011,41300054,,,,12,10,22
,2011,41300072,,,,4,4,8
,2011,41300120,,,,1,1,2
HND-003405,2011,41300002,,,,6,11,17
HND-003418,2011,41300016,,,,14,9,23
,2011,41300116,,,,281,377,658
,2011,41300051,,,,15,10,25
,2011,41300072,,,,5,3,8
,2011,41300120,,,,0,1,1
HND-003405,2011,41300002,,,,6,6,12
HND-003406,2011,41300003,,,,7,7,14
HND-003418,2011,41300016,,,,13,14,27
,2011,41300047,,,,11,16,27
HND-003444,2011,41300050,,,,105,169,274
,2011,41300052,,,,12,10,22
,2011,41300054,,,,15,22,37
,2011,41300116,,,,214,290,504
,2011,41300047,,,,11,7,18
HND-003444,2011,41300050,,,,117,178,295
,2011,41300051,,,,57,78,135
,2011,41300052,,,,40,44,84
,2011,41300054,,,,9,9,18
,2011,41300116,,,,217,246,463
,2011,41300047,,,,4,3,7
HND-003444,2011,41300050,,,,77,133,210
,2011,41300051,,,,39,52,91
,2011,41300052,,,,28,56,84
,2011,41300054,,,,8,14,22
,2011,41300116,,,,100,142,242
HND-003444,2011,41300050,,,,41,111,152
,2011,41300051,,,,26,65,91
,2011,41300052,,,,18,57,75
HND-003472,2011,41400007,,,,5,3,8
HND-003473,2011,41400008,,,,4,5,9
HND-003478,2011,41400028,,,,3,3,6
HND-003480,2011,41400047,,,,2,8,10
HND-003482,2011,41400049,,,,2,6,8
HND-003483,2011,41400050,,,,3,7,10
HND-003485,2011,41400053,,,,4,1,5
HND-003489,2011,41400057,,,,8,7,15
HND-003490,2011,41400058,,,,6,5,11
HND-003477,2011,41400015,,,,4,6,10
HND-003481,2011,41400048,,,,4,5,9
HND-003484,2011,41400052,,,,2,2,4
HND-003491,2011,41400059,,,,2,4,6
HND-003470,2011,41400005,,,,1,5,6
HND-003471,2011,41400006,,,,3,3,6
HND-003475,2011,41400010,,,,3,2,5
HND-003476,2011,41400011,,,,3,8,11
HND-003471,2011,41400006,,,,4,1,5
HND-003470,2011,41400005,,,,9,15,24
HND-003475,2011,41400010,,,,3,3,6
HND-003476,2011,41400011,,,,6,4,10
HND-003470,2011,41400005,,,,16,18,34
HND-003471,2011,41400006,,,,3,2,5
HND-003475,2011,41400010,,,,4,5,9
HND-003476,2011,41400011,,,,2,7,9
HND-003469,2011,41400004,,,,7,16,23
HND-003471,2011,41400006,,,,3,1,4
HND-003479,2011,41400046,,,,0,3,3
HND-003486,2011,41400054,,,,7,6,13
HND-003487,2011,41400055,,,,1,3,4
HND-003488,2011,41400056,,,,7,9,16
HND-003466,2011,41400001,,,,9,8,17
HND-003467,2011,41400002,,,,33,39,72
HND-003468,2011,41400003,,,,10,4,14
HND-003466,2011,41400001,,,,8,7,15
HND-003468,2011,41400003,,,,1,6,7
HND-003469,2011,41400004,,,,2,12,14
HND-003471,2011,41400006,,,,3,5,8
HND-003467,2011,41400002,,,,22,39,61
HND-003479,2011,41400046,,,,4,2,6
HND-003486,2011,41400054,,,,12,4,16
HND-003487,2011,41400055,,,,6,4,10
HND-003488,2011,41400056,,,,2,4,6
HND-003469,2011,41400004,,,,4,6,10
HND-003471,2011,41400006,,,,6,3,9
HND-003466,2011,41400001,,,,4,4,8
HND-003467,2011,41400002,,,,13,22,35
HND-003468,2011,41400003,,,,5,5,10
HND-003479,2011,41400046,,,,0,3,3
HND-003486,2011,41400054,,,,5,3,8
HND-003487,2011,41400055,,,,1,0,1
HND-003488,2011,41400056,,,,2,3,5
HND-003466,2011,41400001,,,,9,9,18
HND-003468,2011,41400003,,,,6,3,9
HND-003469,2011,41400004,,,,2,5,7
HND-003471,2011,41400006,,,,6,1,7
HND-003487,2011,41400055,,,,1,0,1
HND-003467,2011,41400002,,,,22,40,62
HND-003479,2011,41400046,,,,1,0,1
HND-003486,2011,41400054,,,,12,4,16
HND-003488,2011,41400056,,,,0,2,2
HND-003466,2011,41400001,,,,5,4,9
HND-003467,2011,41400002,,,,19,13,32
HND-003468,2011,41400003,,,,2,5,7
HND-003486,2011,41400054,,,,3,8,11
HND-003487,2011,41400055,,,,0,1,1
HND-003488,2011,41400056,,,,0,1,1
HND-003469,2011,41400004,,,,3,5,8
HND-003479,2011,41400046,,,,1,4,5
HND-003467,2011,41400002,,,,18,17,35
HND-003486,2011,41400054,,,,1,1,2
HND-003466,2011,41400001,,,,5,5,10
HND-003468,2011,41400003,,,,2,2,4
HND-003469,2011,41400004,,,,6,7,13
HND-003467,2011,41400002,,,,11,22,33
HND-003467,2011,41400002,,,,4,9,13
HND-003467,2011,41400002,,,,4,19,23
HND-003524,2011,41500040,,,,5,6,11
,2011,41500065,,,,1,11,12
,2011,41500068,,,,5,4,9
,2011,41500069,,,,3,6,9
HND-003529,2011,41500070,,,,5,5,10
HND-003530,2011,41500075,,,,4,4,8
HND-003531,2011,41500076,,,,4,6,10
,2011,41500078,,,,4,8,12
,2011,41500079,,,,6,5,11
,2011,41500080,,,,6,4,10
HND-003536,2011,41500086,,,,6,4,10
,2011,41500087,,,,2,9,11
,2011,41500088,,,,5,5,10
HND-003525,2011,41500062,,,,6,4,10
HND-003527,2011,41500064,,,,7,3,10
,2011,41500066,,,,5,5,10
HND-003528,2011,41500067,,,,6,5,11
,2011,41500071,,,,9,7,16
,2011,41500072,,,,3,6,9
,2011,41500073,,,,4,8,12
,2011,41500077,,,,2,10,12
,2011,41500089,,,,6,5,11
HND-003511,2011,41500021,,,,2,4,6
HND-003513,2011,41500023,,,,2,4,6
HND-003516,2011,41500026,,,,16,11,27
HND-003522,2011,41500035,,,,2,8,10
HND-003512,2011,41500022,,,,4,6,10
HND-003514,2011,41500024,,,,3,3,6
HND-003515,2011,41500025,,,,4,5,9
,2011,41500061,,,,5,7,12
,2011,41500083,,,,5,6,11
HND-003534,2011,41500084,,,,4,10,14
HND-003511,2011,41500021,,,,6,3,9
HND-003512,2011,41500022,,,,11,10,21
HND-003513,2011,41500023,,,,7,16,23
HND-003514,2011,41500024,,,,9,7,16
HND-003515,2011,41500025,,,,4,10,14
HND-003517,2011,41500027,,,,10,8,18
HND-003522,2011,41500035,,,,2,4,6
HND-003516,2011,41500026,,,,14,22,36
,2011,41500061,,,,2,4,6
,2011,41500083,,,,2,6,8
HND-003534,2011,41500084,,,,2,5,7
HND-003494,2011,41500002,,,,9,12,21
HND-003495,2011,41500003,,,,16,9,25
HND-003496,2011,41500004,,,,16,15,31
HND-003502,2011,41500011,,,,1,1,2
HND-003533,2011,41500082,,,,3,4,7
HND-003493,2011,41500001,,,,31,25,56
HND-003497,2011,41500005,,,,1,6,7
HND-003498,2011,41500006,,,,8,2,10
HND-003499,2011,41500008,,,,17,17,34
HND-003500,2011,41500009,,,,7,12,19
HND-003501,2011,41500010,,,,8,4,12
HND-003503,2011,41500012,,,,6,5,11
HND-003504,2011,41500013,,,,23,19,42
HND-003505,2011,41500014,,,,5,5,10
HND-003506,2011,41500015,,,,12,13,25
HND-003507,2011,41500016,,,,1,5,6
HND-003508,2011,41500017,,,,4,2,6
HND-003509,2011,41500018,,,,4,2,6
HND-003510,2011,41500019,,,,17,15,32
HND-003518,2011,41500028,,,,9,3,12
HND-003519,2011,41500031,,,,5,8,13
HND-003520,2011,41500032,,,,1,3,4
HND-003521,2011,41500034,,,,4,4,8
HND-003535,2011,41500085,,,,3,4,7
HND-003494,2011,41500002,,,,13,5,18
HND-003495,2011,41500003,,,,16,15,31
HND-003496,2011,41500004,,,,18,7,25
HND-003497,2011,41500005,,,,1,1,2
HND-003498,2011,41500006,,,,6,4,10
HND-003499,2011,41500008,,,,16,19,35
HND-003500,2011,41500009,,,,7,12,19
HND-003502,2011,41500011,,,,1,4,5
HND-003503,2011,41500012,,,,10,3,13
HND-003504,2011,41500013,,,,19,11,30
HND-003505,2011,41500014,,,,9,3,12
HND-003507,2011,41500016,,,,1,2,3
HND-003508,2011,41500017,,,,0,1,1
HND-003518,2011,41500028,,,,3,6,9
HND-003519,2011,41500031,,,,1,1,2
HND-003520,2011,41500032,,,,4,3,7
HND-003521,2011,41500034,,,,2,0,2
HND-003493,2011,41500001,,,,23,29,52
HND-003506,2011,41500015,,,,2,3,5
HND-003510,2011,41500019,,,,8,23,31
HND-003533,2011,41500082,,,,0,1,1
HND-003535,2011,41500085,,,,0,3,3
HND-003493,2011,41500001,,,,25,15,40
HND-003496,2011,41500004,,,,17,14,31
HND-003497,2011,41500005,,,,2,1,3
HND-003498,2011,41500006,,,,3,5,8
HND-003499,2011,41500008,,,,10,7,17
HND-003500,2011,41500009,,,,9,12,21
HND-003501,2011,41500010,,,,3,1,4
HND-003503,2011,41500012,,,,7,5,12
HND-003504,2011,41500013,,,,21,14,35
HND-003505,2011,41500014,,,,5,3,8
HND-003506,2011,41500015,,,,3,3,6
HND-003507,2011,41500016,,,,1,2,3
HND-003508,2011,41500017,,,,0,1,1
HND-003509,2011,41500018,,,,6,0,6
HND-003510,2011,41500019,,,,8,13,21
HND-003518,2011,41500028,,,,0,4,4
HND-003521,2011,41500034,,,,5,3,8
HND-003533,2011,41500082,,,,5,2,7
HND-003494,2011,41500002,,,,12,8,20
HND-003495,2011,41500003,,,,21,19,40
HND-003519,2011,41500031,,,,3,1,4
HND-003520,2011,41500032,,,,3,2,5
HND-003535,2011,41500085,,,,4,0,4
HND-003494,2011,41500002,,,,5,6,11
HND-003495,2011,41500003,,,,12,14,26
HND-003496,2011,41500004,,,,16,16,32
HND-003497,2011,41500005,,,,1,2,3
HND-003498,2011,41500006,,,,2,3,5
HND-003499,2011,41500008,,,,16,16,32
HND-003502,2011,41500011,,,,0,1,1
HND-003503,2011,41500012,,,,1,2,3
HND-003504,2011,41500013,,,,15,10,25
HND-003508,2011,41500017,,,,1,2,3
HND-003519,2011,41500031,,,,0,2,2
HND-003520,2011,41500032,,,,1,3,4
HND-003521,2011,41500034,,,,7,2,9
HND-003535,2011,41500085,,,,7,6,13
HND-003493,2011,41500001,,,,21,30,51
HND-003500,2011,41500009,,,,19,8,27
HND-003501,2011,41500010,,,,3,2,5
HND-003505,2011,41500014,,,,3,5,8
HND-003506,2011,41500015,,,,2,2,4
HND-003507,2011,41500016,,,,2,1,3
HND-003509,2011,41500018,,,,3,1,4
HND-003510,2011,41500019,,,,13,10,23
HND-003533,2011,41500082,,,,5,0,5
HND-003494,2011,41500002,,,,5,17,22
HND-003495,2011,41500003,,,,15,20,35
HND-003496,2011,41500004,,,,9,13,22
HND-003498,2011,41500006,,,,2,3,5
HND-003504,2011,41500013,,,,17,18,35
HND-003508,2011,41500017,,,,2,0,2
HND-003519,2011,41500031,,,,1,1,2
HND-003520,2011,41500032,,,,1,0,1
HND-003521,2011,41500034,,,,4,1,5
HND-003535,2011,41500085,,,,1,0,1
HND-003493,2011,41500001,,,,26,21,47
HND-003497,2011,41500005,,,,3,2,5
HND-003499,2011,41500008,,,,7,7,14
HND-003500,2011,41500009,,,,5,11,16
HND-003501,2011,41500010,,,,0,2,2
HND-003503,2011,41500012,,,,7,5,12
HND-003505,2011,41500014,,,,2,2,4
HND-003506,2011,41500015,,,,3,3,6
HND-003507,2011,41500016,,,,3,2,5
HND-003509,2011,41500018,,,,5,8,13
HND-003510,2011,41500019,,,,13,7,20
HND-003493,2011,41500001,,,,25,32,57
HND-003501,2011,41500010,,,,3,2,5
HND-003506,2011,41500015,,,,1,3,4
HND-003510,2011,41500019,,,,10,10,20
HND-003519,2011,41500031,,,,1,0,1
HND-003494,2011,41500002,,,,14,9,23
HND-003495,2011,41500003,,,,8,10,18
HND-003496,2011,41500004,,,,14,15,29
HND-003497,2011,41500005,,,,3,0,3
HND-003498,2011,41500006,,,,4,0,4
HND-003499,2011,41500008,,,,6,6,12
HND-003500,2011,41500009,,,,9,10,19
HND-003503,2011,41500012,,,,4,1,5
HND-003504,2011,41500013,,,,12,12,24
HND-003505,2011,41500014,,,,2,2,4
HND-003507,2011,41500016,,,,0,1,1
HND-003508,2011,41500017,,,,1,1,2
HND-003521,2011,41500034,,,,3,3,6
HND-003495,2011,41500003,,,,15,20,35
HND-003493,2011,41500001,,,,27,23,50
HND-003510,2011,41500019,,,,6,9,15
HND-003495,2011,41500003,,,,9,11,20
HND-003493,2011,41500001,,,,24,25,49
HND-003510,2011,41500019,,,,2,8,10
HND-003495,2011,41500003,,,,6,8,14
HND-003493,2011,41500001,,,,23,26,49
HND-003510,2011,41500019,,,,3,9,12
HND-003552,2011,41600051,,,,5,5,10
,2011,41600054,,,,2,7,9
,2011,41600056,,,,4,9,13
,2011,41600058,,,,5,5,10
HND-003556,2011,41600061,,,,7,2,9
,2011,41600050,,,,7,3,10
HND-003553,2011,41600055,,,,3,8,11
HND-003555,2011,41600060,,,,4,6,10
HND-003557,2011,41600062,,,,4,5,9
HND-003547,2011,41600012,,,,1,3,4
HND-003547,2011,41600012,,,,4,4,8
HND-003549,2011,41600014,,,,6,4,10
HND-003550,2011,41600015,,,,5,6,11
HND-003551,2011,41600016,,,,4,5,9
HND-003548,2011,41600013,,,,6,8,14
HND-003548,2011,41600013,,,,14,13,27
HND-003550,2011,41600015,,,,10,9,19
HND-003547,2011,41600012,,,,4,4,8
HND-003549,2011,41600014,,,,8,4,12
HND-003551,2011,41600016,,,,6,7,13
HND-003539,2011,41600002,,,,9,6,15
HND-003540,2011,41600003,,,,21,9,30
HND-003541,2011,41600004,,,,19,11,30
HND-003543,2011,41600006,,,,8,5,13
HND-003544,2011,41600007,,,,6,6,12
HND-003546,2011,41600010,,,,2,3,5
HND-003538,2011,41600001,,,,12,20,32
HND-003542,2011,41600005,,,,1,1,2
,2011,41600008,,,,7,9,16
HND-003545,2011,41600009,,,,4,4,8
HND-003539,2011,41600002,,,,4,4,8
HND-003541,2011,41600004,,,,20,8,28
HND-003542,2011,41600005,,,,4,6,10
HND-003543,2011,41600006,,,,5,5,10
,2011,41600008,,,,3,3,6
HND-003545,2011,41600009,,,,2,3,5
HND-003546,2011,41600010,,,,2,0,2
HND-003538,2011,41600001,,,,19,6,25
HND-003540,2011,41600003,,,,8,13,21
HND-003544,2011,41600007,,,,2,4,6
HND-003538,2011,41600001,,,,18,12,30
HND-003542,2011,41600005,,,,3,1,4
HND-003543,2011,41600006,,,,9,4,13
,2011,41600008,,,,9,6,15
HND-003545,2011,41600009,,,,8,1,9
HND-003539,2011,41600002,,,,5,12,17
HND-003540,2011,41600003,,,,19,8,27
HND-003541,2011,41600004,,,,8,8,16
HND-003544,2011,41600007,,,,1,5,6
HND-003546,2011,41600010,,,,2,3,5
HND-003539,2011,41600002,,,,5,10,15
HND-003540,2011,41600003,,,,16,5,21
HND-003541,2011,41600004,,,,13,18,31
HND-003542,2011,41600005,,,,5,6,11
HND-003543,2011,41600006,,,,8,10,18
,2011,41600008,,,,5,2,7
HND-003545,2011,41600009,,,,5,3,8
HND-003538,2011,41600001,,,,20,11,31
HND-003539,2011,41600002,,,,8,8,16
HND-003540,2011,41600003,,,,10,9,19
HND-003541,2011,41600004,,,,10,14,24
HND-003542,2011,41600005,,,,0,4,4
HND-003543,2011,41600006,,,,0,3,3
HND-003544,2011,41600007,,,,3,0,3
,2011,41600008,,,,3,2,5
HND-003546,2011,41600010,,,,2,2,4
HND-003538,2011,41600001,,,,14,11,25
HND-003545,2011,41600009,,,,4,5,9
HND-003538,2011,41600001,,,,17,14,31
HND-003540,2011,41600003,,,,13,12,25
HND-003544,2011,41600007,,,,0,3,3
HND-003539,2011,41600002,,,,1,5,6
HND-003541,2011,41600004,,,,19,8,27
HND-003542,2011,41600005,,,,5,2,7
HND-003543,2011,41600006,,,,1,5,6
,2011,41600008,,,,1,3,4
HND-003545,2011,41600009,,,,0,1,1
HND-003546,2011,41600010,,,,1,0,1
HND-003538,2011,41600001,,,,19,12,31
HND-003538,2011,41600001,,,,20,13,33
HND-003538,2011,41600001,,,,15,14,29
,2011,41700032,,,,2,3,5
,2011,41700034,,,,0,3,3
,2011,41700035,,,,4,2,6
,2011,41700038,,,,4,5,9
,2011,41700039,,,,2,4,6
,2011,41700031,,,,4,2,6
HND-003572,2011,41700033,,,,6,3,9
,2011,41700036,,,,3,3,6
,2011,41700037,,,,0,3,3
,2011,41700040,,,,3,7,10
HND-003566,2011,41700010,,,,7,11,18
HND-003567,2011,41700011,,,,21,23,44
HND-003568,2011,41700012,,,,4,4,8
HND-003570,2011,41700014,,,,5,6,11
,2011,41700031,,,,3,5,8
,2011,41700001,,,,2,1,3
,2011,41700001,,,,6,5,11
HND-003566,2011,41700010,,,,9,6,15
HND-003567,2011,41700011,,,,21,22,43
HND-003568,2011,41700012,,,,15,12,27
HND-003570,2011,41700014,,,,7,7,14
,2011,41700031,,,,5,4,9
HND-003559,2011,41700003,,,,32,29,61
,2011,41700005,,,,19,7,26
HND-003564,2011,41700008,,,,4,4,8
HND-003565,2011,41700009,,,,1,1,2
HND-003558,2011,41700002,,,,19,15,34
HND-003560,2011,41700004,,,,4,3,7
HND-003562,2011,41700006,,,,8,7,15
HND-003563,2011,41700007,,,,3,4,7
HND-003559,2011,41700003,,,,31,21,52
HND-003563,2011,41700007,,,,9,4,13
HND-003558,2011,41700002,,,,11,17,28
HND-003560,2011,41700004,,,,3,4,7
,2011,41700005,,,,15,18,33
HND-003562,2011,41700006,,,,8,5,13
HND-003564,2011,41700008,,,,2,5,7
HND-003565,2011,41700009,,,,1,1,2
HND-003558,2011,41700002,,,,11,14,25
HND-003560,2011,41700004,,,,4,4,8
HND-003563,2011,41700007,,,,5,4,9
HND-003559,2011,41700003,,,,33,28,61
,2011,41700005,,,,10,24,34
HND-003562,2011,41700006,,,,8,7,15
HND-003564,2011,41700008,,,,3,2,5
HND-003565,2011,41700009,,,,4,7,11
HND-003559,2011,41700003,,,,38,26,64
HND-003558,2011,41700002,,,,19,19,38
HND-003560,2011,41700004,,,,3,3,6
,2011,41700005,,,,18,18,36
HND-003562,2011,41700006,,,,10,5,15
HND-003563,2011,41700007,,,,3,8,11
HND-003564,2011,41700008,,,,1,2,3
HND-003565,2011,41700009,,,,5,0,5
HND-003559,2011,41700003,,,,35,18,53
HND-003565,2011,41700009,,,,2,3,5
HND-003558,2011,41700002,,,,15,11,26
HND-003560,2011,41700004,,,,5,3,8
,2011,41700005,,,,20,12,32
HND-003562,2011,41700006,,,,9,11,20
HND-003563,2011,41700007,,,,7,3,10
HND-003564,2011,41700008,,,,0,5,5
HND-003558,2011,41700002,,,,20,20,40
HND-003560,2011,41700004,,,,7,5,12
,2011,41700005,,,,14,18,32
HND-003562,2011,41700006,,,,10,6,16
HND-003564,2011,41700008,,,,2,3,5
HND-003565,2011,41700009,,,,0,2,2
HND-003559,2011,41700003,,,,25,30,55
HND-003563,2011,41700007,,,,5,5,10
,2011,41700005,,,,14,7,21
HND-003569,2011,41700013,,,,32,43,75
HND-003558,2011,41700002,,,,22,15,37
HND-003558,2011,41700002,,,,22,17,39
,2011,41700005,,,,4,9,13
HND-003569,2011,41700013,,,,43,34,77
HND-003569,2011,41700013,,,,26,21,47
HND-003558,2011,41700002,,,,12,15,27
,2011,41700005,,,,1,14,15
HND-003569,2011,41700013,,,,29,18,47
HND-003569,2011,41700013,,,,28,17,45
HND-003569,2011,41700013,,,,14,12,26
HND-003587,2011,41800016,,,,4,9,13
HND-003589,2011,41800018,,,,6,9,15
HND-003600,2011,41800034,,,,2,9,11
HND-003601,2011,41800055,,,,3,6,9
,2011,41800058,,,,1,7,8
HND-003602,2011,41800060,,,,5,5,10
HND-003604,2011,41800062,,,,1,8,9
HND-003606,2011,41800064,,,,4,5,9
HND-003607,2011,41800065,,,,4,5,9
HND-003608,2011,41800067,,,,9,0,9
HND-003609,2011,41800068,,,,4,5,9
HND-003612,2011,41800072,,,,5,4,9
,2011,41800076,,,,5,5,10
HND-003622,2011,41800085,,,,4,6,10
,2011,41800087,,,,4,6,10
HND-003623,2011,41800088,,,,4,5,9
HND-003625,2011,41800090,,,,5,4,9
HND-003626,2011,41800091,,,,4,5,9
HND-003627,2011,41800092,,,,3,6,9
HND-003628,2011,41800093,,,,2,7,9
HND-003629,2011,41800094,,,,3,6,9
HND-003630,2011,41800095,,,,5,4,9
HND-003576,2011,41800005,,,,4,7,11
HND-003603,2011,41800061,,,,7,3,10
HND-003605,2011,41800063,,,,3,6,9
HND-003610,2011,41800069,,,,4,5,9
,2011,41800070,,,,5,4,9
,2011,41800073,,,,3,7,10
HND-003613,2011,41800074,,,,4,6,10
HND-003614,2011,41800075,,,,8,6,14
HND-003615,2011,41800078,,,,4,5,9
HND-003616,2011,41800079,,,,3,6,9
HND-003617,2011,41800080,,,,6,3,9
HND-003618,2011,41800081,,,,5,4,9
HND-003619,2011,41800082,,,,5,5,10
HND-003621,2011,41800084,,,,4,5,9
,2011,41800086,,,,3,7,10
HND-003624,2011,41800089,,,,8,2,10
,2011,41800031,,,,1,2,3
HND-003590,2011,41800019,,,,4,3,7
,2011,41800030,,,,2,1,3
HND-003573,2011,41800001,,,,4,6,10
HND-003590,2011,41800019,,,,4,3,7
HND-003593,2011,41800023,,,,5,6,11
HND-003594,2011,41800024,,,,4,6,10
HND-003596,2011,41800026,,,,3,7,10
,2011,41800030,,,,7,5,12
,2011,41800031,,,,2,4,6
,2011,41800032,,,,4,8,12
HND-003592,2011,41800022,,,,17,18,35
HND-003595,2011,41800025,,,,7,4,11
HND-003595,2011,41800025,,,,5,4,9
HND-003596,2011,41800026,,,,3,7,10
,2011,41800030,,,,5,2,7
HND-003573,2011,41800001,,,,2,8,10
HND-003590,2011,41800019,,,,4,3,7
HND-003592,2011,41800022,,,,25,15,40
HND-003593,2011,41800023,,,,8,12,20
HND-003594,2011,41800024,,,,12,9,21
,2011,41800031,,,,4,7,11
,2011,41800032,,,,5,4,9
HND-003574,2011,41800003,,,,18,15,33
HND-003575,2011,41800004,,,,4,6,10
HND-003577,2011,41800006,,,,3,10,13
HND-003578,2011,41800007,,,,5,3,8
HND-003581,2011,41800010,,,,8,6,14
HND-003582,2011,41800011,,,,26,16,42
HND-003586,2011,41800015,,,,6,17,23
HND-003589,2011,41800018,,,,3,5,8
HND-003590,2011,41800019,,,,5,4,9
HND-003591,2011,41800020,,,,1,0,1
HND-003598,2011,41800028,,,,1,2,3
HND-003620,2011,41800083,,,,3,2,5
HND-003576,2011,41800005,,,,14,11,25
HND-003580,2011,41800009,,,,6,3,9
HND-003583,2011,41800012,,,,13,11,24
HND-003584,2011,41800013,,,,18,20,38
HND-003585,2011,41800014,,,,2,9,11
HND-003587,2011,41800016,,,,2,5,7
HND-003588,2011,41800017,,,,2,0,2
HND-003599,2011,41800029,,,,0,2,2
HND-003574,2011,41800003,,,,9,14,23
HND-003575,2011,41800004,,,,5,9,14
HND-003576,2011,41800005,,,,8,7,15
HND-003577,2011,41800006,,,,6,9,15
HND-003580,2011,41800009,,,,2,3,5
HND-003582,2011,41800011,,,,36,26,62
HND-003584,2011,41800013,,,,13,7,20
HND-003588,2011,41800017,,,,3,0,3
HND-003591,2011,41800020,,,,2,1,3
HND-003598,2011,41800028,,,,3,3,6
HND-003599,2011,41800029,,,,0,2,2
HND-003620,2011,41800083,,,,2,2,4
HND-003578,2011,41800007,,,,8,5,13
HND-003581,2011,41800010,,,,6,8,14
HND-003583,2011,41800012,,,,9,7,16
HND-003585,2011,41800014,,,,7,7,14
HND-003586,2011,41800015,,,,18,10,28
HND-003587,2011,41800016,,,,2,6,8
HND-003589,2011,41800018,,,,8,1,9
HND-003590,2011,41800019,,,,6,5,11
HND-003576,2011,41800005,,,,7,10,17
HND-003577,2011,41800006,,,,7,5,12
HND-003580,2011,41800009,,,,10,8,18
HND-003583,2011,41800012,,,,3,10,13
HND-003584,2011,41800013,,,,14,7,21
HND-003585,2011,41800014,,,,8,8,16
HND-003588,2011,41800017,,,,3,0,3
HND-003599,2011,41800029,,,,2,0,2
HND-003574,2011,41800003,,,,12,13,25
HND-003575,2011,41800004,,,,7,5,12
HND-003578,2011,41800007,,,,6,8,14
HND-003581,2011,41800010,,,,9,9,18
HND-003582,2011,41800011,,,,29,21,50
HND-003586,2011,41800015,,,,3,14,17
HND-003587,2011,41800016,,,,1,1,2
HND-003589,2011,41800018,,,,7,3,10
HND-003590,2011,41800019,,,,7,4,11
HND-003591,2011,41800020,,,,0,3,3
HND-003598,2011,41800028,,,,1,1,2
HND-003620,2011,41800083,,,,1,4,5
HND-003574,2011,41800003,,,,16,9,25
HND-003575,2011,41800004,,,,4,10,14
HND-003576,2011,41800005,,,,9,4,13
HND-003577,2011,41800006,,,,5,4,9
HND-003578,2011,41800007,,,,6,6,12
HND-003582,2011,41800011,,,,19,20,39
HND-003591,2011,41800020,,,,1,0,1
HND-003599,2011,41800029,,,,3,1,4
HND-003620,2011,41800083,,,,2,3,5
HND-003580,2011,41800009,,,,2,4,6
HND-003581,2011,41800010,,,,6,5,11
HND-003583,2011,41800012,,,,6,7,13
HND-003584,2011,41800013,,,,13,15,28
HND-003585,2011,41800014,,,,5,6,11
HND-003586,2011,41800015,,,,9,8,17
HND-003587,2011,41800016,,,,2,1,3
HND-003588,2011,41800017,,,,0,2,2
HND-003589,2011,41800018,,,,11,9,20
HND-003590,2011,41800019,,,,3,0,3
HND-003576,2011,41800005,,,,3,5,8
HND-003580,2011,41800009,,,,2,5,7
HND-003583,2011,41800012,,,,6,5,11
HND-003584,2011,41800013,,,,9,10,19
HND-003585,2011,41800014,,,,11,11,22
HND-003586,2011,41800015,,,,5,12,17
HND-003587,2011,41800016,,,,2,1,3
HND-003588,2011,41800017,,,,2,4,6
HND-003589,2011,41800018,,,,2,7,9
HND-003620,2011,41800083,,,,4,2,6
HND-003574,2011,41800003,,,,15,16,31
HND-003575,2011,41800004,,,,1,4,5
HND-003577,2011,41800006,,,,8,1,9
HND-003578,2011,41800007,,,,3,6,9
HND-003581,2011,41800010,,,,8,3,11
HND-003582,2011,41800011,,,,33,23,56
HND-003590,2011,41800019,,,,3,3,6
HND-003598,2011,41800028,,,,3,1,4
HND-003599,2011,41800029,,,,1,0,1
HND-003575,2011,41800004,,,,5,6,11
HND-003576,2011,41800005,,,,3,2,5
HND-003577,2011,41800006,,,,4,10,14
HND-003580,2011,41800009,,,,5,5,10
HND-003582,2011,41800011,,,,30,24,54
HND-003584,2011,41800013,,,,8,8,16
HND-003588,2011,41800017,,,,2,0,2
HND-003591,2011,41800020,,,,1,0,1
HND-003598,2011,41800028,,,,3,3,6
HND-003599,2011,41800029,,,,3,4,7
HND-003574,2011,41800003,,,,6,12,18
HND-003578,2011,41800007,,,,12,5,17
HND-003581,2011,41800010,,,,9,9,18
HND-003583,2011,41800012,,,,3,7,10
HND-003585,2011,41800014,,,,8,12,20
HND-003586,2011,41800015,,,,5,4,9
HND-003587,2011,41800016,,,,1,3,4
HND-003589,2011,41800018,,,,4,3,7
HND-003590,2011,41800019,,,,4,2,6
HND-003620,2011,41800083,,,,0,4,4
HND-003597,2011,41800027,,,,43,36,79
HND-003597,2011,41800027,,,,33,31,64
HND-003597,2011,41800027,,,,24,36,60
HND-003597,2011,41800027,,,,8,13,21
HND-003597,2011,41800027,,,,13,3,16
HND-003597,2011,41800027,,,,7,5,12
,2011,41900013,,,,5,6,11
HND-003653,2011,41900022,,,,7,12,19
HND-003654,2011,41900023,,,,4,7,11
,2011,41900024,,,,4,4,8
,2011,41900025,,,,5,4,9
,2011,41900026,,,,5,5,10
HND-003657,2011,41900047,,,,3,5,8
,2011,41900030,,,,3,4,7
HND-003655,2011,41900033,,,,4,5,9
,2011,41900051,,,,4,4,8
,2011,41900052,,,,3,9,12
HND-003658,2011,41900053,,,,6,3,9
HND-003647,2011,41900015,,,,3,4,7
HND-003651,2011,41900019,,,,7,4,11
HND-003646,2011,41900014,,,,5,13,18
HND-003648,2011,41900016,,,,9,5,14
HND-003652,2011,41900020,,,,5,9,14
HND-003646,2011,41900014,,,,24,25,49
HND-003648,2011,41900016,,,,6,4,10
HND-003652,2011,41900020,,,,3,5,8
HND-003647,2011,41900015,,,,3,7,10
HND-003651,2011,41900019,,,,4,5,9
HND-003634,2011,41900002,,,,9,8,17
HND-003635,2011,41900003,,,,3,4,7
HND-003636,2011,41900004,,,,7,10,17
HND-003637,2011,41900005,,,,7,11,18
HND-003638,2011,41900006,,,,2,3,5
HND-003640,2011,41900008,,,,18,7,25
HND-003641,2011,41900009,,,,11,6,17
HND-003633,2011,41900001,,,,36,38,74
HND-003639,2011,41900007,,,,5,7,12
HND-003642,2011,41900010,,,,5,2,7
HND-003643,2011,41900011,,,,0,2,2
HND-003644,2011,41900012,,,,4,5,9
HND-003650,2011,41900018,,,,2,4,6
HND-003656,2011,41900044,,,,12,5,17
HND-003633,2011,41900001,,,,47,34,81
HND-003637,2011,41900005,,,,12,9,21
HND-003641,2011,41900009,,,,3,1,4
HND-003643,2011,41900011,,,,4,0,4
HND-003644,2011,41900012,,,,1,2,3
HND-003656,2011,41900044,,,,3,2,5
HND-003634,2011,41900002,,,,5,6,11
HND-003635,2011,41900003,,,,3,6,9
HND-003636,2011,41900004,,,,5,2,7
HND-003638,2011,41900006,,,,3,3,6
HND-003639,2011,41900007,,,,8,4,12
HND-003640,2011,41900008,,,,13,5,18
HND-003642,2011,41900010,,,,5,6,11
HND-003650,2011,41900018,,,,1,2,3
HND-003633,2011,41900001,,,,29,39,68
HND-003642,2011,41900010,,,,4,7,11
HND-003643,2011,41900011,,,,3,2,5
HND-003644,2011,41900012,,,,3,1,4
HND-003650,2011,41900018,,,,1,4,5
HND-003656,2011,41900044,,,,6,6,12
HND-003634,2011,41900002,,,,6,5,11
HND-003635,2011,41900003,,,,2,1,3
HND-003636,2011,41900004,,,,5,6,11
HND-003637,2011,41900005,,,,12,8,20
HND-003638,2011,41900006,,,,3,3,6
HND-003639,2011,41900007,,,,7,6,13
HND-003640,2011,41900008,,,,8,12,20
HND-003641,2011,41900009,,,,1,3,4
HND-003633,2011,41900001,,,,36,37,73
HND-003637,2011,41900005,,,,6,12,18
HND-003638,2011,41900006,,,,3,4,7
HND-003640,2011,41900008,,,,11,9,20
HND-003641,2011,41900009,,,,1,2,3
HND-003643,2011,41900011,,,,2,2,4
HND-003656,2011,41900044,,,,3,1,4
HND-003634,2011,41900002,,,,9,8,17
HND-003635,2011,41900003,,,,1,1,2
HND-003636,2011,41900004,,,,5,6,11
HND-003639,2011,41900007,,,,9,0,9
HND-003642,2011,41900010,,,,3,4,7
HND-003644,2011,41900012,,,,2,1,3
HND-003650,2011,41900018,,,,5,2,7
HND-003634,2011,41900002,,,,12,8,20
HND-003636,2011,41900004,,,,4,8,12
HND-003637,2011,41900005,,,,5,5,10
HND-003638,2011,41900006,,,,1,0,1
HND-003640,2011,41900008,,,,10,14,24
HND-003641,2011,41900009,,,,3,3,6
HND-003643,2011,41900011,,,,4,1,5
HND-003656,2011,41900044,,,,1,4,5
HND-003633,2011,41900001,,,,26,30,56
HND-003635,2011,41900003,,,,1,1,2
HND-003639,2011,41900007,,,,6,6,12
HND-003642,2011,41900010,,,,1,2,3
HND-003644,2011,41900012,,,,3,4,7
HND-003650,2011,41900018,,,,1,0,1
HND-003634,2011,41900002,,,,10,10,20
HND-003635,2011,41900003,,,,0,3,3
HND-003636,2011,41900004,,,,5,6,11
HND-003638,2011,41900006,,,,2,2,4
HND-003639,2011,41900007,,,,9,2,11
HND-003640,2011,41900008,,,,9,9,18
HND-003642,2011,41900010,,,,1,1,2
HND-003650,2011,41900018,,,,2,2,4
HND-003633,2011,41900001,,,,41,33,74
HND-003637,2011,41900005,,,,5,9,14
HND-003641,2011,41900009,,,,1,0,1
HND-003643,2011,41900011,,,,3,5,8
HND-003644,2011,41900012,,,,0,2,2
HND-003656,2011,41900044,,,,4,3,7
HND-003634,2011,41900002,,,,6,5,11
HND-003649,2011,41900017,,,,32,19,51
HND-003649,2011,41900017,,,,19,22,41
HND-003634,2011,41900002,,,,5,5,10
HND-003649,2011,41900017,,,,24,18,42
HND-003634,2011,41900002,,,,1,11,12
HND-003649,2011,41900017,,,,18,9,27
HND-003649,2011,41900017,,,,15,21,36
HND-003649,2011,41900017,,,,9,16,25
HND-003696,2011,42000052,,,,9,4,13
HND-003697,2011,42000053,,,,6,4,10
HND-003698,2011,42000054,,,,3,6,9
,2011,42000056,,,,6,4,10
HND-003699,2011,42000057,,,,7,3,10
HND-003700,2011,42000059,,,,4,6,10
HND-003693,2011,42000043,,,,5,6,11
,2011,42000044,,,,2,7,9
HND-003694,2011,42000048,,,,7,2,9
HND-003695,2011,42000049,,,,4,6,10
,2011,42000050,,,,5,4,9
,2011,42000058,,,,4,5,9
HND-003675,2011,42000017,,,,2,1,3
HND-003678,2011,42000020,,,,0,4,4
HND-003679,2011,42000021,,,,0,2,2
HND-003680,2011,42000022,,,,1,1,2
HND-003686,2011,42000031,,,,3,3,6
HND-003691,2011,42000037,,,,3,1,4
,2011,42000038,,,,3,0,3
HND-003684,2011,42000026,,,,0,5,5
HND-003685,2011,42000027,,,,1,4,5
,2011,42000055,,,,1,0,1
HND-003684,2011,42000026,,,,5,5,10
HND-003686,2011,42000031,,,,4,4,8
,2011,42000038,,,,1,4,5
,2011,42000055,,,,1,2,3
HND-003675,2011,42000017,,,,3,2,5
HND-003678,2011,42000020,,,,4,1,5
HND-003679,2011,42000021,,,,2,2,4
HND-003680,2011,42000022,,,,4,11,15
HND-003685,2011,42000027,,,,5,3,8
HND-003691,2011,42000037,,,,3,1,4
HND-003679,2011,42000021,,,,4,5,9
HND-003684,2011,42000026,,,,11,5,16
HND-003691,2011,42000037,,,,5,2,7
HND-003675,2011,42000017,,,,4,5,9
HND-003678,2011,42000020,,,,2,2,4
HND-003680,2011,42000022,,,,15,5,20
HND-003685,2011,42000027,,,,4,6,10
HND-003686,2011,42000031,,,,5,5,10
,2011,42000038,,,,6,2,8
,2011,42000055,,,,1,1,2
HND-003666,2011,42000007,,,,8,9,17
HND-003670,2011,42000011,,,,1,3,4
HND-003671,2011,42000012,,,,3,2,5
HND-003672,2011,42000013,,,,2,2,4
HND-003673,2011,42000014,,,,5,4,9
HND-003674,2011,42000016,,,,2,2,4
HND-003677,2011,42000019,,,,3,4,7
HND-003681,2011,42000023,,,,3,8,11
HND-003683,2011,42000025,,,,2,4,6
HND-003687,2011,42000032,,,,2,2,4
HND-003688,2011,42000034,,,,1,1,2
HND-003689,2011,42000035,,,,3,2,5
HND-003690,2011,42000036,,,,1,2,3
HND-003692,2011,42000041,,,,5,2,7
HND-003661,2011,42000001,,,,1,2,3
HND-003662,2011,42000003,,,,2,2,4
HND-003663,2011,42000004,,,,4,3,7
HND-003664,2011,42000005,,,,26,13,39
HND-003665,2011,42000006,,,,2,2,4
HND-003667,2011,42000008,,,,2,5,7
HND-003669,2011,42000010,,,,5,0,5
HND-003676,2011,42000018,,,,0,2,2
HND-003665,2011,42000006,,,,6,3,9
HND-003666,2011,42000007,,,,8,10,18
HND-003668,2011,42000009,,,,1,3,4
HND-003669,2011,42000010,,,,0,3,3
HND-003670,2011,42000011,,,,2,4,6
HND-003673,2011,42000014,,,,1,4,5
HND-003676,2011,42000018,,,,2,2,4
HND-003677,2011,42000019,,,,3,1,4
HND-003681,2011,42000023,,,,1,3,4
HND-003683,2011,42000025,,,,4,3,7
HND-003661,2011,42000001,,,,4,0,4
HND-003662,2011,42000003,,,,1,1,2
HND-003663,2011,42000004,,,,1,3,4
HND-003664,2011,42000005,,,,24,29,53
HND-003667,2011,42000008,,,,1,0,1
HND-003671,2011,42000012,,,,2,3,5
HND-003672,2011,42000013,,,,0,3,3
HND-003674,2011,42000016,,,,0,2,2
HND-003687,2011,42000032,,,,3,1,4
HND-003688,2011,42000034,,,,2,0,2
HND-003689,2011,42000035,,,,1,2,3
HND-003690,2011,42000036,,,,1,2,3
HND-003692,2011,42000041,,,,4,1,5
HND-003665,2011,42000006,,,,2,3,5
HND-003666,2011,42000007,,,,17,12,29
HND-003670,2011,42000011,,,,4,0,4
HND-003671,2011,42000012,,,,4,1,5
HND-003672,2011,42000013,,,,0,2,2
HND-003673,2011,42000014,,,,4,2,6
HND-003674,2011,42000016,,,,3,2,5
HND-003677,2011,42000019,,,,3,1,4
HND-003681,2011,42000023,,,,4,2,6
HND-003683,2011,42000025,,,,2,5,7
HND-003661,2011,42000001,,,,1,1,2
HND-003662,2011,42000003,,,,5,1,6
HND-003663,2011,42000004,,,,2,5,7
HND-003664,2011,42000005,,,,24,22,46
HND-003667,2011,42000008,,,,4,0,4
HND-003668,2011,42000009,,,,4,2,6
HND-003669,2011,42000010,,,,2,3,5
HND-003676,2011,42000018,,,,7,4,11
HND-003687,2011,42000032,,,,1,1,2
HND-003688,2011,42000034,,,,2,3,5
HND-003689,2011,42000035,,,,1,1,2
HND-003690,2011,42000036,,,,1,1,2
HND-003692,2011,42000041,,,,4,2,6
HND-003662,2011,42000003,,,,0,1,1
HND-003663,2011,42000004,,,,8,6,14
HND-003665,2011,42000006,,,,4,2,6
HND-003668,2011,42000009,,,,0,2,2
HND-003669,2011,42000010,,,,2,0,2
HND-003670,2011,42000011,,,,0,1,1
HND-003673,2011,42000014,,,,2,4,6
HND-003676,2011,42000018,,,,5,4,9
HND-003677,2011,42000019,,,,4,6,10
HND-003681,2011,42000023,,,,2,3,5
HND-003688,2011,42000034,,,,3,0,3
HND-003689,2011,42000035,,,,2,2,4
HND-003690,2011,42000036,,,,2,1,3
HND-003692,2011,42000041,,,,1,1,2
HND-003661,2011,42000001,,,,1,1,2
HND-003664,2011,42000005,,,,29,15,44
HND-003666,2011,42000007,,,,7,9,16
HND-003667,2011,42000008,,,,3,3,6
HND-003671,2011,42000012,,,,1,2,3
HND-003672,2011,42000013,,,,3,1,4
HND-003674,2011,42000016,,,,3,2,5
HND-003683,2011,42000025,,,,2,2,4
HND-003687,2011,42000032,,,,1,1,2
HND-003662,2011,42000003,,,,2,0,2
HND-003663,2011,42000004,,,,4,4,8
HND-003664,2011,42000005,,,,29,29,58
HND-003665,2011,42000006,,,,1,8,9
HND-003668,2011,42000009,,,,0,4,4
HND-003669,2011,42000010,,,,0,2,2
HND-003673,2011,42000014,,,,1,4,5
HND-003676,2011,42000018,,,,1,3,4
HND-003681,2011,42000023,,,,3,4,7
HND-003687,2011,42000032,,,,4,8,12
HND-003688,2011,42000034,,,,2,2,4
HND-003689,2011,42000035,,,,3,0,3
HND-003690,2011,42000036,,,,2,2,4
HND-003692,2011,42000041,,,,1,4,5
HND-003661,2011,42000001,,,,0,3,3
HND-003666,2011,42000007,,,,13,6,19
HND-003670,2011,42000011,,,,1,1,2
HND-003671,2011,42000012,,,,1,3,4
HND-003672,2011,42000013,,,,0,1,1
HND-003674,2011,42000016,,,,5,3,8
HND-003677,2011,42000019,,,,6,2,8
HND-003683,2011,42000025,,,,6,4,10
HND-003661,2011,42000001,,,,3,3,6
HND-003662,2011,42000003,,,,0,2,2
HND-003663,2011,42000004,,,,4,6,10
HND-003664,2011,42000005,,,,24,23,47
HND-003667,2011,42000008,,,,4,3,7
HND-003671,2011,42000012,,,,1,4,5
HND-003672,2011,42000013,,,,0,1,1
HND-003674,2011,42000016,,,,1,1,2
HND-003688,2011,42000034,,,,1,1,2
HND-003689,2011,42000035,,,,1,0,1
HND-003690,2011,42000036,,,,2,1,3
HND-003692,2011,42000041,,,,5,1,6
HND-003665,2011,42000006,,,,2,8,10
HND-003666,2011,42000007,,,,5,13,18
HND-003668,2011,42000009,,,,2,0,2
HND-003669,2011,42000010,,,,3,2,5
HND-003670,2011,42000011,,,,3,0,3
HND-003673,2011,42000014,,,,3,4,7
HND-003676,2011,42000018,,,,1,2,3
HND-003677,2011,42000019,,,,3,4,7
HND-003681,2011,42000023,,,,3,3,6
HND-003683,2011,42000025,,,,5,1,6
HND-003666,2011,42000007,,,,3,10,13
HND-003682,2011,42000024,,,,93,101,194
HND-003666,2011,42000007,,,,6,8,14
HND-003682,2011,42000024,,,,64,89,153
HND-003666,2011,42000007,,,,3,11,14
HND-003682,2011,42000024,,,,65,90,155
HND-003682,2011,42000024,,,,44,86,130
HND-003682,2011,42000024,,,,37,59,96
HND-003682,2011,42000024,,,,35,30,65
HND-003748,2011,42100055,,,,4,6,10
,2011,42100066,,,,4,8,12
,2011,42100105,,,,5,5,10
,2011,42100115,,,,4,6,10
,2011,42100142,,,,5,5,10
HND-003785,2011,42100173,,,,11,4,15
,2011,42100180,,,,6,4,10
,2011,42100181,,,,4,6,10
,2011,42100184,,,,4,6,10
,2011,42100185,,,,4,8,12
HND-003786,2011,42100186,,,,3,7,10
,2011,42100192,,,,4,6,10
HND-003790,2011,42100202,,,,5,5,10
HND-003791,2011,42100205,,,,4,6,10
,2011,42100207,,,,2,8,10
,2011,42100217,,,,5,4,9
HND-003797,2011,42100219,,,,5,6,11
,2011,42100222,,,,5,5,10
HND-003799,2011,42100223,,,,3,7,10
,2011,42100225,,,,5,5,10
,2011,42100226,,,,6,6,12
,2011,42100228,,,,6,4,10
,2011,42100229,,,,4,6,10
,2011,42100231,,,,5,5,10
HND-003801,2011,42100232,,,,4,6,10
,2011,42100233,,,,4,6,10
,2011,42100234,,,,8,4,12
,2011,42100237,,,,4,6,10
,2011,42100238,,,,5,5,10
,2011,42100240,,,,2,8,10
,2011,42100245,,,,4,6,10
HND-003804,2011,42100246,,,,3,7,10
,2011,42100249,,,,5,5,10
,2011,42100252,,,,4,7,11
,2011,42100253,,,,8,2,10
,2011,42100255,,,,6,6,12
HND-003702,2011,42100002,,,,6,5,11
,2011,42100069,,,,2,8,10
,2011,42100088,,,,7,3,10
,2011,42100090,,,,4,7,11
HND-003773,2011,42100100,,,,3,7,10
HND-003774,2011,42100107,,,,6,4,10
,2011,42100108,,,,3,7,10
HND-003775,2011,42100112,,,,5,5,10
HND-003776,2011,42100114,,,,6,5,11
HND-003777,2011,42100116,,,,5,5,10
,2011,42100161,,,,6,4,10
,2011,42100175,,,,3,5,8
,2011,42100182,,,,6,4,10
HND-003789,2011,42100201,,,,5,5,10
,2011,42100213,,,,5,5,10
,2011,42100214,,,,4,6,10
HND-003795,2011,42100215,,,,7,3,10
,2011,42100216,,,,4,6,10
HND-003796,2011,42100218,,,,5,5,10
HND-003798,2011,42100220,,,,5,5,10
,2011,42100221,,,,7,3,10
,2011,42100224,,,,3,7,10
,2011,42100227,,,,4,6,10
HND-003800,2011,42100230,,,,7,5,12
,2011,42100235,,,,4,6,10
,2011,42100236,,,,4,6,10
,2011,42100241,,,,5,5,10
,2011,42100242,,,,7,5,12
,2011,42100243,,,,5,5,10
,2011,42100247,,,,5,5,10
HND-003805,2011,42100248,,,,6,4,10
,2011,42100250,,,,3,7,10
,2011,42100251,,,,5,5,10
HND-003806,2011,42100254,,,,5,5,10
HND-003727,2011,42100027,,,,1,4,5
HND-003757,2011,42100071,,,,1,0,1
HND-003761,2011,42100076,,,,3,0,3
HND-003745,2011,42100048,,,,4,4,8
HND-003750,2011,42100057,,,,25,19,44
HND-003753,2011,42100060,,,,3,0,3
HND-003762,2011,42100080,,,,2,10,12
,2011,42100088,,,,1,3,4
HND-003750,2011,42100057,,,,35,22,57
HND-003751,2011,42100058,,,,11,13,24
HND-003752,2011,42100059,,,,3,5,8
HND-003753,2011,42100060,,,,2,0,2
HND-003761,2011,42100076,,,,6,13,19
HND-003762,2011,42100080,,,,6,3,9
,2011,42100088,,,,3,4,7
HND-003788,2011,42100196,,,,5,5,10
HND-003792,2011,42100208,,,,7,5,12
,2011,42100209,,,,3,4,7
HND-003727,2011,42100027,,,,2,5,7
HND-003745,2011,42100048,,,,1,4,5
HND-003748,2011,42100055,,,,4,4,8
HND-003749,2011,42100056,,,,0,3,3
HND-003757,2011,42100071,,,,3,4,7
HND-003768,2011,42100089,,,,5,5,10
HND-003780,2011,42100157,,,,4,4,8
HND-003727,2011,42100027,,,,3,2,5
HND-003750,2011,42100057,,,,34,36,70
HND-003752,2011,42100059,,,,8,5,13
HND-003753,2011,42100060,,,,13,8,21
HND-003761,2011,42100076,,,,2,0,2
HND-003762,2011,42100080,,,,1,11,12
HND-003780,2011,42100157,,,,6,7,13
HND-003745,2011,42100048,,,,2,5,7
HND-003748,2011,42100055,,,,8,4,12
HND-003749,2011,42100056,,,,15,15,30
HND-003757,2011,42100071,,,,6,10,16
,2011,42100088,,,,5,5,10
HND-003768,2011,42100089,,,,9,6,15
HND-003788,2011,42100196,,,,20,14,34
HND-003792,2011,42100208,,,,6,2,8
,2011,42100209,,,,6,6,12
HND-003701,2011,42100001,,,,13,14,27
HND-003703,2011,42100003,,,,62,38,100
HND-003707,2011,42100007,,,,25,13,38
HND-003708,2011,42100008,,,,17,16,33
HND-003711,2011,42100011,,,,18,20,38
HND-003712,2011,42100012,,,,7,15,22
HND-003713,2011,42100013,,,,11,9,20
HND-003714,2011,42100014,,,,6,7,13
HND-003718,2011,42100018,,,,43,38,81
HND-003719,2011,42100019,,,,8,7,15
HND-003722,2011,42100022,,,,8,9,17
HND-003723,2011,42100023,,,,11,8,19
HND-003724,2011,42100024,,,,5,4,9
HND-003725,2011,42100025,,,,5,5,10
HND-003726,2011,42100026,,,,5,8,13
HND-003728,2011,42100029,,,,19,1,20
HND-003731,2011,42100032,,,,3,2,5
HND-003734,2011,42100035,,,,22,22,44
HND-003735,2011,42100036,,,,8,8,16
HND-003736,2011,42100037,,,,5,12,17
HND-003738,2011,42100039,,,,9,5,14
HND-003744,2011,42100047,,,,6,5,11
HND-003756,2011,42100068,,,,7,1,8
HND-003760,2011,42100075,,,,8,2,10
,2011,42100077,,,,10,8,18
HND-003763,2011,42100081,,,,1,3,4
HND-003765,2011,42100084,,,,4,2,6
,2011,42100097,,,,7,1,8
HND-003772,2011,42100098,,,,5,3,8
HND-003784,2011,42100170,,,,8,2,10
,2011,42100209,,,,7,7,14
HND-003793,2011,42100211,,,,4,3,7
HND-003702,2011,42100002,,,,12,6,18
HND-003704,2011,42100004,,,,3,2,5
HND-003705,2011,42100005,,,,11,6,17
HND-003706,2011,42100006,,,,11,8,19
HND-003709,2011,42100009,,,,5,4,9
HND-003710,2011,42100010,,,,16,14,30
HND-003715,2011,42100015,,,,10,10,20
HND-003716,2011,42100016,,,,4,5,9
HND-003717,2011,42100017,,,,9,11,20
HND-003720,2011,42100020,,,,11,10,21
HND-003721,2011,42100021,,,,10,6,16
HND-003727,2011,42100027,,,,7,7,14
HND-003729,2011,42100030,,,,3,6,9
HND-003730,2011,42100031,,,,5,1,6
HND-003732,2011,42100033,,,,7,2,9
HND-003733,2011,42100034,,,,2,4,6
HND-003737,2011,42100038,,,,5,5,10
HND-003739,2011,42100040,,,,9,7,16
HND-003740,2011,42100041,,,,3,5,8
HND-003741,2011,42100042,,,,10,10,20
HND-003742,2011,42100043,,,,11,12,23
HND-003743,2011,42100044,,,,7,8,15
HND-003745,2011,42100048,,,,8,4,12
HND-003746,2011,42100049,,,,14,17,31
HND-003747,2011,42100050,,,,11,4,15
,2011,42100062,,,,11,9,20
HND-003755,2011,42100063,,,,6,5,11
HND-003758,2011,42100072,,,,22,18,40
HND-003759,2011,42100073,,,,10,7,17
HND-003764,2011,42100082,,,,5,4,9
HND-003766,2011,42100085,,,,6,6,12
HND-003767,2011,42100086,,,,7,2,9
HND-003769,2011,42100092,,,,8,9,17
HND-003770,2011,42100093,,,,5,2,7
HND-003771,2011,42100096,,,,12,5,17
HND-003773,2011,42100100,,,,5,6,11
HND-003779,2011,42100121,,,,5,8,13
HND-003781,2011,42100167,,,,2,7,9
HND-003782,2011,42100168,,,,8,5,13
HND-003783,2011,42100169,,,,6,3,9
HND-003794,2011,42100212,,,,3,7,10
HND-003701,2011,42100001,,,,7,9,16
HND-003702,2011,42100002,,,,10,8,18
HND-003704,2011,42100004,,,,1,2,3
HND-003708,2011,42100008,,,,22,7,29
HND-003709,2011,42100009,,,,6,6,12
HND-003712,2011,42100012,,,,10,10,20
HND-003715,2011,42100015,,,,3,5,8
HND-003716,2011,42100016,,,,5,4,9
HND-003717,2011,42100017,,,,6,10,16
HND-003719,2011,42100019,,,,4,11,15
HND-003721,2011,42100021,,,,8,6,14
HND-003722,2011,42100022,,,,11,8,19
HND-003725,2011,42100025,,,,4,7,11
HND-003726,2011,42100026,,,,3,5,8
HND-003727,2011,42100027,,,,2,3,5
HND-003730,2011,42100031,,,,5,7,12
HND-003731,2011,42100032,,,,2,3,5
HND-003732,2011,42100033,,,,6,2,8
HND-003733,2011,42100034,,,,4,2,6
HND-003734,2011,42100035,,,,14,6,20
HND-003735,2011,42100036,,,,5,8,13
HND-003738,2011,42100039,,,,7,8,15
HND-003741,2011,42100042,,,,0,5,5
HND-003743,2011,42100044,,,,4,5,9
HND-003746,2011,42100049,,,,7,10,17
HND-003747,2011,42100050,,,,3,5,8
HND-003755,2011,42100063,,,,5,9,14
HND-003756,2011,42100068,,,,6,4,10
HND-003758,2011,42100072,,,,3,3,6
HND-003759,2011,42100073,,,,7,1,8
HND-003760,2011,42100075,,,,1,4,5
HND-003771,2011,42100096,,,,9,5,14
,2011,42100097,,,,0,1,1
HND-003782,2011,42100168,,,,3,3,6
HND-003783,2011,42100169,,,,6,3,9
HND-003784,2011,42100170,,,,1,1,2
HND-003794,2011,42100212,,,,4,8,12
HND-003703,2011,42100003,,,,29,44,73
HND-003705,2011,42100005,,,,8,4,12
HND-003706,2011,42100006,,,,10,8,18
HND-003707,2011,42100007,,,,12,9,21
HND-003710,2011,42100010,,,,9,10,19
HND-003711,2011,42100011,,,,3,0,3
HND-003713,2011,42100013,,,,6,7,13
HND-003714,2011,42100014,,,,2,2,4
HND-003718,2011,42100018,,,,40,31,71
HND-003720,2011,42100020,,,,7,14,21
HND-003723,2011,42100023,,,,6,6,12
HND-003724,2011,42100024,,,,3,16,19
HND-003728,2011,42100029,,,,4,9,13
HND-003729,2011,42100030,,,,6,6,12
HND-003736,2011,42100037,,,,6,8,14
HND-003737,2011,42100038,,,,6,2,8
HND-003739,2011,42100040,,,,5,3,8
HND-003740,2011,42100041,,,,4,1,5
HND-003744,2011,42100047,,,,0,2,2
HND-003745,2011,42100048,,,,8,10,18
,2011,42100062,,,,12,8,20
,2011,42100077,,,,9,7,16
HND-003763,2011,42100081,,,,0,2,2
HND-003764,2011,42100082,,,,4,0,4
HND-003765,2011,42100084,,,,2,4,6
HND-003766,2011,42100085,,,,1,2,3
HND-003767,2011,42100086,,,,4,3,7
HND-003769,2011,42100092,,,,4,3,7
HND-003770,2011,42100093,,,,5,5,10
HND-003772,2011,42100098,,,,4,1,5
HND-003773,2011,42100100,,,,5,2,7
HND-003779,2011,42100121,,,,3,7,10
HND-003781,2011,42100167,,,,2,4,6
,2011,42100209,,,,10,10,20
HND-003793,2011,42100211,,,,5,5,10
HND-003702,2011,42100002,,,,2,7,9
HND-003704,2011,42100004,,,,7,3,10
HND-003705,2011,42100005,,,,3,4,7
HND-003706,2011,42100006,,,,7,8,15
HND-003709,2011,42100009,,,,3,1,4
HND-003710,2011,42100010,,,,10,5,15
HND-003715,2011,42100015,,,,8,7,15
HND-003716,2011,42100016,,,,3,3,6
HND-003717,2011,42100017,,,,8,10,18
HND-003720,2011,42100020,,,,8,11,19
HND-003721,2011,42100021,,,,2,9,11
HND-003725,2011,42100025,,,,9,8,17
HND-003726,2011,42100026,,,,3,2,5
HND-003727,2011,42100027,,,,5,4,9
HND-003731,2011,42100032,,,,2,4,6
HND-003732,2011,42100033,,,,6,0,6
HND-003734,2011,42100035,,,,14,10,24
HND-003735,2011,42100036,,,,6,4,10
HND-003736,2011,42100037,,,,9,7,16
HND-003738,2011,42100039,,,,5,0,5
HND-003741,2011,42100042,,,,1,1,2
HND-003744,2011,42100047,,,,1,1,2
,2011,42100062,,,,4,5,9
HND-003755,2011,42100063,,,,2,6,8
HND-003756,2011,42100068,,,,4,2,6
HND-003760,2011,42100075,,,,1,3,4
,2011,42100077,,,,1,5,6
HND-003763,2011,42100081,,,,3,3,6
,2011,42100097,,,,5,1,6
HND-003772,2011,42100098,,,,2,3,5
HND-003701,2011,42100001,,,,7,0,7
HND-003703,2011,42100003,,,,50,43,93
HND-003707,2011,42100007,,,,8,13,21
HND-003708,2011,42100008,,,,11,19,30
HND-003711,2011,42100011,,,,1,0,1
HND-003712,2011,42100012,,,,5,11,16
HND-003713,2011,42100013,,,,7,4,11
HND-003714,2011,42100014,,,,3,2,5
HND-003718,2011,42100018,,,,31,26,57
HND-003719,2011,42100019,,,,3,5,8
HND-003722,2011,42100022,,,,5,10,15
HND-003723,2011,42100023,,,,10,7,17
HND-003724,2011,42100024,,,,8,0,8
HND-003728,2011,42100029,,,,4,7,11
HND-003729,2011,42100030,,,,8,3,11
HND-003730,2011,42100031,,,,6,2,8
HND-003733,2011,42100034,,,,0,3,3
HND-003737,2011,42100038,,,,4,3,7
HND-003739,2011,42100040,,,,2,4,6
HND-003740,2011,42100041,,,,7,6,13
HND-003742,2011,42100043,,,,3,1,4
HND-003743,2011,42100044,,,,7,2,9
HND-003745,2011,42100048,,,,0,1,1
HND-003746,2011,42100049,,,,13,7,20
HND-003747,2011,42100050,,,,3,5,8
HND-003758,2011,42100072,,,,0,3,3
HND-003759,2011,42100073,,,,1,1,2
HND-003764,2011,42100082,,,,3,2,5
HND-003765,2011,42100084,,,,1,1,2
HND-003766,2011,42100085,,,,4,4,8
HND-003767,2011,42100086,,,,1,1,2
HND-003769,2011,42100092,,,,1,3,4
HND-003770,2011,42100093,,,,3,2,5
HND-003771,2011,42100096,,,,9,7,16
HND-003779,2011,42100121,,,,0,3,3
HND-003781,2011,42100167,,,,5,3,8
HND-003782,2011,42100168,,,,6,6,12
HND-003783,2011,42100169,,,,5,2,7
HND-003784,2011,42100170,,,,2,5,7
,2011,42100209,,,,10,15,25
HND-003793,2011,42100211,,,,1,2,3
HND-003701,2011,42100001,,,,4,2,6
HND-003703,2011,42100003,,,,38,36,74
HND-003704,2011,42100004,,,,7,4,11
HND-003708,2011,42100008,,,,12,10,22
HND-003712,2011,42100012,,,,8,6,14
HND-003713,2011,42100013,,,,10,9,19
HND-003714,2011,42100014,,,,5,3,8
HND-003715,2011,42100015,,,,8,8,16
HND-003716,2011,42100016,,,,1,5,6
HND-003719,2011,42100019,,,,4,3,7
HND-003721,2011,42100021,,,,5,4,9
HND-003722,2011,42100022,,,,10,7,17
HND-003723,2011,42100023,,,,8,7,15
HND-003724,2011,42100024,,,,3,7,10
HND-003725,2011,42100025,,,,14,13,27
HND-003726,2011,42100026,,,,3,2,5
HND-003728,2011,42100029,,,,5,0,5
HND-003730,2011,42100031,,,,1,6,7
HND-003731,2011,42100032,,,,3,3,6
HND-003732,2011,42100033,,,,3,2,5
HND-003733,2011,42100034,,,,2,5,7
HND-003737,2011,42100038,,,,0,2,2
HND-003738,2011,42100039,,,,0,2,2
HND-003740,2011,42100041,,,,4,6,10
HND-003741,2011,42100042,,,,2,1,3
HND-003743,2011,42100044,,,,3,3,6
HND-003746,2011,42100049,,,,3,6,9
HND-003747,2011,42100050,,,,6,3,9
HND-003756,2011,42100068,,,,4,1,5
HND-003758,2011,42100072,,,,0,7,7
HND-003759,2011,42100073,,,,1,4,5
HND-003760,2011,42100075,,,,1,1,2
HND-003766,2011,42100085,,,,4,1,5
HND-003767,2011,42100086,,,,1,1,2
HND-003769,2011,42100092,,,,0,1,1
HND-003771,2011,42100096,,,,6,6,12
,2011,42100097,,,,0,1,1
HND-003782,2011,42100168,,,,3,5,8
HND-003783,2011,42100169,,,,2,2,4
HND-003784,2011,42100170,,,,2,6,8
HND-003793,2011,42100211,,,,1,1,2
HND-003702,2011,42100002,,,,2,5,7
HND-003705,2011,42100005,,,,2,3,5
HND-003706,2011,42100006,,,,3,12,15
HND-003707,2011,42100007,,,,8,12,20
HND-003709,2011,42100009,,,,2,5,7
HND-003710,2011,42100010,,,,10,10,20
HND-003717,2011,42100017,,,,6,12,18
HND-003718,2011,42100018,,,,22,19,41
HND-003720,2011,42100020,,,,12,10,22
HND-003727,2011,42100027,,,,2,6,8
HND-003729,2011,42100030,,,,5,0,5
HND-003734,2011,42100035,,,,19,15,34
HND-003735,2011,42100036,,,,3,5,8
HND-003736,2011,42100037,,,,9,6,15
HND-003739,2011,42100040,,,,2,4,6
HND-003744,2011,42100047,,,,4,3,7
HND-003745,2011,42100048,,,,6,2,8
,2011,42100062,,,,3,7,10
HND-003755,2011,42100063,,,,4,5,9
,2011,42100077,,,,5,5,10
HND-003763,2011,42100081,,,,2,2,4
HND-003764,2011,42100082,,,,3,3,6
HND-003765,2011,42100084,,,,2,0,2
HND-003770,2011,42100093,,,,4,3,7
HND-003772,2011,42100098,,,,2,1,3
,2011,42100209,,,,14,6,20
HND-003701,2011,42100001,,,,2,3,5
HND-003703,2011,42100003,,,,42,30,72
HND-003707,2011,42100007,,,,7,5,12
HND-003708,2011,42100008,,,,11,10,21
HND-003712,2011,42100012,,,,4,8,12
HND-003713,2011,42100013,,,,4,9,13
HND-003714,2011,42100014,,,,0,1,1
HND-003715,2011,42100015,,,,6,5,11
HND-003716,2011,42100016,,,,0,2,2
HND-003719,2011,42100019,,,,8,5,13
HND-003722,2011,42100022,,,,2,11,13
HND-003723,2011,42100023,,,,3,4,7
HND-003724,2011,42100024,,,,4,5,9
HND-003725,2011,42100025,,,,8,6,14
HND-003726,2011,42100026,,,,6,3,9
HND-003728,2011,42100029,,,,2,5,7
HND-003729,2011,42100030,,,,3,2,5
HND-003730,2011,42100031,,,,2,1,3
HND-003733,2011,42100034,,,,3,4,7
HND-003740,2011,42100041,,,,3,2,5
HND-003741,2011,42100042,,,,0,1,1
HND-003742,2011,42100043,,,,1,0,1
HND-003743,2011,42100044,,,,2,0,2
HND-003745,2011,42100048,,,,2,1,3
HND-003746,2011,42100049,,,,5,3,8
HND-003747,2011,42100050,,,,3,0,3
HND-003756,2011,42100068,,,,0,1,1
HND-003758,2011,42100072,,,,5,6,11
HND-003759,2011,42100073,,,,2,0,2
HND-003764,2011,42100082,,,,1,1,2
HND-003766,2011,42100085,,,,0,1,1
HND-003767,2011,42100086,,,,1,0,1
HND-003769,2011,42100092,,,,3,1,4
HND-003771,2011,42100096,,,,5,5,10
HND-003773,2011,42100100,,,,3,3,6
HND-003781,2011,42100167,,,,2,2,4
HND-003782,2011,42100168,,,,1,2,3
HND-003784,2011,42100170,,,,4,3,7
,2011,42100209,,,,7,1,8
HND-003793,2011,42100211,,,,1,3,4
HND-003794,2011,42100212,,,,2,2,4
HND-003702,2011,42100002,,,,2,3,5
HND-003704,2011,42100004,,,,2,1,3
HND-003705,2011,42100005,,,,3,3,6
HND-003706,2011,42100006,,,,6,6,12
HND-003709,2011,42100009,,,,3,5,8
HND-003710,2011,42100010,,,,7,10,17
HND-003717,2011,42100017,,,,8,14,22
HND-003718,2011,42100018,,,,17,13,30
HND-003720,2011,42100020,,,,6,7,13
HND-003721,2011,42100021,,,,2,2,4
HND-003727,2011,42100027,,,,3,4,7
HND-003731,2011,42100032,,,,5,4,9
HND-003734,2011,42100035,,,,13,9,22
HND-003735,2011,42100036,,,,1,1,2
HND-003736,2011,42100037,,,,7,10,17
HND-003739,2011,42100040,,,,1,3,4
,2011,42100062,,,,5,4,9
HND-003755,2011,42100063,,,,1,3,4
HND-003760,2011,42100075,,,,1,0,1
,2011,42100077,,,,3,3,6
HND-003763,2011,42100081,,,,1,2,3
HND-003765,2011,42100084,,,,0,2,2
,2011,42100097,,,,4,2,6
HND-003772,2011,42100098,,,,3,1,4
HND-003779,2011,42100121,,,,3,3,6
HND-003703,2011,42100003,,,,48,40,88
HND-003705,2011,42100005,,,,2,5,7
HND-003706,2011,42100006,,,,3,7,10
HND-003707,2011,42100007,,,,8,10,18
HND-003710,2011,42100010,,,,5,7,12
HND-003711,2011,42100011,,,,3,0,3
HND-003713,2011,42100013,,,,8,3,11
HND-003714,2011,42100014,,,,3,1,4
HND-003718,2011,42100018,,,,17,15,32
HND-003720,2011,42100020,,,,9,9,18
HND-003723,2011,42100023,,,,1,3,4
HND-003724,2011,42100024,,,,1,5,6
HND-003728,2011,42100029,,,,2,4,6
HND-003729,2011,42100030,,,,3,2,5
HND-003736,2011,42100037,,,,4,7,11
HND-003737,2011,42100038,,,,0,2,2
HND-003739,2011,42100040,,,,2,2,4
HND-003740,2011,42100041,,,,3,2,5
HND-003744,2011,42100047,,,,2,4,6
HND-003745,2011,42100048,,,,0,4,4
,2011,42100062,,,,3,8,11
,2011,42100077,,,,1,4,5
HND-003763,2011,42100081,,,,1,3,4
HND-003764,2011,42100082,,,,2,2,4
HND-003765,2011,42100084,,,,3,2,5
HND-003766,2011,42100085,,,,0,1,1
HND-003769,2011,42100092,,,,1,0,1
HND-003770,2011,42100093,,,,0,2,2
HND-003772,2011,42100098,,,,2,1,3
HND-003779,2011,42100121,,,,1,4,5
HND-003781,2011,42100167,,,,1,0,1
HND-003793,2011,42100211,,,,0,1,1
HND-003701,2011,42100001,,,,3,4,7
HND-003702,2011,42100002,,,,2,5,7
HND-003708,2011,42100008,,,,9,8,17
HND-003709,2011,42100009,,,,2,3,5
HND-003712,2011,42100012,,,,2,6,8
HND-003715,2011,42100015,,,,6,10,16
HND-003716,2011,42100016,,,,0,5,5
HND-003717,2011,42100017,,,,6,6,12
HND-003719,2011,42100019,,,,2,2,4
HND-003721,2011,42100021,,,,2,7,9
HND-003722,2011,42100022,,,,5,4,9
HND-003725,2011,42100025,,,,6,8,14
HND-003726,2011,42100026,,,,3,1,4
HND-003727,2011,42100027,,,,0,4,4
HND-003730,2011,42100031,,,,4,1,5
HND-003731,2011,42100032,,,,1,2,3
HND-003733,2011,42100034,,,,0,2,2
HND-003734,2011,42100035,,,,9,5,14
HND-003741,2011,42100042,,,,1,1,2
HND-003742,2011,42100043,,,,0,1,1
HND-003743,2011,42100044,,,,2,4,6
HND-003746,2011,42100049,,,,2,5,7
HND-003747,2011,42100050,,,,3,1,4
HND-003755,2011,42100063,,,,2,5,7
HND-003756,2011,42100068,,,,0,3,3
HND-003758,2011,42100072,,,,1,0,1
HND-003759,2011,42100073,,,,1,5,6
HND-003760,2011,42100075,,,,1,1,2
HND-003771,2011,42100096,,,,4,2,6
,2011,42100097,,,,0,1,1
HND-003782,2011,42100168,,,,3,3,6
HND-003784,2011,42100170,,,,1,2,3
HND-003718,2011,42100018,,,,14,25,39
,2011,42100062,,,,38,37,75
,2011,42100210,,,,24,26,50
HND-003718,2011,42100018,,,,13,14,27
,2011,42100062,,,,21,21,42
,2011,42100210,,,,11,10,21
,2011,42100062,,,,27,31,58
,2011,42100210,,,,9,9,18
HND-003718,2011,42100018,,,,8,15,23
,2011,42100062,,,,38,57,95
,2011,42100210,,,,11,12,23
,2011,42100062,,,,9,24,33
,2011,42100062,,,,23,27,50
HND-003822,2011,42200016,,,,7,3,10
,2011,42200019,,,,4,5,9
,2011,42200038,,,,8,9,17
,2011,42200039,,,,5,7,12
,2011,42200040,,,,3,6,9
,2011,42200045,,,,5,5,10
,2011,42200018,,,,6,8,14
,2011,42200035,,,,8,5,13
,2011,42200036,,,,5,6,11
,2011,42200037,,,,5,6,11
,2011,42200041,,,,8,3,11
,2011,42200042,,,,4,5,9
HND-003824,2011,42200043,,,,5,5,10
,2011,42200044,,,,6,7,13
HND-003821,2011,42200015,,,,0,3,3
HND-003816,2011,42200010,,,,12,16,28
HND-003819,2011,42200013,,,,5,6,11
HND-003820,2011,42200014,,,,4,6,10
HND-003821,2011,42200015,,,,5,5,10
HND-003817,2011,42200011,,,,9,10,19
,2011,42200018,,,,1,8,9
HND-003816,2011,42200010,,,,16,20,36
HND-003817,2011,42200011,,,,12,9,21
,2011,42200018,,,,4,7,11
HND-003819,2011,42200013,,,,11,4,15
HND-003820,2011,42200014,,,,6,6,12
HND-003821,2011,42200015,,,,5,0,5
HND-003810,2011,42200003,,,,7,8,15
HND-003811,2011,42200004,,,,15,13,28
HND-003812,2011,42200005,,,,12,4,16
,2011,42200006,,,,14,21,35
HND-003815,2011,42200009,,,,5,1,6
HND-003822,2011,42200016,,,,5,1,6
HND-003808,2011,42200001,,,,8,10,18
HND-003809,2011,42200002,,,,33,29,62
HND-003813,2011,42200007,,,,5,1,6
HND-003814,2011,42200008,,,,2,4,6
HND-003823,2011,42200017,,,,2,10,12
HND-003812,2011,42200005,,,,7,3,10
,2011,42200006,,,,18,21,39
HND-003813,2011,42200007,,,,4,3,7
HND-003823,2011,42200017,,,,2,2,4
HND-003808,2011,42200001,,,,5,4,9
HND-003809,2011,42200002,,,,36,26,62
HND-003810,2011,42200003,,,,12,14,26
HND-003811,2011,42200004,,,,9,6,15
HND-003814,2011,42200008,,,,4,1,5
HND-003822,2011,42200016,,,,2,2,4
HND-003808,2011,42200001,,,,6,9,15
HND-003809,2011,42200002,,,,30,31,61
HND-003813,2011,42200007,,,,2,1,3
HND-003814,2011,42200008,,,,3,2,5
HND-003823,2011,42200017,,,,3,0,3
HND-003810,2011,42200003,,,,9,9,18
HND-003811,2011,42200004,,,,9,10,19
HND-003812,2011,42200005,,,,10,4,14
,2011,42200006,,,,8,18,26
HND-003815,2011,42200009,,,,0,1,1
HND-003822,2011,42200016,,,,3,1,4
HND-003812,2011,42200005,,,,4,8,12
,2011,42200006,,,,17,17,34
HND-003813,2011,42200007,,,,2,3,5
HND-003822,2011,42200016,,,,1,3,4
HND-003808,2011,42200001,,,,9,7,16
HND-003809,2011,42200002,,,,29,26,55
HND-003810,2011,42200003,,,,7,5,12
HND-003811,2011,42200004,,,,3,0,3
HND-003814,2011,42200008,,,,1,1,2
HND-003815,2011,42200009,,,,1,1,2
HND-003810,2011,42200003,,,,5,5,10
HND-003812,2011,42200005,,,,5,10,15
,2011,42200006,,,,15,11,26
HND-003815,2011,42200009,,,,2,5,7
HND-003822,2011,42200016,,,,1,1,2
HND-003823,2011,42200017,,,,1,0,1
HND-003808,2011,42200001,,,,7,2,9
HND-003809,2011,42200002,,,,32,32,64
HND-003811,2011,42200004,,,,7,6,13
HND-003813,2011,42200007,,,,1,1,2
HND-003814,2011,42200008,,,,1,3,4
HND-003808,2011,42200001,,,,3,7,10
HND-003809,2011,42200002,,,,31,33,64
HND-003810,2011,42200003,,,,5,2,7
HND-003811,2011,42200004,,,,1,0,1
HND-003814,2011,42200008,,,,0,2,2
HND-003815,2011,42200009,,,,2,2,4
HND-003822,2011,42200016,,,,2,2,4
HND-003812,2011,42200005,,,,1,2,3
,2011,42200006,,,,17,16,33
HND-003813,2011,42200007,,,,0,1,1
HND-003823,2011,42200017,,,,3,2,5
,2011,42200006,,,,16,25,41
HND-003818,2011,42200012,,,,33,36,69
HND-003818,2011,42200012,,,,25,10,35
,2011,42200006,,,,12,9,21
HND-003818,2011,42200012,,,,21,14,35
,2011,42200006,,,,5,8,13
HND-003818,2011,42200012,,,,16,14,30
HND-003818,2011,42200012,,,,4,5,9
HND-003818,2011,42200012,,,,11,15,26
,2011,42300018,,,,8,3,11
,2011,42300019,,,,3,3,6
HND-003834,2011,42300021,,,,10,5,15
,2011,42300022,,,,4,5,9
HND-003832,2011,42300016,,,,12,9,21
,2011,42300017,,,,10,9,19
HND-003833,2011,42300020,,,,6,8,14
HND-003831,2011,42300007,,,,3,5,8
,2011,42300008,,,,1,4,5
,2011,42300008,,,,6,5,11
HND-003831,2011,42300007,,,,12,9,21
HND-003825,2011,42300001,,,,13,15,28
HND-003829,2011,42300005,,,,8,3,11
HND-003826,2011,42300002,,,,4,6,10
HND-003827,2011,42300003,,,,6,12,18
HND-003828,2011,42300004,,,,20,16,36
HND-003830,2011,42300006,,,,5,5,10
HND-003827,2011,42300003,,,,9,7,16
HND-003828,2011,42300004,,,,8,4,12
HND-003825,2011,42300001,,,,6,14,20
HND-003826,2011,42300002,,,,4,3,7
HND-003829,2011,42300005,,,,9,6,15
HND-003830,2011,42300006,,,,6,5,11
HND-003826,2011,42300002,,,,2,4,6
HND-003827,2011,42300003,,,,8,9,17
HND-003828,2011,42300004,,,,6,6,12
HND-003825,2011,42300001,,,,17,11,28
HND-003829,2011,42300005,,,,7,7,14
HND-003830,2011,42300006,,,,7,6,13
HND-003825,2011,42300001,,,,13,9,22
HND-003826,2011,42300002,,,,1,6,7
HND-003827,2011,42300003,,,,7,9,16
HND-003828,2011,42300004,,,,6,5,11
HND-003829,2011,42300005,,,,7,6,13
HND-003830,2011,42300006,,,,4,2,6
HND-003825,2011,42300001,,,,15,11,26
HND-003829,2011,42300005,,,,8,4,12
HND-003826,2011,42300002,,,,1,1,2
HND-003827,2011,42300003,,,,5,4,9
HND-003828,2011,42300004,,,,3,3,6
HND-003830,2011,42300006,,,,4,7,11
HND-003827,2011,42300003,,,,5,2,7
HND-003828,2011,42300004,,,,4,2,6
HND-003825,2011,42300001,,,,12,15,27
HND-003826,2011,42300002,,,,4,5,9
HND-003829,2011,42300005,,,,8,5,13
HND-003830,2011,42300006,,,,5,2,7
HND-003825,2011,42300001,,,,16,18,34
HND-003825,2011,42300001,,,,11,11,22
HND-003825,2011,42300001,,,,13,7,20
HND-003873,2011,50100050,,,,2,7,9
HND-003889,2011,50100070,,,,9,8,17
HND-003912,2011,50100095,,,,10,9,19
,2011,50100199,,,,8,12,20
HND-003985,2011,50100296,,,,6,6,12
,2011,50100395,,,,11,14,25
HND-004016,2011,50100396,,,,13,13,26
HND-004020,2011,50100414,,,,10,10,20
,2011,50100531,,,,6,10,16
HND-004075,2011,50100736,,,,8,7,15
,2011,50100742,,,,8,7,15
,2011,50100746,,,,9,11,20
,2011,50100747,,,,6,10,16
,2011,50100755,,,,11,9,20
,2011,50100759,,,,27,24,51
,2011,50100761,,,,5,7,12
,2011,50100766,,,,12,3,15
,2011,50100768,,,,12,16,28
HND-004080,2011,50100779,,,,34,23,57
,2011,50100783,,,,11,7,18
,2011,50100786,,,,10,10,20
,2011,50100789,,,,6,5,11
,2011,50100790,,,,5,4,9
HND-004085,2011,50100796,,,,9,16,25
HND-004089,2011,50100853,,,,10,10,20
HND-004091,2011,50100856,,,,11,36,47
,2011,50100857,,,,20,18,38
,2011,50100877,,,,12,17,29
,2011,50100903,,,,5,4,9
HND-004100,2011,50100926,,,,10,11,21
,2011,50100929,,,,4,7,11
HND-004103,2011,50100945,,,,14,14,28
,2011,50100966,,,,15,11,26
HND-004109,2011,50100980,,,,7,7,14
,2011,50100995,,,,16,18,34
,2011,50101008,,,,10,8,18
HND-004112,2011,50101010,,,,2,4,6
,2011,50101014,,,,11,11,22
,2011,50101016,,,,10,9,19
,2011,50101020,,,,7,12,19
,2011,50101022,,,,4,6,10
,2011,50101024,,,,14,14,28
,2011,50101091,,,,15,10,25
,2011,50101098,,,,18,16,34
,2011,50101099,,,,8,16,24
HND-004121,2011,50101102,,,,7,6,13
,2011,50101110,,,,10,6,16
,2011,50101113,,,,2,5,7
HND-004125,2011,50101118,,,,12,10,22
,2011,50101119,,,,14,8,22
,2011,50101123,,,,8,2,10
,2011,50101125,,,,4,6,10
,2011,50101127,,,,39,12,51
,2011,50101130,,,,10,10,20
HND-004128,2011,50101133,,,,8,9,17
HND-004129,2011,50101139,,,,16,10,26
,2011,50101204,,,,7,7,14
,2011,50101208,,,,7,5,12
,2011,50101209,,,,8,3,11
,2011,50101212,,,,5,3,8
HND-004139,2011,50101213,,,,1,2,3
,2011,50101215,,,,4,5,9
,2011,50101216,,,,6,4,10
HND-004141,2011,50101221,,,,10,5,15
,2011,50101223,,,,9,7,16
,2011,50101225,,,,10,6,16
,2011,50101228,,,,5,5,10
,2011,50101230,,,,3,4,7
HND-004144,2011,50101234,,,,12,6,18
,2011,50101246,,,,5,10,15
,2011,50101247,,,,5,10,15
,2011,50101248,,,,0,8,8
HND-004150,2011,50101250,,,,6,7,13
,2011,50101272,,,,9,8,17
,2011,50101274,,,,6,4,10
,2011,50101280,,,,9,7,16
,2011,50101283,,,,9,10,19
,2011,50101284,,,,3,7,10
HND-004152,2011,50101285,,,,9,11,20
,2011,50101292,,,,5,13,18
HND-004154,2011,50101295,,,,19,9,28
,2011,50100079,,,,9,4,13
HND-003908,2011,50100091,,,,6,7,13
,2011,50100093,,,,6,5,11
,2011,50100099,,,,5,4,9
HND-003918,2011,50100104,,,,11,7,18
HND-003956,2011,50100188,,,,10,15,25
,2011,50100267,,,,6,5,11
HND-004006,2011,50100343,,,,11,8,19
,2011,50100393,,,,16,13,29
,2011,50100394,,,,8,4,12
,2011,50100418,,,,5,6,11
HND-004046,2011,50100539,,,,10,16,26
HND-004064,2011,50100629,,,,7,10,17
HND-004071,2011,50100706,,,,10,5,15
HND-004073,2011,50100726,,,,8,10,18
HND-004074,2011,50100734,,,,17,9,26
,2011,50100735,,,,12,10,22
HND-004077,2011,50100764,,,,9,3,12
HND-004078,2011,50100765,,,,9,10,19
,2011,50100770,,,,7,13,20
,2011,50100771,,,,21,19,40
HND-004079,2011,50100778,,,,7,9,16
HND-004082,2011,50100785,,,,11,6,17
HND-004084,2011,50100795,,,,14,13,27
HND-004088,2011,50100851,,,,7,8,15
HND-004092,2011,50100858,,,,12,6,18
HND-004093,2011,50100860,,,,27,17,44
HND-004097,2011,50100901,,,,9,13,22
HND-004101,2011,50100928,,,,4,4,8
,2011,50101011,,,,9,6,15
HND-004113,2011,50101018,,,,16,12,28
,2011,50101021,,,,12,14,26
HND-004114,2011,50101026,,,,12,14,26
HND-004115,2011,50101028,,,,10,10,20
,2011,50101057,,,,13,13,26
,2011,50101059,,,,8,2,10
HND-004119,2011,50101086,,,,4,5,9
HND-004120,2011,50101101,,,,9,11,20
,2011,50101109,,,,5,4,9
,2011,50101114,,,,10,15,25
HND-004123,2011,50101116,,,,10,19,29
HND-004124,2011,50101117,,,,10,9,19
HND-004126,2011,50101120,,,,5,5,10
HND-004127,2011,50101121,,,,14,7,21
,2011,50101131,,,,12,10,22
,2011,50101137,,,,10,9,19
HND-004130,2011,50101143,,,,16,10,26
,2011,50101205,,,,16,12,28
,2011,50101211,,,,8,10,18
,2011,50101217,,,,3,4,7
,2011,50101218,,,,10,10,20
HND-004140,2011,50101219,,,,14,8,22
,2011,50101220,,,,7,4,11
HND-004142,2011,50101222,,,,5,7,12
,2011,50101226,,,,8,6,14
,2011,50101227,,,,14,8,22
,2011,50101229,,,,11,11,22
HND-004143,2011,50101233,,,,7,5,12
,2011,50101235,,,,7,2,9
HND-004145,2011,50101236,,,,15,5,20
,2011,50101237,,,,5,5,10
HND-004146,2011,50101238,,,,12,8,20
HND-004147,2011,50101241,,,,5,10,15
HND-004148,2011,50101242,,,,9,10,19
,2011,50101243,,,,8,4,12
,2011,50101245,,,,7,7,14
HND-004151,2011,50101251,,,,18,8,26
,2011,50101254,,,,11,6,17
,2011,50101268,,,,18,8,26
,2011,50101269,,,,7,8,15
,2011,50101270,,,,7,8,15
,2011,50101271,,,,12,17,29
,2011,50101273,,,,6,5,11
,2011,50101286,,,,5,5,10
,2011,50101287,,,,4,6,10
,2011,50101294,,,,4,6,10
,2011,50100014,,,,0,2,2
HND-003925,2011,50100114,,,,0,1,1
,2011,50100117,,,,6,9,15
,2011,50100130,,,,2,1,3
,2011,50100135,,,,1,5,6
,2011,50100145,,,,1,0,1
,2011,50100147,,,,1,1,2
,2011,50100173,,,,1,2,3
,2011,50100179,,,,1,3,4
HND-003954,2011,50100182,,,,6,6,12
HND-003958,2011,50100195,,,,1,3,4
,2011,50100198,,,,9,11,20
,2011,50100213,,,,1,1,2
,2011,50100266,,,,13,7,20
,2011,50100271,,,,8,7,15
,2011,50100275,,,,6,2,8
HND-003990,2011,50100307,,,,5,7,12
,2011,50100308,,,,1,1,2
,2011,50100338,,,,2,2,4
,2011,50100352,,,,2,5,7
,2011,50100404,,,,7,14,21
HND-004020,2011,50100414,,,,101,74,175
,2011,50100426,,,,4,5,9
,2011,50100429,,,,1,3,4
,2011,50100430,,,,12,11,23
,2011,50100431,,,,6,7,13
,2011,50100433,,,,10,9,19
,2011,50100443,,,,13,5,18
,2011,50100458,,,,1,0,1
,2011,50100470,,,,7,8,15
,2011,50100472,,,,3,1,4
,2011,50100476,,,,58,53,111
,2011,50100477,,,,16,10,26
,2011,50100483,,,,7,2,9
,2011,50100496,,,,33,37,70
,2011,50100497,,,,6,8,14
,2011,50100499,,,,22,26,48
,2011,50100512,,,,3,0,3
,2011,50100517,,,,11,8,19
,2011,50100519,,,,4,2,6
,2011,50100526,,,,1,3,4
,2011,50100542,,,,0,2,2
,2011,50100573,,,,6,10,16
,2011,50100586,,,,16,15,31
,2011,50100588,,,,0,1,1
,2011,50100600,,,,2,2,4
,2011,50100616,,,,6,2,8
,2011,50100686,,,,19,8,27
,2011,50100688,,,,1,0,1
,2011,50100693,,,,6,4,10
,2011,50100709,,,,3,2,5
,2011,50100710,,,,3,5,8
,2011,50100711,,,,1,2,3
,2011,50100712,,,,5,3,8
,2011,50100713,,,,1,0,1
HND-004076,2011,50100756,,,,1,6,7
HND-004081,2011,50100780,,,,0,1,1
,2011,50100822,,,,1,1,2
,2011,50100823,,,,0,1,1
,2011,50100831,,,,1,0,1
,2011,50100832,,,,0,2,2
,2011,50100848,,,,0,1,1
,2011,50100888,,,,6,5,11
,2011,50100921,,,,0,1,1
,2011,50100923,,,,0,1,1
,2011,50100932,,,,2,1,3
,2011,50100934,,,,9,4,13
HND-004102,2011,50100935,,,,1,2,3
,2011,50100936,,,,2,1,3
HND-004108,2011,50100973,,,,24,13,37
,2011,50101047,,,,10,4,14
,2011,50101052,,,,1,2,3
,2011,50101072,,,,3,9,12
,2011,50101074,,,,4,2,6
,2011,50101088,,,,3,4,7
,2011,50101169,,,,2,0,2
,2011,50101179,,,,2,1,3
HND-004137,2011,50101193,,,,4,1,5
,2011,50101195,,,,6,2,8
,2011,50101196,,,,4,3,7
,2011,50101197,,,,2,0,2
,2011,50101198,,,,12,8,20
,2011,50101200,,,,0,2,2
,2011,50101256,,,,3,0,3
,2011,50101261,,,,8,7,15
,2011,50101262,,,,0,3,3
,2011,50101279,,,,2,3,5
HND-003843,2011,50100007,,,,30,13,43
,2011,50100012,,,,1,2,3
,2011,50100038,,,,0,30,30
,2011,50100110,,,,11,14,25
,2011,50100149,,,,6,4,10
,2011,50100220,,,,1,0,1
,2011,50100224,,,,3,23,26
,2011,50100269,,,,7,7,14
,2011,50100273,,,,1,1,2
HND-003984,2011,50100293,,,,16,4,20
,2011,50100327,,,,0,2,2
,2011,50100335,,,,5,5,10
,2011,50100348,,,,7,0,7
,2011,50100370,,,,5,10,15
,2011,50100403,,,,3,1,4
,2011,50100419,,,,1,4,5
,2011,50100428,,,,7,16,23
,2011,50100445,,,,6,6,12
HND-004026,2011,50100453,,,,5,8,13
,2011,50100455,,,,2,4,6
,2011,50100456,,,,3,2,5
,2011,50100461,,,,0,1,1
,2011,50100475,,,,1,0,1
,2011,50100485,,,,0,2,2
,2011,50100493,,,,4,11,15
,2011,50100500,,,,21,20,41
,2011,50100508,,,,3,2,5
,2011,50100522,,,,2,3,5
,2011,50100543,,,,13,9,22
,2011,50100547,,,,7,11,18
,2011,50100549,,,,6,8,14
,2011,50100557,,,,7,7,14
,2011,50100568,,,,4,6,10
,2011,50100618,,,,10,18,28
,2011,50100619,,,,9,11,20
,2011,50100620,,,,10,4,14
HND-004065,2011,50100631,,,,70,57,127
,2011,50100643,,,,1,1,2
,2011,50100651,,,,3,3,6
,2011,50100655,,,,1,0,1
,2011,50100674,,,,7,5,12
,2011,50100689,,,,3,0,3
,2011,50100818,,,,3,2,5
,2011,50100824,,,,1,0,1
,2011,50100827,,,,4,2,6
,2011,50100834,,,,3,1,4
,2011,50100852,,,,8,3,11
,2011,50100918,,,,1,1,2
,2011,50100919,,,,1,0,1
,2011,50100940,,,,1,1,2
,2011,50100944,,,,3,4,7
HND-004107,2011,50100965,,,,1,0,1
,2011,50101037,,,,1,0,1
,2011,50101042,,,,6,7,13
,2011,50101058,,,,0,2,2
,2011,50101170,,,,4,10,14
,2011,50101171,,,,3,1,4
,2011,50101177,,,,1,1,2
,2011,50101194,,,,2,2,4
,2011,50101202,,,,0,1,1
,2011,50101257,,,,1,9,10
,2011,50101264,,,,0,3,3
,2011,50101277,,,,20,6,26
,2011,50101282,,,,0,2,2
HND-003843,2011,50100007,,,,20,15,35
,2011,50100009,,,,1,1,2
,2011,50100011,,,,2,2,4
HND-003846,2011,50100013,,,,4,5,9
,2011,50100015,,,,1,1,2
,2011,50100038,,,,0,18,18
,2011,50100040,,,,1,0,1
,2011,50100058,,,,2,2,4
HND-003881,2011,50100061,,,,8,8,16
HND-003883,2011,50100063,,,,4,5,9
HND-003885,2011,50100066,,,,22,27,49
HND-003904,2011,50100087,,,,13,12,25
,2011,50100130,,,,7,1,8
,2011,50100133,,,,2,1,3
,2011,50100149,,,,11,13,24
,2011,50100154,,,,5,6,11
,2011,50100156,,,,3,1,4
,2011,50100157,,,,1,1,2
,2011,50100173,,,,9,8,17
,2011,50100179,,,,7,5,12
HND-003953,2011,50100180,,,,9,11,20
,2011,50100187,,,,2,2,4
HND-003957,2011,50100193,,,,12,13,25
HND-003958,2011,50100195,,,,17,20,37
,2011,50100198,,,,19,18,37
HND-003965,2011,50100214,,,,3,9,12
,2011,50100217,,,,6,3,9
HND-003975,2011,50100261,,,,12,8,20
,2011,50100266,,,,11,17,28
HND-003978,2011,50100276,,,,25,19,44
HND-003981,2011,50100280,,,,4,11,15
HND-003983,2011,50100286,,,,12,13,25
HND-003984,2011,50100293,,,,13,3,16
,2011,50100294,,,,1,3,4
,2011,50100295,,,,2,3,5
,2011,50100313,,,,5,10,15
HND-003993,2011,50100314,,,,3,2,5
,2011,50100327,,,,8,3,11
,2011,50100338,,,,8,11,19
,2011,50100346,,,,11,7,18
HND-004009,2011,50100357,,,,3,4,7
,2011,50100370,,,,7,6,13
HND-004017,2011,50100409,,,,16,20,36
HND-004018,2011,50100411,,,,5,10,15
HND-004019,2011,50100412,,,,4,7,11
,2011,50100426,,,,12,11,23
,2011,50100428,,,,19,18,37
,2011,50100429,,,,7,13,20
,2011,50100430,,,,13,14,27
,2011,50100431,,,,8,14,22
,2011,50100436,,,,7,7,14
,2011,50100443,,,,21,18,39
,2011,50100446,,,,2,0,2
HND-004027,2011,50100457,,,,5,3,8
,2011,50100468,,,,1,3,4
,2011,50100469,,,,5,3,8
,2011,50100470,,,,12,14,26
,2011,50100475,,,,1,0,1
,2011,50100476,,,,50,57,107
,2011,50100477,,,,30,25,55
,2011,50100478,,,,3,4,7
,2011,50100483,,,,11,5,16
HND-004028,2011,50100486,,,,2,3,5
HND-004031,2011,50100489,,,,3,5,8
,2011,50100493,,,,27,34,61
,2011,50100499,,,,29,27,56
,2011,50100500,,,,36,19,55
HND-004036,2011,50100502,,,,21,17,38
HND-004037,2011,50100503,,,,10,16,26
,2011,50100512,,,,4,1,5
,2011,50100515,,,,4,0,4
,2011,50100517,,,,16,18,34
,2011,50100521,,,,2,1,3
,2011,50100525,,,,27,35,62
,2011,50100526,,,,9,5,14
,2011,50100528,,,,9,7,16
,2011,50100531,,,,8,15,23
,2011,50100544,,,,3,2,5
,2011,50100547,,,,10,10,20
,2011,50100549,,,,9,9,18
,2011,50100554,,,,3,1,4
,2011,50100557,,,,10,10,20
,2011,50100585,,,,24,24,48
,2011,50100586,,,,12,23,35
,2011,50100600,,,,4,4,8
,2011,50100616,,,,4,3,7
,2011,50100619,,,,3,5,8
,2011,50100620,,,,16,9,25
,2011,50100621,,,,3,3,6
HND-004065,2011,50100631,,,,20,109,129
,2011,50100643,,,,6,7,13
,2011,50100655,,,,6,5,11
,2011,50100659,,,,2,5,7
,2011,50100674,,,,7,6,13
,2011,50100686,,,,10,13,23
,2011,50100688,,,,1,0,1
,2011,50100689,,,,14,18,32
,2011,50100691,,,,2,2,4
,2011,50100697,,,,3,0,3
,2011,50100709,,,,9,10,19
,2011,50100710,,,,8,6,14
,2011,50100714,,,,0,4,4
,2011,50100717,,,,4,0,4
,2011,50100772,,,,2,0,2
HND-004081,2011,50100780,,,,2,2,4
,2011,50100792,,,,3,1,4
,2011,50100798,,,,2,3,5
,2011,50100819,,,,30,39,69
,2011,50100823,,,,5,4,9
,2011,50100824,,,,4,2,6
,2011,50100827,,,,6,1,7
,2011,50100832,,,,4,3,7
,2011,50100840,,,,17,14,31
,2011,50100849,,,,5,12,17
HND-004088,2011,50100851,,,,3,6,9
HND-004090,2011,50100854,,,,2,4,6
,2011,50100888,,,,9,10,19
,2011,50100911,,,,3,3,6
,2011,50100916,,,,1,2,3
,2011,50100918,,,,3,0,3
,2011,50100921,,,,6,3,9
,2011,50100923,,,,3,0,3
,2011,50100932,,,,1,2,3
HND-004102,2011,50100935,,,,24,16,40
,2011,50100939,,,,2,2,4
,2011,50100949,,,,0,3,3
,2011,50100951,,,,0,2,2
,2011,50100958,,,,11,12,23
HND-004111,2011,50100998,,,,4,2,6
,2011,50101037,,,,3,5,8
,2011,50101039,,,,1,2,3
,2011,50101040,,,,6,8,14
,2011,50101052,,,,2,3,5
,2011,50101057,,,,4,5,9
,2011,50101059,,,,5,1,6
,2011,50101064,,,,11,6,17
,2011,50101074,,,,10,3,13
HND-004132,2011,50101149,,,,8,4,12
,2011,50101170,,,,5,5,10
,2011,50101171,,,,1,3,4
,2011,50101174,,,,4,3,7
,2011,50101176,,,,0,4,4
,2011,50101177,,,,2,1,3
,2011,50101182,,,,19,15,34
HND-004137,2011,50101193,,,,2,1,3
,2011,50101198,,,,9,8,17
,2011,50101199,,,,4,4,8
,2011,50101259,,,,1,1,2
,2011,50101262,,,,1,1,2
,2011,50101264,,,,6,7,13
,2011,50101275,,,,5,1,6
,2011,50101276,,,,3,3,6
,2011,50101277,,,,20,22,42
,2011,50101282,,,,2,8,10
,2011,50101293,,,,3,7,10
HND-003845,2011,50100010,,,,10,8,18
,2011,50100012,,,,11,9,20
,2011,50100014,,,,5,0,5
HND-003847,2011,50100017,,,,6,6,12
HND-003858,2011,50100032,,,,0,2,2
,2011,50100038,,,,0,36,36
HND-003867,2011,50100044,,,,8,10,18
HND-003877,2011,50100055,,,,5,2,7
,2011,50100059,,,,3,2,5
HND-003882,2011,50100062,,,,4,4,8
,2011,50100110,,,,12,16,28
,2011,50100112,,,,2,4,6
HND-003925,2011,50100114,,,,0,3,3
,2011,50100117,,,,12,21,33
,2011,50100121,,,,5,1,6
,2011,50100124,,,,4,2,6
,2011,50100135,,,,12,4,16
,2011,50100145,,,,1,0,1
,2011,50100147,,,,7,3,10
,2011,50100150,,,,39,54,93
HND-003951,2011,50100174,,,,1,0,1
,2011,50100175,,,,8,13,21
HND-003954,2011,50100182,,,,4,8,12
HND-003955,2011,50100184,,,,14,14,28
HND-003961,2011,50100201,,,,11,14,25
HND-003963,2011,50100206,,,,11,4,15
,2011,50100207,,,,2,2,4
,2011,50100211,,,,1,1,2
,2011,50100213,,,,4,2,6
,2011,50100220,,,,7,5,12
,2011,50100221,,,,18,13,31
,2011,50100224,,,,12,12,24
,2011,50100239,,,,2,2,4
HND-003973,2011,50100250,,,,12,12,24
HND-003974,2011,50100253,,,,13,12,25
HND-003976,2011,50100262,,,,5,5,10
,2011,50100269,,,,7,8,15
,2011,50100270,,,,4,3,7
,2011,50100271,,,,13,7,20
,2011,50100275,,,,6,2,8
,2011,50100278,,,,5,2,7
,2011,50100292,,,,1,1,2
HND-003989,2011,50100304,,,,10,5,15
HND-003990,2011,50100307,,,,9,12,21
,2011,50100308,,,,4,8,12
,2011,50100335,,,,4,3,7
HND-004005,2011,50100342,,,,8,12,20
,2011,50100348,,,,4,0,4
,2011,50100352,,,,15,14,29
,2011,50100354,,,,12,12,24
,2011,50100369,,,,3,3,6
,2011,50100371,,,,4,3,7
HND-004015,2011,50100374,,,,5,8,13
,2011,50100400,,,,12,6,18
,2011,50100403,,,,2,2,4
,2011,50100404,,,,20,15,35
,2011,50100416,,,,0,1,1
,2011,50100419,,,,8,4,12
,2011,50100420,,,,6,7,13
,2011,50100421,,,,7,9,16
HND-004021,2011,50100422,,,,12,13,25
,2011,50100423,,,,4,1,5
,2011,50100433,,,,8,11,19
,2011,50100438,,,,6,9,15
,2011,50100445,,,,14,19,33
HND-004023,2011,50100447,,,,1,1,2
,2011,50100448,,,,1,5,6
HND-004026,2011,50100453,,,,6,6,12
,2011,50100455,,,,9,5,14
,2011,50100456,,,,2,1,3
,2011,50100459,,,,13,12,25
,2011,50100461,,,,2,5,7
,2011,50100467,,,,3,0,3
,2011,50100471,,,,2,0,2
,2011,50100472,,,,4,5,9
,2011,50100485,,,,1,2,3
HND-004029,2011,50100487,,,,11,20,31
HND-004032,2011,50100490,,,,7,2,9
,2011,50100491,,,,19,17,36
HND-004034,2011,50100494,,,,13,13,26
,2011,50100496,,,,48,42,90
,2011,50100497,,,,16,14,30
,2011,50100508,,,,3,3,6
,2011,50100519,,,,3,4,7
,2011,50100522,,,,5,5,10
,2011,50100527,,,,6,4,10
HND-004041,2011,50100532,,,,1,2,3
,2011,50100542,,,,6,13,19
,2011,50100543,,,,14,11,25
,2011,50100568,,,,5,7,12
,2011,50100573,,,,6,11,17
,2011,50100580,,,,0,1,1
,2011,50100588,,,,4,7,11
,2011,50100589,,,,1,0,1
HND-004059,2011,50100595,,,,1,4,5
,2011,50100598,,,,2,1,3
,2011,50100618,,,,7,15,22
,2011,50100651,,,,1,2,3
,2011,50100653,,,,2,0,2
,2011,50100665,,,,2,4,6
,2011,50100666,,,,6,2,8
,2011,50100680,,,,3,7,10
,2011,50100693,,,,4,10,14
,2011,50100698,,,,13,5,18
HND-004069,2011,50100699,,,,5,2,7
HND-004070,2011,50100702,,,,14,11,25
,2011,50100703,,,,7,5,12
,2011,50100705,,,,11,9,20
,2011,50100711,,,,1,1,2
,2011,50100712,,,,13,11,24
,2011,50100713,,,,4,11,15
HND-004076,2011,50100756,,,,5,5,10
,2011,50100792,,,,3,2,5
,2011,50100808,,,,11,13,24
,2011,50100816,,,,3,2,5
,2011,50100818,,,,5,4,9
,2011,50100822,,,,4,7,11
,2011,50100831,,,,3,2,5
,2011,50100834,,,,6,7,13
,2011,50100848,,,,0,3,3
,2011,50100852,,,,6,8,14
,2011,50100859,,,,4,3,7
,2011,50100863,,,,1,2,3
,2011,50100897,,,,2,3,5
,2011,50100912,,,,4,1,5
,2011,50100924,,,,2,3,5
,2011,50100934,,,,9,10,19
,2011,50100936,,,,7,1,8
,2011,50100940,,,,0,1,1
,2011,50100941,,,,1,1,2
,2011,50100954,,,,0,2,2
HND-004106,2011,50100963,,,,0,3,3
HND-004107,2011,50100965,,,,5,1,6
HND-004108,2011,50100973,,,,43,43,86
HND-004110,2011,50100986,,,,1,1,2
,2011,50100999,,,,0,4,4
,2011,50101042,,,,15,10,25
,2011,50101044,,,,1,1,2
,2011,50101045,,,,2,0,2
,2011,50101046,,,,2,2,4
,2011,50101047,,,,13,7,20
,2011,50101053,,,,6,2,8
,2011,50101058,,,,5,8,13
HND-004117,2011,50101062,,,,6,4,10
,2011,50101072,,,,12,7,19
HND-004118,2011,50101082,,,,0,2,2
,2011,50101084,,,,3,3,6
,2011,50101088,,,,2,4,6
HND-004122,2011,50101108,,,,7,6,13
,2011,50101122,,,,5,11,16
HND-004131,2011,50101146,,,,3,0,3
,2011,50101166,,,,1,1,2
,2011,50101168,,,,7,7,14
,2011,50101179,,,,0,2,2
,2011,50101194,,,,3,7,10
,2011,50101195,,,,3,4,7
,2011,50101196,,,,9,1,10
,2011,50101197,,,,0,3,3
,2011,50101200,,,,7,5,12
,2011,50101202,,,,9,5,14
,2011,50101256,,,,2,2,4
,2011,50101257,,,,1,6,7
,2011,50101258,,,,4,0,4
,2011,50101260,,,,1,4,5
,2011,50101261,,,,1,5,6
,2011,50101265,,,,7,3,10
,2011,50101266,,,,5,6,11
,2011,50101279,,,,2,4,6
,2011,50100009,,,,6,13,19
HND-003845,2011,50100010,,,,11,6,17
,2011,50100012,,,,15,17,32
HND-003846,2011,50100013,,,,22,19,41
,2011,50100014,,,,5,3,8
HND-003857,2011,50100031,,,,27,36,63
HND-003858,2011,50100032,,,,9,9,18
,2011,50100038,,,,0,66,66
,2011,50100038,,,,0,7,7
,2011,50100039,,,,0,25,25
HND-003867,2011,50100044,,,,15,10,25
HND-003869,2011,50100046,,,,45,37,82
HND-003877,2011,50100055,,,,19,21,40
,2011,50100058,,,,25,19,44
,2011,50100059,,,,7,7,14
HND-003882,2011,50100062,,,,48,37,85
HND-003883,2011,50100063,,,,15,9,24
HND-003907,2011,50100090,,,,18,18,36
HND-003909,2011,50100092,,,,37,41,78
,2011,50100110,,,,27,16,43
HND-003925,2011,50100114,,,,14,17,31
,2011,50100117,,,,35,28,63
,2011,50100121,,,,6,8,14
,2011,50100124,,,,6,7,13
,2011,50100131,,,,4,2,6
,2011,50100134,,,,3,2,5
,2011,50100147,,,,12,8,20
,2011,50100149,,,,9,17,26
,2011,50100150,,,,41,47,88
,2011,50100156,,,,2,2,4
HND-003949,2011,50100167,,,,19,13,32
,2011,50100170,,,,4,1,5
,2011,50100171,,,,1,1,2
HND-003951,2011,50100174,,,,7,10,17
,2011,50100175,,,,19,5,24
HND-003954,2011,50100182,,,,6,8,14
HND-003959,2011,50100197,,,,19,21,40
HND-003960,2011,50100200,,,,40,28,68
HND-003962,2011,50100203,,,,25,19,44
,2011,50100213,,,,9,8,17
HND-003965,2011,50100214,,,,36,37,73
,2011,50100217,,,,6,12,18
,2011,50100258,,,,3,3,6
HND-003975,2011,50100261,,,,5,5,10
,2011,50100269,,,,5,12,17
,2011,50100270,,,,4,8,12
,2011,50100271,,,,17,13,30
,2011,50100272,,,,23,20,43
,2011,50100273,,,,1,4,5
,2011,50100275,,,,12,13,25
,2011,50100278,,,,7,12,19
,2011,50100292,,,,2,2,4
HND-003990,2011,50100307,,,,21,18,39
,2011,50100308,,,,2,6,8
HND-003991,2011,50100310,,,,25,20,45
,2011,50100313,,,,43,26,69
HND-003993,2011,50100314,,,,8,7,15
,2011,50100325,,,,3,5,8
,2011,50100327,,,,8,10,18
HND-003999,2011,50100331,,,,11,12,23
HND-004000,2011,50100334,,,,34,36,70
,2011,50100335,,,,6,6,12
,2011,50100339,,,,6,8,14
HND-004005,2011,50100342,,,,14,16,30
,2011,50100349,,,,14,15,29
,2011,50100352,,,,11,5,16
,2011,50100354,,,,18,16,34
,2011,50100371,,,,7,6,13
HND-004015,2011,50100374,,,,5,14,19
,2011,50100400,,,,25,17,42
,2011,50100403,,,,1,1,2
HND-004018,2011,50100411,,,,28,20,48
,2011,50100413,,,,5,7,12
,2011,50100415,,,,13,6,19
,2011,50100416,,,,2,3,5
,2011,50100419,,,,8,8,16
,2011,50100421,,,,13,12,25
HND-004021,2011,50100422,,,,56,42,98
,2011,50100423,,,,5,7,12
,2011,50100438,,,,17,15,32
,2011,50100445,,,,30,21,51
,2011,50100446,,,,11,7,18
HND-004023,2011,50100447,,,,16,15,31
,2011,50100448,,,,2,1,3
,2011,50100450,,,,7,5,12
HND-004026,2011,50100453,,,,3,11,14
,2011,50100455,,,,15,16,31
,2011,50100456,,,,2,3,5
,2011,50100458,,,,4,4,8
,2011,50100459,,,,22,18,40
,2011,50100461,,,,5,11,16
,2011,50100467,,,,2,6,8
,2011,50100472,,,,3,2,5
,2011,50100485,,,,1,5,6
HND-004029,2011,50100487,,,,51,29,80
HND-004030,2011,50100488,,,,11,12,23
,2011,50100491,,,,31,23,54
HND-004033,2011,50100492,,,,39,38,77
,2011,50100493,,,,43,48,91
HND-004034,2011,50100494,,,,35,21,56
,2011,50100496,,,,40,57,97
,2011,50100497,,,,11,15,26
,2011,50100500,,,,29,33,62
HND-004035,2011,50100501,,,,37,35,72
,2011,50100508,,,,7,4,11
,2011,50100516,,,,6,6,12
,2011,50100519,,,,6,8,14
HND-004038,2011,50100520,,,,38,40,78
,2011,50100521,,,,2,1,3
,2011,50100522,,,,8,11,19
HND-004040,2011,50100523,,,,29,25,54
,2011,50100527,,,,10,4,14
HND-004041,2011,50100532,,,,6,8,14
,2011,50100541,,,,2,2,4
,2011,50100542,,,,12,14,26
,2011,50100543,,,,11,19,30
,2011,50100544,,,,7,4,11
,2011,50100549,,,,7,8,15
,2011,50100573,,,,1,14,15
,2011,50100580,,,,6,6,12
,2011,50100589,,,,7,5,12
,2011,50100598,,,,8,8,16
,2011,50100600,,,,8,5,13
,2011,50100621,,,,10,3,13
,2011,50100636,,,,0,1,1
,2011,50100643,,,,7,14,21
,2011,50100651,,,,4,7,11
,2011,50100653,,,,1,0,1
,2011,50100659,,,,4,2,6
,2011,50100660,,,,12,11,23
,2011,50100680,,,,6,10,16
HND-004067,2011,50100685,,,,20,20,40
,2011,50100689,,,,41,51,92
,2011,50100691,,,,17,17,34
,2011,50100693,,,,4,4,8
HND-004069,2011,50100699,,,,10,15,25
HND-004070,2011,50100702,,,,26,23,49
,2011,50100703,,,,6,11,17
,2011,50100705,,,,16,9,25
,2011,50100712,,,,18,18,36
,2011,50100713,,,,9,11,20
HND-004076,2011,50100756,,,,9,10,19
,2011,50100808,,,,21,24,45
,2011,50100818,,,,7,8,15
,2011,50100824,,,,1,1,2
,2011,50100829,,,,4,3,7
,2011,50100830,,,,1,2,3
,2011,50100832,,,,4,6,10
HND-004087,2011,50100844,,,,32,33,65
,2011,50100845,,,,5,5,10
,2011,50100846,,,,5,5,10
,2011,50100849,,,,33,33,66
HND-004088,2011,50100851,,,,33,29,62
,2011,50100863,,,,3,2,5
,2011,50100888,,,,3,3,6
,2011,50100919,,,,2,0,2
,2011,50100924,,,,3,5,8
,2011,50100934,,,,10,12,22
,2011,50100936,,,,8,3,11
,2011,50100939,,,,5,2,7
,2011,50100940,,,,3,10,13
,2011,50100941,,,,2,1,3
HND-004105,2011,50100950,,,,25,29,54
,2011,50100954,,,,7,5,12
,2011,50100956,,,,16,17,33
,2011,50100958,,,,11,18,29
HND-004106,2011,50100963,,,,17,23,40
HND-004107,2011,50100965,,,,22,23,45
HND-004108,2011,50100973,,,,62,53,115
HND-004110,2011,50100986,,,,11,12,23
,2011,50101039,,,,5,5,10
,2011,50101040,,,,6,12,18
,2011,50101045,,,,4,2,6
,2011,50101046,,,,10,8,18
,2011,50101052,,,,1,3,4
,2011,50101053,,,,5,3,8
,2011,50101059,,,,4,0,4
HND-004117,2011,50101062,,,,8,9,17
,2011,50101074,,,,5,2,7
,2011,50101083,,,,13,18,31
HND-004122,2011,50101108,,,,5,4,9
,2011,50101122,,,,18,22,40
HND-004131,2011,50101146,,,,11,12,23
,2011,50101165,,,,1,7,8
,2011,50101166,,,,7,6,13
,2011,50101167,,,,4,3,7
,2011,50101170,,,,7,6,13
,2011,50101176,,,,3,4,7
,2011,50101178,,,,2,1,3
,2011,50101179,,,,1,3,4
,2011,50101194,,,,7,3,10
,2011,50101197,,,,3,3,6
,2011,50101202,,,,8,10,18
,2011,50101256,,,,2,4,6
,2011,50101257,,,,3,5,8
,2011,50101265,,,,14,18,32
,2011,50101266,,,,6,12,18
,2011,50101275,,,,9,8,17
,2011,50101276,,,,6,3,9
,2011,50101278,,,,4,7,11
HND-003843,2011,50100007,,,,42,45,87
,2011,50100011,,,,5,5,10
,2011,50100015,,,,8,2,10
HND-003847,2011,50100017,,,,18,18,36
HND-003850,2011,50100021,,,,15,20,35
,2011,50100040,,,,0,6,6
HND-003881,2011,50100061,,,,13,9,22
HND-003885,2011,50100066,,,,32,28,60
HND-003887,2011,50100068,,,,22,30,52
HND-003889,2011,50100070,,,,23,18,41
HND-003890,2011,50100071,,,,16,16,32
HND-003904,2011,50100087,,,,33,27,60
HND-003921,2011,50100107,,,,23,21,44
,2011,50100112,,,,18,16,34
,2011,50100130,,,,8,2,10
,2011,50100133,,,,8,7,15
,2011,50100135,,,,7,17,24
HND-003937,2011,50100139,,,,17,16,33
,2011,50100145,,,,2,1,3
,2011,50100154,,,,16,12,28
,2011,50100157,,,,6,9,15
,2011,50100159,,,,18,21,39
,2011,50100173,,,,17,23,40
,2011,50100179,,,,11,9,20
HND-003953,2011,50100180,,,,13,23,36
,2011,50100181,,,,5,0,5
HND-003955,2011,50100184,,,,48,52,100
,2011,50100187,,,,9,11,20
HND-003957,2011,50100193,,,,21,24,45
HND-003958,2011,50100195,,,,66,57,123
,2011,50100198,,,,12,26,38
HND-003961,2011,50100201,,,,23,17,40
HND-003963,2011,50100206,,,,15,13,28
,2011,50100207,,,,16,12,28
,2011,50100211,,,,18,20,38
,2011,50100216,,,,2,1,3
,2011,50100220,,,,8,8,16
,2011,50100221,,,,12,18,30
,2011,50100224,,,,7,8,15
,2011,50100239,,,,1,3,4
HND-003969,2011,50100243,,,,36,35,71
,2011,50100246,,,,9,27,36
HND-003973,2011,50100250,,,,10,12,22
HND-003974,2011,50100253,,,,54,44,98
,2011,50100254,,,,30,30,60
HND-003976,2011,50100262,,,,39,43,82
,2011,50100264,,,,15,25,40
,2011,50100266,,,,19,16,35
HND-003978,2011,50100276,,,,41,40,81
HND-003980,2011,50100279,,,,14,20,34
HND-003981,2011,50100280,,,,25,15,40
HND-003982,2011,50100283,,,,41,47,88
HND-003983,2011,50100286,,,,48,45,93
HND-003984,2011,50100293,,,,19,8,27
,2011,50100294,,,,6,9,15
,2011,50100295,,,,7,5,12
HND-003988,2011,50100302,,,,17,18,35
HND-003989,2011,50100304,,,,9,11,20
HND-003992,2011,50100312,,,,9,10,19
,2011,50100317,,,,20,21,41
HND-003994,2011,50100319,,,,25,18,43
HND-003995,2011,50100321,,,,23,27,50
HND-003997,2011,50100324,,,,12,18,30
HND-003998,2011,50100329,,,,49,41,90
,2011,50100338,,,,9,17,26
,2011,50100346,,,,11,8,19
,2011,50100348,,,,4,0,4
HND-004009,2011,50100357,,,,24,26,50
,2011,50100369,,,,15,22,37
,2011,50100370,,,,6,8,14
,2011,50100392,,,,28,33,61
,2011,50100404,,,,20,14,34
HND-004017,2011,50100409,,,,48,40,88
HND-004019,2011,50100412,,,,29,16,45
,2011,50100420,,,,20,16,36
,2011,50100426,,,,11,11,22
,2011,50100428,,,,20,16,36
,2011,50100429,,,,12,11,23
,2011,50100430,,,,11,17,28
,2011,50100431,,,,12,13,25
,2011,50100433,,,,10,8,18
,2011,50100436,,,,8,7,15
HND-004022,2011,50100437,,,,19,33,52
,2011,50100443,,,,20,22,42
,2011,50100444,,,,6,6,12
HND-004027,2011,50100457,,,,35,26,61
,2011,50100468,,,,10,3,13
,2011,50100469,,,,8,2,10
,2011,50100470,,,,12,11,23
,2011,50100475,,,,5,8,13
,2011,50100476,,,,52,48,100
,2011,50100477,,,,22,20,42
,2011,50100478,,,,4,4,8
,2011,50100481,,,,15,14,29
,2011,50100483,,,,6,11,17
,2011,50100484,,,,2,2,4
HND-004028,2011,50100486,,,,6,9,15
HND-004031,2011,50100489,,,,28,24,52
HND-004032,2011,50100490,,,,20,17,37
,2011,50100499,,,,21,32,53
HND-004036,2011,50100502,,,,33,26,59
HND-004037,2011,50100503,,,,12,12,24
,2011,50100512,,,,6,3,9
,2011,50100515,,,,10,7,17
,2011,50100517,,,,14,27,41
,2011,50100525,,,,44,43,87
,2011,50100526,,,,8,10,18
,2011,50100528,,,,15,7,22
,2011,50100531,,,,12,20,32
,2011,50100535,,,,2,2,4
,2011,50100547,,,,20,14,34
,2011,50100554,,,,7,11,18
,2011,50100557,,,,25,22,47
HND-004053,2011,50100563,,,,23,17,40
,2011,50100568,,,,26,12,38
,2011,50100585,,,,34,15,49
,2011,50100586,,,,18,19,37
,2011,50100588,,,,6,5,11
HND-004059,2011,50100595,,,,19,6,25
,2011,50100616,,,,7,4,11
,2011,50100618,,,,9,16,25
,2011,50100619,,,,6,9,15
,2011,50100620,,,,14,7,21
HND-004065,2011,50100631,,,,118,180,298
,2011,50100655,,,,12,10,22
,2011,50100666,,,,9,17,26
,2011,50100674,,,,4,8,12
,2011,50100686,,,,26,23,49
,2011,50100688,,,,7,5,12
,2011,50100697,,,,4,3,7
,2011,50100698,,,,23,28,51
,2011,50100709,,,,14,20,34
,2011,50100710,,,,6,8,14
,2011,50100711,,,,2,2,4
,2011,50100714,,,,2,5,7
,2011,50100717,,,,12,17,29
HND-004075,2011,50100736,,,,57,28,85
,2011,50100743,,,,40,41,81
,2011,50100772,,,,2,2,4
HND-004081,2011,50100780,,,,12,12,24
,2011,50100792,,,,5,7,12
,2011,50100792,,,,17,23,40
,2011,50100798,,,,5,6,11
HND-004086,2011,50100810,,,,34,36,70
,2011,50100819,,,,40,52,92
,2011,50100820,,,,21,16,37
,2011,50100822,,,,10,11,21
,2011,50100823,,,,14,14,28
,2011,50100827,,,,6,4,10
,2011,50100831,,,,3,8,11
,2011,50100834,,,,4,8,12
,2011,50100840,,,,17,21,38
,2011,50100848,,,,9,7,16
HND-004090,2011,50100854,,,,17,9,26
,2011,50100859,,,,6,5,11
HND-004094,2011,50100880,,,,9,12,21
,2011,50100891,,,,1,1,2
,2011,50100897,,,,4,4,8
,2011,50100911,,,,15,8,23
,2011,50100912,,,,2,6,8
,2011,50100916,,,,5,9,14
,2011,50100918,,,,3,3,6
,2011,50100921,,,,3,6,9
,2011,50100923,,,,2,7,9
,2011,50100932,,,,7,7,14
HND-004102,2011,50100935,,,,25,25,50
,2011,50100949,,,,2,8,10
,2011,50100951,,,,7,1,8
,2011,50100969,,,,6,17,23
,2011,50100983,,,,3,2,5
HND-004111,2011,50100998,,,,43,31,74
,2011,50100999,,,,11,9,20
,2011,50101037,,,,2,3,5
,2011,50101042,,,,12,15,27
,2011,50101044,,,,5,4,9
,2011,50101047,,,,14,17,31
,2011,50101055,,,,11,12,23
,2011,50101057,,,,11,10,21
,2011,50101058,,,,8,6,14
,2011,50101064,,,,3,4,7
,2011,50101072,,,,5,6,11
HND-004118,2011,50101082,,,,25,33,58
,2011,50101084,,,,10,10,20
,2011,50101088,,,,3,4,7
HND-004132,2011,50101149,,,,5,5,10
,2011,50101171,,,,4,3,7
,2011,50101174,,,,3,5,8
,2011,50101177,,,,4,2,6
,2011,50101182,,,,13,22,35
HND-004135,2011,50101191,,,,42,51,93
HND-004136,2011,50101192,,,,32,28,60
HND-004137,2011,50101193,,,,2,9,11
,2011,50101195,,,,1,4,5
,2011,50101196,,,,4,3,7
,2011,50101199,,,,4,8,12
,2011,50101200,,,,0,2,2
,2011,50101258,,,,1,1,2
,2011,50101260,,,,0,4,4
,2011,50101262,,,,0,1,1
,2011,50101264,,,,6,13,19
,2011,50101277,,,,31,31,62
,2011,50101279,,,,3,2,5
,2011,50101282,,,,7,2,9
,2011,50101293,,,,3,4,7
HND-003842,2011,50100006,,,,10,10,20
HND-003844,2011,50100008,,,,5,2,7
,2011,50100009,,,,18,10,28
HND-003845,2011,50100010,,,,14,14,28
,2011,50100011,,,,8,9,17
HND-003846,2011,50100013,,,,44,34,78
,2011,50100015,,,,3,1,4
,2011,50100016,,,,9,10,19
HND-003848,2011,50100018,,,,121,115,236
HND-003849,2011,50100020,,,,10,4,14
HND-003851,2011,50100022,,,,54,46,100
HND-003853,2011,50100025,,,,62,74,136
,2011,50100035,,,,18,11,29
HND-003862,2011,50100036,,,,42,33,75
,2011,50100038,,,,0,18,18
,2011,50100040,,,,2,2,4
HND-003865,2011,50100042,,,,83,93,176
HND-003866,2011,50100043,,,,69,75,144
HND-003869,2011,50100046,,,,111,114,225
HND-003871,2011,50100048,,,,20,23,43
HND-003874,2011,50100051,,,,51,49,100
HND-003879,2011,50100057,,,,13,13,26
,2011,50100058,,,,59,46,105
HND-003881,2011,50100061,,,,37,37,74
HND-003882,2011,50100062,,,,117,129,246
HND-003883,2011,50100063,,,,28,12,40
HND-003887,2011,50100068,,,,33,37,70
HND-003888,2011,50100069,,,,92,91,183
HND-003889,2011,50100070,,,,47,46,93
HND-003892,2011,50100073,,,,6,4,10
HND-003894,2011,50100075,,,,8,8,16
HND-003895,2011,50100076,,,,2,3,5
,2011,50100079,,,,45,37,82
HND-003898,2011,50100080,,,,84,75,159
HND-003900,2011,50100082,,,,5,7,12
HND-003902,2011,50100084,,,,33,28,61
HND-003904,2011,50100087,,,,59,59,118
HND-003907,2011,50100090,,,,53,41,94
HND-003908,2011,50100091,,,,3,3,6
HND-003912,2011,50100095,,,,35,44,79
HND-003913,2011,50100096,,,,44,41,85
HND-003915,2011,50100098,,,,6,11,17
HND-003916,2011,50100101,,,,68,66,134
HND-003918,2011,50100104,,,,66,69,135
HND-003919,2011,50100105,,,,28,23,51
HND-003920,2011,50100106,,,,60,59,119
HND-003921,2011,50100107,,,,61,55,116
,2011,50100110,,,,26,26,52
,2011,50100112,,,,28,18,46
HND-003924,2011,50100113,,,,61,66,127
HND-003925,2011,50100114,,,,46,57,103
HND-003926,2011,50100115,,,,111,113,224
HND-003927,2011,50100116,,,,34,51,85
,2011,50100117,,,,27,19,46
,2011,50100121,,,,8,7,15
HND-003931,2011,50100123,,,,56,63,119
HND-003932,2011,50100126,,,,17,17,34
HND-003933,2011,50100127,,,,94,92,186
,2011,50100133,,,,15,16,31
HND-003936,2011,50100138,,,,42,34,76
HND-003937,2011,50100139,,,,23,30,53
HND-003939,2011,50100142,,,,6,3,9
,2011,50100149,,,,13,9,22
,2011,50100150,,,,49,45,94
HND-003944,2011,50100151,,,,36,31,67
,2011,50100154,,,,21,17,38
,2011,50100156,,,,2,2,4
,2011,50100157,,,,17,8,25
HND-003947,2011,50100161,,,,94,99,193
,2011,50100163,,,,5,2,7
HND-003948,2011,50100165,,,,14,13,27
,2011,50100166,,,,62,64,126
HND-003949,2011,50100167,,,,23,21,44
,2011,50100171,,,,4,5,9
HND-003951,2011,50100174,,,,11,18,29
,2011,50100175,,,,10,11,21
HND-003953,2011,50100180,,,,16,23,39
,2011,50100181,,,,5,4,9
,2011,50100187,,,,21,12,33
,2011,50100198,,,,23,15,38
,2011,50100220,,,,13,18,31
,2011,50100237,,,,17,22,39
HND-003969,2011,50100243,,,,43,51,94
HND-003977,2011,50100268,,,,42,38,80
HND-003979,2011,50100277,,,,3,3,6
,2011,50100289,,,,5,5,10
,2011,50100295,,,,16,9,25
HND-003985,2011,50100296,,,,13,19,32
HND-003993,2011,50100314,,,,11,13,24
,2011,50100325,,,,4,2,6
,2011,50100327,,,,8,8,16
HND-004001,2011,50100336,,,,34,34,68
,2011,50100338,,,,16,9,25
HND-004004,2011,50100341,,,,42,31,73
,2011,50100346,,,,12,12,24
,2011,50100347,,,,11,4,15
HND-004008,2011,50100356,,,,24,19,43
HND-004010,2011,50100363,,,,29,17,46
HND-004011,2011,50100365,,,,44,51,95
,2011,50100413,,,,20,16,36
,2011,50100415,,,,6,1,7
,2011,50100425,,,,3,8,11
,2011,50100428,,,,25,25,50
,2011,50100429,,,,15,12,27
,2011,50100430,,,,11,17,28
,2011,50100436,,,,14,15,29
,2011,50100444,,,,8,5,13
,2011,50100445,,,,18,15,33
,2011,50100446,,,,11,16,27
,2011,50100450,,,,6,3,9
HND-004025,2011,50100451,,,,20,18,38
,2011,50100461,,,,3,7,10
,2011,50100475,,,,10,5,15
,2011,50100476,,,,48,44,92
,2011,50100478,,,,10,5,15
,2011,50100481,,,,15,15,30
,2011,50100484,,,,1,1,2
,2011,50100485,,,,1,4,5
,2011,50100493,,,,31,38,69
,2011,50100500,,,,41,28,69
,2011,50100508,,,,5,10,15
,2011,50100512,,,,4,3,7
,2011,50100517,,,,23,20,43
,2011,50100521,,,,2,3,5
HND-004040,2011,50100523,,,,47,47,94
,2011,50100525,,,,42,35,77
,2011,50100526,,,,6,8,14
,2011,50100531,,,,18,26,44
HND-004041,2011,50100532,,,,60,62,122
HND-004043,2011,50100536,,,,53,59,112
,2011,50100544,,,,4,4,8
HND-004047,2011,50100548,,,,57,33,90
,2011,50100549,,,,8,10,18
,2011,50100558,,,,25,25,50
,2011,50100559,,,,54,42,96
HND-004050,2011,50100560,,,,37,23,60
HND-004053,2011,50100563,,,,42,46,88
HND-004056,2011,50100567,,,,122,116,238
,2011,50100572,,,,4,4,8
,2011,50100589,,,,16,6,22
HND-004061,2011,50100597,,,,55,51,106
,2011,50100598,,,,12,10,22
,2011,50100600,,,,6,9,15
,2011,50100621,,,,11,9,20
,2011,50100636,,,,0,1,1
,2011,50100643,,,,9,11,20
,2011,50100651,,,,2,4,6
,2011,50100655,,,,17,18,35
,2011,50100659,,,,4,8,12
,2011,50100666,,,,11,4,15
,2011,50100673,,,,6,15,21
HND-004067,2011,50100685,,,,27,13,40
,2011,50100688,,,,7,1,8
,2011,50100689,,,,48,42,90
,2011,50100691,,,,19,20,39
,2011,50100697,,,,7,7,14
,2011,50100705,,,,12,13,25
,2011,50100709,,,,17,18,35
HND-004072,2011,50100716,,,,9,9,18
,2011,50100717,,,,70,63,133
,2011,50100772,,,,1,2,3
,2011,50100792,,,,36,45,81
,2011,50100820,,,,25,16,41
,2011,50100824,,,,8,1,9
,2011,50100827,,,,3,4,7
,2011,50100830,,,,1,1,2
,2011,50100832,,,,6,3,9
,2011,50100840,,,,12,17,29
,2011,50100888,,,,3,5,8
,2011,50100891,,,,0,1,1
,2011,50100897,,,,5,8,13
,2011,50100903,,,,3,4,7
,2011,50100918,,,,0,3,3
HND-004099,2011,50100920,,,,9,9,18
,2011,50100921,,,,3,6,9
,2011,50100939,,,,7,3,10
,2011,50100949,,,,5,5,10
,2011,50100951,,,,5,6,11
,2011,50100958,,,,22,9,31
,2011,50100983,,,,3,1,4
,2011,50101037,,,,9,5,14
,2011,50101040,,,,8,5,13
,2011,50101042,,,,12,11,23
,2011,50101055,,,,8,9,17
,2011,50101057,,,,15,10,25
,2011,50101164,,,,2,1,3
,2011,50101167,,,,7,12,19
,2011,50101169,,,,0,3,3
,2011,50101170,,,,2,4,6
,2011,50101171,,,,6,7,13
,2011,50101172,,,,2,2,4
,2011,50101174,,,,3,6,9
,2011,50101176,,,,3,1,4
,2011,50101177,,,,3,3,6
,2011,50101178,,,,3,3,6
,2011,50101183,,,,8,10,18
HND-004149,2011,50101244,,,,2,4,6
,2011,50101259,,,,1,0,1
,2011,50101264,,,,12,7,19
,2011,50101265,,,,25,7,32
,2011,50101266,,,,3,8,11
,2011,50101275,,,,7,7,14
,2011,50101276,,,,5,4,9
,2011,50101281,,,,6,8,14
,2011,50101282,,,,2,3,5
,2011,50101293,,,,4,2,6
HND-003838,2011,50100001,,,,97,85,182
HND-003839,2011,50100002,,,,1,4,5
,2011,50100003,,,,0,5,5
HND-003840,2011,50100004,,,,3,4,7
HND-003841,2011,50100005,,,,19,17,36
HND-003843,2011,50100007,,,,49,59,108
,2011,50100012,,,,14,15,29
,2011,50100014,,,,2,0,2
HND-003847,2011,50100017,,,,45,31,76
HND-003850,2011,50100021,,,,55,68,123
HND-003852,2011,50100024,,,,4,0,4
HND-003854,2011,50100027,,,,3,5,8
HND-003855,2011,50100028,,,,19,16,35
HND-003856,2011,50100029,,,,3,3,6
HND-003857,2011,50100031,,,,84,92,176
HND-003858,2011,50100032,,,,16,14,30
,2011,50100033,,,,6,11,17
HND-003860,2011,50100034,,,,59,54,113
HND-003863,2011,50100037,,,,18,21,39
,2011,50100039,,,,0,40,40
HND-003864,2011,50100041,,,,123,101,224
HND-003867,2011,50100044,,,,39,28,67
HND-003868,2011,50100045,,,,37,29,66
HND-003870,2011,50100047,,,,6,2,8
HND-003872,2011,50100049,,,,46,21,67
HND-003873,2011,50100050,,,,7,7,14
HND-003875,2011,50100052,,,,21,13,34
HND-003876,2011,50100053,,,,10,5,15
HND-003877,2011,50100055,,,,46,36,82
HND-003878,2011,50100056,,,,3,2,5
,2011,50100059,,,,16,9,25
HND-003880,2011,50100060,,,,12,8,20
HND-003884,2011,50100064,,,,52,47,99
HND-003885,2011,50100066,,,,82,61,143
HND-003886,2011,50100067,,,,38,49,87
HND-003890,2011,50100071,,,,26,29,55
HND-003891,2011,50100072,,,,9,9,18
HND-003893,2011,50100074,,,,0,5,5
HND-003896,2011,50100077,,,,76,69,145
HND-003897,2011,50100078,,,,66,52,118
HND-003901,2011,50100083,,,,82,76,158
,2011,50100085,,,,2,4,6
HND-003905,2011,50100088,,,,18,12,30
HND-003906,2011,50100089,,,,20,24,44
HND-003909,2011,50100092,,,,66,60,126
,2011,50100093,,,,5,2,7
HND-003911,2011,50100094,,,,8,2,10
HND-003914,2011,50100097,,,,6,8,14
,2011,50100099,,,,13,20,33
,2011,50100100,,,,8,8,16
,2011,50100102,,,,12,6,18
HND-003922,2011,50100108,,,,52,38,90
HND-003923,2011,50100109,,,,62,55,117
HND-003928,2011,50100118,,,,33,29,62
HND-003929,2011,50100119,,,,11,12,23
HND-003930,2011,50100120,,,,52,56,108
,2011,50100124,,,,13,14,27
,2011,50100129,,,,74,65,139
,2011,50100130,,,,15,1,16
,2011,50100131,,,,6,6,12
,2011,50100135,,,,8,9,17
HND-003934,2011,50100136,,,,18,21,39
HND-003935,2011,50100137,,,,53,37,90
HND-003938,2011,50100140,,,,52,50,102
HND-003940,2011,50100143,,,,9,5,14
HND-003941,2011,50100144,,,,21,19,40
,2011,50100145,,,,3,3,6
HND-003942,2011,50100146,,,,49,43,92
,2011,50100147,,,,7,7,14
HND-003943,2011,50100148,,,,59,66,125
HND-003945,2011,50100152,,,,3,3,6
,2011,50100159,,,,21,18,39
HND-003946,2011,50100160,,,,12,24,36
,2011,50100162,,,,1,2,3
,2011,50100168,,,,39,43,82
HND-003950,2011,50100169,,,,5,3,8
,2011,50100170,,,,2,5,7
,2011,50100173,,,,19,16,35
,2011,50100176,,,,2,5,7
HND-003952,2011,50100177,,,,8,0,8
,2011,50100178,,,,6,5,11
,2011,50100179,,,,7,9,16
HND-003959,2011,50100197,,,,34,43,77
HND-003961,2011,50100201,,,,45,21,66
HND-003964,2011,50100212,,,,55,39,94
,2011,50100213,,,,10,6,16
HND-003965,2011,50100214,,,,38,38,76
,2011,50100221,,,,14,22,36
,2011,50100227,,,,1,0,1
,2011,50100239,,,,2,1,3
,2011,50100245,,,,6,5,11
,2011,50100246,,,,18,19,37
HND-003973,2011,50100250,,,,16,24,40
,2011,50100258,,,,2,2,4
,2011,50100270,,,,7,6,13
,2011,50100273,,,,3,4,7
,2011,50100294,,,,10,7,17
HND-003986,2011,50100299,,,,5,4,9
HND-003996,2011,50100323,,,,38,42,80
HND-004002,2011,50100337,,,,58,49,107
HND-004003,2011,50100340,,,,3,0,3
,2011,50100352,,,,9,11,20
HND-004007,2011,50100353,,,,53,41,94
,2011,50100354,,,,12,17,29
HND-004009,2011,50100357,,,,33,36,69
HND-004012,2011,50100366,,,,21,19,40
HND-004013,2011,50100367,,,,23,23,46
,2011,50100371,,,,16,25,41
HND-004015,2011,50100374,,,,12,13,25
,2011,50100403,,,,3,1,4
,2011,50100404,,,,25,16,41
,2011,50100416,,,,5,11,16
,2011,50100418,,,,5,7,12
,2011,50100419,,,,8,9,17
,2011,50100420,,,,15,16,31
,2011,50100421,,,,8,8,16
,2011,50100423,,,,12,8,20
,2011,50100426,,,,13,16,29
,2011,50100431,,,,11,15,26
,2011,50100433,,,,9,15,24
,2011,50100438,,,,9,18,27
,2011,50100443,,,,14,19,33
,2011,50100448,,,,1,1,2
HND-004024,2011,50100449,,,,72,70,142
,2011,50100455,,,,6,9,15
,2011,50100458,,,,4,3,7
,2011,50100459,,,,14,14,28
,2011,50100467,,,,6,2,8
,2011,50100468,,,,7,2,9
,2011,50100469,,,,6,10,16
,2011,50100470,,,,8,8,16
,2011,50100477,,,,37,34,71
,2011,50100483,,,,11,10,21
,2011,50100497,,,,14,10,24
,2011,50100499,,,,27,26,53
,2011,50100515,,,,17,10,27
,2011,50100516,,,,10,5,15
,2011,50100527,,,,4,7,11
,2011,50100528,,,,11,12,23
HND-004042,2011,50100534,,,,77,55,132
,2011,50100535,,,,7,10,17
HND-004044,2011,50100537,,,,24,20,44
HND-004045,2011,50100538,,,,24,27,51
,2011,50100540,,,,48,32,80
,2011,50100543,,,,18,10,28
,2011,50100554,,,,8,10,18
HND-004051,2011,50100561,,,,58,50,108
,2011,50100564,,,,52,51,103
HND-004054,2011,50100565,,,,7,1,8
HND-004055,2011,50100566,,,,87,75,162
HND-004057,2011,50100570,,,,6,6,12
,2011,50100580,,,,7,5,12
,2011,50100585,,,,27,33,60
,2011,50100586,,,,14,17,31
,2011,50100588,,,,4,7,11
HND-004060,2011,50100596,,,,32,30,62
,2011,50100608,,,,1,0,1
HND-004063,2011,50100626,,,,18,22,40
,2011,50100653,,,,2,4,6
HND-004066,2011,50100678,,,,15,5,20
,2011,50100680,,,,6,12,18
,2011,50100692,,,,16,16,32
,2011,50100703,,,,4,4,8
HND-004071,2011,50100706,,,,36,29,65
,2011,50100710,,,,4,7,11
,2011,50100711,,,,3,2,5
,2011,50100712,,,,17,13,30
,2011,50100713,,,,14,3,17
,2011,50100714,,,,6,7,13
,2011,50100715,,,,28,12,40
HND-004077,2011,50100764,,,,3,3,6
,2011,50100771,,,,16,6,22
HND-004083,2011,50100788,,,,39,41,80
,2011,50100798,,,,15,13,28
,2011,50100808,,,,34,10,44
,2011,50100816,,,,2,1,3
,2011,50100818,,,,6,7,13
,2011,50100819,,,,31,42,73
,2011,50100822,,,,6,9,15
,2011,50100829,,,,0,2,2
,2011,50100831,,,,2,7,9
,2011,50100834,,,,7,10,17
,2011,50100845,,,,7,8,15
,2011,50100846,,,,8,7,15
,2011,50100848,,,,12,8,20
,2011,50100850,,,,15,13,28
,2011,50100852,,,,4,9,13
,2011,50100859,,,,10,3,13
,2011,50100863,,,,3,5,8
HND-004094,2011,50100880,,,,18,10,28
,2011,50100898,,,,1,1,2
HND-004096,2011,50100899,,,,24,16,40
HND-004098,2011,50100907,,,,55,38,93
,2011,50100911,,,,7,9,16
,2011,50100912,,,,6,8,14
,2011,50100916,,,,10,5,15
,2011,50100919,,,,3,1,4
,2011,50100923,,,,4,7,11
,2011,50100924,,,,3,2,5
,2011,50100931,,,,17,17,34
,2011,50100932,,,,5,7,12
,2011,50100936,,,,2,3,5
,2011,50100941,,,,4,6,10
,2011,50100944,,,,2,2,4
HND-004104,2011,50100947,,,,17,22,39
,2011,50101039,,,,10,7,17
,2011,50101044,,,,2,2,4
,2011,50101045,,,,4,6,10
,2011,50101046,,,,15,11,26
,2011,50101047,,,,12,14,26
,2011,50101053,,,,4,5,9
,2011,50101058,,,,6,11,17
,2011,50101059,,,,2,1,3
HND-004116,2011,50101061,,,,0,3,3
HND-004117,2011,50101062,,,,13,8,21
,2011,50101063,,,,6,5,11
,2011,50101064,,,,4,7,11
,2011,50101072,,,,11,10,21
,2011,50101074,,,,3,5,8
HND-004122,2011,50101108,,,,1,1,2
,2011,50101122,,,,11,17,28
,2011,50101165,,,,8,4,12
,2011,50101166,,,,21,14,35
,2011,50101168,,,,8,5,13
HND-004133,2011,50101173,,,,18,19,37
HND-004134,2011,50101175,,,,38,21,59
,2011,50101179,,,,2,6,8
,2011,50101181,,,,4,2,6
,2011,50101182,,,,15,19,34
,2011,50101194,,,,4,4,8
,2011,50101195,,,,1,1,2
,2011,50101197,,,,0,2,2
,2011,50101200,,,,1,4,5
,2011,50101258,,,,1,0,1
,2011,50101278,,,,10,15,25
,2011,50101279,,,,2,0,2
HND-003839,2011,50100002,,,,15,6,21
,2011,50100003,,,,3,2,5
HND-003840,2011,50100004,,,,3,4,7
HND-003841,2011,50100005,,,,21,14,35
,2011,50100009,,,,19,11,30
HND-003845,2011,50100010,,,,11,12,23
,2011,50100012,,,,18,7,25
HND-003846,2011,50100013,,,,44,41,85
,2011,50100014,,,,1,1,2
HND-003849,2011,50100020,,,,1,3,4
HND-003852,2011,50100024,,,,6,4,10
HND-003856,2011,50100029,,,,2,5,7
HND-003857,2011,50100031,,,,81,89,170
HND-003858,2011,50100032,,,,15,8,23
HND-003860,2011,50100034,,,,65,39,104
,2011,50100035,,,,4,9,13
,2011,50100038,,,,0,23,23
,2011,50100039,,,,0,34,34
HND-003864,2011,50100041,,,,114,85,199
HND-003865,2011,50100042,,,,71,54,125
HND-003866,2011,50100043,,,,55,47,102
HND-003867,2011,50100044,,,,31,41,72
HND-003868,2011,50100045,,,,15,20,35
HND-003869,2011,50100046,,,,116,120,236
HND-003870,2011,50100047,,,,10,7,17
HND-003874,2011,50100051,,,,48,37,85
HND-003875,2011,50100052,,,,14,16,30
HND-003877,2011,50100055,,,,40,38,78
HND-003878,2011,50100056,,,,9,9,18
HND-003879,2011,50100057,,,,15,14,29
,2011,50100058,,,,60,53,113
,2011,50100059,,,,11,13,24
HND-003880,2011,50100060,,,,10,6,16
HND-003882,2011,50100062,,,,146,117,263
HND-003883,2011,50100063,,,,25,8,33
HND-003884,2011,50100064,,,,35,36,71
HND-003888,2011,50100069,,,,93,78,171
HND-003891,2011,50100072,,,,20,13,33
HND-003892,2011,50100073,,,,4,3,7
HND-003893,2011,50100074,,,,2,4,6
,2011,50100079,,,,50,27,77
HND-003901,2011,50100083,,,,73,70,143
HND-003902,2011,50100084,,,,24,26,50
,2011,50100085,,,,3,1,4
HND-003905,2011,50100088,,,,2,3,5
HND-003906,2011,50100089,,,,39,20,59
HND-003907,2011,50100090,,,,48,49,97
HND-003908,2011,50100091,,,,11,4,15
HND-003909,2011,50100092,,,,57,59,116
,2011,50100093,,,,2,2,4
,2011,50100099,,,,13,5,18
,2011,50100102,,,,6,11,17
HND-003918,2011,50100104,,,,52,43,95
HND-003923,2011,50100109,,,,62,47,109
,2011,50100110,,,,19,20,39
HND-003924,2011,50100113,,,,78,84,162
HND-003925,2011,50100114,,,,45,33,78
HND-003926,2011,50100115,,,,103,102,205
,2011,50100117,,,,23,23,46
HND-003929,2011,50100119,,,,8,10,18
,2011,50100121,,,,6,3,9
,2011,50100124,,,,13,5,18
HND-003933,2011,50100127,,,,76,95,171
,2011,50100131,,,,8,3,11
HND-003934,2011,50100136,,,,8,12,20
HND-003938,2011,50100140,,,,24,37,61
HND-003940,2011,50100143,,,,6,7,13
HND-003942,2011,50100146,,,,40,33,73
,2011,50100147,,,,13,10,23
,2011,50100149,,,,14,9,23
,2011,50100150,,,,50,45,95
,2011,50100156,,,,3,4,7
,2011,50100163,,,,4,2,6
,2011,50100166,,,,47,47,94
HND-003949,2011,50100167,,,,16,14,30
HND-003950,2011,50100169,,,,3,5,8
,2011,50100170,,,,3,3,6
,2011,50100171,,,,5,3,8
HND-003951,2011,50100174,,,,11,11,22
,2011,50100175,,,,3,12,15
,2011,50100176,,,,2,2,4
HND-003952,2011,50100177,,,,2,3,5
,2011,50100178,,,,6,3,9
HND-003959,2011,50100197,,,,30,23,53
,2011,50100213,,,,4,8,12
HND-003965,2011,50100214,,,,42,40,82
,2011,50100227,,,,1,1,2
,2011,50100245,,,,5,7,12
,2011,50100258,,,,3,3,6
,2011,50100270,,,,6,5,11
,2011,50100273,,,,4,3,7
HND-003979,2011,50100277,,,,5,1,6
HND-003993,2011,50100314,,,,13,10,23
,2011,50100325,,,,4,2,6
,2011,50100327,,,,16,12,28
HND-004001,2011,50100336,,,,35,39,74
HND-004002,2011,50100337,,,,49,46,95
HND-004003,2011,50100340,,,,3,0,3
HND-004004,2011,50100341,,,,19,22,41
,2011,50100352,,,,5,9,14
,2011,50100354,,,,12,17,29
,2011,50100371,,,,13,15,28
HND-004015,2011,50100374,,,,16,8,24
,2011,50100404,,,,19,18,37
,2011,50100416,,,,9,3,12
,2011,50100418,,,,5,6,11
,2011,50100419,,,,5,7,12
,2011,50100420,,,,13,12,25
,2011,50100425,,,,1,6,7
,2011,50100445,,,,22,18,40
,2011,50100446,,,,15,9,24
,2011,50100448,,,,3,7,10
HND-004024,2011,50100449,,,,61,54,115
,2011,50100450,,,,2,3,5
HND-004025,2011,50100451,,,,10,16,26
,2011,50100455,,,,14,12,26
,2011,50100456,,,,4,3,7
,2011,50100458,,,,7,2,9
,2011,50100459,,,,21,18,39
,2011,50100467,,,,5,2,7
,2011,50100485,,,,5,4,9
,2011,50100493,,,,37,35,72
,2011,50100497,,,,12,10,22
,2011,50100500,,,,29,17,46
,2011,50100508,,,,3,7,10
,2011,50100516,,,,10,4,14
HND-004040,2011,50100523,,,,47,27,74
,2011,50100527,,,,7,5,12
HND-004041,2011,50100532,,,,50,30,80
HND-004045,2011,50100538,,,,31,19,50
,2011,50100543,,,,11,13,24
,2011,50100544,,,,5,4,9
HND-004047,2011,50100548,,,,28,31,59
,2011,50100549,,,,11,15,26
,2011,50100558,,,,16,12,28
HND-004050,2011,50100560,,,,38,24,62
,2011,50100564,,,,46,45,91
HND-004054,2011,50100565,,,,3,5,8
HND-004055,2011,50100566,,,,73,55,128
HND-004056,2011,50100567,,,,136,110,246
HND-004057,2011,50100570,,,,7,5,12
,2011,50100572,,,,3,3,6
,2011,50100580,,,,5,3,8
,2011,50100589,,,,13,5,18
,2011,50100598,,,,12,8,20
,2011,50100600,,,,13,5,18
,2011,50100621,,,,5,12,17
HND-004063,2011,50100626,,,,20,22,42
,2011,50100636,,,,0,2,2
,2011,50100643,,,,2,5,7
,2011,50100651,,,,2,1,3
,2011,50100653,,,,2,4,6
,2011,50100659,,,,5,7,12
,2011,50100680,,,,7,7,14
HND-004067,2011,50100685,,,,17,19,36
,2011,50100689,,,,30,35,65
,2011,50100691,,,,18,21,39
,2011,50100703,,,,5,3,8
HND-004071,2011,50100706,,,,22,19,41
,2011,50100712,,,,24,14,38
,2011,50100713,,,,5,10,15
,2011,50100715,,,,9,3,12
HND-004083,2011,50100788,,,,25,31,56
,2011,50100808,,,,19,20,39
,2011,50100818,,,,9,8,17
,2011,50100824,,,,3,3,6
,2011,50100829,,,,2,4,6
,2011,50100830,,,,0,1,1
,2011,50100832,,,,3,3,6
,2011,50100840,,,,25,18,43
,2011,50100845,,,,16,5,21
,2011,50100846,,,,5,2,7
,2011,50100863,,,,0,4,4
HND-004094,2011,50100880,,,,14,8,22
HND-004096,2011,50100899,,,,23,25,48
HND-004098,2011,50100907,,,,35,35,70
,2011,50100919,,,,2,1,3
HND-004099,2011,50100920,,,,10,8,18
,2011,50100924,,,,2,2,4
,2011,50100932,,,,2,3,5
,2011,50100939,,,,3,2,5
,2011,50100951,,,,3,6,9
,2011,50100983,,,,1,5,6
,2011,50101039,,,,11,11,22
,2011,50101040,,,,2,2,4
,2011,50101045,,,,3,1,4
,2011,50101046,,,,7,9,16
,2011,50101053,,,,1,2,3
,2011,50101059,,,,0,3,3
HND-004116,2011,50101061,,,,3,2,5
HND-004117,2011,50101062,,,,10,5,15
,2011,50101063,,,,2,3,5
,2011,50101122,,,,11,14,25
,2011,50101164,,,,1,1,2
,2011,50101169,,,,2,1,3
,2011,50101170,,,,5,3,8
,2011,50101172,,,,5,1,6
HND-004134,2011,50101175,,,,35,40,75
,2011,50101176,,,,0,2,2
,2011,50101178,,,,3,1,4
,2011,50101179,,,,4,0,4
,2011,50101256,,,,2,2,4
,2011,50101257,,,,1,1,2
,2011,50101265,,,,18,16,34
,2011,50101266,,,,6,3,9
,2011,50101275,,,,5,4,9
,2011,50101276,,,,2,4,6
,2011,50101278,,,,9,7,16
HND-003838,2011,50100001,,,,88,84,172
HND-003842,2011,50100006,,,,8,7,15
HND-003843,2011,50100007,,,,61,51,112
HND-003844,2011,50100008,,,,2,2,4
,2011,50100011,,,,14,14,28
,2011,50100015,,,,7,3,10
,2011,50100016,,,,6,5,11
HND-003847,2011,50100017,,,,36,32,68
HND-003848,2011,50100018,,,,128,111,239
HND-003850,2011,50100021,,,,47,47,94
HND-003851,2011,50100022,,,,47,32,79
HND-003853,2011,50100025,,,,55,46,101
HND-003854,2011,50100027,,,,1,1,2
HND-003855,2011,50100028,,,,30,20,50
,2011,50100033,,,,6,10,16
HND-003862,2011,50100036,,,,38,42,80
HND-003863,2011,50100037,,,,21,25,46
,2011,50100040,,,,2,4,6
HND-003871,2011,50100048,,,,43,38,81
HND-003872,2011,50100049,,,,16,19,35
HND-003873,2011,50100050,,,,4,1,5
HND-003876,2011,50100053,,,,5,7,12
HND-003881,2011,50100061,,,,26,27,53
HND-003885,2011,50100066,,,,73,75,148
HND-003886,2011,50100067,,,,39,38,77
HND-003887,2011,50100068,,,,19,39,58
HND-003889,2011,50100070,,,,38,37,75
HND-003890,2011,50100071,,,,28,36,64
HND-003894,2011,50100075,,,,5,8,13
HND-003895,2011,50100076,,,,4,4,8
HND-003896,2011,50100077,,,,70,67,137
HND-003897,2011,50100078,,,,44,45,89
HND-003898,2011,50100080,,,,66,58,124
HND-003900,2011,50100082,,,,6,5,11
HND-003904,2011,50100087,,,,61,50,111
HND-003911,2011,50100094,,,,5,5,10
HND-003912,2011,50100095,,,,29,27,56
HND-003913,2011,50100096,,,,36,29,65
HND-003914,2011,50100097,,,,7,7,14
HND-003915,2011,50100098,,,,5,5,10
,2011,50100100,,,,13,5,18
HND-003916,2011,50100101,,,,59,56,115
HND-003919,2011,50100105,,,,22,19,41
HND-003920,2011,50100106,,,,66,57,123
HND-003921,2011,50100107,,,,50,41,91
HND-003922,2011,50100108,,,,32,35,67
,2011,50100112,,,,17,19,36
HND-003927,2011,50100116,,,,28,39,67
HND-003928,2011,50100118,,,,38,29,67
HND-003930,2011,50100120,,,,54,37,91
HND-003931,2011,50100123,,,,59,63,122
HND-003932,2011,50100126,,,,18,19,37
,2011,50100129,,,,57,62,119
,2011,50100130,,,,12,0,12
,2011,50100133,,,,19,16,35
,2011,50100135,,,,3,4,7
HND-003935,2011,50100137,,,,27,43,70
HND-003936,2011,50100138,,,,43,30,73
HND-003937,2011,50100139,,,,21,18,39
HND-003939,2011,50100142,,,,2,3,5
HND-003941,2011,50100144,,,,22,21,43
,2011,50100145,,,,4,0,4
HND-003943,2011,50100148,,,,56,63,119
HND-003944,2011,50100151,,,,49,36,85
HND-003945,2011,50100152,,,,2,0,2
,2011,50100154,,,,21,19,40
,2011,50100157,,,,10,7,17
,2011,50100159,,,,23,17,40
HND-003946,2011,50100160,,,,17,20,37
HND-003947,2011,50100161,,,,73,78,151
,2011,50100162,,,,3,1,4
HND-003948,2011,50100165,,,,6,11,17
,2011,50100168,,,,31,35,66
,2011,50100173,,,,12,21,33
,2011,50100179,,,,5,7,12
HND-003953,2011,50100180,,,,25,13,38
,2011,50100181,,,,5,6,11
,2011,50100187,,,,11,13,24
,2011,50100198,,,,14,15,29
HND-003961,2011,50100201,,,,34,16,50
HND-003964,2011,50100212,,,,46,55,101
,2011,50100216,,,,4,0,4
,2011,50100220,,,,13,13,26
,2011,50100221,,,,15,18,33
,2011,50100237,,,,12,21,33
,2011,50100239,,,,1,1,2
HND-003969,2011,50100243,,,,38,37,75
,2011,50100246,,,,22,17,39
HND-003973,2011,50100250,,,,10,12,22
HND-003977,2011,50100268,,,,20,22,42
,2011,50100289,,,,2,3,5
,2011,50100294,,,,10,13,23
,2011,50100295,,,,7,6,13
HND-003985,2011,50100296,,,,17,13,30
HND-003986,2011,50100299,,,,4,4,8
HND-003996,2011,50100323,,,,35,38,73
,2011,50100338,,,,9,8,17
,2011,50100346,,,,12,13,25
,2011,50100347,,,,5,5,10
HND-004007,2011,50100353,,,,44,32,76
HND-004008,2011,50100356,,,,15,22,37
HND-004009,2011,50100357,,,,27,31,58
HND-004010,2011,50100363,,,,19,13,32
HND-004011,2011,50100365,,,,50,44,94
HND-004012,2011,50100366,,,,11,12,23
HND-004013,2011,50100367,,,,32,38,70
,2011,50100403,,,,2,1,3
,2011,50100413,,,,16,6,22
,2011,50100415,,,,2,1,3
,2011,50100421,,,,6,7,13
,2011,50100423,,,,9,12,21
,2011,50100426,,,,16,16,32
,2011,50100428,,,,13,16,29
,2011,50100429,,,,9,12,21
,2011,50100430,,,,16,11,27
,2011,50100431,,,,9,17,26
,2011,50100433,,,,9,11,20
,2011,50100436,,,,16,12,28
,2011,50100438,,,,11,17,28
,2011,50100443,,,,20,31,51
,2011,50100444,,,,10,5,15
,2011,50100461,,,,7,3,10
,2011,50100468,,,,5,2,7
,2011,50100469,,,,7,4,11
,2011,50100470,,,,11,15,26
,2011,50100475,,,,9,7,16
,2011,50100476,,,,40,45,85
,2011,50100477,,,,50,45,95
,2011,50100478,,,,3,7,10
,2011,50100481,,,,14,13,27
,2011,50100483,,,,5,10,15
,2011,50100484,,,,3,0,3
,2011,50100499,,,,20,29,49
,2011,50100512,,,,4,6,10
,2011,50100515,,,,17,8,25
,2011,50100517,,,,19,20,39
,2011,50100521,,,,6,6,12
,2011,50100525,,,,27,44,71
,2011,50100526,,,,17,13,30
,2011,50100528,,,,13,9,22
,2011,50100531,,,,14,24,38
HND-004042,2011,50100534,,,,52,58,110
,2011,50100535,,,,11,6,17
HND-004043,2011,50100536,,,,39,43,82
HND-004044,2011,50100537,,,,17,13,30
,2011,50100540,,,,44,50,94
,2011,50100554,,,,12,18,30
,2011,50100559,,,,58,59,117
HND-004051,2011,50100561,,,,51,45,96
HND-004053,2011,50100563,,,,41,32,73
,2011,50100585,,,,32,34,66
,2011,50100586,,,,17,14,31
HND-004060,2011,50100596,,,,37,36,73
HND-004061,2011,50100597,,,,45,43,88
,2011,50100608,,,,1,2,3
,2011,50100655,,,,13,21,34
,2011,50100666,,,,5,10,15
,2011,50100673,,,,5,4,9
HND-004066,2011,50100678,,,,10,8,18
,2011,50100688,,,,4,7,11
,2011,50100692,,,,24,14,38
,2011,50100697,,,,6,7,13
,2011,50100705,,,,8,17,25
,2011,50100709,,,,18,26,44
,2011,50100710,,,,8,8,16
,2011,50100711,,,,4,4,8
,2011,50100714,,,,6,6,12
HND-004072,2011,50100716,,,,7,5,12
,2011,50100717,,,,72,64,136
HND-004077,2011,50100764,,,,4,4,8
,2011,50100771,,,,25,13,38
,2011,50100772,,,,11,4,15
,2011,50100792,,,,45,32,77
,2011,50100798,,,,11,13,24
,2011,50100819,,,,31,35,66
,2011,50100820,,,,12,18,30
,2011,50100822,,,,12,1,13
,2011,50100827,,,,2,6,8
,2011,50100831,,,,7,7,14
,2011,50100834,,,,4,8,12
,2011,50100848,,,,6,3,9
,2011,50100850,,,,7,1,8
,2011,50100852,,,,5,5,10
,2011,50100859,,,,5,4,9
,2011,50100897,,,,7,4,11
,2011,50100898,,,,2,2,4
,2011,50100903,,,,2,1,3
,2011,50100911,,,,7,3,10
,2011,50100912,,,,5,5,10
,2011,50100916,,,,10,8,18
,2011,50100921,,,,10,4,14
,2011,50100923,,,,2,3,5
,2011,50100931,,,,22,18,40
,2011,50100936,,,,5,2,7
,2011,50100941,,,,4,4,8
,2011,50100944,,,,1,4,5
HND-004104,2011,50100947,,,,13,22,35
,2011,50100949,,,,4,6,10
,2011,50100958,,,,14,14,28
,2011,50101037,,,,9,3,12
,2011,50101042,,,,14,19,33
,2011,50101044,,,,2,2,4
,2011,50101047,,,,13,17,30
,2011,50101055,,,,15,9,24
,2011,50101057,,,,8,8,16
,2011,50101058,,,,6,12,18
,2011,50101064,,,,3,5,8
,2011,50101072,,,,4,6,10
HND-004122,2011,50101108,,,,2,2,4
,2011,50101165,,,,6,6,12
,2011,50101166,,,,11,20,31
,2011,50101167,,,,10,3,13
,2011,50101168,,,,5,9,14
,2011,50101171,,,,2,7,9
HND-004133,2011,50101173,,,,12,18,30
,2011,50101174,,,,3,2,5
,2011,50101177,,,,1,4,5
,2011,50101182,,,,11,18,29
,2011,50101183,,,,3,5,8
HND-004149,2011,50101244,,,,5,4,9
,2011,50101259,,,,1,0,1
,2011,50101264,,,,5,6,11
,2011,50101279,,,,2,3,5
,2011,50101281,,,,4,6,10
,2011,50101282,,,,6,4,10
,2011,50101293,,,,4,3,7
HND-003838,2011,50100001,,,,69,76,145
HND-003839,2011,50100002,,,,9,6,15
,2011,50100003,,,,9,2,11
HND-003841,2011,50100005,,,,18,18,36
,2011,50100012,,,,10,15,25
HND-003847,2011,50100017,,,,37,23,60
HND-003849,2011,50100020,,,,5,4,9
HND-003850,2011,50100021,,,,41,53,94
HND-003855,2011,50100028,,,,20,13,33
HND-003857,2011,50100031,,,,74,92,166
HND-003858,2011,50100032,,,,29,9,38
,2011,50100033,,,,12,7,19
HND-003860,2011,50100034,,,,55,41,96
HND-003863,2011,50100037,,,,10,20,30
,2011,50100039,,,,0,41,41
HND-003864,2011,50100041,,,,118,102,220
HND-003867,2011,50100044,,,,39,38,77
HND-003868,2011,50100045,,,,31,21,52
HND-003869,2011,50100046,,,,115,110,225
HND-003870,2011,50100047,,,,4,6,10
HND-003873,2011,50100050,,,,1,6,7
HND-003875,2011,50100052,,,,15,20,35
HND-003876,2011,50100053,,,,10,6,16
HND-003877,2011,50100055,,,,45,47,92
HND-003878,2011,50100056,,,,2,4,6
,2011,50100059,,,,17,10,27
HND-003880,2011,50100060,,,,15,7,22
HND-003884,2011,50100064,,,,47,48,95
HND-003885,2011,50100066,,,,52,48,100
HND-003886,2011,50100067,,,,29,34,63
HND-003890,2011,50100071,,,,25,27,52
HND-003891,2011,50100072,,,,3,4,7
HND-003893,2011,50100074,,,,4,1,5
HND-003896,2011,50100077,,,,66,76,142
HND-003897,2011,50100078,,,,44,41,85
,2011,50100079,,,,28,22,50
HND-003901,2011,50100083,,,,68,70,138
,2011,50100085,,,,3,4,7
HND-003905,2011,50100088,,,,5,7,12
HND-003906,2011,50100089,,,,34,29,63
HND-003907,2011,50100090,,,,42,50,92
HND-003909,2011,50100092,,,,51,39,90
,2011,50100093,,,,4,2,6
HND-003911,2011,50100094,,,,2,2,4
,2011,50100099,,,,6,5,11
HND-003916,2011,50100101,,,,64,44,108
HND-003918,2011,50100104,,,,39,69,108
HND-003919,2011,50100105,,,,18,20,38
HND-003920,2011,50100106,,,,72,57,129
HND-003921,2011,50100107,,,,52,42,94
,2011,50100110,,,,26,28,54
,2011,50100112,,,,33,33,66
HND-003925,2011,50100114,,,,41,40,81
HND-003926,2011,50100115,,,,88,79,167
HND-003927,2011,50100116,,,,26,35,61
,2011,50100117,,,,21,33,54
,2011,50100121,,,,5,6,11
HND-003933,2011,50100127,,,,73,57,130
,2011,50100130,,,,8,3,11
,2011,50100131,,,,8,8,16
,2011,50100135,,,,8,2,10
HND-003934,2011,50100136,,,,10,11,21
HND-003938,2011,50100140,,,,42,22,64
HND-003940,2011,50100143,,,,1,5,6
HND-003941,2011,50100144,,,,18,15,33
,2011,50100145,,,,1,1,2
HND-003942,2011,50100146,,,,50,28,78
,2011,50100147,,,,10,4,14
HND-003943,2011,50100148,,,,48,52,100
HND-003945,2011,50100152,,,,1,2,3
,2011,50100159,,,,18,20,38
HND-003947,2011,50100161,,,,97,88,185
,2011,50100166,,,,51,67,118
HND-003949,2011,50100167,,,,14,19,33
,2011,50100170,,,,2,3,5
,2011,50100173,,,,14,21,35
,2011,50100175,,,,23,17,40
,2011,50100176,,,,1,2,3
HND-003952,2011,50100177,,,,1,0,1
,2011,50100178,,,,3,2,5
,2011,50100179,,,,5,6,11
HND-003959,2011,50100197,,,,30,31,61
,2011,50100216,,,,4,3,7
,2011,50100220,,,,21,7,28
,2011,50100239,,,,1,2,3
,2011,50100245,,,,6,4,10
HND-003973,2011,50100250,,,,16,14,30
,2011,50100258,,,,2,3,5
HND-003977,2011,50100268,,,,22,28,50
,2011,50100270,,,,6,2,8
,2011,50100273,,,,2,0,2
,2011,50100294,,,,8,9,17
HND-003986,2011,50100299,,,,5,2,7
HND-003993,2011,50100314,,,,12,10,22
,2011,50100325,,,,1,1,2
,2011,50100327,,,,16,8,24
HND-004002,2011,50100337,,,,31,46,77
HND-004003,2011,50100340,,,,1,0,1
HND-004004,2011,50100341,,,,20,22,42
,2011,50100352,,,,3,12,15
HND-004007,2011,50100353,,,,21,25,46
,2011,50100354,,,,22,17,39
HND-004009,2011,50100357,,,,36,34,70
HND-004011,2011,50100365,,,,44,39,83
,2011,50100371,,,,11,21,32
HND-004015,2011,50100374,,,,11,18,29
,2011,50100403,,,,3,3,6
,2011,50100404,,,,22,30,52
,2011,50100415,,,,0,7,7
,2011,50100416,,,,5,5,10
,2011,50100418,,,,3,5,8
,2011,50100419,,,,11,15,26
,2011,50100420,,,,3,9,12
,2011,50100421,,,,8,10,18
,2011,50100423,,,,7,10,17
,2011,50100433,,,,7,16,23
,2011,50100438,,,,4,8,12
,2011,50100443,,,,16,11,27
,2011,50100445,,,,12,12,24
,2011,50100448,,,,4,5,9
HND-004024,2011,50100449,,,,56,57,113
,2011,50100455,,,,10,14,24
,2011,50100456,,,,0,1,1
,2011,50100458,,,,9,9,18
,2011,50100459,,,,13,18,31
,2011,50100461,,,,3,6,9
,2011,50100467,,,,3,2,5
,2011,50100468,,,,1,3,4
,2011,50100469,,,,8,8,16
,2011,50100470,,,,7,15,22
,2011,50100471,,,,0,2,2
,2011,50100483,,,,5,3,8
,2011,50100485,,,,2,6,8
,2011,50100497,,,,10,12,22
,2011,50100499,,,,29,21,50
,2011,50100508,,,,5,1,6
,2011,50100515,,,,10,8,18
,2011,50100516,,,,10,5,15
,2011,50100527,,,,10,1,11
,2011,50100528,,,,14,15,29
HND-004042,2011,50100534,,,,57,40,97
HND-004044,2011,50100537,,,,6,13,19
HND-004045,2011,50100538,,,,19,27,46
,2011,50100540,,,,30,18,48
,2011,50100543,,,,16,8,24
HND-004050,2011,50100560,,,,27,26,53
,2011,50100564,,,,43,60,103
HND-004054,2011,50100565,,,,4,3,7
HND-004055,2011,50100566,,,,67,73,140
HND-004057,2011,50100570,,,,6,3,9
,2011,50100580,,,,3,2,5
,2011,50100585,,,,36,25,61
,2011,50100586,,,,17,18,35
,2011,50100588,,,,1,0,1
,2011,50100589,,,,4,7,11
HND-004060,2011,50100596,,,,32,40,72
,2011,50100600,,,,4,2,6
,2011,50100621,,,,8,7,15
,2011,50100636,,,,1,0,1
,2011,50100653,,,,1,0,1
,2011,50100666,,,,4,7,11
HND-004066,2011,50100678,,,,6,12,18
,2011,50100680,,,,10,7,17
HND-004067,2011,50100685,,,,14,10,24
,2011,50100692,,,,9,13,22
,2011,50100703,,,,8,3,11
HND-004071,2011,50100706,,,,19,26,45
,2011,50100712,,,,13,9,22
,2011,50100713,,,,7,9,16
,2011,50100714,,,,3,2,5
,2011,50100715,,,,6,4,10
HND-004077,2011,50100764,,,,0,2,2
,2011,50100771,,,,15,15,30
HND-004083,2011,50100788,,,,35,33,68
,2011,50100798,,,,15,12,27
,2011,50100808,,,,23,15,38
,2011,50100816,,,,1,1,2
,2011,50100818,,,,13,7,20
,2011,50100819,,,,35,40,75
,2011,50100822,,,,5,10,15
,2011,50100829,,,,1,4,5
,2011,50100830,,,,3,1,4
,2011,50100832,,,,11,11,22
,2011,50100840,,,,33,26,59
,2011,50100863,,,,5,1,6
,2011,50100888,,,,5,2,7
,2011,50100891,,,,1,0,1
,2011,50100897,,,,11,9,20
HND-004098,2011,50100907,,,,32,25,57
,2011,50100911,,,,4,2,6
,2011,50100912,,,,1,8,9
,2011,50100919,,,,2,0,2
HND-004099,2011,50100920,,,,5,13,18
,2011,50100923,,,,3,1,4
,2011,50100924,,,,2,2,4
,2011,50100931,,,,14,12,26
,2011,50100932,,,,3,2,5
,2011,50100941,,,,5,10,15
,2011,50100944,,,,1,2,3
HND-004104,2011,50100947,,,,13,22,35
,2011,50101037,,,,7,9,16
,2011,50101040,,,,3,2,5
,2011,50101042,,,,5,11,16
,2011,50101055,,,,9,12,21
,2011,50101057,,,,13,4,17
HND-004116,2011,50101061,,,,2,3,5
HND-004117,2011,50101062,,,,3,3,6
,2011,50101063,,,,8,5,13
HND-004122,2011,50101108,,,,3,1,4
,2011,50101122,,,,10,10,20
,2011,50101165,,,,6,1,7
,2011,50101166,,,,10,6,16
,2011,50101168,,,,1,3,4
,2011,50101172,,,,1,6,7
HND-004134,2011,50101175,,,,36,25,61
,2011,50101178,,,,2,2,4
,2011,50101179,,,,3,0,3
,2011,50101182,,,,6,7,13
,2011,50101256,,,,1,3,4
,2011,50101278,,,,2,4,6
HND-003842,2011,50100006,,,,10,4,14
HND-003843,2011,50100007,,,,68,55,123
HND-003844,2011,50100008,,,,3,6,9
,2011,50100009,,,,13,10,23
HND-003845,2011,50100010,,,,11,16,27
,2011,50100011,,,,16,7,23
HND-003846,2011,50100013,,,,29,33,62
,2011,50100015,,,,1,5,6
,2011,50100016,,,,4,7,11
HND-003848,2011,50100018,,,,127,143,270
HND-003851,2011,50100022,,,,52,55,107
HND-003853,2011,50100025,,,,51,53,104
HND-003854,2011,50100027,,,,1,0,1
,2011,50100035,,,,11,9,20
HND-003862,2011,50100036,,,,37,36,73
,2011,50100038,,,,0,23,23
,2011,50100040,,,,2,1,3
HND-003865,2011,50100042,,,,52,66,118
HND-003866,2011,50100043,,,,65,64,129
HND-003871,2011,50100048,,,,39,41,80
HND-003872,2011,50100049,,,,20,31,51
HND-003874,2011,50100051,,,,35,41,76
HND-003879,2011,50100057,,,,16,14,30
,2011,50100058,,,,59,46,105
HND-003881,2011,50100061,,,,30,41,71
HND-003882,2011,50100062,,,,129,111,240
HND-003883,2011,50100063,,,,27,9,36
HND-003887,2011,50100068,,,,23,27,50
HND-003888,2011,50100069,,,,85,88,173
HND-003889,2011,50100070,,,,35,31,66
HND-003892,2011,50100073,,,,5,3,8
HND-003894,2011,50100075,,,,9,7,16
HND-003895,2011,50100076,,,,4,6,10
HND-003898,2011,50100080,,,,78,68,146
HND-003900,2011,50100082,,,,3,3,6
HND-003902,2011,50100084,,,,21,23,44
HND-003904,2011,50100087,,,,67,47,114
HND-003908,2011,50100091,,,,3,3,6
HND-003912,2011,50100095,,,,33,52,85
HND-003913,2011,50100096,,,,42,51,93
HND-003914,2011,50100097,,,,5,3,8
HND-003915,2011,50100098,,,,6,7,13
,2011,50100100,,,,9,4,13
,2011,50100102,,,,7,5,12
HND-003922,2011,50100108,,,,31,24,55
HND-003923,2011,50100109,,,,61,63,124
HND-003924,2011,50100113,,,,76,57,133
HND-003928,2011,50100118,,,,29,30,59
HND-003929,2011,50100119,,,,8,11,19
HND-003930,2011,50100120,,,,49,49,98
HND-003931,2011,50100123,,,,71,61,132
,2011,50100124,,,,10,6,16
HND-003932,2011,50100126,,,,7,10,17
,2011,50100129,,,,61,64,125
,2011,50100133,,,,20,15,35
HND-003935,2011,50100137,,,,26,32,58
HND-003936,2011,50100138,,,,31,32,63
HND-003937,2011,50100139,,,,28,27,55
HND-003939,2011,50100142,,,,1,1,2
,2011,50100149,,,,12,6,18
,2011,50100150,,,,62,42,104
HND-003944,2011,50100151,,,,33,23,56
,2011,50100154,,,,29,19,48
,2011,50100156,,,,4,1,5
,2011,50100157,,,,12,11,23
HND-003946,2011,50100160,,,,20,20,40
,2011,50100162,,,,3,1,4
,2011,50100163,,,,2,5,7
HND-003948,2011,50100165,,,,15,18,33
,2011,50100168,,,,33,50,83
HND-003950,2011,50100169,,,,2,1,3
,2011,50100171,,,,5,7,12
HND-003951,2011,50100174,,,,8,18,26
HND-003953,2011,50100180,,,,21,16,37
,2011,50100181,,,,4,5,9
,2011,50100187,,,,13,4,17
,2011,50100198,,,,16,25,41
HND-003961,2011,50100201,,,,32,36,68
HND-003964,2011,50100212,,,,56,53,109
,2011,50100213,,,,6,7,13
HND-003965,2011,50100214,,,,30,26,56
,2011,50100221,,,,15,19,34
,2011,50100227,,,,0,2,2
,2011,50100237,,,,11,16,27
HND-003969,2011,50100243,,,,45,32,77
,2011,50100246,,,,20,20,40
HND-003979,2011,50100277,,,,2,2,4
,2011,50100289,,,,4,1,5
,2011,50100295,,,,5,8,13
HND-003985,2011,50100296,,,,11,14,25
HND-003996,2011,50100323,,,,35,31,66
HND-004001,2011,50100336,,,,35,34,69
,2011,50100338,,,,8,10,18
,2011,50100346,,,,17,10,27
,2011,50100347,,,,5,3,8
HND-004008,2011,50100356,,,,15,18,33
HND-004010,2011,50100363,,,,16,19,35
HND-004012,2011,50100366,,,,16,11,27
HND-004013,2011,50100367,,,,34,30,64
,2011,50100413,,,,10,0,10
,2011,50100425,,,,8,4,12
,2011,50100426,,,,14,18,32
,2011,50100428,,,,16,20,36
,2011,50100429,,,,13,11,24
,2011,50100430,,,,11,20,31
,2011,50100431,,,,10,17,27
,2011,50100436,,,,13,14,27
,2011,50100444,,,,1,3,4
,2011,50100446,,,,21,15,36
,2011,50100450,,,,5,2,7
HND-004025,2011,50100451,,,,10,17,27
,2011,50100475,,,,6,5,11
,2011,50100476,,,,37,43,80
,2011,50100477,,,,43,45,88
,2011,50100478,,,,3,7,10
,2011,50100481,,,,14,9,23
,2011,50100484,,,,0,3,3
,2011,50100493,,,,32,35,67
,2011,50100500,,,,43,23,66
,2011,50100512,,,,3,4,7
,2011,50100517,,,,20,16,36
,2011,50100521,,,,2,3,5
HND-004040,2011,50100523,,,,33,35,68
,2011,50100525,,,,37,37,74
,2011,50100526,,,,6,15,21
,2011,50100531,,,,22,19,41
HND-004041,2011,50100532,,,,29,33,62
,2011,50100535,,,,6,9,15
HND-004043,2011,50100536,,,,40,45,85
HND-004046,2011,50100539,,,,11,7,18
,2011,50100544,,,,7,2,9
HND-004047,2011,50100548,,,,26,18,44
,2011,50100549,,,,11,13,24
,2011,50100554,,,,12,10,22
,2011,50100558,,,,20,15,35
,2011,50100559,,,,55,42,97
HND-004051,2011,50100561,,,,46,37,83
HND-004053,2011,50100563,,,,40,33,73
HND-004056,2011,50100567,,,,117,107,224
,2011,50100572,,,,3,2,5
HND-004061,2011,50100597,,,,42,41,83
,2011,50100598,,,,19,8,27
,2011,50100608,,,,1,1,2
HND-004063,2011,50100626,,,,19,15,34
,2011,50100643,,,,5,7,12
,2011,50100651,,,,3,3,6
,2011,50100655,,,,19,17,36
,2011,50100659,,,,7,6,13
,2011,50100673,,,,3,4,7
,2011,50100688,,,,4,6,10
,2011,50100689,,,,30,22,52
,2011,50100691,,,,11,11,22
,2011,50100697,,,,5,6,11
,2011,50100705,,,,11,14,25
,2011,50100709,,,,15,14,29
,2011,50100710,,,,4,9,13
HND-004072,2011,50100716,,,,16,7,23
,2011,50100717,,,,55,50,105
,2011,50100772,,,,1,6,7
,2011,50100792,,,,33,34,67
,2011,50100820,,,,22,12,34
,2011,50100824,,,,2,2,4
,2011,50100827,,,,4,2,6
,2011,50100831,,,,6,10,16
,2011,50100834,,,,3,3,6
,2011,50100845,,,,11,6,17
,2011,50100846,,,,4,4,8
,2011,50100848,,,,5,14,19
,2011,50100850,,,,4,9,13
,2011,50100852,,,,5,4,9
,2011,50100859,,,,8,6,14
,2011,50100898,,,,2,4,6
HND-004096,2011,50100899,,,,20,20,40
,2011,50100903,,,,12,8,20
,2011,50100916,,,,8,8,16
,2011,50100921,,,,3,5,8
,2011,50100939,,,,4,3,7
,2011,50100949,,,,3,7,10
,2011,50100951,,,,3,5,8
,2011,50100958,,,,7,5,12
,2011,50100983,,,,2,0,2
,2011,50101039,,,,4,7,11
,2011,50101045,,,,2,5,7
,2011,50101046,,,,9,10,19
,2011,50101047,,,,8,10,18
,2011,50101053,,,,4,1,5
,2011,50101058,,,,9,7,16
,2011,50101064,,,,3,0,3
,2011,50101164,,,,3,2,5
,2011,50101167,,,,9,3,12
,2011,50101169,,,,1,1,2
,2011,50101170,,,,1,2,3
,2011,50101171,,,,2,6,8
HND-004133,2011,50101173,,,,11,14,25
,2011,50101174,,,,3,4,7
,2011,50101176,,,,0,1,1
,2011,50101177,,,,3,1,4
,2011,50101183,,,,5,3,8
HND-004149,2011,50101244,,,,2,7,9
,2011,50101259,,,,2,0,2
,2011,50101264,,,,5,5,10
,2011,50101265,,,,8,4,12
,2011,50101266,,,,4,3,7
,2011,50101275,,,,2,3,5
,2011,50101276,,,,0,6,6
,2011,50101282,,,,5,11,16
,2011,50101293,,,,3,4,7
HND-003839,2011,50100002,,,,4,9,13
,2011,50100003,,,,2,2,4
HND-003844,2011,50100008,,,,3,1,4
,2011,50100009,,,,15,8,23
HND-003845,2011,50100010,,,,10,9,19
,2011,50100011,,,,14,14,28
,2011,50100012,,,,8,6,14
HND-003846,2011,50100013,,,,33,40,73
,2011,50100016,,,,2,5,7
HND-003849,2011,50100020,,,,4,4,8
HND-003851,2011,50100022,,,,64,43,107
HND-003856,2011,50100029,,,,0,2,2
HND-003857,2011,50100031,,,,91,87,178
HND-003858,2011,50100032,,,,19,19,38
,2011,50100035,,,,12,14,26
,2011,50100038,,,,0,23,23
,2011,50100039,,,,0,45,45
HND-003865,2011,50100042,,,,53,64,117
HND-003866,2011,50100043,,,,75,71,146
HND-003867,2011,50100044,,,,27,35,62
HND-003868,2011,50100045,,,,19,25,44
HND-003869,2011,50100046,,,,100,98,198
HND-003874,2011,50100051,,,,39,31,70
HND-003875,2011,50100052,,,,15,19,34
HND-003877,2011,50100055,,,,26,46,72
HND-003878,2011,50100056,,,,4,11,15
HND-003879,2011,50100057,,,,15,15,30
,2011,50100058,,,,55,65,120
HND-003882,2011,50100062,,,,109,130,239
HND-003883,2011,50100063,,,,18,16,34
HND-003884,2011,50100064,,,,41,42,83
HND-003888,2011,50100069,,,,65,75,140
HND-003891,2011,50100072,,,,5,3,8
HND-003892,2011,50100073,,,,6,5,11
,2011,50100079,,,,31,27,58
HND-003901,2011,50100083,,,,57,56,113
HND-003902,2011,50100084,,,,18,27,45
,2011,50100085,,,,5,0,5
HND-003907,2011,50100090,,,,48,46,94
HND-003908,2011,50100091,,,,4,2,6
HND-003909,2011,50100092,,,,64,38,102
,2011,50100093,,,,0,1,1
HND-003915,2011,50100098,,,,7,3,10
,2011,50100099,,,,9,5,14
,2011,50100102,,,,4,5,9
HND-003918,2011,50100104,,,,30,36,66
HND-003923,2011,50100109,,,,59,62,121
HND-003924,2011,50100113,,,,62,60,122
HND-003925,2011,50100114,,,,45,36,81
HND-003926,2011,50100115,,,,85,80,165
,2011,50100117,,,,37,22,59
HND-003929,2011,50100119,,,,8,10,18
,2011,50100121,,,,11,7,18
,2011,50100124,,,,10,5,15
HND-003933,2011,50100127,,,,70,78,148
,2011,50100133,,,,20,16,36
HND-003936,2011,50100138,,,,32,31,63
HND-003939,2011,50100142,,,,3,3,6
HND-003940,2011,50100143,,,,1,6,7
,2011,50100149,,,,11,11,22
,2011,50100150,,,,36,47,83
,2011,50100156,,,,4,5,9
,2011,50100157,,,,5,7,12
,2011,50100163,,,,0,3,3
,2011,50100166,,,,50,60,110
HND-003949,2011,50100167,,,,19,27,46
HND-003950,2011,50100169,,,,5,1,6
,2011,50100171,,,,3,4,7
HND-003951,2011,50100174,,,,9,15,24
,2011,50100175,,,,13,12,25
HND-003952,2011,50100177,,,,1,4,5
HND-003959,2011,50100197,,,,35,20,55
HND-003961,2011,50100201,,,,51,27,78
HND-003964,2011,50100212,,,,46,65,111
,2011,50100213,,,,7,2,9
HND-003965,2011,50100214,,,,34,30,64
,2011,50100237,,,,19,18,37
,2011,50100270,,,,4,4,8
,2011,50100273,,,,1,2,3
HND-003979,2011,50100277,,,,3,1,4
,2011,50100295,,,,7,9,16
,2011,50100325,,,,5,3,8
HND-004001,2011,50100336,,,,43,38,81
HND-004002,2011,50100337,,,,39,51,90
HND-004004,2011,50100341,,,,23,17,40
,2011,50100347,,,,2,1,3
,2011,50100354,,,,21,14,35
HND-004012,2011,50100366,,,,11,12,23
,2011,50100371,,,,10,11,21
HND-004015,2011,50100374,,,,16,20,36
,2011,50100404,,,,25,30,55
,2011,50100418,,,,6,3,9
,2011,50100419,,,,8,3,11
,2011,50100420,,,,4,8,12
,2011,50100421,,,,6,3,9
,2011,50100425,,,,4,6,10
,2011,50100428,,,,24,14,38
,2011,50100436,,,,16,12,28
,2011,50100444,,,,4,3,7
,2011,50100445,,,,24,13,37
,2011,50100446,,,,19,16,35
,2011,50100448,,,,2,4,6
,2011,50100450,,,,5,3,8
HND-004025,2011,50100451,,,,14,18,32
,2011,50100455,,,,9,13,22
,2011,50100456,,,,5,3,8
,2011,50100459,,,,14,12,26
,2011,50100475,,,,4,12,16
,2011,50100478,,,,3,4,7
,2011,50100484,,,,1,1,2
,2011,50100485,,,,5,6,11
,2011,50100493,,,,31,33,64
,2011,50100497,,,,6,11,17
,2011,50100500,,,,36,21,57
,2011,50100508,,,,4,4,8
,2011,50100516,,,,4,3,7
,2011,50100521,,,,8,5,13
HND-004040,2011,50100523,,,,30,39,69
,2011,50100527,,,,3,5,8
,2011,50100531,,,,17,23,40
HND-004041,2011,50100532,,,,42,31,73
HND-004042,2011,50100534,,,,51,40,91
,2011,50100535,,,,8,6,14
HND-004044,2011,50100537,,,,12,12,24
HND-004045,2011,50100538,,,,26,24,50
,2011,50100543,,,,10,12,22
,2011,50100554,,,,13,12,25
HND-004050,2011,50100560,,,,21,15,36
HND-004053,2011,50100563,,,,28,31,59
,2011,50100564,,,,53,57,110
HND-004056,2011,50100567,,,,110,108,218
HND-004057,2011,50100570,,,,8,0,8
,2011,50100572,,,,2,4,6
,2011,50100585,,,,39,35,74
,2011,50100586,,,,15,16,31
HND-004060,2011,50100596,,,,44,38,82
HND-004061,2011,50100597,,,,48,33,81
,2011,50100600,,,,11,9,20
HND-004063,2011,50100626,,,,17,18,35
,2011,50100636,,,,2,0,2
,2011,50100643,,,,6,3,9
,2011,50100651,,,,6,2,8
,2011,50100655,,,,19,18,37
,2011,50100659,,,,9,3,12
,2011,50100680,,,,8,8,16
HND-004067,2011,50100685,,,,19,17,36
,2011,50100689,,,,29,23,52
,2011,50100691,,,,10,13,23
,2011,50100705,,,,10,15,25
,2011,50100713,,,,12,5,17
,2011,50100715,,,,0,2,2
HND-004083,2011,50100788,,,,36,21,57
,2011,50100792,,,,30,19,49
,2011,50100818,,,,11,7,18
,2011,50100824,,,,2,3,5
,2011,50100827,,,,3,3,6
,2011,50100831,,,,9,8,17
,2011,50100832,,,,8,1,9
,2011,50100845,,,,10,3,13
,2011,50100846,,,,4,5,9
,2011,50100848,,,,4,3,7
,2011,50100850,,,,4,7,11
,2011,50100863,,,,4,5,9
,2011,50100888,,,,0,1,1
HND-004096,2011,50100899,,,,22,23,45
,2011,50100903,,,,6,2,8
HND-004098,2011,50100907,,,,39,29,68
,2011,50100919,,,,2,2,4
HND-004099,2011,50100920,,,,9,11,20
,2011,50100924,,,,2,0,2
,2011,50100932,,,,4,2,6
,2011,50100936,,,,1,1,2
,2011,50100941,,,,4,4,8
,2011,50100951,,,,1,2,3
,2011,50100983,,,,5,2,7
,2011,50101039,,,,7,6,13
,2011,50101045,,,,5,0,5
,2011,50101046,,,,8,5,13
,2011,50101047,,,,13,10,23
,2011,50101053,,,,6,2,8
,2011,50101059,,,,0,2,2
HND-004117,2011,50101062,,,,4,5,9
HND-004122,2011,50101108,,,,2,2,4
,2011,50101122,,,,8,8,16
,2011,50101168,,,,0,1,1
,2011,50101169,,,,4,0,4
,2011,50101170,,,,0,3,3
,2011,50101171,,,,4,3,7
,2011,50101172,,,,4,0,4
HND-004134,2011,50101175,,,,23,30,53
,2011,50101176,,,,4,0,4
,2011,50101177,,,,0,2,2
,2011,50101178,,,,3,1,4
,2011,50101181,,,,1,0,1
,2011,50101256,,,,2,0,2
,2011,50101264,,,,4,5,9
,2011,50101265,,,,9,8,17
,2011,50101266,,,,3,4,7
,2011,50101275,,,,5,3,8
,2011,50101276,,,,2,5,7
,2011,50101278,,,,6,8,14
,2011,50101282,,,,6,6,12
HND-003838,2011,50100001,,,,85,75,160
HND-003840,2011,50100004,,,,1,5,6
HND-003841,2011,50100005,,,,22,34,56
HND-003842,2011,50100006,,,,5,8,13
HND-003843,2011,50100007,,,,42,44,86
,2011,50100015,,,,2,2,4
HND-003847,2011,50100017,,,,28,31,59
HND-003848,2011,50100018,,,,124,121,245
HND-003850,2011,50100021,,,,60,51,111
HND-003852,2011,50100024,,,,5,3,8
HND-003853,2011,50100025,,,,45,42,87
HND-003854,2011,50100027,,,,1,1,2
HND-003855,2011,50100028,,,,20,19,39
,2011,50100033,,,,7,3,10
HND-003860,2011,50100034,,,,52,49,101
HND-003862,2011,50100036,,,,31,44,75
HND-003863,2011,50100037,,,,32,16,48
,2011,50100040,,,,1,1,2
HND-003864,2011,50100041,,,,105,118,223
HND-003870,2011,50100047,,,,10,5,15
HND-003871,2011,50100048,,,,11,28,39
HND-003872,2011,50100049,,,,25,14,39
HND-003873,2011,50100050,,,,1,3,4
HND-003876,2011,50100053,,,,16,7,23
,2011,50100059,,,,11,10,21
HND-003880,2011,50100060,,,,3,8,11
HND-003881,2011,50100061,,,,30,30,60
HND-003885,2011,50100066,,,,79,61,140
HND-003886,2011,50100067,,,,41,50,91
HND-003887,2011,50100068,,,,15,31,46
HND-003889,2011,50100070,,,,26,31,57
HND-003890,2011,50100071,,,,34,35,69
HND-003893,2011,50100074,,,,4,2,6
HND-003894,2011,50100075,,,,7,4,11
HND-003895,2011,50100076,,,,4,7,11
HND-003896,2011,50100077,,,,74,68,142
HND-003897,2011,50100078,,,,37,39,76
HND-003898,2011,50100080,,,,77,67,144
HND-003900,2011,50100082,,,,7,9,16
HND-003904,2011,50100087,,,,71,57,128
HND-003905,2011,50100088,,,,0,2,2
HND-003906,2011,50100089,,,,23,18,41
HND-003911,2011,50100094,,,,2,1,3
HND-003912,2011,50100095,,,,34,36,70
HND-003913,2011,50100096,,,,54,38,92
HND-003914,2011,50100097,,,,4,4,8
,2011,50100100,,,,6,6,12
HND-003916,2011,50100101,,,,70,71,141
HND-003919,2011,50100105,,,,14,18,32
HND-003920,2011,50100106,,,,74,48,122
HND-003921,2011,50100107,,,,41,33,74
HND-003922,2011,50100108,,,,40,36,76
,2011,50100110,,,,19,28,47
,2011,50100112,,,,33,18,51
HND-003927,2011,50100116,,,,31,35,66
HND-003928,2011,50100118,,,,26,18,44
HND-003930,2011,50100120,,,,46,45,91
HND-003931,2011,50100123,,,,85,63,148
HND-003932,2011,50100126,,,,12,11,23
,2011,50100129,,,,48,36,84
,2011,50100130,,,,6,5,11
,2011,50100131,,,,10,5,15
,2011,50100135,,,,2,2,4
HND-003934,2011,50100136,,,,12,2,14
HND-003935,2011,50100137,,,,43,48,91
HND-003937,2011,50100139,,,,18,18,36
HND-003938,2011,50100140,,,,21,34,55
HND-003941,2011,50100144,,,,17,17,34
,2011,50100145,,,,0,3,3
HND-003942,2011,50100146,,,,39,38,77
,2011,50100147,,,,9,5,14
HND-003943,2011,50100148,,,,60,55,115
HND-003944,2011,50100151,,,,31,21,52
HND-003945,2011,50100152,,,,3,3,6
,2011,50100154,,,,23,21,44
,2011,50100159,,,,17,17,34
HND-003946,2011,50100160,,,,24,14,38
HND-003947,2011,50100161,,,,70,82,152
,2011,50100162,,,,3,0,3
HND-003948,2011,50100165,,,,2,8,10
,2011,50100168,,,,47,47,94
,2011,50100173,,,,14,23,37
,2011,50100176,,,,1,0,1
,2011,50100178,,,,7,1,8
,2011,50100179,,,,9,5,14
HND-003953,2011,50100180,,,,17,20,37
,2011,50100181,,,,7,7,14
,2011,50100187,,,,14,11,25
,2011,50100198,,,,17,11,28
,2011,50100216,,,,5,0,5
,2011,50100220,,,,12,18,30
,2011,50100221,,,,16,22,38
,2011,50100239,,,,3,2,5
HND-003969,2011,50100243,,,,42,43,85
,2011,50100245,,,,7,5,12
,2011,50100246,,,,20,20,40
HND-003973,2011,50100250,,,,15,15,30
,2011,50100258,,,,3,3,6
HND-003977,2011,50100268,,,,16,29,45
,2011,50100289,,,,3,1,4
,2011,50100294,,,,10,11,21
HND-003985,2011,50100296,,,,10,22,32
HND-003986,2011,50100299,,,,4,2,6
HND-003993,2011,50100314,,,,10,9,19
HND-003996,2011,50100323,,,,31,43,74
,2011,50100327,,,,3,7,10
,2011,50100338,,,,8,13,21
HND-004003,2011,50100340,,,,3,1,4
,2011,50100346,,,,15,15,30
,2011,50100352,,,,8,20,28
HND-004007,2011,50100353,,,,49,45,94
HND-004008,2011,50100356,,,,20,18,38
HND-004009,2011,50100357,,,,46,24,70
HND-004010,2011,50100363,,,,17,7,24
HND-004011,2011,50100365,,,,53,41,94
HND-004013,2011,50100367,,,,26,27,53
,2011,50100403,,,,3,1,4
,2011,50100413,,,,8,12,20
,2011,50100415,,,,2,4,6
,2011,50100416,,,,5,12,17
,2011,50100423,,,,5,9,14
,2011,50100426,,,,6,10,16
,2011,50100429,,,,10,12,22
,2011,50100430,,,,12,13,25
,2011,50100431,,,,14,17,31
,2011,50100433,,,,13,7,20
,2011,50100438,,,,13,8,21
,2011,50100443,,,,18,18,36
HND-004024,2011,50100449,,,,47,47,94
,2011,50100458,,,,6,11,17
,2011,50100461,,,,2,2,4
,2011,50100467,,,,1,1,2
,2011,50100468,,,,3,0,3
,2011,50100469,,,,8,3,11
,2011,50100470,,,,9,14,23
,2011,50100471,,,,0,1,1
,2011,50100476,,,,47,53,100
,2011,50100477,,,,42,42,84
,2011,50100481,,,,10,14,24
,2011,50100483,,,,9,6,15
,2011,50100499,,,,29,23,52
,2011,50100512,,,,3,6,9
,2011,50100515,,,,10,12,22
,2011,50100517,,,,24,23,47
,2011,50100525,,,,47,41,88
,2011,50100526,,,,12,7,19
,2011,50100528,,,,6,10,16
HND-004043,2011,50100536,,,,39,45,84
HND-004046,2011,50100539,,,,10,3,13
,2011,50100540,,,,46,39,85
,2011,50100544,,,,7,3,10
HND-004047,2011,50100548,,,,26,18,44
,2011,50100549,,,,20,13,33
,2011,50100558,,,,15,16,31
,2011,50100559,,,,51,64,115
HND-004051,2011,50100561,,,,47,44,91
HND-004054,2011,50100565,,,,4,5,9
HND-004055,2011,50100566,,,,68,74,142
,2011,50100580,,,,9,3,12
,2011,50100589,,,,3,12,15
,2011,50100598,,,,12,12,24
,2011,50100608,,,,2,1,3
,2011,50100621,,,,10,12,22
,2011,50100666,,,,3,6,9
,2011,50100673,,,,3,6,9
HND-004066,2011,50100678,,,,9,3,12
,2011,50100688,,,,2,5,7
,2011,50100692,,,,16,8,24
,2011,50100697,,,,8,8,16
,2011,50100703,,,,9,7,16
HND-004071,2011,50100706,,,,17,17,34
,2011,50100709,,,,14,22,36
,2011,50100710,,,,5,9,14
,2011,50100712,,,,5,12,17
HND-004072,2011,50100716,,,,10,9,19
,2011,50100717,,,,45,56,101
,2011,50100771,,,,9,18,27
,2011,50100772,,,,7,5,12
,2011,50100798,,,,7,5,12
,2011,50100808,,,,12,10,22
,2011,50100816,,,,1,0,1
,2011,50100819,,,,30,44,74
,2011,50100820,,,,19,22,41
,2011,50100822,,,,4,9,13
,2011,50100829,,,,6,2,8
,2011,50100830,,,,1,0,1
,2011,50100834,,,,1,5,6
,2011,50100840,,,,24,31,55
,2011,50100852,,,,1,6,7
,2011,50100859,,,,4,3,7
,2011,50100897,,,,6,5,11
,2011,50100898,,,,0,1,1
,2011,50100911,,,,7,9,16
,2011,50100912,,,,10,5,15
,2011,50100916,,,,5,6,11
,2011,50100921,,,,2,1,3
,2011,50100923,,,,3,1,4
,2011,50100931,,,,19,12,31
,2011,50100939,,,,6,2,8
,2011,50100944,,,,1,0,1
HND-004104,2011,50100947,,,,17,13,30
,2011,50100949,,,,3,3,6
,2011,50100958,,,,13,10,23
,2011,50101037,,,,2,8,10
,2011,50101040,,,,2,1,3
,2011,50101042,,,,11,8,19
,2011,50101044,,,,1,5,6
,2011,50101055,,,,12,11,23
,2011,50101057,,,,6,3,9
,2011,50101058,,,,5,6,11
HND-004116,2011,50101061,,,,1,2,3
,2011,50101063,,,,3,10,13
,2011,50101064,,,,5,6,11
,2011,50101164,,,,2,3,5
,2011,50101166,,,,8,12,20
,2011,50101167,,,,4,3,7
HND-004133,2011,50101173,,,,16,12,28
,2011,50101174,,,,4,2,6
,2011,50101179,,,,1,0,1
,2011,50101182,,,,10,4,14
,2011,50101183,,,,2,0,2
HND-004149,2011,50101244,,,,3,4,7
,2011,50101279,,,,5,2,7
,2011,50100003,,,,2,4,6
HND-003844,2011,50100008,,,,4,4,8
,2011,50100009,,,,8,9,17
HND-003845,2011,50100010,,,,10,13,23
,2011,50100011,,,,20,8,28
,2011,50100012,,,,14,16,30
HND-003846,2011,50100013,,,,36,31,67
,2011,50100016,,,,6,6,12
HND-003848,2011,50100018,,,,96,107,203
HND-003849,2011,50100020,,,,0,3,3
HND-003851,2011,50100022,,,,57,44,101
HND-003856,2011,50100029,,,,3,2,5
HND-003857,2011,50100031,,,,77,98,175
,2011,50100033,,,,2,7,9
HND-003860,2011,50100034,,,,45,54,99
HND-003862,2011,50100036,,,,45,41,86
HND-003863,2011,50100037,,,,21,18,39
,2011,50100039,,,,0,48,48
,2011,50100040,,,,1,1,2
HND-003864,2011,50100041,,,,119,137,256
HND-003867,2011,50100044,,,,26,25,51
HND-003870,2011,50100047,,,,7,5,12
HND-003871,2011,50100048,,,,29,31,60
HND-003872,2011,50100049,,,,15,18,33
HND-003873,2011,50100050,,,,7,7,14
HND-003875,2011,50100052,,,,19,17,36
HND-003876,2011,50100053,,,,7,9,16
,2011,50100059,,,,8,10,18
HND-003881,2011,50100061,,,,43,42,85
HND-003882,2011,50100062,,,,129,141,270
HND-003883,2011,50100063,,,,27,7,34
HND-003887,2011,50100068,,,,28,32,60
HND-003888,2011,50100069,,,,90,78,168
HND-003889,2011,50100070,,,,40,37,77
HND-003890,2011,50100071,,,,32,26,58
HND-003893,2011,50100074,,,,1,1,2
HND-003894,2011,50100075,,,,2,5,7
HND-003895,2011,50100076,,,,5,4,9
HND-003896,2011,50100077,,,,64,70,134
HND-003897,2011,50100078,,,,30,44,74
HND-003898,2011,50100080,,,,97,78,175
HND-003901,2011,50100083,,,,43,53,96
,2011,50100085,,,,6,3,9
HND-003905,2011,50100088,,,,0,2,2
HND-003906,2011,50100089,,,,21,24,45
HND-003909,2011,50100092,,,,48,44,92
HND-003911,2011,50100094,,,,5,1,6
HND-003914,2011,50100097,,,,9,5,14
,2011,50100100,,,,7,7,14
,2011,50100102,,,,6,8,14
HND-003922,2011,50100108,,,,38,29,67
HND-003923,2011,50100109,,,,65,46,111
HND-003924,2011,50100113,,,,84,84,168
HND-003926,2011,50100115,,,,83,83,166
,2011,50100117,,,,26,34,60
HND-003928,2011,50100118,,,,17,31,48
HND-003929,2011,50100119,,,,8,13,21
,2011,50100124,,,,11,4,15
HND-003933,2011,50100127,,,,85,93,178
,2011,50100129,,,,46,53,99
,2011,50100133,,,,22,20,42
HND-003936,2011,50100138,,,,36,34,70
HND-003937,2011,50100139,,,,17,18,35
HND-003939,2011,50100142,,,,3,3,6
HND-003940,2011,50100143,,,,1,6,7
,2011,50100149,,,,11,9,20
,2011,50100150,,,,38,48,86
HND-003944,2011,50100151,,,,21,25,46
,2011,50100154,,,,26,30,56
,2011,50100156,,,,4,5,9
,2011,50100157,,,,15,10,25
,2011,50100162,,,,0,2,2
,2011,50100163,,,,0,2,2
HND-003949,2011,50100167,,,,35,19,54
,2011,50100168,,,,35,59,94
HND-003950,2011,50100169,,,,4,5,9
,2011,50100171,,,,5,3,8
HND-003951,2011,50100174,,,,9,4,13
,2011,50100175,,,,26,28,54
HND-003953,2011,50100180,,,,18,15,33
,2011,50100181,,,,4,3,7
,2011,50100187,,,,10,12,22
HND-003961,2011,50100201,,,,31,36,67
HND-003964,2011,50100212,,,,41,43,84
,2011,50100213,,,,5,8,13
HND-003965,2011,50100214,,,,50,35,85
,2011,50100221,,,,24,22,46
,2011,50100227,,,,1,0,1
,2011,50100237,,,,13,27,40
HND-003979,2011,50100277,,,,1,4,5
,2011,50100289,,,,5,4,9
,2011,50100295,,,,11,7,18
HND-003985,2011,50100296,,,,16,14,30
HND-003996,2011,50100323,,,,40,30,70
,2011,50100325,,,,4,2,6
HND-004001,2011,50100336,,,,36,34,70
HND-004004,2011,50100341,,,,42,33,75
,2011,50100347,,,,1,2,3
HND-004008,2011,50100356,,,,15,17,32
HND-004012,2011,50100366,,,,11,12,23
HND-004013,2011,50100367,,,,20,40,60
,2011,50100371,,,,11,27,38
HND-004015,2011,50100374,,,,8,13,21
,2011,50100404,,,,28,28,56
,2011,50100416,,,,10,7,17
,2011,50100421,,,,5,3,8
,2011,50100426,,,,13,19,32
,2011,50100430,,,,8,13,21
,2011,50100436,,,,9,7,16
,2011,50100444,,,,10,3,13
,2011,50100445,,,,17,13,30
,2011,50100446,,,,25,13,38
,2011,50100448,,,,4,3,7
,2011,50100450,,,,6,2,8
HND-004025,2011,50100451,,,,17,11,28
,2011,50100456,,,,8,4,12
,2011,50100467,,,,3,2,5
,2011,50100468,,,,3,5,8
,2011,50100469,,,,11,6,17
,2011,50100475,,,,9,9,18
,2011,50100476,,,,29,44,73
,2011,50100478,,,,4,9,13
,2011,50100485,,,,1,4,5
,2011,50100493,,,,31,50,81
,2011,50100500,,,,25,35,60
,2011,50100508,,,,8,2,10
,2011,50100516,,,,8,1,9
,2011,50100517,,,,19,18,37
,2011,50100521,,,,4,4,8
HND-004040,2011,50100523,,,,28,24,52
HND-004042,2011,50100534,,,,52,57,109
,2011,50100535,,,,10,8,18
HND-004044,2011,50100537,,,,14,9,23
HND-004045,2011,50100538,,,,25,24,49
,2011,50100540,,,,42,43,85
,2011,50100543,,,,8,14,22
,2011,50100554,,,,13,13,26
HND-004050,2011,50100560,,,,30,27,57
HND-004053,2011,50100563,,,,42,40,82
HND-004056,2011,50100567,,,,148,142,290
,2011,50100580,,,,4,5,9
,2011,50100585,,,,42,30,72
,2011,50100586,,,,18,17,35
HND-004060,2011,50100596,,,,40,40,80
HND-004061,2011,50100597,,,,47,39,86
,2011,50100600,,,,9,8,17
HND-004063,2011,50100626,,,,22,25,47
,2011,50100636,,,,3,1,4
,2011,50100643,,,,1,0,1
,2011,50100651,,,,2,3,5
,2011,50100655,,,,20,20,40
,2011,50100659,,,,5,4,9
,2011,50100673,,,,3,6,9
HND-004067,2011,50100685,,,,15,18,33
,2011,50100689,,,,13,30,43
,2011,50100691,,,,19,12,31
,2011,50100703,,,,4,9,13
HND-004071,2011,50100706,,,,19,14,33
,2011,50100709,,,,8,12,20
,2011,50100710,,,,5,5,10
,2011,50100711,,,,0,1,1
,2011,50100712,,,,9,16,25
,2011,50100713,,,,5,9,14
,2011,50100714,,,,6,8,14
,2011,50100715,,,,2,1,3
,2011,50100717,,,,41,42,83
,2011,50100792,,,,26,27,53
,2011,50100824,,,,4,1,5
,2011,50100827,,,,3,0,3
,2011,50100831,,,,5,7,12
,2011,50100832,,,,5,6,11
,2011,50100845,,,,7,3,10
,2011,50100846,,,,4,2,6
,2011,50100848,,,,4,2,6
,2011,50100850,,,,9,6,15
,2011,50100863,,,,7,3,10
,2011,50100898,,,,5,2,7
HND-004096,2011,50100899,,,,25,15,40
,2011,50100903,,,,2,1,3
,2011,50100919,,,,1,0,1
HND-004099,2011,50100920,,,,5,12,17
,2011,50100931,,,,13,14,27
,2011,50100932,,,,0,2,2
,2011,50100941,,,,3,6,9
HND-004104,2011,50100947,,,,15,16,31
,2011,50100951,,,,3,4,7
,2011,50100983,,,,2,2,4
,2011,50101039,,,,8,10,18
,2011,50101044,,,,2,1,3
,2011,50101045,,,,3,4,7
,2011,50101046,,,,6,2,8
,2011,50101047,,,,8,13,21
,2011,50101053,,,,4,5,9
,2011,50101058,,,,4,5,9
,2011,50101059,,,,1,1,2
HND-004122,2011,50101108,,,,2,1,3
,2011,50101168,,,,1,0,1
,2011,50101169,,,,1,0,1
,2011,50101171,,,,2,0,2
,2011,50101172,,,,1,0,1
HND-004134,2011,50101175,,,,21,20,41
,2011,50101177,,,,2,1,3
,2011,50101178,,,,2,2,4
,2011,50101183,,,,2,0,2
,2011,50101259,,,,1,0,1
,2011,50101275,,,,5,4,9
,2011,50101278,,,,8,8,16
,2011,50101281,,,,0,1,1
,2011,50101282,,,,7,7,14
HND-003838,2011,50100001,,,,88,92,180
HND-003839,2011,50100002,,,,8,3,11
HND-003840,2011,50100004,,,,1,0,1
HND-003841,2011,50100005,,,,25,29,54
HND-003842,2011,50100006,,,,7,12,19
HND-003843,2011,50100007,,,,48,55,103
,2011,50100015,,,,3,4,7
HND-003847,2011,50100017,,,,46,25,71
HND-003850,2011,50100021,,,,58,55,113
HND-003852,2011,50100024,,,,2,1,3
HND-003853,2011,50100025,,,,41,54,95
HND-003854,2011,50100027,,,,3,1,4
HND-003855,2011,50100028,,,,19,18,37
HND-003858,2011,50100032,,,,31,27,58
,2011,50100035,,,,13,11,24
,2011,50100038,,,,0,28,28
HND-003865,2011,50100042,,,,57,51,108
HND-003866,2011,50100043,,,,76,57,133
HND-003868,2011,50100045,,,,31,27,58
HND-003869,2011,50100046,,,,118,109,227
HND-003874,2011,50100051,,,,40,36,76
HND-003877,2011,50100055,,,,31,36,67
HND-003878,2011,50100056,,,,7,5,12
HND-003879,2011,50100057,,,,11,12,23
,2011,50100058,,,,62,54,116
HND-003880,2011,50100060,,,,7,8,15
HND-003884,2011,50100064,,,,52,48,100
HND-003885,2011,50100066,,,,62,63,125
HND-003886,2011,50100067,,,,44,37,81
HND-003892,2011,50100073,,,,2,2,4
,2011,50100079,,,,23,25,48
HND-003900,2011,50100082,,,,3,7,10
HND-003902,2011,50100084,,,,8,24,32
HND-003904,2011,50100087,,,,49,59,108
HND-003907,2011,50100090,,,,41,44,85
HND-003908,2011,50100091,,,,2,6,8
,2011,50100093,,,,3,1,4
HND-003912,2011,50100095,,,,43,35,78
HND-003913,2011,50100096,,,,47,51,98
HND-003915,2011,50100098,,,,7,3,10
,2011,50100099,,,,6,4,10
HND-003916,2011,50100101,,,,43,50,93
HND-003918,2011,50100104,,,,44,39,83
HND-003919,2011,50100105,,,,22,29,51
HND-003920,2011,50100106,,,,50,61,111
HND-003921,2011,50100107,,,,45,64,109
,2011,50100110,,,,18,21,39
,2011,50100112,,,,40,24,64
HND-003925,2011,50100114,,,,45,36,81
HND-003927,2011,50100116,,,,29,32,61
HND-003930,2011,50100120,,,,43,38,81
,2011,50100121,,,,10,5,15
HND-003931,2011,50100123,,,,59,48,107
HND-003932,2011,50100126,,,,12,10,22
,2011,50100130,,,,7,0,7
,2011,50100131,,,,8,6,14
,2011,50100135,,,,4,3,7
HND-003934,2011,50100136,,,,14,10,24
HND-003935,2011,50100137,,,,36,38,74
HND-003938,2011,50100140,,,,28,37,65
HND-003941,2011,50100144,,,,19,16,35
,2011,50100145,,,,4,1,5
HND-003942,2011,50100146,,,,41,43,84
,2011,50100147,,,,21,9,30
HND-003943,2011,50100148,,,,42,49,91
HND-003945,2011,50100152,,,,2,3,5
,2011,50100159,,,,21,17,38
HND-003946,2011,50100160,,,,18,18,36
HND-003947,2011,50100161,,,,63,74,137
HND-003948,2011,50100165,,,,13,16,29
,2011,50100166,,,,57,66,123
,2011,50100173,,,,23,27,50
,2011,50100176,,,,1,2,3
HND-003952,2011,50100177,,,,2,4,6
,2011,50100178,,,,0,5,5
,2011,50100179,,,,3,4,7
HND-003959,2011,50100197,,,,29,25,54
,2011,50100198,,,,7,11,18
,2011,50100216,,,,3,1,4
,2011,50100220,,,,16,18,34
,2011,50100239,,,,2,4,6
HND-003969,2011,50100243,,,,30,29,59
,2011,50100245,,,,3,8,11
,2011,50100246,,,,14,17,31
HND-003973,2011,50100250,,,,18,12,30
,2011,50100258,,,,4,2,6
HND-003977,2011,50100268,,,,25,25,50
,2011,50100270,,,,4,5,9
,2011,50100273,,,,3,0,3
,2011,50100294,,,,13,13,26
HND-003986,2011,50100299,,,,2,2,4
HND-003993,2011,50100314,,,,10,11,21
,2011,50100327,,,,11,11,22
HND-004002,2011,50100337,,,,37,40,77
,2011,50100338,,,,12,9,21
HND-004003,2011,50100340,,,,3,2,5
,2011,50100346,,,,15,11,26
,2011,50100352,,,,15,17,32
HND-004007,2011,50100353,,,,16,30,46
,2011,50100354,,,,17,4,21
HND-004009,2011,50100357,,,,31,26,57
HND-004010,2011,50100363,,,,16,16,32
HND-004011,2011,50100365,,,,52,33,85
,2011,50100403,,,,2,2,4
,2011,50100413,,,,19,5,24
,2011,50100415,,,,3,4,7
,2011,50100418,,,,7,8,15
,2011,50100419,,,,6,13,19
,2011,50100423,,,,8,8,16
,2011,50100425,,,,4,3,7
,2011,50100428,,,,12,16,28
,2011,50100429,,,,16,21,37
,2011,50100431,,,,10,15,25
,2011,50100433,,,,13,7,20
,2011,50100438,,,,8,9,17
,2011,50100443,,,,23,15,38
HND-004024,2011,50100449,,,,40,46,86
,2011,50100455,,,,8,17,25
,2011,50100458,,,,6,4,10
,2011,50100459,,,,6,14,20
,2011,50100461,,,,5,2,7
,2011,50100470,,,,7,18,25
,2011,50100471,,,,4,3,7
,2011,50100477,,,,35,42,77
,2011,50100481,,,,16,5,21
,2011,50100483,,,,8,8,16
,2011,50100497,,,,10,10,20
,2011,50100499,,,,27,27,54
,2011,50100512,,,,2,3,5
,2011,50100515,,,,10,8,18
,2011,50100525,,,,37,35,72
,2011,50100526,,,,5,10,15
,2011,50100527,,,,3,5,8
,2011,50100528,,,,15,11,26
,2011,50100531,,,,17,15,32
HND-004041,2011,50100532,,,,39,32,71
HND-004043,2011,50100536,,,,27,36,63
HND-004046,2011,50100539,,,,13,16,29
,2011,50100544,,,,5,5,10
HND-004047,2011,50100548,,,,23,15,38
,2011,50100549,,,,7,9,16
,2011,50100558,,,,15,20,35
,2011,50100559,,,,61,62,123
HND-004051,2011,50100561,,,,50,47,97
,2011,50100564,,,,54,53,107
HND-004054,2011,50100565,,,,6,8,14
HND-004055,2011,50100566,,,,81,79,160
HND-004057,2011,50100570,,,,6,4,10
,2011,50100572,,,,0,1,1
,2011,50100589,,,,11,9,20
,2011,50100598,,,,13,9,22
,2011,50100621,,,,9,7,16
,2011,50100666,,,,4,6,10
HND-004066,2011,50100678,,,,15,4,19
,2011,50100680,,,,7,5,12
,2011,50100688,,,,4,2,6
,2011,50100692,,,,8,20,28
,2011,50100697,,,,13,9,22
,2011,50100705,,,,15,8,23
HND-004072,2011,50100716,,,,14,5,19
,2011,50100771,,,,6,20,26
,2011,50100772,,,,3,5,8
HND-004083,2011,50100788,,,,29,32,61
,2011,50100798,,,,9,10,19
,2011,50100808,,,,13,8,21
,2011,50100816,,,,1,0,1
,2011,50100818,,,,16,12,28
,2011,50100819,,,,34,36,70
,2011,50100820,,,,20,24,44
,2011,50100822,,,,4,2,6
,2011,50100829,,,,1,3,4
,2011,50100830,,,,1,2,3
,2011,50100834,,,,1,5,6
,2011,50100840,,,,19,26,45
,2011,50100852,,,,6,2,8
,2011,50100859,,,,3,6,9
,2011,50100888,,,,0,2,2
,2011,50100891,,,,2,1,3
,2011,50100897,,,,5,3,8
HND-004098,2011,50100907,,,,25,26,51
,2011,50100911,,,,6,13,19
,2011,50100912,,,,5,5,10
,2011,50100916,,,,5,6,11
,2011,50100921,,,,1,2,3
,2011,50100923,,,,4,1,5
,2011,50100924,,,,0,4,4
,2011,50100939,,,,4,4,8
,2011,50100949,,,,4,5,9
,2011,50100958,,,,13,4,17
,2011,50101037,,,,1,2,3
,2011,50101040,,,,4,2,6
,2011,50101042,,,,12,12,24
,2011,50101055,,,,11,8,19
,2011,50101057,,,,3,4,7
HND-004116,2011,50101061,,,,2,2,4
HND-004117,2011,50101062,,,,5,3,8
,2011,50101063,,,,4,7,11
,2011,50101064,,,,1,1,2
,2011,50101164,,,,1,1,2
,2011,50101166,,,,3,3,6
,2011,50101167,,,,2,1,3
HND-004133,2011,50101173,,,,8,11,19
,2011,50101174,,,,0,2,2
,2011,50101181,,,,3,3,6
HND-004149,2011,50101244,,,,6,2,8
,2011,50101256,,,,1,1,2
,2011,50101264,,,,7,4,11
,2011,50101265,,,,15,12,27
,2011,50101266,,,,7,2,9
,2011,50101279,,,,2,3,5
HND-003838,2011,50100001,,,,81,77,158
HND-003842,2011,50100006,,,,7,4,11
HND-003843,2011,50100007,,,,40,39,79
HND-003844,2011,50100008,,,,2,3,5
,2011,50100011,,,,17,17,34
,2011,50100015,,,,0,4,4
,2011,50100016,,,,3,2,5
HND-003847,2011,50100017,,,,23,34,57
HND-003848,2011,50100018,,,,95,111,206
HND-003850,2011,50100021,,,,61,83,144
HND-003851,2011,50100022,,,,68,41,109
HND-003853,2011,50100025,,,,43,43,86
HND-003854,2011,50100027,,,,3,2,5
HND-003855,2011,50100028,,,,17,17,34
HND-003857,2011,50100031,,,,80,89,169
HND-003858,2011,50100032,,,,29,22,51
HND-003860,2011,50100034,,,,58,57,115
,2011,50100035,,,,12,17,29
,2011,50100038,,,,0,31,31
,2011,50100039,,,,0,45,45
HND-003864,2011,50100041,,,,118,128,246
HND-003865,2011,50100042,,,,44,47,91
HND-003866,2011,50100043,,,,53,55,108
HND-003867,2011,50100044,,,,34,40,74
HND-003868,2011,50100045,,,,19,17,36
HND-003869,2011,50100046,,,,104,130,234
HND-003870,2011,50100047,,,,4,1,5
HND-003874,2011,50100051,,,,31,51,82
HND-003875,2011,50100052,,,,20,9,29
HND-003877,2011,50100055,,,,29,31,60
HND-003878,2011,50100056,,,,8,3,11
HND-003879,2011,50100057,,,,11,15,26
,2011,50100058,,,,69,52,121
,2011,50100059,,,,17,13,30
HND-003881,2011,50100061,,,,41,38,79
HND-003885,2011,50100066,,,,51,54,105
HND-003886,2011,50100067,,,,33,50,83
HND-003887,2011,50100068,,,,29,29,58
HND-003891,2011,50100072,,,,3,4,7
HND-003892,2011,50100073,,,,3,9,12
HND-003893,2011,50100074,,,,1,3,4
,2011,50100079,,,,24,16,40
HND-003901,2011,50100083,,,,53,48,101
HND-003902,2011,50100084,,,,24,24,48
,2011,50100085,,,,4,3,7
HND-003905,2011,50100088,,,,2,2,4
HND-003906,2011,50100089,,,,28,19,47
HND-003907,2011,50100090,,,,43,45,88
HND-003908,2011,50100091,,,,0,1,1
HND-003909,2011,50100092,,,,32,46,78
,2011,50100093,,,,5,0,5
,2011,50100099,,,,6,6,12
,2011,50100100,,,,9,8,17
HND-003919,2011,50100105,,,,20,21,41
HND-003920,2011,50100106,,,,53,58,111
HND-003921,2011,50100107,,,,58,61,119
HND-003922,2011,50100108,,,,28,23,51
,2011,50100112,,,,37,34,71
HND-003927,2011,50100116,,,,23,25,48
HND-003928,2011,50100118,,,,14,11,25
HND-003930,2011,50100120,,,,38,38,76
HND-003931,2011,50100123,,,,56,50,106
HND-003932,2011,50100126,,,,9,6,15
,2011,50100129,,,,40,45,85
,2011,50100130,,,,8,3,11
,2011,50100133,,,,21,23,44
,2011,50100135,,,,2,6,8
HND-003935,2011,50100137,,,,36,38,74
HND-003936,2011,50100138,,,,27,31,58
HND-003937,2011,50100139,,,,17,18,35
HND-003939,2011,50100142,,,,0,4,4
HND-003941,2011,50100144,,,,12,28,40
HND-003943,2011,50100148,,,,45,43,88
HND-003944,2011,50100151,,,,25,21,46
HND-003945,2011,50100152,,,,4,2,6
,2011,50100154,,,,21,33,54
,2011,50100157,,,,12,11,23
,2011,50100159,,,,15,23,38
HND-003946,2011,50100160,,,,17,15,32
HND-003947,2011,50100161,,,,58,69,127
,2011,50100162,,,,0,1,1
HND-003948,2011,50100165,,,,3,18,21
,2011,50100168,,,,41,42,83
,2011,50100173,,,,14,17,31
,2011,50100179,,,,5,1,6
HND-003953,2011,50100180,,,,17,20,37
,2011,50100181,,,,4,13,17
,2011,50100187,,,,6,18,24
,2011,50100198,,,,18,15,33
HND-003961,2011,50100201,,,,43,46,89
HND-003964,2011,50100212,,,,56,46,102
,2011,50100216,,,,4,1,5
,2011,50100220,,,,20,19,39
,2011,50100221,,,,16,21,37
,2011,50100237,,,,17,10,27
HND-003969,2011,50100243,,,,35,30,65
,2011,50100246,,,,15,9,24
HND-003973,2011,50100250,,,,10,10,20
HND-003977,2011,50100268,,,,25,20,45
,2011,50100289,,,,2,3,5
,2011,50100294,,,,0,6,6
,2011,50100295,,,,7,6,13
HND-003985,2011,50100296,,,,13,12,25
HND-003986,2011,50100299,,,,0,2,2
HND-003996,2011,50100323,,,,25,29,54
,2011,50100338,,,,7,14,21
,2011,50100346,,,,16,15,31
,2011,50100347,,,,2,2,4
HND-004007,2011,50100353,,,,33,38,71
HND-004008,2011,50100356,,,,14,16,30
HND-004009,2011,50100357,,,,39,39,78
HND-004010,2011,50100363,,,,15,11,26
HND-004011,2011,50100365,,,,35,42,77
HND-004012,2011,50100366,,,,11,13,24
HND-004013,2011,50100367,,,,34,34,68
,2011,50100403,,,,1,1,2
,2011,50100413,,,,10,10,20
,2011,50100415,,,,3,1,4
,2011,50100416,,,,5,5,10
,2011,50100418,,,,6,5,11
,2011,50100419,,,,10,22,32
,2011,50100421,,,,3,5,8
,2011,50100423,,,,11,7,18
,2011,50100430,,,,7,8,15
,2011,50100431,,,,19,12,31
,2011,50100433,,,,7,6,13
,2011,50100436,,,,11,14,25
,2011,50100438,,,,3,10,13
,2011,50100443,,,,20,27,47
,2011,50100444,,,,9,3,12
,2011,50100461,,,,3,4,7
,2011,50100467,,,,2,3,5
,2011,50100470,,,,8,15,23
,2011,50100475,,,,11,6,17
,2011,50100476,,,,49,41,90
,2011,50100477,,,,45,40,85
,2011,50100478,,,,6,2,8
,2011,50100481,,,,8,9,17
,2011,50100483,,,,6,4,10
,2011,50100484,,,,1,2,3
,2011,50100499,,,,30,17,47
,2011,50100512,,,,3,6,9
,2011,50100515,,,,8,8,16
,2011,50100517,,,,14,22,36
,2011,50100521,,,,2,7,9
,2011,50100525,,,,36,30,66
,2011,50100526,,,,10,7,17
,2011,50100528,,,,7,14,21
HND-004041,2011,50100532,,,,27,15,42
HND-004045,2011,50100538,,,,23,17,40
HND-004046,2011,50100539,,,,7,8,15
,2011,50100543,,,,11,5,16
,2011,50100544,,,,1,4,5
HND-004047,2011,50100548,,,,26,25,51
,2011,50100549,,,,8,11,19
,2011,50100558,,,,17,12,29
HND-004051,2011,50100561,,,,32,45,77
HND-004053,2011,50100563,,,,43,44,87
HND-004057,2011,50100570,,,,7,1,8
,2011,50100572,,,,1,1,2
,2011,50100580,,,,6,3,9
,2011,50100589,,,,9,2,11
,2011,50100598,,,,11,6,17
,2011,50100608,,,,0,1,1
,2011,50100655,,,,23,13,36
,2011,50100666,,,,2,1,3
,2011,50100673,,,,6,4,10
HND-004066,2011,50100678,,,,2,6,8
,2011,50100688,,,,4,3,7
,2011,50100692,,,,10,11,21
,2011,50100697,,,,10,5,15
,2011,50100703,,,,2,12,14
HND-004071,2011,50100706,,,,19,15,34
,2011,50100712,,,,3,11,14
,2011,50100713,,,,4,6,10
,2011,50100715,,,,0,2,2
,2011,50100771,,,,8,5,13
,2011,50100772,,,,0,6,6
,2011,50100792,,,,19,15,34
,2011,50100798,,,,5,5,10
,2011,50100819,,,,36,25,61
,2011,50100820,,,,19,20,39
,2011,50100822,,,,0,2,2
,2011,50100831,,,,3,6,9
,2011,50100834,,,,6,3,9
,2011,50100848,,,,2,3,5
,2011,50100859,,,,7,3,10
,2011,50100891,,,,1,2,3
,2011,50100897,,,,9,5,14
,2011,50100898,,,,2,5,7
,2011,50100911,,,,4,4,8
,2011,50100912,,,,5,5,10
,2011,50100916,,,,8,8,16
,2011,50100921,,,,1,1,2
,2011,50100931,,,,14,9,23
,2011,50100941,,,,2,2,4
HND-004104,2011,50100947,,,,18,16,34
,2011,50100949,,,,2,3,5
,2011,50100958,,,,11,5,16
,2011,50101037,,,,5,3,8
,2011,50101042,,,,1,5,6
,2011,50101044,,,,3,8,11
,2011,50101047,,,,8,5,13
,2011,50101055,,,,8,4,12
,2011,50101057,,,,2,1,3
,2011,50101058,,,,7,4,11
,2011,50101064,,,,0,1,1
,2011,50101166,,,,6,4,10
,2011,50101167,,,,5,4,9
,2011,50101168,,,,1,2,3
,2011,50101171,,,,1,2,3
HND-004133,2011,50101173,,,,11,14,25
,2011,50101174,,,,2,1,3
,2011,50101177,,,,1,3,4
,2011,50101183,,,,1,2,3
HND-004149,2011,50101244,,,,2,5,7
,2011,50101259,,,,3,0,3
,2011,50101265,,,,11,18,29
,2011,50101266,,,,5,4,9
,2011,50101282,,,,5,9,14
HND-003839,2011,50100002,,,,6,7,13
,2011,50100003,,,,2,5,7
HND-003840,2011,50100004,,,,3,2,5
HND-003841,2011,50100005,,,,20,18,38
,2011,50100009,,,,12,11,23
HND-003845,2011,50100010,,,,13,10,23
,2011,50100012,,,,21,12,33
HND-003846,2011,50100013,,,,55,43,98
HND-003849,2011,50100020,,,,5,7,12
HND-003852,2011,50100024,,,,1,3,4
HND-003856,2011,50100029,,,,2,3,5
,2011,50100033,,,,7,2,9
HND-003862,2011,50100036,,,,33,35,68
HND-003863,2011,50100037,,,,13,22,35
,2011,50100040,,,,2,1,3
HND-003871,2011,50100048,,,,23,27,50
HND-003872,2011,50100049,,,,15,7,22
HND-003873,2011,50100050,,,,5,1,6
HND-003876,2011,50100053,,,,7,9,16
HND-003880,2011,50100060,,,,6,5,11
HND-003882,2011,50100062,,,,117,128,245
HND-003883,2011,50100063,,,,26,10,36
HND-003884,2011,50100064,,,,37,36,73
HND-003888,2011,50100069,,,,89,94,183
HND-003889,2011,50100070,,,,18,20,38
HND-003890,2011,50100071,,,,26,33,59
HND-003894,2011,50100075,,,,2,4,6
HND-003895,2011,50100076,,,,0,5,5
HND-003896,2011,50100077,,,,62,66,128
HND-003897,2011,50100078,,,,27,37,64
HND-003898,2011,50100080,,,,65,71,136
HND-003900,2011,50100082,,,,7,7,14
HND-003904,2011,50100087,,,,67,66,133
HND-003911,2011,50100094,,,,0,1,1
HND-003912,2011,50100095,,,,38,44,82
HND-003913,2011,50100096,,,,48,46,94
HND-003914,2011,50100097,,,,9,4,13
HND-003915,2011,50100098,,,,4,0,4
HND-003916,2011,50100101,,,,31,53,84
,2011,50100102,,,,5,5,10
HND-003918,2011,50100104,,,,48,50,98
HND-003923,2011,50100109,,,,67,61,128
,2011,50100110,,,,14,20,34
HND-003924,2011,50100113,,,,74,49,123
HND-003925,2011,50100114,,,,43,46,89
HND-003926,2011,50100115,,,,76,78,154
,2011,50100117,,,,23,36,59
HND-003929,2011,50100119,,,,6,9,15
,2011,50100121,,,,7,7,14
,2011,50100124,,,,9,14,23
HND-003933,2011,50100127,,,,71,76,147
,2011,50100131,,,,9,15,24
HND-003934,2011,50100136,,,,10,10,20
HND-003938,2011,50100140,,,,27,31,58
HND-003940,2011,50100143,,,,5,4,9
HND-003942,2011,50100146,,,,60,55,115
,2011,50100147,,,,11,10,21
,2011,50100149,,,,7,14,21
,2011,50100150,,,,39,57,96
,2011,50100156,,,,3,1,4
,2011,50100163,,,,2,0,2
,2011,50100166,,,,80,71,151
HND-003949,2011,50100167,,,,17,21,38
HND-003950,2011,50100169,,,,5,0,5
,2011,50100171,,,,4,4,8
HND-003951,2011,50100174,,,,12,7,19
,2011,50100175,,,,16,28,44
,2011,50100176,,,,1,1,2
HND-003952,2011,50100177,,,,1,2,3
,2011,50100178,,,,1,3,4
HND-003959,2011,50100197,,,,29,28,57
,2011,50100213,,,,0,7,7
HND-003965,2011,50100214,,,,34,33,67
,2011,50100227,,,,0,1,1
,2011,50100245,,,,7,3,10
,2011,50100258,,,,2,3,5
,2011,50100270,,,,7,9,16
,2011,50100273,,,,1,0,1
HND-003979,2011,50100277,,,,5,1,6
HND-003993,2011,50100314,,,,17,10,27
,2011,50100325,,,,12,4,16
,2011,50100327,,,,10,6,16
HND-004001,2011,50100336,,,,32,29,61
HND-004002,2011,50100337,,,,37,47,84
HND-004003,2011,50100340,,,,1,1,2
HND-004004,2011,50100341,,,,26,12,38
,2011,50100352,,,,5,11,16
,2011,50100354,,,,11,18,29
,2011,50100371,,,,12,10,22
HND-004015,2011,50100374,,,,8,5,13
,2011,50100404,,,,33,28,61
,2011,50100425,,,,1,6,7
,2011,50100426,,,,14,17,31
,2011,50100428,,,,12,20,32
,2011,50100429,,,,8,12,20
,2011,50100445,,,,28,29,57
,2011,50100446,,,,22,16,38
,2011,50100448,,,,2,3,5
HND-004024,2011,50100449,,,,52,40,92
,2011,50100450,,,,9,6,15
HND-004025,2011,50100451,,,,6,11,17
,2011,50100455,,,,12,21,33
,2011,50100456,,,,4,4,8
,2011,50100458,,,,8,6,14
,2011,50100459,,,,10,9,19
,2011,50100468,,,,5,5,10
,2011,50100469,,,,7,8,15
,2011,50100471,,,,4,1,5
,2011,50100485,,,,5,3,8
,2011,50100493,,,,38,39,77
,2011,50100497,,,,7,8,15
,2011,50100500,,,,35,36,71
,2011,50100508,,,,5,6,11
,2011,50100516,,,,8,9,17
HND-004040,2011,50100523,,,,18,35,53
,2011,50100527,,,,7,4,11
,2011,50100531,,,,4,21,25
HND-004042,2011,50100534,,,,40,38,78
,2011,50100535,,,,1,0,1
HND-004043,2011,50100536,,,,48,33,81
HND-004044,2011,50100537,,,,2,6,8
,2011,50100540,,,,37,39,76
,2011,50100554,,,,15,17,32
,2011,50100559,,,,64,57,121
HND-004050,2011,50100560,,,,19,21,40
,2011,50100564,,,,47,58,105
HND-004054,2011,50100565,,,,7,8,15
HND-004055,2011,50100566,,,,67,61,128
HND-004056,2011,50100567,,,,105,112,217
,2011,50100585,,,,49,30,79
,2011,50100586,,,,13,19,32
HND-004060,2011,50100596,,,,40,35,75
HND-004061,2011,50100597,,,,50,37,87
,2011,50100600,,,,7,7,14
,2011,50100621,,,,7,2,9
HND-004063,2011,50100626,,,,19,11,30
,2011,50100636,,,,2,0,2
,2011,50100643,,,,1,5,6
,2011,50100651,,,,1,4,5
,2011,50100659,,,,2,2,4
,2011,50100680,,,,4,2,6
HND-004067,2011,50100685,,,,12,12,24
,2011,50100689,,,,11,7,18
,2011,50100691,,,,13,15,28
,2011,50100705,,,,14,11,25
,2011,50100709,,,,4,17,21
,2011,50100710,,,,2,2,4
,2011,50100711,,,,1,0,1
HND-004072,2011,50100716,,,,4,10,14
,2011,50100717,,,,32,40,72
HND-004083,2011,50100788,,,,18,26,44
,2011,50100808,,,,9,9,18
,2011,50100818,,,,7,10,17
,2011,50100824,,,,1,1,2
,2011,50100829,,,,1,1,2
,2011,50100832,,,,2,4,6
,2011,50100840,,,,16,13,29
,2011,50100845,,,,5,3,8
,2011,50100846,,,,4,2,6
,2011,50100863,,,,1,3,4
,2011,50100888,,,,2,1,3
HND-004096,2011,50100899,,,,16,26,42
HND-004098,2011,50100907,,,,26,24,50
,2011,50100919,,,,3,1,4
HND-004099,2011,50100920,,,,2,2,4
,2011,50100924,,,,0,1,1
,2011,50100939,,,,3,4,7
,2011,50100951,,,,2,1,3
,2011,50100983,,,,0,2,2
,2011,50101039,,,,12,10,22
,2011,50101045,,,,4,2,6
,2011,50101046,,,,1,6,7
,2011,50101053,,,,3,1,4
,2011,50101059,,,,1,1,2
HND-004116,2011,50101061,,,,3,2,5
,2011,50101063,,,,4,4,8
,2011,50101164,,,,1,4,5
,2011,50101170,,,,1,2,3
,2011,50101172,,,,1,0,1
HND-004134,2011,50101175,,,,14,7,21
,2011,50101176,,,,0,2,2
,2011,50101178,,,,4,2,6
,2011,50101179,,,,0,2,2
,2011,50101181,,,,1,2,3
,2011,50101264,,,,2,5,7
,2011,50101275,,,,2,5,7
,2011,50101278,,,,5,7,12
HND-003842,2011,50100006,,,,20,23,43
,2011,50100012,,,,12,12,24
HND-003846,2011,50100013,,,,20,25,45
HND-003848,2011,50100018,,,,40,58,98
HND-003851,2011,50100022,,,,15,14,29
HND-003853,2011,50100025,,,,17,25,42
HND-003862,2011,50100036,,,,24,20,44
,2011,50100038,,,,0,261,261
HND-003865,2011,50100042,,,,17,35,52
HND-003868,2011,50100045,,,,18,27,45
HND-003879,2011,50100057,,,,13,8,21
,2011,50100058,,,,21,27,48
HND-003882,2011,50100062,,,,21,24,45
HND-003883,2011,50100063,,,,9,9,18
HND-003887,2011,50100068,,,,22,28,50
HND-003888,2011,50100069,,,,21,31,52
,2011,50100079,,,,21,21,42
HND-003902,2011,50100084,,,,25,27,52
HND-003904,2011,50100087,,,,39,32,71
HND-003912,2011,50100095,,,,31,50,81
HND-003913,2011,50100096,,,,25,26,51
,2011,50100110,,,,16,12,28
,2011,50100112,,,,43,48,91
HND-003926,2011,50100115,,,,56,37,93
,2011,50100117,,,,27,30,57
HND-003928,2011,50100118,,,,22,24,46
HND-003930,2011,50100120,,,,12,19,31
,2011,50100121,,,,13,6,19
HND-003931,2011,50100123,,,,47,47,94
HND-003933,2011,50100127,,,,23,21,44
,2011,50100129,,,,50,58,108
,2011,50100130,,,,38,9,47
,2011,50100131,,,,8,3,11
,2011,50100133,,,,33,24,57
,2011,50100134,,,,12,12,24
,2011,50100135,,,,7,5,12
,2011,50100145,,,,0,2,2
,2011,50100147,,,,6,2,8
,2011,50100170,,,,5,5,10
,2011,50100175,,,,30,41,71
HND-003953,2011,50100180,,,,19,20,39
,2011,50100225,,,,297,279,576
,2011,50100227,,,,14,9,23
,2011,50100228,,,,297,336,633
,2011,50100230,,,,94,73,167
,2011,50100231,,,,30,14,44
,2011,50100232,,,,52,35,87
,2011,50100239,,,,3,2,5
,2011,50100241,,,,88,43,131
,2011,50100244,,,,50,76,126
HND-003971,2011,50100247,,,,102,108,210
,2011,50100273,,,,11,8,19
,2011,50100291,,,,26,34,60
HND-003987,2011,50100300,,,,53,57,110
HND-003996,2011,50100323,,,,24,25,49
,2011,50100327,,,,6,12,18
,2011,50100352,,,,10,14,24
,2011,50100354,,,,12,14,26
,2011,50100359,,,,13,18,31
,2011,50100361,,,,13,14,27
,2011,50100362,,,,3,8,11
HND-004012,2011,50100366,,,,235,204,439
,2011,50100371,,,,12,13,25
,2011,50100381,,,,25,9,34
,2011,50100383,,,,9,15,24
,2011,50100384,,,,42,52,94
,2011,50100385,,,,40,66,106
,2011,50100388,,,,592,576,1168
,2011,50100413,,,,13,13,26
,2011,50100419,,,,7,5,12
,2011,50100433,,,,11,10,21
,2011,50100438,,,,5,2,7
,2011,50100445,,,,3,5,8
,2011,50100455,,,,7,13,20
,2011,50100456,,,,10,3,13
,2011,50100459,,,,4,7,11
,2011,50100471,,,,0,3,3
,2011,50100472,,,,6,4,10
,2011,50100483,,,,6,2,8
,2011,50100497,,,,7,6,13
,2011,50100516,,,,8,18,26
,2011,50100527,,,,3,5,8
HND-004041,2011,50100532,,,,15,20,35
,2011,50100533,,,,32,32,64
,2011,50100535,,,,8,7,15
,2011,50100549,,,,7,5,12
,2011,50100554,,,,17,27,44
HND-004053,2011,50100563,,,,40,30,70
,2011,50100564,,,,55,55,110
HND-004056,2011,50100567,,,,21,29,50
,2011,50100585,,,,61,65,126
,2011,50100586,,,,14,19,33
,2011,50100593,,,,26,36,62
HND-004061,2011,50100597,,,,50,50,100
,2011,50100599,,,,13,24,37
,2011,50100600,,,,15,10,25
,2011,50100606,,,,80,77,157
,2011,50100607,,,,41,44,85
,2011,50100621,,,,5,8,13
,2011,50100634,,,,22,25,47
,2011,50100635,,,,34,27,61
,2011,50100636,,,,5,6,11
,2011,50100638,,,,25,38,63
,2011,50100696,,,,10,3,13
,2011,50100712,,,,18,16,34
,2011,50100713,,,,8,9,17
,2011,50100818,,,,11,11,22
,2011,50100819,,,,25,25,50
,2011,50100829,,,,14,19,33
,2011,50100832,,,,6,6,12
,2011,50100863,,,,15,10,25
HND-004095,2011,50100883,,,,3,0,3
,2011,50100884,,,,33,30,63
,2011,50100894,,,,28,24,52
,2011,50100911,,,,1,5,6
,2011,50100917,,,,0,3,3
,2011,50100919,,,,1,1,2
,2011,50100938,,,,7,9,16
,2011,50100958,,,,7,4,11
,2011,50100983,,,,3,9,12
,2011,50101037,,,,13,12,25
,2011,50101042,,,,2,3,5
,2011,50101049,,,,2,1,3
,2011,50101151,,,,23,11,34
,2011,50101164,,,,8,16,24
,2011,50101178,,,,3,5,8
,2011,50101181,,,,5,5,10
,2011,50101184,,,,20,30,50
,2011,50101185,,,,11,12,23
,2011,50101187,,,,17,12,29
,2011,50101263,,,,6,5,11
,2011,50101265,,,,10,9,19
,2011,50101278,,,,30,26,56
,2011,50101279,,,,2,1,3
,2011,50101296,,,,5,1,6
HND-003841,2011,50100005,,,,26,17,43
,2011,50100011,,,,24,36,60
,2011,50100015,,,,2,2,4
HND-003850,2011,50100021,,,,27,25,52
HND-003855,2011,50100028,,,,15,13,28
HND-003857,2011,50100031,,,,61,67,128
HND-003860,2011,50100034,,,,98,91,189
HND-003864,2011,50100041,,,,49,50,99
HND-003867,2011,50100044,,,,21,30,51
HND-003880,2011,50100060,,,,14,9,23
HND-003886,2011,50100067,,,,54,47,101
HND-003890,2011,50100071,,,,36,21,57
HND-003896,2011,50100077,,,,32,37,69
HND-003897,2011,50100078,,,,17,29,46
HND-003901,2011,50100083,,,,33,22,55
HND-003906,2011,50100089,,,,13,19,32
HND-003909,2011,50100092,,,,28,29,57
HND-003918,2011,50100104,,,,36,48,84
HND-003921,2011,50100107,,,,38,34,72
HND-003927,2011,50100116,,,,17,18,35
HND-003938,2011,50100140,,,,27,18,45
,2011,50100149,,,,10,9,19
,2011,50100157,,,,3,7,10
HND-003947,2011,50100161,,,,48,44,92
,2011,50100166,,,,24,21,45
,2011,50100171,,,,0,3,3
,2011,50100173,,,,22,18,40
,2011,50100187,,,,7,12,19
HND-003959,2011,50100197,,,,26,17,43
HND-003961,2011,50100201,,,,44,40,84
HND-003964,2011,50100212,,,,26,24,50
,2011,50100213,,,,7,10,17
,2011,50100218,,,,20,26,46
,2011,50100220,,,,23,24,47
,2011,50100221,,,,12,31,43
HND-003966,2011,50100226,,,,161,199,360
HND-003967,2011,50100233,,,,197,178,375
,2011,50100234,,,,7,4,11
HND-003968,2011,50100235,,,,192,267,459
,2011,50100237,,,,11,13,24
,2011,50100240,,,,25,12,37
HND-003972,2011,50100248,,,,53,55,108
,2011,50100289,,,,8,8,16
,2011,50100294,,,,11,15,26
,2011,50100346,,,,12,15,27
HND-004011,2011,50100365,,,,29,20,49
,2011,50100368,,,,141,20,161
,2011,50100382,,,,60,42,102
,2011,50100387,,,,22,31,53
,2011,50100402,,,,9,7,16
,2011,50100404,,,,31,28,59
,2011,50100426,,,,15,16,31
,2011,50100428,,,,21,15,36
,2011,50100429,,,,14,12,26
,2011,50100430,,,,6,9,15
,2011,50100442,,,,50,17,67
,2011,50100443,,,,15,16,31
,2011,50100444,,,,11,12,23
,2011,50100446,,,,31,39,70
,2011,50100454,,,,5,10,15
,2011,50100461,,,,2,2,4
,2011,50100469,,,,17,14,31
,2011,50100470,,,,8,8,16
,2011,50100475,,,,6,2,8
,2011,50100476,,,,22,39,61
,2011,50100477,,,,48,58,106
,2011,50100484,,,,7,3,10
,2011,50100499,,,,31,25,56
,2011,50100500,,,,29,25,54
,2011,50100512,,,,1,0,1
,2011,50100517,,,,19,12,31
,2011,50100521,,,,4,8,12
,2011,50100526,,,,5,9,14
,2011,50100528,,,,21,15,36
HND-004042,2011,50100534,,,,20,25,45
,2011,50100543,,,,14,9,23
,2011,50100551,,,,2,2,4
HND-004055,2011,50100566,,,,42,57,99
,2011,50100569,,,,25,37,62
,2011,50100576,,,,16,15,31
,2011,50100578,,,,23,28,51
,2011,50100580,,,,16,16,32
,2011,50100582,,,,18,18,36
,2011,50100588,,,,21,31,52
,2011,50100589,,,,16,39,55
HND-004060,2011,50100596,,,,28,40,68
,2011,50100598,,,,23,23,46
,2011,50100608,,,,25,24,49
,2011,50100609,,,,31,19,50
,2011,50100610,,,,22,21,43
,2011,50100612,,,,20,23,43
,2011,50100633,,,,10,10,20
,2011,50100643,,,,20,32,52
,2011,50100645,,,,25,19,44
,2011,50100655,,,,16,21,37
,2011,50100668,,,,21,22,43
,2011,50100671,,,,12,11,23
,2011,50100673,,,,16,8,24
,2011,50100684,,,,18,14,32
,2011,50100688,,,,1,2,3
,2011,50100689,,,,13,16,29
,2011,50100691,,,,6,7,13
,2011,50100697,,,,45,48,93
,2011,50100705,,,,8,13,21
HND-004071,2011,50100706,,,,12,12,24
,2011,50100709,,,,11,9,20
,2011,50100714,,,,6,4,10
,2011,50100803,,,,23,41,64
,2011,50100817,,,,5,6,11
,2011,50100846,,,,3,1,4
,2011,50100859,,,,31,38,69
,2011,50100882,,,,16,26,42
,2011,50100893,,,,36,15,51
,2011,50100895,,,,10,8,18
,2011,50100896,,,,31,38,69
,2011,50100916,,,,3,3,6
,2011,50100918,,,,10,22,32
,2011,50100921,,,,3,1,4
,2011,50100923,,,,20,29,49
,2011,50100934,,,,6,2,8
,2011,50100937,,,,8,8,16
,2011,50100940,,,,5,7,12
,2011,50100941,,,,3,4,7
,2011,50100985,,,,2,7,9
,2011,50101034,,,,4,10,14
,2011,50101036,,,,6,16,22
,2011,50101039,,,,7,11,18
,2011,50101045,,,,2,6,8
,2011,50101046,,,,5,9,14
,2011,50101047,,,,2,6,8
,2011,50101048,,,,77,103,180
,2011,50101050,,,,3,3,6
,2011,50101051,,,,8,14,22
,2011,50101058,,,,13,9,22
,2011,50101168,,,,8,4,12
,2011,50101171,,,,5,1,6
,2011,50101188,,,,7,8,15
,2011,50101264,,,,5,3,8
,2011,50101267,,,,14,8,22
,2011,50101275,,,,8,21,29
,2011,50101282,,,,11,15,26
HND-003841,2011,50100005,,,,13,17,30
,2011,50100011,,,,23,47,70
HND-003846,2011,50100013,,,,28,15,43
,2011,50100015,,,,5,1,6
HND-003862,2011,50100036,,,,21,12,33
,2011,50100038,,,,0,234,234
HND-003880,2011,50100060,,,,11,11,22
HND-003882,2011,50100062,,,,56,71,127
HND-003883,2011,50100063,,,,13,5,18
HND-003888,2011,50100069,,,,16,32,48
HND-003890,2011,50100071,,,,23,9,32
HND-003896,2011,50100077,,,,31,21,52
HND-003897,2011,50100078,,,,19,19,38
HND-003904,2011,50100087,,,,17,27,44
HND-003912,2011,50100095,,,,26,31,57
HND-003913,2011,50100096,,,,21,19,40
HND-003918,2011,50100104,,,,27,41,68
HND-003926,2011,50100115,,,,48,34,82
HND-003933,2011,50100127,,,,14,23,37
,2011,50100130,,,,43,2,45
HND-003938,2011,50100140,,,,25,22,47
,2011,50100149,,,,5,8,13
,2011,50100157,,,,4,10,14
,2011,50100166,,,,18,25,43
,2011,50100171,,,,1,0,1
,2011,50100175,,,,33,41,74
,2011,50100187,,,,10,10,20
HND-003959,2011,50100197,,,,23,13,36
,2011,50100213,,,,2,9,11
,2011,50100218,,,,22,17,39
,2011,50100221,,,,15,19,34
HND-003966,2011,50100226,,,,129,143,272
,2011,50100227,,,,13,11,24
HND-003967,2011,50100233,,,,121,155,276
,2011,50100234,,,,21,10,31
HND-003968,2011,50100235,,,,150,197,347
,2011,50100237,,,,5,13,18
,2011,50100240,,,,13,6,19
,2011,50100244,,,,39,83,122
HND-003971,2011,50100247,,,,74,72,146
HND-003972,2011,50100248,,,,34,40,74
,2011,50100289,,,,6,5,11
,2011,50100291,,,,23,20,43
,2011,50100346,,,,12,8,20
,2011,50100368,,,,136,14,150
,2011,50100371,,,,15,17,32
,2011,50100385,,,,15,39,54
,2011,50100387,,,,12,29,41
,2011,50100388,,,,425,430,855
,2011,50100419,,,,3,9,12
,2011,50100428,,,,19,24,43
,2011,50100429,,,,6,7,13
,2011,50100430,,,,5,10,15
,2011,50100444,,,,8,9,17
,2011,50100445,,,,5,1,6
,2011,50100446,,,,28,36,64
,2011,50100454,,,,3,6,9
,2011,50100456,,,,5,3,8
,2011,50100461,,,,1,0,1
,2011,50100475,,,,1,2,3
,2011,50100476,,,,18,29,47
,2011,50100500,,,,33,32,65
,2011,50100517,,,,20,17,37
,2011,50100521,,,,3,5,8
,2011,50100526,,,,6,10,16
,2011,50100533,,,,32,30,62
HND-004042,2011,50100534,,,,20,16,36
,2011,50100549,,,,11,6,17
,2011,50100551,,,,2,0,2
HND-004055,2011,50100566,,,,44,45,89
HND-004056,2011,50100567,,,,19,26,45
,2011,50100569,,,,39,35,74
,2011,50100578,,,,47,57,104
,2011,50100582,,,,22,14,36
,2011,50100589,,,,20,31,51
HND-004060,2011,50100596,,,,38,35,73
HND-004061,2011,50100597,,,,20,36,56
,2011,50100598,,,,22,21,43
,2011,50100599,,,,18,14,32
,2011,50100609,,,,35,30,65
,2011,50100610,,,,24,24,48
,2011,50100612,,,,38,23,61
,2011,50100633,,,,22,13,35
,2011,50100636,,,,5,9,14
,2011,50100643,,,,32,35,67
,2011,50100655,,,,19,30,49
,2011,50100668,,,,16,20,36
,2011,50100673,,,,4,5,9
,2011,50100688,,,,8,8,16
,2011,50100689,,,,13,16,29
,2011,50100691,,,,7,7,14
,2011,50100705,,,,6,6,12
,2011,50100709,,,,10,6,16
,2011,50100803,,,,33,51,84
,2011,50100817,,,,9,7,16
,2011,50100846,,,,2,3,5
,2011,50100863,,,,17,16,33
HND-004095,2011,50100883,,,,3,1,4
,2011,50100884,,,,42,32,74
,2011,50100893,,,,18,16,34
,2011,50100918,,,,5,8,13
,2011,50100919,,,,2,7,9
,2011,50100921,,,,4,1,5
,2011,50100983,,,,1,5,6
,2011,50101039,,,,4,3,7
,2011,50101045,,,,2,2,4
,2011,50101046,,,,8,5,13
,2011,50101047,,,,11,6,17
,2011,50101050,,,,8,5,13
,2011,50101051,,,,9,21,30
,2011,50101058,,,,5,5,10
,2011,50101164,,,,13,10,23
,2011,50101178,,,,1,2,3
,2011,50101184,,,,15,23,38
,2011,50101264,,,,5,4,9
,2011,50101265,,,,7,10,17
,2011,50101267,,,,18,30,48
,2011,50101275,,,,11,13,24
,2011,50101278,,,,16,11,27
,2011,50101282,,,,2,2,4
HND-003842,2011,50100006,,,,16,15,31
,2011,50100012,,,,11,9,20
HND-003848,2011,50100018,,,,43,53,96
HND-003853,2011,50100025,,,,19,18,37
HND-003857,2011,50100031,,,,38,55,93
HND-003860,2011,50100034,,,,60,73,133
HND-003864,2011,50100041,,,,32,38,70
HND-003865,2011,50100042,,,,18,31,49
HND-003879,2011,50100057,,,,4,9,13
,2011,50100058,,,,21,22,43
HND-003886,2011,50100067,,,,32,30,62
HND-003887,2011,50100068,,,,13,17,30
,2011,50100079,,,,11,19,30
HND-003901,2011,50100083,,,,14,24,38
HND-003902,2011,50100084,,,,15,25,40
HND-003906,2011,50100089,,,,4,5,9
HND-003909,2011,50100092,,,,23,23,46
HND-003921,2011,50100107,,,,49,39,88
,2011,50100110,,,,20,12,32
,2011,50100112,,,,49,48,97
HND-003927,2011,50100116,,,,11,16,27
,2011,50100117,,,,19,15,34
HND-003928,2011,50100118,,,,12,18,30
HND-003930,2011,50100120,,,,10,9,19
,2011,50100121,,,,20,13,33
HND-003931,2011,50100123,,,,15,24,39
,2011,50100129,,,,22,27,49
,2011,50100131,,,,4,12,16
,2011,50100133,,,,16,23,39
,2011,50100134,,,,8,15,23
,2011,50100135,,,,4,1,5
,2011,50100147,,,,1,0,1
HND-003947,2011,50100161,,,,31,36,67
,2011,50100170,,,,4,3,7
,2011,50100173,,,,17,21,38
HND-003953,2011,50100180,,,,16,8,24
HND-003961,2011,50100201,,,,37,32,69
HND-003964,2011,50100212,,,,10,18,28
,2011,50100220,,,,12,21,33
,2011,50100225,,,,193,193,386
,2011,50100228,,,,229,300,529
,2011,50100230,,,,85,85,170
,2011,50100231,,,,27,27,54
,2011,50100232,,,,27,38,65
,2011,50100239,,,,2,1,3
,2011,50100241,,,,51,56,107
,2011,50100273,,,,8,6,14
,2011,50100294,,,,4,3,7
HND-003987,2011,50100300,,,,57,61,118
HND-003996,2011,50100323,,,,30,19,49
,2011,50100327,,,,5,7,12
,2011,50100352,,,,5,13,18
,2011,50100354,,,,8,13,21
,2011,50100359,,,,24,12,36
,2011,50100361,,,,15,14,29
,2011,50100362,,,,7,3,10
HND-004011,2011,50100365,,,,17,30,47
HND-004012,2011,50100366,,,,196,178,374
,2011,50100381,,,,15,8,23
,2011,50100382,,,,53,44,97
,2011,50100383,,,,8,13,21
,2011,50100384,,,,48,47,95
,2011,50100402,,,,11,5,16
,2011,50100404,,,,21,23,44
,2011,50100426,,,,14,21,35
,2011,50100433,,,,6,5,11
,2011,50100442,,,,73,15,88
,2011,50100443,,,,22,16,38
,2011,50100448,,,,2,2,4
,2011,50100455,,,,10,14,24
,2011,50100459,,,,4,8,12
,2011,50100469,,,,20,19,39
,2011,50100470,,,,2,7,9
,2011,50100471,,,,2,1,3
,2011,50100472,,,,5,1,6
,2011,50100477,,,,41,43,84
,2011,50100483,,,,1,2,3
,2011,50100497,,,,4,2,6
,2011,50100499,,,,23,33,56
,2011,50100516,,,,22,12,34
,2011,50100527,,,,6,6,12
,2011,50100528,,,,10,8,18
HND-004041,2011,50100532,,,,17,10,27
,2011,50100535,,,,2,3,5
,2011,50100543,,,,8,12,20
,2011,50100554,,,,20,18,38
HND-004053,2011,50100563,,,,20,26,46
,2011,50100564,,,,55,42,97
,2011,50100576,,,,17,14,31
,2011,50100580,,,,15,13,28
,2011,50100585,,,,78,72,150
,2011,50100586,,,,12,17,29
,2011,50100588,,,,13,12,25
,2011,50100593,,,,23,31,54
,2011,50100600,,,,12,6,18
,2011,50100606,,,,52,103,155
,2011,50100607,,,,33,34,67
,2011,50100608,,,,27,18,45
,2011,50100621,,,,7,6,13
,2011,50100634,,,,31,20,51
,2011,50100635,,,,38,34,72
,2011,50100638,,,,30,31,61
,2011,50100645,,,,36,31,67
,2011,50100671,,,,9,9,18
,2011,50100684,,,,14,12,26
,2011,50100696,,,,8,2,10
,2011,50100697,,,,32,51,83
,2011,50100712,,,,7,7,14
,2011,50100713,,,,4,7,11
,2011,50100714,,,,7,6,13
,2011,50100818,,,,13,15,28
,2011,50100819,,,,24,31,55
,2011,50100829,,,,4,7,11
,2011,50100832,,,,6,7,13
,2011,50100859,,,,20,26,46
,2011,50100882,,,,16,20,36
,2011,50100894,,,,24,18,42
,2011,50100895,,,,7,7,14
,2011,50100896,,,,45,58,103
,2011,50100916,,,,3,4,7
,2011,50100917,,,,1,11,12
,2011,50100923,,,,33,23,56
,2011,50100934,,,,2,3,5
,2011,50100937,,,,6,12,18
,2011,50100938,,,,8,14,22
,2011,50100940,,,,0,2,2
,2011,50100941,,,,6,4,10
,2011,50100985,,,,2,6,8
,2011,50101034,,,,4,6,10
,2011,50101036,,,,7,10,17
,2011,50101037,,,,12,16,28
,2011,50101042,,,,3,6,9
,2011,50101048,,,,73,111,184
,2011,50101049,,,,3,2,5
,2011,50101151,,,,22,11,33
,2011,50101168,,,,5,2,7
,2011,50101181,,,,11,9,20
,2011,50101185,,,,12,18,30
,2011,50101187,,,,21,16,37
,2011,50101188,,,,6,9,15
,2011,50101263,,,,3,7,10
,2011,50101279,,,,2,2,4
,2011,50101296,,,,2,0,2
HND-003841,2011,50100005,,,,12,19,31
,2011,50100011,,,,18,53,71
HND-003846,2011,50100013,,,,20,25,45
,2011,50100015,,,,2,1,3
HND-003857,2011,50100031,,,,20,40,60
HND-003865,2011,50100042,,,,18,19,37
HND-003879,2011,50100057,,,,7,9,16
,2011,50100058,,,,16,17,33
HND-003880,2011,50100060,,,,10,9,19
HND-003882,2011,50100062,,,,34,43,77
HND-003883,2011,50100063,,,,7,13,20
HND-003888,2011,50100069,,,,16,27,43
,2011,50100079,,,,17,5,22
HND-003901,2011,50100083,,,,10,13,23
HND-003902,2011,50100084,,,,12,27,39
HND-003909,2011,50100092,,,,21,17,38
HND-003918,2011,50100104,,,,16,21,37
,2011,50100110,,,,13,21,34
HND-003926,2011,50100115,,,,15,24,39
,2011,50100117,,,,14,31,45
,2011,50100121,,,,14,10,24
HND-003933,2011,50100127,,,,17,23,40
,2011,50100133,,,,22,21,43
,2011,50100135,,,,2,4,6
,2011,50100145,,,,1,0,1
,2011,50100166,,,,14,16,30
,2011,50100173,,,,15,23,38
,2011,50100187,,,,1,3,4
HND-003964,2011,50100212,,,,7,15,22
,2011,50100225,,,,103,137,240
HND-003966,2011,50100226,,,,85,115,200
,2011,50100227,,,,7,8,15
,2011,50100228,,,,256,304,560
,2011,50100232,,,,24,33,57
HND-003967,2011,50100233,,,,102,149,251
,2011,50100234,,,,18,9,27
HND-003968,2011,50100235,,,,120,200,320
,2011,50100237,,,,12,14,26
,2011,50100239,,,,2,1,3
,2011,50100240,,,,8,5,13
,2011,50100241,,,,60,54,114
HND-003972,2011,50100248,,,,28,27,55
,2011,50100289,,,,4,11,15
,2011,50100294,,,,7,6,13
HND-003987,2011,50100300,,,,40,54,94
,2011,50100327,,,,5,4,9
,2011,50100346,,,,13,18,31
,2011,50100361,,,,17,14,31
,2011,50100368,,,,116,16,132
,2011,50100382,,,,43,62,105
,2011,50100383,,,,18,9,27
,2011,50100384,,,,36,59,95
,2011,50100404,,,,26,23,49
,2011,50100426,,,,12,14,26
,2011,50100428,,,,19,24,43
,2011,50100429,,,,8,2,10
,2011,50100430,,,,7,5,12
,2011,50100442,,,,61,15,76
,2011,50100443,,,,10,10,20
,2011,50100444,,,,8,9,17
,2011,50100469,,,,19,26,45
,2011,50100470,,,,10,11,21
,2011,50100475,,,,7,5,12
,2011,50100476,,,,22,24,46
,2011,50100477,,,,34,37,71
,2011,50100484,,,,3,0,3
,2011,50100499,,,,15,32,47
,2011,50100517,,,,15,16,31
,2011,50100521,,,,4,7,11
,2011,50100526,,,,3,1,4
,2011,50100528,,,,8,13,21
HND-004041,2011,50100532,,,,13,9,22
HND-004042,2011,50100534,,,,15,17,32
,2011,50100535,,,,1,3,4
,2011,50100554,,,,17,23,40
HND-004056,2011,50100567,,,,8,19,27
,2011,50100569,,,,39,40,79
,2011,50100585,,,,101,60,161
,2011,50100586,,,,18,9,27
,2011,50100588,,,,13,24,37
,2011,50100593,,,,29,32,61
HND-004060,2011,50100596,,,,16,24,40
HND-004061,2011,50100597,,,,15,27,42
,2011,50100600,,,,16,13,29
,2011,50100607,,,,25,52,77
,2011,50100612,,,,40,29,69
,2011,50100633,,,,12,24,36
,2011,50100635,,,,40,39,79
,2011,50100645,,,,14,22,36
,2011,50100655,,,,6,2,8
,2011,50100671,,,,7,7,14
,2011,50100673,,,,4,4,8
,2011,50100684,,,,9,12,21
,2011,50100688,,,,1,4,5
,2011,50100697,,,,29,38,67
,2011,50100705,,,,3,7,10
,2011,50100714,,,,3,6,9
,2011,50100819,,,,18,17,35
,2011,50100832,,,,7,13,20
HND-004095,2011,50100883,,,,3,5,8
,2011,50100884,,,,47,39,86
,2011,50100894,,,,18,11,29
,2011,50100916,,,,1,3,4
,2011,50100917,,,,2,5,7
,2011,50100918,,,,14,12,26
,2011,50100921,,,,2,0,2
,2011,50100923,,,,33,25,58
,2011,50100938,,,,6,6,12
,2011,50100983,,,,3,2,5
,2011,50101045,,,,2,1,3
,2011,50101046,,,,1,3,4
,2011,50101164,,,,6,9,15
,2011,50101188,,,,5,4,9
,2011,50101263,,,,13,13,26
,2011,50101282,,,,2,1,3
HND-003842,2011,50100006,,,,19,12,31
,2011,50100012,,,,3,2,5
HND-003848,2011,50100018,,,,22,54,76
HND-003853,2011,50100025,,,,8,15,23
HND-003860,2011,50100034,,,,58,61,119
,2011,50100038,,,,0,208,208
HND-003864,2011,50100041,,,,17,26,43
HND-003886,2011,50100067,,,,21,24,45
HND-003887,2011,50100068,,,,20,22,42
HND-003896,2011,50100077,,,,17,19,36
HND-003897,2011,50100078,,,,8,22,30
HND-003904,2011,50100087,,,,18,22,40
HND-003912,2011,50100095,,,,23,34,57
HND-003913,2011,50100096,,,,19,19,38
HND-003921,2011,50100107,,,,32,42,74
,2011,50100112,,,,45,50,95
HND-003927,2011,50100116,,,,12,11,23
HND-003928,2011,50100118,,,,12,18,30
HND-003930,2011,50100120,,,,10,14,24
HND-003931,2011,50100123,,,,14,26,40
,2011,50100129,,,,14,23,37
,2011,50100130,,,,35,2,37
,2011,50100131,,,,3,10,13
,2011,50100134,,,,10,7,17
HND-003938,2011,50100140,,,,19,10,29
,2011,50100147,,,,8,8,16
,2011,50100149,,,,1,7,8
HND-003947,2011,50100161,,,,28,32,60
,2011,50100170,,,,3,10,13
,2011,50100171,,,,1,5,6
,2011,50100175,,,,39,41,80
HND-003953,2011,50100180,,,,14,16,30
HND-003961,2011,50100201,,,,31,29,60
,2011,50100213,,,,10,3,13
,2011,50100218,,,,22,16,38
,2011,50100220,,,,13,24,37
,2011,50100221,,,,22,20,42
,2011,50100230,,,,108,95,203
,2011,50100231,,,,38,21,59
,2011,50100244,,,,42,86,128
HND-003971,2011,50100247,,,,62,76,138
,2011,50100273,,,,7,10,17
,2011,50100291,,,,19,26,45
HND-003996,2011,50100323,,,,14,18,32
,2011,50100352,,,,10,9,19
,2011,50100354,,,,10,10,20
,2011,50100359,,,,16,22,38
,2011,50100362,,,,2,3,5
HND-004011,2011,50100365,,,,16,9,25
HND-004012,2011,50100366,,,,140,146,286
,2011,50100371,,,,13,11,24
,2011,50100381,,,,13,10,23
,2011,50100385,,,,16,33,49
,2011,50100387,,,,26,21,47
,2011,50100388,,,,388,393,781
,2011,50100402,,,,9,17,26
,2011,50100419,,,,7,9,16
,2011,50100445,,,,7,6,13
,2011,50100446,,,,41,28,69
,2011,50100454,,,,2,4,6
,2011,50100455,,,,19,19,38
,2011,50100456,,,,14,13,27
,2011,50100459,,,,4,2,6
,2011,50100461,,,,2,0,2
,2011,50100471,,,,2,0,2
,2011,50100472,,,,4,8,12
,2011,50100497,,,,1,6,7
,2011,50100500,,,,37,31,68
,2011,50100516,,,,6,23,29
,2011,50100527,,,,3,1,4
,2011,50100533,,,,40,31,71
,2011,50100543,,,,10,6,16
,2011,50100551,,,,3,0,3
HND-004053,2011,50100563,,,,11,23,34
,2011,50100564,,,,52,62,114
HND-004055,2011,50100566,,,,38,38,76
,2011,50100576,,,,9,13,22
,2011,50100578,,,,44,37,81
,2011,50100580,,,,14,8,22
,2011,50100582,,,,23,20,43
,2011,50100589,,,,12,28,40
,2011,50100598,,,,27,41,68
,2011,50100599,,,,12,8,20
,2011,50100606,,,,48,108,156
,2011,50100608,,,,29,26,55
,2011,50100609,,,,28,29,57
,2011,50100610,,,,16,15,31
,2011,50100634,,,,27,27,54
,2011,50100636,,,,12,6,18
,2011,50100638,,,,26,28,54
,2011,50100643,,,,39,44,83
,2011,50100668,,,,12,16,28
,2011,50100689,,,,4,15,19
,2011,50100691,,,,3,0,3
,2011,50100696,,,,6,0,6
,2011,50100712,,,,7,9,16
,2011,50100713,,,,3,6,9
,2011,50100803,,,,23,36,59
,2011,50100817,,,,5,4,9
,2011,50100818,,,,12,2,14
,2011,50100829,,,,8,11,19
,2011,50100859,,,,19,22,41
,2011,50100863,,,,14,8,22
,2011,50100882,,,,10,12,22
,2011,50100893,,,,27,15,42
,2011,50100895,,,,14,9,23
,2011,50100896,,,,37,70,107
,2011,50100919,,,,2,8,10
,2011,50100937,,,,6,12,18
,2011,50100940,,,,0,2,2
,2011,50100941,,,,3,6,9
,2011,50100985,,,,3,8,11
,2011,50101034,,,,4,4,8
,2011,50101036,,,,9,2,11
,2011,50101037,,,,18,13,31
,2011,50101047,,,,9,6,15
,2011,50101048,,,,89,127,216
,2011,50101049,,,,4,1,5
,2011,50101050,,,,7,8,15
,2011,50101051,,,,12,20,32
,2011,50101058,,,,2,3,5
,2011,50101151,,,,18,13,31
,2011,50101168,,,,8,3,11
,2011,50101178,,,,2,3,5
,2011,50101181,,,,3,7,10
,2011,50101184,,,,13,27,40
,2011,50101185,,,,25,14,39
,2011,50101187,,,,12,19,31
,2011,50101265,,,,10,9,19
,2011,50101267,,,,15,12,27
,2011,50101275,,,,5,9,14
,2011,50101278,,,,10,8,18
,2011,50101279,,,,2,2,4
,2011,50101296,,,,3,3,6
,2011,50100038,,,,0,221,221
,2011,50100110,,,,13,22,35
,2011,50100112,,,,38,41,79
,2011,50100130,,,,44,4,48
,2011,50100133,,,,3,3,6
,2011,50100149,,,,9,8,17
,2011,50100170,,,,2,6,8
,2011,50100175,,,,46,59,105
,2011,50100218,,,,56,53,109
,2011,50100220,,,,6,11,17
,2011,50100225,,,,93,118,211
,2011,50100231,,,,48,38,86
HND-003968,2011,50100235,,,,244,485,729
,2011,50100237,,,,3,14,17
,2011,50100244,,,,50,97,147
HND-003971,2011,50100247,,,,59,75,134
HND-003972,2011,50100248,,,,20,27,47
,2011,50100273,,,,13,11,24
,2011,50100289,,,,5,10,15
,2011,50100291,,,,49,78,127
,2011,50100327,,,,6,5,11
,2011,50100354,,,,9,5,14
,2011,50100362,,,,3,1,4
HND-004012,2011,50100366,,,,54,86,140
,2011,50100371,,,,7,8,15
,2011,50100385,,,,88,140,228
,2011,50100387,,,,25,25,50
,2011,50100388,,,,488,621,1109
,2011,50100402,,,,8,10,18
,2011,50100419,,,,10,7,17
,2011,50100428,,,,24,14,38
,2011,50100444,,,,5,4,9
,2011,50100454,,,,6,4,10
,2011,50100455,,,,10,10,20
,2011,50100476,,,,13,34,47
,2011,50100477,,,,44,51,95
,2011,50100484,,,,0,2,2
,2011,50100499,,,,16,20,36
,2011,50100533,,,,45,45,90
,2011,50100551,,,,0,1,1
,2011,50100564,,,,66,60,126
,2011,50100576,,,,3,8,11
,2011,50100578,,,,66,83,149
,2011,50100582,,,,19,10,29
,2011,50100589,,,,17,25,42
,2011,50100598,,,,28,22,50
,2011,50100599,,,,12,8,20
,2011,50100606,,,,81,178,259
,2011,50100607,,,,45,41,86
,2011,50100608,,,,49,62,111
,2011,50100633,,,,8,22,30
,2011,50100634,,,,53,74,127
,2011,50100636,,,,4,6,10
,2011,50100643,,,,42,64,106
,2011,50100655,,,,6,3,9
,2011,50100668,,,,24,28,52
,2011,50100689,,,,2,4,6
,2011,50100803,,,,37,60,97
,2011,50100817,,,,6,8,14
,2011,50100818,,,,16,10,26
,2011,50100859,,,,19,31,50
,2011,50100863,,,,18,12,30
,2011,50100882,,,,5,7,12
,2011,50100893,,,,29,36,65
,2011,50100894,,,,12,28,40
,2011,50100895,,,,13,6,19
,2011,50100896,,,,110,132,242
,2011,50100918,,,,14,11,25
,2011,50100919,,,,3,5,8
,2011,50100937,,,,10,3,13
,2011,50101036,,,,8,8,16
,2011,50101037,,,,24,34,58
,2011,50101044,,,,23,23,46
,2011,50101151,,,,15,15,30
,2011,50101164,,,,17,16,33
,2011,50101178,,,,2,1,3
,2011,50101181,,,,2,4,6
,2011,50101184,,,,16,48,64
,2011,50101187,,,,22,38,60
,2011,50101265,,,,12,6,18
,2011,50101267,,,,21,15,36
,2011,50101296,,,,3,0,3
,2011,50100011,,,,28,64,92
,2011,50100117,,,,11,15,26
,2011,50100121,,,,7,32,39
,2011,50100131,,,,10,10,20
,2011,50100135,,,,6,6,12
,2011,50100145,,,,2,0,2
,2011,50100147,,,,3,4,7
,2011,50100173,,,,12,14,26
,2011,50100213,,,,4,10,14
HND-003966,2011,50100226,,,,53,84,137
,2011,50100227,,,,5,14,19
,2011,50100228,,,,246,358,604
,2011,50100230,,,,131,155,286
,2011,50100232,,,,18,26,44
HND-003967,2011,50100233,,,,32,62,94
,2011,50100234,,,,11,17,28
,2011,50100239,,,,9,8,17
,2011,50100240,,,,3,3,6
,2011,50100241,,,,57,65,122
,2011,50100294,,,,0,5,5
HND-003987,2011,50100300,,,,47,64,111
,2011,50100346,,,,7,7,14
,2011,50100352,,,,6,8,14
,2011,50100359,,,,35,35,70
,2011,50100361,,,,26,14,40
,2011,50100368,,,,299,29,328
,2011,50100381,,,,55,20,75
,2011,50100382,,,,104,104,208
,2011,50100383,,,,16,45,61
,2011,50100384,,,,47,39,86
,2011,50100404,,,,22,23,45
,2011,50100426,,,,15,8,23
,2011,50100429,,,,3,4,7
,2011,50100430,,,,3,6,9
,2011,50100442,,,,132,36,168
,2011,50100443,,,,20,19,39
,2011,50100446,,,,28,46,74
,2011,50100456,,,,9,6,15
,2011,50100459,,,,5,3,8
,2011,50100469,,,,24,21,45
,2011,50100471,,,,0,1,1
,2011,50100472,,,,10,6,16
,2011,50100500,,,,36,38,74
,2011,50100516,,,,2,4,6
,2011,50100517,,,,7,17,24
,2011,50100521,,,,5,5,10
,2011,50100528,,,,9,17,26
,2011,50100554,,,,15,13,28
,2011,50100569,,,,78,97,175
,2011,50100580,,,,29,14,43
,2011,50100585,,,,74,65,139
,2011,50100586,,,,15,17,32
,2011,50100588,,,,23,25,48
,2011,50100593,,,,24,20,44
,2011,50100600,,,,15,15,30
,2011,50100609,,,,35,41,76
,2011,50100610,,,,36,29,65
,2011,50100612,,,,67,76,143
,2011,50100635,,,,71,80,151
,2011,50100638,,,,45,65,110
,2011,50100645,,,,10,18,28
,2011,50100671,,,,8,10,18
,2011,50100684,,,,14,12,26
,2011,50100696,,,,15,10,25
,2011,50100697,,,,61,104,165
,2011,50100712,,,,1,14,15
,2011,50100713,,,,4,1,5
,2011,50100714,,,,6,1,7
,2011,50100819,,,,7,19,26
,2011,50100829,,,,17,28,45
,2011,50100832,,,,1,2,3
HND-004095,2011,50100883,,,,6,5,11
,2011,50100884,,,,44,69,113
,2011,50100917,,,,6,19,25
,2011,50100923,,,,14,25,39
,2011,50100938,,,,3,17,20
,2011,50100983,,,,2,3,5
,2011,50101047,,,,3,2,5
,2011,50101050,,,,7,29,36
,2011,50101051,,,,24,47,71
,2011,50101185,,,,15,17,32
,2011,50101255,,,,117,251,368
,2011,50101263,,,,3,12,15
,2011,50101275,,,,3,20,23
,2011,50101278,,,,7,22,29
,2011,50100011,,,,17,55,72
,2011,50100038,,,,0,161,161
,2011,50100110,,,,16,16,32
,2011,50100117,,,,10,16,26
,2011,50100121,,,,17,25,42
,2011,50100130,,,,31,2,33
,2011,50100131,,,,14,10,24
,2011,50100133,,,,1,0,1
,2011,50100149,,,,7,8,15
,2011,50100170,,,,5,8,13
,2011,50100175,,,,36,53,89
,2011,50100215,,,,129,104,233
,2011,50100218,,,,82,84,166
,2011,50100225,,,,58,100,158
,2011,50100231,,,,49,51,100
HND-003968,2011,50100235,,,,145,386,531
,2011,50100237,,,,6,11,17
,2011,50100244,,,,43,90,133
HND-003971,2011,50100247,,,,19,47,66
,2011,50100273,,,,22,22,44
,2011,50100291,,,,29,49,78
,2011,50100352,,,,7,5,12
,2011,50100354,,,,3,6,9
,2011,50100359,,,,30,41,71
,2011,50100362,,,,2,8,10
HND-004012,2011,50100366,,,,52,95,147
,2011,50100371,,,,2,4,6
,2011,50100381,,,,30,26,56
,2011,50100385,,,,91,137,228
,2011,50100387,,,,22,29,51
,2011,50100388,,,,346,509,855
,2011,50100402,,,,20,12,32
,2011,50100419,,,,8,6,14
,2011,50100446,,,,16,31,47
,2011,50100454,,,,9,12,21
,2011,50100455,,,,18,15,33
,2011,50100456,,,,7,9,16
,2011,50100500,,,,36,48,84
,2011,50100516,,,,9,7,16
,2011,50100521,,,,4,5,9
,2011,50100527,,,,4,5,9
,2011,50100533,,,,30,27,57
,2011,50100551,,,,1,2,3
,2011,50100564,,,,49,58,107
,2011,50100576,,,,3,5,8
,2011,50100578,,,,121,143,264
,2011,50100580,,,,12,24,36
,2011,50100582,,,,43,43,86
,2011,50100589,,,,15,25,40
,2011,50100598,,,,18,33,51
,2011,50100599,,,,11,15,26
,2011,50100606,,,,94,179,273
,2011,50100608,,,,36,67,103
,2011,50100610,,,,141,151,292
,2011,50100633,,,,39,55,94
,2011,50100634,,,,52,55,107
,2011,50100636,,,,8,8,16
,2011,50100638,,,,55,76,131
,2011,50100643,,,,46,79,125
,2011,50100668,,,,46,40,86
,2011,50100696,,,,11,3,14
,2011,50100713,,,,2,3,5
,2011,50100803,,,,21,53,74
,2011,50100817,,,,17,18,35
,2011,50100818,,,,11,7,18
,2011,50100859,,,,26,19,45
,2011,50100863,,,,25,37,62
,2011,50100882,,,,3,6,9
,2011,50100893,,,,31,56,87
,2011,50100895,,,,19,30,49
,2011,50100896,,,,106,120,226
,2011,50100919,,,,5,6,11
,2011,50100937,,,,5,2,7
,2011,50100985,,,,1,2,3
,2011,50101036,,,,10,5,15
,2011,50101037,,,,49,57,106
,2011,50101044,,,,7,8,15
,2011,50101051,,,,31,48,79
,2011,50101151,,,,32,30,62
,2011,50101164,,,,21,35,56
,2011,50101168,,,,1,1,2
,2011,50101178,,,,2,0,2
,2011,50101181,,,,4,7,11
,2011,50101184,,,,25,57,82
,2011,50101187,,,,22,33,55
,2011,50101255,,,,61,222,283
,2011,50101265,,,,5,9,14
,2011,50101267,,,,15,19,34
,2011,50101275,,,,16,24,40
,2011,50101278,,,,10,17,27
,2011,50100112,,,,17,43,60
,2011,50100135,,,,4,0,4
,2011,50100145,,,,3,3,6
,2011,50100173,,,,7,4,11
,2011,50100213,,,,6,4,10
HND-003966,2011,50100226,,,,37,87,124
,2011,50100227,,,,10,15,25
,2011,50100228,,,,166,274,440
,2011,50100230,,,,102,122,224
,2011,50100232,,,,17,23,40
HND-003967,2011,50100233,,,,21,51,72
,2011,50100234,,,,15,13,28
,2011,50100239,,,,9,9,18
,2011,50100240,,,,8,8,16
,2011,50100241,,,,33,45,78
HND-003972,2011,50100248,,,,8,12,20
,2011,50100289,,,,5,3,8
,2011,50100294,,,,1,2,3
HND-003987,2011,50100300,,,,33,41,74
,2011,50100346,,,,4,14,18
,2011,50100361,,,,22,32,54
,2011,50100368,,,,281,20,301
,2011,50100382,,,,139,152,291
,2011,50100383,,,,29,42,71
,2011,50100384,,,,28,39,67
,2011,50100404,,,,25,35,60
,2011,50100426,,,,16,21,37
,2011,50100428,,,,13,20,33
,2011,50100429,,,,1,2,3
,2011,50100442,,,,125,34,159
,2011,50100443,,,,8,14,22
,2011,50100444,,,,0,2,2
,2011,50100469,,,,18,22,40
,2011,50100471,,,,5,5,10
,2011,50100472,,,,4,3,7
,2011,50100477,,,,43,41,84
,2011,50100499,,,,36,45,81
,2011,50100517,,,,10,13,23
,2011,50100528,,,,9,13,22
,2011,50100554,,,,15,15,30
,2011,50100569,,,,126,129,255
,2011,50100585,,,,64,54,118
,2011,50100586,,,,11,18,29
,2011,50100588,,,,16,33,49
,2011,50100593,,,,29,23,52
,2011,50100600,,,,20,12,32
,2011,50100607,,,,27,27,54
,2011,50100609,,,,29,20,49
,2011,50100612,,,,75,64,139
,2011,50100635,,,,64,82,146
,2011,50100645,,,,14,14,28
,2011,50100671,,,,7,8,15
,2011,50100684,,,,8,5,13
,2011,50100697,,,,61,108,169
,2011,50100712,,,,8,10,18
,2011,50100714,,,,0,1,1
,2011,50100829,,,,14,15,29
,2011,50100832,,,,5,7,12
HND-004095,2011,50100883,,,,2,2,4
,2011,50100884,,,,69,72,141
,2011,50100894,,,,22,23,45
,2011,50100917,,,,9,40,49
,2011,50100918,,,,10,6,16
,2011,50100923,,,,19,31,50
,2011,50100938,,,,11,13,24
,2011,50100983,,,,2,5,7
,2011,50101047,,,,2,2,4
,2011,50101050,,,,15,21,36
,2011,50101185,,,,16,13,29
,2011,50101263,,,,20,18,38
,2011,50100121,,,,9,13,22
,2011,50100131,,,,4,12,16
,2011,50100173,,,,4,9,13
HND-003966,2011,50100226,,,,26,61,87
,2011,50100227,,,,1,3,4
,2011,50100228,,,,76,98,174
,2011,50100230,,,,78,116,194
,2011,50100232,,,,17,7,24
HND-003967,2011,50100233,,,,13,30,43
,2011,50100234,,,,6,4,10
,2011,50100241,,,,21,40,61
HND-003972,2011,50100248,,,,11,20,31
,2011,50100289,,,,1,6,7
HND-003987,2011,50100300,,,,20,30,50
,2011,50100368,,,,252,21,273
,2011,50100382,,,,71,77,148
,2011,50100383,,,,3,8,11
,2011,50100384,,,,34,40,74
,2011,50100442,,,,101,20,121
,2011,50100469,,,,13,18,31
,2011,50100554,,,,7,11,18
,2011,50100569,,,,69,100,169
,2011,50100588,,,,5,12,17
,2011,50100593,,,,14,32,46
,2011,50100609,,,,16,25,41
,2011,50100610,,,,12,11,23
,2011,50100612,,,,37,26,63
,2011,50100635,,,,61,75,136
,2011,50100638,,,,38,42,80
,2011,50100645,,,,5,12,17
,2011,50100671,,,,4,12,16
,2011,50100684,,,,8,10,18
,2011,50100696,,,,10,1,11
,2011,50100697,,,,23,25,48
,2011,50100829,,,,4,5,9
,2011,50100832,,,,6,5,11
HND-004095,2011,50100883,,,,2,2,4
,2011,50100884,,,,48,50,98
,2011,50100917,,,,5,2,7
,2011,50100923,,,,20,25,45
,2011,50100938,,,,5,11,16
,2011,50100983,,,,1,0,1
,2011,50101050,,,,4,12,16
,2011,50101185,,,,21,16,37
,2011,50101263,,,,5,5,10
,2011,50100011,,,,4,26,30
,2011,50100038,,,,0,112,112
,2011,50100112,,,,32,48,80
,2011,50100130,,,,9,2,11
,2011,50100133,,,,1,3,4
,2011,50100175,,,,18,17,35
,2011,50100218,,,,42,58,100
,2011,50100225,,,,54,87,141
,2011,50100231,,,,36,49,85
HND-003968,2011,50100235,,,,120,242,362
HND-003971,2011,50100247,,,,18,31,49
,2011,50100273,,,,10,12,22
,2011,50100291,,,,24,24,48
,2011,50100359,,,,14,28,42
HND-004012,2011,50100366,,,,56,82,138
,2011,50100371,,,,4,3,7
,2011,50100381,,,,26,21,47
,2011,50100385,,,,29,62,91
,2011,50100387,,,,10,25,35
,2011,50100388,,,,254,425,679
,2011,50100402,,,,3,2,5
,2011,50100444,,,,0,3,3
,2011,50100446,,,,27,29,56
,2011,50100516,,,,2,3,5
,2011,50100521,,,,0,3,3
,2011,50100576,,,,4,8,12
,2011,50100578,,,,48,97,145
,2011,50100580,,,,6,19,25
,2011,50100582,,,,10,12,22
,2011,50100589,,,,7,10,17
,2011,50100598,,,,22,20,42
,2011,50100606,,,,44,110,154
,2011,50100608,,,,19,47,66
,2011,50100633,,,,6,15,21
,2011,50100634,,,,21,27,48
,2011,50100636,,,,3,3,6
,2011,50100643,,,,29,52,81
,2011,50100668,,,,11,7,18
,2011,50100713,,,,0,3,3
,2011,50100803,,,,28,53,81
,2011,50100817,,,,4,7,11
,2011,50100859,,,,9,11,20
,2011,50100863,,,,8,15,23
,2011,50100893,,,,12,20,32
,2011,50100894,,,,14,17,31
,2011,50100895,,,,11,16,27
,2011,50100896,,,,59,89,148
,2011,50100918,,,,6,5,11
,2011,50100919,,,,3,6,9
,2011,50101037,,,,14,26,40
,2011,50101044,,,,9,7,16
,2011,50101051,,,,34,34,68
,2011,50101164,,,,8,24,32
,2011,50101181,,,,1,0,1
,2011,50101184,,,,13,27,40
,2011,50101187,,,,15,33,48
,2011,50101255,,,,50,158,208
,2011,50101265,,,,5,3,8
,2011,50101267,,,,7,4,11
,2011,50101275,,,,1,1,2
,2011,50101278,,,,1,14,15
HND-004176,2011,50200005,,,,13,9,22
HND-004209,2011,50200042,,,,8,4,12
HND-004231,2011,50200068,,,,3,1,4
HND-004244,2011,50200091,,,,2,6,8
,2011,50200116,,,,6,4,10
HND-004275,2011,50200147,,,,15,5,20
,2011,50200164,,,,13,12,25
HND-004295,2011,50200198,,,,6,5,11
HND-004297,2011,50200215,,,,6,6,12
,2011,50200216,,,,9,7,16
,2011,50200217,,,,11,8,19
,2011,50200229,,,,15,8,23
,2011,50200230,,,,9,7,16
,2011,50200236,,,,9,7,16
HND-004300,2011,50200238,,,,6,5,11
,2011,50200241,,,,4,4,8
HND-004301,2011,50200260,,,,8,8,16
HND-004307,2011,50200283,,,,7,4,11
HND-004308,2011,50200285,,,,9,8,17
,2011,50200286,,,,10,8,18
HND-004309,2011,50200288,,,,6,5,11
,2011,50200296,,,,5,5,10
HND-004312,2011,50200308,,,,4,6,10
,2011,50200312,,,,9,3,12
HND-004314,2011,50200314,,,,7,9,16
HND-004317,2011,50200319,,,,9,12,21
,2011,50200322,,,,4,4,8
HND-004319,2011,50200325,,,,9,11,20
,2011,50200326,,,,5,1,6
,2011,50200327,,,,5,5,10
,2011,50200329,,,,2,6,8
HND-004320,2011,50200332,,,,9,7,16
,2011,50200333,,,,4,5,9
,2011,50200335,,,,3,1,4
HND-004321,2011,50200336,,,,5,12,17
,2011,50200339,,,,2,8,10
,2011,50200340,,,,1,4,5
,2011,50200368,,,,3,2,5
,2011,50200369,,,,11,11,22
,2011,50200370,,,,2,4,6
,2011,50200372,,,,1,9,10
,2011,50200373,,,,10,10,20
,2011,50200374,,,,4,7,11
,2011,50200375,,,,9,6,15
HND-004327,2011,50200377,,,,10,7,17
HND-004328,2011,50200378,,,,12,12,24
HND-004329,2011,50200380,,,,12,12,24
,2011,50200383,,,,6,5,11
,2011,50200384,,,,7,4,11
HND-004181,2011,50200011,,,,10,5,15
HND-004195,2011,50200026,,,,2,5,7
HND-004212,2011,50200045,,,,6,4,10
HND-004230,2011,50200065,,,,8,4,12
HND-004268,2011,50200131,,,,1,2,3
HND-004270,2011,50200133,,,,8,9,17
HND-004284,2011,50200176,,,,8,5,13
,2011,50200177,,,,5,6,11
,2011,50200191,,,,12,5,17
,2011,50200218,,,,6,5,11
HND-004298,2011,50200220,,,,3,4,7
,2011,50200221,,,,7,10,17
HND-004299,2011,50200222,,,,10,4,14
,2011,50200223,,,,11,8,19
,2011,50200226,,,,9,8,17
,2011,50200227,,,,3,11,14
,2011,50200233,,,,5,5,10
,2011,50200237,,,,8,6,14
HND-004310,2011,50200290,,,,7,8,15
,2011,50200293,,,,6,6,12
HND-004315,2011,50200316,,,,9,6,15
HND-004316,2011,50200317,,,,8,7,15
,2011,50200320,,,,6,9,15
HND-004318,2011,50200321,,,,12,11,23
,2011,50200323,,,,11,10,21
,2011,50200328,,,,5,5,10
,2011,50200330,,,,4,16,20
,2011,50200337,,,,7,5,12
HND-004322,2011,50200338,,,,5,7,12
,2011,50200341,,,,4,1,5
,2011,50200342,,,,3,2,5
,2011,50200364,,,,2,2,4
,2011,50200365,,,,2,3,5
,2011,50200366,,,,4,4,8
,2011,50200367,,,,4,5,9
,2011,50200371,,,,14,17,31
HND-004330,2011,50200381,,,,10,11,21
,2011,50200382,,,,5,19,24
,2011,50200121,,,,4,5,9
,2011,50200151,,,,2,1,3
,2011,50200155,,,,22,19,41
HND-004279,2011,50200159,,,,18,19,37
,2011,50200165,,,,1,0,1
HND-004302,2011,50200266,,,,4,3,7
,2011,50200353,,,,0,1,1
,2011,50200354,,,,1,3,4
,2011,50200358,,,,1,1,2
,2011,50200361,,,,0,1,1
,2011,50200387,,,,1,5,6
HND-004331,2011,50200388,,,,1,4,5
HND-004228,2011,50200061,,,,5,4,9
,2011,50200113,,,,0,2,2
,2011,50200137,,,,1,5,6
HND-004273,2011,50200144,,,,1,1,2
,2011,50200149,,,,17,15,32
,2011,50200174,,,,0,6,6
,2011,50200355,,,,0,3,3
,2011,50200386,,,,3,0,3
HND-004225,2011,50200058,,,,0,1,1
,2011,50200071,,,,8,6,14
,2011,50200072,,,,1,3,4
,2011,50200073,,,,1,3,4
HND-004233,2011,50200075,,,,3,2,5
HND-004236,2011,50200078,,,,1,2,3
,2011,50200081,,,,1,3,4
,2011,50200082,,,,2,2,4
,2011,50200089,,,,0,3,3
HND-004250,2011,50200097,,,,2,4,6
HND-004252,2011,50200099,,,,8,3,11
HND-004255,2011,50200104,,,,4,4,8
HND-004260,2011,50200110,,,,2,3,5
,2011,50200115,,,,5,4,9
,2011,50200118,,,,1,5,6
HND-004263,2011,50200124,,,,3,5,8
HND-004265,2011,50200127,,,,6,5,11
,2011,50200137,,,,10,2,12
,2011,50200140,,,,0,4,4
HND-004274,2011,50200145,,,,2,3,5
,2011,50200146,,,,4,4,8
,2011,50200148,,,,2,0,2
,2011,50200151,,,,3,4,7
HND-004277,2011,50200153,,,,2,4,6
,2011,50200165,,,,8,14,22
,2011,50200166,,,,1,2,3
,2011,50200174,,,,20,21,41
HND-004288,2011,50200183,,,,2,4,6
,2011,50200208,,,,1,3,4
,2011,50200209,,,,6,11,17
,2011,50200213,,,,3,4,7
,2011,50200265,,,,1,0,1
HND-004302,2011,50200266,,,,1,5,6
HND-004305,2011,50200277,,,,4,6,10
,2011,50200349,,,,2,4,6
,2011,50200350,,,,0,1,1
,2011,50200354,,,,8,4,12
,2011,50200355,,,,2,1,3
,2011,50200358,,,,6,5,11
,2011,50200361,,,,1,1,2
,2011,50200393,,,,0,2,2
HND-004228,2011,50200061,,,,7,2,9
HND-004237,2011,50200079,,,,2,3,5
HND-004247,2011,50200094,,,,1,0,1
HND-004249,2011,50200096,,,,2,0,2
HND-004251,2011,50200098,,,,3,3,6
,2011,50200113,,,,4,7,11
,2011,50200121,,,,13,1,14
HND-004264,2011,50200125,,,,2,2,4
HND-004266,2011,50200128,,,,2,1,3
HND-004267,2011,50200130,,,,3,2,5
,2011,50200138,,,,8,10,18
HND-004272,2011,50200139,,,,3,3,6
HND-004273,2011,50200144,,,,1,1,2
,2011,50200149,,,,15,16,31
,2011,50200155,,,,13,11,24
HND-004279,2011,50200159,,,,20,20,40
,2011,50200161,,,,0,1,1
HND-004287,2011,50200181,,,,8,7,15
HND-004289,2011,50200186,,,,1,0,1
,2011,50200191,,,,2,2,4
,2011,50200192,,,,0,2,2
HND-004294,2011,50200195,,,,2,1,3
,2011,50200207,,,,1,1,2
,2011,50200212,,,,2,1,3
,2011,50200282,,,,8,4,12
,2011,50200302,,,,1,2,3
,2011,50200305,,,,3,5,8
,2011,50200306,,,,2,0,2
,2011,50200313,,,,3,0,3
,2011,50200345,,,,0,1,1
,2011,50200353,,,,1,6,7
,2011,50200357,,,,3,3,6
,2011,50200359,,,,0,1,1
,2011,50200360,,,,5,7,12
,2011,50200362,,,,0,1,1
,2011,50200386,,,,5,2,7
HND-004331,2011,50200388,,,,3,2,5
,2011,50200390,,,,2,0,2
HND-004182,2011,50200012,,,,21,21,42
,2011,50200036,,,,5,8,13
HND-004220,2011,50200053,,,,45,37,82
HND-004225,2011,50200058,,,,11,10,21
,2011,50200071,,,,24,21,45
,2011,50200072,,,,11,6,17
,2011,50200073,,,,5,10,15
HND-004233,2011,50200075,,,,4,2,6
HND-004236,2011,50200078,,,,13,1,14
,2011,50200081,,,,9,12,21
,2011,50200082,,,,2,9,11
,2011,50200089,,,,11,11,22
HND-004248,2011,50200095,,,,35,25,60
HND-004252,2011,50200099,,,,17,22,39
HND-004255,2011,50200104,,,,94,86,180
HND-004259,2011,50200109,,,,15,17,32
HND-004260,2011,50200110,,,,18,12,30
HND-004262,2011,50200114,,,,15,12,27
,2011,50200115,,,,11,13,24
,2011,50200118,,,,22,14,36
,2011,50200121,,,,7,6,13
,2011,50200122,,,,39,27,66
HND-004265,2011,50200127,,,,15,26,41
HND-004267,2011,50200130,,,,7,8,15
,2011,50200138,,,,26,25,51
HND-004272,2011,50200139,,,,19,17,36
,2011,50200146,,,,6,6,12
,2011,50200148,,,,4,6,10
,2011,50200149,,,,13,18,31
,2011,50200151,,,,5,6,11
,2011,50200155,,,,32,15,47
HND-004279,2011,50200159,,,,21,28,49
,2011,50200161,,,,7,6,13
,2011,50200165,,,,8,13,21
,2011,50200166,,,,6,6,12
HND-004283,2011,50200175,,,,12,11,23
HND-004286,2011,50200180,,,,20,36,56
HND-004287,2011,50200181,,,,15,12,27
,2011,50200185,,,,29,10,39
HND-004289,2011,50200186,,,,14,9,23
,2011,50200191,,,,6,5,11
HND-004294,2011,50200195,,,,29,15,44
,2011,50200206,,,,11,12,23
,2011,50200207,,,,3,11,14
,2011,50200210,,,,10,7,17
,2011,50200211,,,,6,3,9
,2011,50200212,,,,21,26,47
,2011,50200213,,,,8,3,11
,2011,50200264,,,,8,6,14
HND-004302,2011,50200266,,,,5,2,7
HND-004305,2011,50200277,,,,13,11,24
,2011,50200282,,,,6,10,16
,2011,50200302,,,,8,5,13
,2011,50200306,,,,7,6,13
,2011,50200313,,,,16,26,42
,2011,50200345,,,,0,1,1
,2011,50200349,,,,1,1,2
,2011,50200353,,,,9,7,16
,2011,50200354,,,,5,8,13
,2011,50200357,,,,7,9,16
,2011,50200360,,,,15,9,24
,2011,50200362,,,,5,5,10
,2011,50200386,,,,4,7,11
HND-004331,2011,50200388,,,,8,7,15
,2011,50200390,,,,5,1,6
HND-004179,2011,50200009,,,,49,33,82
HND-004190,2011,50200021,,,,6,5,11
HND-004194,2011,50200025,,,,22,22,44
HND-004228,2011,50200061,,,,3,14,17
HND-004229,2011,50200064,,,,25,15,40
HND-004232,2011,50200074,,,,19,24,43
HND-004234,2011,50200076,,,,27,15,42
HND-004235,2011,50200077,,,,16,10,26
HND-004237,2011,50200079,,,,10,8,18
HND-004240,2011,50200086,,,,41,39,80
HND-004247,2011,50200094,,,,44,52,96
HND-004249,2011,50200096,,,,13,16,29
HND-004250,2011,50200097,,,,28,35,63
HND-004251,2011,50200098,,,,25,26,51
HND-004254,2011,50200101,,,,23,17,40
HND-004261,2011,50200111,,,,8,12,20
,2011,50200113,,,,9,9,18
HND-004263,2011,50200124,,,,19,13,32
HND-004264,2011,50200125,,,,58,58,116
HND-004266,2011,50200128,,,,11,9,20
,2011,50200137,,,,15,15,30
,2011,50200140,,,,6,10,16
HND-004273,2011,50200144,,,,13,11,24
HND-004273,2011,50200144,,,,1,5,6
HND-004274,2011,50200145,,,,24,26,50
HND-004275,2011,50200147,,,,20,20,40
HND-004277,2011,50200153,,,,13,11,24
,2011,50200174,,,,15,5,20
HND-004285,2011,50200178,,,,54,44,98
HND-004288,2011,50200183,,,,13,11,24
HND-004293,2011,50200194,,,,10,6,16
,2011,50200199,,,,3,7,10
,2011,50200208,,,,5,7,12
,2011,50200209,,,,6,10,16
,2011,50200263,,,,1,0,1
,2011,50200265,,,,13,12,25
,2011,50200305,,,,9,9,18
,2011,50200350,,,,6,3,9
,2011,50200355,,,,6,12,18
,2011,50200358,,,,15,19,34
,2011,50200359,,,,12,6,18
,2011,50200361,,,,11,4,15
,2011,50200387,,,,8,13,21
,2011,50200393,,,,3,4,7
HND-004172,2011,50200001,,,,4,7,11
HND-004173,2011,50200002,,,,10,9,19
HND-004174,2011,50200003,,,,5,1,6
HND-004175,2011,50200004,,,,45,32,77
HND-004178,2011,50200008,,,,9,2,11
HND-004179,2011,50200009,,,,81,66,147
HND-004180,2011,50200010,,,,31,29,60
HND-004182,2011,50200012,,,,51,45,96
HND-004183,2011,50200013,,,,94,86,180
HND-004184,2011,50200015,,,,34,26,60
HND-004185,2011,50200016,,,,4,5,9
HND-004186,2011,50200017,,,,6,0,6
HND-004191,2011,50200022,,,,24,11,35
HND-004193,2011,50200024,,,,83,70,153
HND-004194,2011,50200025,,,,38,49,87
HND-004196,2011,50200027,,,,18,18,36
HND-004197,2011,50200028,,,,49,40,89
HND-004203,2011,50200034,,,,22,27,49
,2011,50200036,,,,14,8,22
HND-004204,2011,50200037,,,,22,22,44
HND-004211,2011,50200044,,,,16,13,29
HND-004212,2011,50200045,,,,7,7,14
HND-004213,2011,50200046,,,,10,10,20
HND-004217,2011,50200050,,,,12,12,24
HND-004219,2011,50200052,,,,24,15,39
HND-004220,2011,50200053,,,,79,54,133
HND-004221,2011,50200054,,,,100,92,192
HND-004222,2011,50200055,,,,26,27,53
HND-004223,2011,50200056,,,,1,3,4
HND-004229,2011,50200064,,,,43,52,95
,2011,50200072,,,,8,8,16
,2011,50200073,,,,9,6,15
HND-004232,2011,50200074,,,,39,54,93
HND-004236,2011,50200078,,,,6,7,13
HND-004237,2011,50200079,,,,11,7,18
HND-004238,2011,50200080,,,,24,18,42
,2011,50200081,,,,15,11,26
,2011,50200082,,,,9,12,21
HND-004242,2011,50200088,,,,15,18,33
,2011,50200089,,,,8,12,20
HND-004243,2011,50200090,,,,11,10,21
,2011,50200113,,,,11,12,23
,2011,50200118,,,,22,25,47
HND-004268,2011,50200131,,,,1,1,2
HND-004271,2011,50200134,,,,3,4,7
,2011,50200140,,,,8,9,17
,2011,50200148,,,,8,10,18
HND-004278,2011,50200156,,,,23,24,47
,2011,50200161,,,,7,9,16
HND-004280,2011,50200162,,,,27,18,45
HND-004282,2011,50200167,,,,7,9,16
,2011,50200174,,,,30,28,58
HND-004288,2011,50200183,,,,11,11,22
HND-004289,2011,50200186,,,,15,19,34
HND-004292,2011,50200190,,,,44,26,70
HND-004293,2011,50200194,,,,10,12,22
HND-004296,2011,50200201,,,,0,3,3
,2011,50200202,,,,11,12,23
,2011,50200209,,,,9,15,24
,2011,50200210,,,,8,17,25
,2011,50200212,,,,33,28,61
,2011,50200213,,,,10,8,18
HND-004297,2011,50200215,,,,13,12,25
,2011,50200263,,,,1,2,3
,2011,50200264,,,,6,12,18
HND-004305,2011,50200277,,,,34,27,61
HND-004306,2011,50200278,,,,20,16,36
HND-004311,2011,50200307,,,,2,0,2
,2011,50200345,,,,2,1,3
,2011,50200347,,,,8,9,17
HND-004325,2011,50200352,,,,18,20,38
,2011,50200359,,,,8,9,17
,2011,50200362,,,,7,6,13
,2011,50200390,,,,2,9,11
,2011,50200391,,,,15,11,26
HND-004333,2011,50200392,,,,10,5,15
HND-004176,2011,50200005,,,,18,8,26
,2011,50200006,,,,1,5,6
HND-004177,2011,50200007,,,,28,21,49
HND-004181,2011,50200011,,,,7,3,10
,2011,50200014,,,,17,17,34
HND-004187,2011,50200018,,,,3,9,12
HND-004188,2011,50200019,,,,3,5,8
HND-004189,2011,50200020,,,,4,3,7
HND-004190,2011,50200021,,,,6,5,11
HND-004192,2011,50200023,,,,50,53,103
HND-004195,2011,50200026,,,,3,4,7
HND-004198,2011,50200029,,,,120,76,196
HND-004199,2011,50200030,,,,8,10,18
HND-004200,2011,50200031,,,,21,17,38
HND-004201,2011,50200032,,,,3,2,5
HND-004202,2011,50200033,,,,1,0,1
HND-004205,2011,50200038,,,,19,22,41
HND-004206,2011,50200039,,,,18,13,31
HND-004207,2011,50200040,,,,12,7,19
HND-004208,2011,50200041,,,,19,21,40
HND-004209,2011,50200042,,,,14,12,26
HND-004210,2011,50200043,,,,56,48,104
HND-004214,2011,50200047,,,,43,42,85
HND-004215,2011,50200048,,,,38,30,68
HND-004216,2011,50200049,,,,7,5,12
HND-004218,2011,50200051,,,,53,67,120
HND-004224,2011,50200057,,,,1,3,4
HND-004225,2011,50200058,,,,14,16,30
HND-004226,2011,50200059,,,,64,67,131
HND-004227,2011,50200060,,,,35,40,75
HND-004228,2011,50200061,,,,56,59,115
HND-004230,2011,50200065,,,,5,6,11
HND-004231,2011,50200068,,,,2,4,6
,2011,50200071,,,,25,29,54
HND-004233,2011,50200075,,,,11,8,19
HND-004234,2011,50200076,,,,42,41,83
HND-004235,2011,50200077,,,,30,16,46
HND-004239,2011,50200083,,,,43,39,82
HND-004241,2011,50200087,,,,13,7,20
HND-004244,2011,50200091,,,,2,1,3
HND-004245,2011,50200092,,,,4,2,6
HND-004246,2011,50200093,,,,37,33,70
HND-004247,2011,50200094,,,,64,67,131
HND-004256,2011,50200105,,,,19,14,33
,2011,50200115,,,,12,14,26
HND-004267,2011,50200130,,,,9,12,21
HND-004269,2011,50200132,,,,47,38,85
HND-004270,2011,50200133,,,,33,31,64
HND-004275,2011,50200147,,,,45,35,80
HND-004276,2011,50200150,,,,14,16,30
,2011,50200165,,,,25,20,45
,2011,50200166,,,,6,8,14
HND-004290,2011,50200187,,,,39,29,68
HND-004291,2011,50200188,,,,50,55,105
,2011,50200191,,,,18,12,30
,2011,50200192,,,,3,2,5
HND-004294,2011,50200195,,,,35,41,76
,2011,50200199,,,,3,4,7
,2011,50200206,,,,14,16,30
,2011,50200207,,,,13,15,28
,2011,50200208,,,,3,6,9
,2011,50200211,,,,6,3,9
HND-004302,2011,50200266,,,,4,0,4
HND-004303,2011,50200272,,,,67,53,120
HND-004304,2011,50200273,,,,1,3,4
,2011,50200300,,,,7,13,20
,2011,50200302,,,,10,14,24
,2011,50200305,,,,8,14,22
,2011,50200306,,,,7,8,15
HND-004313,2011,50200309,,,,10,20,30
HND-004323,2011,50200346,,,,18,14,32
,2011,50200349,,,,9,5,14
,2011,50200350,,,,1,5,6
HND-004324,2011,50200351,,,,6,10,16
,2011,50200353,,,,8,10,18
,2011,50200354,,,,2,6,8
,2011,50200355,,,,20,16,36
HND-004326,2011,50200356,,,,13,11,24
,2011,50200358,,,,16,16,32
HND-004332,2011,50200389,,,,26,11,37
HND-004173,2011,50200002,,,,10,8,18
HND-004174,2011,50200003,,,,4,3,7
HND-004180,2011,50200010,,,,31,32,63
HND-004181,2011,50200011,,,,13,3,16
HND-004182,2011,50200012,,,,59,35,94
HND-004183,2011,50200013,,,,73,77,150
HND-004184,2011,50200015,,,,38,25,63
HND-004185,2011,50200016,,,,2,2,4
HND-004187,2011,50200018,,,,10,7,17
HND-004192,2011,50200023,,,,50,41,91
HND-004195,2011,50200026,,,,4,1,5
HND-004196,2011,50200027,,,,7,13,20
HND-004197,2011,50200028,,,,38,39,77
HND-004198,2011,50200029,,,,111,82,193
HND-004201,2011,50200032,,,,7,2,9
HND-004203,2011,50200034,,,,17,19,36
,2011,50200036,,,,12,14,26
HND-004204,2011,50200037,,,,15,15,30
HND-004209,2011,50200042,,,,18,17,35
HND-004211,2011,50200044,,,,14,13,27
HND-004214,2011,50200047,,,,51,42,93
HND-004216,2011,50200049,,,,5,6,11
HND-004217,2011,50200050,,,,12,8,20
HND-004218,2011,50200051,,,,71,50,121
HND-004219,2011,50200052,,,,20,20,40
HND-004220,2011,50200053,,,,58,44,102
HND-004221,2011,50200054,,,,108,104,212
HND-004225,2011,50200058,,,,14,20,34
HND-004226,2011,50200059,,,,64,52,116
HND-004227,2011,50200060,,,,32,28,60
HND-004228,2011,50200061,,,,64,64,128
HND-004230,2011,50200065,,,,5,4,9
,2011,50200071,,,,14,13,27
,2011,50200072,,,,13,6,19
,2011,50200073,,,,8,5,13
HND-004233,2011,50200075,,,,7,4,11
HND-004234,2011,50200076,,,,56,47,103
HND-004236,2011,50200078,,,,6,11,17
HND-004238,2011,50200080,,,,15,15,30
,2011,50200081,,,,11,15,26
,2011,50200082,,,,17,8,25
HND-004239,2011,50200083,,,,41,32,73
HND-004242,2011,50200088,,,,23,18,41
,2011,50200089,,,,11,9,20
HND-004245,2011,50200092,,,,2,1,3
HND-004246,2011,50200093,,,,35,35,70
,2011,50200115,,,,16,10,26
,2011,50200118,,,,14,24,38
HND-004267,2011,50200130,,,,11,14,25
HND-004268,2011,50200131,,,,3,1,4
HND-004269,2011,50200132,,,,53,49,102
HND-004270,2011,50200133,,,,38,33,71
,2011,50200161,,,,11,12,23
,2011,50200165,,,,25,15,40
,2011,50200166,,,,6,2,8
HND-004282,2011,50200167,,,,13,10,23
HND-004289,2011,50200186,,,,18,17,35
HND-004290,2011,50200187,,,,47,30,77
HND-004292,2011,50200190,,,,30,25,55
,2011,50200191,,,,15,11,26
,2011,50200192,,,,4,3,7
HND-004294,2011,50200195,,,,34,31,65
,2011,50200206,,,,18,10,28
,2011,50200207,,,,12,19,31
,2011,50200210,,,,4,4,8
,2011,50200211,,,,1,2,3
,2011,50200212,,,,28,26,54
,2011,50200213,,,,3,6,9
,2011,50200264,,,,9,10,19
HND-004305,2011,50200277,,,,24,16,40
,2011,50200300,,,,5,3,8
,2011,50200302,,,,6,12,18
,2011,50200306,,,,5,2,7
,2011,50200345,,,,1,1,2
HND-004323,2011,50200346,,,,15,23,38
,2011,50200347,,,,7,6,13
,2011,50200349,,,,4,4,8
HND-004324,2011,50200351,,,,10,7,17
HND-004325,2011,50200352,,,,20,10,30
,2011,50200353,,,,2,5,7
,2011,50200354,,,,3,3,6
,2011,50200362,,,,13,2,15
,2011,50200390,,,,5,8,13
HND-004172,2011,50200001,,,,4,8,12
HND-004175,2011,50200004,,,,36,37,73
HND-004176,2011,50200005,,,,13,17,30
,2011,50200006,,,,2,1,3
HND-004177,2011,50200007,,,,21,21,42
HND-004178,2011,50200008,,,,9,5,14
HND-004179,2011,50200009,,,,80,70,150
,2011,50200014,,,,12,14,26
HND-004186,2011,50200017,,,,1,3,4
HND-004188,2011,50200019,,,,4,5,9
HND-004189,2011,50200020,,,,0,4,4
HND-004190,2011,50200021,,,,8,5,13
HND-004191,2011,50200022,,,,16,9,25
HND-004193,2011,50200024,,,,46,49,95
HND-004194,2011,50200025,,,,36,45,81
HND-004199,2011,50200030,,,,7,8,15
HND-004200,2011,50200031,,,,18,16,34
HND-004202,2011,50200033,,,,0,5,5
HND-004205,2011,50200038,,,,26,16,42
HND-004206,2011,50200039,,,,21,8,29
HND-004207,2011,50200040,,,,15,4,19
HND-004208,2011,50200041,,,,14,10,24
HND-004210,2011,50200043,,,,48,48,96
HND-004212,2011,50200045,,,,10,6,16
HND-004213,2011,50200046,,,,14,4,18
HND-004215,2011,50200048,,,,37,37,74
HND-004222,2011,50200055,,,,24,16,40
HND-004223,2011,50200056,,,,2,3,5
HND-004224,2011,50200057,,,,1,2,3
HND-004229,2011,50200064,,,,48,54,102
HND-004231,2011,50200068,,,,2,1,3
HND-004232,2011,50200074,,,,51,57,108
HND-004235,2011,50200077,,,,21,18,39
HND-004237,2011,50200079,,,,14,8,22
HND-004241,2011,50200087,,,,4,8,12
HND-004243,2011,50200090,,,,9,7,16
HND-004244,2011,50200091,,,,7,7,14
HND-004247,2011,50200094,,,,60,61,121
HND-004256,2011,50200105,,,,18,18,36
,2011,50200113,,,,11,8,19
HND-004271,2011,50200134,,,,3,1,4
,2011,50200140,,,,12,15,27
HND-004275,2011,50200147,,,,41,39,80
,2011,50200148,,,,5,6,11
HND-004276,2011,50200150,,,,14,13,27
HND-004278,2011,50200156,,,,26,23,49
HND-004280,2011,50200162,,,,39,27,66
,2011,50200174,,,,39,24,63
HND-004288,2011,50200183,,,,11,11,22
HND-004291,2011,50200188,,,,59,39,98
HND-004293,2011,50200194,,,,6,17,23
,2011,50200199,,,,3,0,3
HND-004296,2011,50200201,,,,2,1,3
,2011,50200202,,,,9,9,18
,2011,50200208,,,,3,11,14
,2011,50200209,,,,9,18,27
HND-004297,2011,50200215,,,,14,15,29
,2011,50200263,,,,2,2,4
HND-004302,2011,50200266,,,,3,2,5
HND-004303,2011,50200272,,,,34,36,70
HND-004306,2011,50200278,,,,24,19,43
,2011,50200305,,,,6,5,11
HND-004311,2011,50200307,,,,3,2,5
HND-004313,2011,50200309,,,,13,17,30
,2011,50200350,,,,1,3,4
,2011,50200355,,,,14,17,31
HND-004326,2011,50200356,,,,11,4,15
,2011,50200358,,,,9,7,16
,2011,50200359,,,,9,9,18
HND-004332,2011,50200389,,,,12,13,25
HND-004333,2011,50200392,,,,6,6,12
HND-004173,2011,50200002,,,,2,9,11
HND-004176,2011,50200005,,,,10,19,29
,2011,50200006,,,,2,2,4
HND-004177,2011,50200007,,,,16,22,38
HND-004181,2011,50200011,,,,8,7,15
HND-004182,2011,50200012,,,,37,39,76
,2011,50200014,,,,13,19,32
HND-004187,2011,50200018,,,,6,9,15
HND-004188,2011,50200019,,,,6,6,12
HND-004190,2011,50200021,,,,4,6,10
HND-004192,2011,50200023,,,,38,36,74
HND-004195,2011,50200026,,,,2,2,4
HND-004196,2011,50200027,,,,16,10,26
HND-004198,2011,50200029,,,,65,69,134
HND-004203,2011,50200034,,,,28,18,46
,2011,50200036,,,,16,19,35
HND-004204,2011,50200037,,,,14,13,27
HND-004211,2011,50200044,,,,21,16,37
HND-004212,2011,50200045,,,,7,8,15
HND-004213,2011,50200046,,,,16,13,29
HND-004217,2011,50200050,,,,6,4,10
HND-004218,2011,50200051,,,,61,59,120
HND-004219,2011,50200052,,,,24,17,41
HND-004220,2011,50200053,,,,55,49,104
HND-004221,2011,50200054,,,,102,100,202
HND-004222,2011,50200055,,,,27,18,45
HND-004223,2011,50200056,,,,3,4,7
HND-004227,2011,50200060,,,,29,32,61
HND-004228,2011,50200061,,,,69,54,123
HND-004230,2011,50200065,,,,7,3,10
HND-004231,2011,50200068,,,,2,1,3
,2011,50200071,,,,10,14,24
,2011,50200072,,,,9,5,14
,2011,50200073,,,,9,11,20
HND-004232,2011,50200074,,,,46,28,74
HND-004233,2011,50200075,,,,8,10,18
HND-004234,2011,50200076,,,,37,49,86
HND-004236,2011,50200078,,,,17,10,27
HND-004237,2011,50200079,,,,14,7,21
HND-004238,2011,50200080,,,,25,15,40
,2011,50200081,,,,15,19,34
,2011,50200082,,,,6,5,11
HND-004242,2011,50200088,,,,17,15,32
,2011,50200089,,,,10,4,14
HND-004243,2011,50200090,,,,13,7,20
,2011,50200113,,,,9,15,24
,2011,50200118,,,,18,31,49
HND-004267,2011,50200130,,,,12,11,23
HND-004269,2011,50200132,,,,42,38,80
HND-004270,2011,50200133,,,,33,35,68
HND-004275,2011,50200147,,,,38,42,80
HND-004276,2011,50200150,,,,14,13,27
,2011,50200161,,,,5,11,16
HND-004280,2011,50200162,,,,27,27,54
HND-004282,2011,50200167,,,,6,7,13
HND-004290,2011,50200187,,,,31,37,68
,2011,50200191,,,,12,12,24
,2011,50200192,,,,2,2,4
HND-004294,2011,50200195,,,,35,41,76
,2011,50200206,,,,18,10,28
,2011,50200207,,,,5,10,15
,2011,50200208,,,,4,4,8
,2011,50200211,,,,7,5,12
,2011,50200264,,,,7,5,12
HND-004304,2011,50200273,,,,4,1,5
,2011,50200300,,,,11,6,17
,2011,50200302,,,,5,10,15
,2011,50200305,,,,13,8,21
HND-004313,2011,50200309,,,,8,9,17
,2011,50200345,,,,0,1,1
HND-004325,2011,50200352,,,,12,18,30
,2011,50200359,,,,8,9,17
,2011,50200390,,,,7,4,11
HND-004172,2011,50200001,,,,1,5,6
HND-004174,2011,50200003,,,,4,2,6
HND-004175,2011,50200004,,,,47,27,74
HND-004178,2011,50200008,,,,2,4,6
HND-004179,2011,50200009,,,,83,58,141
HND-004180,2011,50200010,,,,33,32,65
HND-004183,2011,50200013,,,,81,84,165
HND-004184,2011,50200015,,,,43,28,71
HND-004185,2011,50200016,,,,4,2,6
HND-004186,2011,50200017,,,,3,4,7
HND-004189,2011,50200020,,,,8,5,13
HND-004191,2011,50200022,,,,13,14,27
HND-004193,2011,50200024,,,,47,51,98
HND-004194,2011,50200025,,,,22,24,46
HND-004197,2011,50200028,,,,37,39,76
HND-004199,2011,50200030,,,,8,6,14
HND-004200,2011,50200031,,,,20,20,40
HND-004201,2011,50200032,,,,0,1,1
HND-004202,2011,50200033,,,,5,1,6
HND-004205,2011,50200038,,,,18,20,38
HND-004206,2011,50200039,,,,9,15,24
HND-004207,2011,50200040,,,,7,4,11
HND-004208,2011,50200041,,,,13,21,34
HND-004209,2011,50200042,,,,15,12,27
HND-004210,2011,50200043,,,,48,44,92
HND-004214,2011,50200047,,,,59,54,113
HND-004215,2011,50200048,,,,38,33,71
HND-004216,2011,50200049,,,,4,5,9
HND-004224,2011,50200057,,,,4,3,7
HND-004225,2011,50200058,,,,17,18,35
HND-004226,2011,50200059,,,,59,63,122
HND-004229,2011,50200064,,,,47,44,91
HND-004235,2011,50200077,,,,34,22,56
HND-004239,2011,50200083,,,,37,45,82
HND-004241,2011,50200087,,,,9,4,13
HND-004244,2011,50200091,,,,4,3,7
HND-004245,2011,50200092,,,,1,1,2
HND-004246,2011,50200093,,,,41,39,80
HND-004247,2011,50200094,,,,49,77,126
HND-004256,2011,50200105,,,,22,17,39
,2011,50200115,,,,15,11,26
HND-004268,2011,50200131,,,,3,2,5
HND-004271,2011,50200134,,,,1,1,2
,2011,50200140,,,,9,9,18
,2011,50200148,,,,1,5,6
HND-004278,2011,50200156,,,,23,25,48
,2011,50200165,,,,18,17,35
,2011,50200166,,,,4,3,7
,2011,50200174,,,,26,26,52
HND-004288,2011,50200183,,,,15,15,30
HND-004289,2011,50200186,,,,16,16,32
HND-004291,2011,50200188,,,,53,54,107
HND-004292,2011,50200190,,,,37,23,60
HND-004293,2011,50200194,,,,12,9,21
,2011,50200199,,,,1,0,1
HND-004296,2011,50200201,,,,1,1,2
,2011,50200202,,,,14,9,23
,2011,50200209,,,,15,12,27
,2011,50200210,,,,7,2,9
,2011,50200212,,,,36,22,58
,2011,50200213,,,,4,9,13
HND-004297,2011,50200215,,,,15,9,24
,2011,50200263,,,,1,0,1
HND-004302,2011,50200266,,,,2,0,2
HND-004303,2011,50200272,,,,41,40,81
HND-004305,2011,50200277,,,,9,20,29
HND-004306,2011,50200278,,,,14,12,26
HND-004311,2011,50200307,,,,3,3,6
HND-004323,2011,50200346,,,,17,13,30
,2011,50200349,,,,5,6,11
,2011,50200350,,,,0,1,1
HND-004324,2011,50200351,,,,4,4,8
,2011,50200353,,,,1,2,3
,2011,50200354,,,,4,1,5
,2011,50200355,,,,12,14,26
HND-004326,2011,50200356,,,,3,7,10
,2011,50200358,,,,14,19,33
,2011,50200362,,,,7,7,14
HND-004332,2011,50200389,,,,10,5,15
HND-004172,2011,50200001,,,,1,6,7
HND-004173,2011,50200002,,,,3,2,5
HND-004174,2011,50200003,,,,2,0,2
HND-004175,2011,50200004,,,,34,49,83
HND-004180,2011,50200010,,,,34,32,66
HND-004181,2011,50200011,,,,10,5,15
HND-004182,2011,50200012,,,,62,47,109
HND-004183,2011,50200013,,,,64,70,134
HND-004184,2011,50200015,,,,23,29,52
HND-004185,2011,50200016,,,,3,2,5
HND-004186,2011,50200017,,,,4,3,7
HND-004187,2011,50200018,,,,4,7,11
HND-004192,2011,50200023,,,,28,47,75
HND-004193,2011,50200024,,,,55,40,95
HND-004195,2011,50200026,,,,2,3,5
HND-004196,2011,50200027,,,,8,10,18
HND-004197,2011,50200028,,,,51,40,91
HND-004198,2011,50200029,,,,80,80,160
HND-004199,2011,50200030,,,,6,3,9
HND-004201,2011,50200032,,,,2,2,4
HND-004202,2011,50200033,,,,3,1,4
HND-004203,2011,50200034,,,,20,22,42
,2011,50200036,,,,10,17,27
HND-004206,2011,50200039,,,,10,14,24
HND-004207,2011,50200040,,,,6,9,15
HND-004209,2011,50200042,,,,18,7,25
HND-004210,2011,50200043,,,,45,37,82
HND-004211,2011,50200044,,,,12,15,27
HND-004214,2011,50200047,,,,43,47,90
HND-004216,2011,50200049,,,,7,8,15
HND-004217,2011,50200050,,,,3,4,7
HND-004218,2011,50200051,,,,62,60,122
HND-004221,2011,50200054,,,,100,111,211
HND-004225,2011,50200058,,,,12,19,31
HND-004226,2011,50200059,,,,56,56,112
HND-004228,2011,50200061,,,,72,56,128
,2011,50200071,,,,9,6,15
,2011,50200073,,,,12,10,22
HND-004233,2011,50200075,,,,6,3,9
HND-004234,2011,50200076,,,,50,50,100
HND-004236,2011,50200078,,,,4,8,12
,2011,50200082,,,,8,11,19
HND-004239,2011,50200083,,,,53,27,80
HND-004241,2011,50200087,,,,3,4,7
HND-004242,2011,50200088,,,,19,18,37
,2011,50200089,,,,9,4,13
HND-004244,2011,50200091,,,,0,1,1
HND-004245,2011,50200092,,,,3,1,4
HND-004246,2011,50200093,,,,41,39,80
HND-004247,2011,50200094,,,,74,65,139
,2011,50200115,,,,14,5,19
,2011,50200118,,,,11,14,25
HND-004267,2011,50200130,,,,12,14,26
HND-004268,2011,50200131,,,,1,1,2
HND-004270,2011,50200133,,,,36,33,69
HND-004271,2011,50200134,,,,1,0,1
,2011,50200148,,,,2,1,3
HND-004278,2011,50200156,,,,23,23,46
,2011,50200165,,,,21,21,42
,2011,50200166,,,,4,5,9
HND-004282,2011,50200167,,,,2,9,11
,2011,50200174,,,,34,32,66
HND-004288,2011,50200183,,,,14,13,27
HND-004289,2011,50200186,,,,12,7,19
HND-004292,2011,50200190,,,,19,27,46
HND-004296,2011,50200201,,,,1,1,2
,2011,50200202,,,,16,9,25
,2011,50200207,,,,12,10,22
,2011,50200209,,,,11,16,27
,2011,50200210,,,,8,6,14
,2011,50200211,,,,5,5,10
,2011,50200212,,,,24,27,51
,2011,50200213,,,,2,7,9
,2011,50200263,,,,1,4,5
,2011,50200264,,,,7,4,11
HND-004305,2011,50200277,,,,23,11,34
,2011,50200300,,,,6,7,13
,2011,50200302,,,,3,3,6
HND-004311,2011,50200307,,,,1,4,5
,2011,50200345,,,,2,0,2
HND-004323,2011,50200346,,,,17,19,36
,2011,50200349,,,,5,3,8
HND-004324,2011,50200351,,,,2,4,6
,2011,50200353,,,,5,3,8
,2011,50200354,,,,0,1,1
HND-004326,2011,50200356,,,,3,6,9
,2011,50200362,,,,8,10,18
HND-004176,2011,50200005,,,,18,9,27
,2011,50200006,,,,2,4,6
HND-004177,2011,50200007,,,,15,26,41
HND-004178,2011,50200008,,,,4,3,7
HND-004179,2011,50200009,,,,84,59,143
,2011,50200014,,,,9,14,23
HND-004188,2011,50200019,,,,4,5,9
HND-004189,2011,50200020,,,,3,1,4
HND-004190,2011,50200021,,,,5,10,15
HND-004191,2011,50200022,,,,9,9,18
HND-004200,2011,50200031,,,,16,24,40
HND-004204,2011,50200037,,,,9,9,18
HND-004205,2011,50200038,,,,30,21,51
HND-004208,2011,50200041,,,,13,11,24
HND-004212,2011,50200045,,,,4,7,11
HND-004213,2011,50200046,,,,9,17,26
HND-004215,2011,50200048,,,,25,35,60
HND-004219,2011,50200052,,,,31,24,55
HND-004220,2011,50200053,,,,69,46,115
HND-004222,2011,50200055,,,,28,19,47
HND-004223,2011,50200056,,,,4,3,7
HND-004224,2011,50200057,,,,3,1,4
HND-004227,2011,50200060,,,,39,48,87
HND-004229,2011,50200064,,,,51,48,99
HND-004230,2011,50200065,,,,6,5,11
HND-004231,2011,50200068,,,,2,2,4
,2011,50200072,,,,11,5,16
HND-004232,2011,50200074,,,,42,38,80
HND-004235,2011,50200077,,,,18,26,44
HND-004237,2011,50200079,,,,16,9,25
HND-004238,2011,50200080,,,,14,20,34
,2011,50200081,,,,16,17,33
HND-004243,2011,50200090,,,,15,8,23
HND-004256,2011,50200105,,,,15,13,28
,2011,50200113,,,,5,7,12
HND-004269,2011,50200132,,,,48,32,80
,2011,50200140,,,,16,9,25
HND-004275,2011,50200147,,,,38,39,77
HND-004276,2011,50200150,,,,11,11,22
,2011,50200161,,,,5,10,15
HND-004280,2011,50200162,,,,37,26,63
HND-004290,2011,50200187,,,,24,33,57
HND-004291,2011,50200188,,,,72,61,133
,2011,50200191,,,,15,13,28
,2011,50200192,,,,2,2,4
HND-004293,2011,50200194,,,,12,14,26
HND-004294,2011,50200195,,,,37,31,68
,2011,50200199,,,,4,5,9
,2011,50200206,,,,10,9,19
,2011,50200208,,,,3,2,5
HND-004297,2011,50200215,,,,7,9,16
HND-004302,2011,50200266,,,,5,2,7
HND-004303,2011,50200272,,,,36,29,65
HND-004304,2011,50200273,,,,1,6,7
HND-004306,2011,50200278,,,,14,12,26
,2011,50200305,,,,4,10,14
HND-004313,2011,50200309,,,,23,14,37
,2011,50200347,,,,3,3,6
HND-004325,2011,50200352,,,,15,10,25
,2011,50200355,,,,2,1,3
,2011,50200358,,,,14,11,25
,2011,50200359,,,,10,1,11
HND-004332,2011,50200389,,,,3,3,6
,2011,50200390,,,,6,4,10
HND-004172,2011,50200001,,,,6,5,11
HND-004173,2011,50200002,,,,4,6,10
HND-004174,2011,50200003,,,,6,0,6
HND-004175,2011,50200004,,,,29,34,63
HND-004178,2011,50200008,,,,7,2,9
HND-004180,2011,50200010,,,,28,28,56
HND-004181,2011,50200011,,,,6,7,13
HND-004182,2011,50200012,,,,42,45,87
HND-004183,2011,50200013,,,,78,69,147
HND-004184,2011,50200015,,,,28,19,47
HND-004185,2011,50200016,,,,7,2,9
HND-004186,2011,50200017,,,,3,1,4
HND-004187,2011,50200018,,,,11,6,17
HND-004191,2011,50200022,,,,9,21,30
HND-004193,2011,50200024,,,,40,44,84
HND-004194,2011,50200025,,,,40,35,75
HND-004195,2011,50200026,,,,3,2,5
HND-004196,2011,50200027,,,,6,13,19
HND-004197,2011,50200028,,,,38,39,77
HND-004199,2011,50200030,,,,5,5,10
HND-004201,2011,50200032,,,,5,4,9
HND-004202,2011,50200033,,,,0,1,1
HND-004203,2011,50200034,,,,22,22,44
,2011,50200036,,,,26,14,40
HND-004206,2011,50200039,,,,8,8,16
HND-004207,2011,50200040,,,,8,10,18
HND-004208,2011,50200041,,,,19,11,30
HND-004209,2011,50200042,,,,14,13,27
HND-004210,2011,50200043,,,,37,46,83
HND-004211,2011,50200044,,,,17,17,34
HND-004214,2011,50200047,,,,37,42,79
HND-004216,2011,50200049,,,,0,6,6
HND-004218,2011,50200051,,,,68,70,138
HND-004224,2011,50200057,,,,3,5,8
HND-004225,2011,50200058,,,,15,12,27
HND-004226,2011,50200059,,,,72,51,123
HND-004229,2011,50200064,,,,41,44,85
,2011,50200071,,,,13,11,24
HND-004233,2011,50200075,,,,5,6,11
HND-004234,2011,50200076,,,,50,47,97
HND-004239,2011,50200083,,,,26,28,54
HND-004241,2011,50200087,,,,6,4,10
HND-004242,2011,50200088,,,,16,15,31
HND-004244,2011,50200091,,,,1,3,4
HND-004245,2011,50200092,,,,1,1,2
HND-004246,2011,50200093,,,,26,22,48
HND-004247,2011,50200094,,,,61,58,119
,2011,50200115,,,,14,14,28
HND-004268,2011,50200131,,,,1,4,5
HND-004271,2011,50200134,,,,2,3,5
,2011,50200140,,,,10,13,23
,2011,50200148,,,,5,3,8
HND-004278,2011,50200156,,,,24,25,49
,2011,50200165,,,,16,21,37
,2011,50200166,,,,2,5,7
,2011,50200174,,,,30,24,54
HND-004288,2011,50200183,,,,13,18,31
HND-004289,2011,50200186,,,,11,19,30
HND-004292,2011,50200190,,,,17,24,41
HND-004293,2011,50200194,,,,11,15,26
HND-004296,2011,50200201,,,,1,2,3
,2011,50200202,,,,15,12,27
,2011,50200209,,,,7,6,13
,2011,50200210,,,,11,6,17
,2011,50200211,,,,7,3,10
,2011,50200212,,,,31,36,67
,2011,50200213,,,,1,6,7
HND-004297,2011,50200215,,,,10,10,20
,2011,50200263,,,,0,1,1
,2011,50200264,,,,4,5,9
HND-004305,2011,50200277,,,,21,19,40
,2011,50200300,,,,6,9,15
HND-004311,2011,50200307,,,,2,1,3
,2011,50200345,,,,0,1,1
HND-004323,2011,50200346,,,,16,14,30
,2011,50200349,,,,4,6,10
HND-004324,2011,50200351,,,,3,2,5
,2011,50200353,,,,1,2,3
,2011,50200354,,,,3,1,4
HND-004326,2011,50200356,,,,5,5,10
,2011,50200358,,,,15,16,31
,2011,50200362,,,,2,6,8
HND-004332,2011,50200389,,,,7,4,11
HND-004176,2011,50200005,,,,10,10,20
,2011,50200006,,,,1,3,4
HND-004177,2011,50200007,,,,22,26,48
HND-004179,2011,50200009,,,,64,61,125
,2011,50200014,,,,11,17,28
HND-004188,2011,50200019,,,,8,3,11
HND-004189,2011,50200020,,,,3,1,4
HND-004190,2011,50200021,,,,7,7,14
HND-004192,2011,50200023,,,,34,52,86
HND-004198,2011,50200029,,,,81,94,175
HND-004200,2011,50200031,,,,15,12,27
HND-004204,2011,50200037,,,,8,14,22
HND-004205,2011,50200038,,,,25,29,54
HND-004212,2011,50200045,,,,1,5,6
HND-004213,2011,50200046,,,,10,13,23
HND-004215,2011,50200048,,,,40,38,78
HND-004217,2011,50200050,,,,3,5,8
HND-004219,2011,50200052,,,,14,11,25
HND-004220,2011,50200053,,,,56,56,112
HND-004221,2011,50200054,,,,109,111,220
HND-004222,2011,50200055,,,,27,24,51
HND-004223,2011,50200056,,,,2,3,5
HND-004227,2011,50200060,,,,26,27,53
HND-004228,2011,50200061,,,,69,62,131
HND-004230,2011,50200065,,,,4,6,10
HND-004231,2011,50200068,,,,4,2,6
,2011,50200072,,,,8,13,21
,2011,50200073,,,,9,15,24
HND-004232,2011,50200074,,,,53,47,100
HND-004235,2011,50200077,,,,24,29,53
HND-004236,2011,50200078,,,,6,3,9
HND-004237,2011,50200079,,,,19,15,34
HND-004238,2011,50200080,,,,30,30,60
,2011,50200081,,,,23,20,43
,2011,50200082,,,,9,6,15
,2011,50200089,,,,8,9,17
HND-004243,2011,50200090,,,,10,7,17
HND-004256,2011,50200105,,,,14,14,28
,2011,50200113,,,,5,8,13
,2011,50200118,,,,15,22,37
HND-004267,2011,50200130,,,,14,10,24
HND-004269,2011,50200132,,,,28,35,63
HND-004270,2011,50200133,,,,46,32,78
HND-004275,2011,50200147,,,,43,36,79
HND-004276,2011,50200150,,,,18,14,32
,2011,50200161,,,,11,5,16
HND-004280,2011,50200162,,,,48,42,90
HND-004282,2011,50200167,,,,2,7,9
HND-004290,2011,50200187,,,,25,36,61
HND-004291,2011,50200188,,,,45,46,91
,2011,50200191,,,,10,8,18
,2011,50200192,,,,1,4,5
HND-004294,2011,50200195,,,,44,44,88
,2011,50200199,,,,3,3,6
,2011,50200206,,,,13,7,20
,2011,50200207,,,,9,5,14
,2011,50200208,,,,4,5,9
HND-004302,2011,50200266,,,,3,1,4
HND-004303,2011,50200272,,,,22,28,50
HND-004304,2011,50200273,,,,0,1,1
HND-004306,2011,50200278,,,,15,16,31
,2011,50200302,,,,3,6,9
,2011,50200305,,,,3,3,6
HND-004313,2011,50200309,,,,10,11,21
,2011,50200347,,,,3,3,6
HND-004325,2011,50200352,,,,13,10,23
,2011,50200355,,,,0,4,4
,2011,50200359,,,,4,4,8
,2011,50200390,,,,6,4,10
HND-004172,2011,50200001,,,,3,5,8
HND-004175,2011,50200004,,,,43,31,74
HND-004176,2011,50200005,,,,18,7,25
,2011,50200006,,,,3,3,6
HND-004177,2011,50200007,,,,14,20,34
HND-004178,2011,50200008,,,,7,4,11
HND-004179,2011,50200009,,,,63,46,109
,2011,50200014,,,,20,11,31
HND-004186,2011,50200017,,,,2,0,2
HND-004188,2011,50200019,,,,5,5,10
HND-004189,2011,50200020,,,,3,7,10
HND-004190,2011,50200021,,,,7,5,12
HND-004191,2011,50200022,,,,9,8,17
HND-004193,2011,50200024,,,,39,58,97
HND-004194,2011,50200025,,,,38,28,66
HND-004199,2011,50200030,,,,6,9,15
HND-004200,2011,50200031,,,,12,10,22
HND-004202,2011,50200033,,,,3,4,7
HND-004205,2011,50200038,,,,18,25,43
HND-004206,2011,50200039,,,,14,17,31
HND-004207,2011,50200040,,,,1,10,11
HND-004208,2011,50200041,,,,15,19,34
HND-004210,2011,50200043,,,,61,45,106
HND-004212,2011,50200045,,,,2,7,9
HND-004213,2011,50200046,,,,20,14,34
HND-004215,2011,50200048,,,,35,45,80
HND-004222,2011,50200055,,,,19,15,34
HND-004223,2011,50200056,,,,1,4,5
HND-004224,2011,50200057,,,,3,1,4
HND-004229,2011,50200064,,,,50,41,91
HND-004231,2011,50200068,,,,2,0,2
HND-004232,2011,50200074,,,,36,36,72
HND-004235,2011,50200077,,,,27,17,44
HND-004237,2011,50200079,,,,5,6,11
HND-004241,2011,50200087,,,,2,8,10
HND-004243,2011,50200090,,,,7,10,17
HND-004247,2011,50200094,,,,79,64,143
HND-004256,2011,50200105,,,,10,10,20
,2011,50200113,,,,2,6,8
HND-004271,2011,50200134,,,,0,1,1
,2011,50200140,,,,11,11,22
HND-004275,2011,50200147,,,,38,33,71
,2011,50200148,,,,2,3,5
HND-004276,2011,50200150,,,,15,13,28
HND-004278,2011,50200156,,,,12,13,25
HND-004280,2011,50200162,,,,37,36,73
,2011,50200174,,,,33,25,58
HND-004288,2011,50200183,,,,10,15,25
HND-004291,2011,50200188,,,,37,36,73
HND-004293,2011,50200194,,,,7,6,13
,2011,50200199,,,,3,3,6
HND-004296,2011,50200201,,,,4,2,6
,2011,50200202,,,,13,13,26
,2011,50200208,,,,3,3,6
,2011,50200209,,,,2,10,12
HND-004297,2011,50200215,,,,10,4,14
,2011,50200263,,,,2,0,2
HND-004302,2011,50200266,,,,1,1,2
HND-004305,2011,50200277,,,,8,15,23
,2011,50200305,,,,5,4,9
HND-004311,2011,50200307,,,,2,2,4
HND-004313,2011,50200309,,,,2,5,7
HND-004326,2011,50200356,,,,3,2,5
,2011,50200358,,,,10,10,20
,2011,50200359,,,,2,2,4
HND-004332,2011,50200389,,,,1,3,4
HND-004173,2011,50200002,,,,5,7,12
HND-004174,2011,50200003,,,,5,4,9
HND-004180,2011,50200010,,,,26,26,52
HND-004181,2011,50200011,,,,5,7,12
HND-004182,2011,50200012,,,,34,39,73
HND-004183,2011,50200013,,,,77,51,128
HND-004184,2011,50200015,,,,23,23,46
HND-004185,2011,50200016,,,,2,2,4
HND-004187,2011,50200018,,,,8,10,18
HND-004192,2011,50200023,,,,34,27,61
HND-004195,2011,50200026,,,,10,3,13
HND-004196,2011,50200027,,,,11,10,21
HND-004197,2011,50200028,,,,37,35,72
HND-004198,2011,50200029,,,,73,79,152
HND-004201,2011,50200032,,,,1,2,3
HND-004203,2011,50200034,,,,29,17,46
,2011,50200036,,,,2,1,3
HND-004204,2011,50200037,,,,3,6,9
HND-004209,2011,50200042,,,,15,22,37
HND-004211,2011,50200044,,,,26,20,46
HND-004214,2011,50200047,,,,35,41,76
HND-004216,2011,50200049,,,,2,6,8
HND-004217,2011,50200050,,,,1,2,3
HND-004218,2011,50200051,,,,62,57,119
HND-004219,2011,50200052,,,,17,20,37
HND-004220,2011,50200053,,,,70,66,136
HND-004221,2011,50200054,,,,105,97,202
HND-004225,2011,50200058,,,,24,14,38
HND-004226,2011,50200059,,,,59,35,94
HND-004227,2011,50200060,,,,29,35,64
HND-004228,2011,50200061,,,,36,33,69
HND-004230,2011,50200065,,,,2,3,5
,2011,50200071,,,,7,11,18
,2011,50200072,,,,9,9,18
,2011,50200073,,,,12,12,24
HND-004233,2011,50200075,,,,6,7,13
HND-004234,2011,50200076,,,,56,56,112
HND-004236,2011,50200078,,,,8,6,14
HND-004238,2011,50200080,,,,19,11,30
,2011,50200081,,,,13,26,39
,2011,50200082,,,,9,17,26
HND-004239,2011,50200083,,,,29,32,61
HND-004242,2011,50200088,,,,22,9,31
,2011,50200089,,,,5,13,18
HND-004245,2011,50200092,,,,3,0,3
HND-004246,2011,50200093,,,,27,27,54
,2011,50200115,,,,6,6,12
,2011,50200118,,,,9,18,27
HND-004267,2011,50200130,,,,11,10,21
HND-004268,2011,50200131,,,,2,2,4
HND-004269,2011,50200132,,,,20,33,53
HND-004270,2011,50200133,,,,34,28,62
,2011,50200161,,,,5,5,10
,2011,50200165,,,,14,26,40
,2011,50200166,,,,0,4,4
HND-004282,2011,50200167,,,,3,5,8
HND-004289,2011,50200186,,,,4,6,10
HND-004290,2011,50200187,,,,21,20,41
HND-004292,2011,50200190,,,,22,26,48
,2011,50200191,,,,16,15,31
,2011,50200192,,,,2,3,5
HND-004294,2011,50200195,,,,44,33,77
,2011,50200206,,,,5,14,19
,2011,50200207,,,,10,6,16
,2011,50200210,,,,7,7,14
,2011,50200211,,,,1,3,4
,2011,50200212,,,,21,36,57
,2011,50200213,,,,0,2,2
,2011,50200264,,,,7,2,9
HND-004303,2011,50200272,,,,18,30,48
HND-004304,2011,50200273,,,,2,1,3
HND-004306,2011,50200278,,,,7,7,14
,2011,50200300,,,,6,5,11
,2011,50200302,,,,4,1,5
HND-004323,2011,50200346,,,,12,11,23
,2011,50200347,,,,3,3,6
,2011,50200349,,,,3,1,4
HND-004324,2011,50200351,,,,2,10,12
HND-004325,2011,50200352,,,,10,12,22
,2011,50200362,,,,7,1,8
,2011,50200390,,,,8,6,14
HND-004179,2011,50200009,,,,57,65,122
,2011,50200014,,,,10,21,31
HND-004193,2011,50200024,,,,49,48,97
HND-004194,2011,50200025,,,,26,28,54
HND-004219,2011,50200052,,,,25,32,57
,2011,50200071,,,,4,10,14
,2011,50200081,,,,8,9,17
,2011,50200082,,,,23,24,47
,2011,50200089,,,,24,31,55
HND-004253,2011,50200100,,,,371,318,689
HND-004257,2011,50200106,,,,653,624,1277
,2011,50200113,,,,6,8,14
HND-004281,2011,50200163,,,,39,57,96
,2011,50200165,,,,28,36,64
,2011,50200171,,,,8,17,25
,2011,50200172,,,,67,73,140
,2011,50200191,,,,7,7,14
,2011,50200207,,,,5,12,17
,2011,50200214,,,,30,26,56
,2011,50200264,,,,6,4,10
,2011,50200279,,,,34,30,64
,2011,50200292,,,,20,16,36
,2011,50200300,,,,11,11,22
,2011,50200302,,,,26,26,52
,2011,50200303,,,,2,10,12
HND-004210,2011,50200043,,,,31,34,65
HND-004218,2011,50200051,,,,25,25,50
,2011,50200073,,,,37,34,71
HND-004239,2011,50200083,,,,24,28,52
HND-004247,2011,50200094,,,,48,68,116
,2011,50200103,,,,39,54,93
HND-004258,2011,50200107,,,,123,114,237
HND-004280,2011,50200162,,,,20,20,40
,2011,50200173,,,,8,8,16
,2011,50200174,,,,28,16,44
,2011,50200193,,,,4,4,8
,2011,50200209,,,,2,4,6
,2011,50200210,,,,6,5,11
,2011,50200213,,,,7,10,17
,2011,50200301,,,,5,13,18
,2011,50200344,,,,17,20,37
,2011,50200348,,,,14,16,30
,2011,50200358,,,,13,11,24
HND-004193,2011,50200024,,,,35,24,59
HND-004218,2011,50200051,,,,20,18,38
HND-004219,2011,50200052,,,,18,16,34
,2011,50200071,,,,2,6,8
,2011,50200073,,,,24,36,60
HND-004239,2011,50200083,,,,15,16,31
,2011,50200103,,,,16,20,36
,2011,50200165,,,,14,26,40
,2011,50200171,,,,10,15,25
,2011,50200174,,,,22,25,47
,2011,50200210,,,,2,3,5
,2011,50200213,,,,4,7,11
,2011,50200264,,,,4,3,7
,2011,50200301,,,,4,10,14
,2011,50200344,,,,12,17,29
,2011,50200348,,,,11,15,26
,2011,50200358,,,,4,3,7
HND-004179,2011,50200009,,,,45,44,89
,2011,50200014,,,,16,14,30
HND-004194,2011,50200025,,,,20,19,39
HND-004210,2011,50200043,,,,25,30,55
,2011,50200081,,,,9,4,13
,2011,50200082,,,,22,15,37
,2011,50200089,,,,19,38,57
HND-004247,2011,50200094,,,,17,28,45
HND-004253,2011,50200100,,,,241,275,516
HND-004257,2011,50200106,,,,442,520,962
HND-004258,2011,50200107,,,,70,75,145
,2011,50200113,,,,1,6,7
HND-004281,2011,50200163,,,,33,42,75
,2011,50200172,,,,81,63,144
,2011,50200173,,,,7,7,14
,2011,50200191,,,,9,6,15
,2011,50200193,,,,3,4,7
,2011,50200207,,,,2,4,6
,2011,50200214,,,,12,23,35
,2011,50200279,,,,37,42,79
,2011,50200292,,,,13,14,27
,2011,50200300,,,,3,10,13
,2011,50200302,,,,15,19,34
,2011,50200303,,,,3,7,10
HND-004193,2011,50200024,,,,26,27,53
HND-004210,2011,50200043,,,,26,21,47
HND-004218,2011,50200051,,,,24,8,32
,2011,50200081,,,,6,2,8
,2011,50200082,,,,24,17,41
HND-004239,2011,50200083,,,,10,12,22
,2011,50200089,,,,6,14,20
HND-004247,2011,50200094,,,,11,13,24
HND-004253,2011,50200100,,,,217,238,455
HND-004257,2011,50200106,,,,361,515,876
HND-004281,2011,50200163,,,,36,38,74
,2011,50200165,,,,16,22,38
,2011,50200173,,,,14,8,22
,2011,50200174,,,,15,14,29
,2011,50200207,,,,0,1,1
,2011,50200213,,,,1,6,7
,2011,50200214,,,,6,12,18
,2011,50200264,,,,7,6,13
HND-004179,2011,50200009,,,,30,37,67
,2011,50200014,,,,8,20,28
HND-004194,2011,50200025,,,,10,8,18
HND-004219,2011,50200052,,,,28,13,41
,2011,50200073,,,,27,23,50
,2011,50200103,,,,20,34,54
HND-004258,2011,50200107,,,,62,70,132
,2011,50200113,,,,7,6,13
,2011,50200171,,,,6,13,19
,2011,50200172,,,,61,87,148
,2011,50200191,,,,2,3,5
,2011,50200210,,,,0,2,2
,2011,50200279,,,,11,25,36
,2011,50200292,,,,14,16,30
,2011,50200300,,,,5,4,9
,2011,50200301,,,,5,3,8
,2011,50200302,,,,7,19,26
,2011,50200303,,,,6,7,13
,2011,50200344,,,,5,14,19
,2011,50200348,,,,9,13,22
,2011,50200073,,,,17,40,57
,2011,50200081,,,,5,5,10
,2011,50200082,,,,22,9,31
HND-004253,2011,50200100,,,,238,366,604
HND-004257,2011,50200106,,,,367,623,990
HND-004258,2011,50200107,,,,28,39,67
HND-004281,2011,50200163,,,,24,42,66
,2011,50200171,,,,15,25,40
,2011,50200174,,,,6,6,12
,2011,50200292,,,,21,22,43
,2011,50200300,,,,3,5,8
,2011,50200301,,,,9,5,14
,2011,50200303,,,,7,12,19
,2011,50200348,,,,8,15,23
,2011,50200014,,,,7,14,21
,2011,50200089,,,,5,12,17
,2011,50200103,,,,20,24,44
,2011,50200165,,,,6,4,10
,2011,50200172,,,,60,74,134
,2011,50200173,,,,5,6,11
,2011,50200193,,,,0,2,2
,2011,50200213,,,,0,7,7
,2011,50200214,,,,17,35,52
,2011,50200279,,,,14,20,34
,2011,50200302,,,,4,17,21
,2011,50200073,,,,25,42,67
,2011,50200081,,,,4,6,10
HND-004253,2011,50200100,,,,143,206,349
HND-004258,2011,50200107,,,,33,41,74
,2011,50200113,,,,7,17,24
,2011,50200171,,,,11,12,23
,2011,50200172,,,,54,108,162
,2011,50200213,,,,7,14,21
,2011,50200214,,,,21,26,47
,2011,50200279,,,,12,11,23
,2011,50200292,,,,32,26,58
,2011,50200302,,,,11,29,40
,2011,50200303,,,,1,11,12
,2011,50200014,,,,4,9,13
,2011,50200082,,,,12,15,27
,2011,50200089,,,,16,12,28
,2011,50200103,,,,23,21,44
HND-004257,2011,50200106,,,,206,418,624
HND-004281,2011,50200163,,,,15,38,53
,2011,50200165,,,,0,5,5
,2011,50200173,,,,6,10,16
,2011,50200174,,,,1,5,6
,2011,50200193,,,,2,0,2
,2011,50200348,,,,2,3,5
,2011,50200014,,,,7,16,23
,2011,50200082,,,,11,10,21
,2011,50200103,,,,7,7,14
,2011,50200172,,,,29,55,84
,2011,50200173,,,,7,4,11
,2011,50200073,,,,13,19,32
,2011,50200081,,,,7,6,13
HND-004253,2011,50200100,,,,165,219,384
HND-004257,2011,50200106,,,,158,302,460
HND-004258,2011,50200107,,,,18,17,35
HND-004281,2011,50200163,,,,29,35,64
,2011,50200171,,,,3,4,7
,2011,50200213,,,,1,3,4
,2011,50200214,,,,14,15,29
,2011,50200279,,,,4,4,8
,2011,50200302,,,,3,10,13
,2011,50200348,,,,4,8,12
HND-004384,2011,50300051,,,,7,4,11
,2011,50300052,,,,4,3,7
HND-004401,2011,50300085,,,,2,5,7
,2011,50300102,,,,9,3,12
HND-004425,2011,50300124,,,,3,5,8
,2011,50300126,,,,5,5,10
,2011,50300133,,,,3,2,5
HND-004427,2011,50300144,,,,7,4,11
,2011,50300145,,,,3,3,6
,2011,50300153,,,,8,8,16
,2011,50300155,,,,5,6,11
,2011,50300156,,,,7,8,15
HND-004365,2011,50300029,,,,4,5,9
HND-004366,2011,50300030,,,,4,4,8
HND-004391,2011,50300068,,,,3,4,7
HND-004397,2011,50300076,,,,1,3,4
,2011,50300128,,,,3,1,4
,2011,50300131,,,,2,2,4
,2011,50300142,,,,10,8,18
,2011,50300146,,,,11,9,20
,2011,50300151,,,,4,3,7
,2011,50300157,,,,5,4,9
HND-004428,2011,50300159,,,,11,4,15
,2011,50300160,,,,3,6,9
,2011,50300165,,,,5,6,11
,2011,50300166,,,,3,3,6
,2011,50300070,,,,7,5,12
HND-004340,2011,50300002,,,,9,6,15
HND-004355,2011,50300019,,,,3,1,4
HND-004358,2011,50300022,,,,20,10,30
,2011,50300055,,,,10,3,13
HND-004385,2011,50300057,,,,4,1,5
HND-004386,2011,50300060,,,,6,2,8
,2011,50300061,,,,6,4,10
,2011,50300115,,,,5,5,10
,2011,50300121,,,,3,3,6
,2011,50300149,,,,8,7,15
,2011,50300154,,,,3,2,5
HND-004342,2011,50300004,,,,2,4,6
HND-004344,2011,50300007,,,,7,6,13
HND-004346,2011,50300009,,,,3,4,7
,2011,50300016,,,,3,3,6
HND-004354,2011,50300018,,,,8,3,11
HND-004362,2011,50300026,,,,3,5,8
HND-004363,2011,50300027,,,,4,1,5
HND-004380,2011,50300047,,,,24,24,48
HND-004383,2011,50300050,,,,11,8,19
,2011,50300053,,,,2,2,4
,2011,50300070,,,,7,8,15
,2011,50300148,,,,3,5,8
,2011,50300162,,,,2,2,4
HND-004430,2011,50300164,,,,4,7,11
HND-004342,2011,50300004,,,,7,7,14
HND-004346,2011,50300009,,,,5,9,14
,2011,50300016,,,,10,4,14
HND-004354,2011,50300018,,,,8,5,13
HND-004362,2011,50300026,,,,11,11,22
HND-004363,2011,50300027,,,,4,7,11
HND-004383,2011,50300050,,,,27,31,58
,2011,50300053,,,,34,24,58
,2011,50300058,,,,10,12,22
HND-004386,2011,50300060,,,,9,6,15
,2011,50300162,,,,1,4,5
HND-004430,2011,50300164,,,,13,12,25
HND-004340,2011,50300002,,,,19,21,40
HND-004344,2011,50300007,,,,8,10,18
HND-004355,2011,50300019,,,,11,8,19
HND-004358,2011,50300022,,,,18,25,43
HND-004380,2011,50300047,,,,45,50,95
,2011,50300055,,,,10,6,16
,2011,50300056,,,,12,10,22
HND-004385,2011,50300057,,,,15,20,35
,2011,50300061,,,,7,5,12
,2011,50300070,,,,10,8,18
,2011,50300095,,,,8,3,11
,2011,50300115,,,,12,10,22
,2011,50300148,,,,12,6,18
,2011,50300149,,,,4,8,12
,2011,50300154,,,,3,3,6
HND-004339,2011,50300001,,,,4,2,6
HND-004341,2011,50300003,,,,14,16,30
HND-004345,2011,50300008,,,,9,5,14
HND-004346,2011,50300009,,,,15,10,25
,2011,50300012,,,,3,2,5
HND-004350,2011,50300014,,,,41,28,69
HND-004353,2011,50300017,,,,10,4,14
HND-004355,2011,50300019,,,,17,11,28
HND-004356,2011,50300020,,,,74,86,160
HND-004358,2011,50300022,,,,22,33,55
HND-004359,2011,50300023,,,,5,3,8
HND-004360,2011,50300024,,,,4,5,9
HND-004365,2011,50300029,,,,8,3,11
HND-004368,2011,50300032,,,,4,5,9
HND-004370,2011,50300034,,,,9,9,18
HND-004373,2011,50300037,,,,6,1,7
HND-004375,2011,50300039,,,,4,6,10
HND-004376,2011,50300042,,,,0,2,2
HND-004377,2011,50300043,,,,0,1,1
,2011,50300049,,,,3,3,6
HND-004387,2011,50300062,,,,7,1,8
HND-004388,2011,50300063,,,,2,1,3
HND-004391,2011,50300068,,,,0,3,3
HND-004392,2011,50300071,,,,7,6,13
HND-004396,2011,50300075,,,,4,2,6
HND-004397,2011,50300076,,,,2,1,3
HND-004401,2011,50300085,,,,0,3,3
HND-004402,2011,50300086,,,,1,2,3
HND-004403,2011,50300087,,,,7,14,21
,2011,50300091,,,,8,4,12
HND-004407,2011,50300092,,,,0,4,4
,2011,50300095,,,,4,6,10
HND-004411,2011,50300098,,,,2,4,6
HND-004412,2011,50300099,,,,16,18,34
HND-004415,2011,50300105,,,,4,9,13
,2011,50300106,,,,5,2,7
HND-004417,2011,50300108,,,,4,3,7
HND-004418,2011,50300111,,,,5,7,12
HND-004422,2011,50300116,,,,3,1,4
,2011,50300121,,,,1,2,3
HND-004424,2011,50300122,,,,1,3,4
,2011,50300154,,,,7,3,10
HND-004429,2011,50300163,,,,11,9,20
HND-004342,2011,50300004,,,,7,19,26
,2011,50300005,,,,2,5,7
HND-004343,2011,50300006,,,,8,8,16
HND-004344,2011,50300007,,,,13,14,27
HND-004347,2011,50300010,,,,14,14,28
HND-004348,2011,50300011,,,,5,2,7
HND-004351,2011,50300015,,,,2,2,4
,2011,50300016,,,,13,8,21
HND-004354,2011,50300018,,,,17,10,27
HND-004357,2011,50300021,,,,72,35,107
HND-004361,2011,50300025,,,,15,10,25
HND-004362,2011,50300026,,,,6,9,15
HND-004363,2011,50300027,,,,9,8,17
HND-004364,2011,50300028,,,,28,22,50
HND-004366,2011,50300030,,,,9,4,13
HND-004367,2011,50300031,,,,10,10,20
HND-004369,2011,50300033,,,,1,2,3
HND-004371,2011,50300035,,,,5,11,16
HND-004372,2011,50300036,,,,1,1,2
HND-004374,2011,50300038,,,,14,14,28
HND-004378,2011,50300044,,,,2,4,6
HND-004379,2011,50300045,,,,4,3,7
HND-004381,2011,50300048,,,,57,48,105
,2011,50300065,,,,2,2,4
HND-004390,2011,50300067,,,,4,1,5
HND-004393,2011,50300072,,,,4,2,6
HND-004394,2011,50300073,,,,2,6,8
,2011,50300074,,,,7,6,13
,2011,50300080,,,,1,1,2
HND-004398,2011,50300081,,,,3,8,11
HND-004399,2011,50300082,,,,8,3,11
HND-004400,2011,50300083,,,,6,2,8
HND-004404,2011,50300088,,,,3,3,6
,2011,50300089,,,,3,1,4
HND-004408,2011,50300094,,,,20,23,43
HND-004409,2011,50300096,,,,11,7,18
HND-004410,2011,50300097,,,,1,1,2
HND-004414,2011,50300104,,,,4,4,8
HND-004419,2011,50300112,,,,1,3,4
HND-004423,2011,50300119,,,,7,2,9
,2011,50300142,,,,5,8,13
,2011,50300162,,,,9,7,16
HND-004341,2011,50300003,,,,8,18,26
HND-004342,2011,50300004,,,,12,15,27
HND-004346,2011,50300009,,,,14,12,26
HND-004348,2011,50300011,,,,1,1,2
HND-004351,2011,50300015,,,,2,1,3
,2011,50300016,,,,13,9,22
HND-004353,2011,50300017,,,,0,2,2
HND-004354,2011,50300018,,,,11,10,21
HND-004360,2011,50300024,,,,6,3,9
HND-004361,2011,50300025,,,,14,12,26
HND-004362,2011,50300026,,,,8,6,14
HND-004363,2011,50300027,,,,4,3,7
HND-004367,2011,50300031,,,,12,12,24
HND-004371,2011,50300035,,,,15,16,31
HND-004373,2011,50300037,,,,3,6,9
HND-004374,2011,50300038,,,,17,9,26
HND-004376,2011,50300042,,,,4,4,8
HND-004377,2011,50300043,,,,1,2,3
HND-004378,2011,50300044,,,,4,6,10
HND-004381,2011,50300048,,,,40,44,84
,2011,50300049,,,,2,2,4
HND-004387,2011,50300062,,,,3,0,3
HND-004388,2011,50300063,,,,1,1,2
HND-004392,2011,50300071,,,,5,2,7
HND-004393,2011,50300072,,,,1,4,5
HND-004394,2011,50300073,,,,4,3,7
,2011,50300080,,,,1,1,2
HND-004398,2011,50300081,,,,1,0,1
HND-004401,2011,50300085,,,,5,5,10
HND-004402,2011,50300086,,,,2,0,2
HND-004404,2011,50300088,,,,4,1,5
HND-004407,2011,50300092,,,,0,1,1
HND-004408,2011,50300094,,,,15,16,31
HND-004410,2011,50300097,,,,1,4,5
HND-004412,2011,50300099,,,,12,10,22
HND-004417,2011,50300108,,,,7,4,11
HND-004418,2011,50300111,,,,10,10,20
HND-004419,2011,50300112,,,,4,0,4
HND-004422,2011,50300116,,,,4,2,6
,2011,50300162,,,,12,10,22
HND-004339,2011,50300001,,,,1,1,2
,2011,50300005,,,,1,1,2
HND-004343,2011,50300006,,,,8,6,14
HND-004344,2011,50300007,,,,12,9,21
HND-004345,2011,50300008,,,,10,8,18
HND-004347,2011,50300010,,,,14,8,22
,2011,50300012,,,,2,2,4
HND-004350,2011,50300014,,,,22,34,56
HND-004355,2011,50300019,,,,18,14,32
HND-004356,2011,50300020,,,,77,76,153
HND-004357,2011,50300021,,,,52,44,96
HND-004358,2011,50300022,,,,26,19,45
HND-004359,2011,50300023,,,,2,4,6
HND-004364,2011,50300028,,,,18,28,46
HND-004365,2011,50300029,,,,11,0,11
HND-004366,2011,50300030,,,,6,4,10
HND-004368,2011,50300032,,,,4,5,9
HND-004369,2011,50300033,,,,2,2,4
HND-004370,2011,50300034,,,,4,7,11
HND-004375,2011,50300039,,,,6,4,10
HND-004379,2011,50300045,,,,4,1,5
,2011,50300065,,,,4,3,7
HND-004390,2011,50300067,,,,6,2,8
HND-004391,2011,50300068,,,,2,9,11
,2011,50300074,,,,6,3,9
HND-004397,2011,50300076,,,,1,2,3
HND-004399,2011,50300082,,,,0,3,3
HND-004400,2011,50300083,,,,2,2,4
HND-004403,2011,50300087,,,,11,6,17
,2011,50300089,,,,4,2,6
,2011,50300091,,,,2,7,9
,2011,50300095,,,,1,10,11
HND-004409,2011,50300096,,,,4,5,9
HND-004411,2011,50300098,,,,4,2,6
HND-004414,2011,50300104,,,,6,7,13
HND-004415,2011,50300105,,,,8,4,12
,2011,50300106,,,,4,3,7
HND-004420,2011,50300113,,,,5,3,8
HND-004423,2011,50300119,,,,3,1,4
,2011,50300121,,,,2,2,4
HND-004424,2011,50300122,,,,1,0,1
,2011,50300142,,,,6,6,12
,2011,50300154,,,,2,2,4
HND-004429,2011,50300163,,,,6,3,9
HND-004342,2011,50300004,,,,14,18,32
,2011,50300005,,,,1,2,3
HND-004343,2011,50300006,,,,11,4,15
HND-004344,2011,50300007,,,,12,11,23
HND-004347,2011,50300010,,,,11,10,21
HND-004348,2011,50300011,,,,0,1,1
HND-004351,2011,50300015,,,,1,4,5
,2011,50300016,,,,11,6,17
HND-004354,2011,50300018,,,,8,4,12
HND-004357,2011,50300021,,,,39,46,85
HND-004361,2011,50300025,,,,13,19,32
HND-004362,2011,50300026,,,,11,10,21
HND-004363,2011,50300027,,,,4,6,10
HND-004364,2011,50300028,,,,28,22,50
HND-004366,2011,50300030,,,,3,2,5
HND-004367,2011,50300031,,,,11,8,19
HND-004371,2011,50300035,,,,11,7,18
HND-004372,2011,50300036,,,,1,2,3
HND-004374,2011,50300038,,,,10,13,23
HND-004378,2011,50300044,,,,2,4,6
HND-004379,2011,50300045,,,,2,1,3
HND-004381,2011,50300048,,,,56,62,118
HND-004387,2011,50300062,,,,5,1,6
,2011,50300065,,,,5,4,9
HND-004390,2011,50300067,,,,0,2,2
HND-004393,2011,50300072,,,,3,2,5
HND-004394,2011,50300073,,,,1,4,5
,2011,50300074,,,,4,3,7
HND-004398,2011,50300081,,,,5,7,12
HND-004399,2011,50300082,,,,6,2,8
HND-004400,2011,50300083,,,,1,4,5
HND-004404,2011,50300088,,,,3,1,4
,2011,50300089,,,,5,3,8
HND-004408,2011,50300094,,,,18,15,33
HND-004409,2011,50300096,,,,4,2,6
HND-004410,2011,50300097,,,,1,2,3
HND-004414,2011,50300104,,,,5,5,10
HND-004423,2011,50300119,,,,1,0,1
,2011,50300142,,,,8,2,10
,2011,50300162,,,,6,4,10
HND-004339,2011,50300001,,,,5,2,7
HND-004341,2011,50300003,,,,16,8,24
HND-004345,2011,50300008,,,,9,8,17
HND-004346,2011,50300009,,,,11,18,29
,2011,50300012,,,,2,1,3
HND-004350,2011,50300014,,,,42,36,78
HND-004353,2011,50300017,,,,15,7,22
HND-004355,2011,50300019,,,,21,18,39
HND-004356,2011,50300020,,,,69,53,122
HND-004358,2011,50300022,,,,31,23,54
HND-004359,2011,50300023,,,,6,5,11
HND-004360,2011,50300024,,,,9,4,13
HND-004368,2011,50300032,,,,3,5,8
HND-004369,2011,50300033,,,,1,1,2
HND-004370,2011,50300034,,,,6,8,14
HND-004373,2011,50300037,,,,2,3,5
HND-004375,2011,50300039,,,,7,2,9
HND-004376,2011,50300042,,,,3,1,4
,2011,50300049,,,,1,1,2
HND-004388,2011,50300063,,,,2,1,3
HND-004391,2011,50300068,,,,3,5,8
HND-004392,2011,50300071,,,,4,4,8
HND-004396,2011,50300075,,,,1,0,1
HND-004397,2011,50300076,,,,3,2,5
HND-004401,2011,50300085,,,,4,3,7
HND-004402,2011,50300086,,,,2,1,3
HND-004403,2011,50300087,,,,5,10,15
,2011,50300091,,,,3,2,5
,2011,50300095,,,,2,3,5
HND-004411,2011,50300098,,,,3,0,3
HND-004412,2011,50300099,,,,12,5,17
HND-004415,2011,50300105,,,,5,7,12
,2011,50300106,,,,1,2,3
HND-004417,2011,50300108,,,,3,0,3
HND-004418,2011,50300111,,,,8,7,15
HND-004422,2011,50300116,,,,3,6,9
,2011,50300121,,,,2,1,3
HND-004424,2011,50300122,,,,0,1,1
HND-004429,2011,50300163,,,,8,8,16
HND-004339,2011,50300001,,,,8,2,10
HND-004341,2011,50300003,,,,10,20,30
HND-004342,2011,50300004,,,,16,28,44
HND-004346,2011,50300009,,,,17,8,25
HND-004350,2011,50300014,,,,38,34,72
HND-004351,2011,50300015,,,,3,0,3
,2011,50300016,,,,6,7,13
HND-004353,2011,50300017,,,,8,9,17
HND-004358,2011,50300022,,,,20,19,39
HND-004360,2011,50300024,,,,4,5,9
HND-004363,2011,50300027,,,,6,2,8
HND-004370,2011,50300034,,,,8,11,19
HND-004371,2011,50300035,,,,10,7,17
HND-004372,2011,50300036,,,,3,2,5
HND-004373,2011,50300037,,,,5,2,7
HND-004376,2011,50300042,,,,0,3,3
HND-004377,2011,50300043,,,,0,2,2
HND-004378,2011,50300044,,,,4,3,7
,2011,50300049,,,,1,1,2
HND-004387,2011,50300062,,,,2,2,4
HND-004388,2011,50300063,,,,4,2,6
HND-004392,2011,50300071,,,,7,4,11
HND-004394,2011,50300073,,,,6,4,10
HND-004396,2011,50300075,,,,2,2,4
HND-004398,2011,50300081,,,,3,3,6
HND-004401,2011,50300085,,,,4,4,8
HND-004402,2011,50300086,,,,2,2,4
HND-004403,2011,50300087,,,,9,4,13
HND-004404,2011,50300088,,,,4,1,5
HND-004407,2011,50300092,,,,1,3,4
HND-004408,2011,50300094,,,,14,22,36
HND-004412,2011,50300099,,,,1,17,18
HND-004415,2011,50300105,,,,5,3,8
,2011,50300106,,,,1,2,3
HND-004417,2011,50300108,,,,4,5,9
HND-004418,2011,50300111,,,,9,6,15
HND-004419,2011,50300112,,,,3,3,6
HND-004422,2011,50300116,,,,4,4,8
HND-004424,2011,50300122,,,,3,3,6
,2011,50300005,,,,0,2,2
HND-004343,2011,50300006,,,,7,8,15
HND-004344,2011,50300007,,,,21,10,31
HND-004345,2011,50300008,,,,6,4,10
HND-004347,2011,50300010,,,,17,8,25
HND-004348,2011,50300011,,,,3,3,6
,2011,50300012,,,,0,5,5
HND-004354,2011,50300018,,,,14,15,29
HND-004355,2011,50300019,,,,16,12,28
HND-004356,2011,50300020,,,,88,78,166
HND-004357,2011,50300021,,,,44,52,96
HND-004359,2011,50300023,,,,2,3,5
HND-004361,2011,50300025,,,,15,13,28
HND-004362,2011,50300026,,,,10,9,19
HND-004364,2011,50300028,,,,25,17,42
HND-004365,2011,50300029,,,,6,2,8
HND-004366,2011,50300030,,,,5,9,14
HND-004367,2011,50300031,,,,6,9,15
HND-004368,2011,50300032,,,,7,3,10
HND-004369,2011,50300033,,,,0,4,4
HND-004374,2011,50300038,,,,10,11,21
HND-004375,2011,50300039,,,,7,5,12
HND-004379,2011,50300045,,,,0,1,1
HND-004381,2011,50300048,,,,37,46,83
,2011,50300065,,,,0,1,1
HND-004390,2011,50300067,,,,1,2,3
HND-004391,2011,50300068,,,,4,1,5
HND-004393,2011,50300072,,,,1,2,3
,2011,50300074,,,,3,6,9
HND-004397,2011,50300076,,,,3,3,6
HND-004399,2011,50300082,,,,1,1,2
HND-004400,2011,50300083,,,,1,4,5
,2011,50300089,,,,2,3,5
,2011,50300091,,,,4,3,7
,2011,50300095,,,,1,8,9
HND-004409,2011,50300096,,,,1,6,7
HND-004410,2011,50300097,,,,2,1,3
HND-004411,2011,50300098,,,,2,1,3
HND-004414,2011,50300104,,,,4,2,6
HND-004420,2011,50300113,,,,6,0,6
HND-004423,2011,50300119,,,,2,2,4
,2011,50300121,,,,5,0,5
,2011,50300142,,,,16,3,19
,2011,50300162,,,,8,4,12
HND-004339,2011,50300001,,,,6,5,11
HND-004341,2011,50300003,,,,9,11,20
HND-004345,2011,50300008,,,,6,7,13
HND-004346,2011,50300009,,,,19,15,34
,2011,50300012,,,,3,2,5
HND-004350,2011,50300014,,,,47,32,79
HND-004351,2011,50300015,,,,3,2,5
,2011,50300016,,,,6,5,11
HND-004353,2011,50300017,,,,0,2,2
HND-004356,2011,50300020,,,,75,92,167
HND-004358,2011,50300022,,,,21,19,40
HND-004359,2011,50300023,,,,6,8,14
HND-004360,2011,50300024,,,,7,5,12
HND-004365,2011,50300029,,,,0,3,3
HND-004370,2011,50300034,,,,6,7,13
HND-004371,2011,50300035,,,,11,7,18
HND-004372,2011,50300036,,,,3,3,6
HND-004373,2011,50300037,,,,0,3,3
HND-004376,2011,50300042,,,,0,4,4
HND-004377,2011,50300043,,,,0,1,1
,2011,50300049,,,,0,1,1
HND-004387,2011,50300062,,,,4,4,8
HND-004388,2011,50300063,,,,2,4,6
HND-004391,2011,50300068,,,,6,3,9
HND-004392,2011,50300071,,,,4,6,10
HND-004396,2011,50300075,,,,1,1,2
HND-004401,2011,50300085,,,,7,4,11
HND-004402,2011,50300086,,,,0,3,3
HND-004403,2011,50300087,,,,8,1,9
HND-004404,2011,50300088,,,,2,3,5
,2011,50300091,,,,5,3,8
HND-004407,2011,50300092,,,,0,1,1
HND-004412,2011,50300099,,,,6,1,7
HND-004415,2011,50300105,,,,5,5,10
,2011,50300106,,,,2,0,2
HND-004417,2011,50300108,,,,2,4,6
HND-004418,2011,50300111,,,,3,7,10
HND-004422,2011,50300116,,,,4,0,4
HND-004424,2011,50300122,,,,1,1,2
,2011,50300142,,,,4,1,5
HND-004342,2011,50300004,,,,18,20,38
,2011,50300005,,,,0,1,1
HND-004343,2011,50300006,,,,5,7,12
HND-004344,2011,50300007,,,,12,15,27
HND-004347,2011,50300010,,,,13,15,28
HND-004348,2011,50300011,,,,3,4,7
HND-004354,2011,50300018,,,,13,9,22
HND-004355,2011,50300019,,,,21,12,33
HND-004357,2011,50300021,,,,48,56,104
HND-004361,2011,50300025,,,,20,16,36
HND-004362,2011,50300026,,,,9,12,21
HND-004363,2011,50300027,,,,5,7,12
HND-004364,2011,50300028,,,,22,23,45
HND-004366,2011,50300030,,,,6,11,17
HND-004367,2011,50300031,,,,10,11,21
HND-004368,2011,50300032,,,,3,2,5
HND-004369,2011,50300033,,,,3,3,6
HND-004374,2011,50300038,,,,14,14,28
HND-004375,2011,50300039,,,,2,5,7
HND-004378,2011,50300044,,,,1,0,1
HND-004379,2011,50300045,,,,1,1,2
HND-004381,2011,50300048,,,,48,66,114
,2011,50300065,,,,1,2,3
HND-004390,2011,50300067,,,,1,1,2
HND-004393,2011,50300072,,,,3,3,6
HND-004394,2011,50300073,,,,2,2,4
,2011,50300074,,,,2,5,7
,2011,50300080,,,,3,3,6
HND-004398,2011,50300081,,,,1,1,2
HND-004399,2011,50300082,,,,1,5,6
HND-004400,2011,50300083,,,,1,0,1
,2011,50300089,,,,4,2,6
HND-004408,2011,50300094,,,,23,15,38
,2011,50300095,,,,4,4,8
HND-004409,2011,50300096,,,,6,5,11
HND-004410,2011,50300097,,,,0,1,1
HND-004411,2011,50300098,,,,1,3,4
HND-004414,2011,50300104,,,,3,4,7
HND-004419,2011,50300112,,,,2,1,3
HND-004420,2011,50300113,,,,3,2,5
HND-004423,2011,50300119,,,,2,3,5
,2011,50300121,,,,2,1,3
,2011,50300162,,,,8,3,11
HND-004339,2011,50300001,,,,3,1,4
,2011,50300005,,,,2,4,6
HND-004343,2011,50300006,,,,12,6,18
HND-004344,2011,50300007,,,,10,12,22
HND-004345,2011,50300008,,,,3,8,11
HND-004347,2011,50300010,,,,17,8,25
,2011,50300012,,,,6,3,9
HND-004350,2011,50300014,,,,33,37,70
HND-004355,2011,50300019,,,,19,20,39
HND-004356,2011,50300020,,,,78,78,156
HND-004357,2011,50300021,,,,48,31,79
HND-004358,2011,50300022,,,,11,16,27
HND-004359,2011,50300023,,,,3,4,7
HND-004364,2011,50300028,,,,23,19,42
HND-004365,2011,50300029,,,,1,2,3
HND-004366,2011,50300030,,,,4,4,8
HND-004368,2011,50300032,,,,6,1,7
HND-004369,2011,50300033,,,,1,0,1
HND-004370,2011,50300034,,,,5,5,10
HND-004375,2011,50300039,,,,5,7,12
HND-004379,2011,50300045,,,,2,2,4
,2011,50300065,,,,2,0,2
HND-004390,2011,50300067,,,,1,3,4
HND-004391,2011,50300068,,,,2,2,4
,2011,50300074,,,,1,4,5
HND-004396,2011,50300075,,,,4,0,4
HND-004397,2011,50300076,,,,0,3,3
HND-004399,2011,50300082,,,,1,0,1
HND-004400,2011,50300083,,,,2,1,3
HND-004403,2011,50300087,,,,0,3,3
,2011,50300089,,,,1,3,4
,2011,50300091,,,,5,1,6
,2011,50300095,,,,3,0,3
HND-004409,2011,50300096,,,,1,2,3
HND-004411,2011,50300098,,,,0,3,3
HND-004414,2011,50300104,,,,5,1,6
HND-004415,2011,50300105,,,,4,2,6
,2011,50300106,,,,4,1,5
HND-004420,2011,50300113,,,,3,5,8
HND-004423,2011,50300119,,,,1,0,1
,2011,50300121,,,,0,3,3
HND-004424,2011,50300122,,,,0,2,2
HND-004341,2011,50300003,,,,11,17,28
HND-004342,2011,50300004,,,,14,18,32
HND-004346,2011,50300009,,,,21,12,33
HND-004348,2011,50300011,,,,1,2,3
HND-004351,2011,50300015,,,,0,3,3
,2011,50300016,,,,7,6,13
HND-004353,2011,50300017,,,,5,2,7
HND-004354,2011,50300018,,,,17,11,28
HND-004360,2011,50300024,,,,4,2,6
HND-004361,2011,50300025,,,,17,13,30
HND-004362,2011,50300026,,,,9,13,22
HND-004363,2011,50300027,,,,3,3,6
HND-004367,2011,50300031,,,,5,10,15
HND-004371,2011,50300035,,,,1,4,5
HND-004372,2011,50300036,,,,3,2,5
HND-004373,2011,50300037,,,,3,6,9
HND-004374,2011,50300038,,,,11,12,23
HND-004376,2011,50300042,,,,0,3,3
HND-004377,2011,50300043,,,,1,1,2
HND-004378,2011,50300044,,,,3,5,8
HND-004381,2011,50300048,,,,36,32,68
,2011,50300049,,,,1,1,2
HND-004387,2011,50300062,,,,2,0,2
HND-004388,2011,50300063,,,,1,1,2
HND-004392,2011,50300071,,,,2,2,4
HND-004393,2011,50300072,,,,1,2,3
HND-004394,2011,50300073,,,,2,6,8
,2011,50300080,,,,2,3,5
HND-004398,2011,50300081,,,,2,3,5
HND-004401,2011,50300085,,,,6,4,10
HND-004402,2011,50300086,,,,2,0,2
HND-004404,2011,50300088,,,,0,1,1
HND-004407,2011,50300092,,,,2,4,6
HND-004408,2011,50300094,,,,9,11,20
HND-004410,2011,50300097,,,,0,1,1
HND-004412,2011,50300099,,,,2,1,3
HND-004417,2011,50300108,,,,2,4,6
HND-004418,2011,50300111,,,,2,3,5
HND-004419,2011,50300112,,,,2,2,4
HND-004422,2011,50300116,,,,3,2,5
,2011,50300142,,,,2,2,4
,2011,50300162,,,,8,5,13
HND-004341,2011,50300003,,,,23,25,48
HND-004346,2011,50300009,,,,23,9,32
HND-004350,2011,50300014,,,,39,38,77
HND-004356,2011,50300020,,,,69,58,127
HND-004358,2011,50300022,,,,15,18,33
,2011,50300162,,,,2,5,7
HND-004343,2011,50300006,,,,15,15,30
HND-004344,2011,50300007,,,,20,30,50
HND-004347,2011,50300010,,,,21,18,39
HND-004357,2011,50300021,,,,35,47,82
HND-004361,2011,50300025,,,,23,28,51
HND-004362,2011,50300026,,,,10,11,21
HND-004364,2011,50300028,,,,16,30,46
HND-004374,2011,50300038,,,,16,24,40
,2011,50300093,,,,89,62,151
,2011,50300095,,,,2,3,5
,2011,50300120,,,,2,3,5
,2011,50300121,,,,4,2,6
HND-004341,2011,50300003,,,,7,16,23
HND-004346,2011,50300009,,,,11,12,23
HND-004361,2011,50300025,,,,17,26,43
HND-004362,2011,50300026,,,,8,11,19
HND-004374,2011,50300038,,,,20,14,34
,2011,50300120,,,,5,6,11
,2011,50300121,,,,4,1,5
HND-004343,2011,50300006,,,,11,17,28
HND-004344,2011,50300007,,,,17,12,29
HND-004347,2011,50300010,,,,14,6,20
HND-004350,2011,50300014,,,,22,39,61
HND-004356,2011,50300020,,,,49,56,105
HND-004357,2011,50300021,,,,21,28,49
HND-004358,2011,50300022,,,,10,10,20
HND-004364,2011,50300028,,,,14,17,31
,2011,50300093,,,,60,64,124
,2011,50300095,,,,2,2,4
,2011,50300162,,,,5,6,11
HND-004341,2011,50300003,,,,14,16,30
HND-004346,2011,50300009,,,,12,12,24
HND-004350,2011,50300014,,,,20,31,51
HND-004358,2011,50300022,,,,10,11,21
HND-004361,2011,50300025,,,,21,16,37
HND-004362,2011,50300026,,,,7,8,15
,2011,50300093,,,,55,50,105
,2011,50300095,,,,2,4,6
,2011,50300120,,,,1,11,12
,2011,50300121,,,,5,4,9
HND-004343,2011,50300006,,,,2,9,11
HND-004344,2011,50300007,,,,21,11,32
HND-004347,2011,50300010,,,,15,21,36
HND-004356,2011,50300020,,,,42,53,95
HND-004357,2011,50300021,,,,16,25,41
HND-004364,2011,50300028,,,,12,24,36
HND-004374,2011,50300038,,,,12,20,32
,2011,50300162,,,,2,4,6
,2011,50300121,,,,11,12,23
,2011,50300162,,,,7,23,30
,2011,50300093,,,,104,109,213
,2011,50300095,,,,4,3,7
,2011,50300120,,,,11,16,27
,2011,50300093,,,,85,101,186
,2011,50300120,,,,11,12,23
,2011,50300121,,,,6,9,15
,2011,50300162,,,,6,16,22
,2011,50300093,,,,60,87,147
,2011,50300121,,,,6,8,14
,2011,50300120,,,,8,6,14
HND-004450,2011,50400030,,,,2,3,5
,2011,50400015,,,,11,14,25
HND-004452,2011,50400036,,,,5,9,14
HND-004453,2011,50400037,,,,7,9,16
HND-004454,2011,50400039,,,,8,7,15
,2011,50400040,,,,11,3,14
HND-004446,2011,50400023,,,,2,2,4
HND-004438,2011,50400007,,,,0,1,1
HND-004442,2011,50400014,,,,0,2,2
HND-004444,2011,50400021,,,,8,8,16
HND-004445,2011,50400022,,,,5,4,9
HND-004446,2011,50400023,,,,4,1,5
HND-004439,2011,50400008,,,,4,6,10
HND-004451,2011,50400034,,,,2,7,9
,2011,50400035,,,,2,2,4
HND-004439,2011,50400008,,,,18,21,39
HND-004442,2011,50400014,,,,19,9,28
HND-004443,2011,50400016,,,,31,17,48
HND-004451,2011,50400034,,,,30,27,57
,2011,50400038,,,,7,5,12
HND-004438,2011,50400007,,,,28,36,64
HND-004444,2011,50400021,,,,6,13,19
HND-004445,2011,50400022,,,,20,14,34
HND-004446,2011,50400023,,,,3,4,7
,2011,50400035,,,,7,7,14
HND-004435,2011,50400004,,,,5,7,12
HND-004447,2011,50400024,,,,20,26,46
HND-004449,2011,50400029,,,,29,28,57
HND-004450,2011,50400030,,,,3,4,7
HND-004432,2011,50400001,,,,19,19,38
HND-004433,2011,50400002,,,,58,53,111
HND-004434,2011,50400003,,,,46,38,84
HND-004436,2011,50400005,,,,31,30,61
HND-004437,2011,50400006,,,,62,62,124
HND-004448,2011,50400028,,,,27,27,54
,2011,50400035,,,,7,7,14
,2011,50400038,,,,5,5,10
HND-004432,2011,50400001,,,,25,16,41
HND-004433,2011,50400002,,,,52,55,107
HND-004436,2011,50400005,,,,20,22,42
HND-004437,2011,50400006,,,,50,46,96
HND-004447,2011,50400024,,,,24,25,49
,2011,50400038,,,,2,3,5
HND-004434,2011,50400003,,,,37,48,85
HND-004435,2011,50400004,,,,7,2,9
HND-004448,2011,50400028,,,,27,29,56
HND-004449,2011,50400029,,,,30,24,54
HND-004450,2011,50400030,,,,1,1,2
,2011,50400035,,,,8,7,15
HND-004432,2011,50400001,,,,20,19,39
HND-004433,2011,50400002,,,,52,39,91
HND-004434,2011,50400003,,,,35,40,75
HND-004436,2011,50400005,,,,25,16,41
HND-004437,2011,50400006,,,,44,56,100
HND-004448,2011,50400028,,,,24,23,47
,2011,50400035,,,,6,7,13
HND-004435,2011,50400004,,,,8,6,14
HND-004447,2011,50400024,,,,26,27,53
HND-004449,2011,50400029,,,,39,39,78
HND-004450,2011,50400030,,,,3,3,6
HND-004433,2011,50400002,,,,52,50,102
HND-004435,2011,50400004,,,,3,4,7
HND-004436,2011,50400005,,,,33,15,48
HND-004437,2011,50400006,,,,57,48,105
HND-004447,2011,50400024,,,,29,19,48
HND-004449,2011,50400029,,,,20,35,55
HND-004432,2011,50400001,,,,24,20,44
HND-004434,2011,50400003,,,,51,36,87
HND-004448,2011,50400028,,,,25,25,50
HND-004450,2011,50400030,,,,2,1,3
HND-004435,2011,50400004,,,,9,9,18
HND-004436,2011,50400005,,,,23,27,50
HND-004437,2011,50400006,,,,49,51,100
HND-004447,2011,50400024,,,,25,20,45
HND-004449,2011,50400029,,,,32,29,61
HND-004450,2011,50400030,,,,2,4,6
HND-004432,2011,50400001,,,,21,12,33
HND-004433,2011,50400002,,,,58,48,106
HND-004434,2011,50400003,,,,49,43,92
HND-004448,2011,50400028,,,,18,30,48
HND-004434,2011,50400003,,,,42,34,76
HND-004435,2011,50400004,,,,8,10,18
HND-004448,2011,50400028,,,,15,18,33
HND-004449,2011,50400029,,,,25,25,50
HND-004432,2011,50400001,,,,21,22,43
HND-004433,2011,50400002,,,,42,43,85
HND-004436,2011,50400005,,,,22,21,43
HND-004437,2011,50400006,,,,53,55,108
HND-004447,2011,50400024,,,,21,17,38
HND-004435,2011,50400004,,,,19,15,34
HND-004440,2011,50400009,,,,124,93,217
HND-004441,2011,50400010,,,,61,41,102
HND-004440,2011,50400009,,,,82,93,175
HND-004441,2011,50400010,,,,39,42,81
HND-004440,2011,50400009,,,,55,72,127
HND-004441,2011,50400010,,,,19,25,44
HND-004441,2011,50400010,,,,10,12,22
HND-004440,2011,50400009,,,,17,44,61
HND-004440,2011,50400009,,,,13,32,45
HND-004441,2011,50400010,,,,9,13,22
HND-004441,2011,50400010,,,,12,16,28
HND-004440,2011,50400009,,,,11,27,38
HND-004486,2011,50500060,,,,2,4,6
HND-004488,2011,50500064,,,,9,6,15
HND-004476,2011,50500021,,,,5,1,6
HND-004479,2011,50500029,,,,0,1,1
HND-004484,2011,50500044,,,,2,2,4
,2011,50500065,,,,2,0,2
,2011,50500043,,,,0,1,1
,2011,50500051,,,,0,1,1
,2011,50500016,,,,4,0,4
,2011,50500020,,,,2,6,8
HND-004476,2011,50500021,,,,11,11,22
HND-004477,2011,50500024,,,,3,3,6
,2011,50500028,,,,1,1,2
HND-004481,2011,50500031,,,,6,4,10
,2011,50500043,,,,3,2,5
,2011,50500058,,,,0,6,6
HND-004487,2011,50500063,,,,3,5,8
HND-004475,2011,50500019,,,,17,20,37
HND-004479,2011,50500029,,,,1,1,2
HND-004480,2011,50500030,,,,3,6,9
HND-004482,2011,50500033,,,,2,3,5
,2011,50500035,,,,9,5,14
,2011,50500036,,,,3,1,4
HND-004484,2011,50500044,,,,4,3,7
,2011,50500065,,,,8,3,11
HND-004475,2011,50500019,,,,37,40,77
HND-004476,2011,50500021,,,,9,15,24
HND-004479,2011,50500029,,,,4,5,9
,2011,50500035,,,,15,8,23
,2011,50500036,,,,6,3,9
,2011,50500051,,,,1,1,2
,2011,50500065,,,,8,5,13
,2011,50500016,,,,9,8,17
,2011,50500020,,,,20,19,39
HND-004477,2011,50500024,,,,5,11,16
,2011,50500028,,,,12,9,21
HND-004480,2011,50500030,,,,17,23,40
HND-004481,2011,50500031,,,,17,16,33
HND-004482,2011,50500033,,,,20,9,29
,2011,50500043,,,,23,24,47
HND-004484,2011,50500044,,,,7,8,15
,2011,50500058,,,,0,4,4
HND-004487,2011,50500063,,,,22,19,41
HND-004458,2011,50500001,,,,62,57,119
HND-004461,2011,50500004,,,,1,0,1
HND-004462,2011,50500005,,,,20,20,40
HND-004463,2011,50500006,,,,25,21,46
HND-004464,2011,50500007,,,,7,4,11
HND-004468,2011,50500011,,,,18,15,33
HND-004471,2011,50500014,,,,9,14,23
HND-004472,2011,50500015,,,,4,3,7
,2011,50500016,,,,7,10,17
,2011,50500017,,,,5,5,10
HND-004478,2011,50500027,,,,5,6,11
,2011,50500050,,,,25,32,57
,2011,50500051,,,,1,1,2
HND-004486,2011,50500060,,,,5,3,8
,2011,50500062,,,,4,2,6
HND-004459,2011,50500002,,,,33,30,63
,2011,50500003,,,,12,18,30
HND-004465,2011,50500008,,,,9,16,25
HND-004466,2011,50500009,,,,3,6,9
HND-004467,2011,50500010,,,,22,17,39
HND-004469,2011,50500012,,,,7,17,24
HND-004470,2011,50500013,,,,12,12,24
HND-004474,2011,50500018,,,,4,9,13
,2011,50500065,,,,4,8,12
HND-004459,2011,50500002,,,,36,41,77
HND-004462,2011,50500005,,,,18,17,35
HND-004463,2011,50500006,,,,15,19,34
HND-004464,2011,50500007,,,,4,4,8
HND-004465,2011,50500008,,,,16,8,24
HND-004467,2011,50500010,,,,17,8,25
HND-004468,2011,50500011,,,,20,21,41
HND-004469,2011,50500012,,,,13,13,26
HND-004470,2011,50500013,,,,9,23,32
HND-004472,2011,50500015,,,,1,0,1
,2011,50500017,,,,3,5,8
HND-004474,2011,50500018,,,,3,9,12
,2011,50500050,,,,29,27,56
,2011,50500051,,,,3,1,4
HND-004486,2011,50500060,,,,2,4,6
,2011,50500062,,,,6,3,9
,2011,50500065,,,,3,5,8
HND-004458,2011,50500001,,,,74,40,114
,2011,50500003,,,,13,15,28
HND-004461,2011,50500004,,,,3,3,6
HND-004466,2011,50500009,,,,2,1,3
HND-004471,2011,50500014,,,,7,7,14
,2011,50500016,,,,8,8,16
HND-004478,2011,50500027,,,,2,1,3
HND-004459,2011,50500002,,,,36,24,60
,2011,50500003,,,,19,12,31
HND-004465,2011,50500008,,,,13,2,15
HND-004466,2011,50500009,,,,2,0,2
HND-004467,2011,50500010,,,,15,7,22
HND-004469,2011,50500012,,,,9,8,17
HND-004470,2011,50500013,,,,19,9,28
HND-004472,2011,50500015,,,,3,0,3
HND-004474,2011,50500018,,,,4,3,7
,2011,50500065,,,,3,1,4
HND-004458,2011,50500001,,,,53,49,102
HND-004461,2011,50500004,,,,1,0,1
HND-004462,2011,50500005,,,,19,17,36
HND-004463,2011,50500006,,,,16,11,27
HND-004464,2011,50500007,,,,3,1,4
HND-004468,2011,50500011,,,,21,26,47
HND-004471,2011,50500014,,,,13,18,31
,2011,50500016,,,,9,4,13
,2011,50500017,,,,6,10,16
HND-004478,2011,50500027,,,,8,5,13
,2011,50500050,,,,26,21,47
,2011,50500051,,,,4,1,5
HND-004486,2011,50500060,,,,4,3,7
,2011,50500062,,,,5,3,8
HND-004458,2011,50500001,,,,51,64,115
HND-004459,2011,50500002,,,,28,25,53
HND-004462,2011,50500005,,,,16,17,33
HND-004463,2011,50500006,,,,25,19,44
HND-004464,2011,50500007,,,,2,2,4
HND-004465,2011,50500008,,,,6,8,14
HND-004467,2011,50500010,,,,23,11,34
HND-004468,2011,50500011,,,,18,15,33
HND-004469,2011,50500012,,,,11,10,21
HND-004470,2011,50500013,,,,18,28,46
HND-004471,2011,50500014,,,,6,8,14
HND-004472,2011,50500015,,,,3,2,5
,2011,50500016,,,,8,10,18
,2011,50500017,,,,4,9,13
HND-004474,2011,50500018,,,,3,5,8
,2011,50500050,,,,30,23,53
,2011,50500051,,,,1,1,2
HND-004486,2011,50500060,,,,4,2,6
,2011,50500062,,,,5,1,6
,2011,50500003,,,,12,14,26
HND-004461,2011,50500004,,,,0,1,1
HND-004466,2011,50500009,,,,4,3,7
HND-004478,2011,50500027,,,,1,4,5
HND-004458,2011,50500001,,,,58,57,115
HND-004459,2011,50500002,,,,39,38,77
HND-004461,2011,50500004,,,,4,2,6
HND-004462,2011,50500005,,,,13,14,27
HND-004463,2011,50500006,,,,23,24,47
HND-004464,2011,50500007,,,,2,2,4
HND-004467,2011,50500010,,,,22,11,33
HND-004468,2011,50500011,,,,26,19,45
HND-004470,2011,50500013,,,,22,20,42
HND-004471,2011,50500014,,,,8,5,13
HND-004472,2011,50500015,,,,4,0,4
,2011,50500016,,,,7,9,16
,2011,50500017,,,,9,5,14
HND-004478,2011,50500027,,,,9,4,13
,2011,50500050,,,,19,25,44
,2011,50500051,,,,5,2,7
HND-004486,2011,50500060,,,,1,1,2
,2011,50500062,,,,3,2,5
,2011,50500003,,,,12,19,31
HND-004465,2011,50500008,,,,12,8,20
HND-004466,2011,50500009,,,,6,6,12
HND-004469,2011,50500012,,,,20,7,27
HND-004474,2011,50500018,,,,5,2,7
HND-004459,2011,50500002,,,,34,29,63
HND-004462,2011,50500005,,,,15,4,19
HND-004463,2011,50500006,,,,11,24,35
HND-004464,2011,50500007,,,,1,0,1
HND-004465,2011,50500008,,,,7,9,16
HND-004467,2011,50500010,,,,26,21,47
HND-004468,2011,50500011,,,,17,17,34
HND-004469,2011,50500012,,,,11,6,17
HND-004472,2011,50500015,,,,3,2,5
,2011,50500017,,,,3,5,8
HND-004474,2011,50500018,,,,4,3,7
HND-004486,2011,50500060,,,,5,3,8
,2011,50500062,,,,0,1,1
HND-004458,2011,50500001,,,,56,66,122
,2011,50500003,,,,13,16,29
HND-004461,2011,50500004,,,,0,2,2
HND-004466,2011,50500009,,,,4,1,5
HND-004471,2011,50500014,,,,5,9,14
,2011,50500016,,,,8,8,16
HND-004478,2011,50500027,,,,3,2,5
,2011,50500050,,,,23,11,34
,2011,50500051,,,,0,1,1
HND-004463,2011,50500006,,,,24,30,54
,2011,50500003,,,,24,11,35
HND-004465,2011,50500008,,,,12,13,25
,2011,50500016,,,,22,19,41
,2011,50500022,,,,165,183,348
,2011,50500051,,,,14,7,21
HND-004463,2011,50500006,,,,11,14,25
HND-004465,2011,50500008,,,,10,9,19
,2011,50500016,,,,11,12,23
,2011,50500022,,,,129,135,264
,2011,50500051,,,,7,17,24
,2011,50500003,,,,16,11,27
HND-004463,2011,50500006,,,,11,16,27
HND-004465,2011,50500008,,,,14,11,25
,2011,50500016,,,,14,10,24
,2011,50500051,,,,9,8,17
,2011,50500003,,,,13,10,23
,2011,50500022,,,,83,83,166
,2011,50500016,,,,2,8,10
,2011,50500022,,,,54,90,144
,2011,50500051,,,,5,8,13
,2011,50500022,,,,18,87,105
,2011,50500051,,,,2,1,3
,2011,50500022,,,,25,45,70
HND-004543,2011,50600068,,,,7,6,13
,2011,50600188,,,,5,8,13
,2011,50600229,,,,7,6,13
HND-004602,2011,50600230,,,,8,4,12
,2011,50600231,,,,5,5,10
HND-004603,2011,50600232,,,,10,4,14
,2011,50600241,,,,13,17,30
HND-004605,2011,50600242,,,,10,6,16
HND-004607,2011,50600246,,,,5,3,8
,2011,50600022,,,,3,2,5
HND-004591,2011,50600158,,,,5,14,19
,2011,50600174,,,,5,5,10
HND-004600,2011,50600225,,,,11,12,23
HND-004601,2011,50600226,,,,14,10,24
,2011,50600227,,,,4,2,6
,2011,50600237,,,,4,8,12
,2011,50600238,,,,8,4,12
HND-004608,2011,50600247,,,,13,12,25
HND-004520,2011,50600037,,,,5,5,10
HND-004545,2011,50600070,,,,4,5,9
HND-004571,2011,50600116,,,,0,2,2
,2011,50600129,,,,9,9,18
HND-004585,2011,50600145,,,,1,2,3
,2011,50600161,,,,0,1,1
,2011,50600166,,,,4,4,8
,2011,50600207,,,,2,3,5
HND-004562,2011,50600099,,,,1,2,3
,2011,50600140,,,,1,3,4
,2011,50600149,,,,2,1,3
HND-004598,2011,50600223,,,,3,4,7
HND-004504,2011,50600019,,,,9,12,21
HND-004519,2011,50600035,,,,3,3,6
HND-004520,2011,50600037,,,,5,10,15
HND-004520,2011,50600037,,,,1,1,2
,2011,50600054,,,,1,1,2
HND-004541,2011,50600066,,,,45,35,80
HND-004545,2011,50600070,,,,4,3,7
HND-004546,2011,50600071,,,,12,13,25
HND-004547,2011,50600072,,,,25,20,45
HND-004548,2011,50600073,,,,18,18,36
HND-004551,2011,50600077,,,,6,7,13
HND-004553,2011,50600083,,,,15,23,38
HND-004557,2011,50600092,,,,3,5,8
HND-004562,2011,50600099,,,,9,8,17
,2011,50600109,,,,2,5,7
HND-004576,2011,50600125,,,,0,3,3
,2011,50600129,,,,24,10,34
HND-004584,2011,50600143,,,,12,6,18
,2011,50600148,,,,4,8,12
,2011,50600149,,,,11,6,17
,2011,50600161,,,,3,2,5
HND-004593,2011,50600162,,,,2,3,5
,2011,50600166,,,,4,3,7
,2011,50600206,,,,4,3,7
,2011,50600220,,,,2,2,4
HND-004597,2011,50600221,,,,6,2,8
HND-004598,2011,50600223,,,,3,12,15
,2011,50600236,,,,2,3,5
,2011,50600243,,,,14,16,30
,2011,50600005,,,,3,2,5
HND-004498,2011,50600011,,,,8,4,12
HND-004511,2011,50600026,,,,4,4,8
HND-004522,2011,50600039,,,,1,2,3
HND-004542,2011,50600067,,,,5,3,8
HND-004550,2011,50600075,,,,5,9,14
,2011,50600076,,,,1,0,1
HND-004552,2011,50600082,,,,15,15,30
HND-004554,2011,50600084,,,,4,2,6
HND-004555,2011,50600085,,,,10,7,17
HND-004556,2011,50600087,,,,3,1,4
HND-004558,2011,50600094,,,,9,2,11
HND-004559,2011,50600095,,,,0,2,2
HND-004560,2011,50600096,,,,3,3,6
HND-004561,2011,50600097,,,,4,3,7
HND-004564,2011,50600101,,,,4,8,12
,2011,50600103,,,,5,7,12
HND-004566,2011,50600106,,,,1,2,3
HND-004571,2011,50600116,,,,2,0,2
,2011,50600121,,,,9,11,20
HND-004581,2011,50600139,,,,2,1,3
,2011,50600140,,,,4,5,9
HND-004585,2011,50600145,,,,5,4,9
,2011,50600146,,,,2,0,2
,2011,50600156,,,,2,6,8
,2011,50600164,,,,12,17,29
,2011,50600172,,,,1,1,2
,2011,50600207,,,,10,5,15
HND-004599,2011,50600224,,,,5,11,16
,2011,50600245,,,,5,5,10
HND-004490,2011,50600002,,,,14,20,34
,2011,50600005,,,,9,7,16
HND-004498,2011,50600011,,,,27,19,46
HND-004500,2011,50600013,,,,13,20,33
HND-004504,2011,50600019,,,,28,39,67
HND-004517,2011,50600032,,,,9,9,18
HND-004520,2011,50600037,,,,5,4,9
HND-004521,2011,50600038,,,,32,38,70
HND-004522,2011,50600039,,,,13,8,21
HND-004542,2011,50600067,,,,11,9,20
HND-004545,2011,50600070,,,,9,10,19
HND-004546,2011,50600071,,,,8,10,18
HND-004549,2011,50600074,,,,19,20,39
HND-004550,2011,50600075,,,,16,23,39
,2011,50600079,,,,7,13,20
HND-004552,2011,50600082,,,,14,10,24
HND-004554,2011,50600084,,,,14,12,26
HND-004555,2011,50600085,,,,26,18,44
HND-004556,2011,50600087,,,,24,24,48
HND-004557,2011,50600092,,,,7,5,12
HND-004558,2011,50600094,,,,8,3,11
HND-004560,2011,50600096,,,,14,10,24
HND-004561,2011,50600097,,,,14,15,29
HND-004563,2011,50600100,,,,14,7,21
HND-004564,2011,50600101,,,,15,15,30
HND-004565,2011,50600102,,,,13,7,20
,2011,50600103,,,,4,4,8
HND-004566,2011,50600106,,,,7,9,16
HND-004571,2011,50600116,,,,10,6,16
,2011,50600121,,,,16,27,43
,2011,50600129,,,,36,18,54
,2011,50600138,,,,27,29,56
,2011,50600140,,,,18,13,31
HND-004585,2011,50600145,,,,3,1,4
,2011,50600146,,,,10,9,19
,2011,50600156,,,,10,8,18
,2011,50600164,,,,34,31,65
,2011,50600172,,,,8,6,14
,2011,50600206,,,,13,9,22
,2011,50600207,,,,18,18,36
,2011,50600220,,,,5,8,13
HND-004597,2011,50600221,,,,17,14,31
HND-004598,2011,50600223,,,,13,9,22
,2011,50600245,,,,2,11,13
HND-004511,2011,50600026,,,,7,3,10
HND-004519,2011,50600035,,,,3,6,9
HND-004520,2011,50600037,,,,24,14,38
,2011,50600054,,,,4,4,8
,2011,50600063,,,,8,1,9
,2011,50600064,,,,15,13,28
HND-004547,2011,50600072,,,,50,56,106
HND-004548,2011,50600073,,,,76,60,136
,2011,50600076,,,,7,4,11
HND-004551,2011,50600077,,,,13,16,29
HND-004553,2011,50600083,,,,28,37,65
,2011,50600090,,,,12,8,20
HND-004559,2011,50600095,,,,7,4,11
,2011,50600109,,,,10,10,20
HND-004568,2011,50600113,,,,19,21,40
HND-004573,2011,50600118,,,,3,3,6
HND-004576,2011,50600125,,,,5,9,14
HND-004581,2011,50600139,,,,5,12,17
HND-004584,2011,50600143,,,,32,22,54
,2011,50600148,,,,5,9,14
,2011,50600149,,,,8,12,20
HND-004587,2011,50600150,,,,9,13,22
HND-004588,2011,50600151,,,,15,10,25
,2011,50600153,,,,1,1,2
,2011,50600161,,,,7,7,14
HND-004593,2011,50600162,,,,11,12,23
,2011,50600166,,,,5,5,10
,2011,50600169,,,,3,6,9
,2011,50600218,,,,6,2,8
HND-004599,2011,50600224,,,,3,7,10
,2011,50600236,,,,4,6,10
HND-004604,2011,50600239,,,,10,10,20
HND-004489,2011,50600001,,,,9,3,12
HND-004490,2011,50600002,,,,43,27,70
HND-004491,2011,50600003,,,,0,3,3
HND-004493,2011,50600006,,,,50,28,78
HND-004499,2011,50600012,,,,53,45,98
HND-004500,2011,50600013,,,,31,30,61
HND-004503,2011,50600018,,,,36,54,90
HND-004504,2011,50600019,,,,44,62,106
,2011,50600020,,,,35,25,60
,2011,50600022,,,,4,2,6
HND-004508,2011,50600023,,,,5,5,10
HND-004510,2011,50600025,,,,22,16,38
HND-004513,2011,50600028,,,,15,20,35
HND-004514,2011,50600029,,,,12,9,21
HND-004516,2011,50600031,,,,23,22,45
HND-004519,2011,50600035,,,,6,11,17
HND-004520,2011,50600037,,,,35,31,66
HND-004521,2011,50600038,,,,46,33,79
HND-004523,2011,50600040,,,,26,36,62
HND-004525,2011,50600042,,,,13,10,23
HND-004526,2011,50600043,,,,28,15,43
HND-004527,2011,50600044,,,,4,4,8
HND-004532,2011,50600049,,,,19,15,34
HND-004533,2011,50600050,,,,11,15,26
HND-004536,2011,50600055,,,,1,2,3
HND-004537,2011,50600056,,,,33,27,60
HND-004538,2011,50600057,,,,5,1,6
HND-004539,2011,50600060,,,,20,9,29
,2011,50600064,,,,18,14,32
HND-004541,2011,50600066,,,,28,31,59
HND-004545,2011,50600070,,,,74,50,124
,2011,50600109,,,,9,14,23
HND-004569,2011,50600114,,,,10,7,17
HND-004576,2011,50600125,,,,5,2,7
HND-004577,2011,50600126,,,,4,2,6
HND-004589,2011,50600152,,,,0,4,4
,2011,50600153,,,,6,4,10
,2011,50600159,,,,1,2,3
HND-004592,2011,50600160,,,,13,7,20
,2011,50600169,,,,13,6,19
HND-004594,2011,50600205,,,,8,13,21
HND-004595,2011,50600208,,,,11,9,20
HND-004596,2011,50600219,,,,11,13,24
,2011,50600240,,,,8,4,12
,2011,50600243,,,,11,12,23
,2011,50600248,,,,1,1,2
HND-004492,2011,50600004,,,,24,19,43
,2011,50600005,,,,1,4,5
HND-004494,2011,50600007,,,,12,8,20
HND-004495,2011,50600008,,,,31,23,54
,2011,50600009,,,,56,41,97
HND-004497,2011,50600010,,,,67,66,133
HND-004498,2011,50600011,,,,26,33,59
HND-004501,2011,50600015,,,,2,1,3
HND-004502,2011,50600017,,,,22,16,38
HND-004506,2011,50600021,,,,46,26,72
HND-004509,2011,50600024,,,,14,14,28
HND-004511,2011,50600026,,,,14,8,22
HND-004512,2011,50600027,,,,31,25,56
HND-004515,2011,50600030,,,,11,15,26
HND-004517,2011,50600032,,,,17,8,25
HND-004518,2011,50600034,,,,14,11,25
HND-004522,2011,50600039,,,,24,20,44
HND-004524,2011,50600041,,,,14,10,24
HND-004528,2011,50600045,,,,15,10,25
HND-004529,2011,50600046,,,,16,15,31
HND-004530,2011,50600047,,,,14,10,24
HND-004531,2011,50600048,,,,4,5,9
HND-004534,2011,50600051,,,,8,6,14
HND-004535,2011,50600052,,,,5,4,9
,2011,50600053,,,,2,2,4
,2011,50600054,,,,5,9,14
HND-004540,2011,50600062,,,,5,3,8
,2011,50600063,,,,6,6,12
HND-004542,2011,50600067,,,,16,19,35
HND-004543,2011,50600068,,,,7,9,16
HND-004544,2011,50600069,,,,30,27,57
,2011,50600076,,,,8,13,21
,2011,50600079,,,,3,9,12
,2011,50600081,,,,6,9,15
HND-004567,2011,50600108,,,,15,10,25
HND-004570,2011,50600115,,,,9,10,19
HND-004574,2011,50600119,,,,15,15,30
,2011,50600121,,,,14,26,40
HND-004575,2011,50600124,,,,10,8,18
HND-004578,2011,50600127,,,,16,7,23
HND-004579,2011,50600128,,,,8,1,9
,2011,50600140,,,,14,14,28
HND-004582,2011,50600141,,,,11,8,19
HND-004583,2011,50600142,,,,10,10,20
HND-004585,2011,50600145,,,,13,10,23
HND-004590,2011,50600155,,,,15,16,31
,2011,50600156,,,,7,14,21
,2011,50600164,,,,20,20,40
,2011,50600168,,,,3,5,8
,2011,50600207,,,,15,15,30
,2011,50600218,,,,5,4,9
,2011,50600220,,,,4,9,13
HND-004597,2011,50600221,,,,6,12,18
,2011,50600236,,,,4,5,9
HND-004604,2011,50600239,,,,7,5,12
HND-004606,2011,50600244,,,,13,5,18
HND-004490,2011,50600002,,,,30,35,65
HND-004492,2011,50600004,,,,17,15,32
,2011,50600005,,,,6,6,12
HND-004493,2011,50600006,,,,45,47,92
HND-004494,2011,50600007,,,,10,12,22
HND-004495,2011,50600008,,,,31,19,50
HND-004498,2011,50600011,,,,23,20,43
HND-004500,2011,50600013,,,,24,34,58
HND-004502,2011,50600017,,,,8,12,20
HND-004504,2011,50600019,,,,55,52,107
HND-004506,2011,50600021,,,,37,27,64
,2011,50600022,,,,1,0,1
HND-004509,2011,50600024,,,,16,12,28
HND-004510,2011,50600025,,,,18,16,34
HND-004512,2011,50600027,,,,25,18,43
HND-004514,2011,50600029,,,,4,7,11
HND-004515,2011,50600030,,,,20,11,31
HND-004516,2011,50600031,,,,27,16,43
HND-004517,2011,50600032,,,,7,9,16
HND-004521,2011,50600038,,,,52,38,90
HND-004522,2011,50600039,,,,16,26,42
HND-004527,2011,50600044,,,,3,2,5
HND-004528,2011,50600045,,,,12,13,25
HND-004529,2011,50600046,,,,12,7,19
HND-004530,2011,50600047,,,,9,19,28
HND-004533,2011,50600050,,,,19,11,30
HND-004534,2011,50600051,,,,7,5,12
,2011,50600053,,,,2,4,6
HND-004536,2011,50600055,,,,4,7,11
HND-004537,2011,50600056,,,,26,28,54
HND-004538,2011,50600057,,,,3,1,4
HND-004540,2011,50600062,,,,2,1,3
HND-004541,2011,50600066,,,,62,42,104
HND-004542,2011,50600067,,,,22,9,31
HND-004544,2011,50600069,,,,16,29,45
,2011,50600079,,,,11,9,20
HND-004567,2011,50600108,,,,13,5,18
HND-004569,2011,50600114,,,,10,7,17
HND-004570,2011,50600115,,,,7,3,10
HND-004574,2011,50600119,,,,10,15,25
,2011,50600121,,,,27,16,43
HND-004575,2011,50600124,,,,7,8,15
,2011,50600140,,,,15,13,28
HND-004582,2011,50600141,,,,7,7,14
HND-004585,2011,50600145,,,,8,7,15
,2011,50600156,,,,10,10,20
,2011,50600159,,,,1,1,2
,2011,50600164,,,,18,21,39
HND-004594,2011,50600205,,,,8,9,17
HND-004596,2011,50600219,,,,8,6,14
,2011,50600220,,,,3,6,9
HND-004597,2011,50600221,,,,9,9,18
,2011,50600243,,,,19,8,27
HND-004489,2011,50600001,,,,8,2,10
HND-004491,2011,50600003,,,,4,0,4
,2011,50600009,,,,37,26,63
HND-004497,2011,50600010,,,,65,61,126
HND-004499,2011,50600012,,,,30,44,74
HND-004501,2011,50600015,,,,3,1,4
HND-004503,2011,50600018,,,,53,45,98
,2011,50600020,,,,27,11,38
HND-004508,2011,50600023,,,,10,6,16
HND-004511,2011,50600026,,,,13,13,26
HND-004513,2011,50600028,,,,15,8,23
HND-004518,2011,50600034,,,,8,5,13
HND-004519,2011,50600035,,,,12,12,24
HND-004520,2011,50600037,,,,26,21,47
HND-004523,2011,50600040,,,,31,28,59
HND-004524,2011,50600041,,,,6,12,18
HND-004525,2011,50600042,,,,10,9,19
HND-004526,2011,50600043,,,,17,21,38
HND-004531,2011,50600048,,,,8,5,13
HND-004532,2011,50600049,,,,18,10,28
HND-004535,2011,50600052,,,,7,5,12
,2011,50600054,,,,2,5,7
HND-004539,2011,50600060,,,,14,13,27
,2011,50600063,,,,9,11,20
,2011,50600064,,,,18,13,31
HND-004543,2011,50600068,,,,14,10,24
HND-004545,2011,50600070,,,,54,39,93
,2011,50600076,,,,9,4,13
,2011,50600081,,,,11,6,17
,2011,50600109,,,,6,15,21
HND-004576,2011,50600125,,,,1,3,4
HND-004577,2011,50600126,,,,2,3,5
HND-004578,2011,50600127,,,,9,8,17
HND-004579,2011,50600128,,,,6,2,8
HND-004583,2011,50600142,,,,11,11,22
HND-004589,2011,50600152,,,,2,0,2
,2011,50600153,,,,4,1,5
HND-004590,2011,50600155,,,,6,6,12
HND-004592,2011,50600160,,,,13,17,30
,2011,50600168,,,,1,1,2
,2011,50600169,,,,12,16,28
,2011,50600207,,,,9,19,28
HND-004595,2011,50600208,,,,10,8,18
,2011,50600218,,,,5,1,6
,2011,50600236,,,,3,3,6
HND-004604,2011,50600239,,,,11,7,18
,2011,50600248,,,,0,1,1
HND-004492,2011,50600004,,,,16,12,28
,2011,50600005,,,,8,4,12
HND-004494,2011,50600007,,,,12,10,22
HND-004495,2011,50600008,,,,30,26,56
,2011,50600009,,,,53,45,98
HND-004497,2011,50600010,,,,53,50,103
HND-004498,2011,50600011,,,,26,32,58
HND-004501,2011,50600015,,,,2,0,2
HND-004502,2011,50600017,,,,18,21,39
HND-004506,2011,50600021,,,,36,54,90
HND-004509,2011,50600024,,,,11,17,28
HND-004510,2011,50600025,,,,16,14,30
HND-004511,2011,50600026,,,,13,7,20
HND-004512,2011,50600027,,,,35,30,65
HND-004515,2011,50600030,,,,9,13,22
HND-004517,2011,50600032,,,,14,10,24
HND-004518,2011,50600034,,,,7,5,12
HND-004522,2011,50600039,,,,17,21,38
HND-004524,2011,50600041,,,,17,10,27
HND-004528,2011,50600045,,,,14,10,24
HND-004529,2011,50600046,,,,12,9,21
HND-004530,2011,50600047,,,,14,16,30
HND-004531,2011,50600048,,,,3,7,10
HND-004534,2011,50600051,,,,8,6,14
HND-004535,2011,50600052,,,,5,6,11
,2011,50600053,,,,1,2,3
,2011,50600054,,,,9,7,16
,2011,50600063,,,,7,5,12
HND-004542,2011,50600067,,,,16,17,33
HND-004543,2011,50600068,,,,10,12,22
HND-004544,2011,50600069,,,,32,27,59
,2011,50600076,,,,6,11,17
,2011,50600079,,,,8,6,14
,2011,50600081,,,,5,8,13
HND-004567,2011,50600108,,,,7,6,13
HND-004570,2011,50600115,,,,4,5,9
HND-004574,2011,50600119,,,,7,7,14
,2011,50600121,,,,32,28,60
HND-004575,2011,50600124,,,,10,7,17
HND-004578,2011,50600127,,,,8,7,15
HND-004579,2011,50600128,,,,5,6,11
,2011,50600140,,,,14,6,20
HND-004582,2011,50600141,,,,11,5,16
HND-004583,2011,50600142,,,,9,11,20
HND-004585,2011,50600145,,,,6,9,15
HND-004590,2011,50600155,,,,13,7,20
,2011,50600156,,,,11,9,20
,2011,50600164,,,,16,23,39
HND-004594,2011,50600205,,,,10,12,22
,2011,50600218,,,,4,5,9
HND-004597,2011,50600221,,,,4,6,10
,2011,50600235,,,,1,0,1
,2011,50600236,,,,5,2,7
HND-004604,2011,50600239,,,,14,11,25
HND-004489,2011,50600001,,,,4,6,10
HND-004490,2011,50600002,,,,28,32,60
HND-004491,2011,50600003,,,,4,1,5
HND-004493,2011,50600006,,,,48,37,85
HND-004499,2011,50600012,,,,45,36,81
HND-004500,2011,50600013,,,,17,27,44
HND-004503,2011,50600018,,,,43,35,78
HND-004504,2011,50600019,,,,44,53,97
,2011,50600020,,,,33,32,65
,2011,50600022,,,,3,5,8
HND-004508,2011,50600023,,,,13,10,23
HND-004513,2011,50600028,,,,22,22,44
HND-004514,2011,50600029,,,,8,6,14
HND-004516,2011,50600031,,,,21,16,37
HND-004519,2011,50600035,,,,9,6,15
HND-004520,2011,50600037,,,,31,31,62
HND-004521,2011,50600038,,,,47,56,103
HND-004523,2011,50600040,,,,33,31,64
HND-004525,2011,50600042,,,,6,5,11
HND-004526,2011,50600043,,,,10,10,20
HND-004527,2011,50600044,,,,1,1,2
HND-004532,2011,50600049,,,,18,19,37
HND-004533,2011,50600050,,,,14,12,26
HND-004536,2011,50600055,,,,3,4,7
HND-004537,2011,50600056,,,,25,24,49
HND-004538,2011,50600057,,,,3,3,6
HND-004539,2011,50600060,,,,8,7,15
,2011,50600064,,,,28,23,51
HND-004541,2011,50600066,,,,57,43,100
HND-004545,2011,50600070,,,,58,51,109
,2011,50600109,,,,17,4,21
HND-004569,2011,50600114,,,,6,6,12
HND-004576,2011,50600125,,,,10,0,10
HND-004577,2011,50600126,,,,1,0,1
HND-004589,2011,50600152,,,,2,0,2
,2011,50600153,,,,3,2,5
,2011,50600159,,,,0,1,1
HND-004592,2011,50600160,,,,13,13,26
,2011,50600168,,,,2,0,2
,2011,50600169,,,,15,13,28
,2011,50600207,,,,10,12,22
HND-004595,2011,50600208,,,,6,6,12
HND-004596,2011,50600219,,,,15,14,29
,2011,50600220,,,,8,3,11
,2011,50600248,,,,2,2,4
HND-004490,2011,50600002,,,,39,31,70
HND-004491,2011,50600003,,,,2,1,3
HND-004492,2011,50600004,,,,14,13,27
,2011,50600005,,,,14,4,18
HND-004493,2011,50600006,,,,39,29,68
HND-004495,2011,50600008,,,,32,34,66
HND-004500,2011,50600013,,,,24,26,50
HND-004504,2011,50600019,,,,46,51,97
,2011,50600020,,,,34,24,58
,2011,50600022,,,,4,1,5
HND-004508,2011,50600023,,,,11,10,21
HND-004509,2011,50600024,,,,14,11,25
HND-004510,2011,50600025,,,,25,14,39
HND-004514,2011,50600029,,,,10,12,22
HND-004515,2011,50600030,,,,8,13,21
HND-004516,2011,50600031,,,,29,27,56
HND-004519,2011,50600035,,,,12,5,17
HND-004521,2011,50600038,,,,49,36,85
HND-004525,2011,50600042,,,,11,3,14
HND-004528,2011,50600045,,,,6,8,14
HND-004529,2011,50600046,,,,7,7,14
HND-004530,2011,50600047,,,,17,18,35
HND-004533,2011,50600050,,,,17,13,30
HND-004534,2011,50600051,,,,12,5,17
,2011,50600053,,,,4,6,10
HND-004536,2011,50600055,,,,4,0,4
HND-004537,2011,50600056,,,,23,20,43
HND-004538,2011,50600057,,,,1,1,2
HND-004540,2011,50600062,,,,5,3,8
HND-004541,2011,50600066,,,,56,39,95
HND-004542,2011,50600067,,,,19,23,42
,2011,50600079,,,,10,10,20
,2011,50600109,,,,12,7,19
HND-004569,2011,50600114,,,,4,8,12
HND-004570,2011,50600115,,,,8,4,12
,2011,50600121,,,,26,26,52
,2011,50600140,,,,6,19,25
HND-004582,2011,50600141,,,,6,9,15
,2011,50600156,,,,11,10,21
,2011,50600164,,,,12,15,27
,2011,50600169,,,,18,13,31
HND-004594,2011,50600205,,,,5,16,21
,2011,50600207,,,,9,9,18
,2011,50600218,,,,4,7,11
,2011,50600220,,,,1,3,4
HND-004597,2011,50600221,,,,4,10,14
HND-004489,2011,50600001,,,,5,9,14
HND-004494,2011,50600007,,,,13,17,30
,2011,50600009,,,,47,50,97
HND-004497,2011,50600010,,,,56,65,121
HND-004498,2011,50600011,,,,27,28,55
HND-004499,2011,50600012,,,,43,33,76
HND-004501,2011,50600015,,,,1,2,3
HND-004502,2011,50600017,,,,21,14,35
HND-004503,2011,50600018,,,,45,48,93
HND-004506,2011,50600021,,,,49,43,92
HND-004511,2011,50600026,,,,14,9,23
HND-004512,2011,50600027,,,,31,20,51
HND-004513,2011,50600028,,,,25,27,52
HND-004517,2011,50600032,,,,5,10,15
HND-004518,2011,50600034,,,,9,6,15
HND-004520,2011,50600037,,,,24,18,42
HND-004522,2011,50600039,,,,30,21,51
HND-004523,2011,50600040,,,,30,23,53
HND-004524,2011,50600041,,,,13,8,21
HND-004526,2011,50600043,,,,25,22,47
HND-004531,2011,50600048,,,,7,4,11
HND-004532,2011,50600049,,,,27,20,47
HND-004535,2011,50600052,,,,6,4,10
,2011,50600054,,,,8,6,14
HND-004539,2011,50600060,,,,24,12,36
,2011,50600063,,,,6,12,18
,2011,50600064,,,,16,21,37
HND-004543,2011,50600068,,,,6,11,17
HND-004544,2011,50600069,,,,26,31,57
HND-004545,2011,50600070,,,,81,57,138
,2011,50600076,,,,7,14,21
,2011,50600081,,,,11,9,20
HND-004567,2011,50600108,,,,13,21,34
HND-004574,2011,50600119,,,,11,5,16
HND-004575,2011,50600124,,,,13,8,21
HND-004576,2011,50600125,,,,5,4,9
HND-004577,2011,50600126,,,,2,3,5
HND-004578,2011,50600127,,,,4,6,10
HND-004579,2011,50600128,,,,6,6,12
HND-004583,2011,50600142,,,,13,9,22
HND-004585,2011,50600145,,,,6,7,13
HND-004589,2011,50600152,,,,1,2,3
,2011,50600153,,,,4,3,7
HND-004590,2011,50600155,,,,7,13,20
HND-004592,2011,50600160,,,,11,16,27
,2011,50600168,,,,1,1,2
HND-004595,2011,50600208,,,,4,10,14
HND-004596,2011,50600219,,,,17,16,33
,2011,50600236,,,,3,3,6
HND-004604,2011,50600239,,,,10,10,20
,2011,50600248,,,,2,1,3
HND-004490,2011,50600002,,,,40,38,78
HND-004491,2011,50600003,,,,0,5,5
HND-004492,2011,50600004,,,,26,16,42
,2011,50600005,,,,2,11,13
HND-004493,2011,50600006,,,,49,43,92
HND-004500,2011,50600013,,,,25,28,53
HND-004504,2011,50600019,,,,55,53,108
,2011,50600020,,,,19,21,40
,2011,50600022,,,,1,5,6
HND-004508,2011,50600023,,,,13,9,22
HND-004509,2011,50600024,,,,15,13,28
HND-004510,2011,50600025,,,,20,16,36
HND-004514,2011,50600029,,,,7,3,10
HND-004516,2011,50600031,,,,19,14,33
HND-004519,2011,50600035,,,,5,11,16
HND-004520,2011,50600037,,,,35,36,71
HND-004521,2011,50600038,,,,45,37,82
HND-004525,2011,50600042,,,,10,10,20
HND-004526,2011,50600043,,,,17,22,39
HND-004527,2011,50600044,,,,6,3,9
HND-004530,2011,50600047,,,,16,14,30
HND-004532,2011,50600049,,,,24,28,52
HND-004533,2011,50600050,,,,29,22,51
HND-004536,2011,50600055,,,,2,3,5
HND-004537,2011,50600056,,,,31,23,54
HND-004538,2011,50600057,,,,3,3,6
HND-004539,2011,50600060,,,,12,3,15
,2011,50600064,,,,21,32,53
HND-004541,2011,50600066,,,,42,49,91
HND-004545,2011,50600070,,,,56,50,106
HND-004567,2011,50600108,,,,6,1,7
HND-004570,2011,50600115,,,,8,5,13
HND-004574,2011,50600119,,,,8,6,14
,2011,50600121,,,,28,27,55
HND-004575,2011,50600124,,,,6,11,17
HND-004576,2011,50600125,,,,7,7,14
HND-004577,2011,50600126,,,,1,8,9
HND-004578,2011,50600127,,,,4,6,10
HND-004579,2011,50600128,,,,5,8,13
HND-004589,2011,50600152,,,,1,0,1
,2011,50600153,,,,4,2,6
,2011,50600159,,,,1,2,3
,2011,50600168,,,,1,2,3
,2011,50600207,,,,4,6,10
,2011,50600218,,,,2,4,6
,2011,50600220,,,,0,2,2
HND-004597,2011,50600221,,,,8,7,15
,2011,50600235,,,,1,0,1
,2011,50600248,,,,1,2,3
HND-004489,2011,50600001,,,,3,4,7
HND-004494,2011,50600007,,,,16,16,32
HND-004495,2011,50600008,,,,27,37,64
,2011,50600009,,,,47,52,99
HND-004497,2011,50600010,,,,64,55,119
HND-004498,2011,50600011,,,,41,31,72
HND-004499,2011,50600012,,,,38,53,91
HND-004501,2011,50600015,,,,3,1,4
HND-004502,2011,50600017,,,,11,15,26
HND-004503,2011,50600018,,,,56,38,94
HND-004506,2011,50600021,,,,38,46,84
HND-004511,2011,50600026,,,,7,13,20
HND-004512,2011,50600027,,,,26,38,64
HND-004513,2011,50600028,,,,9,13,22
HND-004515,2011,50600030,,,,10,13,23
HND-004517,2011,50600032,,,,15,9,24
HND-004518,2011,50600034,,,,10,4,14
HND-004522,2011,50600039,,,,22,20,42
HND-004523,2011,50600040,,,,36,22,58
HND-004524,2011,50600041,,,,10,9,19
HND-004528,2011,50600045,,,,16,12,28
HND-004529,2011,50600046,,,,8,9,17
HND-004531,2011,50600048,,,,4,3,7
HND-004534,2011,50600051,,,,7,11,18
HND-004535,2011,50600052,,,,3,2,5
,2011,50600053,,,,8,2,10
,2011,50600054,,,,17,5,22
HND-004540,2011,50600062,,,,0,1,1
,2011,50600063,,,,14,8,22
HND-004542,2011,50600067,,,,10,15,25
HND-004543,2011,50600068,,,,15,4,19
HND-004544,2011,50600069,,,,28,37,65
,2011,50600076,,,,12,9,21
,2011,50600079,,,,2,7,9
,2011,50600081,,,,11,14,25
,2011,50600109,,,,9,8,17
HND-004569,2011,50600114,,,,7,1,8
,2011,50600140,,,,17,10,27
HND-004582,2011,50600141,,,,6,6,12
HND-004583,2011,50600142,,,,10,10,20
HND-004585,2011,50600145,,,,3,1,4
HND-004590,2011,50600155,,,,8,7,15
,2011,50600156,,,,8,8,16
HND-004592,2011,50600160,,,,17,13,30
,2011,50600164,,,,13,17,30
,2011,50600169,,,,18,11,29
HND-004594,2011,50600205,,,,9,14,23
HND-004595,2011,50600208,,,,4,9,13
HND-004596,2011,50600219,,,,13,13,26
,2011,50600236,,,,2,3,5
HND-004604,2011,50600239,,,,11,12,23
HND-004489,2011,50600001,,,,2,1,3
HND-004491,2011,50600003,,,,1,1,2
,2011,50600009,,,,53,57,110
HND-004497,2011,50600010,,,,71,65,136
HND-004499,2011,50600012,,,,38,52,90
HND-004501,2011,50600015,,,,0,1,1
HND-004503,2011,50600018,,,,45,47,92
,2011,50600020,,,,24,22,46
HND-004508,2011,50600023,,,,9,8,17
HND-004511,2011,50600026,,,,6,7,13
HND-004513,2011,50600028,,,,23,20,43
HND-004515,2011,50600030,,,,10,6,16
HND-004516,2011,50600031,,,,16,22,38
HND-004517,2011,50600032,,,,9,12,21
HND-004521,2011,50600038,,,,63,52,115
HND-004522,2011,50600039,,,,18,16,34
HND-004528,2011,50600045,,,,11,8,19
HND-004529,2011,50600046,,,,7,8,15
HND-004530,2011,50600047,,,,16,12,28
HND-004533,2011,50600050,,,,14,18,32
HND-004534,2011,50600051,,,,4,1,5
,2011,50600053,,,,5,5,10
HND-004536,2011,50600055,,,,3,1,4
HND-004537,2011,50600056,,,,20,21,41
HND-004538,2011,50600057,,,,4,1,5
HND-004539,2011,50600060,,,,16,11,27
,2011,50600063,,,,5,11,16
,2011,50600064,,,,41,25,66
HND-004543,2011,50600068,,,,10,11,21
,2011,50600079,,,,7,8,15
HND-004567,2011,50600108,,,,9,5,14
HND-004569,2011,50600114,,,,1,6,7
HND-004570,2011,50600115,,,,5,3,8
HND-004574,2011,50600119,,,,6,8,14
,2011,50600121,,,,28,22,50
HND-004575,2011,50600124,,,,6,10,16
HND-004583,2011,50600142,,,,4,14,18
HND-004589,2011,50600152,,,,2,0,2
,2011,50600153,,,,2,4,6
HND-004590,2011,50600155,,,,9,7,16
,2011,50600164,,,,16,6,22
,2011,50600207,,,,6,4,10
HND-004595,2011,50600208,,,,6,3,9
,2011,50600218,,,,6,7,13
,2011,50600236,,,,2,3,5
HND-004604,2011,50600239,,,,10,10,20
,2011,50600248,,,,1,0,1
HND-004490,2011,50600002,,,,31,29,60
HND-004492,2011,50600004,,,,6,9,15
,2011,50600005,,,,8,10,18
HND-004493,2011,50600006,,,,51,47,98
HND-004494,2011,50600007,,,,11,13,24
HND-004495,2011,50600008,,,,29,15,44
HND-004498,2011,50600011,,,,29,31,60
HND-004500,2011,50600013,,,,20,32,52
HND-004502,2011,50600017,,,,24,20,44
HND-004504,2011,50600019,,,,58,51,109
HND-004506,2011,50600021,,,,41,37,78
,2011,50600022,,,,2,2,4
HND-004509,2011,50600024,,,,10,11,21
HND-004510,2011,50600025,,,,16,22,38
HND-004512,2011,50600027,,,,32,17,49
HND-004514,2011,50600029,,,,1,6,7
HND-004518,2011,50600034,,,,12,5,17
HND-004519,2011,50600035,,,,8,6,14
HND-004520,2011,50600037,,,,25,39,64
HND-004523,2011,50600040,,,,24,32,56
HND-004524,2011,50600041,,,,15,13,28
HND-004525,2011,50600042,,,,9,11,20
HND-004526,2011,50600043,,,,14,13,27
HND-004531,2011,50600048,,,,7,1,8
HND-004532,2011,50600049,,,,12,14,26
HND-004535,2011,50600052,,,,2,5,7
,2011,50600054,,,,12,7,19
HND-004540,2011,50600062,,,,1,2,3
HND-004541,2011,50600066,,,,41,44,85
HND-004542,2011,50600067,,,,6,10,16
HND-004544,2011,50600069,,,,24,28,52
HND-004545,2011,50600070,,,,63,77,140
,2011,50600076,,,,12,8,20
,2011,50600081,,,,9,8,17
,2011,50600109,,,,2,5,7
HND-004576,2011,50600125,,,,1,3,4
HND-004577,2011,50600126,,,,4,1,5
HND-004578,2011,50600127,,,,3,3,6
HND-004579,2011,50600128,,,,4,4,8
,2011,50600140,,,,7,15,22
HND-004582,2011,50600141,,,,6,8,14
HND-004585,2011,50600145,,,,7,2,9
,2011,50600156,,,,10,1,11
,2011,50600159,,,,1,1,2
HND-004592,2011,50600160,,,,9,16,25
,2011,50600168,,,,3,1,4
,2011,50600169,,,,16,22,38
HND-004594,2011,50600205,,,,7,11,18
HND-004596,2011,50600219,,,,12,13,25
,2011,50600220,,,,3,0,3
HND-004597,2011,50600221,,,,5,9,14
,2011,50600005,,,,5,7,12
HND-004503,2011,50600018,,,,21,23,44
,2011,50600020,,,,48,43,91
HND-004516,2011,50600031,,,,21,24,45
HND-004521,2011,50600038,,,,18,25,43
HND-004523,2011,50600040,,,,18,30,48
HND-004525,2011,50600042,,,,26,19,45
HND-004526,2011,50600043,,,,22,23,45
HND-004532,2011,50600049,,,,24,27,51
,2011,50600053,,,,11,12,23
,2011,50600063,,,,14,23,37
,2011,50600065,,,,15,15,30
HND-004545,2011,50600070,,,,99,70,169
,2011,50600076,,,,23,26,49
,2011,50600079,,,,9,14,23
,2011,50600088,,,,304,254,558
HND-004572,2011,50600117,,,,18,19,37
,2011,50600121,,,,14,33,47
,2011,50600140,,,,8,13,21
,2011,50600156,,,,4,6,10
,2011,50600164,,,,8,13,21
,2011,50600235,,,,6,4,10
HND-004502,2011,50600017,,,,23,22,45
HND-004504,2011,50600019,,,,189,140,329
HND-004512,2011,50600027,,,,18,27,45
HND-004524,2011,50600041,,,,17,28,45
HND-004528,2011,50600045,,,,4,11,15
HND-004530,2011,50600047,,,,22,35,57
,2011,50600054,,,,7,13,20
,2011,50600064,,,,82,116,198
HND-004544,2011,50600069,,,,45,57,102
HND-004580,2011,50600133,,,,37,11,48
,2011,50600135,,,,4,12,16
,2011,50600144,,,,17,18,35
,2011,50600153,,,,11,11,22
,2011,50600169,,,,27,26,53
,2011,50600207,,,,6,6,12
,2011,50600218,,,,17,23,40
,2011,50600248,,,,2,2,4
HND-004502,2011,50600017,,,,7,20,27
HND-004504,2011,50600019,,,,100,132,232
HND-004512,2011,50600027,,,,24,21,45
HND-004516,2011,50600031,,,,4,11,15
HND-004521,2011,50600038,,,,25,32,57
HND-004528,2011,50600045,,,,7,2,9
HND-004530,2011,50600047,,,,18,29,47
,2011,50600064,,,,61,120,181
,2011,50600065,,,,12,17,29
HND-004544,2011,50600069,,,,36,33,69
HND-004580,2011,50600133,,,,28,6,34
,2011,50600135,,,,9,11,20
,2011,50600144,,,,18,16,34
,2011,50600153,,,,14,7,21
,2011,50600164,,,,8,4,12
,2011,50600169,,,,20,34,54
,2011,50600248,,,,1,4,5
,2011,50600005,,,,12,11,23
HND-004503,2011,50600018,,,,14,21,35
,2011,50600020,,,,31,32,63
HND-004523,2011,50600040,,,,24,20,44
HND-004524,2011,50600041,,,,15,21,36
HND-004525,2011,50600042,,,,9,24,33
HND-004526,2011,50600043,,,,14,22,36
HND-004532,2011,50600049,,,,7,15,22
,2011,50600053,,,,7,7,14
,2011,50600054,,,,6,13,19
,2011,50600063,,,,19,25,44
HND-004545,2011,50600070,,,,56,55,111
,2011,50600076,,,,17,12,29
,2011,50600079,,,,5,14,19
,2011,50600088,,,,216,231,447
HND-004572,2011,50600117,,,,10,10,20
,2011,50600121,,,,20,19,39
,2011,50600140,,,,17,8,25
,2011,50600156,,,,2,2,4
,2011,50600207,,,,3,7,10
,2011,50600218,,,,22,21,43
,2011,50600235,,,,5,4,9
,2011,50600005,,,,13,13,26
HND-004504,2011,50600019,,,,103,103,206
,2011,50600020,,,,29,16,45
HND-004516,2011,50600031,,,,5,7,12
HND-004521,2011,50600038,,,,15,20,35
HND-004528,2011,50600045,,,,7,5,12
HND-004530,2011,50600047,,,,24,16,40
,2011,50600054,,,,10,10,20
,2011,50600065,,,,11,13,24
HND-004580,2011,50600133,,,,17,5,22
,2011,50600135,,,,6,12,18
,2011,50600144,,,,12,14,26
,2011,50600153,,,,17,10,27
,2011,50600169,,,,23,35,58
,2011,50600248,,,,2,1,3
HND-004502,2011,50600017,,,,13,12,25
HND-004503,2011,50600018,,,,14,28,42
HND-004512,2011,50600027,,,,13,16,29
HND-004523,2011,50600040,,,,22,21,43
HND-004524,2011,50600041,,,,19,15,34
HND-004525,2011,50600042,,,,14,18,32
HND-004526,2011,50600043,,,,6,15,21
HND-004532,2011,50600049,,,,14,14,28
,2011,50600053,,,,1,3,4
,2011,50600063,,,,17,20,37
,2011,50600064,,,,69,120,189
HND-004544,2011,50600069,,,,25,26,51
HND-004545,2011,50600070,,,,53,47,100
,2011,50600076,,,,12,18,30
,2011,50600079,,,,4,4,8
,2011,50600088,,,,196,235,431
HND-004572,2011,50600117,,,,11,19,30
,2011,50600121,,,,19,13,32
,2011,50600140,,,,15,20,35
,2011,50600164,,,,4,6,10
,2011,50600218,,,,21,26,47
,2011,50600235,,,,3,4,7
,2011,50600053,,,,3,8,11
,2011,50600063,,,,12,19,31
HND-004572,2011,50600117,,,,4,4,8
,2011,50600153,,,,19,10,29
,2011,50600169,,,,26,34,60
,2011,50600235,,,,2,1,3
,2011,50600005,,,,18,22,40
HND-004504,2011,50600019,,,,70,121,191
HND-004532,2011,50600049,,,,4,23,27
,2011,50600054,,,,14,14,28
,2011,50600064,,,,57,127,184
,2011,50600065,,,,6,7,13
,2011,50600076,,,,16,19,35
,2011,50600088,,,,287,387,674
,2011,50600121,,,,20,16,36
HND-004580,2011,50600133,,,,111,16,127
,2011,50600135,,,,22,30,52
,2011,50600140,,,,8,11,19
,2011,50600144,,,,19,27,46
,2011,50600218,,,,33,32,65
,2011,50600005,,,,21,23,44
HND-004504,2011,50600019,,,,64,78,142
,2011,50600053,,,,2,4,6
,2011,50600065,,,,7,12,19
,2011,50600088,,,,248,341,589
HND-004572,2011,50600117,,,,5,4,9
,2011,50600121,,,,12,10,22
,2011,50600140,,,,4,5,9
,2011,50600144,,,,14,27,41
,2011,50600169,,,,20,31,51
,2011,50600235,,,,10,6,16
HND-004532,2011,50600049,,,,5,11,16
,2011,50600054,,,,13,14,27
,2011,50600063,,,,7,15,22
,2011,50600064,,,,61,104,165
,2011,50600076,,,,17,17,34
HND-004580,2011,50600133,,,,35,13,48
,2011,50600135,,,,8,15,23
,2011,50600153,,,,31,25,56
,2011,50600218,,,,22,20,42
HND-004532,2011,50600049,,,,0,6,6
,2011,50600054,,,,7,5,12
,2011,50600063,,,,8,17,25
,2011,50600064,,,,20,30,50
,2011,50600076,,,,10,18,28
,2011,50600135,,,,10,21,31
,2011,50600153,,,,11,10,21
,2011,50600218,,,,12,24,36
,2011,50600005,,,,13,19,32
HND-004504,2011,50600019,,,,33,68,101
,2011,50600053,,,,2,4,6
,2011,50600065,,,,5,12,17
,2011,50600088,,,,164,305,469
HND-004572,2011,50600117,,,,5,7,12
HND-004580,2011,50600133,,,,13,11,24
,2011,50600144,,,,12,22,34
,2011,50600169,,,,24,32,56
,2011,50600235,,,,2,10,12
HND-004652,2011,50700047,,,,9,4,13
,2011,50700056,,,,5,3,8
HND-004658,2011,50700061,,,,5,15,20
HND-004659,2011,50700062,,,,5,2,7
,2011,50700063,,,,2,4,6
,2011,50700100,,,,4,3,7
,2011,50700050,,,,3,3,6
,2011,50700066,,,,8,2,10
,2011,50700073,,,,10,15,25
,2011,50700095,,,,6,4,10
,2011,50700097,,,,5,5,10
,2011,50700099,,,,4,4,8
HND-004665,2011,50700103,,,,8,5,13
HND-004666,2011,50700104,,,,5,7,12
HND-004623,2011,50700016,,,,1,4,5
HND-004649,2011,50700043,,,,3,0,3
HND-004653,2011,50700048,,,,3,2,5
HND-004654,2011,50700049,,,,0,1,1
HND-004656,2011,50700053,,,,3,1,4
HND-004660,2011,50700075,,,,3,1,4
HND-004661,2011,50700088,,,,1,1,2
HND-004663,2011,50700092,,,,1,1,2
HND-004664,2011,50700101,,,,4,3,7
,2011,50700102,,,,5,1,6
HND-004657,2011,50700055,,,,3,5,8
HND-004643,2011,50700036,,,,5,3,8
HND-004653,2011,50700048,,,,1,7,8
HND-004655,2011,50700051,,,,3,0,3
HND-004656,2011,50700053,,,,1,3,4
HND-004657,2011,50700055,,,,8,7,15
HND-004660,2011,50700075,,,,14,3,17
HND-004662,2011,50700090,,,,2,2,4
HND-004663,2011,50700092,,,,6,4,10
,2011,50700102,,,,1,1,2
HND-004613,2011,50700006,,,,8,6,14
HND-004623,2011,50700016,,,,8,11,19
HND-004645,2011,50700038,,,,23,25,48
HND-004647,2011,50700041,,,,1,1,2
HND-004648,2011,50700042,,,,20,14,34
HND-004649,2011,50700043,,,,4,5,9
HND-004650,2011,50700044,,,,7,5,12
HND-004654,2011,50700049,,,,9,11,20
,2011,50700052,,,,6,7,13
,2011,50700068,,,,6,2,8
HND-004661,2011,50700088,,,,7,5,12
,2011,50700089,,,,8,4,12
HND-004664,2011,50700101,,,,7,3,10
HND-004613,2011,50700006,,,,20,17,37
HND-004645,2011,50700038,,,,40,47,87
HND-004647,2011,50700041,,,,6,7,13
HND-004648,2011,50700042,,,,17,14,31
HND-004649,2011,50700043,,,,11,14,25
HND-004653,2011,50700048,,,,6,7,13
,2011,50700052,,,,10,9,19
HND-004656,2011,50700053,,,,2,8,10
HND-004660,2011,50700075,,,,8,11,19
HND-004661,2011,50700088,,,,7,8,15
,2011,50700089,,,,2,7,9
HND-004623,2011,50700016,,,,18,11,29
HND-004643,2011,50700036,,,,6,6,12
HND-004650,2011,50700044,,,,9,9,18
HND-004655,2011,50700051,,,,8,11,19
HND-004657,2011,50700055,,,,8,9,17
,2011,50700068,,,,6,5,11
HND-004662,2011,50700090,,,,6,4,10
HND-004663,2011,50700092,,,,4,8,12
HND-004664,2011,50700101,,,,16,6,22
,2011,50700102,,,,3,2,5
HND-004611,2011,50700004,,,,2,2,4
HND-004616,2011,50700009,,,,12,10,22
HND-004617,2011,50700010,,,,12,10,22
HND-004618,2011,50700011,,,,15,17,32
HND-004619,2011,50700012,,,,10,8,18
HND-004620,2011,50700013,,,,5,5,10
HND-004626,2011,50700019,,,,7,9,16
,2011,50700020,,,,5,6,11
HND-004628,2011,50700021,,,,11,10,21
HND-004632,2011,50700025,,,,9,7,16
HND-004633,2011,50700026,,,,6,3,9
HND-004634,2011,50700027,,,,5,7,12
HND-004635,2011,50700028,,,,2,2,4
HND-004641,2011,50700034,,,,3,3,6
HND-004642,2011,50700035,,,,2,3,5
HND-004643,2011,50700036,,,,2,3,5
HND-004644,2011,50700037,,,,5,2,7
HND-004646,2011,50700040,,,,3,2,5
HND-004610,2011,50700003,,,,92,73,165
HND-004612,2011,50700005,,,,7,5,12
HND-004613,2011,50700006,,,,35,21,56
HND-004614,2011,50700007,,,,10,7,17
HND-004621,2011,50700014,,,,24,22,46
HND-004622,2011,50700015,,,,3,9,12
HND-004623,2011,50700016,,,,22,10,32
HND-004624,2011,50700017,,,,12,9,21
,2011,50700018,,,,10,7,17
HND-004629,2011,50700022,,,,11,5,16
HND-004630,2011,50700023,,,,8,4,12
HND-004631,2011,50700024,,,,11,11,22
HND-004636,2011,50700029,,,,2,0,2
HND-004637,2011,50700030,,,,14,9,23
HND-004638,2011,50700031,,,,4,4,8
HND-004639,2011,50700032,,,,4,2,6
HND-004640,2011,50700033,,,,6,0,6
HND-004651,2011,50700045,,,,1,3,4
HND-004610,2011,50700003,,,,81,82,163
HND-004611,2011,50700004,,,,0,1,1
HND-004612,2011,50700005,,,,8,6,14
HND-004613,2011,50700006,,,,34,29,63
HND-004614,2011,50700007,,,,6,8,14
HND-004619,2011,50700012,,,,3,17,20
HND-004621,2011,50700014,,,,15,17,32
HND-004623,2011,50700016,,,,15,5,20
HND-004624,2011,50700017,,,,8,10,18
,2011,50700020,,,,2,3,5
HND-004628,2011,50700021,,,,11,8,19
HND-004629,2011,50700022,,,,13,6,19
HND-004630,2011,50700023,,,,1,4,5
HND-004636,2011,50700029,,,,3,2,5
HND-004637,2011,50700030,,,,12,5,17
HND-004639,2011,50700032,,,,3,1,4
HND-004640,2011,50700033,,,,1,0,1
HND-004641,2011,50700034,,,,2,2,4
HND-004646,2011,50700040,,,,8,4,12
HND-004615,2011,50700008,,,,0,3,3
HND-004616,2011,50700009,,,,8,11,19
HND-004617,2011,50700010,,,,13,16,29
HND-004618,2011,50700011,,,,4,10,14
HND-004620,2011,50700013,,,,2,5,7
HND-004622,2011,50700015,,,,3,7,10
,2011,50700018,,,,9,11,20
HND-004626,2011,50700019,,,,12,7,19
HND-004631,2011,50700024,,,,11,14,25
HND-004632,2011,50700025,,,,13,8,21
HND-004633,2011,50700026,,,,5,5,10
HND-004634,2011,50700027,,,,6,8,14
HND-004635,2011,50700028,,,,3,3,6
HND-004638,2011,50700031,,,,1,0,1
HND-004643,2011,50700036,,,,2,0,2
HND-004644,2011,50700037,,,,4,1,5
HND-004651,2011,50700045,,,,3,1,4
HND-004610,2011,50700003,,,,83,84,167
HND-004612,2011,50700005,,,,4,5,9
HND-004613,2011,50700006,,,,20,35,55
HND-004614,2011,50700007,,,,10,14,24
HND-004615,2011,50700008,,,,2,2,4
HND-004621,2011,50700014,,,,19,16,35
HND-004622,2011,50700015,,,,8,7,15
HND-004623,2011,50700016,,,,11,14,25
HND-004624,2011,50700017,,,,9,17,26
,2011,50700020,,,,7,4,11
HND-004629,2011,50700022,,,,8,6,14
HND-004630,2011,50700023,,,,4,3,7
HND-004631,2011,50700024,,,,9,5,14
HND-004636,2011,50700029,,,,3,1,4
HND-004639,2011,50700032,,,,8,0,8
HND-004641,2011,50700034,,,,2,3,5
HND-004644,2011,50700037,,,,4,4,8
HND-004646,2011,50700040,,,,5,5,10
HND-004611,2011,50700004,,,,5,0,5
HND-004616,2011,50700009,,,,11,9,20
HND-004617,2011,50700010,,,,13,9,22
HND-004618,2011,50700011,,,,11,7,18
HND-004619,2011,50700012,,,,10,4,14
HND-004620,2011,50700013,,,,4,4,8
,2011,50700018,,,,6,8,14
HND-004626,2011,50700019,,,,15,14,29
HND-004628,2011,50700021,,,,12,14,26
HND-004632,2011,50700025,,,,9,11,20
HND-004633,2011,50700026,,,,5,6,11
HND-004634,2011,50700027,,,,10,8,18
HND-004635,2011,50700028,,,,2,0,2
HND-004637,2011,50700030,,,,7,6,13
HND-004638,2011,50700031,,,,2,3,5
HND-004640,2011,50700033,,,,2,1,3
HND-004642,2011,50700035,,,,4,0,4
HND-004643,2011,50700036,,,,5,6,11
HND-004651,2011,50700045,,,,4,3,7
HND-004611,2011,50700004,,,,1,3,4
HND-004614,2011,50700007,,,,14,6,20
HND-004616,2011,50700009,,,,5,4,9
HND-004617,2011,50700010,,,,10,10,20
HND-004619,2011,50700012,,,,9,8,17
HND-004620,2011,50700013,,,,5,2,7
HND-004621,2011,50700014,,,,18,21,39
HND-004626,2011,50700019,,,,18,9,27
,2011,50700020,,,,9,5,14
HND-004628,2011,50700021,,,,14,13,27
HND-004629,2011,50700022,,,,6,6,12
HND-004630,2011,50700023,,,,3,8,11
HND-004635,2011,50700028,,,,2,2,4
HND-004636,2011,50700029,,,,2,3,5
HND-004637,2011,50700030,,,,6,6,12
HND-004638,2011,50700031,,,,6,5,11
HND-004639,2011,50700032,,,,3,4,7
HND-004640,2011,50700033,,,,1,3,4
HND-004646,2011,50700040,,,,5,5,10
HND-004610,2011,50700003,,,,105,72,177
HND-004612,2011,50700005,,,,4,4,8
HND-004613,2011,50700006,,,,30,37,67
HND-004615,2011,50700008,,,,0,2,2
HND-004618,2011,50700011,,,,18,12,30
HND-004622,2011,50700015,,,,7,3,10
HND-004623,2011,50700016,,,,9,11,20
HND-004624,2011,50700017,,,,11,10,21
,2011,50700018,,,,8,11,19
HND-004631,2011,50700024,,,,14,9,23
HND-004632,2011,50700025,,,,10,4,14
HND-004633,2011,50700026,,,,5,3,8
HND-004634,2011,50700027,,,,11,7,18
HND-004641,2011,50700034,,,,1,3,4
HND-004642,2011,50700035,,,,2,5,7
HND-004643,2011,50700036,,,,1,1,2
HND-004644,2011,50700037,,,,1,5,6
HND-004651,2011,50700045,,,,4,2,6
HND-004611,2011,50700004,,,,2,3,5
HND-004616,2011,50700009,,,,9,4,13
HND-004617,2011,50700010,,,,17,10,27
HND-004619,2011,50700012,,,,14,10,24
HND-004621,2011,50700014,,,,26,21,47
HND-004626,2011,50700019,,,,19,17,36
,2011,50700020,,,,5,4,9
HND-004628,2011,50700021,,,,11,17,28
HND-004630,2011,50700023,,,,7,6,13
HND-004632,2011,50700025,,,,10,16,26
HND-004636,2011,50700029,,,,2,4,6
HND-004637,2011,50700030,,,,3,10,13
HND-004638,2011,50700031,,,,7,3,10
HND-004639,2011,50700032,,,,4,11,15
HND-004640,2011,50700033,,,,1,3,4
HND-004646,2011,50700040,,,,8,6,14
HND-004651,2011,50700045,,,,2,1,3
HND-004610,2011,50700003,,,,90,83,173
HND-004612,2011,50700005,,,,5,6,11
HND-004613,2011,50700006,,,,29,24,53
HND-004614,2011,50700007,,,,6,12,18
HND-004615,2011,50700008,,,,1,1,2
HND-004618,2011,50700011,,,,11,12,23
HND-004622,2011,50700015,,,,9,6,15
HND-004623,2011,50700016,,,,15,10,25
HND-004624,2011,50700017,,,,7,4,11
,2011,50700018,,,,2,10,12
HND-004629,2011,50700022,,,,4,8,12
HND-004631,2011,50700024,,,,3,9,12
HND-004634,2011,50700027,,,,9,13,22
HND-004641,2011,50700034,,,,1,2,3
HND-004643,2011,50700036,,,,1,2,3
HND-004615,2011,50700008,,,,1,0,1
HND-004616,2011,50700009,,,,4,7,11
HND-004617,2011,50700010,,,,10,15,25
HND-004618,2011,50700011,,,,9,5,14
HND-004622,2011,50700015,,,,9,5,14
,2011,50700018,,,,11,6,17
HND-004626,2011,50700019,,,,11,12,23
HND-004631,2011,50700024,,,,13,3,16
HND-004632,2011,50700025,,,,10,5,15
HND-004634,2011,50700027,,,,10,18,28
HND-004638,2011,50700031,,,,3,2,5
HND-004642,2011,50700035,,,,2,2,4
HND-004643,2011,50700036,,,,2,0,2
HND-004644,2011,50700037,,,,5,1,6
HND-004651,2011,50700045,,,,5,3,8
HND-004610,2011,50700003,,,,82,84,166
HND-004611,2011,50700004,,,,0,2,2
HND-004612,2011,50700005,,,,2,4,6
HND-004613,2011,50700006,,,,27,29,56
HND-004614,2011,50700007,,,,6,4,10
HND-004619,2011,50700012,,,,8,8,16
HND-004621,2011,50700014,,,,20,16,36
HND-004623,2011,50700016,,,,15,20,35
HND-004624,2011,50700017,,,,8,6,14
,2011,50700020,,,,8,4,12
HND-004628,2011,50700021,,,,13,14,27
HND-004629,2011,50700022,,,,9,9,18
HND-004630,2011,50700023,,,,5,2,7
HND-004637,2011,50700030,,,,8,5,13
HND-004639,2011,50700032,,,,3,7,10
HND-004640,2011,50700033,,,,3,1,4
HND-004641,2011,50700034,,,,4,1,5
HND-004646,2011,50700040,,,,3,8,11
HND-004613,2011,50700006,,,,22,19,41
HND-004622,2011,50700015,,,,18,13,31
HND-004623,2011,50700016,,,,18,20,38
HND-004624,2011,50700017,,,,16,21,37
,2011,50700054,,,,177,142,319
HND-004613,2011,50700006,,,,20,18,38
HND-004624,2011,50700017,,,,9,10,19
,2011,50700054,,,,116,107,223
HND-004622,2011,50700015,,,,8,14,22
HND-004623,2011,50700016,,,,22,20,42
HND-004624,2011,50700017,,,,12,4,16
HND-004613,2011,50700006,,,,25,12,37
HND-004622,2011,50700015,,,,10,8,18
HND-004623,2011,50700016,,,,15,24,39
,2011,50700054,,,,91,85,176
,2011,50700054,,,,63,38,101
,2011,50700054,,,,26,24,50
,2011,50700054,,,,26,26,52
HND-004699,2011,50800055,,,,14,6,20
,2011,50800038,,,,5,7,12
HND-004697,2011,50800040,,,,7,6,13
,2011,50800045,,,,11,4,15
,2011,50800051,,,,4,5,9
,2011,50800032,,,,11,5,16
,2011,50800043,,,,3,2,5
HND-004686,2011,50800024,,,,2,0,2
HND-004689,2011,50800027,,,,2,0,2
HND-004691,2011,50800029,,,,3,2,5
HND-004693,2011,50800033,,,,0,1,1
HND-004694,2011,50800035,,,,3,5,8
HND-004680,2011,50800014,,,,5,7,12
HND-004681,2011,50800015,,,,6,0,6
HND-004684,2011,50800021,,,,5,1,6
HND-004687,2011,50800025,,,,1,0,1
HND-004688,2011,50800026,,,,2,2,4
HND-004690,2011,50800028,,,,3,2,5
,2011,50800032,,,,3,1,4
HND-004696,2011,50800037,,,,4,5,9
,2011,50800043,,,,1,1,2
HND-004681,2011,50800015,,,,17,8,25
HND-004684,2011,50800021,,,,14,13,27
HND-004687,2011,50800025,,,,5,6,11
HND-004688,2011,50800026,,,,8,6,14
HND-004689,2011,50800027,,,,12,15,27
HND-004690,2011,50800028,,,,4,8,12
HND-004692,2011,50800030,,,,21,14,35
,2011,50800032,,,,14,14,28
HND-004693,2011,50800033,,,,4,5,9
HND-004694,2011,50800035,,,,18,10,28
HND-004680,2011,50800014,,,,33,25,58
,2011,50800023,,,,14,16,30
HND-004686,2011,50800024,,,,24,14,38
HND-004691,2011,50800029,,,,22,17,39
HND-004696,2011,50800037,,,,7,7,14
,2011,50800043,,,,1,1,2
HND-004671,2011,50800004,,,,9,8,17
HND-004674,2011,50800007,,,,23,21,44
,2011,50800011,,,,9,8,17
,2011,50800043,,,,1,1,2
HND-004698,2011,50800050,,,,4,1,5
HND-004668,2011,50800001,,,,33,29,62
HND-004669,2011,50800002,,,,38,36,74
,2011,50800003,,,,10,15,25
HND-004672,2011,50800005,,,,16,14,30
HND-004673,2011,50800006,,,,6,5,11
HND-004675,2011,50800008,,,,35,39,74
HND-004676,2011,50800009,,,,24,32,56
HND-004677,2011,50800010,,,,75,88,163
HND-004679,2011,50800012,,,,9,2,11
HND-004695,2011,50800036,,,,8,6,14
HND-004668,2011,50800001,,,,37,39,76
HND-004669,2011,50800002,,,,30,31,61
HND-004672,2011,50800005,,,,8,18,26
HND-004673,2011,50800006,,,,1,5,6
HND-004674,2011,50800007,,,,13,18,31
HND-004675,2011,50800008,,,,32,29,61
HND-004677,2011,50800010,,,,74,68,142
,2011,50800011,,,,6,5,11
HND-004679,2011,50800012,,,,2,2,4
,2011,50800003,,,,13,6,19
HND-004671,2011,50800004,,,,14,11,25
HND-004676,2011,50800009,,,,34,30,64
HND-004695,2011,50800036,,,,6,6,12
,2011,50800043,,,,4,0,4
HND-004668,2011,50800001,,,,35,32,67
HND-004669,2011,50800002,,,,44,30,74
,2011,50800003,,,,11,21,32
HND-004672,2011,50800005,,,,11,9,20
HND-004673,2011,50800006,,,,7,3,10
HND-004675,2011,50800008,,,,41,30,71
HND-004677,2011,50800010,,,,60,70,130
HND-004679,2011,50800012,,,,4,4,8
,2011,50800043,,,,1,3,4
HND-004698,2011,50800050,,,,2,2,4
HND-004671,2011,50800004,,,,9,11,20
HND-004674,2011,50800007,,,,21,18,39
HND-004676,2011,50800009,,,,32,37,69
,2011,50800011,,,,8,14,22
HND-004695,2011,50800036,,,,3,6,9
HND-004669,2011,50800002,,,,44,26,70
HND-004671,2011,50800004,,,,7,7,14
HND-004672,2011,50800005,,,,9,10,19
HND-004673,2011,50800006,,,,6,6,12
HND-004674,2011,50800007,,,,14,21,35
HND-004677,2011,50800010,,,,86,57,143
,2011,50800011,,,,7,13,20
HND-004679,2011,50800012,,,,1,5,6
HND-004698,2011,50800050,,,,2,1,3
HND-004668,2011,50800001,,,,26,28,54
,2011,50800003,,,,16,15,31
HND-004675,2011,50800008,,,,34,32,66
HND-004676,2011,50800009,,,,33,31,64
HND-004695,2011,50800036,,,,4,7,11
,2011,50800043,,,,0,3,3
HND-004671,2011,50800004,,,,5,6,11
HND-004672,2011,50800005,,,,4,5,9
HND-004673,2011,50800006,,,,7,9,16
HND-004674,2011,50800007,,,,13,18,31
HND-004677,2011,50800010,,,,75,76,151
,2011,50800011,,,,7,5,12
HND-004695,2011,50800036,,,,5,4,9
HND-004698,2011,50800050,,,,1,0,1
HND-004668,2011,50800001,,,,24,25,49
HND-004669,2011,50800002,,,,43,37,80
,2011,50800003,,,,22,10,32
HND-004675,2011,50800008,,,,45,21,66
HND-004676,2011,50800009,,,,34,43,77
HND-004679,2011,50800012,,,,5,3,8
,2011,50800043,,,,1,2,3
,2011,50800003,,,,5,7,12
HND-004671,2011,50800004,,,,7,9,16
HND-004676,2011,50800009,,,,31,30,61
HND-004695,2011,50800036,,,,0,4,4
,2011,50800043,,,,0,1,1
HND-004668,2011,50800001,,,,21,27,48
HND-004669,2011,50800002,,,,41,24,65
HND-004672,2011,50800005,,,,11,9,20
HND-004673,2011,50800006,,,,4,5,9
HND-004674,2011,50800007,,,,7,17,24
HND-004675,2011,50800008,,,,40,48,88
HND-004677,2011,50800010,,,,80,71,151
,2011,50800011,,,,9,7,16
HND-004679,2011,50800012,,,,1,1,2
HND-004698,2011,50800050,,,,1,2,3
HND-004674,2011,50800007,,,,8,8,16
HND-004682,2011,50800017,,,,80,41,121
HND-004683,2011,50800020,,,,34,24,58
,2011,50800016,,,,125,111,236
,2011,50800018,,,,132,101,233
HND-004685,2011,50800022,,,,28,21,49
,2011,50800043,,,,3,2,5
,2011,50800054,,,,6,13,19
HND-004674,2011,50800007,,,,7,10,17
,2011,50800016,,,,82,72,154
,2011,50800018,,,,104,102,206
HND-004682,2011,50800017,,,,33,29,62
HND-004683,2011,50800020,,,,24,14,38
HND-004685,2011,50800022,,,,32,17,49
,2011,50800043,,,,5,2,7
,2011,50800054,,,,6,10,16
HND-004674,2011,50800007,,,,5,6,11
,2011,50800016,,,,57,54,111
HND-004683,2011,50800020,,,,24,27,51
HND-004685,2011,50800022,,,,18,18,36
HND-004682,2011,50800017,,,,27,40,67
,2011,50800018,,,,63,73,136
,2011,50800043,,,,1,0,1
,2011,50800054,,,,6,11,17
,2011,50800018,,,,57,79,136
,2011,50800054,,,,9,20,29
,2011,50800016,,,,58,58,116
HND-004682,2011,50800017,,,,30,28,58
HND-004683,2011,50800020,,,,11,17,28
HND-004685,2011,50800022,,,,10,40,50
HND-004682,2011,50800017,,,,11,12,23
,2011,50800018,,,,45,51,96
,2011,50800054,,,,11,9,20
,2011,50800016,,,,42,32,74
HND-004683,2011,50800020,,,,12,10,22
HND-004685,2011,50800022,,,,7,24,31
,2011,50800016,,,,40,45,85
HND-004683,2011,50800020,,,,3,9,12
HND-004685,2011,50800022,,,,4,23,27
HND-004682,2011,50800017,,,,13,13,26
,2011,50800018,,,,29,47,76
,2011,50800054,,,,0,5,5
HND-004685,2011,50800022,,,,0,9,9
HND-004705,2011,50900006,,,,7,5,12
HND-004712,2011,50900014,,,,3,4,7
HND-004727,2011,50900035,,,,19,7,26
,2011,50900060,,,,9,6,15
HND-004734,2011,50900069,,,,11,10,21
HND-004736,2011,50900072,,,,3,4,7
HND-004738,2011,50900074,,,,7,2,9
,2011,50900075,,,,12,8,20
HND-004740,2011,50900076,,,,10,10,20
HND-004725,2011,50900031,,,,15,11,26
HND-004726,2011,50900032,,,,12,11,23
,2011,50900039,,,,9,7,16
,2011,50900046,,,,16,9,25
HND-004731,2011,50900064,,,,12,8,20
,2011,50900065,,,,8,14,22
HND-004732,2011,50900066,,,,7,14,21
HND-004733,2011,50900068,,,,12,7,19
,2011,50900070,,,,5,6,11
,2011,50900071,,,,4,9,13
HND-004737,2011,50900073,,,,4,8,12
,2011,50900013,,,,1,0,1
,2011,50900065,,,,0,1,1
,2011,50900036,,,,1,0,1
,2011,50900079,,,,1,1,2
,2011,50900005,,,,1,1,2
HND-004716,2011,50900020,,,,4,2,6
HND-004718,2011,50900022,,,,1,1,2
HND-004724,2011,50900029,,,,2,3,5
,2011,50900040,,,,2,1,3
,2011,50900041,,,,1,0,1
,2011,50900043,,,,0,1,1
,2011,50900045,,,,2,2,4
,2011,50900049,,,,3,0,3
,2011,50900059,,,,3,1,4
,2011,50900063,,,,1,4,5
HND-004708,2011,50900009,,,,0,2,2
,2011,50900010,,,,4,6,10
,2011,50900013,,,,5,2,7
HND-004717,2011,50900021,,,,1,0,1
HND-004722,2011,50900026,,,,1,5,6
HND-004723,2011,50900027,,,,16,16,32
,2011,50900030,,,,5,5,10
,2011,50900036,,,,0,2,2
,2011,50900058,,,,0,3,3
,2011,50900065,,,,7,6,13
,2011,50900078,,,,3,4,7
,2011,50900079,,,,6,2,8
,2011,50900003,,,,28,43,71
HND-004708,2011,50900009,,,,22,26,48
,2011,50900010,,,,26,27,53
,2011,50900013,,,,2,0,2
HND-004722,2011,50900026,,,,15,14,29
HND-004723,2011,50900027,,,,23,21,44
,2011,50900030,,,,8,14,22
,2011,50900036,,,,3,6,9
,2011,50900045,,,,7,10,17
,2011,50900058,,,,1,3,4
,2011,50900063,,,,1,2,3
,2011,50900065,,,,6,10,16
,2011,50900077,,,,13,15,28
,2011,50900078,,,,5,4,9
,2011,50900079,,,,5,6,11
,2011,50900005,,,,16,16,32
HND-004711,2011,50900012,,,,21,17,38
HND-004716,2011,50900020,,,,5,6,11
HND-004717,2011,50900021,,,,27,38,65
HND-004718,2011,50900022,,,,23,23,46
HND-004724,2011,50900029,,,,10,13,23
,2011,50900040,,,,0,1,1
,2011,50900041,,,,8,11,19
,2011,50900043,,,,2,1,3
,2011,50900049,,,,13,6,19
,2011,50900059,,,,12,9,21
,2011,50900003,,,,75,66,141
,2011,50900005,,,,19,24,43
HND-004707,2011,50900008,,,,18,12,30
HND-004708,2011,50900009,,,,74,68,142
HND-004712,2011,50900014,,,,11,9,20
HND-004713,2011,50900015,,,,27,17,44
HND-004714,2011,50900016,,,,27,22,49
HND-004715,2011,50900017,,,,15,9,24
,2011,50900036,,,,5,7,12
HND-004728,2011,50900038,,,,14,14,28
,2011,50900040,,,,0,3,3
,2011,50900043,,,,6,0,6
,2011,50900045,,,,15,12,27
,2011,50900056,,,,66,39,105
,2011,50900062,,,,20,21,41
,2011,50900063,,,,2,1,3
,2011,50900077,,,,8,11,19
,2011,50900079,,,,8,7,15
HND-004742,2011,50900080,,,,14,5,19
HND-004700,2011,50900001,,,,49,44,93
,2011,50900002,,,,15,10,25
HND-004703,2011,50900004,,,,50,60,110
HND-004705,2011,50900006,,,,7,4,11
HND-004706,2011,50900007,,,,24,16,40
HND-004710,2011,50900011,,,,42,35,77
HND-004711,2011,50900012,,,,22,20,42
,2011,50900013,,,,14,11,25
HND-004716,2011,50900020,,,,4,7,11
,2011,50900041,,,,17,13,30
,2011,50900058,,,,4,3,7
,2011,50900059,,,,15,16,31
HND-004731,2011,50900064,,,,23,25,48
,2011,50900065,,,,24,14,38
,2011,50900078,,,,4,4,8
,2011,50900002,,,,8,11,19
,2011,50900003,,,,71,70,141
HND-004703,2011,50900004,,,,54,45,99
HND-004708,2011,50900009,,,,66,55,121
HND-004710,2011,50900011,,,,39,34,73
,2011,50900013,,,,10,16,26
HND-004713,2011,50900015,,,,15,17,32
HND-004714,2011,50900016,,,,34,23,57
,2011,50900036,,,,4,4,8
HND-004728,2011,50900038,,,,5,18,23
,2011,50900045,,,,19,15,34
,2011,50900058,,,,2,4,6
,2011,50900062,,,,25,19,44
,2011,50900063,,,,2,4,6
,2011,50900065,,,,19,23,42
,2011,50900077,,,,9,7,16
,2011,50900078,,,,10,4,14
,2011,50900079,,,,14,7,21
HND-004700,2011,50900001,,,,42,38,80
,2011,50900005,,,,20,27,47
HND-004705,2011,50900006,,,,5,4,9
HND-004706,2011,50900007,,,,16,15,31
HND-004707,2011,50900008,,,,14,18,32
HND-004711,2011,50900012,,,,29,34,63
HND-004712,2011,50900014,,,,13,7,20
HND-004715,2011,50900017,,,,7,11,18
HND-004716,2011,50900020,,,,4,6,10
,2011,50900040,,,,7,3,10
,2011,50900041,,,,8,16,24
,2011,50900043,,,,5,2,7
,2011,50900056,,,,40,33,73
,2011,50900059,,,,11,6,17
HND-004731,2011,50900064,,,,24,21,45
HND-004742,2011,50900080,,,,2,7,9
HND-004700,2011,50900001,,,,52,49,101
,2011,50900002,,,,11,14,25
HND-004703,2011,50900004,,,,48,41,89
HND-004706,2011,50900007,,,,11,12,23
HND-004708,2011,50900009,,,,51,53,104
HND-004710,2011,50900011,,,,26,19,45
HND-004711,2011,50900012,,,,22,16,38
,2011,50900013,,,,23,12,35
HND-004728,2011,50900038,,,,6,6,12
,2011,50900041,,,,11,11,22
,2011,50900058,,,,6,5,11
,2011,50900059,,,,11,6,17
HND-004731,2011,50900064,,,,25,23,48
,2011,50900065,,,,20,13,33
,2011,50900078,,,,4,2,6
,2011,50900003,,,,67,77,144
,2011,50900005,,,,21,23,44
HND-004705,2011,50900006,,,,7,7,14
HND-004707,2011,50900008,,,,12,10,22
HND-004712,2011,50900014,,,,9,5,14
HND-004713,2011,50900015,,,,18,17,35
HND-004714,2011,50900016,,,,29,33,62
HND-004715,2011,50900017,,,,17,11,28
HND-004716,2011,50900020,,,,7,7,14
,2011,50900036,,,,1,5,6
,2011,50900043,,,,3,4,7
,2011,50900045,,,,16,6,22
,2011,50900056,,,,33,48,81
,2011,50900062,,,,22,17,39
,2011,50900063,,,,1,4,5
,2011,50900079,,,,8,8,16
HND-004742,2011,50900080,,,,6,7,13
,2011,50900002,,,,9,10,19
,2011,50900003,,,,58,67,125
HND-004707,2011,50900008,,,,12,19,31
HND-004708,2011,50900009,,,,54,51,105
HND-004710,2011,50900011,,,,29,35,64
,2011,50900013,,,,10,12,22
HND-004713,2011,50900015,,,,14,17,31
HND-004714,2011,50900016,,,,27,19,46
HND-004715,2011,50900017,,,,12,12,24
,2011,50900036,,,,6,0,6
HND-004728,2011,50900038,,,,12,6,18
,2011,50900045,,,,8,15,23
,2011,50900056,,,,51,48,99
,2011,50900058,,,,5,2,7
,2011,50900062,,,,26,21,47
,2011,50900063,,,,0,1,1
,2011,50900065,,,,5,21,26
,2011,50900078,,,,4,2,6
,2011,50900079,,,,4,10,14
HND-004700,2011,50900001,,,,46,41,87
HND-004703,2011,50900004,,,,51,48,99
,2011,50900005,,,,22,14,36
HND-004705,2011,50900006,,,,4,5,9
HND-004706,2011,50900007,,,,16,16,32
HND-004711,2011,50900012,,,,22,18,40
HND-004712,2011,50900014,,,,12,2,14
HND-004716,2011,50900020,,,,4,3,7
,2011,50900040,,,,3,4,7
,2011,50900041,,,,10,10,20
,2011,50900043,,,,4,1,5
,2011,50900059,,,,11,7,18
HND-004731,2011,50900064,,,,14,16,30
HND-004742,2011,50900080,,,,5,4,9
,2011,50900002,,,,12,12,24
,2011,50900003,,,,64,69,133
HND-004707,2011,50900008,,,,16,13,29
HND-004708,2011,50900009,,,,46,54,100
,2011,50900013,,,,21,19,40
HND-004712,2011,50900014,,,,9,9,18
HND-004713,2011,50900015,,,,19,23,42
HND-004714,2011,50900016,,,,23,35,58
HND-004715,2011,50900017,,,,15,12,27
,2011,50900036,,,,3,5,8
HND-004728,2011,50900038,,,,11,7,18
,2011,50900043,,,,1,1,2
,2011,50900045,,,,12,12,24
,2011,50900056,,,,32,54,86
,2011,50900062,,,,20,31,51
,2011,50900063,,,,1,2,3
,2011,50900079,,,,11,3,14
HND-004700,2011,50900001,,,,61,60,121
HND-004703,2011,50900004,,,,48,35,83
,2011,50900005,,,,11,17,28
HND-004705,2011,50900006,,,,7,9,16
HND-004706,2011,50900007,,,,12,14,26
HND-004710,2011,50900011,,,,29,27,56
HND-004711,2011,50900012,,,,32,31,63
HND-004716,2011,50900020,,,,5,7,12
,2011,50900040,,,,1,5,6
,2011,50900041,,,,15,6,21
,2011,50900058,,,,2,4,6
,2011,50900059,,,,5,2,7
HND-004731,2011,50900064,,,,17,21,38
,2011,50900078,,,,4,7,11
HND-004742,2011,50900080,,,,4,2,6
HND-004700,2011,50900001,,,,65,47,112
,2011,50900005,,,,20,25,45
HND-004705,2011,50900006,,,,9,6,15
HND-004706,2011,50900007,,,,13,14,27
HND-004707,2011,50900008,,,,19,12,31
HND-004711,2011,50900012,,,,26,29,55
HND-004712,2011,50900014,,,,9,7,16
HND-004715,2011,50900017,,,,5,7,12
HND-004716,2011,50900020,,,,4,7,11
,2011,50900040,,,,9,7,16
,2011,50900041,,,,9,15,24
,2011,50900043,,,,4,2,6
,2011,50900045,,,,4,6,10
,2011,50900056,,,,44,45,89
,2011,50900059,,,,3,5,8
HND-004731,2011,50900064,,,,25,9,34
HND-004742,2011,50900080,,,,3,1,4
,2011,50900002,,,,3,11,14
,2011,50900003,,,,61,81,142
HND-004703,2011,50900004,,,,46,30,76
HND-004708,2011,50900009,,,,55,51,106
HND-004710,2011,50900011,,,,30,38,68
,2011,50900013,,,,17,19,36
HND-004713,2011,50900015,,,,11,17,28
HND-004714,2011,50900016,,,,19,29,48
,2011,50900036,,,,3,3,6
HND-004728,2011,50900038,,,,4,8,12
,2011,50900058,,,,6,5,11
,2011,50900062,,,,24,16,40
,2011,50900063,,,,1,0,1
,2011,50900078,,,,5,1,6
,2011,50900079,,,,6,7,13
HND-004707,2011,50900008,,,,11,11,22
HND-004708,2011,50900009,,,,37,39,76
,2011,50900013,,,,28,18,46
HND-004714,2011,50900016,,,,11,8,19
HND-004719,2011,50900023,,,,92,91,183
,2011,50900025,,,,37,31,68
,2011,50900033,,,,5,2,7
,2011,50900041,,,,17,18,35
,2011,50900053,,,,13,7,20
,2011,50900058,,,,8,10,18
,2011,50900005,,,,22,13,35
HND-004710,2011,50900011,,,,37,38,75
,2011,50900024,,,,97,95,192
,2011,50900043,,,,3,2,5
,2011,50900063,,,,3,3,6
HND-004708,2011,50900009,,,,23,39,62
HND-004710,2011,50900011,,,,19,24,43
HND-004714,2011,50900016,,,,13,16,29
,2011,50900024,,,,85,73,158
,2011,50900033,,,,4,6,10
,2011,50900043,,,,4,0,4
,2011,50900063,,,,5,5,10
,2011,50900005,,,,16,12,28
HND-004707,2011,50900008,,,,6,7,13
,2011,50900013,,,,19,26,45
HND-004719,2011,50900023,,,,76,80,156
,2011,50900025,,,,29,35,64
,2011,50900041,,,,13,10,23
,2011,50900053,,,,3,7,10
,2011,50900058,,,,6,2,8
HND-004708,2011,50900009,,,,17,16,33
HND-004710,2011,50900011,,,,27,21,48
,2011,50900013,,,,20,17,37
HND-004714,2011,50900016,,,,6,2,8
HND-004719,2011,50900023,,,,57,71,128
,2011,50900025,,,,17,22,39
,2011,50900041,,,,8,7,15
,2011,50900043,,,,3,2,5
,2011,50900053,,,,0,3,3
,2011,50900063,,,,8,5,13
,2011,50900005,,,,4,6,10
HND-004707,2011,50900008,,,,3,13,16
,2011,50900024,,,,34,55,89
,2011,50900033,,,,7,7,14
,2011,50900058,,,,6,5,11
,2011,50900033,,,,8,12,20
,2011,50900058,,,,1,5,6
HND-004719,2011,50900023,,,,32,48,80
,2011,50900024,,,,38,20,58
,2011,50900025,,,,14,12,26
,2011,50900041,,,,7,3,10
,2011,50900043,,,,4,1,5
,2011,50900063,,,,1,1,2
HND-004719,2011,50900023,,,,18,37,55
,2011,50900024,,,,22,19,41
,2011,50900025,,,,17,32,49
,2011,50900033,,,,13,19,32
,2011,50900058,,,,1,4,5
,2011,50900063,,,,0,2,2
,2011,50900041,,,,8,4,12
,2011,50900043,,,,0,1,1
HND-004719,2011,50900023,,,,18,37,55
,2011,50900024,,,,12,23,35
,2011,50900025,,,,3,6,9
,2011,50900043,,,,3,0,3
,2011,50900033,,,,3,9,12
,2011,50900058,,,,2,4,6
HND-004757,2011,51000017,,,,10,10,20
HND-004758,2011,51000018,,,,8,6,14
HND-004773,2011,51000035,,,,6,7,13
HND-004817,2011,51000088,,,,4,5,9
HND-004839,2011,51000129,,,,10,5,15
HND-004859,2011,51000168,,,,4,3,7
,2011,51000174,,,,6,3,9
HND-004863,2011,51000183,,,,11,12,23
,2011,51000184,,,,6,4,10
HND-004864,2011,51000185,,,,7,6,13
,2011,51000186,,,,6,8,14
,2011,51000188,,,,4,2,6
HND-004865,2011,51000190,,,,15,19,34
,2011,51000211,,,,15,8,23
,2011,51000212,,,,6,2,8
,2011,51000213,,,,4,5,9
,2011,51000214,,,,5,3,8
,2011,51000215,,,,6,3,9
HND-004871,2011,51000216,,,,7,7,14
,2011,51000250,,,,5,10,15
,2011,51000254,,,,6,2,8
,2011,51000256,,,,6,1,7
HND-004876,2011,51000258,,,,9,3,12
HND-004877,2011,51000259,,,,9,5,14
HND-004880,2011,51000269,,,,3,5,8
,2011,51000270,,,,4,2,6
,2011,51000274,,,,11,7,18
HND-004744,2011,51000002,,,,6,2,8
HND-004747,2011,51000005,,,,7,3,10
HND-004841,2011,51000131,,,,6,13,19
HND-004842,2011,51000132,,,,16,21,37
,2011,51000133,,,,9,5,14
,2011,51000134,,,,12,13,25
,2011,51000143,,,,4,7,11
,2011,51000144,,,,7,9,16
HND-004847,2011,51000145,,,,13,11,24
,2011,51000149,,,,5,6,11
,2011,51000172,,,,9,7,16
HND-004862,2011,51000173,,,,14,5,19
,2011,51000180,,,,9,7,16
,2011,51000187,,,,4,4,8
HND-004873,2011,51000234,,,,12,6,18
,2011,51000246,,,,5,4,9
,2011,51000247,,,,5,2,7
,2011,51000248,,,,5,6,11
,2011,51000251,,,,0,3,3
,2011,51000252,,,,13,16,29
,2011,51000253,,,,1,3,4
,2011,51000257,,,,5,5,10
,2011,51000260,,,,7,3,10
HND-004878,2011,51000261,,,,2,4,6
,2011,51000263,,,,2,3,5
,2011,51000264,,,,3,7,10
,2011,51000267,,,,5,3,8
,2011,51000268,,,,14,9,23
,2011,51000281,,,,6,1,7
,2011,51000095,,,,4,4,8
HND-004853,2011,51000159,,,,14,6,20
,2011,51000208,,,,4,10,14
,2011,51000136,,,,3,2,5
,2011,51000177,,,,4,2,6
,2011,51000095,,,,1,3,4
HND-004822,2011,51000098,,,,0,2,2
HND-004824,2011,51000101,,,,4,3,7
HND-004826,2011,51000103,,,,3,3,6
,2011,51000105,,,,2,2,4
,2011,51000110,,,,1,4,5
,2011,51000115,,,,8,7,15
HND-004843,2011,51000137,,,,1,2,3
,2011,51000177,,,,7,4,11
,2011,51000182,,,,21,13,34
HND-004867,2011,51000206,,,,4,2,6
,2011,51000208,,,,16,21,37
HND-004870,2011,51000210,,,,2,2,4
,2011,51000236,,,,1,2,3
,2011,51000271,,,,2,1,3
,2011,51000275,,,,3,6,9
HND-004819,2011,51000092,,,,7,8,15
HND-004827,2011,51000104,,,,3,0,3
,2011,51000111,,,,6,2,8
,2011,51000136,,,,2,4,6
HND-004844,2011,51000138,,,,6,5,11
HND-004845,2011,51000139,,,,7,9,16
HND-004846,2011,51000141,,,,1,2,3
,2011,51000142,,,,1,1,2
HND-004848,2011,51000152,,,,1,1,2
HND-004853,2011,51000159,,,,14,8,22
,2011,51000241,,,,1,0,1
,2011,51000266,,,,1,1,2
,2011,51000078,,,,8,8,16
HND-004819,2011,51000092,,,,28,22,50
HND-004821,2011,51000097,,,,17,14,31
HND-004825,2011,51000102,,,,15,10,25
,2011,51000111,,,,11,6,17
HND-004830,2011,51000113,,,,19,15,34
HND-004831,2011,51000114,,,,10,16,26
,2011,51000115,,,,33,24,57
,2011,51000135,,,,18,20,38
,2011,51000136,,,,14,6,20
HND-004845,2011,51000139,,,,31,24,55
HND-004846,2011,51000141,,,,18,14,32
HND-004848,2011,51000152,,,,11,17,28
HND-004849,2011,51000153,,,,21,14,35
HND-004850,2011,51000154,,,,14,13,27
HND-004851,2011,51000156,,,,16,14,30
HND-004853,2011,51000159,,,,14,19,33
HND-004854,2011,51000160,,,,19,17,36
HND-004858,2011,51000167,,,,18,11,29
HND-004870,2011,51000210,,,,9,5,14
HND-004872,2011,51000232,,,,24,19,43
,2011,51000236,,,,2,2,4
,2011,51000241,,,,11,3,14
HND-004782,2011,51000047,,,,27,35,62
,2011,51000076,,,,3,11,14
HND-004820,2011,51000094,,,,16,9,25
,2011,51000095,,,,25,32,57
,2011,51000096,,,,18,21,39
HND-004822,2011,51000098,,,,14,14,28
HND-004823,2011,51000099,,,,26,12,38
,2011,51000100,,,,39,39,78
HND-004824,2011,51000101,,,,8,6,14
HND-004826,2011,51000103,,,,12,9,21
HND-004827,2011,51000104,,,,7,9,16
,2011,51000105,,,,12,12,24
HND-004829,2011,51000107,,,,15,9,24
,2011,51000108,,,,19,24,43
,2011,51000109,,,,17,10,27
,2011,51000110,,,,19,21,40
HND-004838,2011,51000128,,,,14,9,23
HND-004840,2011,51000130,,,,2,7,9
HND-004843,2011,51000137,,,,3,11,14
,2011,51000142,,,,6,6,12
,2011,51000177,,,,6,4,10
HND-004867,2011,51000206,,,,3,6,9
,2011,51000208,,,,21,15,36
,2011,51000266,,,,5,3,8
,2011,51000271,,,,0,1,1
,2011,51000275,,,,3,5,8
HND-004743,2011,51000001,,,,19,16,35
HND-004744,2011,51000002,,,,8,3,11
HND-004745,2011,51000003,,,,73,62,135
HND-004746,2011,51000004,,,,6,5,11
HND-004748,2011,51000006,,,,3,1,4
HND-004752,2011,51000012,,,,31,26,57
HND-004754,2011,51000014,,,,2,3,5
HND-004755,2011,51000015,,,,4,5,9
HND-004756,2011,51000016,,,,30,28,58
HND-004758,2011,51000018,,,,9,9,18
HND-004759,2011,51000019,,,,28,17,45
HND-004768,2011,51000029,,,,19,17,36
HND-004776,2011,51000039,,,,21,22,43
,2011,51000041,,,,3,7,10
HND-004777,2011,51000042,,,,37,32,69
HND-004778,2011,51000043,,,,24,12,36
HND-004779,2011,51000044,,,,2,4,6
HND-004780,2011,51000045,,,,7,11,18
HND-004781,2011,51000046,,,,20,21,41
HND-004782,2011,51000047,,,,41,36,77
HND-004783,2011,51000048,,,,26,15,41
HND-004785,2011,51000050,,,,13,8,21
HND-004790,2011,51000055,,,,7,5,12
HND-004793,2011,51000058,,,,8,8,16
HND-004794,2011,51000059,,,,9,7,16
HND-004795,2011,51000060,,,,2,2,4
HND-004799,2011,51000065,,,,15,16,31
HND-004803,2011,51000069,,,,3,4,7
,2011,51000076,,,,5,5,10
HND-004810,2011,51000079,,,,7,5,12
HND-004811,2011,51000080,,,,8,7,15
HND-004812,2011,51000081,,,,1,2,3
HND-004813,2011,51000082,,,,27,23,50
HND-004814,2011,51000083,,,,4,5,9
HND-004815,2011,51000084,,,,2,4,6
HND-004816,2011,51000087,,,,21,16,37
HND-004817,2011,51000088,,,,7,4,11
HND-004832,2011,51000116,,,,21,15,36
HND-004855,2011,51000161,,,,28,22,50
HND-004859,2011,51000168,,,,8,4,12
,2011,51000177,,,,9,7,16
,2011,51000182,,,,10,15,25
,2011,51000208,,,,19,26,45
HND-004869,2011,51000209,,,,7,5,12
HND-004874,2011,51000235,,,,6,2,8
,2011,51000236,,,,2,3,5
,2011,51000271,,,,2,0,2
HND-004882,2011,51000272,,,,6,8,14
HND-004883,2011,51000273,,,,0,3,3
,2011,51000275,,,,2,3,5
HND-004747,2011,51000005,,,,5,4,9
,2011,51000007,,,,97,83,180
HND-004749,2011,51000008,,,,6,9,15
HND-004750,2011,51000009,,,,13,10,23
HND-004751,2011,51000011,,,,9,11,20
HND-004753,2011,51000013,,,,39,33,72
HND-004757,2011,51000017,,,,20,18,38
HND-004760,2011,51000020,,,,19,15,34
HND-004761,2011,51000021,,,,9,10,19
HND-004762,2011,51000022,,,,24,21,45
HND-004763,2011,51000023,,,,14,9,23
HND-004764,2011,51000024,,,,25,24,49
HND-004765,2011,51000025,,,,15,6,21
HND-004766,2011,51000026,,,,9,11,20
HND-004767,2011,51000027,,,,14,23,37
,2011,51000028,,,,15,11,26
HND-004769,2011,51000030,,,,17,14,31
HND-004770,2011,51000031,,,,12,9,21
HND-004771,2011,51000032,,,,23,15,38
,2011,51000033,,,,1,4,5
HND-004772,2011,51000034,,,,5,5,10
HND-004773,2011,51000035,,,,8,8,16
HND-004774,2011,51000037,,,,18,17,35
HND-004775,2011,51000038,,,,49,36,85
HND-004784,2011,51000049,,,,23,5,28
HND-004786,2011,51000051,,,,19,15,34
HND-004787,2011,51000052,,,,26,19,45
HND-004788,2011,51000053,,,,11,13,24
HND-004789,2011,51000054,,,,6,11,17
HND-004791,2011,51000056,,,,4,3,7
HND-004792,2011,51000057,,,,9,6,15
HND-004796,2011,51000061,,,,1,3,4
HND-004797,2011,51000062,,,,28,23,51
HND-004798,2011,51000063,,,,9,5,14
HND-004800,2011,51000066,,,,5,5,10
HND-004801,2011,51000067,,,,14,10,24
HND-004802,2011,51000068,,,,49,48,97
HND-004804,2011,51000070,,,,14,3,17
HND-004805,2011,51000072,,,,4,2,6
HND-004806,2011,51000073,,,,3,4,7
HND-004807,2011,51000074,,,,9,7,16
HND-004808,2011,51000075,,,,4,6,10
HND-004809,2011,51000077,,,,3,7,10
,2011,51000078,,,,9,11,20
HND-004818,2011,51000091,,,,5,5,10
HND-004828,2011,51000106,,,,13,10,23
,2011,51000111,,,,14,7,21
HND-004852,2011,51000158,,,,13,14,27
HND-004860,2011,51000169,,,,4,4,8
HND-004861,2011,51000170,,,,17,12,29
HND-004866,2011,51000205,,,,5,8,13
HND-004867,2011,51000206,,,,4,6,10
HND-004868,2011,51000207,,,,4,1,5
HND-004875,2011,51000237,,,,4,0,4
,2011,51000266,,,,4,6,10
,2011,51000280,,,,14,7,21
,2011,51000282,,,,5,3,8
HND-004743,2011,51000001,,,,5,8,13
HND-004745,2011,51000003,,,,1,1,2
,2011,51000007,,,,116,94,210
HND-004751,2011,51000011,,,,4,9,13
HND-004752,2011,51000012,,,,39,20,59
HND-004753,2011,51000013,,,,25,27,52
HND-004754,2011,51000014,,,,4,2,6
HND-004755,2011,51000015,,,,2,3,5
HND-004756,2011,51000016,,,,19,18,37
HND-004757,2011,51000017,,,,20,20,40
HND-004758,2011,51000018,,,,8,11,19
HND-004760,2011,51000020,,,,19,10,29
HND-004764,2011,51000024,,,,16,16,32
HND-004765,2011,51000025,,,,16,9,25
HND-004766,2011,51000026,,,,8,5,13
,2011,51000028,,,,18,14,32
HND-004768,2011,51000029,,,,14,16,30
HND-004770,2011,51000031,,,,13,6,19
HND-004771,2011,51000032,,,,16,11,27
,2011,51000033,,,,4,3,7
HND-004774,2011,51000037,,,,19,10,29
HND-004779,2011,51000044,,,,2,3,5
HND-004780,2011,51000045,,,,11,4,15
HND-004781,2011,51000046,,,,26,17,43
HND-004783,2011,51000048,,,,17,10,27
HND-004784,2011,51000049,,,,8,5,13
HND-004786,2011,51000051,,,,15,10,25
HND-004792,2011,51000057,,,,10,3,13
HND-004795,2011,51000060,,,,2,2,4
HND-004797,2011,51000062,,,,21,17,38
HND-004799,2011,51000065,,,,7,15,22
HND-004800,2011,51000066,,,,4,1,5
HND-004803,2011,51000069,,,,2,5,7
HND-004805,2011,51000072,,,,1,5,6
HND-004806,2011,51000073,,,,3,5,8
HND-004809,2011,51000077,,,,1,3,4
,2011,51000078,,,,6,3,9
HND-004811,2011,51000080,,,,9,9,18
HND-004817,2011,51000088,,,,1,1,2
HND-004818,2011,51000091,,,,2,2,4
,2011,51000111,,,,8,7,15
HND-004832,2011,51000116,,,,17,26,43
HND-004852,2011,51000158,,,,11,11,22
HND-004861,2011,51000170,,,,14,18,32
,2011,51000182,,,,8,10,18
HND-004868,2011,51000207,,,,5,6,11
,2011,51000236,,,,1,1,2
HND-004875,2011,51000237,,,,1,0,1
HND-004744,2011,51000002,,,,5,4,9
HND-004746,2011,51000004,,,,5,4,9
HND-004747,2011,51000005,,,,9,8,17
HND-004748,2011,51000006,,,,5,2,7
HND-004749,2011,51000008,,,,12,10,22
HND-004750,2011,51000009,,,,9,7,16
HND-004759,2011,51000019,,,,21,20,41
HND-004761,2011,51000021,,,,6,6,12
HND-004762,2011,51000022,,,,21,18,39
HND-004763,2011,51000023,,,,15,13,28
HND-004767,2011,51000027,,,,19,28,47
HND-004769,2011,51000030,,,,13,14,27
HND-004772,2011,51000034,,,,2,5,7
HND-004773,2011,51000035,,,,6,3,9
HND-004775,2011,51000038,,,,32,35,67
HND-004776,2011,51000039,,,,16,14,30
,2011,51000041,,,,4,8,12
HND-004777,2011,51000042,,,,32,23,55
HND-004778,2011,51000043,,,,12,12,24
HND-004782,2011,51000047,,,,36,38,74
HND-004785,2011,51000050,,,,13,8,21
HND-004787,2011,51000052,,,,18,21,39
HND-004788,2011,51000053,,,,5,6,11
HND-004789,2011,51000054,,,,13,11,24
HND-004790,2011,51000055,,,,9,6,15
HND-004791,2011,51000056,,,,5,7,12
HND-004793,2011,51000058,,,,5,8,13
HND-004794,2011,51000059,,,,12,4,16
HND-004796,2011,51000061,,,,3,3,6
HND-004798,2011,51000063,,,,4,5,9
HND-004801,2011,51000067,,,,11,8,19
HND-004802,2011,51000068,,,,50,49,99
HND-004804,2011,51000070,,,,9,10,19
HND-004807,2011,51000074,,,,3,2,5
HND-004808,2011,51000075,,,,4,4,8
,2011,51000076,,,,9,9,18
HND-004810,2011,51000079,,,,5,12,17
HND-004812,2011,51000081,,,,5,4,9
HND-004813,2011,51000082,,,,22,33,55
HND-004814,2011,51000083,,,,4,4,8
HND-004815,2011,51000084,,,,1,2,3
HND-004816,2011,51000087,,,,32,14,46
HND-004828,2011,51000106,,,,8,13,21
HND-004855,2011,51000161,,,,16,14,30
HND-004859,2011,51000168,,,,5,9,14
,2011,51000177,,,,8,9,17
HND-004866,2011,51000205,,,,8,13,21
HND-004867,2011,51000206,,,,7,3,10
,2011,51000208,,,,22,13,35
HND-004869,2011,51000209,,,,5,4,9
HND-004874,2011,51000235,,,,3,5,8
,2011,51000266,,,,7,1,8
,2011,51000271,,,,1,1,2
HND-004882,2011,51000272,,,,9,3,12
,2011,51000275,,,,1,2,3
,2011,51000280,,,,7,5,12
HND-004743,2011,51000001,,,,10,4,14
HND-004744,2011,51000002,,,,6,2,8
HND-004745,2011,51000003,,,,28,29,57
HND-004746,2011,51000004,,,,3,5,8
HND-004748,2011,51000006,,,,4,5,9
HND-004752,2011,51000012,,,,19,21,40
HND-004754,2011,51000014,,,,2,3,5
HND-004755,2011,51000015,,,,4,2,6
HND-004756,2011,51000016,,,,29,20,49
HND-004758,2011,51000018,,,,3,4,7
HND-004759,2011,51000019,,,,10,21,31
HND-004760,2011,51000020,,,,16,20,36
HND-004765,2011,51000025,,,,8,6,14
HND-004768,2011,51000029,,,,11,17,28
HND-004769,2011,51000030,,,,14,6,20
HND-004770,2011,51000031,,,,11,9,20
HND-004771,2011,51000032,,,,10,16,26
,2011,51000033,,,,2,1,3
HND-004772,2011,51000034,,,,4,7,11
HND-004773,2011,51000035,,,,4,4,8
HND-004774,2011,51000037,,,,20,11,31
HND-004775,2011,51000038,,,,27,25,52
HND-004784,2011,51000049,,,,10,12,22
HND-004786,2011,51000051,,,,15,13,28
HND-004787,2011,51000052,,,,18,24,42
HND-004788,2011,51000053,,,,2,8,10
HND-004789,2011,51000054,,,,11,8,19
HND-004792,2011,51000057,,,,2,6,8
HND-004795,2011,51000060,,,,1,0,1
HND-004799,2011,51000065,,,,7,14,21
HND-004803,2011,51000069,,,,5,3,8
HND-004805,2011,51000072,,,,4,2,6
HND-004806,2011,51000073,,,,5,2,7
HND-004807,2011,51000074,,,,4,5,9
HND-004808,2011,51000075,,,,3,6,9
HND-004809,2011,51000077,,,,4,2,6
,2011,51000078,,,,12,16,28
HND-004818,2011,51000091,,,,6,4,10
,2011,51000111,,,,12,13,25
HND-004832,2011,51000116,,,,25,16,41
HND-004852,2011,51000158,,,,9,6,15
HND-004859,2011,51000168,,,,6,10,16
HND-004861,2011,51000170,,,,26,31,57
HND-004867,2011,51000206,,,,6,6,12
HND-004868,2011,51000207,,,,1,3,4
HND-004875,2011,51000237,,,,0,1,1
,2011,51000266,,,,8,6,14
,2011,51000280,,,,4,5,9
HND-004747,2011,51000005,,,,7,6,13
,2011,51000007,,,,83,91,174
HND-004749,2011,51000008,,,,8,14,22
HND-004750,2011,51000009,,,,8,8,16
HND-004751,2011,51000011,,,,5,7,12
HND-004753,2011,51000013,,,,26,28,54
HND-004757,2011,51000017,,,,22,15,37
HND-004761,2011,51000021,,,,3,9,12
HND-004762,2011,51000022,,,,19,14,33
HND-004763,2011,51000023,,,,10,16,26
HND-004764,2011,51000024,,,,18,22,40
HND-004766,2011,51000026,,,,7,6,13
HND-004767,2011,51000027,,,,17,26,43
,2011,51000028,,,,19,10,29
HND-004776,2011,51000039,,,,20,15,35
,2011,51000041,,,,0,4,4
HND-004777,2011,51000042,,,,22,23,45
HND-004778,2011,51000043,,,,13,13,26
HND-004779,2011,51000044,,,,7,5,12
HND-004780,2011,51000045,,,,6,4,10
HND-004781,2011,51000046,,,,17,24,41
HND-004782,2011,51000047,,,,30,43,73
HND-004783,2011,51000048,,,,25,20,45
HND-004785,2011,51000050,,,,13,15,28
HND-004790,2011,51000055,,,,5,5,10
HND-004791,2011,51000056,,,,1,4,5
HND-004793,2011,51000058,,,,3,2,5
HND-004794,2011,51000059,,,,12,7,19
HND-004796,2011,51000061,,,,9,3,12
HND-004797,2011,51000062,,,,34,43,77
HND-004798,2011,51000063,,,,6,3,9
HND-004800,2011,51000066,,,,2,3,5
HND-004801,2011,51000067,,,,16,12,28
HND-004802,2011,51000068,,,,38,36,74
HND-004804,2011,51000070,,,,4,7,11
,2011,51000076,,,,17,4,21
HND-004810,2011,51000079,,,,2,14,16
HND-004811,2011,51000080,,,,1,2,3
HND-004812,2011,51000081,,,,0,1,1
HND-004813,2011,51000082,,,,29,26,55
HND-004814,2011,51000083,,,,3,2,5
HND-004815,2011,51000084,,,,0,1,1
HND-004816,2011,51000087,,,,20,12,32
HND-004817,2011,51000088,,,,5,3,8
HND-004828,2011,51000106,,,,15,9,24
HND-004855,2011,51000161,,,,30,30,60
HND-004860,2011,51000169,,,,2,1,3
,2011,51000177,,,,7,8,15
,2011,51000182,,,,9,7,16
HND-004866,2011,51000205,,,,7,5,12
,2011,51000208,,,,12,11,23
HND-004869,2011,51000209,,,,7,7,14
HND-004874,2011,51000235,,,,4,0,4
,2011,51000236,,,,3,6,9
HND-004883,2011,51000273,,,,0,3,3
,2011,51000007,,,,91,90,181
HND-004751,2011,51000011,,,,7,8,15
HND-004752,2011,51000012,,,,37,27,64
HND-004753,2011,51000013,,,,25,24,49
HND-004754,2011,51000014,,,,4,2,6
HND-004756,2011,51000016,,,,22,33,55
HND-004757,2011,51000017,,,,26,15,41
HND-004758,2011,51000018,,,,10,7,17
HND-004760,2011,51000020,,,,12,16,28
HND-004762,2011,51000022,,,,16,19,35
HND-004763,2011,51000023,,,,14,12,26
HND-004764,2011,51000024,,,,19,26,45
HND-004765,2011,51000025,,,,10,9,19
HND-004766,2011,51000026,,,,6,5,11
HND-004767,2011,51000027,,,,31,31,62
,2011,51000028,,,,9,14,23
HND-004768,2011,51000029,,,,20,21,41
HND-004770,2011,51000031,,,,13,13,26
,2011,51000033,,,,4,4,8
HND-004774,2011,51000037,,,,15,16,31
,2011,51000041,,,,8,10,18
HND-004777,2011,51000042,,,,26,33,59
HND-004779,2011,51000044,,,,4,0,4
HND-004780,2011,51000045,,,,6,11,17
HND-004781,2011,51000046,,,,25,16,41
HND-004783,2011,51000048,,,,2,2,4
HND-004784,2011,51000049,,,,5,10,15
HND-004794,2011,51000059,,,,7,7,14
HND-004795,2011,51000060,,,,4,1,5
HND-004796,2011,51000061,,,,4,6,10
HND-004797,2011,51000062,,,,10,21,31
HND-004798,2011,51000063,,,,2,6,8
HND-004799,2011,51000065,,,,4,12,16
HND-004800,2011,51000066,,,,3,4,7
HND-004801,2011,51000067,,,,11,14,25
HND-004803,2011,51000069,,,,4,4,8
HND-004809,2011,51000077,,,,4,3,7
HND-004811,2011,51000080,,,,3,3,6
HND-004815,2011,51000084,,,,3,2,5
HND-004817,2011,51000088,,,,3,3,6
,2011,51000111,,,,6,9,15
HND-004832,2011,51000116,,,,26,13,39
HND-004852,2011,51000158,,,,12,8,20
,2011,51000177,,,,4,9,13
,2011,51000182,,,,12,12,24
,2011,51000236,,,,0,2,2
HND-004883,2011,51000273,,,,0,4,4
HND-004743,2011,51000001,,,,15,11,26
HND-004744,2011,51000002,,,,2,0,2
HND-004745,2011,51000003,,,,41,25,66
HND-004746,2011,51000004,,,,4,0,4
HND-004747,2011,51000005,,,,3,4,7
HND-004748,2011,51000006,,,,0,3,3
HND-004749,2011,51000008,,,,7,10,17
HND-004750,2011,51000009,,,,13,7,20
HND-004755,2011,51000015,,,,2,1,3
HND-004759,2011,51000019,,,,35,23,58
HND-004761,2011,51000021,,,,7,5,12
HND-004769,2011,51000030,,,,17,11,28
HND-004771,2011,51000032,,,,19,18,37
HND-004772,2011,51000034,,,,1,4,5
HND-004773,2011,51000035,,,,9,4,13
HND-004775,2011,51000038,,,,31,36,67
HND-004776,2011,51000039,,,,15,21,36
HND-004778,2011,51000043,,,,23,14,37
HND-004782,2011,51000047,,,,34,33,67
HND-004785,2011,51000050,,,,11,5,16
HND-004786,2011,51000051,,,,11,9,20
HND-004787,2011,51000052,,,,13,14,27
HND-004788,2011,51000053,,,,3,7,10
HND-004789,2011,51000054,,,,13,14,27
HND-004791,2011,51000056,,,,2,2,4
HND-004792,2011,51000057,,,,2,12,14
HND-004793,2011,51000058,,,,4,6,10
HND-004802,2011,51000068,,,,40,47,87
HND-004804,2011,51000070,,,,4,10,14
HND-004805,2011,51000072,,,,3,3,6
HND-004806,2011,51000073,,,,4,5,9
HND-004807,2011,51000074,,,,4,6,10
HND-004808,2011,51000075,,,,2,4,6
,2011,51000076,,,,4,3,7
,2011,51000078,,,,9,10,19
HND-004810,2011,51000079,,,,6,8,14
HND-004812,2011,51000081,,,,1,2,3
HND-004813,2011,51000082,,,,29,21,50
HND-004814,2011,51000083,,,,3,6,9
HND-004816,2011,51000087,,,,14,15,29
HND-004818,2011,51000091,,,,7,9,16
HND-004828,2011,51000106,,,,16,25,41
HND-004855,2011,51000161,,,,18,17,35
HND-004859,2011,51000168,,,,3,7,10
HND-004861,2011,51000170,,,,11,14,25
HND-004866,2011,51000205,,,,14,17,31
HND-004867,2011,51000206,,,,3,5,8
HND-004868,2011,51000207,,,,1,0,1
,2011,51000208,,,,11,11,22
HND-004869,2011,51000209,,,,5,5,10
HND-004875,2011,51000237,,,,2,4,6
,2011,51000280,,,,8,4,12
,2011,51000007,,,,105,90,195
HND-004750,2011,51000009,,,,7,7,14
HND-004751,2011,51000011,,,,4,10,14
HND-004752,2011,51000012,,,,22,26,48
HND-004753,2011,51000013,,,,28,33,61
HND-004754,2011,51000014,,,,6,5,11
HND-004757,2011,51000017,,,,24,11,35
HND-004760,2011,51000020,,,,21,15,36
HND-004761,2011,51000021,,,,1,11,12
HND-004762,2011,51000022,,,,18,18,36
HND-004763,2011,51000023,,,,18,14,32
HND-004764,2011,51000024,,,,24,19,43
HND-004765,2011,51000025,,,,6,10,16
HND-004766,2011,51000026,,,,4,5,9
HND-004767,2011,51000027,,,,31,29,60
,2011,51000028,,,,9,13,22
,2011,51000041,,,,9,10,19
HND-004777,2011,51000042,,,,34,23,57
HND-004778,2011,51000043,,,,9,12,21
HND-004779,2011,51000044,,,,5,2,7
HND-004780,2011,51000045,,,,12,9,21
HND-004781,2011,51000046,,,,15,35,50
HND-004782,2011,51000047,,,,42,55,97
HND-004783,2011,51000048,,,,12,12,24
HND-004784,2011,51000049,,,,5,4,9
HND-004785,2011,51000050,,,,9,7,16
HND-004790,2011,51000055,,,,4,2,6
HND-004794,2011,51000059,,,,8,5,13
HND-004795,2011,51000060,,,,0,2,2
HND-004796,2011,51000061,,,,2,4,6
HND-004797,2011,51000062,,,,4,2,6
HND-004798,2011,51000063,,,,6,5,11
HND-004799,2011,51000065,,,,14,8,22
HND-004800,2011,51000066,,,,5,5,10
HND-004801,2011,51000067,,,,17,17,34
HND-004802,2011,51000068,,,,47,53,100
HND-004811,2011,51000080,,,,3,4,7
HND-004813,2011,51000082,,,,23,21,44
HND-004815,2011,51000084,,,,2,2,4
HND-004817,2011,51000088,,,,5,1,6
HND-004828,2011,51000106,,,,15,13,28
,2011,51000111,,,,3,11,14
HND-004852,2011,51000158,,,,12,9,21
,2011,51000177,,,,9,4,13
,2011,51000182,,,,4,9,13
,2011,51000208,,,,5,7,12
HND-004869,2011,51000209,,,,7,4,11
HND-004874,2011,51000235,,,,1,1,2
HND-004875,2011,51000237,,,,0,2,2
,2011,51000280,,,,6,6,12
HND-004743,2011,51000001,,,,7,5,12
HND-004744,2011,51000002,,,,1,0,1
HND-004745,2011,51000003,,,,31,30,61
HND-004746,2011,51000004,,,,4,0,4
HND-004747,2011,51000005,,,,6,5,11
HND-004748,2011,51000006,,,,1,3,4
HND-004749,2011,51000008,,,,10,9,19
HND-004756,2011,51000016,,,,26,21,47
HND-004758,2011,51000018,,,,12,4,16
HND-004759,2011,51000019,,,,7,14,21
HND-004768,2011,51000029,,,,26,21,47
HND-004769,2011,51000030,,,,15,16,31
HND-004770,2011,51000031,,,,9,16,25
HND-004771,2011,51000032,,,,11,19,30
,2011,51000033,,,,5,2,7
HND-004772,2011,51000034,,,,7,10,17
HND-004773,2011,51000035,,,,10,4,14
HND-004774,2011,51000037,,,,11,20,31
HND-004775,2011,51000038,,,,34,30,64
HND-004776,2011,51000039,,,,14,16,30
HND-004786,2011,51000051,,,,16,17,33
HND-004787,2011,51000052,,,,21,16,37
HND-004788,2011,51000053,,,,4,6,10
HND-004789,2011,51000054,,,,0,2,2
HND-004791,2011,51000056,,,,0,2,2
HND-004792,2011,51000057,,,,2,2,4
HND-004793,2011,51000058,,,,7,4,11
HND-004803,2011,51000069,,,,2,3,5
HND-004804,2011,51000070,,,,7,7,14
HND-004805,2011,51000072,,,,2,3,5
HND-004806,2011,51000073,,,,4,4,8
HND-004807,2011,51000074,,,,4,3,7
HND-004808,2011,51000075,,,,10,3,13
,2011,51000076,,,,7,10,17
HND-004809,2011,51000077,,,,1,2,3
,2011,51000078,,,,15,11,26
HND-004810,2011,51000079,,,,13,8,21
HND-004812,2011,51000081,,,,2,0,2
HND-004814,2011,51000083,,,,5,5,10
HND-004816,2011,51000087,,,,8,13,21
HND-004818,2011,51000091,,,,8,8,16
HND-004832,2011,51000116,,,,20,16,36
HND-004855,2011,51000161,,,,21,26,47
HND-004859,2011,51000168,,,,5,6,11
HND-004860,2011,51000169,,,,0,2,2
HND-004861,2011,51000170,,,,6,7,13
HND-004866,2011,51000205,,,,8,13,21
HND-004867,2011,51000206,,,,5,7,12
HND-004868,2011,51000207,,,,1,0,1
,2011,51000236,,,,6,1,7
HND-004883,2011,51000273,,,,2,0,2
HND-004744,2011,51000002,,,,0,5,5
HND-004746,2011,51000004,,,,4,4,8
HND-004747,2011,51000005,,,,4,10,14
HND-004748,2011,51000006,,,,3,3,6
HND-004749,2011,51000008,,,,16,13,29
HND-004750,2011,51000009,,,,4,10,14
HND-004759,2011,51000019,,,,6,6,12
HND-004761,2011,51000021,,,,3,5,8
HND-004762,2011,51000022,,,,15,12,27
HND-004763,2011,51000023,,,,13,14,27
HND-004767,2011,51000027,,,,30,26,56
HND-004769,2011,51000030,,,,12,10,22
HND-004772,2011,51000034,,,,8,5,13
HND-004773,2011,51000035,,,,3,3,6
HND-004775,2011,51000038,,,,38,36,74
HND-004776,2011,51000039,,,,10,11,21
,2011,51000041,,,,13,7,20
HND-004777,2011,51000042,,,,24,46,70
HND-004778,2011,51000043,,,,12,7,19
HND-004782,2011,51000047,,,,49,48,97
HND-004785,2011,51000050,,,,9,5,14
HND-004787,2011,51000052,,,,26,9,35
HND-004788,2011,51000053,,,,5,5,10
HND-004789,2011,51000054,,,,8,6,14
HND-004790,2011,51000055,,,,6,2,8
HND-004791,2011,51000056,,,,2,5,7
HND-004793,2011,51000058,,,,3,5,8
HND-004794,2011,51000059,,,,5,7,12
HND-004796,2011,51000061,,,,6,3,9
HND-004798,2011,51000063,,,,2,3,5
HND-004801,2011,51000067,,,,14,5,19
HND-004802,2011,51000068,,,,41,46,87
HND-004804,2011,51000070,,,,5,5,10
HND-004807,2011,51000074,,,,9,6,15
HND-004808,2011,51000075,,,,2,6,8
,2011,51000076,,,,5,4,9
HND-004810,2011,51000079,,,,11,8,19
HND-004812,2011,51000081,,,,1,1,2
HND-004813,2011,51000082,,,,18,20,38
HND-004814,2011,51000083,,,,4,6,10
HND-004815,2011,51000084,,,,2,1,3
HND-004816,2011,51000087,,,,14,10,24
HND-004828,2011,51000106,,,,21,9,30
HND-004855,2011,51000161,,,,24,21,45
HND-004859,2011,51000168,,,,10,5,15
HND-004860,2011,51000169,,,,2,0,2
,2011,51000177,,,,5,1,6
HND-004866,2011,51000205,,,,9,5,14
HND-004867,2011,51000206,,,,6,3,9
,2011,51000208,,,,8,10,18
HND-004869,2011,51000209,,,,2,4,6
,2011,51000236,,,,1,5,6
HND-004883,2011,51000273,,,,0,1,1
HND-004743,2011,51000001,,,,9,7,16
HND-004745,2011,51000003,,,,19,28,47
,2011,51000007,,,,84,96,180
HND-004751,2011,51000011,,,,12,5,17
HND-004752,2011,51000012,,,,28,28,56
HND-004753,2011,51000013,,,,31,29,60
HND-004754,2011,51000014,,,,3,4,7
HND-004755,2011,51000015,,,,2,3,5
HND-004756,2011,51000016,,,,20,13,33
HND-004757,2011,51000017,,,,13,20,33
HND-004758,2011,51000018,,,,11,12,23
HND-004760,2011,51000020,,,,19,20,39
HND-004764,2011,51000024,,,,25,18,43
HND-004765,2011,51000025,,,,9,13,22
HND-004766,2011,51000026,,,,4,6,10
,2011,51000028,,,,19,10,29
HND-004768,2011,51000029,,,,20,21,41
HND-004770,2011,51000031,,,,5,3,8
HND-004771,2011,51000032,,,,11,8,19
,2011,51000033,,,,1,1,2
HND-004774,2011,51000037,,,,12,25,37
HND-004779,2011,51000044,,,,2,4,6
HND-004780,2011,51000045,,,,7,14,21
HND-004781,2011,51000046,,,,13,23,36
HND-004783,2011,51000048,,,,11,17,28
HND-004784,2011,51000049,,,,6,7,13
HND-004786,2011,51000051,,,,13,17,30
HND-004792,2011,51000057,,,,7,2,9
HND-004795,2011,51000060,,,,1,0,1
HND-004797,2011,51000062,,,,18,20,38
HND-004799,2011,51000065,,,,11,8,19
HND-004800,2011,51000066,,,,1,2,3
HND-004803,2011,51000069,,,,2,3,5
HND-004806,2011,51000073,,,,3,2,5
HND-004809,2011,51000077,,,,0,4,4
,2011,51000078,,,,16,19,35
HND-004811,2011,51000080,,,,1,3,4
HND-004817,2011,51000088,,,,8,3,11
HND-004818,2011,51000091,,,,3,10,13
,2011,51000111,,,,2,11,13
HND-004832,2011,51000116,,,,23,16,39
HND-004852,2011,51000158,,,,6,4,10
HND-004861,2011,51000170,,,,12,7,19
,2011,51000182,,,,8,7,15
HND-004868,2011,51000207,,,,2,3,5
,2011,51000280,,,,6,3,9
HND-004781,2011,51000046,,,,10,6,16
HND-004785,2011,51000050,,,,8,8,16
HND-004834,2011,51000119,,,,73,70,143
,2011,51000126,,,,7,8,15
,2011,51000181,,,,7,8,15
,2011,51000276,,,,4,17,21
,2011,51000278,,,,5,10,15
HND-004762,2011,51000022,,,,20,16,36
HND-004774,2011,51000037,,,,17,17,34
,2011,51000041,,,,18,22,40
HND-004833,2011,51000117,,,,160,93,253
,2011,51000120,,,,126,145,271
HND-004835,2011,51000121,,,,38,44,82
HND-004836,2011,51000122,,,,26,25,51
HND-004837,2011,51000123,,,,84,92,176
HND-004856,2011,51000162,,,,85,93,178
HND-004857,2011,51000163,,,,14,12,26
,2011,51000177,,,,4,8,12
,2011,51000182,,,,3,2,5
,2011,51000277,,,,13,8,21
,2011,51000279,,,,16,14,30
HND-004762,2011,51000022,,,,10,14,24
HND-004774,2011,51000037,,,,15,8,23
,2011,51000041,,,,18,19,37
HND-004781,2011,51000046,,,,3,11,14
,2011,51000120,,,,78,110,188
HND-004835,2011,51000121,,,,27,38,65
HND-004836,2011,51000122,,,,22,33,55
HND-004837,2011,51000123,,,,43,59,102
HND-004856,2011,51000162,,,,59,72,131
HND-004857,2011,51000163,,,,8,8,16
,2011,51000177,,,,2,2,4
,2011,51000182,,,,8,4,12
,2011,51000279,,,,3,1,4
HND-004785,2011,51000050,,,,3,4,7
HND-004833,2011,51000117,,,,91,55,146
HND-004834,2011,51000119,,,,35,46,81
,2011,51000126,,,,6,5,11
,2011,51000181,,,,6,4,10
,2011,51000276,,,,4,11,15
,2011,51000277,,,,8,13,21
HND-004762,2011,51000022,,,,10,8,18
HND-004774,2011,51000037,,,,12,15,27
,2011,51000041,,,,15,29,44
HND-004781,2011,51000046,,,,5,7,12
HND-004834,2011,51000119,,,,35,42,77
,2011,51000126,,,,1,3,4
HND-004857,2011,51000163,,,,6,9,15
,2011,51000177,,,,4,1,5
,2011,51000181,,,,3,13,16
,2011,51000276,,,,4,8,12
HND-004833,2011,51000117,,,,75,49,124
,2011,51000120,,,,79,105,184
HND-004835,2011,51000121,,,,28,32,60
HND-004836,2011,51000122,,,,29,25,54
HND-004837,2011,51000123,,,,45,60,105
HND-004856,2011,51000162,,,,33,55,88
,2011,51000277,,,,9,20,29
,2011,51000278,,,,1,6,7
,2011,51000279,,,,4,1,5
,2011,51000041,,,,24,23,47
HND-004833,2011,51000117,,,,81,63,144
HND-004834,2011,51000119,,,,22,26,48
,2011,51000120,,,,61,97,158
HND-004835,2011,51000121,,,,13,35,48
HND-004837,2011,51000123,,,,17,21,38
,2011,51000126,,,,5,3,8
HND-004856,2011,51000162,,,,31,53,84
,2011,51000278,,,,10,17,27
,2011,51000279,,,,10,12,22
HND-004836,2011,51000122,,,,11,13,24
HND-004857,2011,51000163,,,,3,5,8
,2011,51000181,,,,11,27,38
,2011,51000277,,,,19,47,66
,2011,51000041,,,,19,21,40
HND-004857,2011,51000163,,,,1,4,5
,2011,51000277,,,,39,88,127
,2011,51000278,,,,7,5,12
,2011,51000279,,,,3,2,5
HND-004833,2011,51000117,,,,72,31,103
HND-004834,2011,51000119,,,,9,21,30
,2011,51000120,,,,22,64,86
HND-004835,2011,51000121,,,,17,20,37
HND-004836,2011,51000122,,,,14,15,29
HND-004837,2011,51000123,,,,13,12,25
,2011,51000126,,,,2,2,4
HND-004856,2011,51000162,,,,30,43,73
,2011,51000181,,,,3,2,5
HND-004836,2011,51000122,,,,10,10,20
,2011,51000181,,,,3,7,10
,2011,51000277,,,,12,47,59
,2011,51000041,,,,8,10,18
HND-004833,2011,51000117,,,,71,16,87
HND-004834,2011,51000119,,,,12,20,32
,2011,51000120,,,,11,72,83
HND-004835,2011,51000121,,,,8,27,35
HND-004837,2011,51000123,,,,12,12,24
HND-004856,2011,51000162,,,,19,30,49
HND-004947,2011,51100088,,,,10,6,16
,2011,51100089,,,,9,9,18
HND-004956,2011,51100108,,,,15,9,24
HND-004960,2011,51100113,,,,3,7,10
HND-004968,2011,51100135,,,,11,10,21
HND-004970,2011,51100144,,,,6,11,17
HND-004981,2011,51100170,,,,3,9,12
HND-004982,2011,51100172,,,,8,6,14
,2011,51100173,,,,9,8,17
,2011,51100212,,,,7,6,13
,2011,51100243,,,,4,4,8
HND-005000,2011,51100259,,,,6,9,15
HND-005001,2011,51100260,,,,4,5,9
,2011,51100282,,,,17,9,26
HND-005003,2011,51100284,,,,6,9,15
,2011,51100286,,,,7,12,19
HND-005004,2011,51100287,,,,2,4,6
HND-005005,2011,51100288,,,,10,4,14
HND-005006,2011,51100289,,,,5,2,7
,2011,51100090,,,,6,3,9
HND-004963,2011,51100117,,,,6,5,11
,2011,51100137,,,,7,7,14
HND-004978,2011,51100156,,,,16,10,26
HND-004983,2011,51100174,,,,7,17,24
,2011,51100177,,,,2,4,6
,2011,51100178,,,,7,12,19
,2011,51100261,,,,6,7,13
,2011,51100262,,,,8,2,10
,2011,51100263,,,,5,7,12
,2011,51100264,,,,2,4,6
,2011,51100283,,,,6,9,15
,2011,51100285,,,,2,3,5
,2011,51100068,,,,0,1,1
HND-004950,2011,51100095,,,,0,1,1
HND-004970,2011,51100144,,,,0,1,1
HND-004984,2011,51100175,,,,0,2,2
,2011,51100273,,,,1,1,2
,2011,51100044,,,,1,0,1
,2011,51100097,,,,2,0,2
HND-004958,2011,51100110,,,,1,0,1
,2011,51100130,,,,0,1,1
,2011,51100211,,,,1,0,1
,2011,51100249,,,,0,1,1
,2011,51100270,,,,1,0,1
HND-004896,2011,51100009,,,,3,4,7
,2011,51100041,,,,4,9,13
,2011,51100044,,,,0,4,4
,2011,51100048,,,,3,2,5
HND-004927,2011,51100051,,,,2,2,4
HND-004928,2011,51100053,,,,6,6,12
,2011,51100055,,,,1,1,2
,2011,51100069,,,,2,0,2
,2011,51100079,,,,1,2,3
HND-004943,2011,51100081,,,,3,3,6
HND-004944,2011,51100082,,,,6,2,8
HND-004945,2011,51100084,,,,16,11,27
,2011,51100085,,,,4,3,7
,2011,51100087,,,,2,2,4
,2011,51100093,,,,5,0,5
HND-004950,2011,51100095,,,,3,7,10
,2011,51100097,,,,5,3,8
,2011,51100128,,,,3,0,3
,2011,51100130,,,,4,8,12
,2011,51100133,,,,2,1,3
HND-004969,2011,51100138,,,,1,2,3
,2011,51100139,,,,0,2,2
,2011,51100141,,,,2,2,4
,2011,51100143,,,,4,2,6
HND-004975,2011,51100153,,,,6,4,10
,2011,51100162,,,,3,2,5
,2011,51100166,,,,3,9,12
HND-004985,2011,51100179,,,,0,1,1
,2011,51100215,,,,0,1,1
,2011,51100216,,,,3,4,7
,2011,51100240,,,,0,1,1
,2011,51100242,,,,2,3,5
,2011,51100248,,,,4,4,8
,2011,51100270,,,,16,11,27
,2011,51100271,,,,4,2,6
,2011,51100272,,,,0,1,1
,2011,51100273,,,,2,2,4
,2011,51100291,,,,1,2,3
HND-004888,2011,51100001,,,,8,12,20
HND-004891,2011,51100004,,,,9,8,17
,2011,51100026,,,,0,1,1
HND-004914,2011,51100029,,,,3,0,3
,2011,51100052,,,,6,2,8
HND-004937,2011,51100064,,,,1,3,4
,2011,51100068,,,,6,3,9
,2011,51100077,,,,2,1,3
,2011,51100091,,,,2,1,3
HND-004949,2011,51100094,,,,16,17,33
HND-004951,2011,51100099,,,,0,6,6
,2011,51100102,,,,0,4,4
HND-004955,2011,51100106,,,,5,7,12
HND-004958,2011,51100110,,,,4,1,5
HND-004959,2011,51100111,,,,8,6,14
,2011,51100120,,,,2,3,5
,2011,51100127,,,,1,0,1
HND-004970,2011,51100144,,,,5,2,7
,2011,51100158,,,,2,2,4
HND-004984,2011,51100175,,,,4,4,8
,2011,51100209,,,,0,1,1
HND-004988,2011,51100218,,,,7,5,12
,2011,51100219,,,,1,0,1
HND-004989,2011,51100220,,,,0,2,2
HND-004992,2011,51100225,,,,13,6,19
,2011,51100249,,,,6,11,17
HND-004998,2011,51100253,,,,2,4,6
,2011,51100267,,,,4,1,5
,2011,51100268,,,,0,1,1
,2011,51100275,,,,3,2,5
,2011,51100281,,,,0,2,2
,2011,51100290,,,,2,2,4
,2011,51100293,,,,5,0,5
HND-005008,2011,51100295,,,,6,4,10
HND-004888,2011,51100001,,,,45,39,84
HND-004891,2011,51100004,,,,48,37,85
HND-004896,2011,51100009,,,,9,15,24
,2011,51100026,,,,2,3,5
HND-004914,2011,51100029,,,,11,14,25
HND-004917,2011,51100032,,,,62,70,132
HND-004924,2011,51100040,,,,29,21,50
,2011,51100041,,,,14,7,21
,2011,51100044,,,,2,2,4
,2011,51100048,,,,2,3,5
HND-004927,2011,51100051,,,,18,13,31
HND-004928,2011,51100053,,,,15,13,28
,2011,51100055,,,,8,8,16
HND-004937,2011,51100064,,,,6,8,14
,2011,51100068,,,,11,14,25
,2011,51100079,,,,12,10,22
HND-004943,2011,51100081,,,,15,11,26
HND-004944,2011,51100082,,,,44,38,82
,2011,51100083,,,,10,11,21
HND-004945,2011,51100084,,,,15,18,33
,2011,51100085,,,,6,13,19
,2011,51100087,,,,18,26,44
,2011,51100091,,,,23,9,32
,2011,51100093,,,,8,5,13
HND-004950,2011,51100095,,,,37,22,59
HND-004952,2011,51100100,,,,18,19,37
HND-004955,2011,51100106,,,,35,31,66
HND-004958,2011,51100110,,,,16,8,24
,2011,51100127,,,,0,9,9
HND-004975,2011,51100153,,,,17,8,25
,2011,51100158,,,,10,6,16
,2011,51100166,,,,18,24,42
HND-004984,2011,51100175,,,,33,26,59
,2011,51100209,,,,2,3,5
HND-004988,2011,51100218,,,,16,14,30
,2011,51100219,,,,5,6,11
,2011,51100240,,,,2,3,5
,2011,51100248,,,,13,25,38
HND-004997,2011,51100250,,,,23,19,42
HND-004999,2011,51100254,,,,5,4,9
,2011,51100267,,,,2,0,2
,2011,51100268,,,,5,4,9
,2011,51100271,,,,12,5,17
,2011,51100272,,,,2,6,8
,2011,51100273,,,,1,3,4
,2011,51100274,,,,2,3,5
,2011,51100290,,,,12,16,28
,2011,51100291,,,,0,2,2
HND-005008,2011,51100295,,,,6,10,16
HND-004923,2011,51100039,,,,44,48,92
,2011,51100052,,,,12,7,19
HND-004929,2011,51100054,,,,19,11,30
,2011,51100069,,,,8,7,15
HND-004940,2011,51100073,,,,21,15,36
,2011,51100077,,,,8,4,12
HND-004949,2011,51100094,,,,11,16,27
,2011,51100097,,,,5,15,20
HND-004951,2011,51100099,,,,18,16,34
HND-004953,2011,51100101,,,,39,38,77
,2011,51100102,,,,9,11,20
HND-004954,2011,51100103,,,,49,40,89
HND-004957,2011,51100109,,,,24,21,45
HND-004959,2011,51100111,,,,31,30,61
,2011,51100120,,,,7,1,8
HND-004965,2011,51100124,,,,17,11,28
,2011,51100125,,,,5,4,9
,2011,51100128,,,,15,11,26
,2011,51100130,,,,13,12,25
,2011,51100133,,,,14,16,30
HND-004969,2011,51100138,,,,6,4,10
,2011,51100139,,,,30,26,56
,2011,51100141,,,,8,8,16
,2011,51100143,,,,8,7,15
HND-004970,2011,51100144,,,,21,18,39
,2011,51100162,,,,10,16,26
HND-004985,2011,51100179,,,,11,7,18
,2011,51100211,,,,9,4,13
HND-004986,2011,51100214,,,,18,26,44
,2011,51100215,,,,0,4,4
,2011,51100216,,,,3,3,6
HND-004989,2011,51100220,,,,9,3,12
,2011,51100224,,,,4,4,8
HND-004992,2011,51100225,,,,26,22,48
,2011,51100242,,,,6,1,7
,2011,51100249,,,,13,9,22
HND-004998,2011,51100253,,,,15,11,26
,2011,51100275,,,,6,1,7
,2011,51100281,,,,5,3,8
,2011,51100293,,,,13,7,20
,2011,51100296,,,,10,17,27
HND-004889,2011,51100002,,,,3,1,4
HND-004892,2011,51100005,,,,42,18,60
HND-004895,2011,51100008,,,,28,36,64
HND-004897,2011,51100011,,,,9,2,11
HND-004898,2011,51100012,,,,12,19,31
HND-004899,2011,51100013,,,,3,3,6
HND-004900,2011,51100014,,,,25,37,62
HND-004902,2011,51100016,,,,22,9,31
HND-004903,2011,51100017,,,,85,51,136
HND-004904,2011,51100018,,,,30,44,74
HND-004907,2011,51100021,,,,20,20,40
HND-004908,2011,51100022,,,,12,14,26
HND-004909,2011,51100023,,,,68,70,138
HND-004910,2011,51100024,,,,48,40,88
HND-004912,2011,51100027,,,,9,3,12
HND-004915,2011,51100030,,,,10,14,24
HND-004919,2011,51100035,,,,3,5,8
HND-004922,2011,51100038,,,,23,20,43
,2011,51100044,,,,2,7,9
,2011,51100048,,,,5,1,6
HND-004930,2011,51100056,,,,2,0,2
,2011,51100058,,,,6,4,10
HND-004935,2011,51100061,,,,1,3,4
HND-004936,2011,51100062,,,,26,28,54
HND-004938,2011,51100071,,,,7,7,14
,2011,51100079,,,,9,10,19
HND-004942,2011,51100080,,,,4,4,8
HND-004946,2011,51100086,,,,22,14,36
HND-004949,2011,51100094,,,,45,43,88
,2011,51100097,,,,19,9,28
HND-004960,2011,51100113,,,,11,15,26
HND-004961,2011,51100115,,,,38,31,69
HND-004962,2011,51100116,,,,4,3,7
,2011,51100120,,,,4,5,9
HND-004964,2011,51100121,,,,61,54,115
,2011,51100130,,,,19,20,39
HND-004967,2011,51100134,,,,42,29,71
,2011,51100141,,,,8,9,17
,2011,51100143,,,,2,11,13
HND-004973,2011,51100147,,,,1,0,1
HND-004974,2011,51100149,,,,8,6,14
HND-004975,2011,51100153,,,,16,17,33
,2011,51100158,,,,5,11,16
HND-004980,2011,51100160,,,,37,25,62
,2011,51100211,,,,13,9,22
HND-004986,2011,51100214,,,,28,27,55
,2011,51100215,,,,6,6,12
,2011,51100216,,,,7,3,10
HND-004987,2011,51100217,,,,12,6,18
HND-004988,2011,51100218,,,,10,14,24
,2011,51100242,,,,6,4,10
HND-004995,2011,51100246,,,,28,30,58
HND-004996,2011,51100247,,,,15,16,31
,2011,51100248,,,,17,22,39
,2011,51100249,,,,13,13,26
HND-004999,2011,51100254,,,,16,8,24
,2011,51100270,,,,7,3,10
,2011,51100272,,,,4,2,6
,2011,51100274,,,,3,2,5
HND-004890,2011,51100003,,,,54,62,116
HND-004891,2011,51100004,,,,75,54,129
HND-004893,2011,51100006,,,,36,35,71
HND-004894,2011,51100007,,,,4,7,11
HND-004901,2011,51100015,,,,14,8,22
HND-004905,2011,51100019,,,,62,62,124
HND-004906,2011,51100020,,,,89,87,176
HND-004911,2011,51100025,,,,5,4,9
,2011,51100026,,,,11,9,20
HND-004913,2011,51100028,,,,7,9,16
HND-004914,2011,51100029,,,,9,9,18
HND-004916,2011,51100031,,,,6,10,16
HND-004917,2011,51100032,,,,7,3,10
HND-004918,2011,51100034,,,,46,54,100
HND-004920,2011,51100036,,,,11,5,16
HND-004921,2011,51100037,,,,27,25,52
HND-004923,2011,51100039,,,,107,106,213
,2011,51100041,,,,8,9,17
,2011,51100052,,,,6,1,7
HND-004931,2011,51100057,,,,10,18,28
HND-004933,2011,51100059,,,,8,16,24
HND-004934,2011,51100060,,,,22,23,45
,2011,51100068,,,,12,9,21
,2011,51100069,,,,5,7,12
HND-004939,2011,51100072,,,,2,5,7
HND-004941,2011,51100074,,,,12,12,24
,2011,51100077,,,,9,11,20
HND-004951,2011,51100099,,,,29,33,62
HND-004952,2011,51100100,,,,27,25,52
HND-004963,2011,51100117,,,,12,8,20
,2011,51100125,,,,3,6,9
,2011,51100127,,,,7,8,15
,2011,51100128,,,,15,14,29
HND-004970,2011,51100144,,,,29,28,57
HND-004971,2011,51100145,,,,38,26,64
HND-004972,2011,51100146,,,,11,5,16
,2011,51100152,,,,5,4,9
HND-004976,2011,51100154,,,,3,1,4
HND-004977,2011,51100155,,,,42,32,74
HND-004978,2011,51100156,,,,12,8,20
HND-004979,2011,51100159,,,,8,4,12
,2011,51100219,,,,1,4,5
HND-004989,2011,51100220,,,,2,7,9
HND-004990,2011,51100222,,,,23,25,48
HND-004991,2011,51100223,,,,0,1,1
,2011,51100224,,,,5,2,7
HND-004993,2011,51100226,,,,7,1,8
,2011,51100228,,,,3,2,5
HND-004994,2011,51100239,,,,20,22,42
,2011,51100267,,,,3,5,8
,2011,51100268,,,,1,9,10
,2011,51100271,,,,4,5,9
,2011,51100273,,,,7,3,10
,2011,51100275,,,,3,6,9
,2011,51100278,,,,6,5,11
,2011,51100281,,,,4,6,10
,2011,51100293,,,,10,8,18
HND-005007,2011,51100294,,,,8,2,10
HND-005009,2011,51100298,,,,14,18,32
HND-004890,2011,51100003,,,,44,40,84
HND-004891,2011,51100004,,,,71,51,122
HND-004898,2011,51100012,,,,14,14,28
HND-004899,2011,51100013,,,,7,0,7
HND-004900,2011,51100014,,,,31,30,61
HND-004901,2011,51100015,,,,14,9,23
HND-004902,2011,51100016,,,,17,8,25
HND-004905,2011,51100019,,,,57,65,122
HND-004906,2011,51100020,,,,92,76,168
HND-004907,2011,51100021,,,,18,11,29
HND-004908,2011,51100022,,,,13,3,16
HND-004909,2011,51100023,,,,63,53,116
HND-004911,2011,51100025,,,,5,6,11
,2011,51100026,,,,7,6,13
HND-004912,2011,51100027,,,,2,9,11
HND-004913,2011,51100028,,,,7,10,17
HND-004914,2011,51100029,,,,17,11,28
HND-004915,2011,51100030,,,,5,9,14
HND-004917,2011,51100032,,,,5,2,7
HND-004918,2011,51100034,,,,43,49,92
HND-004919,2011,51100035,,,,8,8,16
HND-004920,2011,51100036,,,,9,10,19
HND-004922,2011,51100038,,,,18,27,45
,2011,51100041,,,,7,10,17
,2011,51100044,,,,11,9,20
,2011,51100048,,,,5,4,9
HND-004930,2011,51100056,,,,1,1,2
HND-004931,2011,51100057,,,,21,11,32
,2011,51100058,,,,6,6,12
HND-004933,2011,51100059,,,,5,5,10
HND-004934,2011,51100060,,,,13,11,24
HND-004935,2011,51100061,,,,2,1,3
HND-004936,2011,51100062,,,,24,30,54
,2011,51100068,,,,10,10,20
,2011,51100079,,,,9,9,18
HND-004942,2011,51100080,,,,3,5,8
HND-004946,2011,51100086,,,,30,31,61
HND-004952,2011,51100100,,,,34,24,58
HND-004961,2011,51100115,,,,37,29,66
HND-004962,2011,51100116,,,,2,2,4
HND-004963,2011,51100117,,,,10,6,16
,2011,51100152,,,,6,2,8
HND-004975,2011,51100153,,,,11,24,35
HND-004976,2011,51100154,,,,8,5,13
HND-004977,2011,51100155,,,,35,50,85
HND-004978,2011,51100156,,,,16,7,23
,2011,51100158,,,,7,5,12
HND-004979,2011,51100159,,,,5,9,14
HND-004980,2011,51100160,,,,22,27,49
HND-004986,2011,51100214,,,,27,24,51
HND-004988,2011,51100218,,,,12,15,27
,2011,51100219,,,,2,4,6
HND-004990,2011,51100222,,,,27,22,49
HND-004991,2011,51100223,,,,3,0,3
HND-004993,2011,51100226,,,,8,2,10
HND-004994,2011,51100239,,,,16,15,31
HND-004996,2011,51100247,,,,9,6,15
,2011,51100248,,,,22,20,42
,2011,51100249,,,,14,6,20
,2011,51100267,,,,5,1,6
,2011,51100268,,,,2,5,7
,2011,51100271,,,,5,4,9
,2011,51100272,,,,2,1,3
,2011,51100273,,,,2,0,2
,2011,51100274,,,,1,1,2
HND-005009,2011,51100298,,,,6,6,12
HND-004889,2011,51100002,,,,4,2,6
HND-004892,2011,51100005,,,,25,15,40
HND-004893,2011,51100006,,,,55,63,118
HND-004894,2011,51100007,,,,6,6,12
HND-004895,2011,51100008,,,,32,22,54
HND-004897,2011,51100011,,,,7,4,11
HND-004903,2011,51100017,,,,52,65,117
HND-004904,2011,51100018,,,,44,44,88
HND-004910,2011,51100024,,,,30,40,70
HND-004916,2011,51100031,,,,3,4,7
HND-004921,2011,51100037,,,,16,17,33
HND-004923,2011,51100039,,,,112,82,194
,2011,51100052,,,,3,4,7
,2011,51100069,,,,7,8,15
HND-004938,2011,51100071,,,,6,1,7
HND-004939,2011,51100072,,,,1,3,4
HND-004941,2011,51100074,,,,11,21,32
,2011,51100077,,,,9,14,23
HND-004949,2011,51100094,,,,33,36,69
,2011,51100097,,,,10,12,22
HND-004951,2011,51100099,,,,37,27,64
HND-004960,2011,51100113,,,,12,6,18
,2011,51100120,,,,7,5,12
HND-004964,2011,51100121,,,,45,41,86
,2011,51100125,,,,7,5,12
,2011,51100127,,,,8,9,17
,2011,51100128,,,,23,20,43
,2011,51100130,,,,14,10,24
HND-004967,2011,51100134,,,,21,19,40
,2011,51100141,,,,9,7,16
,2011,51100143,,,,4,4,8
HND-004970,2011,51100144,,,,26,23,49
HND-004971,2011,51100145,,,,24,29,53
HND-004972,2011,51100146,,,,5,5,10
HND-004973,2011,51100147,,,,3,3,6
HND-004974,2011,51100149,,,,4,5,9
,2011,51100211,,,,7,12,19
,2011,51100215,,,,8,3,11
,2011,51100216,,,,6,5,11
HND-004987,2011,51100217,,,,17,5,22
HND-004989,2011,51100220,,,,13,8,21
,2011,51100224,,,,2,3,5
,2011,51100228,,,,3,4,7
,2011,51100242,,,,2,5,7
HND-004995,2011,51100246,,,,37,28,65
HND-004999,2011,51100254,,,,13,16,29
,2011,51100270,,,,3,7,10
,2011,51100275,,,,5,3,8
,2011,51100278,,,,1,1,2
,2011,51100281,,,,4,2,6
HND-005007,2011,51100294,,,,3,1,4
HND-004890,2011,51100003,,,,59,36,95
HND-004891,2011,51100004,,,,58,55,113
HND-004893,2011,51100006,,,,35,39,74
HND-004894,2011,51100007,,,,8,3,11
HND-004901,2011,51100015,,,,5,8,13
HND-004902,2011,51100016,,,,11,16,27
HND-004905,2011,51100019,,,,59,71,130
HND-004906,2011,51100020,,,,99,71,170
HND-004908,2011,51100022,,,,4,6,10
HND-004911,2011,51100025,,,,8,8,16
,2011,51100026,,,,12,9,21
HND-004913,2011,51100028,,,,13,3,16
HND-004914,2011,51100029,,,,11,10,21
HND-004915,2011,51100030,,,,6,4,10
HND-004919,2011,51100035,,,,12,7,19
HND-004922,2011,51100038,,,,24,24,48
,2011,51100041,,,,8,9,17
,2011,51100044,,,,10,5,15
,2011,51100048,,,,7,3,10
HND-004930,2011,51100056,,,,4,1,5
,2011,51100058,,,,8,8,16
HND-004934,2011,51100060,,,,21,18,39
,2011,51100068,,,,15,12,27
,2011,51100069,,,,14,3,17
,2011,51100079,,,,4,4,8
HND-004942,2011,51100080,,,,7,8,15
HND-004946,2011,51100086,,,,17,15,32
HND-004949,2011,51100094,,,,25,38,63
,2011,51100097,,,,10,12,22
HND-004960,2011,51100113,,,,9,4,13
HND-004961,2011,51100115,,,,26,36,62
HND-004962,2011,51100116,,,,2,1,3
,2011,51100120,,,,7,6,13
HND-004964,2011,51100121,,,,47,33,80
HND-004970,2011,51100144,,,,23,17,40
HND-004972,2011,51100146,,,,4,5,9
,2011,51100152,,,,6,6,12
HND-004976,2011,51100154,,,,6,10,16
HND-004977,2011,51100155,,,,31,26,57
HND-004978,2011,51100156,,,,11,8,19
HND-004979,2011,51100159,,,,6,10,16
HND-004980,2011,51100160,,,,22,24,46
,2011,51100219,,,,2,2,4
HND-004989,2011,51100220,,,,3,10,13
HND-004990,2011,51100222,,,,25,20,45
HND-004991,2011,51100223,,,,2,2,4
,2011,51100224,,,,3,7,10
HND-004993,2011,51100226,,,,4,4,8
,2011,51100228,,,,4,5,9
,2011,51100242,,,,3,4,7
HND-004995,2011,51100246,,,,29,24,53
HND-004996,2011,51100247,,,,12,8,20
,2011,51100248,,,,14,14,28
,2011,51100249,,,,6,8,14
,2011,51100267,,,,2,1,3
,2011,51100268,,,,5,7,12
,2011,51100270,,,,2,2,4
,2011,51100272,,,,0,2,2
,2011,51100273,,,,3,2,5
,2011,51100274,,,,4,2,6
HND-004889,2011,51100002,,,,3,8,11
HND-004892,2011,51100005,,,,19,26,45
HND-004895,2011,51100008,,,,18,30,48
HND-004897,2011,51100011,,,,10,6,16
HND-004898,2011,51100012,,,,17,17,34
HND-004899,2011,51100013,,,,3,1,4
HND-004900,2011,51100014,,,,31,29,60
HND-004903,2011,51100017,,,,60,48,108
HND-004904,2011,51100018,,,,49,54,103
HND-004907,2011,51100021,,,,24,14,38
HND-004909,2011,51100023,,,,65,61,126
HND-004910,2011,51100024,,,,49,41,90
HND-004912,2011,51100027,,,,4,6,10
HND-004916,2011,51100031,,,,7,4,11
HND-004917,2011,51100032,,,,2,4,6
HND-004918,2011,51100034,,,,70,60,130
HND-004920,2011,51100036,,,,11,8,19
HND-004921,2011,51100037,,,,15,14,29
HND-004923,2011,51100039,,,,56,70,126
,2011,51100052,,,,12,8,20
HND-004931,2011,51100057,,,,15,15,30
HND-004933,2011,51100059,,,,8,12,20
HND-004935,2011,51100061,,,,0,2,2
HND-004936,2011,51100062,,,,43,40,83
HND-004938,2011,51100071,,,,6,4,10
HND-004939,2011,51100072,,,,1,1,2
HND-004941,2011,51100074,,,,22,10,32
,2011,51100077,,,,12,15,27
HND-004951,2011,51100099,,,,28,28,56
HND-004952,2011,51100100,,,,17,17,34
HND-004963,2011,51100117,,,,3,5,8
,2011,51100125,,,,6,9,15
,2011,51100127,,,,5,14,19
,2011,51100128,,,,13,17,30
,2011,51100130,,,,12,12,24
HND-004967,2011,51100134,,,,24,22,46
,2011,51100141,,,,5,6,11
,2011,51100143,,,,1,3,4
HND-004971,2011,51100145,,,,34,19,53
HND-004973,2011,51100147,,,,2,0,2
HND-004974,2011,51100149,,,,5,1,6
HND-004975,2011,51100153,,,,15,11,26
,2011,51100158,,,,8,14,22
,2011,51100211,,,,9,12,21
HND-004986,2011,51100214,,,,29,22,51
,2011,51100215,,,,3,7,10
,2011,51100216,,,,10,4,14
HND-004987,2011,51100217,,,,12,8,20
HND-004988,2011,51100218,,,,15,16,31
HND-004994,2011,51100239,,,,19,16,35
HND-004999,2011,51100254,,,,8,13,21
,2011,51100275,,,,2,2,4
,2011,51100281,,,,5,4,9
HND-005007,2011,51100294,,,,3,1,4
HND-005009,2011,51100298,,,,10,3,13
HND-004890,2011,51100003,,,,44,42,86
HND-004892,2011,51100005,,,,24,25,49
HND-004895,2011,51100008,,,,31,22,53
HND-004897,2011,51100011,,,,9,12,21
HND-004898,2011,51100012,,,,18,11,29
HND-004899,2011,51100013,,,,3,1,4
HND-004900,2011,51100014,,,,43,39,82
HND-004901,2011,51100015,,,,9,6,15
HND-004902,2011,51100016,,,,10,15,25
HND-004903,2011,51100017,,,,66,73,139
HND-004904,2011,51100018,,,,48,48,96
HND-004907,2011,51100021,,,,13,20,33
HND-004908,2011,51100022,,,,6,4,10
HND-004909,2011,51100023,,,,89,62,151
HND-004911,2011,51100025,,,,5,7,12
HND-004912,2011,51100027,,,,3,7,10
HND-004913,2011,51100028,,,,7,11,18
HND-004915,2011,51100030,,,,11,9,20
HND-004916,2011,51100031,,,,4,3,7
HND-004917,2011,51100032,,,,2,3,5
HND-004918,2011,51100034,,,,57,48,105
HND-004919,2011,51100035,,,,9,11,20
HND-004920,2011,51100036,,,,14,13,27
HND-004921,2011,51100037,,,,20,22,42
HND-004922,2011,51100038,,,,23,24,47
HND-004923,2011,51100039,,,,100,93,193
,2011,51100041,,,,7,16,23
,2011,51100044,,,,10,7,17
,2011,51100052,,,,6,5,11
HND-004930,2011,51100056,,,,1,0,1
HND-004931,2011,51100057,,,,13,14,27
HND-004933,2011,51100059,,,,11,3,14
HND-004934,2011,51100060,,,,23,14,37
HND-004935,2011,51100061,,,,2,1,3
HND-004936,2011,51100062,,,,24,17,41
HND-004941,2011,51100074,,,,22,23,45
,2011,51100079,,,,5,9,14
HND-004946,2011,51100086,,,,26,29,55
HND-004952,2011,51100100,,,,27,33,60
HND-004963,2011,51100117,,,,5,7,12
,2011,51100130,,,,14,11,25
,2011,51100143,,,,6,3,9
,2011,51100152,,,,9,3,12
HND-004975,2011,51100153,,,,13,9,22
HND-004976,2011,51100154,,,,8,7,15
HND-004978,2011,51100156,,,,2,3,5
,2011,51100158,,,,4,10,14
,2011,51100211,,,,11,11,22
HND-004986,2011,51100214,,,,29,26,55
,2011,51100215,,,,1,6,7
HND-004988,2011,51100218,,,,16,17,33
HND-004990,2011,51100222,,,,31,28,59
HND-004991,2011,51100223,,,,4,2,6
HND-004994,2011,51100239,,,,18,20,38
HND-004996,2011,51100247,,,,9,8,17
,2011,51100248,,,,11,14,25
,2011,51100268,,,,6,1,7
,2011,51100272,,,,0,3,3
,2011,51100273,,,,1,2,3
,2011,51100274,,,,1,0,1
HND-005002,2011,51100280,,,,12,19,31
,2011,51100281,,,,4,0,4
HND-005007,2011,51100294,,,,4,4,8
HND-005009,2011,51100298,,,,10,6,16
HND-004889,2011,51100002,,,,8,5,13
HND-004891,2011,51100004,,,,71,54,125
HND-004893,2011,51100006,,,,52,45,97
HND-004894,2011,51100007,,,,8,6,14
HND-004905,2011,51100019,,,,69,62,131
HND-004906,2011,51100020,,,,113,75,188
HND-004910,2011,51100024,,,,50,37,87
,2011,51100026,,,,3,12,15
HND-004914,2011,51100029,,,,13,8,21
,2011,51100048,,,,6,3,9
,2011,51100058,,,,6,8,14
,2011,51100068,,,,14,10,24
,2011,51100069,,,,9,5,14
HND-004938,2011,51100071,,,,3,2,5
HND-004939,2011,51100072,,,,3,8,11
,2011,51100077,,,,6,4,10
HND-004942,2011,51100080,,,,3,2,5
HND-004949,2011,51100094,,,,41,31,72
,2011,51100097,,,,12,7,19
HND-004951,2011,51100099,,,,22,28,50
HND-004960,2011,51100113,,,,10,7,17
HND-004961,2011,51100115,,,,39,35,74
HND-004962,2011,51100116,,,,2,1,3
,2011,51100120,,,,2,5,7
HND-004964,2011,51100121,,,,41,49,90
,2011,51100125,,,,12,14,26
,2011,51100127,,,,5,8,13
,2011,51100128,,,,17,17,34
HND-004967,2011,51100134,,,,38,29,67
,2011,51100141,,,,4,5,9
HND-004970,2011,51100144,,,,21,20,41
HND-004971,2011,51100145,,,,32,23,55
HND-004972,2011,51100146,,,,6,9,15
HND-004973,2011,51100147,,,,0,2,2
HND-004974,2011,51100149,,,,5,2,7
HND-004977,2011,51100155,,,,37,25,62
HND-004979,2011,51100159,,,,8,1,9
HND-004980,2011,51100160,,,,61,60,121
,2011,51100216,,,,7,11,18
HND-004987,2011,51100217,,,,10,10,20
,2011,51100219,,,,1,4,5
HND-004989,2011,51100220,,,,11,11,22
,2011,51100224,,,,5,5,10
HND-004993,2011,51100226,,,,6,5,11
,2011,51100228,,,,5,4,9
,2011,51100242,,,,4,1,5
HND-004995,2011,51100246,,,,18,32,50
,2011,51100249,,,,8,7,15
HND-004999,2011,51100254,,,,18,15,33
,2011,51100267,,,,0,1,1
,2011,51100275,,,,6,4,10
,2011,51100278,,,,2,0,2
HND-004889,2011,51100002,,,,2,4,6
HND-004892,2011,51100005,,,,24,27,51
HND-004895,2011,51100008,,,,30,25,55
HND-004897,2011,51100011,,,,3,7,10
HND-004898,2011,51100012,,,,13,14,27
HND-004899,2011,51100013,,,,0,3,3
HND-004900,2011,51100014,,,,36,36,72
HND-004902,2011,51100016,,,,14,15,29
HND-004903,2011,51100017,,,,59,73,132
HND-004904,2011,51100018,,,,62,53,115
HND-004907,2011,51100021,,,,17,13,30
HND-004908,2011,51100022,,,,13,6,19
HND-004909,2011,51100023,,,,74,63,137
HND-004910,2011,51100024,,,,41,51,92
HND-004912,2011,51100027,,,,2,5,7
HND-004915,2011,51100030,,,,9,12,21
HND-004916,2011,51100031,,,,11,5,16
HND-004917,2011,51100032,,,,2,4,6
HND-004918,2011,51100034,,,,43,64,107
HND-004919,2011,51100035,,,,8,7,15
HND-004920,2011,51100036,,,,16,17,33
HND-004921,2011,51100037,,,,17,21,38
HND-004922,2011,51100038,,,,20,17,37
HND-004923,2011,51100039,,,,80,77,157
,2011,51100041,,,,15,7,22
,2011,51100052,,,,11,7,18
HND-004931,2011,51100057,,,,6,8,14
HND-004933,2011,51100059,,,,6,9,15
HND-004935,2011,51100061,,,,2,2,4
HND-004936,2011,51100062,,,,6,7,13
HND-004939,2011,51100072,,,,0,1,1
HND-004941,2011,51100074,,,,17,16,33
,2011,51100077,,,,6,6,12
,2011,51100079,,,,10,9,19
HND-004951,2011,51100099,,,,33,25,58
HND-004952,2011,51100100,,,,24,27,51
HND-004963,2011,51100117,,,,4,6,10
,2011,51100127,,,,8,8,16
,2011,51100130,,,,6,7,13
,2011,51100141,,,,4,12,16
,2011,51100143,,,,4,2,6
HND-004974,2011,51100149,,,,4,8,12
HND-004975,2011,51100153,,,,12,8,20
HND-004976,2011,51100154,,,,3,3,6
,2011,51100158,,,,13,8,21
,2011,51100211,,,,6,11,17
HND-004986,2011,51100214,,,,31,37,68
,2011,51100215,,,,4,1,5
,2011,51100216,,,,8,13,21
HND-004987,2011,51100217,,,,10,6,16
HND-004988,2011,51100218,,,,5,13,18
HND-004991,2011,51100223,,,,6,4,10
HND-004994,2011,51100239,,,,14,16,30
,2011,51100273,,,,1,0,1
,2011,51100275,,,,4,3,7
,2011,51100278,,,,1,0,1
,2011,51100281,,,,3,3,6
HND-005007,2011,51100294,,,,0,2,2
HND-005009,2011,51100298,,,,1,11,12
HND-004890,2011,51100003,,,,48,57,105
HND-004891,2011,51100004,,,,66,72,138
HND-004893,2011,51100006,,,,40,52,92
HND-004894,2011,51100007,,,,10,14,24
HND-004901,2011,51100015,,,,2,6,8
HND-004905,2011,51100019,,,,60,66,126
HND-004906,2011,51100020,,,,95,89,184
HND-004911,2011,51100025,,,,7,2,9
,2011,51100026,,,,8,10,18
HND-004913,2011,51100028,,,,8,5,13
HND-004914,2011,51100029,,,,16,13,29
,2011,51100044,,,,7,9,16
,2011,51100048,,,,4,2,6
HND-004930,2011,51100056,,,,5,0,5
,2011,51100058,,,,6,11,17
HND-004934,2011,51100060,,,,11,10,21
,2011,51100068,,,,9,12,21
,2011,51100069,,,,7,7,14
HND-004938,2011,51100071,,,,5,5,10
HND-004942,2011,51100080,,,,3,4,7
HND-004946,2011,51100086,,,,22,19,41
HND-004949,2011,51100094,,,,32,32,64
,2011,51100097,,,,7,7,14
HND-004960,2011,51100113,,,,13,15,28
HND-004961,2011,51100115,,,,27,43,70
HND-004962,2011,51100116,,,,3,3,6
,2011,51100120,,,,9,3,12
HND-004964,2011,51100121,,,,40,37,77
,2011,51100125,,,,19,13,32
,2011,51100128,,,,15,18,33
HND-004967,2011,51100134,,,,45,35,80
HND-004970,2011,51100144,,,,25,33,58
HND-004971,2011,51100145,,,,35,26,61
HND-004972,2011,51100146,,,,5,11,16
HND-004973,2011,51100147,,,,1,2,3
HND-004977,2011,51100155,,,,22,38,60
HND-004978,2011,51100156,,,,5,11,16
HND-004979,2011,51100159,,,,8,4,12
HND-004980,2011,51100160,,,,11,10,21
,2011,51100219,,,,3,4,7
HND-004989,2011,51100220,,,,9,15,24
HND-004990,2011,51100222,,,,24,26,50
,2011,51100224,,,,9,9,18
HND-004993,2011,51100226,,,,4,6,10
,2011,51100228,,,,3,3,6
,2011,51100242,,,,4,2,6
HND-004995,2011,51100246,,,,15,21,36
HND-004996,2011,51100247,,,,15,10,25
,2011,51100248,,,,16,15,31
,2011,51100249,,,,6,6,12
HND-004999,2011,51100254,,,,11,19,30
,2011,51100267,,,,0,4,4
,2011,51100268,,,,1,0,1
,2011,51100272,,,,1,0,1
,2011,51100274,,,,0,2,2
HND-005002,2011,51100280,,,,13,14,27
HND-004889,2011,51100002,,,,9,2,11
HND-004892,2011,51100005,,,,14,25,39
HND-004893,2011,51100006,,,,56,42,98
HND-004894,2011,51100007,,,,5,3,8
HND-004895,2011,51100008,,,,27,27,54
HND-004897,2011,51100011,,,,12,5,17
HND-004903,2011,51100017,,,,82,59,141
HND-004904,2011,51100018,,,,61,61,122
HND-004910,2011,51100024,,,,38,38,76
HND-004916,2011,51100031,,,,1,5,6
HND-004921,2011,51100037,,,,11,18,29
HND-004923,2011,51100039,,,,72,104,176
,2011,51100052,,,,10,6,16
,2011,51100069,,,,6,5,11
HND-004938,2011,51100071,,,,2,2,4
HND-004939,2011,51100072,,,,6,0,6
HND-004941,2011,51100074,,,,19,20,39
,2011,51100077,,,,6,5,11
HND-004949,2011,51100094,,,,36,27,63
,2011,51100097,,,,12,9,21
HND-004951,2011,51100099,,,,36,28,64
HND-004960,2011,51100113,,,,7,5,12
,2011,51100120,,,,4,7,11
HND-004964,2011,51100121,,,,32,41,73
,2011,51100125,,,,22,18,40
,2011,51100127,,,,11,9,20
,2011,51100128,,,,9,11,20
,2011,51100130,,,,15,7,22
HND-004967,2011,51100134,,,,32,27,59
,2011,51100141,,,,4,5,9
,2011,51100143,,,,5,5,10
HND-004970,2011,51100144,,,,31,27,58
HND-004971,2011,51100145,,,,31,23,54
HND-004972,2011,51100146,,,,8,7,15
HND-004973,2011,51100147,,,,1,3,4
HND-004974,2011,51100149,,,,4,7,11
,2011,51100211,,,,6,7,13
,2011,51100215,,,,2,3,5
,2011,51100216,,,,8,6,14
HND-004987,2011,51100217,,,,8,8,16
HND-004989,2011,51100220,,,,6,1,7
,2011,51100224,,,,4,3,7
,2011,51100228,,,,2,1,3
,2011,51100242,,,,2,3,5
HND-004995,2011,51100246,,,,16,19,35
HND-004999,2011,51100254,,,,8,6,14
,2011,51100281,,,,2,1,3
HND-005007,2011,51100294,,,,1,2,3
HND-004890,2011,51100003,,,,34,41,75
HND-004891,2011,51100004,,,,63,53,116
HND-004898,2011,51100012,,,,17,12,29
HND-004899,2011,51100013,,,,0,5,5
HND-004900,2011,51100014,,,,40,52,92
HND-004901,2011,51100015,,,,5,3,8
HND-004902,2011,51100016,,,,5,12,17
HND-004905,2011,51100019,,,,57,64,121
HND-004906,2011,51100020,,,,99,83,182
HND-004907,2011,51100021,,,,18,20,38
HND-004908,2011,51100022,,,,9,7,16
HND-004909,2011,51100023,,,,63,49,112
HND-004911,2011,51100025,,,,3,1,4
,2011,51100026,,,,14,12,26
HND-004912,2011,51100027,,,,4,8,12
HND-004913,2011,51100028,,,,3,4,7
HND-004914,2011,51100029,,,,11,7,18
HND-004915,2011,51100030,,,,11,9,20
HND-004917,2011,51100032,,,,4,3,7
HND-004918,2011,51100034,,,,31,46,77
HND-004919,2011,51100035,,,,7,9,16
HND-004920,2011,51100036,,,,7,6,13
HND-004922,2011,51100038,,,,25,23,48
,2011,51100041,,,,3,8,11
,2011,51100044,,,,7,9,16
,2011,51100048,,,,8,10,18
HND-004930,2011,51100056,,,,1,2,3
HND-004931,2011,51100057,,,,20,12,32
,2011,51100058,,,,7,6,13
HND-004933,2011,51100059,,,,14,7,21
HND-004934,2011,51100060,,,,11,26,37
HND-004935,2011,51100061,,,,2,1,3
HND-004936,2011,51100062,,,,22,23,45
,2011,51100068,,,,21,18,39
,2011,51100079,,,,3,11,14
HND-004942,2011,51100080,,,,2,3,5
HND-004946,2011,51100086,,,,16,21,37
HND-004952,2011,51100100,,,,18,15,33
HND-004961,2011,51100115,,,,36,35,71
HND-004962,2011,51100116,,,,2,1,3
HND-004963,2011,51100117,,,,5,3,8
,2011,51100152,,,,0,1,1
HND-004975,2011,51100153,,,,14,9,23
HND-004976,2011,51100154,,,,4,3,7
HND-004977,2011,51100155,,,,28,31,59
HND-004978,2011,51100156,,,,6,7,13
,2011,51100158,,,,7,4,11
HND-004979,2011,51100159,,,,8,7,15
HND-004980,2011,51100160,,,,16,24,40
HND-004986,2011,51100214,,,,22,23,45
HND-004988,2011,51100218,,,,11,10,21
,2011,51100219,,,,3,5,8
HND-004990,2011,51100222,,,,25,21,46
HND-004991,2011,51100223,,,,3,0,3
HND-004993,2011,51100226,,,,3,5,8
HND-004994,2011,51100239,,,,7,12,19
HND-004996,2011,51100247,,,,12,10,22
,2011,51100248,,,,10,9,19
,2011,51100267,,,,2,2,4
,2011,51100268,,,,3,2,5
,2011,51100273,,,,1,0,1
HND-005009,2011,51100298,,,,4,6,10
HND-004892,2011,51100005,,,,15,13,28
HND-004902,2011,51100016,,,,14,25,39
HND-004903,2011,51100017,,,,17,28,45
HND-004907,2011,51100021,,,,20,12,32
HND-004908,2011,51100022,,,,12,9,21
,2011,51100026,,,,11,17,28
,2011,51100041,,,,9,5,14
,2011,51100042,,,,15,27,42
,2011,51100043,,,,11,13,24
,2011,51100044,,,,6,8,14
,2011,51100048,,,,2,4,6
HND-004946,2011,51100086,,,,17,25,42
,2011,51100097,,,,14,13,27
,2011,51100120,,,,11,8,19
HND-004966,2011,51100132,,,,647,652,1299
,2011,51100152,,,,5,1,6
,2011,51100158,,,,28,49,77
,2011,51100163,,,,18,15,33
,2011,51100164,,,,23,29,52
,2011,51100209,,,,5,11,16
HND-004986,2011,51100214,,,,12,15,27
,2011,51100224,,,,12,15,27
,2011,51100230,,,,16,17,33
,2011,51100242,,,,3,2,5
,2011,51100248,,,,14,17,31
,2011,51100266,,,,62,52,114
,2011,51100268,,,,3,7,10
,2011,51100276,,,,123,155,278
,2011,51100277,,,,8,8,16
,2011,51100297,,,,21,29,50
HND-004890,2011,51100003,,,,35,31,66
HND-004893,2011,51100006,,,,19,25,44
HND-004905,2011,51100019,,,,46,46,92
HND-004923,2011,51100039,,,,9,22,31
HND-004925,2011,51100045,,,,242,207,449
HND-004926,2011,51100046,,,,116,99,215
,2011,51100125,,,,26,31,57
,2011,51100126,,,,10,16,26
,2011,51100127,,,,7,6,13
,2011,51100128,,,,9,6,15
,2011,51100130,,,,12,7,19
,2011,51100180,,,,3,8,11
,2011,51100216,,,,6,9,15
,2011,51100275,,,,7,4,11
,2011,51100292,,,,13,15,28
HND-004890,2011,51100003,,,,21,18,39
HND-004902,2011,51100016,,,,16,13,29
HND-004905,2011,51100019,,,,38,51,89
HND-004907,2011,51100021,,,,10,13,23
HND-004908,2011,51100022,,,,5,6,11
,2011,51100041,,,,1,2,3
,2011,51100043,,,,24,16,40
HND-004925,2011,51100045,,,,143,151,294
HND-004946,2011,51100086,,,,14,26,40
,2011,51100125,,,,27,45,72
,2011,51100127,,,,6,10,16
,2011,51100130,,,,6,7,13
,2011,51100158,,,,20,35,55
,2011,51100164,,,,21,20,41
,2011,51100180,,,,5,6,11
,2011,51100209,,,,4,9,13
HND-004986,2011,51100214,,,,1,5,6
,2011,51100216,,,,5,5,10
,2011,51100230,,,,14,17,31
,2011,51100292,,,,8,6,14
HND-004892,2011,51100005,,,,13,17,30
HND-004893,2011,51100006,,,,9,9,18
HND-004903,2011,51100017,,,,14,22,36
,2011,51100026,,,,2,2,4
HND-004923,2011,51100039,,,,23,16,39
,2011,51100042,,,,25,14,39
,2011,51100044,,,,9,6,15
HND-004926,2011,51100046,,,,63,74,137
,2011,51100048,,,,10,4,14
,2011,51100097,,,,17,14,31
,2011,51100120,,,,6,11,17
,2011,51100126,,,,8,12,20
HND-004966,2011,51100132,,,,458,587,1045
,2011,51100152,,,,0,3,3
,2011,51100163,,,,8,16,24
,2011,51100224,,,,12,18,30
,2011,51100242,,,,6,1,7
,2011,51100248,,,,10,7,17
,2011,51100266,,,,47,39,86
,2011,51100268,,,,3,3,6
,2011,51100276,,,,59,123,182
,2011,51100277,,,,3,1,4
HND-004890,2011,51100003,,,,21,16,37
HND-004892,2011,51100005,,,,7,7,14
HND-004902,2011,51100016,,,,12,10,22
HND-004903,2011,51100017,,,,11,24,35
HND-004905,2011,51100019,,,,37,33,70
HND-004907,2011,51100021,,,,11,11,22
HND-004908,2011,51100022,,,,6,9,15
HND-004923,2011,51100039,,,,11,13,24
,2011,51100041,,,,7,4,11
,2011,51100042,,,,25,20,45
,2011,51100043,,,,23,17,40
,2011,51100044,,,,9,4,13
,2011,51100048,,,,3,1,4
HND-004946,2011,51100086,,,,18,12,30
,2011,51100120,,,,13,8,21
HND-004966,2011,51100132,,,,441,499,940
,2011,51100163,,,,11,17,28
,2011,51100164,,,,16,33,49
,2011,51100180,,,,4,7,11
,2011,51100216,,,,3,7,10
,2011,51100224,,,,12,12,24
,2011,51100230,,,,8,13,21
,2011,51100276,,,,70,125,195
HND-004893,2011,51100006,,,,24,13,37
HND-004925,2011,51100045,,,,137,174,311
HND-004926,2011,51100046,,,,55,42,97
,2011,51100097,,,,9,16,25
,2011,51100125,,,,15,26,41
,2011,51100126,,,,7,11,18
,2011,51100127,,,,2,4,6
,2011,51100152,,,,3,1,4
,2011,51100158,,,,26,47,73
,2011,51100209,,,,1,3,4
,2011,51100242,,,,5,4,9
,2011,51100266,,,,28,21,49
,2011,51100268,,,,0,2,2
,2011,51100277,,,,1,4,5
,2011,51100292,,,,3,7,10
HND-004925,2011,51100045,,,,91,98,189
HND-004926,2011,51100046,,,,59,55,114
,2011,51100097,,,,9,12,21
,2011,51100120,,,,14,11,25
,2011,51100125,,,,27,39,66
,2011,51100126,,,,30,27,57
,2011,51100127,,,,4,0,4
,2011,51100158,,,,29,71,100
,2011,51100180,,,,1,4,5
,2011,51100242,,,,2,3,5
,2011,51100266,,,,12,19,31
,2011,51100276,,,,9,27,36
,2011,51100277,,,,1,1,2
,2011,51100042,,,,13,8,21
,2011,51100043,,,,23,33,56
HND-004966,2011,51100132,,,,503,838,1341
,2011,51100163,,,,8,11,19
,2011,51100164,,,,11,17,28
,2011,51100216,,,,4,3,7
,2011,51100224,,,,5,14,19
,2011,51100230,,,,8,17,25
HND-004925,2011,51100045,,,,39,101,140
HND-004926,2011,51100046,,,,38,38,76
,2011,51100097,,,,4,2,6
,2011,51100158,,,,12,72,84
,2011,51100163,,,,9,17,26
,2011,51100164,,,,33,43,76
,2011,51100180,,,,2,7,9
,2011,51100266,,,,21,23,44
,2011,51100277,,,,4,0,4
,2011,51100297,,,,16,33,49
,2011,51100042,,,,8,12,20
,2011,51100043,,,,44,48,92
,2011,51100120,,,,2,18,20
,2011,51100125,,,,33,58,91
,2011,51100126,,,,20,27,47
,2011,51100127,,,,3,0,3
HND-004966,2011,51100132,,,,317,480,797
,2011,51100216,,,,1,1,2
,2011,51100224,,,,10,10,20
,2011,51100230,,,,12,5,17
,2011,51100276,,,,144,191,335
,2011,51100043,,,,25,15,40
HND-004966,2011,51100132,,,,167,341,508
,2011,51100163,,,,8,14,22
,2011,51100164,,,,5,11,16
,2011,51100216,,,,4,4,8
,2011,51100224,,,,4,5,9
,2011,51100230,,,,4,2,6
HND-004925,2011,51100045,,,,45,79,124
HND-004926,2011,51100046,,,,20,41,61
,2011,51100097,,,,3,3,6
,2011,51100120,,,,3,11,14
,2011,51100125,,,,14,26,40
,2011,51100126,,,,11,11,22
,2011,51100158,,,,20,23,43
HND-005016,2011,51200006,,,,10,12,22
HND-005019,2011,51200009,,,,17,19,36
,2011,51200021,,,,4,9,13
HND-005023,2011,51200023,,,,5,6,11
HND-005026,2011,51200026,,,,31,35,66
HND-005038,2011,51200054,,,,6,4,10
,2011,51200065,,,,10,13,23
HND-005040,2011,51200069,,,,12,7,19
HND-005041,2011,51200077,,,,5,13,18
HND-005050,2011,51200112,,,,12,16,28
,2011,51200120,,,,5,6,11
,2011,51200151,,,,7,8,15
,2011,51200154,,,,19,13,32
HND-005031,2011,51200034,,,,6,9,15
HND-005033,2011,51200042,,,,26,27,53
HND-005039,2011,51200060,,,,4,1,5
,2011,51200071,,,,6,9,15
,2011,51200073,,,,18,18,36
HND-005042,2011,51200078,,,,10,11,21
HND-005043,2011,51200079,,,,3,6,9
HND-005046,2011,51200093,,,,18,17,35
,2011,51200115,,,,13,21,34
,2011,51200116,,,,5,10,15
,2011,51200117,,,,7,8,15
,2011,51200118,,,,15,15,30
,2011,51200119,,,,30,24,54
HND-005053,2011,51200149,,,,24,13,37
,2011,51200152,,,,8,10,18
,2011,51200153,,,,4,5,9
,2011,51200092,,,,12,17,29
,2011,51200139,,,,0,1,1
,2011,51200032,,,,0,1,1
,2011,51200070,,,,1,0,1
,2011,51200080,,,,5,1,6
,2011,51200091,,,,7,2,9
HND-005046,2011,51200093,,,,1,2,3
,2011,51200096,,,,6,0,6
,2011,51200097,,,,5,11,16
,2011,51200098,,,,6,6,12
,2011,51200128,,,,6,3,9
,2011,51200148,,,,3,2,5
,2011,51200155,,,,2,2,4
HND-005019,2011,51200009,,,,6,6,12
HND-005024,2011,51200024,,,,1,3,4
,2011,51200027,,,,4,1,5
,2011,51200031,,,,2,6,8
,2011,51200032,,,,7,3,10
,2011,51200038,,,,1,2,3
,2011,51200040,,,,2,1,3
,2011,51200051,,,,2,0,2
HND-005038,2011,51200054,,,,2,4,6
,2011,51200063,,,,6,3,9
,2011,51200074,,,,2,2,4
,2011,51200088,,,,2,1,3
,2011,51200091,,,,10,2,12
,2011,51200097,,,,12,9,21
,2011,51200100,,,,1,2,3
,2011,51200102,,,,5,17,22
HND-005048,2011,51200103,,,,3,6,9
,2011,51200104,,,,2,6,8
,2011,51200128,,,,2,6,8
HND-005051,2011,51200137,,,,0,3,3
,2011,51200139,,,,1,0,1
,2011,51200010,,,,1,2,3
HND-005020,2011,51200011,,,,12,7,19
,2011,51200039,,,,1,2,3
HND-005032,2011,51200041,,,,21,14,35
HND-005034,2011,51200043,,,,8,6,14
,2011,51200070,,,,4,0,4
,2011,51200080,,,,5,7,12
,2011,51200092,,,,10,16,26
HND-005046,2011,51200093,,,,2,3,5
,2011,51200096,,,,5,3,8
,2011,51200098,,,,8,5,13
,2011,51200101,,,,3,4,7
,2011,51200113,,,,12,10,22
,2011,51200141,,,,9,6,15
,2011,51200148,,,,0,1,1
,2011,51200150,,,,1,5,6
,2011,51200155,,,,6,8,14
HND-005020,2011,51200011,,,,23,20,43
,2011,51200038,,,,4,3,7
,2011,51200039,,,,7,5,12
HND-005032,2011,51200041,,,,53,31,84
HND-005034,2011,51200043,,,,11,16,27
,2011,51200070,,,,3,4,7
,2011,51200074,,,,6,5,11
,2011,51200080,,,,14,1,15
,2011,51200092,,,,9,9,18
HND-005046,2011,51200093,,,,17,15,32
,2011,51200096,,,,11,18,29
,2011,51200098,,,,12,5,17
,2011,51200113,,,,9,11,20
,2011,51200141,,,,22,15,37
,2011,51200148,,,,1,4,5
,2011,51200150,,,,7,7,14
,2011,51200155,,,,7,5,12
HND-005019,2011,51200009,,,,9,11,20
,2011,51200010,,,,2,0,2
HND-005024,2011,51200024,,,,12,11,23
,2011,51200027,,,,2,3,5
,2011,51200031,,,,8,10,18
,2011,51200032,,,,17,18,35
,2011,51200040,,,,2,1,3
,2011,51200051,,,,2,0,2
HND-005038,2011,51200054,,,,37,22,59
,2011,51200062,,,,13,11,24
,2011,51200063,,,,4,4,8
,2011,51200088,,,,10,8,18
,2011,51200091,,,,9,6,15
,2011,51200097,,,,14,16,30
,2011,51200100,,,,13,14,27
,2011,51200101,,,,8,8,16
,2011,51200102,,,,15,14,29
HND-005048,2011,51200103,,,,8,6,14
,2011,51200104,,,,4,2,6
HND-005049,2011,51200108,,,,36,31,67
,2011,51200128,,,,1,4,5
HND-005051,2011,51200137,,,,7,7,14
,2011,51200139,,,,1,3,4
HND-005014,2011,51200001,,,,32,37,69
HND-005016,2011,51200006,,,,13,12,25
HND-005017,2011,51200007,,,,16,15,31
HND-005020,2011,51200011,,,,41,43,84
HND-005021,2011,51200020,,,,10,11,21
HND-005022,2011,51200022,,,,2,8,10
HND-005025,2011,51200025,,,,52,44,96
HND-005026,2011,51200026,,,,23,27,50
HND-005027,2011,51200028,,,,22,20,42
,2011,51200031,,,,9,8,17
,2011,51200032,,,,18,15,33
HND-005030,2011,51200033,,,,7,1,8
HND-005031,2011,51200034,,,,7,5,12
,2011,51200038,,,,4,6,10
,2011,51200039,,,,5,5,10
HND-005035,2011,51200044,,,,28,20,48
,2011,51200051,,,,9,2,11
,2011,51200070,,,,4,5,9
,2011,51200074,,,,5,4,9
,2011,51200088,,,,13,17,30
,2011,51200091,,,,8,10,18
,2011,51200096,,,,15,6,21
,2011,51200097,,,,7,14,21
,2011,51200131,,,,8,7,15
,2011,51200141,,,,16,20,36
,2011,51200155,,,,7,3,10
HND-005015,2011,51200004,,,,8,4,12
HND-005018,2011,51200008,,,,9,6,15
HND-005019,2011,51200009,,,,55,48,103
,2011,51200010,,,,4,6,10
HND-005023,2011,51200023,,,,26,25,51
HND-005024,2011,51200024,,,,60,76,136
,2011,51200027,,,,7,8,15
HND-005028,2011,51200029,,,,33,27,60
HND-005029,2011,51200030,,,,10,6,16
,2011,51200035,,,,9,8,17
HND-005033,2011,51200042,,,,21,24,45
,2011,51200061,,,,3,2,5
HND-005044,2011,51200082,,,,2,5,7
HND-005046,2011,51200093,,,,20,20,40
HND-005047,2011,51200094,,,,5,7,12
,2011,51200098,,,,11,10,21
,2011,51200101,,,,22,13,35
HND-005049,2011,51200108,,,,79,67,146
HND-005050,2011,51200112,,,,40,24,64
,2011,51200116,,,,4,2,6
,2011,51200136,,,,5,4,9
,2011,51200150,,,,5,12,17
HND-005014,2011,51200001,,,,40,24,64
HND-005015,2011,51200004,,,,9,4,13
HND-005016,2011,51200006,,,,17,20,37
HND-005018,2011,51200008,,,,18,11,29
HND-005020,2011,51200011,,,,36,37,73
HND-005021,2011,51200020,,,,10,5,15
HND-005028,2011,51200029,,,,21,12,33
HND-005029,2011,51200030,,,,8,4,12
HND-005030,2011,51200033,,,,5,3,8
HND-005031,2011,51200034,,,,2,3,5
,2011,51200035,,,,7,3,10
,2011,51200038,,,,13,1,14
,2011,51200039,,,,9,8,17
HND-005033,2011,51200042,,,,24,22,46
,2011,51200070,,,,1,2,3
,2011,51200074,,,,3,2,5
HND-005044,2011,51200082,,,,6,3,9
HND-005046,2011,51200093,,,,32,25,57
HND-005047,2011,51200094,,,,4,3,7
,2011,51200096,,,,11,12,23
,2011,51200098,,,,10,5,15
,2011,51200136,,,,11,6,17
,2011,51200141,,,,18,20,38
,2011,51200150,,,,3,6,9
,2011,51200155,,,,4,4,8
HND-005017,2011,51200007,,,,10,13,23
HND-005019,2011,51200009,,,,34,51,85
,2011,51200010,,,,11,7,18
HND-005022,2011,51200022,,,,5,6,11
HND-005023,2011,51200023,,,,18,19,37
HND-005024,2011,51200024,,,,54,46,100
HND-005025,2011,51200025,,,,70,53,123
HND-005026,2011,51200026,,,,21,22,43
,2011,51200027,,,,7,7,14
HND-005027,2011,51200028,,,,14,11,25
,2011,51200031,,,,17,15,32
,2011,51200032,,,,18,13,31
HND-005035,2011,51200044,,,,23,22,45
,2011,51200051,,,,6,4,10
,2011,51200061,,,,4,1,5
,2011,51200088,,,,10,13,23
,2011,51200091,,,,2,10,12
,2011,51200097,,,,9,12,21
,2011,51200101,,,,22,17,39
HND-005049,2011,51200108,,,,74,59,133
HND-005050,2011,51200112,,,,27,21,48
,2011,51200116,,,,6,7,13
,2011,51200131,,,,10,2,12
HND-005015,2011,51200004,,,,1,5,6
HND-005018,2011,51200008,,,,4,10,14
HND-005019,2011,51200009,,,,30,25,55
,2011,51200010,,,,16,4,20
HND-005021,2011,51200020,,,,4,5,9
HND-005023,2011,51200023,,,,17,25,42
,2011,51200027,,,,12,9,21
HND-005028,2011,51200029,,,,19,18,37
HND-005029,2011,51200030,,,,7,1,8
HND-005031,2011,51200034,,,,3,6,9
,2011,51200035,,,,5,6,11
HND-005033,2011,51200042,,,,18,26,44
,2011,51200061,,,,3,1,4
HND-005044,2011,51200082,,,,2,2,4
HND-005046,2011,51200093,,,,28,26,54
HND-005047,2011,51200094,,,,4,4,8
,2011,51200096,,,,14,12,26
,2011,51200098,,,,11,6,17
,2011,51200101,,,,21,10,31
HND-005049,2011,51200108,,,,70,74,144
,2011,51200116,,,,7,7,14
,2011,51200136,,,,15,17,32
,2011,51200150,,,,1,2,3
HND-005014,2011,51200001,,,,38,30,68
HND-005016,2011,51200006,,,,19,19,38
HND-005017,2011,51200007,,,,14,6,20
HND-005020,2011,51200011,,,,49,56,105
HND-005022,2011,51200022,,,,2,3,5
HND-005024,2011,51200024,,,,78,60,138
HND-005025,2011,51200025,,,,71,72,143
HND-005026,2011,51200026,,,,16,22,38
HND-005027,2011,51200028,,,,13,10,23
,2011,51200031,,,,19,17,36
,2011,51200032,,,,16,18,34
HND-005030,2011,51200033,,,,7,3,10
,2011,51200038,,,,7,5,12
,2011,51200039,,,,5,11,16
HND-005035,2011,51200044,,,,24,26,50
,2011,51200051,,,,3,7,10
,2011,51200070,,,,4,3,7
,2011,51200074,,,,2,1,3
,2011,51200088,,,,7,3,10
,2011,51200091,,,,10,10,20
,2011,51200097,,,,17,19,36
HND-005050,2011,51200112,,,,37,32,69
,2011,51200131,,,,6,2,8
,2011,51200141,,,,16,15,31
,2011,51200155,,,,2,2,4
HND-005014,2011,51200001,,,,45,36,81
HND-005015,2011,51200004,,,,5,6,11
HND-005016,2011,51200006,,,,18,20,38
HND-005020,2011,51200011,,,,38,39,77
HND-005021,2011,51200020,,,,9,8,17
HND-005022,2011,51200022,,,,5,3,8
HND-005028,2011,51200029,,,,18,13,31
HND-005029,2011,51200030,,,,9,4,13
HND-005030,2011,51200033,,,,0,5,5
HND-005031,2011,51200034,,,,3,0,3
,2011,51200035,,,,4,2,6
,2011,51200038,,,,6,1,7
,2011,51200039,,,,9,15,24
HND-005033,2011,51200042,,,,17,23,40
,2011,51200070,,,,0,2,2
,2011,51200074,,,,1,1,2
,2011,51200091,,,,10,11,21
HND-005046,2011,51200093,,,,39,31,70
,2011,51200096,,,,9,11,20
,2011,51200097,,,,11,17,28
,2011,51200098,,,,13,11,24
,2011,51200131,,,,9,4,13
,2011,51200141,,,,22,22,44
,2011,51200155,,,,1,7,8
HND-005017,2011,51200007,,,,14,15,29
HND-005018,2011,51200008,,,,6,16,22
HND-005019,2011,51200009,,,,38,51,89
,2011,51200010,,,,11,9,20
HND-005023,2011,51200023,,,,32,17,49
HND-005024,2011,51200024,,,,61,58,119
HND-005025,2011,51200025,,,,65,56,121
HND-005026,2011,51200026,,,,15,19,34
,2011,51200027,,,,8,6,14
HND-005027,2011,51200028,,,,10,15,25
,2011,51200031,,,,15,12,27
,2011,51200032,,,,20,15,35
HND-005035,2011,51200044,,,,15,25,40
,2011,51200051,,,,4,3,7
,2011,51200061,,,,0,1,1
HND-005044,2011,51200082,,,,6,1,7
,2011,51200088,,,,2,2,4
HND-005047,2011,51200094,,,,11,9,20
,2011,51200101,,,,15,16,31
HND-005049,2011,51200108,,,,74,88,162
HND-005050,2011,51200112,,,,29,30,59
,2011,51200116,,,,1,2,3
,2011,51200136,,,,8,5,13
,2011,51200150,,,,2,4,6
HND-005014,2011,51200001,,,,30,14,44
HND-005016,2011,51200006,,,,20,11,31
HND-005017,2011,51200007,,,,17,13,30
HND-005020,2011,51200011,,,,53,60,113
HND-005021,2011,51200020,,,,4,13,17
HND-005022,2011,51200022,,,,6,4,10
HND-005025,2011,51200025,,,,63,81,144
HND-005027,2011,51200028,,,,16,13,29
,2011,51200032,,,,5,5,10
HND-005030,2011,51200033,,,,10,6,16
HND-005031,2011,51200034,,,,4,0,4
,2011,51200038,,,,5,2,7
,2011,51200039,,,,10,10,20
HND-005035,2011,51200044,,,,25,21,46
,2011,51200051,,,,4,5,9
,2011,51200070,,,,3,0,3
,2011,51200074,,,,3,2,5
,2011,51200091,,,,20,7,27
HND-005046,2011,51200093,,,,33,33,66
,2011,51200096,,,,13,14,27
,2011,51200097,,,,9,16,25
,2011,51200098,,,,7,9,16
,2011,51200136,,,,8,4,12
HND-005015,2011,51200004,,,,12,3,15
HND-005018,2011,51200008,,,,11,6,17
HND-005019,2011,51200009,,,,40,42,82
,2011,51200010,,,,12,8,20
HND-005023,2011,51200023,,,,24,24,48
HND-005024,2011,51200024,,,,64,56,120
HND-005026,2011,51200026,,,,16,16,32
,2011,51200027,,,,9,6,15
HND-005028,2011,51200029,,,,10,14,24
HND-005029,2011,51200030,,,,6,1,7
,2011,51200031,,,,16,12,28
,2011,51200035,,,,5,4,9
HND-005033,2011,51200042,,,,20,26,46
,2011,51200061,,,,2,1,3
HND-005044,2011,51200082,,,,1,2,3
,2011,51200088,,,,2,6,8
HND-005047,2011,51200094,,,,6,6,12
,2011,51200101,,,,15,23,38
HND-005049,2011,51200108,,,,94,111,205
HND-005050,2011,51200112,,,,46,30,76
,2011,51200116,,,,1,3,4
,2011,51200131,,,,7,6,13
,2011,51200141,,,,16,12,28
,2011,51200155,,,,2,0,2
HND-005017,2011,51200007,,,,11,8,19
HND-005019,2011,51200009,,,,40,35,75
,2011,51200010,,,,14,16,30
HND-005022,2011,51200022,,,,6,5,11
HND-005023,2011,51200023,,,,12,21,33
HND-005024,2011,51200024,,,,57,54,111
HND-005025,2011,51200025,,,,65,52,117
HND-005026,2011,51200026,,,,7,5,12
,2011,51200027,,,,12,4,16
HND-005027,2011,51200028,,,,15,8,23
,2011,51200031,,,,18,19,37
,2011,51200032,,,,12,18,30
HND-005035,2011,51200044,,,,20,12,32
,2011,51200051,,,,4,1,5
,2011,51200061,,,,6,1,7
,2011,51200088,,,,2,1,3
,2011,51200091,,,,7,12,19
,2011,51200097,,,,15,6,21
,2011,51200101,,,,16,15,31
HND-005049,2011,51200108,,,,54,47,101
HND-005050,2011,51200112,,,,35,23,58
,2011,51200116,,,,1,1,2
,2011,51200141,,,,7,11,18
HND-005014,2011,51200001,,,,36,33,69
HND-005015,2011,51200004,,,,2,6,8
HND-005016,2011,51200006,,,,17,13,30
HND-005018,2011,51200008,,,,8,6,14
HND-005020,2011,51200011,,,,47,43,90
HND-005021,2011,51200020,,,,10,7,17
HND-005028,2011,51200029,,,,7,10,17
HND-005029,2011,51200030,,,,4,6,10
HND-005030,2011,51200033,,,,5,3,8
HND-005031,2011,51200034,,,,3,6,9
,2011,51200035,,,,1,1,2
,2011,51200038,,,,5,1,6
,2011,51200039,,,,5,7,12
HND-005033,2011,51200042,,,,19,22,41
,2011,51200070,,,,0,1,1
,2011,51200074,,,,0,3,3
HND-005044,2011,51200082,,,,3,3,6
HND-005046,2011,51200093,,,,34,33,67
HND-005047,2011,51200094,,,,6,6,12
,2011,51200096,,,,10,7,17
,2011,51200098,,,,5,5,10
,2011,51200131,,,,5,3,8
HND-005014,2011,51200001,,,,26,29,55
HND-005016,2011,51200006,,,,32,28,60
HND-005017,2011,51200007,,,,6,10,16
,2011,51200039,,,,18,11,29
,2011,51200047,,,,35,27,62
,2011,51200067,,,,52,80,132
,2011,51200086,,,,166,158,324
HND-005045,2011,51200089,,,,96,32,128
,2011,51200096,,,,5,6,11
,2011,51200098,,,,6,8,14
,2011,51200139,,,,9,18,27
HND-005052,2011,51200147,,,,70,75,145
HND-005019,2011,51200009,,,,31,33,64
HND-005024,2011,51200024,,,,16,29,45
,2011,51200032,,,,3,6,9
,2011,51200048,,,,58,80,138
HND-005036,2011,51200049,,,,367,344,711
HND-005037,2011,51200050,,,,62,41,103
,2011,51200051,,,,3,5,8
,2011,51200091,,,,19,11,30
,2011,51200097,,,,14,13,27
,2011,51200141,,,,5,10,15
HND-005014,2011,51200001,,,,23,18,41
HND-005016,2011,51200006,,,,15,17,32
,2011,51200032,,,,5,7,12
,2011,51200039,,,,18,21,39
HND-005037,2011,51200050,,,,32,28,60
,2011,51200051,,,,12,3,15
,2011,51200067,,,,44,48,92
,2011,51200086,,,,129,159,288
HND-005045,2011,51200089,,,,67,32,99
,2011,51200091,,,,11,12,23
,2011,51200096,,,,4,4,8
,2011,51200097,,,,10,12,22
,2011,51200141,,,,6,3,9
HND-005052,2011,51200147,,,,77,61,138
HND-005017,2011,51200007,,,,8,10,18
HND-005019,2011,51200009,,,,30,38,68
HND-005024,2011,51200024,,,,15,11,26
,2011,51200047,,,,22,25,47
,2011,51200048,,,,40,62,102
HND-005036,2011,51200049,,,,209,283,492
,2011,51200098,,,,1,5,6
,2011,51200139,,,,13,8,21
HND-005014,2011,51200001,,,,8,15,23
HND-005016,2011,51200006,,,,13,15,28
,2011,51200032,,,,0,3,3
,2011,51200048,,,,45,35,80
HND-005036,2011,51200049,,,,230,270,500
HND-005037,2011,51200050,,,,25,29,54
,2011,51200051,,,,3,8,11
,2011,51200067,,,,46,60,106
,2011,51200097,,,,13,10,23
,2011,51200139,,,,5,6,11
HND-005017,2011,51200007,,,,5,4,9
HND-005019,2011,51200009,,,,24,26,50
HND-005024,2011,51200024,,,,7,12,19
,2011,51200039,,,,12,18,30
,2011,51200047,,,,22,24,46
,2011,51200086,,,,115,154,269
HND-005045,2011,51200089,,,,35,17,52
,2011,51200096,,,,7,4,11
,2011,51200098,,,,2,4,6
,2011,51200141,,,,3,8,11
HND-005052,2011,51200147,,,,42,66,108
,2011,51200039,,,,15,9,24
HND-005037,2011,51200050,,,,61,27,88
,2011,51200086,,,,102,119,221
HND-005045,2011,51200089,,,,26,30,56
,2011,51200097,,,,13,12,25
,2011,51200141,,,,4,9,13
HND-005052,2011,51200147,,,,19,15,34
,2011,51200047,,,,19,39,58
,2011,51200048,,,,47,47,94
HND-005036,2011,51200049,,,,229,335,564
,2011,51200051,,,,7,6,13
,2011,51200067,,,,26,57,83
,2011,51200139,,,,13,24,37
,2011,51200039,,,,10,10,20
,2011,51200047,,,,25,33,58
HND-005037,2011,51200050,,,,35,18,53
,2011,51200067,,,,24,31,55
,2011,51200086,,,,90,97,187
HND-005045,2011,51200089,,,,20,30,50
,2011,51200097,,,,9,7,16
,2011,51200141,,,,4,2,6
HND-005052,2011,51200147,,,,16,9,25
,2011,51200048,,,,25,53,78
HND-005036,2011,51200049,,,,227,350,577
,2011,51200051,,,,8,9,17
,2011,51200139,,,,11,19,30
,2011,51200048,,,,28,17,45
HND-005036,2011,51200049,,,,122,271,393
,2011,51200051,,,,4,2,6
,2011,51200139,,,,4,5,9
,2011,51200039,,,,7,2,9
,2011,51200047,,,,18,7,25
HND-005037,2011,51200050,,,,28,18,46
,2011,51200086,,,,50,130,180
HND-005045,2011,51200089,,,,7,12,19
HND-005052,2011,51200147,,,,19,9,28
HND-005117,2011,60100068,,,,0,7,7
HND-005215,2011,60100202,,,,7,3,10
,2011,60100283,,,,6,7,13
,2011,60100289,,,,2,3,5
,2011,60100294,,,,3,7,10
,2011,60100366,,,,3,14,17
HND-005249,2011,60100367,,,,5,9,14
,2011,60100369,,,,5,7,12
HND-005250,2011,60100370,,,,9,5,14
HND-005251,2011,60100371,,,,9,6,15
HND-005252,2011,60100380,,,,6,3,9
HND-005268,2011,60100427,,,,3,6,9
,2011,60100428,,,,11,9,20
HND-005270,2011,60100429,,,,12,21,33
,2011,60100436,,,,6,8,14
,2011,60100440,,,,9,8,17
,2011,60100443,,,,0,11,11
HND-005276,2011,60100444,,,,10,6,16
,2011,60100446,,,,3,7,10
,2011,60100454,,,,5,7,12
,2011,60100455,,,,7,9,16
HND-005071,2011,60100020,,,,7,7,14
HND-005231,2011,60100236,,,,5,8,13
,2011,60100285,,,,8,6,14
,2011,60100372,,,,7,8,15
,2011,60100373,,,,5,10,15
,2011,60100375,,,,6,6,12
,2011,60100381,,,,2,3,5
,2011,60100384,,,,7,8,15
HND-005253,2011,60100385,,,,9,5,14
HND-005258,2011,60100396,,,,13,10,23
,2011,60100430,,,,6,9,15
,2011,60100431,,,,6,9,15
,2011,60100434,,,,12,2,14
HND-005272,2011,60100437,,,,16,5,21
HND-005274,2011,60100439,,,,11,9,20
HND-005275,2011,60100441,,,,4,4,8
,2011,60100445,,,,7,5,12
,2011,60100448,,,,6,5,11
HND-005277,2011,60100449,,,,7,11,18
HND-005278,2011,60100451,,,,3,6,9
HND-005279,2011,60100452,,,,11,13,24
HND-005280,2011,60100453,,,,9,9,18
,2011,60100118,,,,4,3,7
,2011,60100195,,,,1,3,4
,2011,60100200,,,,1,5,6
,2011,60100263,,,,2,1,3
,2011,60100268,,,,4,3,7
HND-005255,2011,60100388,,,,1,2,3
,2011,60100389,,,,6,4,10
HND-005257,2011,60100395,,,,11,5,16
HND-005170,2011,60100138,,,,0,2,2
,2011,60100169,,,,1,1,2
,2011,60100266,,,,7,5,12
,2011,60100274,,,,0,1,1
,2011,60100276,,,,2,4,6
,2011,60100282,,,,0,1,1
,2011,60100316,,,,3,4,7
,2011,60100365,,,,8,0,8
HND-005254,2011,60100386,,,,6,4,10
HND-005256,2011,60100390,,,,6,0,6
,2011,60100394,,,,4,2,6
,2011,60100401,,,,4,5,9
,2011,60100411,,,,4,5,9
,2011,60100413,,,,7,2,9
HND-005273,2011,60100438,,,,4,0,4
,2011,60100450,,,,2,1,3
HND-005076,2011,60100025,,,,2,4,6
HND-005088,2011,60100038,,,,6,5,11
,2011,60100118,,,,0,7,7
HND-005183,2011,60100153,,,,8,4,12
HND-005185,2011,60100156,,,,69,67,136
HND-005186,2011,60100157,,,,15,20,35
HND-005188,2011,60100162,,,,7,12,19
HND-005189,2011,60100163,,,,10,10,20
HND-005190,2011,60100164,,,,12,7,19
,2011,60100167,,,,14,10,24
HND-005194,2011,60100172,,,,5,1,6
HND-005195,2011,60100173,,,,15,8,23
HND-005200,2011,60100178,,,,15,18,33
HND-005201,2011,60100180,,,,6,10,16
HND-005203,2011,60100182,,,,6,4,10
HND-005205,2011,60100184,,,,1,1,2
HND-005206,2011,60100185,,,,1,1,2
,2011,60100186,,,,6,4,10
HND-005207,2011,60100187,,,,1,2,3
,2011,60100203,,,,4,7,11
HND-005216,2011,60100205,,,,7,10,17
HND-005217,2011,60100207,,,,8,6,14
,2011,60100211,,,,2,2,4
HND-005221,2011,60100221,,,,10,5,15
HND-005225,2011,60100227,,,,13,21,34
HND-005228,2011,60100232,,,,10,10,20
HND-005229,2011,60100233,,,,4,5,9
HND-005234,2011,60100239,,,,4,5,9
,2011,60100244,,,,2,8,10
HND-005238,2011,60100245,,,,11,7,18
HND-005239,2011,60100247,,,,8,10,18
HND-005240,2011,60100248,,,,11,7,18
HND-005243,2011,60100251,,,,7,11,18
,2011,60100253,,,,11,12,23
,2011,60100255,,,,6,5,11
HND-005245,2011,60100258,,,,10,11,21
,2011,60100266,,,,6,4,10
,2011,60100268,,,,5,4,9
,2011,60100271,,,,1,1,2
,2011,60100276,,,,8,9,17
,2011,60100365,,,,6,8,14
HND-005255,2011,60100388,,,,2,2,4
HND-005256,2011,60100390,,,,12,0,12
,2011,60100394,,,,3,3,6
HND-005257,2011,60100395,,,,16,11,27
HND-005261,2011,60100404,,,,3,4,7
,2011,60100409,,,,5,5,10
,2011,60100414,,,,8,3,11
,2011,60100424,,,,5,9,14
HND-005267,2011,60100425,,,,3,4,7
,2011,60100426,,,,7,6,13
HND-005273,2011,60100438,,,,2,1,3
,2011,60100107,,,,9,4,13
,2011,60100119,,,,28,15,43
,2011,60100129,,,,5,2,7
HND-005170,2011,60100138,,,,2,1,3
HND-005181,2011,60100150,,,,1,2,3
,2011,60100158,,,,14,10,24
HND-005187,2011,60100160,,,,1,2,3
HND-005191,2011,60100165,,,,11,10,21
HND-005192,2011,60100168,,,,13,10,23
HND-005193,2011,60100170,,,,9,6,15
,2011,60100171,,,,2,2,4
HND-005196,2011,60100174,,,,8,3,11
HND-005197,2011,60100175,,,,9,19,28
HND-005198,2011,60100176,,,,2,3,5
HND-005199,2011,60100177,,,,18,15,33
,2011,60100179,,,,4,5,9
HND-005202,2011,60100181,,,,6,6,12
HND-005204,2011,60100183,,,,5,8,13
,2011,60100189,,,,3,1,4
HND-005208,2011,60100190,,,,5,4,9
HND-005209,2011,60100191,,,,11,10,21
HND-005210,2011,60100192,,,,8,14,22
HND-005211,2011,60100193,,,,1,0,1
,2011,60100195,,,,4,2,6
,2011,60100197,,,,2,3,5
,2011,60100200,,,,7,13,20
,2011,60100201,,,,5,2,7
,2011,60100204,,,,9,6,15
,2011,60100208,,,,7,4,11
HND-005219,2011,60100213,,,,1,3,4
,2011,60100215,,,,7,6,13
,2011,60100226,,,,7,8,15
,2011,60100228,,,,8,10,18
HND-005226,2011,60100230,,,,10,7,17
HND-005232,2011,60100237,,,,2,6,8
HND-005235,2011,60100240,,,,5,3,8
HND-005236,2011,60100241,,,,5,4,9
HND-005237,2011,60100243,,,,3,5,8
HND-005244,2011,60100252,,,,7,5,12
,2011,60100254,,,,4,2,6
HND-005246,2011,60100259,,,,3,8,11
,2011,60100260,,,,1,7,8
HND-005247,2011,60100261,,,,4,4,8
,2011,60100263,,,,1,2,3
,2011,60100274,,,,4,4,8
,2011,60100282,,,,2,2,4
,2011,60100316,,,,6,4,10
HND-005254,2011,60100386,,,,5,3,8
,2011,60100389,,,,4,6,10
,2011,60100401,,,,6,13,19
HND-005260,2011,60100403,,,,6,8,14
HND-005262,2011,60100405,,,,2,5,7
HND-005263,2011,60100407,,,,1,5,6
,2011,60100411,,,,6,13,19
,2011,60100413,,,,11,9,20
HND-005271,2011,60100432,,,,3,2,5
,2011,60100450,,,,5,0,5
,2011,60100107,,,,9,9,18
,2011,60100119,,,,14,21,35
,2011,60100129,,,,7,7,14
HND-005170,2011,60100138,,,,5,7,12
HND-005181,2011,60100150,,,,4,5,9
,2011,60100158,,,,16,12,28
HND-005187,2011,60100160,,,,8,5,13
HND-005188,2011,60100162,,,,31,22,53
HND-005191,2011,60100165,,,,11,13,24
HND-005192,2011,60100168,,,,20,11,31
HND-005194,2011,60100172,,,,10,10,20
HND-005196,2011,60100174,,,,8,4,12
HND-005199,2011,60100177,,,,18,20,38
,2011,60100179,,,,3,3,6
HND-005202,2011,60100181,,,,15,13,28
HND-005204,2011,60100183,,,,8,10,18
,2011,60100189,,,,3,8,11
HND-005208,2011,60100190,,,,17,12,29
HND-005209,2011,60100191,,,,20,20,40
HND-005211,2011,60100193,,,,8,7,15
,2011,60100195,,,,9,7,16
,2011,60100197,,,,7,3,10
,2011,60100200,,,,12,17,29
,2011,60100201,,,,7,7,14
,2011,60100208,,,,4,3,7
,2011,60100215,,,,6,3,9
HND-005225,2011,60100227,,,,22,20,42
,2011,60100228,,,,14,21,35
HND-005226,2011,60100230,,,,21,26,47
HND-005232,2011,60100237,,,,9,9,18
HND-005235,2011,60100240,,,,6,6,12
HND-005236,2011,60100241,,,,4,4,8
HND-005237,2011,60100243,,,,3,12,15
HND-005244,2011,60100252,,,,4,3,7
HND-005246,2011,60100259,,,,9,11,20
,2011,60100260,,,,10,5,15
HND-005247,2011,60100261,,,,6,3,9
,2011,60100263,,,,6,4,10
,2011,60100268,,,,6,3,9
,2011,60100274,,,,4,6,10
,2011,60100282,,,,3,9,12
HND-005254,2011,60100386,,,,6,16,22
,2011,60100389,,,,9,4,13
HND-005257,2011,60100395,,,,12,13,25
,2011,60100401,,,,15,16,31
HND-005260,2011,60100403,,,,5,11,16
HND-005263,2011,60100407,,,,5,5,10
,2011,60100409,,,,7,4,11
,2011,60100411,,,,15,16,31
,2011,60100413,,,,11,9,20
HND-005271,2011,60100432,,,,6,3,9
HND-005076,2011,60100025,,,,7,4,11
HND-005088,2011,60100038,,,,9,12,21
,2011,60100118,,,,5,1,6
HND-005183,2011,60100153,,,,1,5,6
HND-005185,2011,60100156,,,,117,134,251
HND-005186,2011,60100157,,,,60,47,107
HND-005189,2011,60100163,,,,17,13,30
HND-005190,2011,60100164,,,,11,5,16
,2011,60100167,,,,33,14,47
,2011,60100169,,,,6,6,12
HND-005193,2011,60100170,,,,17,8,25
,2011,60100171,,,,4,6,10
HND-005195,2011,60100173,,,,30,32,62
HND-005197,2011,60100175,,,,27,25,52
HND-005198,2011,60100176,,,,13,9,22
HND-005200,2011,60100178,,,,36,42,78
HND-005201,2011,60100180,,,,27,30,57
HND-005203,2011,60100182,,,,8,6,14
HND-005205,2011,60100184,,,,8,12,20
HND-005206,2011,60100185,,,,8,12,20
,2011,60100186,,,,9,2,11
HND-005207,2011,60100187,,,,6,8,14
HND-005210,2011,60100192,,,,17,4,21
,2011,60100203,,,,2,3,5
,2011,60100204,,,,25,25,50
HND-005216,2011,60100205,,,,11,11,22
HND-005217,2011,60100207,,,,27,30,57
,2011,60100211,,,,13,14,27
HND-005219,2011,60100213,,,,9,5,14
,2011,60100217,,,,12,9,21
HND-005221,2011,60100221,,,,14,5,19
,2011,60100226,,,,5,4,9
HND-005228,2011,60100232,,,,21,9,30
HND-005229,2011,60100233,,,,6,3,9
HND-005234,2011,60100239,,,,5,5,10
,2011,60100244,,,,2,3,5
HND-005238,2011,60100245,,,,13,9,22
HND-005239,2011,60100247,,,,18,17,35
HND-005240,2011,60100248,,,,16,25,41
HND-005243,2011,60100251,,,,16,8,24
,2011,60100253,,,,14,23,37
,2011,60100254,,,,10,8,18
,2011,60100255,,,,7,3,10
HND-005245,2011,60100258,,,,14,11,25
,2011,60100266,,,,2,7,9
,2011,60100271,,,,3,8,11
,2011,60100276,,,,8,10,18
,2011,60100316,,,,7,3,10
,2011,60100365,,,,8,2,10
HND-005255,2011,60100388,,,,2,2,4
HND-005256,2011,60100390,,,,16,0,16
,2011,60100394,,,,3,2,5
HND-005261,2011,60100404,,,,5,7,12
HND-005262,2011,60100405,,,,5,8,13
HND-005264,2011,60100408,,,,11,11,22
,2011,60100414,,,,4,6,10
,2011,60100424,,,,3,3,6
HND-005267,2011,60100425,,,,3,7,10
,2011,60100426,,,,2,2,4
HND-005273,2011,60100438,,,,2,6,8
,2011,60100450,,,,3,3,6
,2011,60100002,,,,14,18,32
,2011,60100003,,,,2,1,3
HND-005056,2011,60100004,,,,8,3,11
HND-005059,2011,60100007,,,,3,5,8
HND-005060,2011,60100009,,,,7,7,14
HND-005062,2011,60100011,,,,5,10,15
HND-005063,2011,60100012,,,,4,3,7
HND-005064,2011,60100013,,,,4,2,6
HND-005069,2011,60100018,,,,8,4,12
HND-005070,2011,60100019,,,,2,3,5
HND-005071,2011,60100020,,,,2,3,5
HND-005072,2011,60100021,,,,7,8,15
HND-005076,2011,60100025,,,,4,1,5
HND-005077,2011,60100026,,,,14,10,24
HND-005081,2011,60100030,,,,1,7,8
HND-005082,2011,60100031,,,,9,6,15
HND-005083,2011,60100032,,,,2,1,3
HND-005084,2011,60100033,,,,5,3,8
HND-005088,2011,60100038,,,,13,7,20
HND-005089,2011,60100039,,,,8,8,16
HND-005090,2011,60100040,,,,2,1,3
HND-005093,2011,60100044,,,,3,0,3
HND-005098,2011,60100049,,,,2,3,5
HND-005101,2011,60100052,,,,12,13,25
HND-005103,2011,60100054,,,,1,2,3
HND-005104,2011,60100055,,,,2,1,3
,2011,60100056,,,,18,10,28
HND-005106,2011,60100057,,,,5,2,7
HND-005107,2011,60100058,,,,56,53,109
HND-005110,2011,60100061,,,,4,4,8
HND-005111,2011,60100062,,,,4,3,7
HND-005112,2011,60100063,,,,9,7,16
HND-005120,2011,60100071,,,,71,62,133
HND-005121,2011,60100072,,,,21,12,33
HND-005123,2011,60100074,,,,12,8,20
HND-005126,2011,60100077,,,,5,5,10
HND-005128,2011,60100079,,,,4,7,11
HND-005131,2011,60100083,,,,18,12,30
HND-005133,2011,60100085,,,,3,1,4
HND-005134,2011,60100086,,,,3,6,9
HND-005135,2011,60100087,,,,6,7,13
HND-005136,2011,60100088,,,,2,5,7
,2011,60100089,,,,30,25,55
,2011,60100090,,,,3,3,6
HND-005137,2011,60100092,,,,8,9,17
HND-005143,2011,60100098,,,,11,9,20
HND-005144,2011,60100099,,,,4,13,17
HND-005146,2011,60100102,,,,8,10,18
HND-005147,2011,60100103,,,,15,14,29
HND-005150,2011,60100106,,,,4,5,9
HND-005151,2011,60100109,,,,41,47,88
HND-005152,2011,60100110,,,,13,8,21
HND-005153,2011,60100111,,,,1,4,5
HND-005154,2011,60100112,,,,18,14,32
HND-005158,2011,60100116,,,,2,3,5
HND-005159,2011,60100117,,,,7,7,14
,2011,60100118,,,,3,2,5
HND-005162,2011,60100124,,,,0,5,5
HND-005163,2011,60100125,,,,9,7,16
,2011,60100126,,,,6,7,13
,2011,60100127,,,,25,12,37
HND-005166,2011,60100133,,,,25,18,43
HND-005168,2011,60100136,,,,25,20,45
HND-005169,2011,60100137,,,,20,22,42
HND-005170,2011,60100138,,,,31,23,54
HND-005175,2011,60100143,,,,58,33,91
HND-005176,2011,60100144,,,,71,38,109
HND-005178,2011,60100146,,,,14,11,25
HND-005180,2011,60100148,,,,8,7,15
HND-005184,2011,60100155,,,,3,6,9
HND-005222,2011,60100222,,,,9,8,17
HND-005223,2011,60100223,,,,7,4,11
HND-005224,2011,60100224,,,,1,1,2
,2011,60100229,,,,13,8,21
HND-005230,2011,60100234,,,,4,4,8
HND-005233,2011,60100238,,,,46,32,78
HND-005242,2011,60100250,,,,63,48,111
,2011,60100271,,,,3,5,8
HND-005248,2011,60100275,,,,6,2,8
HND-005259,2011,60100397,,,,20,27,47
,2011,60100413,,,,7,10,17
HND-005054,2011,60100001,,,,3,6,9
HND-005057,2011,60100005,,,,25,10,35
HND-005058,2011,60100006,,,,23,17,40
HND-005061,2011,60100010,,,,25,23,48
HND-005065,2011,60100014,,,,6,2,8
HND-005066,2011,60100015,,,,3,1,4
HND-005067,2011,60100016,,,,5,5,10
,2011,60100017,,,,9,7,16
HND-005073,2011,60100022,,,,2,3,5
HND-005074,2011,60100023,,,,1,4,5
HND-005075,2011,60100024,,,,8,4,12
HND-005078,2011,60100027,,,,20,13,33
HND-005079,2011,60100028,,,,50,52,102
HND-005080,2011,60100029,,,,14,6,20
HND-005085,2011,60100034,,,,3,4,7
HND-005086,2011,60100035,,,,7,5,12
HND-005087,2011,60100036,,,,3,3,6
,2011,60100037,,,,10,13,23
HND-005091,2011,60100041,,,,20,23,43
HND-005094,2011,60100045,,,,16,14,30
HND-005095,2011,60100046,,,,2,4,6
HND-005096,2011,60100047,,,,2,4,6
HND-005097,2011,60100048,,,,8,7,15
HND-005099,2011,60100050,,,,3,4,7
HND-005100,2011,60100051,,,,11,8,19
HND-005102,2011,60100053,,,,2,3,5
HND-005108,2011,60100059,,,,1,4,5
HND-005109,2011,60100060,,,,36,24,60
,2011,60100064,,,,13,7,20
HND-005114,2011,60100065,,,,10,2,12
HND-005115,2011,60100066,,,,3,3,6
HND-005116,2011,60100067,,,,17,6,23
HND-005117,2011,60100068,,,,3,2,5
HND-005119,2011,60100070,,,,4,9,13
HND-005122,2011,60100073,,,,10,14,24
HND-005124,2011,60100075,,,,8,7,15
HND-005125,2011,60100076,,,,8,8,16
HND-005127,2011,60100078,,,,9,10,19
HND-005129,2011,60100080,,,,7,7,14
HND-005130,2011,60100081,,,,5,6,11
HND-005132,2011,60100084,,,,6,6,12
,2011,60100091,,,,18,15,33
HND-005138,2011,60100093,,,,43,45,88
HND-005139,2011,60100094,,,,3,1,4
HND-005140,2011,60100095,,,,4,3,7
HND-005141,2011,60100096,,,,2,3,5
HND-005142,2011,60100097,,,,3,0,3
HND-005145,2011,60100101,,,,1,2,3
HND-005148,2011,60100104,,,,5,5,10
HND-005149,2011,60100105,,,,55,55,110
,2011,60100107,,,,20,14,34
HND-005155,2011,60100113,,,,21,10,31
HND-005156,2011,60100114,,,,35,29,64
HND-005157,2011,60100115,,,,41,35,76
,2011,60100119,,,,24,27,51
HND-005160,2011,60100122,,,,11,6,17
HND-005161,2011,60100123,,,,6,7,13
,2011,60100129,,,,12,15,27
HND-005164,2011,60100130,,,,9,7,16
HND-005165,2011,60100131,,,,4,3,7
,2011,60100132,,,,3,2,5
HND-005167,2011,60100135,,,,3,4,7
HND-005171,2011,60100139,,,,80,74,154
HND-005172,2011,60100140,,,,42,42,84
HND-005173,2011,60100141,,,,39,37,76
HND-005174,2011,60100142,,,,16,13,29
HND-005177,2011,60100145,,,,86,109,195
,2011,60100147,,,,3,3,6
HND-005182,2011,60100152,,,,4,2,6
HND-005183,2011,60100153,,,,4,5,9
,2011,60100158,,,,21,21,42
,2011,60100169,,,,10,5,15
,2011,60100171,,,,6,7,13
,2011,60100197,,,,6,6,12
,2011,60100200,,,,16,14,30
HND-005218,2011,60100209,,,,5,4,9
,2011,60100218,,,,7,9,16
HND-005220,2011,60100219,,,,1,4,5
HND-005221,2011,60100221,,,,10,9,19
HND-005226,2011,60100230,,,,44,43,87
HND-005227,2011,60100231,,,,5,7,12
HND-005241,2011,60100249,,,,13,11,24
HND-005245,2011,60100258,,,,21,18,39
,2011,60100274,,,,4,5,9
,2011,60100401,,,,26,24,50
,2011,60100411,,,,26,24,50
,2011,60100412,,,,10,5,15
,2011,60100416,,,,24,14,38
HND-005266,2011,60100420,,,,8,4,12
,2011,60100450,,,,4,9,13
HND-005056,2011,60100004,,,,7,13,20
HND-005057,2011,60100005,,,,14,16,30
HND-005058,2011,60100006,,,,26,21,47
HND-005059,2011,60100007,,,,4,10,14
HND-005063,2011,60100012,,,,7,1,8
HND-005064,2011,60100013,,,,2,5,7
HND-005065,2011,60100014,,,,8,5,13
,2011,60100017,,,,7,6,13
HND-005070,2011,60100019,,,,1,8,9
HND-005071,2011,60100020,,,,8,9,17
HND-005072,2011,60100021,,,,9,12,21
HND-005073,2011,60100022,,,,0,1,1
HND-005074,2011,60100023,,,,3,2,5
HND-005080,2011,60100029,,,,10,6,16
HND-005083,2011,60100032,,,,2,2,4
HND-005084,2011,60100033,,,,3,3,6
HND-005085,2011,60100034,,,,0,4,4
,2011,60100037,,,,4,12,16
HND-005089,2011,60100039,,,,6,4,10
HND-005091,2011,60100041,,,,11,14,25
HND-005093,2011,60100044,,,,2,4,6
HND-005094,2011,60100045,,,,13,11,24
HND-005095,2011,60100046,,,,8,2,10
HND-005096,2011,60100047,,,,1,4,5
HND-005099,2011,60100050,,,,4,1,5
HND-005100,2011,60100051,,,,9,7,16
HND-005101,2011,60100052,,,,17,16,33
HND-005102,2011,60100053,,,,2,2,4
HND-005104,2011,60100055,,,,4,2,6
,2011,60100056,,,,18,12,30
HND-005111,2011,60100062,,,,3,3,6
,2011,60100064,,,,12,12,24
HND-005115,2011,60100066,,,,3,3,6
HND-005116,2011,60100067,,,,18,10,28
HND-005120,2011,60100071,,,,54,31,85
HND-005124,2011,60100075,,,,5,4,9
HND-005125,2011,60100076,,,,7,10,17
HND-005126,2011,60100077,,,,10,6,16
HND-005127,2011,60100078,,,,1,15,16
HND-005129,2011,60100080,,,,5,9,14
HND-005130,2011,60100081,,,,4,5,9
HND-005131,2011,60100083,,,,15,12,27
HND-005136,2011,60100088,,,,4,6,10
,2011,60100089,,,,29,22,51
,2011,60100091,,,,21,16,37
HND-005137,2011,60100092,,,,6,6,12
HND-005139,2011,60100094,,,,2,6,8
HND-005142,2011,60100097,,,,3,3,6
HND-005144,2011,60100099,,,,7,2,9
HND-005148,2011,60100104,,,,7,9,16
HND-005149,2011,60100105,,,,39,56,95
,2011,60100107,,,,27,18,45
HND-005152,2011,60100110,,,,11,23,34
HND-005155,2011,60100113,,,,14,8,22
HND-005156,2011,60100114,,,,29,23,52
,2011,60100119,,,,32,24,56
HND-005160,2011,60100122,,,,9,4,13
HND-005161,2011,60100123,,,,3,6,9
HND-005163,2011,60100125,,,,4,9,13
,2011,60100129,,,,15,17,32
HND-005164,2011,60100130,,,,15,11,26
HND-005165,2011,60100131,,,,3,4,7
HND-005167,2011,60100135,,,,3,5,8
HND-005170,2011,60100138,,,,28,26,54
HND-005171,2011,60100139,,,,82,62,144
HND-005172,2011,60100140,,,,55,33,88
HND-005173,2011,60100141,,,,32,33,65
HND-005176,2011,60100144,,,,46,60,106
HND-005177,2011,60100145,,,,105,99,204
HND-005182,2011,60100152,,,,4,3,7
HND-005184,2011,60100155,,,,4,2,6
,2011,60100158,,,,16,14,30
,2011,60100197,,,,5,2,7
,2011,60100200,,,,12,15,27
,2011,60100218,,,,12,10,22
HND-005220,2011,60100219,,,,4,1,5
HND-005226,2011,60100230,,,,30,40,70
HND-005230,2011,60100234,,,,6,8,14
HND-005241,2011,60100249,,,,14,4,18
HND-005245,2011,60100258,,,,13,12,25
,2011,60100274,,,,5,4,9
,2011,60100401,,,,27,21,48
,2011,60100411,,,,27,21,48
,2011,60100412,,,,8,7,15
,2011,60100413,,,,8,10,18
HND-005054,2011,60100001,,,,4,2,6
,2011,60100002,,,,16,8,24
,2011,60100003,,,,0,1,1
HND-005060,2011,60100009,,,,3,2,5
HND-005061,2011,60100010,,,,14,15,29
HND-005062,2011,60100011,,,,8,3,11
HND-005066,2011,60100015,,,,4,1,5
HND-005067,2011,60100016,,,,4,8,12
HND-005069,2011,60100018,,,,5,9,14
HND-005075,2011,60100024,,,,2,5,7
HND-005076,2011,60100025,,,,0,3,3
HND-005077,2011,60100026,,,,8,9,17
HND-005078,2011,60100027,,,,14,15,29
HND-005079,2011,60100028,,,,36,39,75
HND-005081,2011,60100030,,,,1,7,8
HND-005082,2011,60100031,,,,7,8,15
HND-005086,2011,60100035,,,,6,2,8
HND-005087,2011,60100036,,,,5,3,8
HND-005088,2011,60100038,,,,11,16,27
HND-005090,2011,60100040,,,,3,3,6
HND-005092,2011,60100043,,,,3,2,5
HND-005097,2011,60100048,,,,5,2,7
HND-005098,2011,60100049,,,,7,4,11
HND-005103,2011,60100054,,,,2,0,2
HND-005106,2011,60100057,,,,7,4,11
HND-005107,2011,60100058,,,,59,34,93
HND-005108,2011,60100059,,,,1,0,1
HND-005109,2011,60100060,,,,32,25,57
HND-005110,2011,60100061,,,,3,3,6
HND-005112,2011,60100063,,,,12,5,17
HND-005114,2011,60100065,,,,5,13,18
HND-005117,2011,60100068,,,,3,4,7
HND-005118,2011,60100069,,,,1,2,3
HND-005119,2011,60100070,,,,4,4,8
HND-005121,2011,60100072,,,,25,15,40
HND-005122,2011,60100073,,,,14,11,25
HND-005123,2011,60100074,,,,21,10,31
HND-005128,2011,60100079,,,,1,2,3
HND-005132,2011,60100084,,,,3,6,9
HND-005133,2011,60100085,,,,3,2,5
HND-005134,2011,60100086,,,,1,0,1
HND-005135,2011,60100087,,,,5,8,13
,2011,60100090,,,,5,5,10
HND-005138,2011,60100093,,,,37,40,77
HND-005140,2011,60100095,,,,1,4,5
HND-005141,2011,60100096,,,,6,4,10
HND-005143,2011,60100098,,,,10,11,21
HND-005145,2011,60100101,,,,1,8,9
HND-005146,2011,60100102,,,,6,6,12
HND-005147,2011,60100103,,,,17,15,32
HND-005150,2011,60100106,,,,9,7,16
HND-005151,2011,60100109,,,,38,30,68
HND-005153,2011,60100111,,,,1,3,4
HND-005154,2011,60100112,,,,10,13,23
HND-005157,2011,60100115,,,,29,28,57
HND-005158,2011,60100116,,,,2,2,4
HND-005159,2011,60100117,,,,8,8,16
,2011,60100118,,,,1,1,2
HND-005162,2011,60100124,,,,1,0,1
,2011,60100126,,,,10,10,20
,2011,60100127,,,,20,19,39
,2011,60100132,,,,3,6,9
HND-005166,2011,60100133,,,,17,6,23
HND-005168,2011,60100136,,,,18,26,44
HND-005169,2011,60100137,,,,13,18,31
HND-005174,2011,60100142,,,,15,17,32
HND-005175,2011,60100143,,,,42,33,75
HND-005178,2011,60100146,,,,20,15,35
,2011,60100147,,,,3,4,7
HND-005180,2011,60100148,,,,10,9,19
HND-005183,2011,60100153,,,,2,5,7
,2011,60100171,,,,10,10,20
HND-005218,2011,60100209,,,,1,4,5
HND-005221,2011,60100221,,,,6,6,12
HND-005222,2011,60100222,,,,4,11,15
HND-005223,2011,60100223,,,,2,2,4
HND-005224,2011,60100224,,,,0,2,2
,2011,60100229,,,,2,6,8
HND-005227,2011,60100231,,,,9,2,11
HND-005233,2011,60100238,,,,59,26,85
HND-005242,2011,60100250,,,,55,62,117
,2011,60100271,,,,2,3,5
HND-005248,2011,60100275,,,,5,11,16
HND-005259,2011,60100397,,,,16,15,31
,2011,60100416,,,,21,9,30
HND-005265,2011,60100419,,,,1,3,4
HND-005266,2011,60100420,,,,7,7,14
,2011,60100450,,,,8,10,18
HND-005054,2011,60100001,,,,1,6,7
HND-005057,2011,60100005,,,,28,12,40
HND-005058,2011,60100006,,,,21,7,28
HND-005059,2011,60100007,,,,4,7,11
HND-005061,2011,60100010,,,,20,20,40
HND-005065,2011,60100014,,,,0,3,3
HND-005066,2011,60100015,,,,6,2,8
HND-005067,2011,60100016,,,,12,8,20
,2011,60100017,,,,6,6,12
HND-005071,2011,60100020,,,,4,2,6
HND-005073,2011,60100022,,,,7,5,12
HND-005074,2011,60100023,,,,1,0,1
HND-005075,2011,60100024,,,,4,5,9
HND-005079,2011,60100028,,,,43,44,87
HND-005080,2011,60100029,,,,8,9,17
HND-005085,2011,60100034,,,,3,2,5
HND-005086,2011,60100035,,,,2,6,8
HND-005087,2011,60100036,,,,3,2,5
,2011,60100037,,,,10,7,17
HND-005091,2011,60100041,,,,30,14,44
HND-005093,2011,60100044,,,,4,2,6
HND-005094,2011,60100045,,,,17,13,30
HND-005095,2011,60100046,,,,4,2,6
HND-005096,2011,60100047,,,,5,3,8
HND-005097,2011,60100048,,,,1,5,6
HND-005099,2011,60100050,,,,6,4,10
HND-005100,2011,60100051,,,,6,8,14
HND-005101,2011,60100052,,,,11,14,25
HND-005102,2011,60100053,,,,2,0,2
HND-005108,2011,60100059,,,,1,2,3
HND-005109,2011,60100060,,,,27,26,53
,2011,60100064,,,,13,1,14
HND-005114,2011,60100065,,,,6,9,15
HND-005115,2011,60100066,,,,1,1,2
HND-005116,2011,60100067,,,,12,15,27
HND-005119,2011,60100070,,,,4,7,11
HND-005124,2011,60100075,,,,7,3,10
HND-005125,2011,60100076,,,,7,11,18
HND-005127,2011,60100078,,,,4,9,13
HND-005129,2011,60100080,,,,6,4,10
HND-005130,2011,60100081,,,,8,3,11
HND-005136,2011,60100088,,,,7,5,12
,2011,60100091,,,,14,21,35
HND-005138,2011,60100093,,,,46,40,86
HND-005139,2011,60100094,,,,5,4,9
HND-005140,2011,60100095,,,,2,3,5
HND-005141,2011,60100096,,,,0,5,5
HND-005142,2011,60100097,,,,5,2,7
HND-005145,2011,60100101,,,,1,3,4
HND-005148,2011,60100104,,,,14,7,21
HND-005149,2011,60100105,,,,50,40,90
,2011,60100107,,,,34,20,54
HND-005155,2011,60100113,,,,17,19,36
HND-005156,2011,60100114,,,,30,24,54
HND-005157,2011,60100115,,,,39,34,73
,2011,60100119,,,,26,14,40
HND-005160,2011,60100122,,,,3,5,8
HND-005161,2011,60100123,,,,3,4,7
,2011,60100129,,,,18,16,34
HND-005164,2011,60100130,,,,6,8,14
HND-005165,2011,60100131,,,,3,1,4
,2011,60100132,,,,2,3,5
HND-005167,2011,60100135,,,,4,6,10
HND-005170,2011,60100138,,,,26,22,48
HND-005171,2011,60100139,,,,60,85,145
HND-005172,2011,60100140,,,,36,36,72
HND-005173,2011,60100141,,,,34,29,63
HND-005174,2011,60100142,,,,23,19,42
HND-005177,2011,60100145,,,,92,88,180
HND-005182,2011,60100152,,,,4,3,7
HND-005183,2011,60100153,,,,4,2,6
,2011,60100158,,,,32,29,61
,2011,60100169,,,,3,10,13
,2011,60100171,,,,9,9,18
,2011,60100197,,,,2,6,8
,2011,60100200,,,,13,16,29
,2011,60100218,,,,13,3,16
HND-005220,2011,60100219,,,,4,3,7
HND-005221,2011,60100221,,,,8,7,15
HND-005226,2011,60100230,,,,51,37,88
HND-005227,2011,60100231,,,,3,10,13
HND-005241,2011,60100249,,,,8,7,15
HND-005245,2011,60100258,,,,12,16,28
,2011,60100274,,,,4,5,9
,2011,60100401,,,,19,13,32
,2011,60100411,,,,19,13,32
,2011,60100412,,,,10,5,15
,2011,60100413,,,,12,4,16
,2011,60100416,,,,11,14,25
HND-005266,2011,60100420,,,,8,7,15
,2011,60100002,,,,10,13,23
HND-005056,2011,60100004,,,,8,5,13
HND-005060,2011,60100009,,,,3,4,7
HND-005062,2011,60100011,,,,8,5,13
HND-005063,2011,60100012,,,,8,6,14
HND-005064,2011,60100013,,,,3,5,8
HND-005069,2011,60100018,,,,8,7,15
HND-005070,2011,60100019,,,,2,5,7
HND-005072,2011,60100021,,,,8,5,13
HND-005076,2011,60100025,,,,2,5,7
HND-005077,2011,60100026,,,,11,7,18
HND-005078,2011,60100027,,,,17,8,25
HND-005081,2011,60100030,,,,5,3,8
HND-005082,2011,60100031,,,,8,8,16
HND-005083,2011,60100032,,,,2,1,3
HND-005084,2011,60100033,,,,3,1,4
HND-005088,2011,60100038,,,,14,10,24
HND-005089,2011,60100039,,,,8,1,9
HND-005090,2011,60100040,,,,1,2,3
HND-005092,2011,60100043,,,,1,2,3
HND-005098,2011,60100049,,,,1,6,7
HND-005103,2011,60100054,,,,1,1,2
HND-005104,2011,60100055,,,,2,2,4
,2011,60100056,,,,14,10,24
HND-005106,2011,60100057,,,,5,7,12
HND-005107,2011,60100058,,,,42,56,98
HND-005110,2011,60100061,,,,1,4,5
HND-005111,2011,60100062,,,,5,2,7
HND-005112,2011,60100063,,,,9,10,19
HND-005117,2011,60100068,,,,3,4,7
HND-005118,2011,60100069,,,,0,1,1
HND-005120,2011,60100071,,,,60,38,98
HND-005121,2011,60100072,,,,14,6,20
HND-005122,2011,60100073,,,,3,7,10
HND-005123,2011,60100074,,,,10,8,18
HND-005126,2011,60100077,,,,4,6,10
HND-005128,2011,60100079,,,,1,1,2
HND-005131,2011,60100083,,,,13,10,23
HND-005132,2011,60100084,,,,3,4,7
HND-005133,2011,60100085,,,,4,2,6
HND-005134,2011,60100086,,,,2,2,4
HND-005135,2011,60100087,,,,6,12,18
,2011,60100089,,,,28,28,56
,2011,60100090,,,,10,6,16
HND-005137,2011,60100092,,,,2,3,5
HND-005143,2011,60100098,,,,8,11,19
HND-005144,2011,60100099,,,,6,1,7
HND-005146,2011,60100102,,,,3,2,5
HND-005147,2011,60100103,,,,31,25,56
HND-005150,2011,60100106,,,,8,9,17
HND-005151,2011,60100109,,,,45,46,91
HND-005152,2011,60100110,,,,13,4,17
HND-005153,2011,60100111,,,,3,3,6
HND-005154,2011,60100112,,,,21,8,29
HND-005158,2011,60100116,,,,4,1,5
HND-005159,2011,60100117,,,,7,7,14
,2011,60100118,,,,3,5,8
HND-005162,2011,60100124,,,,3,4,7
HND-005163,2011,60100125,,,,7,6,13
,2011,60100126,,,,9,9,18
,2011,60100127,,,,20,20,40
HND-005166,2011,60100133,,,,20,17,37
HND-005168,2011,60100136,,,,24,25,49
HND-005169,2011,60100137,,,,16,17,33
HND-005175,2011,60100143,,,,48,31,79
HND-005176,2011,60100144,,,,54,65,119
HND-005178,2011,60100146,,,,15,13,28
,2011,60100147,,,,8,6,14
HND-005180,2011,60100148,,,,1,11,12
HND-005184,2011,60100155,,,,2,2,4
HND-005218,2011,60100209,,,,3,0,3
HND-005222,2011,60100222,,,,4,11,15
HND-005223,2011,60100223,,,,4,1,5
HND-005224,2011,60100224,,,,1,2,3
,2011,60100229,,,,9,5,14
HND-005230,2011,60100234,,,,3,4,7
HND-005233,2011,60100238,,,,52,38,90
HND-005242,2011,60100250,,,,65,47,112
,2011,60100271,,,,1,5,6
HND-005248,2011,60100275,,,,2,5,7
HND-005259,2011,60100397,,,,17,19,36
HND-005265,2011,60100419,,,,1,6,7
HND-005056,2011,60100004,,,,13,6,19
HND-005057,2011,60100005,,,,9,11,20
HND-005058,2011,60100006,,,,16,13,29
HND-005059,2011,60100007,,,,10,5,15
HND-005063,2011,60100012,,,,5,7,12
HND-005064,2011,60100013,,,,3,1,4
HND-005065,2011,60100014,,,,2,5,7
HND-005070,2011,60100019,,,,4,2,6
HND-005071,2011,60100020,,,,7,9,16
HND-005072,2011,60100021,,,,6,14,20
HND-005073,2011,60100022,,,,7,5,12
HND-005074,2011,60100023,,,,2,3,5
HND-005080,2011,60100029,,,,7,10,17
HND-005081,2011,60100030,,,,1,7,8
HND-005083,2011,60100032,,,,1,4,5
HND-005084,2011,60100033,,,,5,4,9
HND-005085,2011,60100034,,,,4,1,5
HND-005089,2011,60100039,,,,6,8,14
HND-005091,2011,60100041,,,,17,24,41
HND-005092,2011,60100043,,,,2,1,3
HND-005093,2011,60100044,,,,2,5,7
HND-005096,2011,60100047,,,,5,3,8
HND-005098,2011,60100049,,,,2,6,8
HND-005100,2011,60100051,,,,6,4,10
HND-005101,2011,60100052,,,,15,20,35
,2011,60100056,,,,9,8,17
HND-005106,2011,60100057,,,,7,4,11
HND-005111,2011,60100062,,,,2,2,4
HND-005112,2011,60100063,,,,6,4,10
,2011,60100064,,,,17,12,29
HND-005118,2011,60100069,,,,1,0,1
HND-005120,2011,60100071,,,,59,51,110
HND-005123,2011,60100074,,,,13,8,21
HND-005124,2011,60100075,,,,5,4,9
HND-005125,2011,60100076,,,,3,7,10
HND-005126,2011,60100077,,,,5,8,13
HND-005130,2011,60100081,,,,7,3,10
HND-005131,2011,60100083,,,,19,15,34
HND-005133,2011,60100085,,,,1,6,7
HND-005134,2011,60100086,,,,1,7,8
HND-005135,2011,60100087,,,,4,6,10
HND-005136,2011,60100088,,,,2,3,5
,2011,60100089,,,,35,21,56
,2011,60100090,,,,9,3,12
HND-005137,2011,60100092,,,,5,2,7
HND-005139,2011,60100094,,,,8,3,11
HND-005144,2011,60100099,,,,3,5,8
HND-005146,2011,60100102,,,,1,2,3
HND-005152,2011,60100110,,,,17,14,31
HND-005153,2011,60100111,,,,2,4,6
HND-005156,2011,60100114,,,,33,31,64
HND-005158,2011,60100116,,,,2,5,7
HND-005159,2011,60100117,,,,4,9,13
,2011,60100118,,,,0,6,6
,2011,60100119,,,,17,33,50
HND-005160,2011,60100122,,,,5,2,7
HND-005163,2011,60100125,,,,6,6,12
,2011,60100129,,,,15,16,31
HND-005165,2011,60100131,,,,4,6,10
HND-005167,2011,60100135,,,,3,2,5
HND-005168,2011,60100136,,,,16,13,29
HND-005169,2011,60100137,,,,19,9,28
HND-005170,2011,60100138,,,,32,25,57
HND-005173,2011,60100141,,,,29,39,68
HND-005176,2011,60100144,,,,62,62,124
HND-005180,2011,60100148,,,,12,6,18
HND-005182,2011,60100152,,,,2,5,7
HND-005184,2011,60100155,,,,2,4,6
,2011,60100158,,,,31,33,64
,2011,60100197,,,,8,2,10
,2011,60100200,,,,9,21,30
,2011,60100218,,,,12,10,22
HND-005220,2011,60100219,,,,2,4,6
HND-005230,2011,60100234,,,,9,9,18
HND-005233,2011,60100238,,,,29,29,58
HND-005245,2011,60100258,,,,15,18,33
HND-005248,2011,60100275,,,,6,5,11
HND-005259,2011,60100397,,,,19,20,39
,2011,60100401,,,,14,15,29
,2011,60100411,,,,14,15,29
,2011,60100412,,,,4,5,9
,2011,60100413,,,,5,8,13
HND-005054,2011,60100001,,,,5,3,8
,2011,60100002,,,,19,17,36
,2011,60100003,,,,1,0,1
HND-005060,2011,60100009,,,,3,3,6
HND-005061,2011,60100010,,,,14,21,35
HND-005062,2011,60100011,,,,6,4,10
HND-005066,2011,60100015,,,,6,6,12
HND-005067,2011,60100016,,,,6,2,8
,2011,60100017,,,,12,13,25
HND-005069,2011,60100018,,,,15,6,21
HND-005075,2011,60100024,,,,6,3,9
HND-005076,2011,60100025,,,,2,2,4
HND-005077,2011,60100026,,,,12,8,20
HND-005078,2011,60100027,,,,7,16,23
HND-005079,2011,60100028,,,,50,40,90
HND-005082,2011,60100031,,,,12,12,24
HND-005086,2011,60100035,,,,8,2,10
HND-005087,2011,60100036,,,,3,3,6
,2011,60100037,,,,13,8,21
HND-005088,2011,60100038,,,,12,11,23
HND-005090,2011,60100040,,,,2,1,3
HND-005094,2011,60100045,,,,10,9,19
HND-005095,2011,60100046,,,,3,2,5
HND-005097,2011,60100048,,,,3,1,4
HND-005099,2011,60100050,,,,2,6,8
HND-005102,2011,60100053,,,,5,0,5
HND-005103,2011,60100054,,,,1,1,2
HND-005107,2011,60100058,,,,63,51,114
HND-005108,2011,60100059,,,,2,3,5
HND-005109,2011,60100060,,,,37,26,63
HND-005110,2011,60100061,,,,4,7,11
HND-005114,2011,60100065,,,,10,2,12
HND-005115,2011,60100066,,,,1,5,6
HND-005116,2011,60100067,,,,8,10,18
HND-005117,2011,60100068,,,,3,5,8
HND-005119,2011,60100070,,,,5,3,8
HND-005121,2011,60100072,,,,25,16,41
HND-005122,2011,60100073,,,,18,10,28
HND-005127,2011,60100078,,,,7,8,15
HND-005128,2011,60100079,,,,3,2,5
HND-005129,2011,60100080,,,,4,12,16
HND-005132,2011,60100084,,,,5,4,9
,2011,60100091,,,,15,16,31
HND-005138,2011,60100093,,,,33,45,78
HND-005140,2011,60100095,,,,4,2,6
HND-005141,2011,60100096,,,,3,5,8
HND-005142,2011,60100097,,,,2,5,7
HND-005143,2011,60100098,,,,7,7,14
HND-005145,2011,60100101,,,,4,5,9
HND-005147,2011,60100103,,,,22,18,40
HND-005148,2011,60100104,,,,8,13,21
HND-005149,2011,60100105,,,,47,48,95
HND-005150,2011,60100106,,,,5,7,12
,2011,60100107,,,,20,21,41
HND-005151,2011,60100109,,,,38,39,77
HND-005154,2011,60100112,,,,13,20,33
HND-005155,2011,60100113,,,,14,6,20
HND-005157,2011,60100115,,,,35,28,63
HND-005161,2011,60100123,,,,2,1,3
HND-005162,2011,60100124,,,,1,2,3
,2011,60100126,,,,12,5,17
,2011,60100127,,,,18,22,40
HND-005164,2011,60100130,,,,3,8,11
,2011,60100132,,,,6,4,10
HND-005166,2011,60100133,,,,22,11,33
HND-005171,2011,60100139,,,,63,60,123
HND-005172,2011,60100140,,,,35,35,70
HND-005174,2011,60100142,,,,22,22,44
HND-005175,2011,60100143,,,,33,44,77
HND-005177,2011,60100145,,,,72,81,153
HND-005178,2011,60100146,,,,15,10,25
,2011,60100147,,,,2,3,5
HND-005183,2011,60100153,,,,5,3,8
,2011,60100169,,,,4,4,8
,2011,60100171,,,,12,5,17
HND-005218,2011,60100209,,,,2,1,3
HND-005221,2011,60100221,,,,4,12,16
HND-005222,2011,60100222,,,,2,1,3
HND-005223,2011,60100223,,,,5,4,9
HND-005224,2011,60100224,,,,4,1,5
,2011,60100229,,,,8,9,17
HND-005226,2011,60100230,,,,29,30,59
HND-005227,2011,60100231,,,,8,8,16
HND-005241,2011,60100249,,,,10,4,14
HND-005242,2011,60100250,,,,57,49,106
,2011,60100274,,,,3,5,8
,2011,60100416,,,,14,7,21
HND-005265,2011,60100419,,,,2,2,4
HND-005266,2011,60100420,,,,5,14,19
,2011,60100002,,,,14,10,24
HND-005056,2011,60100004,,,,7,8,15
HND-005058,2011,60100006,,,,16,7,23
HND-005059,2011,60100007,,,,7,1,8
HND-005062,2011,60100011,,,,9,10,19
HND-005063,2011,60100012,,,,9,3,12
HND-005064,2011,60100013,,,,4,3,7
HND-005070,2011,60100019,,,,3,1,4
HND-005071,2011,60100020,,,,10,3,13
HND-005072,2011,60100021,,,,9,2,11
HND-005074,2011,60100023,,,,1,3,4
HND-005076,2011,60100025,,,,5,3,8
HND-005080,2011,60100029,,,,11,12,23
HND-005081,2011,60100030,,,,5,5,10
HND-005082,2011,60100031,,,,10,8,18
HND-005083,2011,60100032,,,,4,3,7
HND-005084,2011,60100033,,,,5,6,11
HND-005089,2011,60100039,,,,0,3,3
HND-005090,2011,60100040,,,,1,1,2
HND-005092,2011,60100043,,,,1,0,1
HND-005093,2011,60100044,,,,3,2,5
HND-005098,2011,60100049,,,,5,2,7
HND-005100,2011,60100051,,,,11,6,17
HND-005101,2011,60100052,,,,12,14,26
HND-005104,2011,60100055,,,,1,4,5
,2011,60100056,,,,9,7,16
HND-005106,2011,60100057,,,,1,7,8
HND-005107,2011,60100058,,,,56,57,113
HND-005111,2011,60100062,,,,0,1,1
HND-005112,2011,60100063,,,,10,7,17
,2011,60100064,,,,5,6,11
HND-005118,2011,60100069,,,,3,3,6
HND-005120,2011,60100071,,,,58,53,111
HND-005123,2011,60100074,,,,9,8,17
HND-005124,2011,60100075,,,,6,6,12
HND-005125,2011,60100076,,,,10,5,15
HND-005126,2011,60100077,,,,7,1,8
HND-005130,2011,60100081,,,,4,8,12
HND-005131,2011,60100083,,,,10,12,22
HND-005133,2011,60100085,,,,3,2,5
HND-005134,2011,60100086,,,,1,3,4
HND-005135,2011,60100087,,,,10,9,19
HND-005136,2011,60100088,,,,6,11,17
,2011,60100089,,,,28,32,60
,2011,60100090,,,,2,4,6
HND-005137,2011,60100092,,,,6,5,11
HND-005139,2011,60100094,,,,4,2,6
HND-005144,2011,60100099,,,,2,4,6
HND-005146,2011,60100102,,,,6,5,11
HND-005147,2011,60100103,,,,29,23,52
HND-005151,2011,60100109,,,,44,30,74
HND-005152,2011,60100110,,,,10,8,18
HND-005153,2011,60100111,,,,3,1,4
HND-005154,2011,60100112,,,,11,8,19
HND-005158,2011,60100116,,,,2,1,3
HND-005159,2011,60100117,,,,12,6,18
,2011,60100118,,,,0,1,1
,2011,60100119,,,,19,14,33
HND-005160,2011,60100122,,,,6,6,12
HND-005163,2011,60100125,,,,5,6,11
,2011,60100126,,,,5,6,11
HND-005165,2011,60100131,,,,6,1,7
HND-005166,2011,60100133,,,,11,10,21
HND-005168,2011,60100136,,,,6,17,23
HND-005169,2011,60100137,,,,19,16,35
HND-005170,2011,60100138,,,,35,23,58
HND-005175,2011,60100143,,,,26,39,65
HND-005176,2011,60100144,,,,73,42,115
HND-005180,2011,60100148,,,,7,5,12
HND-005182,2011,60100152,,,,3,6,9
HND-005184,2011,60100155,,,,3,3,6
,2011,60100158,,,,36,32,68
,2011,60100218,,,,8,14,22
HND-005222,2011,60100222,,,,8,3,11
HND-005230,2011,60100234,,,,6,7,13
HND-005233,2011,60100238,,,,39,39,78
HND-005242,2011,60100250,,,,64,63,127
,2011,60100271,,,,2,1,3
HND-005248,2011,60100275,,,,3,3,6
HND-005259,2011,60100397,,,,25,17,42
,2011,60100401,,,,9,11,20
,2011,60100412,,,,9,5,14
,2011,60100413,,,,7,6,13
HND-005054,2011,60100001,,,,4,1,5
,2011,60100003,,,,1,1,2
HND-005057,2011,60100005,,,,22,19,41
HND-005060,2011,60100009,,,,8,5,13
HND-005061,2011,60100010,,,,17,15,32
HND-005065,2011,60100014,,,,2,2,4
HND-005066,2011,60100015,,,,3,1,4
HND-005067,2011,60100016,,,,4,6,10
,2011,60100017,,,,9,10,19
HND-005069,2011,60100018,,,,14,7,21
HND-005073,2011,60100022,,,,10,7,17
HND-005075,2011,60100024,,,,5,5,10
HND-005077,2011,60100026,,,,9,8,17
HND-005078,2011,60100027,,,,11,8,19
HND-005079,2011,60100028,,,,50,49,99
HND-005085,2011,60100034,,,,2,2,4
HND-005086,2011,60100035,,,,4,4,8
HND-005087,2011,60100036,,,,4,2,6
,2011,60100037,,,,13,6,19
HND-005088,2011,60100038,,,,8,12,20
HND-005091,2011,60100041,,,,17,18,35
HND-005094,2011,60100045,,,,7,7,14
HND-005095,2011,60100046,,,,2,3,5
HND-005096,2011,60100047,,,,3,4,7
HND-005097,2011,60100048,,,,4,3,7
HND-005099,2011,60100050,,,,7,8,15
HND-005102,2011,60100053,,,,0,1,1
HND-005103,2011,60100054,,,,2,1,3
HND-005108,2011,60100059,,,,1,1,2
HND-005109,2011,60100060,,,,46,27,73
HND-005110,2011,60100061,,,,5,1,6
HND-005114,2011,60100065,,,,5,10,15
HND-005115,2011,60100066,,,,4,6,10
HND-005116,2011,60100067,,,,7,12,19
HND-005117,2011,60100068,,,,4,2,6
HND-005119,2011,60100070,,,,3,4,7
HND-005121,2011,60100072,,,,18,15,33
HND-005122,2011,60100073,,,,10,13,23
HND-005127,2011,60100078,,,,13,9,22
HND-005128,2011,60100079,,,,0,2,2
HND-005129,2011,60100080,,,,4,6,10
HND-005132,2011,60100084,,,,6,5,11
,2011,60100091,,,,17,16,33
HND-005138,2011,60100093,,,,37,29,66
HND-005140,2011,60100095,,,,1,1,2
HND-005141,2011,60100096,,,,4,2,6
HND-005142,2011,60100097,,,,1,6,7
HND-005143,2011,60100098,,,,10,11,21
HND-005145,2011,60100101,,,,5,2,7
HND-005148,2011,60100104,,,,6,6,12
HND-005149,2011,60100105,,,,43,49,92
HND-005150,2011,60100106,,,,7,11,18
,2011,60100107,,,,21,32,53
HND-005155,2011,60100113,,,,15,14,29
HND-005156,2011,60100114,,,,12,21,33
HND-005157,2011,60100115,,,,41,31,72
HND-005161,2011,60100123,,,,4,3,7
HND-005162,2011,60100124,,,,4,2,6
,2011,60100127,,,,21,32,53
,2011,60100129,,,,9,19,28
HND-005164,2011,60100130,,,,11,8,19
,2011,60100132,,,,6,4,10
HND-005167,2011,60100135,,,,1,8,9
HND-005171,2011,60100139,,,,61,69,130
HND-005172,2011,60100140,,,,33,45,78
HND-005173,2011,60100141,,,,37,38,75
HND-005174,2011,60100142,,,,14,21,35
HND-005177,2011,60100145,,,,92,112,204
HND-005178,2011,60100146,,,,19,10,29
,2011,60100147,,,,4,2,6
HND-005183,2011,60100153,,,,5,4,9
,2011,60100169,,,,8,5,13
,2011,60100171,,,,5,6,11
,2011,60100197,,,,6,3,9
,2011,60100200,,,,12,16,28
HND-005218,2011,60100209,,,,2,4,6
HND-005220,2011,60100219,,,,5,2,7
HND-005221,2011,60100221,,,,7,4,11
HND-005223,2011,60100223,,,,1,3,4
HND-005224,2011,60100224,,,,2,1,3
,2011,60100229,,,,5,3,8
HND-005226,2011,60100230,,,,26,25,51
HND-005227,2011,60100231,,,,3,7,10
HND-005241,2011,60100249,,,,11,9,20
HND-005245,2011,60100258,,,,21,14,35
,2011,60100274,,,,8,5,13
,2011,60100411,,,,9,11,20
,2011,60100416,,,,12,10,22
HND-005265,2011,60100419,,,,1,4,5
HND-005266,2011,60100420,,,,7,5,12
HND-005054,2011,60100001,,,,3,3,6
,2011,60100002,,,,10,13,23
,2011,60100003,,,,4,4,8
HND-005060,2011,60100009,,,,4,4,8
HND-005061,2011,60100010,,,,28,21,49
HND-005062,2011,60100011,,,,5,7,12
HND-005066,2011,60100015,,,,7,4,11
HND-005067,2011,60100016,,,,3,4,7
HND-005069,2011,60100018,,,,6,6,12
HND-005075,2011,60100024,,,,4,2,6
HND-005076,2011,60100025,,,,0,2,2
HND-005077,2011,60100026,,,,13,9,22
HND-005078,2011,60100027,,,,9,7,16
HND-005079,2011,60100028,,,,49,53,102
HND-005083,2011,60100032,,,,4,2,6
HND-005084,2011,60100033,,,,3,4,7
HND-005085,2011,60100034,,,,3,3,6
,2011,60100037,,,,9,8,17
HND-005089,2011,60100039,,,,5,7,12
HND-005091,2011,60100041,,,,15,16,31
HND-005093,2011,60100044,,,,3,2,5
HND-005094,2011,60100045,,,,11,10,21
HND-005095,2011,60100046,,,,0,3,3
HND-005096,2011,60100047,,,,5,3,8
HND-005099,2011,60100050,,,,5,3,8
HND-005100,2011,60100051,,,,2,9,11
HND-005101,2011,60100052,,,,13,14,27
HND-005102,2011,60100053,,,,0,2,2
,2011,60100056,,,,17,11,28
HND-005109,2011,60100060,,,,29,27,56
HND-005110,2011,60100061,,,,3,6,9
HND-005112,2011,60100063,,,,13,9,22
HND-005117,2011,60100068,,,,2,1,3
HND-005118,2011,60100069,,,,3,1,4
HND-005120,2011,60100071,,,,51,53,104
HND-005124,2011,60100075,,,,3,5,8
HND-005125,2011,60100076,,,,4,8,12
HND-005126,2011,60100077,,,,3,6,9
HND-005127,2011,60100078,,,,9,7,16
HND-005129,2011,60100080,,,,4,3,7
HND-005130,2011,60100081,,,,6,8,14
HND-005131,2011,60100083,,,,16,10,26
HND-005136,2011,60100088,,,,4,3,7
,2011,60100089,,,,35,33,68
,2011,60100091,,,,14,19,33
HND-005137,2011,60100092,,,,2,7,9
HND-005139,2011,60100094,,,,7,5,12
HND-005142,2011,60100097,,,,4,2,6
HND-005144,2011,60100099,,,,3,8,11
HND-005146,2011,60100102,,,,6,2,8
HND-005147,2011,60100103,,,,29,23,52
HND-005150,2011,60100106,,,,9,5,14
HND-005151,2011,60100109,,,,32,34,66
HND-005153,2011,60100111,,,,2,3,5
HND-005154,2011,60100112,,,,18,12,30
HND-005157,2011,60100115,,,,26,24,50
HND-005158,2011,60100116,,,,2,3,5
HND-005159,2011,60100117,,,,11,8,19
HND-005162,2011,60100124,,,,3,3,6
,2011,60100126,,,,12,5,17
,2011,60100127,,,,28,23,51
,2011,60100132,,,,2,3,5
HND-005168,2011,60100136,,,,21,31,52
HND-005169,2011,60100137,,,,12,18,30
HND-005174,2011,60100142,,,,10,10,20
HND-005178,2011,60100146,,,,10,12,22
,2011,60100147,,,,1,1,2
HND-005180,2011,60100148,,,,6,4,10
,2011,60100169,,,,3,4,7
,2011,60100171,,,,12,5,17
HND-005221,2011,60100221,,,,3,6,9
HND-005222,2011,60100222,,,,2,3,5
HND-005223,2011,60100223,,,,3,4,7
HND-005224,2011,60100224,,,,4,1,5
,2011,60100229,,,,5,5,10
HND-005227,2011,60100231,,,,7,6,13
HND-005233,2011,60100238,,,,35,39,74
HND-005242,2011,60100250,,,,39,59,98
,2011,60100271,,,,1,2,3
HND-005248,2011,60100275,,,,0,2,2
HND-005259,2011,60100397,,,,19,16,35
,2011,60100416,,,,15,15,30
HND-005265,2011,60100419,,,,2,2,4
HND-005266,2011,60100420,,,,6,3,9
HND-005056,2011,60100004,,,,19,8,27
HND-005057,2011,60100005,,,,13,9,22
HND-005058,2011,60100006,,,,10,5,15
HND-005059,2011,60100007,,,,5,4,9
HND-005063,2011,60100012,,,,9,5,14
HND-005064,2011,60100013,,,,4,3,7
HND-005065,2011,60100014,,,,5,3,8
,2011,60100017,,,,20,7,27
HND-005070,2011,60100019,,,,5,4,9
HND-005071,2011,60100020,,,,7,5,12
HND-005072,2011,60100021,,,,14,7,21
HND-005073,2011,60100022,,,,5,1,6
HND-005074,2011,60100023,,,,6,4,10
HND-005080,2011,60100029,,,,15,13,28
HND-005081,2011,60100030,,,,6,4,10
HND-005082,2011,60100031,,,,4,17,21
HND-005086,2011,60100035,,,,6,2,8
HND-005087,2011,60100036,,,,7,1,8
HND-005088,2011,60100038,,,,8,10,18
HND-005090,2011,60100040,,,,3,1,4
HND-005092,2011,60100043,,,,1,1,2
HND-005097,2011,60100048,,,,5,2,7
HND-005098,2011,60100049,,,,7,6,13
HND-005103,2011,60100054,,,,2,1,3
HND-005106,2011,60100057,,,,2,3,5
HND-005107,2011,60100058,,,,46,44,90
HND-005108,2011,60100059,,,,2,5,7
HND-005111,2011,60100062,,,,2,2,4
,2011,60100064,,,,11,6,17
HND-005114,2011,60100065,,,,9,12,21
HND-005115,2011,60100066,,,,2,1,3
HND-005116,2011,60100067,,,,7,10,17
HND-005119,2011,60100070,,,,4,2,6
HND-005121,2011,60100072,,,,18,13,31
HND-005122,2011,60100073,,,,13,10,23
HND-005123,2011,60100074,,,,6,9,15
HND-005132,2011,60100084,,,,4,2,6
HND-005133,2011,60100085,,,,1,4,5
HND-005134,2011,60100086,,,,2,2,4
HND-005135,2011,60100087,,,,3,0,3
,2011,60100090,,,,3,4,7
HND-005138,2011,60100093,,,,38,39,77
HND-005140,2011,60100095,,,,2,1,3
HND-005141,2011,60100096,,,,7,4,11
HND-005143,2011,60100098,,,,9,11,20
HND-005148,2011,60100104,,,,4,9,13
HND-005149,2011,60100105,,,,50,40,90
,2011,60100107,,,,26,24,50
HND-005152,2011,60100110,,,,11,15,26
HND-005155,2011,60100113,,,,15,13,28
HND-005156,2011,60100114,,,,23,29,52
,2011,60100119,,,,14,20,34
HND-005160,2011,60100122,,,,3,1,4
HND-005161,2011,60100123,,,,3,5,8
HND-005163,2011,60100125,,,,7,3,10
,2011,60100129,,,,16,25,41
HND-005164,2011,60100130,,,,6,10,16
HND-005165,2011,60100131,,,,2,6,8
HND-005166,2011,60100133,,,,14,22,36
HND-005167,2011,60100135,,,,6,8,14
HND-005170,2011,60100138,,,,23,21,44
HND-005171,2011,60100139,,,,50,70,120
HND-005172,2011,60100140,,,,51,52,103
HND-005173,2011,60100141,,,,54,44,98
HND-005175,2011,60100143,,,,36,49,85
HND-005176,2011,60100144,,,,54,62,116
HND-005177,2011,60100145,,,,83,114,197
HND-005182,2011,60100152,,,,2,3,5
HND-005183,2011,60100153,,,,4,0,4
HND-005184,2011,60100155,,,,4,2,6
,2011,60100158,,,,32,40,72
,2011,60100197,,,,4,8,12
,2011,60100200,,,,14,14,28
,2011,60100218,,,,2,7,9
HND-005220,2011,60100219,,,,0,4,4
HND-005226,2011,60100230,,,,24,16,40
HND-005230,2011,60100234,,,,5,4,9
HND-005241,2011,60100249,,,,4,7,11
HND-005245,2011,60100258,,,,10,18,28
,2011,60100274,,,,5,7,12
,2011,60100401,,,,14,12,26
,2011,60100411,,,,14,12,26
,2011,60100412,,,,2,6,8
,2011,60100413,,,,2,4,6
HND-005077,2011,60100026,,,,23,21,44
HND-005082,2011,60100031,,,,19,23,42
HND-005107,2011,60100058,,,,62,73,135
HND-005121,2011,60100072,,,,21,25,46
,2011,60100089,,,,35,40,75
,2011,60100107,,,,47,61,108
,2011,60100119,,,,21,16,37
,2011,60100129,,,,38,73,111
HND-005166,2011,60100133,,,,12,18,30
HND-005170,2011,60100138,,,,47,53,100
HND-005176,2011,60100144,,,,61,69,130
HND-005212,2011,60100196,,,,329,414,743
,2011,60100197,,,,18,12,30
HND-005214,2011,60100199,,,,229,30,259
HND-005242,2011,60100250,,,,71,55,126
,2011,60100274,,,,55,66,121
,2011,60100401,,,,19,33,52
,2011,60100413,,,,1,2,3
,2011,60100417,,,,6,4,10
,2011,60100456,,,,3,3,6
,2011,60100457,,,,1,2,3
,2011,60100459,,,,5,12,17
HND-005057,2011,60100005,,,,22,19,41
HND-005058,2011,60100006,,,,10,13,23
HND-005061,2011,60100010,,,,17,15,32
HND-005078,2011,60100027,,,,37,22,59
HND-005079,2011,60100028,,,,45,51,96
HND-005080,2011,60100029,,,,8,26,34
,2011,60100037,,,,19,16,35
HND-005091,2011,60100041,,,,51,50,101
HND-005122,2011,60100073,,,,11,22,33
HND-005125,2011,60100076,,,,23,10,33
HND-005149,2011,60100105,,,,30,38,68
HND-005155,2011,60100113,,,,16,12,28
,2011,60100118,,,,1,1,2
,2011,60100128,,,,93,93,186
HND-005171,2011,60100139,,,,66,73,139
,2011,60100149,,,,9,16,25
,2011,60100270,,,,25,6,31
,2011,60100271,,,,14,3,17
,2011,60100276,,,,3,2,5
,2011,60100282,,,,111,148,259
,2011,60100416,,,,20,11,31
,2011,60100423,,,,35,46,81
,2011,60100458,,,,3,3,6
HND-005057,2011,60100005,,,,22,12,34
HND-005058,2011,60100006,,,,6,11,17
HND-005080,2011,60100029,,,,31,27,58
,2011,60100037,,,,21,17,38
HND-005091,2011,60100041,,,,26,30,56
HND-005125,2011,60100076,,,,18,16,34
,2011,60100089,,,,39,31,70
HND-005149,2011,60100105,,,,15,20,35
HND-005155,2011,60100113,,,,17,8,25
,2011,60100118,,,,2,4,6
,2011,60100119,,,,14,23,37
,2011,60100128,,,,72,97,169
HND-005170,2011,60100138,,,,38,40,78
HND-005171,2011,60100139,,,,55,60,115
HND-005176,2011,60100144,,,,37,39,76
,2011,60100149,,,,9,7,16
HND-005214,2011,60100199,,,,185,20,205
,2011,60100270,,,,13,5,18
,2011,60100271,,,,15,21,36
,2011,60100401,,,,24,25,49
,2011,60100413,,,,4,5,9
,2011,60100423,,,,30,48,78
HND-005061,2011,60100010,,,,19,14,33
HND-005077,2011,60100026,,,,18,32,50
HND-005078,2011,60100027,,,,26,29,55
HND-005079,2011,60100028,,,,26,26,52
HND-005082,2011,60100031,,,,22,22,44
HND-005107,2011,60100058,,,,35,48,83
HND-005121,2011,60100072,,,,27,22,49
HND-005122,2011,60100073,,,,12,15,27
,2011,60100107,,,,33,50,83
,2011,60100129,,,,27,53,80
HND-005166,2011,60100133,,,,12,11,23
HND-005212,2011,60100196,,,,307,392,699
,2011,60100197,,,,9,12,21
HND-005242,2011,60100250,,,,43,42,85
,2011,60100274,,,,48,51,99
,2011,60100282,,,,107,151,258
,2011,60100416,,,,8,19,27
,2011,60100417,,,,4,8,12
,2011,60100456,,,,4,5,9
,2011,60100457,,,,0,1,1
,2011,60100458,,,,0,1,1
HND-005057,2011,60100005,,,,34,16,50
HND-005058,2011,60100006,,,,7,9,16
HND-005080,2011,60100029,,,,27,27,54
HND-005091,2011,60100041,,,,31,32,63
HND-005125,2011,60100076,,,,14,22,36
,2011,60100089,,,,23,26,49
HND-005149,2011,60100105,,,,12,26,38
,2011,60100107,,,,34,40,74
,2011,60100119,,,,20,22,42
,2011,60100129,,,,35,58,93
HND-005170,2011,60100138,,,,26,42,68
HND-005176,2011,60100144,,,,28,51,79
,2011,60100149,,,,13,15,28
,2011,60100270,,,,8,4,12
,2011,60100274,,,,39,50,89
,2011,60100416,,,,8,10,18
,2011,60100423,,,,26,37,63
,2011,60100458,,,,1,2,3
HND-005061,2011,60100010,,,,7,4,11
HND-005077,2011,60100026,,,,18,23,41
HND-005078,2011,60100027,,,,32,16,48
HND-005079,2011,60100028,,,,13,17,30
HND-005082,2011,60100031,,,,16,18,34
,2011,60100037,,,,11,7,18
HND-005107,2011,60100058,,,,21,24,45
HND-005121,2011,60100072,,,,21,15,36
HND-005122,2011,60100073,,,,16,12,28
HND-005155,2011,60100113,,,,8,7,15
,2011,60100118,,,,0,1,1
,2011,60100128,,,,82,90,172
HND-005166,2011,60100133,,,,6,9,15
HND-005171,2011,60100139,,,,36,37,73
HND-005212,2011,60100196,,,,252,351,603
,2011,60100197,,,,12,14,26
HND-005214,2011,60100199,,,,188,27,215
HND-005242,2011,60100250,,,,47,34,81
,2011,60100271,,,,27,24,51
,2011,60100282,,,,95,144,239
,2011,60100401,,,,11,22,33
,2011,60100413,,,,2,5,7
,2011,60100417,,,,11,5,16
,2011,60100456,,,,3,1,4
,2011,60100457,,,,0,2,2
,2011,60100107,,,,38,44,82
,2011,60100149,,,,5,11,16
HND-005212,2011,60100196,,,,398,606,1004
HND-005214,2011,60100199,,,,427,30,457
,2011,60100274,,,,91,108,199
,2011,60100282,,,,112,134,246
,2011,60100313,,,,174,205,379
,2011,60100401,,,,29,16,45
,2011,60100413,,,,2,4,6
,2011,60100416,,,,12,12,24
,2011,60100417,,,,12,20,32
,2011,60100423,,,,22,66,88
HND-005281,2011,60100460,,,,96,134,230
,2011,60100118,,,,2,0,2
,2011,60100119,,,,10,19,29
,2011,60100128,,,,78,74,152
,2011,60100129,,,,60,69,129
,2011,60100197,,,,21,35,56
HND-005213,2011,60100198,,,,287,651,938
,2011,60100271,,,,83,56,139
,2011,60100447,,,,7,19,26
,2011,60100456,,,,0,2,2
,2011,60100457,,,,2,0,2
,2011,60100458,,,,2,4,6
,2011,60100107,,,,31,43,74
,2011,60100119,,,,7,21,28
,2011,60100128,,,,67,59,126
,2011,60100129,,,,46,58,104
,2011,60100149,,,,8,11,19
HND-005212,2011,60100196,,,,298,502,800
,2011,60100197,,,,29,22,51
HND-005214,2011,60100199,,,,308,1,309
,2011,60100274,,,,116,146,262
,2011,60100313,,,,46,42,88
,2011,60100401,,,,10,8,18
,2011,60100413,,,,0,3,3
,2011,60100423,,,,18,52,70
HND-005281,2011,60100460,,,,33,72,105
HND-005213,2011,60100198,,,,278,769,1047
,2011,60100271,,,,75,38,113
,2011,60100282,,,,57,107,164
,2011,60100416,,,,18,10,28
,2011,60100417,,,,9,11,20
,2011,60100456,,,,2,2,4
,2011,60100458,,,,0,2,2
,2011,60100128,,,,8,27,35
,2011,60100129,,,,22,34,56
HND-005213,2011,60100198,,,,181,553,734
,2011,60100271,,,,39,32,71
,2011,60100416,,,,3,2,5
,2011,60100417,,,,9,10,19
,2011,60100107,,,,11,20,31
,2011,60100149,,,,9,6,15
HND-005212,2011,60100196,,,,213,407,620
,2011,60100197,,,,36,29,65
HND-005214,2011,60100199,,,,305,3,308
,2011,60100274,,,,69,102,171
,2011,60100313,,,,15,6,21
,2011,60100401,,,,7,4,11
,2011,60100423,,,,20,48,68
HND-005281,2011,60100460,,,,21,55,76
,2011,60200075,,,,4,5,9
HND-005326,2011,60200076,,,,4,6,10
,2011,60200077,,,,3,7,10
,2011,60200080,,,,4,6,10
HND-005284,2011,60200002,,,,6,5,11
HND-005285,2011,60200003,,,,5,5,10
,2011,60200073,,,,3,3,6
,2011,60200078,,,,3,4,7
,2011,60200079,,,,7,2,9
HND-005321,2011,60200041,,,,0,1,1
HND-005322,2011,60200042,,,,7,0,7
,2011,60200004,,,,6,10,16
HND-005321,2011,60200041,,,,6,6,12
,2011,60200004,,,,6,7,13
HND-005321,2011,60200041,,,,19,18,37
HND-005322,2011,60200042,,,,3,7,10
HND-005286,2011,60200005,,,,21,22,43
HND-005290,2011,60200009,,,,8,7,15
HND-005295,2011,60200014,,,,1,0,1
HND-005296,2011,60200015,,,,5,2,7
HND-005297,2011,60200016,,,,7,3,10
HND-005298,2011,60200017,,,,2,2,4
HND-005302,2011,60200021,,,,5,7,12
HND-005306,2011,60200025,,,,4,1,5
HND-005307,2011,60200026,,,,2,4,6
HND-005308,2011,60200027,,,,7,2,9
HND-005309,2011,60200028,,,,3,2,5
HND-005315,2011,60200035,,,,3,1,4
HND-005316,2011,60200036,,,,8,4,12
HND-005317,2011,60200037,,,,3,0,3
HND-005320,2011,60200040,,,,4,1,5
HND-005323,2011,60200044,,,,7,6,13
HND-005288,2011,60200007,,,,1,2,3
HND-005289,2011,60200008,,,,6,7,13
HND-005291,2011,60200010,,,,7,6,13
HND-005292,2011,60200011,,,,2,2,4
HND-005293,2011,60200012,,,,1,0,1
HND-005294,2011,60200013,,,,1,5,6
HND-005299,2011,60200018,,,,6,3,9
HND-005300,2011,60200019,,,,1,2,3
HND-005301,2011,60200020,,,,2,4,6
HND-005303,2011,60200022,,,,0,1,1
HND-005304,2011,60200023,,,,2,2,4
HND-005305,2011,60200024,,,,3,2,5
HND-005310,2011,60200029,,,,8,5,13
HND-005311,2011,60200030,,,,2,3,5
HND-005312,2011,60200031,,,,5,3,8
,2011,60200032,,,,3,2,5
HND-005314,2011,60200033,,,,2,2,4
HND-005318,2011,60200038,,,,8,10,18
HND-005319,2011,60200039,,,,3,2,5
HND-005324,2011,60200045,,,,1,2,3
HND-005286,2011,60200005,,,,21,17,38
HND-005287,2011,60200006,,,,1,0,1
HND-005288,2011,60200007,,,,5,4,9
HND-005292,2011,60200011,,,,7,3,10
HND-005296,2011,60200015,,,,5,4,9
HND-005297,2011,60200016,,,,5,5,10
HND-005298,2011,60200017,,,,0,4,4
HND-005299,2011,60200018,,,,3,1,4
HND-005301,2011,60200020,,,,2,6,8
HND-005302,2011,60200021,,,,2,5,7
HND-005303,2011,60200022,,,,2,0,2
HND-005304,2011,60200023,,,,3,1,4
HND-005309,2011,60200028,,,,3,1,4
HND-005310,2011,60200029,,,,6,6,12
HND-005312,2011,60200031,,,,4,2,6
HND-005315,2011,60200035,,,,4,0,4
HND-005316,2011,60200036,,,,3,3,6
HND-005317,2011,60200037,,,,2,1,3
HND-005318,2011,60200038,,,,4,4,8
HND-005323,2011,60200044,,,,5,2,7
HND-005324,2011,60200045,,,,4,1,5
HND-005289,2011,60200008,,,,5,4,9
HND-005290,2011,60200009,,,,4,6,10
HND-005291,2011,60200010,,,,5,4,9
HND-005293,2011,60200012,,,,2,2,4
HND-005294,2011,60200013,,,,6,1,7
HND-005295,2011,60200014,,,,1,3,4
HND-005300,2011,60200019,,,,2,1,3
HND-005305,2011,60200024,,,,2,4,6
HND-005306,2011,60200025,,,,4,2,6
HND-005307,2011,60200026,,,,3,6,9
HND-005308,2011,60200027,,,,2,2,4
HND-005311,2011,60200030,,,,8,3,11
,2011,60200032,,,,4,3,7
HND-005314,2011,60200033,,,,3,2,5
HND-005319,2011,60200039,,,,8,1,9
HND-005320,2011,60200040,,,,3,0,3
HND-005325,2011,60200063,,,,2,3,5
HND-005287,2011,60200006,,,,2,0,2
HND-005288,2011,60200007,,,,5,4,9
HND-005289,2011,60200008,,,,3,3,6
HND-005291,2011,60200010,,,,4,3,7
HND-005292,2011,60200011,,,,5,4,9
HND-005293,2011,60200012,,,,0,1,1
HND-005294,2011,60200013,,,,5,3,8
HND-005299,2011,60200018,,,,2,4,6
HND-005300,2011,60200019,,,,4,1,5
HND-005301,2011,60200020,,,,2,1,3
HND-005303,2011,60200022,,,,2,1,3
HND-005304,2011,60200023,,,,1,2,3
HND-005305,2011,60200024,,,,1,3,4
HND-005310,2011,60200029,,,,5,7,12
HND-005311,2011,60200030,,,,1,1,2
HND-005312,2011,60200031,,,,2,1,3
,2011,60200032,,,,1,1,2
HND-005314,2011,60200033,,,,5,6,11
HND-005318,2011,60200038,,,,6,3,9
HND-005319,2011,60200039,,,,5,1,6
HND-005324,2011,60200045,,,,3,4,7
HND-005286,2011,60200005,,,,22,14,36
HND-005290,2011,60200009,,,,9,3,12
HND-005295,2011,60200014,,,,1,0,1
HND-005296,2011,60200015,,,,7,3,10
HND-005297,2011,60200016,,,,4,3,7
HND-005298,2011,60200017,,,,3,2,5
HND-005302,2011,60200021,,,,1,4,5
HND-005306,2011,60200025,,,,4,5,9
HND-005307,2011,60200026,,,,5,4,9
HND-005308,2011,60200027,,,,7,3,10
HND-005309,2011,60200028,,,,2,2,4
HND-005315,2011,60200035,,,,1,0,1
HND-005316,2011,60200036,,,,4,6,10
HND-005317,2011,60200037,,,,4,3,7
HND-005320,2011,60200040,,,,2,2,4
HND-005323,2011,60200044,,,,2,4,6
HND-005325,2011,60200063,,,,2,1,3
HND-005286,2011,60200005,,,,18,19,37
HND-005288,2011,60200007,,,,2,2,4
HND-005290,2011,60200009,,,,5,4,9
HND-005296,2011,60200015,,,,4,4,8
HND-005297,2011,60200016,,,,5,4,9
HND-005298,2011,60200017,,,,3,2,5
HND-005299,2011,60200018,,,,0,3,3
HND-005301,2011,60200020,,,,5,1,6
HND-005302,2011,60200021,,,,3,4,7
HND-005304,2011,60200023,,,,1,5,6
HND-005309,2011,60200028,,,,1,2,3
HND-005310,2011,60200029,,,,6,5,11
HND-005312,2011,60200031,,,,7,4,11
HND-005315,2011,60200035,,,,2,2,4
HND-005316,2011,60200036,,,,0,3,3
HND-005317,2011,60200037,,,,0,1,1
HND-005318,2011,60200038,,,,9,2,11
HND-005323,2011,60200044,,,,3,3,6
HND-005287,2011,60200006,,,,2,0,2
HND-005289,2011,60200008,,,,3,2,5
HND-005291,2011,60200010,,,,7,9,16
HND-005292,2011,60200011,,,,7,3,10
HND-005293,2011,60200012,,,,3,2,5
HND-005294,2011,60200013,,,,3,5,8
HND-005295,2011,60200014,,,,1,1,2
HND-005300,2011,60200019,,,,2,3,5
HND-005303,2011,60200022,,,,0,5,5
HND-005305,2011,60200024,,,,2,1,3
HND-005306,2011,60200025,,,,11,5,16
HND-005307,2011,60200026,,,,8,7,15
HND-005308,2011,60200027,,,,1,0,1
HND-005311,2011,60200030,,,,0,3,3
,2011,60200032,,,,5,6,11
HND-005314,2011,60200033,,,,5,4,9
HND-005319,2011,60200039,,,,6,3,9
HND-005320,2011,60200040,,,,2,0,2
HND-005324,2011,60200045,,,,4,2,6
HND-005325,2011,60200063,,,,3,3,6
HND-005287,2011,60200006,,,,1,1,2
HND-005288,2011,60200007,,,,2,4,6
HND-005289,2011,60200008,,,,3,3,6
HND-005291,2011,60200010,,,,6,7,13
HND-005292,2011,60200011,,,,6,5,11
HND-005293,2011,60200012,,,,2,0,2
HND-005294,2011,60200013,,,,7,1,8
HND-005299,2011,60200018,,,,3,3,6
HND-005300,2011,60200019,,,,2,0,2
HND-005303,2011,60200022,,,,0,2,2
HND-005304,2011,60200023,,,,1,0,1
HND-005305,2011,60200024,,,,1,1,2
HND-005308,2011,60200027,,,,1,6,7
HND-005310,2011,60200029,,,,8,6,14
HND-005315,2011,60200035,,,,2,2,4
HND-005316,2011,60200036,,,,5,2,7
HND-005317,2011,60200037,,,,0,1,1
HND-005320,2011,60200040,,,,1,4,5
HND-005323,2011,60200044,,,,4,1,5
HND-005286,2011,60200005,,,,20,24,44
HND-005290,2011,60200009,,,,6,4,10
HND-005295,2011,60200014,,,,1,0,1
HND-005296,2011,60200015,,,,3,7,10
HND-005297,2011,60200016,,,,3,4,7
HND-005298,2011,60200017,,,,2,3,5
HND-005301,2011,60200020,,,,1,2,3
HND-005302,2011,60200021,,,,4,4,8
HND-005306,2011,60200025,,,,2,2,4
HND-005307,2011,60200026,,,,8,10,18
HND-005309,2011,60200028,,,,3,2,5
HND-005311,2011,60200030,,,,3,1,4
HND-005312,2011,60200031,,,,2,6,8
,2011,60200032,,,,4,4,8
HND-005314,2011,60200033,,,,2,2,4
HND-005318,2011,60200038,,,,5,5,10
HND-005319,2011,60200039,,,,2,0,2
HND-005324,2011,60200045,,,,3,4,7
HND-005325,2011,60200063,,,,0,1,1
HND-005286,2011,60200005,,,,15,25,40
HND-005287,2011,60200006,,,,1,0,1
HND-005288,2011,60200007,,,,4,4,8
HND-005292,2011,60200011,,,,6,1,7
HND-005296,2011,60200015,,,,6,4,10
HND-005297,2011,60200016,,,,3,7,10
HND-005298,2011,60200017,,,,3,3,6
HND-005299,2011,60200018,,,,3,0,3
HND-005301,2011,60200020,,,,5,3,8
HND-005302,2011,60200021,,,,2,4,6
HND-005304,2011,60200023,,,,2,3,5
HND-005309,2011,60200028,,,,5,0,5
HND-005310,2011,60200029,,,,8,6,14
HND-005311,2011,60200030,,,,2,0,2
,2011,60200032,,,,4,2,6
HND-005314,2011,60200033,,,,1,4,5
HND-005319,2011,60200039,,,,6,0,6
HND-005320,2011,60200040,,,,2,3,5
HND-005289,2011,60200008,,,,3,3,6
HND-005290,2011,60200009,,,,5,4,9
HND-005291,2011,60200010,,,,3,2,5
HND-005294,2011,60200013,,,,12,4,16
HND-005300,2011,60200019,,,,2,1,3
HND-005305,2011,60200024,,,,2,1,3
HND-005306,2011,60200025,,,,2,2,4
HND-005307,2011,60200026,,,,12,8,20
HND-005308,2011,60200027,,,,2,2,4
HND-005312,2011,60200031,,,,2,2,4
HND-005315,2011,60200035,,,,0,1,1
HND-005316,2011,60200036,,,,1,2,3
HND-005317,2011,60200037,,,,1,2,3
HND-005318,2011,60200038,,,,3,4,7
HND-005323,2011,60200044,,,,2,4,6
HND-005324,2011,60200045,,,,3,1,4
HND-005325,2011,60200063,,,,3,2,5
HND-005286,2011,60200005,,,,27,18,45
HND-005286,2011,60200005,,,,25,27,52
HND-005286,2011,60200005,,,,32,27,59
HND-005286,2011,60200005,,,,12,10,22
HND-005286,2011,60200005,,,,12,9,21
HND-005286,2011,60200005,,,,8,4,12
HND-005335,2011,60300009,,,,7,8,15
HND-005348,2011,60300022,,,,1,8,9
HND-005363,2011,60300038,,,,6,8,14
HND-005379,2011,60300055,,,,5,6,11
HND-005380,2011,60300056,,,,8,8,16
HND-005381,2011,60300057,,,,12,6,18
,2011,60300077,,,,7,8,15
HND-005398,2011,60300085,,,,3,4,7
HND-005405,2011,60300094,,,,12,8,20
HND-005406,2011,60300095,,,,1,9,10
HND-005409,2011,60300100,,,,11,3,14
,2011,60300103,,,,6,7,13
,2011,60300133,,,,10,3,13
,2011,60300142,,,,4,3,7
,2011,60300143,,,,7,4,11
HND-005373,2011,60300048,,,,6,2,8
,2011,60300051,,,,9,11,20
,2011,60300072,,,,15,11,26
HND-005404,2011,60300093,,,,9,3,12
HND-005410,2011,60300101,,,,9,7,16
HND-005412,2011,60300122,,,,2,11,13
,2011,60300125,,,,15,7,22
,2011,60300126,,,,8,9,17
HND-005413,2011,60300129,,,,4,6,10
,2011,60300131,,,,13,14,27
,2011,60300144,,,,0,4,4
HND-005417,2011,60300146,,,,11,5,16
,2011,60300147,,,,6,10,16
HND-005372,2011,60300047,,,,1,6,7
HND-005375,2011,60300050,,,,0,2,2
HND-005376,2011,60300052,,,,3,4,7
HND-005377,2011,60300053,,,,1,4,5
,2011,60300064,,,,2,0,2
,2011,60300067,,,,3,0,3
HND-005391,2011,60300074,,,,0,3,3
HND-005400,2011,60300087,,,,4,7,11
,2011,60300092,,,,0,1,1
HND-005382,2011,60300058,,,,4,2,6
HND-005383,2011,60300059,,,,3,6,9
,2011,60300061,,,,1,1,2
HND-005386,2011,60300066,,,,2,2,4
HND-005389,2011,60300071,,,,1,3,4
HND-005396,2011,60300081,,,,0,2,2
HND-005397,2011,60300082,,,,1,1,2
,2011,60300083,,,,1,1,2
HND-005401,2011,60300089,,,,0,1,1
HND-005402,2011,60300090,,,,3,3,6
HND-005328,2011,60300002,,,,4,6,10
HND-005372,2011,60300047,,,,3,4,7
HND-005383,2011,60300059,,,,7,6,13
HND-005386,2011,60300066,,,,2,1,3
,2011,60300067,,,,7,5,12
HND-005387,2011,60300068,,,,6,6,12
HND-005389,2011,60300071,,,,6,3,9
HND-005392,2011,60300075,,,,1,7,8
HND-005393,2011,60300076,,,,6,6,12
HND-005394,2011,60300078,,,,2,4,6
HND-005396,2011,60300081,,,,3,3,6
HND-005399,2011,60300086,,,,3,2,5
HND-005400,2011,60300087,,,,8,3,11
HND-005374,2011,60300049,,,,7,2,9
HND-005375,2011,60300050,,,,4,4,8
HND-005376,2011,60300052,,,,1,6,7
HND-005377,2011,60300053,,,,3,4,7
HND-005382,2011,60300058,,,,4,8,12
HND-005384,2011,60300060,,,,4,1,5
,2011,60300061,,,,5,6,11
,2011,60300062,,,,6,4,10
HND-005385,2011,60300063,,,,3,2,5
,2011,60300064,,,,4,1,5
HND-005390,2011,60300073,,,,3,8,11
HND-005391,2011,60300074,,,,6,5,11
,2011,60300079,,,,6,3,9
HND-005397,2011,60300082,,,,4,3,7
,2011,60300083,,,,4,2,6
HND-005401,2011,60300089,,,,2,2,4
HND-005402,2011,60300090,,,,3,4,7
HND-005403,2011,60300091,,,,4,2,6
,2011,60300092,,,,4,4,8
HND-005374,2011,60300049,,,,6,7,13
HND-005375,2011,60300050,,,,4,5,9
HND-005377,2011,60300053,,,,4,6,10
HND-005382,2011,60300058,,,,8,3,11
HND-005383,2011,60300059,,,,5,23,28
HND-005384,2011,60300060,,,,23,22,45
,2011,60300061,,,,5,7,12
,2011,60300062,,,,10,10,20
HND-005385,2011,60300063,,,,11,6,17
HND-005387,2011,60300068,,,,5,10,15
HND-005390,2011,60300073,,,,14,12,26
HND-005391,2011,60300074,,,,4,3,7
,2011,60300079,,,,8,6,14
HND-005396,2011,60300081,,,,4,4,8
HND-005397,2011,60300082,,,,4,4,8
,2011,60300083,,,,2,5,7
HND-005401,2011,60300089,,,,5,6,11
HND-005402,2011,60300090,,,,2,4,6
HND-005403,2011,60300091,,,,19,22,41
,2011,60300092,,,,2,9,11
HND-005328,2011,60300002,,,,6,5,11
HND-005372,2011,60300047,,,,4,3,7
HND-005376,2011,60300052,,,,4,2,6
,2011,60300064,,,,2,4,6
HND-005386,2011,60300066,,,,10,8,18
,2011,60300067,,,,11,3,14
HND-005389,2011,60300071,,,,5,6,11
HND-005392,2011,60300075,,,,5,10,15
HND-005393,2011,60300076,,,,6,7,13
HND-005394,2011,60300078,,,,4,3,7
HND-005399,2011,60300086,,,,5,10,15
HND-005400,2011,60300087,,,,2,4,6
HND-005329,2011,60300003,,,,1,5,6
HND-005330,2011,60300004,,,,6,2,8
HND-005335,2011,60300009,,,,9,6,15
HND-005338,2011,60300012,,,,25,10,35
HND-005339,2011,60300013,,,,24,11,35
HND-005340,2011,60300014,,,,2,5,7
HND-005343,2011,60300017,,,,6,7,13
HND-005345,2011,60300019,,,,11,11,22
HND-005346,2011,60300020,,,,6,7,13
HND-005347,2011,60300021,,,,16,10,26
HND-005348,2011,60300022,,,,5,0,5
HND-005349,2011,60300023,,,,17,9,26
HND-005355,2011,60300029,,,,9,5,14
HND-005356,2011,60300031,,,,7,8,15
HND-005357,2011,60300032,,,,7,10,17
HND-005358,2011,60300033,,,,17,13,30
HND-005363,2011,60300038,,,,8,6,14
HND-005364,2011,60300039,,,,2,8,10
HND-005366,2011,60300041,,,,2,7,9
,2011,60300045,,,,6,9,15
HND-005371,2011,60300046,,,,1,7,8
HND-005372,2011,60300047,,,,6,6,12
HND-005373,2011,60300048,,,,6,3,9
HND-005379,2011,60300055,,,,8,11,19
HND-005380,2011,60300056,,,,7,8,15
HND-005381,2011,60300057,,,,4,6,10
HND-005386,2011,60300066,,,,5,3,8
HND-005387,2011,60300068,,,,5,7,12
HND-005407,2011,60300097,,,,18,10,28
HND-005411,2011,60300111,,,,3,2,5
HND-005414,2011,60300134,,,,2,6,8
HND-005327,2011,60300001,,,,1,2,3
HND-005331,2011,60300005,,,,10,11,21
HND-005332,2011,60300006,,,,4,8,12
HND-005333,2011,60300007,,,,3,7,10
HND-005334,2011,60300008,,,,6,11,17
HND-005336,2011,60300010,,,,8,7,15
HND-005337,2011,60300011,,,,3,17,20
HND-005341,2011,60300015,,,,6,8,14
HND-005342,2011,60300016,,,,2,3,5
HND-005344,2011,60300018,,,,6,3,9
HND-005350,2011,60300024,,,,9,4,13
HND-005351,2011,60300025,,,,4,6,10
HND-005352,2011,60300026,,,,11,16,27
HND-005353,2011,60300027,,,,3,5,8
HND-005354,2011,60300028,,,,10,11,21
HND-005359,2011,60300034,,,,9,16,25
HND-005360,2011,60300035,,,,5,9,14
HND-005361,2011,60300036,,,,9,7,16
HND-005362,2011,60300037,,,,20,10,30
HND-005365,2011,60300040,,,,10,6,16
HND-005367,2011,60300042,,,,0,2,2
HND-005368,2011,60300043,,,,9,6,15
HND-005369,2011,60300044,,,,7,3,10
HND-005374,2011,60300049,,,,8,12,20
HND-005375,2011,60300050,,,,1,4,5
HND-005376,2011,60300052,,,,6,5,11
HND-005377,2011,60300053,,,,8,9,17
HND-005378,2011,60300054,,,,15,21,36
HND-005395,2011,60300080,,,,1,6,7
HND-005402,2011,60300090,,,,3,2,5
HND-005408,2011,60300099,,,,7,2,9
HND-005415,2011,60300135,,,,7,3,10
HND-005416,2011,60300141,,,,4,3,7
HND-005330,2011,60300004,,,,6,6,12
HND-005331,2011,60300005,,,,5,13,18
HND-005332,2011,60300006,,,,5,11,16
HND-005333,2011,60300007,,,,6,8,14
HND-005340,2011,60300014,,,,2,5,7
HND-005341,2011,60300015,,,,8,7,15
HND-005342,2011,60300016,,,,2,2,4
HND-005343,2011,60300017,,,,7,10,17
HND-005344,2011,60300018,,,,4,6,10
HND-005348,2011,60300022,,,,6,1,7
HND-005350,2011,60300024,,,,7,7,14
HND-005352,2011,60300026,,,,13,20,33
HND-005353,2011,60300027,,,,9,4,13
HND-005357,2011,60300032,,,,4,5,9
HND-005358,2011,60300033,,,,6,11,17
HND-005359,2011,60300034,,,,11,8,19
HND-005364,2011,60300039,,,,4,3,7
HND-005365,2011,60300040,,,,5,6,11
HND-005366,2011,60300041,,,,3,12,15
HND-005367,2011,60300042,,,,1,0,1
HND-005368,2011,60300043,,,,4,5,9
HND-005373,2011,60300048,,,,4,2,6
HND-005374,2011,60300049,,,,16,10,26
HND-005375,2011,60300050,,,,5,6,11
HND-005376,2011,60300052,,,,0,3,3
HND-005377,2011,60300053,,,,6,4,10
HND-005378,2011,60300054,,,,17,14,31
HND-005387,2011,60300068,,,,8,7,15
HND-005395,2011,60300080,,,,5,3,8
HND-005402,2011,60300090,,,,5,4,9
HND-005408,2011,60300099,,,,5,4,9
HND-005414,2011,60300134,,,,2,5,7
HND-005415,2011,60300135,,,,9,11,20
HND-005416,2011,60300141,,,,4,7,11
HND-005327,2011,60300001,,,,4,6,10
HND-005329,2011,60300003,,,,3,5,8
HND-005334,2011,60300008,,,,5,2,7
HND-005335,2011,60300009,,,,8,7,15
HND-005336,2011,60300010,,,,11,7,18
HND-005337,2011,60300011,,,,16,13,29
HND-005338,2011,60300012,,,,24,29,53
HND-005339,2011,60300013,,,,14,15,29
HND-005345,2011,60300019,,,,9,9,18
HND-005346,2011,60300020,,,,7,8,15
HND-005347,2011,60300021,,,,10,11,21
HND-005349,2011,60300023,,,,12,14,26
HND-005351,2011,60300025,,,,7,5,12
HND-005354,2011,60300028,,,,11,5,16
HND-005355,2011,60300029,,,,8,5,13
HND-005356,2011,60300031,,,,16,11,27
HND-005360,2011,60300035,,,,8,3,11
HND-005361,2011,60300036,,,,10,13,23
HND-005362,2011,60300037,,,,14,8,22
HND-005363,2011,60300038,,,,3,5,8
HND-005369,2011,60300044,,,,8,3,11
,2011,60300045,,,,10,6,16
HND-005371,2011,60300046,,,,2,5,7
HND-005372,2011,60300047,,,,6,3,9
HND-005379,2011,60300055,,,,5,8,13
HND-005380,2011,60300056,,,,7,8,15
HND-005381,2011,60300057,,,,7,4,11
HND-005386,2011,60300066,,,,4,8,12
HND-005407,2011,60300097,,,,7,8,15
HND-005411,2011,60300111,,,,5,3,8
HND-005327,2011,60300001,,,,1,0,1
HND-005331,2011,60300005,,,,3,11,14
HND-005332,2011,60300006,,,,4,8,12
HND-005333,2011,60300007,,,,5,9,14
HND-005334,2011,60300008,,,,3,8,11
HND-005337,2011,60300011,,,,10,7,17
HND-005341,2011,60300015,,,,7,5,12
HND-005342,2011,60300016,,,,5,1,6
HND-005343,2011,60300017,,,,8,8,16
HND-005344,2011,60300018,,,,5,4,9
HND-005350,2011,60300024,,,,6,7,13
HND-005351,2011,60300025,,,,8,11,19
HND-005352,2011,60300026,,,,13,12,25
HND-005353,2011,60300027,,,,7,3,10
HND-005359,2011,60300034,,,,9,9,18
HND-005360,2011,60300035,,,,3,6,9
HND-005361,2011,60300036,,,,6,10,16
HND-005362,2011,60300037,,,,11,3,14
HND-005365,2011,60300040,,,,6,3,9
HND-005367,2011,60300042,,,,1,1,2
HND-005368,2011,60300043,,,,5,3,8
HND-005369,2011,60300044,,,,5,8,13
HND-005374,2011,60300049,,,,7,8,15
HND-005375,2011,60300050,,,,5,5,10
HND-005376,2011,60300052,,,,7,7,14
HND-005377,2011,60300053,,,,2,8,10
HND-005378,2011,60300054,,,,10,23,33
HND-005395,2011,60300080,,,,4,5,9
HND-005402,2011,60300090,,,,4,6,10
HND-005408,2011,60300099,,,,3,2,5
HND-005415,2011,60300135,,,,4,5,9
HND-005416,2011,60300141,,,,5,3,8
HND-005329,2011,60300003,,,,4,5,9
HND-005330,2011,60300004,,,,7,4,11
HND-005335,2011,60300009,,,,0,3,3
HND-005336,2011,60300010,,,,7,8,15
HND-005338,2011,60300012,,,,26,23,49
HND-005339,2011,60300013,,,,13,20,33
HND-005340,2011,60300014,,,,7,5,12
HND-005345,2011,60300019,,,,11,9,20
HND-005346,2011,60300020,,,,9,12,21
HND-005347,2011,60300021,,,,6,8,14
HND-005348,2011,60300022,,,,2,2,4
HND-005349,2011,60300023,,,,9,9,18
HND-005354,2011,60300028,,,,8,8,16
HND-005355,2011,60300029,,,,7,7,14
HND-005356,2011,60300031,,,,4,3,7
HND-005357,2011,60300032,,,,6,7,13
HND-005358,2011,60300033,,,,19,11,30
HND-005363,2011,60300038,,,,4,4,8
HND-005364,2011,60300039,,,,4,4,8
HND-005366,2011,60300041,,,,3,10,13
,2011,60300045,,,,7,7,14
HND-005371,2011,60300046,,,,5,2,7
HND-005372,2011,60300047,,,,4,6,10
HND-005373,2011,60300048,,,,8,3,11
HND-005379,2011,60300055,,,,8,7,15
HND-005380,2011,60300056,,,,9,7,16
HND-005381,2011,60300057,,,,5,4,9
HND-005386,2011,60300066,,,,11,2,13
HND-005387,2011,60300068,,,,11,9,20
HND-005407,2011,60300097,,,,10,10,20
HND-005414,2011,60300134,,,,2,1,3
HND-005330,2011,60300004,,,,5,6,11
HND-005333,2011,60300007,,,,4,6,10
HND-005335,2011,60300009,,,,3,5,8
HND-005340,2011,60300014,,,,5,5,10
HND-005341,2011,60300015,,,,9,7,16
HND-005342,2011,60300016,,,,4,6,10
HND-005343,2011,60300017,,,,11,9,20
HND-005346,2011,60300020,,,,10,9,19
HND-005348,2011,60300022,,,,1,5,6
HND-005349,2011,60300023,,,,16,19,35
HND-005350,2011,60300024,,,,4,0,4
HND-005355,2011,60300029,,,,5,6,11
HND-005357,2011,60300032,,,,4,9,13
HND-005358,2011,60300033,,,,16,10,26
HND-005359,2011,60300034,,,,5,5,10
HND-005364,2011,60300039,,,,5,2,7
HND-005365,2011,60300040,,,,7,3,10
HND-005366,2011,60300041,,,,6,5,11
HND-005368,2011,60300043,,,,7,4,11
HND-005373,2011,60300048,,,,5,3,8
HND-005374,2011,60300049,,,,2,8,10
HND-005375,2011,60300050,,,,2,3,5
HND-005378,2011,60300054,,,,15,14,29
HND-005379,2011,60300055,,,,4,6,10
HND-005380,2011,60300056,,,,9,10,19
HND-005387,2011,60300068,,,,5,12,17
HND-005395,2011,60300080,,,,1,4,5
HND-005402,2011,60300090,,,,6,5,11
HND-005414,2011,60300134,,,,3,4,7
HND-005327,2011,60300001,,,,3,5,8
HND-005329,2011,60300003,,,,1,2,3
HND-005331,2011,60300005,,,,2,9,11
HND-005332,2011,60300006,,,,2,6,8
HND-005334,2011,60300008,,,,7,6,13
HND-005336,2011,60300010,,,,6,2,8
HND-005337,2011,60300011,,,,17,12,29
HND-005338,2011,60300012,,,,12,14,26
HND-005339,2011,60300013,,,,16,22,38
HND-005344,2011,60300018,,,,2,7,9
HND-005345,2011,60300019,,,,3,6,9
HND-005347,2011,60300021,,,,12,7,19
HND-005351,2011,60300025,,,,6,6,12
HND-005352,2011,60300026,,,,14,13,27
HND-005353,2011,60300027,,,,6,3,9
HND-005354,2011,60300028,,,,6,7,13
HND-005356,2011,60300031,,,,6,5,11
HND-005360,2011,60300035,,,,11,7,18
HND-005361,2011,60300036,,,,12,6,18
HND-005362,2011,60300037,,,,7,9,16
HND-005363,2011,60300038,,,,1,5,6
HND-005367,2011,60300042,,,,4,0,4
HND-005369,2011,60300044,,,,1,3,4
,2011,60300045,,,,5,11,16
HND-005371,2011,60300046,,,,5,3,8
HND-005372,2011,60300047,,,,5,7,12
HND-005376,2011,60300052,,,,4,0,4
HND-005377,2011,60300053,,,,3,1,4
HND-005381,2011,60300057,,,,6,3,9
HND-005386,2011,60300066,,,,3,12,15
HND-005407,2011,60300097,,,,11,5,16
HND-005408,2011,60300099,,,,4,6,10
HND-005411,2011,60300111,,,,3,1,4
HND-005415,2011,60300135,,,,13,10,23
HND-005416,2011,60300141,,,,5,3,8
HND-005327,2011,60300001,,,,0,2,2
HND-005329,2011,60300003,,,,2,5,7
HND-005330,2011,60300004,,,,8,2,10
HND-005335,2011,60300009,,,,2,2,4
HND-005336,2011,60300010,,,,7,11,18
HND-005337,2011,60300011,,,,8,7,15
HND-005338,2011,60300012,,,,22,15,37
HND-005340,2011,60300014,,,,3,7,10
HND-005343,2011,60300017,,,,9,8,17
HND-005347,2011,60300021,,,,15,8,23
HND-005348,2011,60300022,,,,4,5,9
HND-005349,2011,60300023,,,,10,5,15
HND-005350,2011,60300024,,,,3,3,6
HND-005355,2011,60300029,,,,9,3,12
HND-005356,2011,60300031,,,,12,9,21
HND-005357,2011,60300032,,,,9,7,16
HND-005358,2011,60300033,,,,11,10,21
HND-005363,2011,60300038,,,,8,7,15
HND-005364,2011,60300039,,,,5,1,6
HND-005365,2011,60300040,,,,3,5,8
HND-005366,2011,60300041,,,,5,7,12
,2011,60300045,,,,11,7,18
HND-005371,2011,60300046,,,,5,3,8
HND-005373,2011,60300048,,,,1,2,3
HND-005379,2011,60300055,,,,3,1,4
HND-005380,2011,60300056,,,,4,9,13
HND-005381,2011,60300057,,,,2,5,7
HND-005386,2011,60300066,,,,4,5,9
HND-005387,2011,60300068,,,,10,11,21
HND-005395,2011,60300080,,,,5,3,8
HND-005407,2011,60300097,,,,9,6,15
HND-005411,2011,60300111,,,,1,3,4
HND-005414,2011,60300134,,,,3,5,8
HND-005331,2011,60300005,,,,9,10,19
HND-005332,2011,60300006,,,,7,6,13
HND-005333,2011,60300007,,,,3,8,11
HND-005334,2011,60300008,,,,1,7,8
HND-005339,2011,60300013,,,,12,15,27
HND-005341,2011,60300015,,,,5,6,11
HND-005342,2011,60300016,,,,8,2,10
HND-005344,2011,60300018,,,,5,2,7
HND-005345,2011,60300019,,,,9,17,26
HND-005346,2011,60300020,,,,3,9,12
HND-005351,2011,60300025,,,,4,8,12
HND-005352,2011,60300026,,,,11,16,27
HND-005353,2011,60300027,,,,5,4,9
HND-005354,2011,60300028,,,,9,6,15
HND-005359,2011,60300034,,,,11,9,20
HND-005360,2011,60300035,,,,4,3,7
HND-005361,2011,60300036,,,,5,14,19
HND-005362,2011,60300037,,,,7,5,12
HND-005367,2011,60300042,,,,1,0,1
HND-005368,2011,60300043,,,,3,7,10
HND-005369,2011,60300044,,,,6,3,9
HND-005372,2011,60300047,,,,6,3,9
HND-005374,2011,60300049,,,,8,9,17
HND-005375,2011,60300050,,,,2,2,4
HND-005376,2011,60300052,,,,7,6,13
HND-005377,2011,60300053,,,,1,6,7
HND-005378,2011,60300054,,,,9,13,22
HND-005402,2011,60300090,,,,4,5,9
HND-005408,2011,60300099,,,,3,1,4
HND-005415,2011,60300135,,,,6,8,14
HND-005416,2011,60300141,,,,3,7,10
HND-005330,2011,60300004,,,,4,5,9
HND-005331,2011,60300005,,,,7,9,16
HND-005332,2011,60300006,,,,6,7,13
HND-005333,2011,60300007,,,,6,11,17
HND-005340,2011,60300014,,,,4,3,7
HND-005341,2011,60300015,,,,5,5,10
HND-005342,2011,60300016,,,,2,5,7
HND-005343,2011,60300017,,,,10,7,17
HND-005344,2011,60300018,,,,5,5,10
HND-005348,2011,60300022,,,,6,6,12
HND-005350,2011,60300024,,,,7,3,10
HND-005352,2011,60300026,,,,17,15,32
HND-005353,2011,60300027,,,,1,2,3
HND-005356,2011,60300031,,,,9,8,17
HND-005360,2011,60300035,,,,2,3,5
HND-005361,2011,60300036,,,,5,3,8
HND-005363,2011,60300038,,,,0,4,4
HND-005369,2011,60300044,,,,2,4,6
,2011,60300045,,,,6,8,14
HND-005371,2011,60300046,,,,4,4,8
HND-005372,2011,60300047,,,,4,4,8
HND-005379,2011,60300055,,,,5,4,9
HND-005380,2011,60300056,,,,5,6,11
HND-005381,2011,60300057,,,,5,2,7
HND-005387,2011,60300068,,,,4,4,8
HND-005407,2011,60300097,,,,13,5,18
HND-005327,2011,60300001,,,,3,4,7
HND-005329,2011,60300003,,,,4,3,7
HND-005334,2011,60300008,,,,8,2,10
HND-005335,2011,60300009,,,,5,3,8
HND-005336,2011,60300010,,,,2,7,9
HND-005337,2011,60300011,,,,12,16,28
HND-005338,2011,60300012,,,,9,16,25
HND-005339,2011,60300013,,,,12,8,20
HND-005345,2011,60300019,,,,3,1,4
HND-005346,2011,60300020,,,,7,8,15
HND-005347,2011,60300021,,,,8,7,15
HND-005349,2011,60300023,,,,9,13,22
HND-005351,2011,60300025,,,,7,4,11
HND-005354,2011,60300028,,,,2,4,6
HND-005355,2011,60300029,,,,8,11,19
HND-005357,2011,60300032,,,,7,8,15
HND-005358,2011,60300033,,,,7,6,13
HND-005359,2011,60300034,,,,9,9,18
HND-005362,2011,60300037,,,,4,2,6
HND-005364,2011,60300039,,,,7,2,9
HND-005365,2011,60300040,,,,5,10,15
HND-005366,2011,60300041,,,,5,4,9
HND-005367,2011,60300042,,,,5,1,6
HND-005368,2011,60300043,,,,7,2,9
HND-005373,2011,60300048,,,,2,1,3
HND-005374,2011,60300049,,,,6,6,12
HND-005375,2011,60300050,,,,4,4,8
HND-005376,2011,60300052,,,,0,3,3
HND-005377,2011,60300053,,,,9,2,11
HND-005378,2011,60300054,,,,13,15,28
HND-005386,2011,60300066,,,,6,2,8
HND-005395,2011,60300080,,,,1,2,3
HND-005402,2011,60300090,,,,4,5,9
HND-005408,2011,60300099,,,,2,4,6
HND-005411,2011,60300111,,,,1,1,2
HND-005414,2011,60300134,,,,1,2,3
HND-005415,2011,60300135,,,,3,7,10
HND-005416,2011,60300141,,,,1,4,5
HND-005340,2011,60300014,,,,32,20,52
HND-005358,2011,60300033,,,,11,13,24
,2011,60300136,,,,9,3,12
HND-005388,2011,60300070,,,,74,53,127
,2011,60300137,,,,30,21,51
,2011,60300138,,,,5,6,11
,2011,60300139,,,,3,6,9
,2011,60300140,,,,17,7,24
,2011,60300201,,,,18,9,27
HND-005340,2011,60300014,,,,19,22,41
HND-005358,2011,60300033,,,,11,13,24
,2011,60300136,,,,2,6,8
,2011,60300137,,,,21,16,37
,2011,60300139,,,,3,2,5
,2011,60300201,,,,5,11,16
HND-005388,2011,60300070,,,,68,61,129
,2011,60300138,,,,5,7,12
,2011,60300140,,,,9,6,15
HND-005340,2011,60300014,,,,23,16,39
HND-005358,2011,60300033,,,,8,11,19
,2011,60300138,,,,11,6,17
,2011,60300139,,,,7,1,8
,2011,60300140,,,,4,4,8
HND-005388,2011,60300070,,,,71,51,122
,2011,60300136,,,,4,3,7
,2011,60300137,,,,23,15,38
,2011,60300201,,,,3,15,18
HND-005388,2011,60300070,,,,29,21,50
,2011,60300140,,,,4,4,8
,2011,60300137,,,,25,22,47
,2011,60300137,,,,35,37,72
HND-005388,2011,60300070,,,,40,42,82
,2011,60300140,,,,1,1,2
HND-005388,2011,60300070,,,,33,37,70
HND-005429,2011,60400017,,,,7,15,22
HND-005426,2011,60400014,,,,3,1,4
HND-005427,2011,60400015,,,,2,6,8
HND-005428,2011,60400016,,,,7,2,9
HND-005426,2011,60400014,,,,5,2,7
HND-005429,2011,60400017,,,,9,10,19
HND-005427,2011,60400015,,,,7,3,10
HND-005428,2011,60400016,,,,6,3,9
HND-005418,2011,60400001,,,,16,20,36
HND-005419,2011,60400002,,,,10,5,15
HND-005420,2011,60400003,,,,1,4,5
HND-005421,2011,60400004,,,,4,1,5
HND-005431,2011,60400019,,,,6,2,8
HND-005432,2011,60400020,,,,4,2,6
HND-005422,2011,60400005,,,,6,0,6
HND-005423,2011,60400006,,,,1,3,4
HND-005424,2011,60400007,,,,13,8,21
HND-005425,2011,60400008,,,,4,2,6
HND-005418,2011,60400001,,,,13,15,28
HND-005421,2011,60400004,,,,1,1,2
HND-005422,2011,60400005,,,,3,5,8
HND-005423,2011,60400006,,,,2,2,4
HND-005424,2011,60400007,,,,6,10,16
HND-005425,2011,60400008,,,,3,1,4
HND-005419,2011,60400002,,,,9,5,14
HND-005420,2011,60400003,,,,8,8,16
HND-005431,2011,60400019,,,,2,5,7
HND-005432,2011,60400020,,,,1,2,3
HND-005422,2011,60400005,,,,4,3,7
HND-005423,2011,60400006,,,,2,2,4
HND-005424,2011,60400007,,,,8,10,18
HND-005425,2011,60400008,,,,1,0,1
HND-005418,2011,60400001,,,,24,13,37
HND-005419,2011,60400002,,,,4,3,7
HND-005420,2011,60400003,,,,7,7,14
HND-005421,2011,60400004,,,,1,3,4
HND-005431,2011,60400019,,,,5,1,6
HND-005432,2011,60400020,,,,1,1,2
HND-005418,2011,60400001,,,,29,21,50
HND-005421,2011,60400004,,,,1,1,2
HND-005422,2011,60400005,,,,4,2,6
HND-005423,2011,60400006,,,,3,0,3
HND-005424,2011,60400007,,,,9,3,12
HND-005419,2011,60400002,,,,7,5,12
HND-005420,2011,60400003,,,,3,5,8
HND-005425,2011,60400008,,,,6,2,8
HND-005431,2011,60400019,,,,2,0,2
HND-005432,2011,60400020,,,,1,1,2
HND-005418,2011,60400001,,,,16,14,30
HND-005419,2011,60400002,,,,2,4,6
HND-005424,2011,60400007,,,,7,3,10
HND-005432,2011,60400020,,,,2,2,4
HND-005420,2011,60400003,,,,6,4,10
HND-005422,2011,60400005,,,,1,8,9
HND-005423,2011,60400006,,,,0,3,3
HND-005425,2011,60400008,,,,0,3,3
HND-005431,2011,60400019,,,,5,0,5
HND-005419,2011,60400002,,,,10,3,13
HND-005420,2011,60400003,,,,5,5,10
HND-005431,2011,60400019,,,,0,1,1
HND-005432,2011,60400020,,,,0,1,1
HND-005418,2011,60400001,,,,17,16,33
HND-005422,2011,60400005,,,,3,1,4
HND-005423,2011,60400006,,,,2,1,3
HND-005424,2011,60400007,,,,8,6,14
HND-005425,2011,60400008,,,,2,2,4
HND-005430,2011,60400018,,,,20,24,44
HND-005430,2011,60400018,,,,22,15,37
HND-005430,2011,60400018,,,,8,18,26
HND-005430,2011,60400018,,,,9,12,21
HND-005430,2011,60400018,,,,5,15,20
HND-005430,2011,60400018,,,,11,13,24
HND-005467,2011,60500038,,,,9,12,21
,2011,60500084,,,,3,6,9
HND-005496,2011,60500092,,,,5,5,10
HND-005500,2011,60500119,,,,8,9,17
,2011,60500122,,,,7,5,12
,2011,60500125,,,,5,10,15
HND-005501,2011,60500126,,,,6,6,12
HND-005466,2011,60500037,,,,8,2,10
HND-005468,2011,60500040,,,,8,6,14
,2011,60500075,,,,7,6,13
HND-005491,2011,60500081,,,,10,10,20
HND-005492,2011,60500085,,,,5,8,13
HND-005493,2011,60500087,,,,10,6,16
HND-005495,2011,60500090,,,,10,11,21
,2011,60500091,,,,6,6,12
HND-005497,2011,60500110,,,,4,4,8
,2011,60500123,,,,7,8,15
,2011,60500124,,,,7,4,11
HND-005433,2011,60500001,,,,1,2,3
HND-005489,2011,60500074,,,,4,1,5
,2011,60500077,,,,2,0,2
,2011,60500118,,,,0,1,1
HND-005433,2011,60500001,,,,4,4,8
HND-005434,2011,60500003,,,,4,8,12
HND-005478,2011,60500055,,,,2,3,5
,2011,60500056,,,,1,1,2
,2011,60500060,,,,2,6,8
,2011,60500061,,,,7,2,9
HND-005489,2011,60500074,,,,3,2,5
HND-005490,2011,60500079,,,,1,0,1
HND-005451,2011,60500020,,,,1,1,2
HND-005480,2011,60500058,,,,3,4,7
HND-005488,2011,60500071,,,,3,1,4
,2011,60500076,,,,2,4,6
,2011,60500077,,,,6,5,11
HND-005451,2011,60500020,,,,8,3,11
HND-005481,2011,60500059,,,,20,18,38
HND-005488,2011,60500071,,,,10,6,16
HND-005489,2011,60500074,,,,4,2,6
,2011,60500076,,,,6,13,19
,2011,60500077,,,,7,6,13
HND-005433,2011,60500001,,,,7,4,11
HND-005434,2011,60500003,,,,14,14,28
HND-005478,2011,60500055,,,,4,6,10
,2011,60500056,,,,7,7,14
HND-005480,2011,60500058,,,,17,13,30
,2011,60500060,,,,8,8,16
,2011,60500061,,,,16,20,36
HND-005487,2011,60500070,,,,7,10,17
HND-005490,2011,60500079,,,,11,9,20
,2011,60500118,,,,4,5,9
HND-005433,2011,60500001,,,,5,4,9
HND-005435,2011,60500004,,,,8,6,14
HND-005436,2011,60500005,,,,18,20,38
HND-005440,2011,60500009,,,,13,12,25
HND-005442,2011,60500011,,,,1,1,2
HND-005446,2011,60500015,,,,7,3,10
HND-005447,2011,60500016,,,,6,5,11
HND-005448,2011,60500017,,,,6,8,14
HND-005449,2011,60500018,,,,5,8,13
HND-005455,2011,60500025,,,,20,8,28
HND-005456,2011,60500026,,,,7,3,10
HND-005457,2011,60500027,,,,7,6,13
HND-005461,2011,60500032,,,,6,0,6
,2011,60500033,,,,17,13,30
HND-005463,2011,60500034,,,,7,3,10
,2011,60500039,,,,21,15,36
HND-005469,2011,60500041,,,,7,6,13
HND-005472,2011,60500045,,,,7,6,13
HND-005473,2011,60500046,,,,5,3,8
HND-005475,2011,60500051,,,,7,8,15
HND-005476,2011,60500053,,,,20,21,41
HND-005482,2011,60500062,,,,7,6,13
HND-005494,2011,60500089,,,,5,8,13
HND-005437,2011,60500006,,,,15,9,24
HND-005438,2011,60500007,,,,8,2,10
HND-005439,2011,60500008,,,,3,2,5
HND-005441,2011,60500010,,,,1,4,5
HND-005443,2011,60500012,,,,1,1,2
HND-005444,2011,60500013,,,,5,11,16
HND-005445,2011,60500014,,,,13,11,24
HND-005450,2011,60500019,,,,14,12,26
HND-005451,2011,60500020,,,,13,9,22
HND-005452,2011,60500021,,,,5,4,9
HND-005453,2011,60500022,,,,6,6,12
HND-005454,2011,60500023,,,,3,3,6
HND-005458,2011,60500028,,,,12,11,23
HND-005459,2011,60500029,,,,9,16,25
HND-005460,2011,60500031,,,,5,1,6
HND-005464,2011,60500035,,,,4,7,11
HND-005465,2011,60500036,,,,7,7,14
HND-005466,2011,60500037,,,,2,7,9
HND-005467,2011,60500038,,,,9,9,18
HND-005468,2011,60500040,,,,8,8,16
HND-005470,2011,60500042,,,,11,8,19
HND-005471,2011,60500043,,,,3,5,8
HND-005474,2011,60500050,,,,5,5,10
HND-005477,2011,60500054,,,,4,3,7
HND-005479,2011,60500057,,,,6,7,13
HND-005483,2011,60500064,,,,7,6,13
HND-005484,2011,60500065,,,,6,5,11
HND-005485,2011,60500066,,,,4,2,6
HND-005486,2011,60500067,,,,6,6,12
HND-005435,2011,60500004,,,,3,3,6
HND-005436,2011,60500005,,,,18,22,40
HND-005437,2011,60500006,,,,15,11,26
HND-005438,2011,60500007,,,,4,2,6
HND-005441,2011,60500010,,,,5,10,15
HND-005442,2011,60500011,,,,1,0,1
HND-005443,2011,60500012,,,,1,4,5
HND-005444,2011,60500013,,,,10,8,18
HND-005449,2011,60500018,,,,7,2,9
HND-005450,2011,60500019,,,,14,14,28
HND-005451,2011,60500020,,,,10,6,16
HND-005452,2011,60500021,,,,5,2,7
HND-005454,2011,60500023,,,,1,1,2
HND-005455,2011,60500025,,,,7,7,14
HND-005456,2011,60500026,,,,1,10,11
HND-005458,2011,60500028,,,,11,9,20
HND-005463,2011,60500034,,,,4,4,8
HND-005464,2011,60500035,,,,3,3,6
HND-005465,2011,60500036,,,,9,3,12
HND-005466,2011,60500037,,,,9,6,15
HND-005468,2011,60500040,,,,11,1,12
HND-005469,2011,60500041,,,,10,9,19
HND-005470,2011,60500042,,,,6,6,12
HND-005471,2011,60500043,,,,4,7,11
HND-005476,2011,60500053,,,,14,22,36
HND-005477,2011,60500054,,,,2,7,9
HND-005482,2011,60500062,,,,2,4,6
HND-005483,2011,60500064,,,,2,4,6
HND-005486,2011,60500067,,,,2,2,4
HND-005433,2011,60500001,,,,2,8,10
HND-005439,2011,60500008,,,,1,0,1
HND-005440,2011,60500009,,,,17,11,28
HND-005445,2011,60500014,,,,9,5,14
HND-005446,2011,60500015,,,,9,12,21
HND-005447,2011,60500016,,,,3,5,8
HND-005448,2011,60500017,,,,11,3,14
HND-005453,2011,60500022,,,,5,5,10
HND-005457,2011,60500027,,,,9,4,13
HND-005459,2011,60500029,,,,6,9,15
HND-005460,2011,60500031,,,,6,2,8
HND-005461,2011,60500032,,,,4,9,13
,2011,60500033,,,,17,16,33
HND-005467,2011,60500038,,,,13,12,25
,2011,60500039,,,,11,11,22
HND-005472,2011,60500045,,,,4,2,6
HND-005473,2011,60500046,,,,1,4,5
HND-005474,2011,60500050,,,,5,5,10
HND-005475,2011,60500051,,,,3,4,7
HND-005479,2011,60500057,,,,5,6,11
HND-005484,2011,60500065,,,,6,4,10
HND-005485,2011,60500066,,,,1,3,4
HND-005494,2011,60500089,,,,5,11,16
HND-005435,2011,60500004,,,,3,10,13
HND-005437,2011,60500006,,,,7,12,19
HND-005438,2011,60500007,,,,8,5,13
HND-005439,2011,60500008,,,,3,1,4
HND-005441,2011,60500010,,,,13,8,21
HND-005443,2011,60500012,,,,2,5,7
HND-005444,2011,60500013,,,,6,7,13
HND-005445,2011,60500014,,,,13,10,23
HND-005450,2011,60500019,,,,10,7,17
HND-005451,2011,60500020,,,,9,16,25
HND-005452,2011,60500021,,,,9,3,12
HND-005453,2011,60500022,,,,3,6,9
HND-005454,2011,60500023,,,,1,2,3
HND-005458,2011,60500028,,,,9,12,21
HND-005459,2011,60500029,,,,6,6,12
HND-005460,2011,60500031,,,,0,4,4
HND-005464,2011,60500035,,,,2,5,7
HND-005465,2011,60500036,,,,8,5,13
HND-005466,2011,60500037,,,,9,5,14
HND-005467,2011,60500038,,,,14,10,24
HND-005468,2011,60500040,,,,6,7,13
HND-005470,2011,60500042,,,,6,4,10
HND-005471,2011,60500043,,,,5,3,8
HND-005474,2011,60500050,,,,6,6,12
HND-005477,2011,60500054,,,,3,2,5
HND-005479,2011,60500057,,,,8,9,17
HND-005483,2011,60500064,,,,3,5,8
HND-005484,2011,60500065,,,,3,4,7
HND-005485,2011,60500066,,,,1,2,3
HND-005486,2011,60500067,,,,5,2,7
HND-005433,2011,60500001,,,,5,4,9
HND-005436,2011,60500005,,,,21,18,39
HND-005440,2011,60500009,,,,10,7,17
HND-005442,2011,60500011,,,,3,2,5
HND-005446,2011,60500015,,,,4,8,12
HND-005447,2011,60500016,,,,3,4,7
HND-005448,2011,60500017,,,,1,4,5
HND-005449,2011,60500018,,,,4,2,6
HND-005455,2011,60500025,,,,8,10,18
HND-005456,2011,60500026,,,,11,6,17
HND-005457,2011,60500027,,,,5,3,8
HND-005461,2011,60500032,,,,5,2,7
,2011,60500033,,,,15,17,32
HND-005463,2011,60500034,,,,7,4,11
,2011,60500039,,,,8,4,12
HND-005469,2011,60500041,,,,8,4,12
HND-005472,2011,60500045,,,,7,0,7
HND-005473,2011,60500046,,,,4,2,6
HND-005475,2011,60500051,,,,5,5,10
HND-005476,2011,60500053,,,,13,13,26
HND-005482,2011,60500062,,,,6,4,10
HND-005494,2011,60500089,,,,7,5,12
HND-005435,2011,60500004,,,,3,2,5
HND-005436,2011,60500005,,,,20,17,37
HND-005438,2011,60500007,,,,4,3,7
HND-005440,2011,60500009,,,,10,10,20
HND-005441,2011,60500010,,,,14,6,20
HND-005442,2011,60500011,,,,1,2,3
HND-005444,2011,60500013,,,,2,10,12
HND-005449,2011,60500018,,,,7,3,10
HND-005450,2011,60500019,,,,11,11,22
HND-005452,2011,60500021,,,,3,2,5
HND-005455,2011,60500025,,,,7,12,19
HND-005456,2011,60500026,,,,5,4,9
HND-005457,2011,60500027,,,,3,3,6
HND-005458,2011,60500028,,,,4,10,14
HND-005461,2011,60500032,,,,1,8,9
HND-005463,2011,60500034,,,,5,9,14
HND-005466,2011,60500037,,,,11,5,16
HND-005468,2011,60500040,,,,5,6,11
HND-005469,2011,60500041,,,,3,2,5
HND-005470,2011,60500042,,,,5,7,12
HND-005471,2011,60500043,,,,4,5,9
HND-005475,2011,60500051,,,,3,1,4
HND-005476,2011,60500053,,,,8,15,23
HND-005482,2011,60500062,,,,4,2,6
HND-005483,2011,60500064,,,,6,6,12
HND-005433,2011,60500001,,,,4,5,9
HND-005437,2011,60500006,,,,7,6,13
HND-005439,2011,60500008,,,,2,0,2
HND-005443,2011,60500012,,,,4,2,6
HND-005445,2011,60500014,,,,12,6,18
HND-005446,2011,60500015,,,,14,8,22
HND-005447,2011,60500016,,,,5,10,15
HND-005448,2011,60500017,,,,6,12,18
HND-005451,2011,60500020,,,,9,8,17
HND-005453,2011,60500022,,,,4,2,6
HND-005454,2011,60500023,,,,1,1,2
HND-005459,2011,60500029,,,,15,2,17
HND-005460,2011,60500031,,,,5,3,8
,2011,60500033,,,,22,18,40
HND-005464,2011,60500035,,,,1,1,2
HND-005465,2011,60500036,,,,0,3,3
HND-005467,2011,60500038,,,,10,10,20
,2011,60500039,,,,8,8,16
HND-005472,2011,60500045,,,,2,3,5
HND-005473,2011,60500046,,,,2,3,5
HND-005474,2011,60500050,,,,3,2,5
HND-005477,2011,60500054,,,,2,1,3
HND-005479,2011,60500057,,,,2,7,9
HND-005484,2011,60500065,,,,6,7,13
HND-005485,2011,60500066,,,,3,1,4
HND-005486,2011,60500067,,,,2,6,8
HND-005494,2011,60500089,,,,5,6,11
HND-005433,2011,60500001,,,,5,5,10
HND-005437,2011,60500006,,,,9,7,16
HND-005438,2011,60500007,,,,7,7,14
HND-005439,2011,60500008,,,,2,1,3
HND-005443,2011,60500012,,,,4,1,5
HND-005444,2011,60500013,,,,4,6,10
HND-005445,2011,60500014,,,,10,13,23
HND-005448,2011,60500017,,,,4,2,6
HND-005450,2011,60500019,,,,10,10,20
HND-005451,2011,60500020,,,,9,9,18
HND-005453,2011,60500022,,,,4,6,10
HND-005454,2011,60500023,,,,0,1,1
HND-005459,2011,60500029,,,,6,11,17
HND-005461,2011,60500032,,,,4,3,7
,2011,60500033,,,,16,14,30
HND-005463,2011,60500034,,,,4,3,7
,2011,60500039,,,,10,9,19
HND-005468,2011,60500040,,,,9,7,16
HND-005469,2011,60500041,,,,1,2,3
HND-005471,2011,60500043,,,,4,3,7
HND-005472,2011,60500045,,,,2,1,3
HND-005473,2011,60500046,,,,1,5,6
HND-005475,2011,60500051,,,,2,4,6
HND-005476,2011,60500053,,,,14,20,34
HND-005484,2011,60500065,,,,5,5,10
HND-005485,2011,60500066,,,,3,4,7
HND-005486,2011,60500067,,,,1,2,3
HND-005435,2011,60500004,,,,5,7,12
HND-005436,2011,60500005,,,,14,12,26
HND-005440,2011,60500009,,,,12,7,19
HND-005441,2011,60500010,,,,12,4,16
HND-005442,2011,60500011,,,,2,0,2
HND-005446,2011,60500015,,,,13,13,26
HND-005447,2011,60500016,,,,9,3,12
HND-005449,2011,60500018,,,,1,5,6
HND-005452,2011,60500021,,,,4,6,10
HND-005455,2011,60500025,,,,7,6,13
HND-005456,2011,60500026,,,,9,8,17
HND-005457,2011,60500027,,,,4,5,9
HND-005458,2011,60500028,,,,9,6,15
HND-005460,2011,60500031,,,,4,3,7
HND-005464,2011,60500035,,,,3,2,5
HND-005465,2011,60500036,,,,9,11,20
HND-005466,2011,60500037,,,,4,2,6
HND-005467,2011,60500038,,,,11,17,28
HND-005470,2011,60500042,,,,11,4,15
HND-005474,2011,60500050,,,,5,3,8
HND-005477,2011,60500054,,,,3,1,4
HND-005479,2011,60500057,,,,7,6,13
HND-005482,2011,60500062,,,,8,8,16
HND-005483,2011,60500064,,,,6,5,11
HND-005494,2011,60500089,,,,6,6,12
HND-005435,2011,60500004,,,,7,4,11
HND-005436,2011,60500005,,,,15,16,31
HND-005437,2011,60500006,,,,8,5,13
HND-005438,2011,60500007,,,,4,1,5
HND-005441,2011,60500010,,,,11,12,23
HND-005442,2011,60500011,,,,0,1,1
HND-005443,2011,60500012,,,,7,1,8
HND-005444,2011,60500013,,,,4,8,12
HND-005449,2011,60500018,,,,3,3,6
HND-005450,2011,60500019,,,,13,6,19
HND-005451,2011,60500020,,,,14,11,25
HND-005452,2011,60500021,,,,2,2,4
HND-005454,2011,60500023,,,,2,1,3
HND-005455,2011,60500025,,,,6,5,11
HND-005456,2011,60500026,,,,7,4,11
HND-005458,2011,60500028,,,,11,8,19
HND-005460,2011,60500031,,,,5,6,11
HND-005461,2011,60500032,,,,4,3,7
,2011,60500033,,,,22,18,40
HND-005467,2011,60500038,,,,9,17,26
,2011,60500039,,,,3,8,11
HND-005472,2011,60500045,,,,6,2,8
HND-005473,2011,60500046,,,,5,3,8
HND-005474,2011,60500050,,,,7,4,11
HND-005475,2011,60500051,,,,3,5,8
HND-005479,2011,60500057,,,,4,2,6
HND-005482,2011,60500062,,,,0,2,2
HND-005483,2011,60500064,,,,4,5,9
HND-005486,2011,60500067,,,,4,3,7
HND-005494,2011,60500089,,,,5,7,12
HND-005433,2011,60500001,,,,6,3,9
HND-005439,2011,60500008,,,,0,2,2
HND-005440,2011,60500009,,,,10,14,24
HND-005445,2011,60500014,,,,14,8,22
HND-005446,2011,60500015,,,,4,8,12
HND-005447,2011,60500016,,,,5,6,11
HND-005448,2011,60500017,,,,4,7,11
HND-005453,2011,60500022,,,,7,6,13
HND-005457,2011,60500027,,,,5,2,7
HND-005459,2011,60500029,,,,9,6,15
HND-005463,2011,60500034,,,,4,5,9
HND-005464,2011,60500035,,,,4,0,4
HND-005465,2011,60500036,,,,16,14,30
HND-005466,2011,60500037,,,,4,7,11
HND-005468,2011,60500040,,,,7,3,10
HND-005469,2011,60500041,,,,2,3,5
HND-005470,2011,60500042,,,,7,6,13
HND-005471,2011,60500043,,,,1,8,9
HND-005476,2011,60500053,,,,17,16,33
HND-005477,2011,60500054,,,,3,3,6
HND-005484,2011,60500065,,,,4,5,9
HND-005485,2011,60500066,,,,1,2,3
HND-005449,2011,60500018,,,,13,11,24
HND-005498,2011,60500114,,,,73,53,126
HND-005450,2011,60500019,,,,19,23,42
HND-005499,2011,60500115,,,,25,29,54
HND-005499,2011,60500115,,,,29,25,54
HND-005449,2011,60500018,,,,12,16,28
HND-005450,2011,60500019,,,,10,18,28
HND-005498,2011,60500114,,,,46,31,77
HND-005449,2011,60500018,,,,12,8,20
HND-005450,2011,60500019,,,,17,18,35
HND-005498,2011,60500114,,,,49,42,91
HND-005499,2011,60500115,,,,28,34,62
HND-005499,2011,60500115,,,,28,21,49
HND-005498,2011,60500114,,,,43,36,79
HND-005498,2011,60500114,,,,34,20,54
HND-005499,2011,60500115,,,,20,19,39
HND-005499,2011,60500115,,,,14,22,36
HND-005498,2011,60500114,,,,44,37,81
HND-005577,2011,60600106,,,,4,6,10
,2011,60600107,,,,8,8,16
HND-005581,2011,60600121,,,,5,5,10
HND-005582,2011,60600158,,,,6,6,12
,2011,60600169,,,,7,4,11
,2011,60600170,,,,7,8,15
HND-005584,2011,60600171,,,,5,4,9
HND-005587,2011,60600184,,,,17,6,23
,2011,60600185,,,,7,8,15
,2011,60600186,,,,11,8,19
HND-005588,2011,60600187,,,,3,7,10
HND-005590,2011,60600191,,,,4,5,9
,2011,60600197,,,,6,9,15
,2011,60600157,,,,8,11,19
,2011,60600160,,,,4,4,8
,2011,60600161,,,,6,9,15
,2011,60600162,,,,6,9,15
,2011,60600164,,,,13,7,20
,2011,60600165,,,,4,12,16
HND-005583,2011,60600167,,,,10,7,17
,2011,60600168,,,,11,4,15
,2011,60600173,,,,5,4,9
,2011,60600178,,,,4,8,12
,2011,60600179,,,,17,9,26
,2011,60600182,,,,6,7,13
HND-005586,2011,60600183,,,,11,10,21
,2011,60600188,,,,12,5,17
,2011,60600198,,,,9,11,20
,2011,60600199,,,,3,6,9
HND-005592,2011,60600200,,,,11,9,20
,2011,60600205,,,,5,1,6
HND-005594,2011,60600206,,,,2,8,10
HND-005595,2011,60600207,,,,4,6,10
,2011,60600202,,,,1,2,3
,2011,60600103,,,,13,9,22
HND-005502,2011,60600002,,,,10,13,23
,2011,60600055,,,,4,2,6
HND-005553,2011,60600060,,,,5,7,12
HND-005558,2011,60600066,,,,6,12,18
HND-005561,2011,60600069,,,,3,8,11
HND-005562,2011,60600070,,,,3,7,10
HND-005563,2011,60600071,,,,6,5,11
HND-005567,2011,60600078,,,,14,3,17
,2011,60600084,,,,3,2,5
HND-005570,2011,60600086,,,,3,5,8
HND-005571,2011,60600087,,,,1,1,2
HND-005572,2011,60600088,,,,7,7,14
HND-005574,2011,60600090,,,,5,4,9
,2011,60600092,,,,10,6,16
,2011,60600104,,,,4,5,9
,2011,60600112,,,,5,7,12
,2011,60600180,,,,7,3,10
,2011,60600194,,,,4,4,8
,2011,60600202,,,,3,2,5
HND-005593,2011,60600203,,,,2,5,7
HND-005503,2011,60600003,,,,10,9,19
,2011,60600005,,,,7,5,12
HND-005559,2011,60600067,,,,2,8,10
HND-005565,2011,60600073,,,,11,12,23
HND-005566,2011,60600074,,,,8,4,12
,2011,60600075,,,,5,2,7
,2011,60600076,,,,1,6,7
HND-005568,2011,60600081,,,,5,6,11
HND-005573,2011,60600089,,,,8,5,13
,2011,60600096,,,,6,4,10
,2011,60600097,,,,1,5,6
,2011,60600103,,,,11,9,20
HND-005578,2011,60600109,,,,7,4,11
,2011,60600111,,,,4,5,9
HND-005580,2011,60600114,,,,2,2,4
HND-005591,2011,60600193,,,,4,5,9
,2011,60600005,,,,4,4,8
HND-005559,2011,60600067,,,,14,8,22
HND-005566,2011,60600074,,,,5,8,13
,2011,60600075,,,,7,6,13
,2011,60600076,,,,7,5,12
HND-005568,2011,60600081,,,,4,1,5
HND-005570,2011,60600086,,,,6,6,12
,2011,60600096,,,,1,6,7
,2011,60600097,,,,10,11,21
,2011,60600103,,,,9,10,19
HND-005578,2011,60600109,,,,7,5,12
,2011,60600111,,,,1,5,6
HND-005580,2011,60600114,,,,7,5,12
HND-005591,2011,60600193,,,,5,6,11
,2011,60600202,,,,3,3,6
HND-005502,2011,60600002,,,,26,14,40
HND-005503,2011,60600003,,,,19,28,47
,2011,60600055,,,,13,7,20
HND-005553,2011,60600060,,,,1,1,2
HND-005558,2011,60600066,,,,35,37,72
HND-005560,2011,60600068,,,,19,21,40
HND-005561,2011,60600069,,,,21,20,41
HND-005562,2011,60600070,,,,9,6,15
HND-005563,2011,60600071,,,,0,7,7
HND-005565,2011,60600073,,,,8,6,14
HND-005567,2011,60600078,,,,11,10,21
,2011,60600084,,,,11,18,29
HND-005571,2011,60600087,,,,4,11,15
HND-005572,2011,60600088,,,,19,13,32
HND-005573,2011,60600089,,,,9,10,19
HND-005574,2011,60600090,,,,11,4,15
,2011,60600092,,,,3,2,5
,2011,60600093,,,,10,7,17
,2011,60600104,,,,6,6,12
,2011,60600112,,,,2,6,8
,2011,60600180,,,,5,5,10
HND-005589,2011,60600190,,,,9,4,13
,2011,60600194,,,,7,5,12
HND-005593,2011,60600203,,,,4,5,9
HND-005506,2011,60600009,,,,11,8,19
HND-005509,2011,60600012,,,,35,17,52
HND-005511,2011,60600014,,,,5,3,8
HND-005513,2011,60600016,,,,91,72,163
HND-005514,2011,60600017,,,,12,6,18
HND-005516,2011,60600019,,,,5,2,7
,2011,60600024,,,,4,8,12
HND-005520,2011,60600025,,,,9,6,15
HND-005521,2011,60600026,,,,16,13,29
HND-005522,2011,60600027,,,,4,1,5
HND-005523,2011,60600028,,,,22,16,38
HND-005525,2011,60600030,,,,17,20,37
HND-005527,2011,60600032,,,,8,0,8
HND-005528,2011,60600033,,,,2,10,12
HND-005529,2011,60600034,,,,20,24,44
HND-005534,2011,60600039,,,,16,6,22
,2011,60600042,,,,7,7,14
HND-005538,2011,60600044,,,,11,12,23
HND-005539,2011,60600045,,,,19,9,28
HND-005540,2011,60600046,,,,15,6,21
HND-005541,2011,60600047,,,,5,4,9
HND-005545,2011,60600051,,,,2,1,3
HND-005549,2011,60600056,,,,9,5,14
HND-005550,2011,60600057,,,,8,5,13
HND-005551,2011,60600058,,,,6,7,13
HND-005553,2011,60600060,,,,9,5,14
HND-005555,2011,60600063,,,,5,3,8
HND-005556,2011,60600064,,,,15,14,29
HND-005569,2011,60600085,,,,4,3,7
HND-005570,2011,60600086,,,,10,3,13
HND-005575,2011,60600100,,,,5,1,6
HND-005576,2011,60600101,,,,4,2,6
HND-005579,2011,60600113,,,,7,6,13
HND-005589,2011,60600190,,,,7,6,13
,2011,60600007,,,,12,10,22
HND-005505,2011,60600008,,,,3,6,9
HND-005507,2011,60600010,,,,23,18,41
HND-005508,2011,60600011,,,,2,10,12
HND-005510,2011,60600013,,,,45,43,88
HND-005512,2011,60600015,,,,10,8,18
HND-005515,2011,60600018,,,,6,6,12
HND-005517,2011,60600020,,,,10,7,17
,2011,60600022,,,,20,22,42
HND-005519,2011,60600023,,,,7,8,15
HND-005524,2011,60600029,,,,10,9,19
HND-005526,2011,60600031,,,,11,14,25
,2011,60600035,,,,6,6,12
HND-005531,2011,60600036,,,,9,5,14
HND-005532,2011,60600037,,,,6,1,7
HND-005533,2011,60600038,,,,8,6,14
HND-005535,2011,60600040,,,,24,13,37
HND-005536,2011,60600041,,,,30,22,52
HND-005537,2011,60600043,,,,7,2,9
HND-005542,2011,60600048,,,,13,16,29
HND-005543,2011,60600049,,,,5,10,15
HND-005544,2011,60600050,,,,9,7,16
HND-005546,2011,60600052,,,,9,9,18
HND-005547,2011,60600053,,,,16,7,23
HND-005548,2011,60600054,,,,10,8,18
HND-005552,2011,60600059,,,,6,6,12
HND-005554,2011,60600061,,,,22,21,43
HND-005557,2011,60600065,,,,18,12,30
HND-005568,2011,60600081,,,,5,5,10
HND-005580,2011,60600114,,,,8,2,10
HND-005591,2011,60600193,,,,9,13,22
,2011,60600196,,,,3,3,6
,2011,60600007,,,,6,7,13
HND-005510,2011,60600013,,,,36,25,61
HND-005512,2011,60600015,,,,9,7,16
HND-005514,2011,60600017,,,,7,14,21
HND-005515,2011,60600018,,,,5,3,8
HND-005517,2011,60600020,,,,19,7,26
HND-005519,2011,60600023,,,,9,5,14
HND-005520,2011,60600025,,,,10,8,18
HND-005523,2011,60600028,,,,27,26,53
HND-005524,2011,60600029,,,,15,17,32
HND-005529,2011,60600034,,,,28,25,53
,2011,60600035,,,,4,6,10
HND-005531,2011,60600036,,,,4,3,7
HND-005532,2011,60600037,,,,3,2,5
HND-005536,2011,60600041,,,,21,27,48
HND-005539,2011,60600045,,,,16,13,29
HND-005540,2011,60600046,,,,8,10,18
HND-005541,2011,60600047,,,,6,3,9
HND-005542,2011,60600048,,,,16,12,28
HND-005544,2011,60600050,,,,6,3,9
HND-005545,2011,60600051,,,,2,2,4
HND-005546,2011,60600052,,,,9,10,19
HND-005547,2011,60600053,,,,7,6,13
HND-005551,2011,60600058,,,,11,1,12
HND-005552,2011,60600059,,,,3,7,10
HND-005556,2011,60600064,,,,9,17,26
HND-005557,2011,60600065,,,,10,8,18
HND-005568,2011,60600081,,,,3,2,5
HND-005569,2011,60600085,,,,8,6,14
HND-005570,2011,60600086,,,,4,6,10
HND-005575,2011,60600100,,,,4,3,7
HND-005579,2011,60600113,,,,3,6,9
HND-005580,2011,60600114,,,,2,2,4
HND-005589,2011,60600190,,,,11,9,20
,2011,60600196,,,,3,6,9
HND-005505,2011,60600008,,,,5,3,8
HND-005506,2011,60600009,,,,3,3,6
HND-005507,2011,60600010,,,,9,10,19
HND-005508,2011,60600011,,,,10,9,19
HND-005509,2011,60600012,,,,25,26,51
HND-005511,2011,60600014,,,,8,5,13
HND-005513,2011,60600016,,,,99,82,181
HND-005516,2011,60600019,,,,3,5,8
,2011,60600022,,,,27,28,55
,2011,60600024,,,,9,6,15
HND-005521,2011,60600026,,,,7,8,15
HND-005522,2011,60600027,,,,5,4,9
HND-005525,2011,60600030,,,,10,11,21
HND-005526,2011,60600031,,,,10,8,18
HND-005527,2011,60600032,,,,7,5,12
HND-005528,2011,60600033,,,,4,1,5
HND-005533,2011,60600038,,,,4,4,8
HND-005534,2011,60600039,,,,13,14,27
HND-005535,2011,60600040,,,,22,19,41
,2011,60600042,,,,6,6,12
HND-005537,2011,60600043,,,,8,7,15
HND-005538,2011,60600044,,,,5,12,17
HND-005543,2011,60600049,,,,10,6,16
HND-005548,2011,60600054,,,,5,6,11
HND-005549,2011,60600056,,,,5,6,11
HND-005550,2011,60600057,,,,2,3,5
HND-005553,2011,60600060,,,,3,6,9
HND-005554,2011,60600061,,,,20,12,32
HND-005555,2011,60600063,,,,3,3,6
HND-005576,2011,60600101,,,,3,4,7
HND-005591,2011,60600193,,,,4,9,13
,2011,60600007,,,,11,6,17
HND-005505,2011,60600008,,,,4,4,8
HND-005507,2011,60600010,,,,3,13,16
HND-005508,2011,60600011,,,,6,6,12
HND-005510,2011,60600013,,,,32,36,68
HND-005512,2011,60600015,,,,16,8,24
HND-005514,2011,60600017,,,,10,9,19
HND-005515,2011,60600018,,,,5,4,9
HND-005517,2011,60600020,,,,13,6,19
,2011,60600022,,,,23,18,41
HND-005519,2011,60600023,,,,6,6,12
HND-005523,2011,60600028,,,,33,25,58
HND-005524,2011,60600029,,,,17,10,27
HND-005526,2011,60600031,,,,9,11,20
,2011,60600035,,,,5,4,9
HND-005531,2011,60600036,,,,3,4,7
HND-005532,2011,60600037,,,,7,9,16
HND-005533,2011,60600038,,,,4,5,9
HND-005535,2011,60600040,,,,20,18,38
HND-005536,2011,60600041,,,,18,22,40
HND-005537,2011,60600043,,,,1,7,8
HND-005539,2011,60600045,,,,8,11,19
HND-005540,2011,60600046,,,,7,8,15
HND-005542,2011,60600048,,,,11,9,20
HND-005543,2011,60600049,,,,10,4,14
HND-005544,2011,60600050,,,,3,4,7
HND-005545,2011,60600051,,,,0,4,4
HND-005546,2011,60600052,,,,13,4,17
HND-005547,2011,60600053,,,,11,10,21
HND-005548,2011,60600054,,,,11,9,20
HND-005552,2011,60600059,,,,7,3,10
HND-005554,2011,60600061,,,,8,13,21
HND-005557,2011,60600065,,,,10,8,18
HND-005568,2011,60600081,,,,4,4,8
HND-005580,2011,60600114,,,,6,9,15
HND-005591,2011,60600193,,,,5,9,14
,2011,60600196,,,,3,9,12
HND-005506,2011,60600009,,,,9,12,21
HND-005509,2011,60600012,,,,21,18,39
HND-005511,2011,60600014,,,,1,7,8
HND-005513,2011,60600016,,,,68,51,119
HND-005516,2011,60600019,,,,4,6,10
,2011,60600024,,,,10,5,15
HND-005520,2011,60600025,,,,5,6,11
HND-005521,2011,60600026,,,,12,7,19
HND-005522,2011,60600027,,,,3,10,13
HND-005525,2011,60600030,,,,29,20,49
HND-005527,2011,60600032,,,,3,7,10
HND-005528,2011,60600033,,,,1,4,5
HND-005529,2011,60600034,,,,19,14,33
HND-005534,2011,60600039,,,,10,18,28
,2011,60600042,,,,6,8,14
HND-005538,2011,60600044,,,,6,7,13
HND-005541,2011,60600047,,,,2,3,5
HND-005549,2011,60600056,,,,7,5,12
HND-005550,2011,60600057,,,,5,0,5
HND-005551,2011,60600058,,,,7,13,20
HND-005553,2011,60600060,,,,3,4,7
HND-005555,2011,60600063,,,,4,1,5
HND-005556,2011,60600064,,,,10,9,19
HND-005569,2011,60600085,,,,1,3,4
HND-005570,2011,60600086,,,,4,5,9
HND-005575,2011,60600100,,,,1,7,8
HND-005576,2011,60600101,,,,9,3,12
HND-005579,2011,60600113,,,,7,6,13
HND-005589,2011,60600190,,,,7,1,8
,2011,60600007,,,,7,10,17
HND-005506,2011,60600009,,,,5,5,10
HND-005510,2011,60600013,,,,28,42,70
HND-005511,2011,60600014,,,,7,7,14
HND-005512,2011,60600015,,,,17,7,24
HND-005513,2011,60600016,,,,94,48,142
HND-005514,2011,60600017,,,,6,6,12
HND-005520,2011,60600025,,,,8,8,16
HND-005521,2011,60600026,,,,14,10,24
HND-005522,2011,60600027,,,,8,3,11
HND-005523,2011,60600028,,,,20,19,39
HND-005527,2011,60600032,,,,3,7,10
HND-005529,2011,60600034,,,,9,13,22
HND-005532,2011,60600037,,,,4,2,6
HND-005534,2011,60600039,,,,11,19,30
HND-005538,2011,60600044,,,,18,16,34
HND-005539,2011,60600045,,,,9,7,16
HND-005540,2011,60600046,,,,10,2,12
HND-005541,2011,60600047,,,,4,2,6
HND-005542,2011,60600048,,,,8,9,17
HND-005544,2011,60600050,,,,7,4,11
HND-005545,2011,60600051,,,,4,2,6
HND-005549,2011,60600056,,,,3,2,5
HND-005551,2011,60600058,,,,3,3,6
HND-005556,2011,60600064,,,,7,9,16
HND-005557,2011,60600065,,,,7,14,21
HND-005568,2011,60600081,,,,3,5,8
HND-005569,2011,60600085,,,,6,2,8
HND-005570,2011,60600086,,,,6,7,13
HND-005575,2011,60600100,,,,3,3,6
HND-005576,2011,60600101,,,,3,3,6
HND-005579,2011,60600113,,,,9,5,14
HND-005580,2011,60600114,,,,7,4,11
,2011,60600196,,,,7,6,13
HND-005505,2011,60600008,,,,6,4,10
HND-005507,2011,60600010,,,,8,5,13
HND-005508,2011,60600011,,,,9,10,19
HND-005509,2011,60600012,,,,18,24,42
HND-005515,2011,60600018,,,,5,4,9
HND-005516,2011,60600019,,,,6,3,9
HND-005517,2011,60600020,,,,7,6,13
,2011,60600022,,,,19,26,45
HND-005519,2011,60600023,,,,3,7,10
,2011,60600024,,,,8,3,11
HND-005524,2011,60600029,,,,15,23,38
HND-005525,2011,60600030,,,,20,18,38
HND-005526,2011,60600031,,,,12,3,15
HND-005528,2011,60600033,,,,6,3,9
,2011,60600035,,,,7,4,11
HND-005531,2011,60600036,,,,4,3,7
HND-005533,2011,60600038,,,,5,2,7
HND-005535,2011,60600040,,,,21,19,40
HND-005536,2011,60600041,,,,20,22,42
,2011,60600042,,,,7,2,9
HND-005537,2011,60600043,,,,7,6,13
HND-005543,2011,60600049,,,,6,3,9
HND-005546,2011,60600052,,,,7,8,15
HND-005547,2011,60600053,,,,8,7,15
HND-005548,2011,60600054,,,,8,11,19
HND-005550,2011,60600057,,,,5,0,5
HND-005552,2011,60600059,,,,6,7,13
HND-005553,2011,60600060,,,,11,4,15
HND-005554,2011,60600061,,,,9,9,18
HND-005555,2011,60600063,,,,4,9,13
HND-005589,2011,60600190,,,,6,3,9
HND-005591,2011,60600193,,,,10,5,15
HND-005506,2011,60600009,,,,8,7,15
HND-005509,2011,60600012,,,,18,18,36
HND-005511,2011,60600014,,,,4,4,8
HND-005512,2011,60600015,,,,12,20,32
HND-005513,2011,60600016,,,,74,90,164
HND-005514,2011,60600017,,,,10,9,19
HND-005520,2011,60600025,,,,7,3,10
HND-005521,2011,60600026,,,,7,12,19
HND-005522,2011,60600027,,,,7,4,11
HND-005523,2011,60600028,,,,19,15,34
HND-005525,2011,60600030,,,,21,23,44
HND-005527,2011,60600032,,,,6,3,9
HND-005528,2011,60600033,,,,3,0,3
HND-005529,2011,60600034,,,,10,7,17
HND-005534,2011,60600039,,,,17,9,26
HND-005538,2011,60600044,,,,11,12,23
HND-005539,2011,60600045,,,,7,7,14
HND-005540,2011,60600046,,,,7,7,14
HND-005541,2011,60600047,,,,2,5,7
HND-005545,2011,60600051,,,,4,1,5
HND-005549,2011,60600056,,,,3,9,12
HND-005550,2011,60600057,,,,4,4,8
HND-005551,2011,60600058,,,,5,4,9
HND-005556,2011,60600064,,,,6,8,14
HND-005569,2011,60600085,,,,4,5,9
HND-005570,2011,60600086,,,,10,7,17
HND-005575,2011,60600100,,,,3,3,6
HND-005576,2011,60600101,,,,2,4,6
HND-005579,2011,60600113,,,,8,5,13
HND-005591,2011,60600193,,,,8,7,15
,2011,60600196,,,,2,3,5
,2011,60600007,,,,6,10,16
HND-005505,2011,60600008,,,,7,4,11
HND-005507,2011,60600010,,,,9,10,19
HND-005508,2011,60600011,,,,4,4,8
HND-005510,2011,60600013,,,,36,34,70
HND-005515,2011,60600018,,,,8,10,18
HND-005516,2011,60600019,,,,5,10,15
HND-005517,2011,60600020,,,,12,3,15
,2011,60600022,,,,18,14,32
HND-005519,2011,60600023,,,,4,7,11
,2011,60600024,,,,3,5,8
HND-005524,2011,60600029,,,,21,24,45
HND-005526,2011,60600031,,,,12,10,22
,2011,60600035,,,,11,4,15
HND-005531,2011,60600036,,,,6,4,10
HND-005532,2011,60600037,,,,7,5,12
HND-005533,2011,60600038,,,,3,2,5
HND-005535,2011,60600040,,,,20,18,38
HND-005536,2011,60600041,,,,22,35,57
,2011,60600042,,,,3,4,7
HND-005537,2011,60600043,,,,3,4,7
HND-005542,2011,60600048,,,,11,8,19
HND-005543,2011,60600049,,,,8,7,15
HND-005544,2011,60600050,,,,2,8,10
HND-005546,2011,60600052,,,,13,12,25
HND-005547,2011,60600053,,,,12,7,19
HND-005548,2011,60600054,,,,6,12,18
HND-005552,2011,60600059,,,,4,3,7
HND-005553,2011,60600060,,,,10,6,16
HND-005554,2011,60600061,,,,14,14,28
HND-005555,2011,60600063,,,,1,5,6
HND-005557,2011,60600065,,,,7,13,20
HND-005568,2011,60600081,,,,2,3,5
HND-005580,2011,60600114,,,,4,5,9
HND-005589,2011,60600190,,,,2,4,6
HND-005505,2011,60600008,,,,6,3,9
HND-005506,2011,60600009,,,,3,4,7
HND-005507,2011,60600010,,,,16,14,30
HND-005508,2011,60600011,,,,4,8,12
HND-005509,2011,60600012,,,,19,19,38
HND-005511,2011,60600014,,,,2,10,12
HND-005513,2011,60600016,,,,85,69,154
HND-005516,2011,60600019,,,,6,7,13
,2011,60600022,,,,18,18,36
,2011,60600024,,,,3,4,7
HND-005520,2011,60600025,,,,5,11,16
HND-005521,2011,60600026,,,,20,8,28
HND-005522,2011,60600027,,,,4,6,10
HND-005525,2011,60600030,,,,32,21,53
HND-005526,2011,60600031,,,,9,17,26
HND-005527,2011,60600032,,,,9,8,17
HND-005528,2011,60600033,,,,5,4,9
HND-005533,2011,60600038,,,,8,7,15
HND-005534,2011,60600039,,,,17,11,28
HND-005535,2011,60600040,,,,6,16,22
,2011,60600042,,,,4,8,12
HND-005537,2011,60600043,,,,8,10,18
HND-005538,2011,60600044,,,,15,16,31
HND-005543,2011,60600049,,,,8,6,14
HND-005548,2011,60600054,,,,5,11,16
HND-005549,2011,60600056,,,,6,6,12
HND-005550,2011,60600057,,,,4,2,6
HND-005553,2011,60600060,,,,7,4,11
HND-005554,2011,60600061,,,,8,13,21
HND-005555,2011,60600063,,,,3,3,6
HND-005576,2011,60600101,,,,5,3,8
HND-005591,2011,60600193,,,,9,6,15
,2011,60600007,,,,8,7,15
HND-005510,2011,60600013,,,,27,21,48
HND-005512,2011,60600015,,,,8,11,19
HND-005514,2011,60600017,,,,2,6,8
HND-005515,2011,60600018,,,,8,6,14
HND-005517,2011,60600020,,,,5,7,12
HND-005519,2011,60600023,,,,5,2,7
HND-005523,2011,60600028,,,,13,19,32
HND-005524,2011,60600029,,,,33,25,58
HND-005529,2011,60600034,,,,13,10,23
,2011,60600035,,,,9,6,15
HND-005531,2011,60600036,,,,6,6,12
HND-005532,2011,60600037,,,,6,8,14
HND-005536,2011,60600041,,,,14,16,30
HND-005539,2011,60600045,,,,10,12,22
HND-005540,2011,60600046,,,,2,4,6
HND-005541,2011,60600047,,,,2,5,7
HND-005542,2011,60600048,,,,8,10,18
HND-005544,2011,60600050,,,,4,1,5
HND-005545,2011,60600051,,,,6,3,9
HND-005546,2011,60600052,,,,4,12,16
HND-005547,2011,60600053,,,,6,8,14
HND-005551,2011,60600058,,,,5,6,11
HND-005552,2011,60600059,,,,1,3,4
HND-005556,2011,60600064,,,,5,6,11
HND-005557,2011,60600065,,,,10,12,22
HND-005568,2011,60600081,,,,0,5,5
HND-005569,2011,60600085,,,,4,6,10
HND-005570,2011,60600086,,,,6,5,11
HND-005575,2011,60600100,,,,4,3,7
HND-005579,2011,60600113,,,,3,11,14
HND-005580,2011,60600114,,,,2,4,6
HND-005589,2011,60600190,,,,1,4,5
,2011,60600196,,,,9,8,17
HND-005523,2011,60600028,,,,24,32,56
,2011,60600022,,,,23,19,42
HND-005524,2011,60600029,,,,55,56,111
HND-005536,2011,60600041,,,,20,23,43
HND-005564,2011,60600072,,,,199,198,397
HND-005585,2011,60600181,,,,45,42,87
HND-005523,2011,60600028,,,,31,27,58
HND-005524,2011,60600029,,,,42,53,95
HND-005536,2011,60600041,,,,14,8,22
HND-005585,2011,60600181,,,,30,37,67
,2011,60600022,,,,14,15,29
HND-005564,2011,60600072,,,,160,135,295
HND-005523,2011,60600028,,,,28,25,53
HND-005564,2011,60600072,,,,148,123,271
,2011,60600022,,,,20,11,31
HND-005524,2011,60600029,,,,52,50,102
HND-005536,2011,60600041,,,,7,6,13
HND-005585,2011,60600181,,,,35,34,69
HND-005585,2011,60600181,,,,17,32,49
HND-005564,2011,60600072,,,,131,122,253
HND-005585,2011,60600181,,,,25,21,46
HND-005564,2011,60600072,,,,111,111,222
HND-005564,2011,60600072,,,,136,103,239
HND-005614,2011,60700022,,,,3,9,12
HND-005616,2011,60700024,,,,6,5,11
HND-005662,2011,60700075,,,,25,26,51
HND-005663,2011,60700076,,,,7,8,15
HND-005665,2011,60700080,,,,8,8,16
HND-005670,2011,60700104,,,,22,13,35
HND-005604,2011,60700011,,,,6,7,13
,2011,60700077,,,,4,6,10
HND-005664,2011,60700079,,,,7,6,13
HND-005669,2011,60700102,,,,4,4,8
,2011,60700105,,,,6,9,15
HND-005598,2011,60700005,,,,11,2,13
HND-005599,2011,60700006,,,,7,3,10
HND-005641,2011,60700049,,,,12,11,23
HND-005643,2011,60700051,,,,15,13,28
HND-005644,2011,60700052,,,,7,16,23
HND-005645,2011,60700053,,,,3,8,11
HND-005649,2011,60700058,,,,13,8,21
HND-005650,2011,60700059,,,,6,5,11
HND-005652,2011,60700061,,,,2,9,11
HND-005656,2011,60700065,,,,6,8,14
HND-005657,2011,60700066,,,,1,1,2
,2011,60700070,,,,8,7,15
,2011,60700081,,,,0,1,1
HND-005667,2011,60700100,,,,4,3,7
HND-005596,2011,60700002,,,,5,9,14
HND-005597,2011,60700003,,,,9,7,16
HND-005642,2011,60700050,,,,5,9,14
HND-005646,2011,60700054,,,,3,7,10
HND-005647,2011,60700055,,,,12,13,25
HND-005648,2011,60700056,,,,6,6,12
,2011,60700057,,,,4,3,7
HND-005651,2011,60700060,,,,4,8,12
HND-005653,2011,60700062,,,,10,4,14
,2011,60700063,,,,6,2,8
HND-005655,2011,60700064,,,,5,4,9
HND-005659,2011,60700069,,,,2,7,9
HND-005668,2011,60700101,,,,5,5,10
,2011,60700103,,,,0,3,3
HND-005597,2011,60700003,,,,16,7,23
HND-005598,2011,60700005,,,,2,7,9
HND-005599,2011,60700006,,,,18,17,35
HND-005641,2011,60700049,,,,21,10,31
HND-005643,2011,60700051,,,,24,18,42
HND-005644,2011,60700052,,,,10,13,23
HND-005645,2011,60700053,,,,7,10,17
HND-005649,2011,60700058,,,,10,22,32
HND-005650,2011,60700059,,,,21,14,35
HND-005651,2011,60700060,,,,7,13,20
HND-005652,2011,60700061,,,,11,7,18
HND-005653,2011,60700062,,,,7,8,15
,2011,60700063,,,,5,5,10
HND-005659,2011,60700069,,,,16,17,33
,2011,60700070,,,,5,7,12
,2011,60700081,,,,1,3,4
,2011,60700103,,,,5,3,8
HND-005596,2011,60700002,,,,2,4,6
HND-005642,2011,60700050,,,,26,20,46
HND-005646,2011,60700054,,,,16,15,31
HND-005647,2011,60700055,,,,15,12,27
HND-005648,2011,60700056,,,,20,30,50
,2011,60700057,,,,8,9,17
HND-005655,2011,60700064,,,,10,8,18
HND-005656,2011,60700065,,,,10,7,17
HND-005657,2011,60700066,,,,6,9,15
HND-005667,2011,60700100,,,,8,7,15
HND-005668,2011,60700101,,,,14,10,24
HND-005601,2011,60700008,,,,18,31,49
HND-005603,2011,60700010,,,,20,20,40
HND-005604,2011,60700011,,,,14,6,20
HND-005605,2011,60700012,,,,4,8,12
HND-005606,2011,60700013,,,,17,10,27
HND-005607,2011,60700014,,,,10,7,17
HND-005612,2011,60700019,,,,3,2,5
,2011,60700020,,,,40,33,73
HND-005613,2011,60700021,,,,51,50,101
HND-005614,2011,60700022,,,,3,8,11
HND-005615,2011,60700023,,,,2,5,7
HND-005620,2011,60700028,,,,23,26,49
HND-005621,2011,60700029,,,,17,11,28
HND-005622,2011,60700030,,,,7,1,8
HND-005623,2011,60700031,,,,14,12,26
HND-005624,2011,60700032,,,,15,11,26
HND-005625,2011,60700033,,,,2,0,2
HND-005631,2011,60700039,,,,50,45,95
HND-005632,2011,60700040,,,,21,16,37
HND-005634,2011,60700042,,,,1,3,4
HND-005635,2011,60700043,,,,2,1,3
HND-005636,2011,60700044,,,,17,18,35
HND-005658,2011,60700068,,,,1,2,3
HND-005659,2011,60700069,,,,43,23,66
,2011,60700081,,,,2,1,3
HND-005666,2011,60700098,,,,0,4,4
,2011,60700103,,,,3,7,10
HND-005600,2011,60700007,,,,17,22,39
HND-005602,2011,60700009,,,,21,16,37
HND-005608,2011,60700015,,,,4,7,11
HND-005609,2011,60700016,,,,7,9,16
HND-005610,2011,60700017,,,,3,5,8
HND-005611,2011,60700018,,,,5,3,8
HND-005616,2011,60700024,,,,6,7,13
HND-005617,2011,60700025,,,,15,7,22
HND-005618,2011,60700026,,,,5,4,9
HND-005619,2011,60700027,,,,5,4,9
HND-005626,2011,60700034,,,,8,12,20
HND-005627,2011,60700035,,,,6,11,17
HND-005628,2011,60700036,,,,12,8,20
HND-005629,2011,60700037,,,,58,57,115
HND-005630,2011,60700038,,,,30,27,57
HND-005633,2011,60700041,,,,30,12,42
HND-005637,2011,60700045,,,,44,43,87
HND-005638,2011,60700046,,,,40,42,82
HND-005639,2011,60700047,,,,14,10,24
HND-005640,2011,60700048,,,,12,7,19
HND-005661,2011,60700074,,,,14,18,32
HND-005601,2011,60700008,,,,14,16,30
HND-005602,2011,60700009,,,,12,8,20
HND-005605,2011,60700012,,,,9,4,13
HND-005607,2011,60700014,,,,13,12,25
HND-005608,2011,60700015,,,,2,7,9
HND-005609,2011,60700016,,,,8,5,13
HND-005610,2011,60700017,,,,2,6,8
,2011,60700020,,,,36,37,73
HND-005614,2011,60700022,,,,2,7,9
HND-005615,2011,60700023,,,,5,7,12
HND-005616,2011,60700024,,,,5,2,7
HND-005621,2011,60700029,,,,13,4,17
HND-005622,2011,60700030,,,,2,2,4
HND-005623,2011,60700031,,,,7,13,20
HND-005625,2011,60700033,,,,2,0,2
HND-005627,2011,60700035,,,,5,11,16
HND-005630,2011,60700038,,,,16,14,30
HND-005631,2011,60700039,,,,49,43,92
HND-005632,2011,60700040,,,,25,20,45
HND-005633,2011,60700041,,,,4,10,14
HND-005634,2011,60700042,,,,2,2,4
HND-005635,2011,60700043,,,,4,7,11
HND-005640,2011,60700048,,,,13,7,20
HND-005658,2011,60700068,,,,2,3,5
HND-005659,2011,60700069,,,,26,19,45
,2011,60700081,,,,3,0,3
HND-005666,2011,60700098,,,,1,2,3
,2011,60700103,,,,3,3,6
HND-005600,2011,60700007,,,,23,22,45
HND-005603,2011,60700010,,,,12,17,29
HND-005604,2011,60700011,,,,4,9,13
HND-005606,2011,60700013,,,,17,12,29
HND-005611,2011,60700018,,,,2,1,3
HND-005612,2011,60700019,,,,2,2,4
HND-005613,2011,60700021,,,,43,37,80
HND-005617,2011,60700025,,,,18,13,31
HND-005618,2011,60700026,,,,5,1,6
HND-005619,2011,60700027,,,,2,4,6
HND-005620,2011,60700028,,,,29,24,53
HND-005624,2011,60700032,,,,7,12,19
HND-005626,2011,60700034,,,,8,10,18
HND-005628,2011,60700036,,,,12,7,19
HND-005629,2011,60700037,,,,32,48,80
HND-005636,2011,60700044,,,,18,21,39
HND-005637,2011,60700045,,,,30,37,67
HND-005638,2011,60700046,,,,45,31,76
HND-005639,2011,60700047,,,,10,4,14
HND-005661,2011,60700074,,,,23,21,44
HND-005600,2011,60700007,,,,18,19,37
HND-005601,2011,60700008,,,,14,17,31
HND-005602,2011,60700009,,,,12,16,28
HND-005607,2011,60700014,,,,14,9,23
HND-005608,2011,60700015,,,,6,5,11
HND-005609,2011,60700016,,,,9,7,16
HND-005610,2011,60700017,,,,3,3,6
HND-005611,2011,60700018,,,,3,1,4
HND-005614,2011,60700022,,,,3,3,6
HND-005616,2011,60700024,,,,0,4,4
HND-005617,2011,60700025,,,,16,8,24
HND-005618,2011,60700026,,,,3,3,6
HND-005619,2011,60700027,,,,1,4,5
HND-005622,2011,60700030,,,,7,3,10
HND-005623,2011,60700031,,,,10,6,16
HND-005624,2011,60700032,,,,10,12,22
HND-005625,2011,60700033,,,,1,2,3
HND-005630,2011,60700038,,,,14,22,36
HND-005631,2011,60700039,,,,50,37,87
HND-005632,2011,60700040,,,,20,11,31
HND-005634,2011,60700042,,,,0,2,2
HND-005635,2011,60700043,,,,6,6,12
HND-005636,2011,60700044,,,,17,14,31
,2011,60700081,,,,6,1,7
,2011,60700103,,,,0,4,4
HND-005603,2011,60700010,,,,21,14,35
HND-005604,2011,60700011,,,,12,12,24
HND-005605,2011,60700012,,,,3,8,11
HND-005606,2011,60700013,,,,13,7,20
HND-005612,2011,60700019,,,,0,1,1
,2011,60700020,,,,34,29,63
HND-005613,2011,60700021,,,,29,29,58
HND-005615,2011,60700023,,,,2,2,4
HND-005620,2011,60700028,,,,35,31,66
HND-005621,2011,60700029,,,,7,6,13
HND-005626,2011,60700034,,,,13,4,17
HND-005627,2011,60700035,,,,8,15,23
HND-005628,2011,60700036,,,,9,7,16
HND-005629,2011,60700037,,,,29,34,63
HND-005633,2011,60700041,,,,7,16,23
HND-005637,2011,60700045,,,,48,46,94
HND-005638,2011,60700046,,,,32,23,55
HND-005639,2011,60700047,,,,0,5,5
HND-005640,2011,60700048,,,,4,4,8
HND-005658,2011,60700068,,,,0,2,2
HND-005659,2011,60700069,,,,12,13,25
HND-005661,2011,60700074,,,,20,25,45
HND-005601,2011,60700008,,,,20,12,32
HND-005605,2011,60700012,,,,11,6,17
HND-005606,2011,60700013,,,,5,9,14
HND-005607,2011,60700014,,,,8,14,22
HND-005610,2011,60700017,,,,2,3,5
HND-005612,2011,60700019,,,,1,2,3
,2011,60700020,,,,19,29,48
HND-005613,2011,60700021,,,,34,45,79
HND-005614,2011,60700022,,,,4,1,5
HND-005615,2011,60700023,,,,5,2,7
HND-005616,2011,60700024,,,,1,4,5
HND-005621,2011,60700029,,,,8,5,13
HND-005623,2011,60700031,,,,12,16,28
HND-005627,2011,60700035,,,,11,10,21
HND-005628,2011,60700036,,,,13,6,19
HND-005629,2011,60700037,,,,22,28,50
HND-005630,2011,60700038,,,,16,16,32
HND-005632,2011,60700040,,,,12,16,28
HND-005633,2011,60700041,,,,8,14,22
HND-005634,2011,60700042,,,,3,1,4
HND-005635,2011,60700043,,,,5,9,14
HND-005640,2011,60700048,,,,15,5,20
HND-005658,2011,60700068,,,,1,5,6
HND-005659,2011,60700069,,,,17,12,29
,2011,60700103,,,,2,2,4
HND-005600,2011,60700007,,,,21,16,37
HND-005602,2011,60700009,,,,4,17,21
HND-005603,2011,60700010,,,,5,12,17
HND-005604,2011,60700011,,,,9,12,21
HND-005608,2011,60700015,,,,2,1,3
HND-005609,2011,60700016,,,,9,9,18
HND-005611,2011,60700018,,,,1,0,1
HND-005617,2011,60700025,,,,7,8,15
HND-005618,2011,60700026,,,,2,1,3
HND-005619,2011,60700027,,,,2,3,5
HND-005620,2011,60700028,,,,22,38,60
HND-005622,2011,60700030,,,,2,6,8
HND-005624,2011,60700032,,,,8,10,18
HND-005625,2011,60700033,,,,2,1,3
HND-005626,2011,60700034,,,,9,16,25
HND-005631,2011,60700039,,,,42,46,88
HND-005636,2011,60700044,,,,21,20,41
HND-005637,2011,60700045,,,,48,47,95
HND-005638,2011,60700046,,,,30,30,60
HND-005639,2011,60700047,,,,5,5,10
HND-005661,2011,60700074,,,,18,17,35
,2011,60700081,,,,1,1,2
HND-005601,2011,60700008,,,,20,17,37
HND-005603,2011,60700010,,,,4,12,16
HND-005605,2011,60700012,,,,3,12,15
HND-005606,2011,60700013,,,,14,11,25
HND-005607,2011,60700014,,,,14,9,23
HND-005612,2011,60700019,,,,3,2,5
,2011,60700020,,,,28,27,55
HND-005613,2011,60700021,,,,43,30,73
HND-005614,2011,60700022,,,,7,4,11
HND-005615,2011,60700023,,,,3,0,3
HND-005620,2011,60700028,,,,23,30,53
HND-005621,2011,60700029,,,,12,5,17
HND-005623,2011,60700031,,,,7,16,23
HND-005627,2011,60700035,,,,15,9,24
HND-005628,2011,60700036,,,,8,9,17
HND-005629,2011,60700037,,,,40,32,72
HND-005630,2011,60700038,,,,12,14,26
HND-005632,2011,60700040,,,,32,26,58
HND-005633,2011,60700041,,,,7,7,14
HND-005635,2011,60700043,,,,6,6,12
HND-005637,2011,60700045,,,,42,44,86
HND-005638,2011,60700046,,,,42,28,70
HND-005640,2011,60700048,,,,6,6,12
HND-005658,2011,60700068,,,,1,1,2
HND-005659,2011,60700069,,,,14,11,25
HND-005661,2011,60700074,,,,16,18,34
HND-005666,2011,60700098,,,,2,3,5
,2011,60700103,,,,4,4,8
HND-005600,2011,60700007,,,,21,19,40
HND-005602,2011,60700009,,,,15,18,33
HND-005604,2011,60700011,,,,9,7,16
HND-005608,2011,60700015,,,,3,6,9
HND-005609,2011,60700016,,,,3,3,6
HND-005610,2011,60700017,,,,8,0,8
HND-005611,2011,60700018,,,,0,1,1
HND-005616,2011,60700024,,,,2,2,4
HND-005617,2011,60700025,,,,11,8,19
HND-005618,2011,60700026,,,,3,0,3
HND-005619,2011,60700027,,,,2,3,5
HND-005622,2011,60700030,,,,2,3,5
HND-005624,2011,60700032,,,,9,5,14
HND-005625,2011,60700033,,,,3,0,3
HND-005626,2011,60700034,,,,8,15,23
HND-005631,2011,60700039,,,,46,38,84
HND-005634,2011,60700042,,,,0,1,1
HND-005636,2011,60700044,,,,11,12,23
HND-005639,2011,60700047,,,,4,6,10
,2011,60700081,,,,1,2,3
HND-005600,2011,60700007,,,,31,28,59
HND-005603,2011,60700010,,,,9,7,16
HND-005604,2011,60700011,,,,4,8,12
HND-005605,2011,60700012,,,,5,6,11
HND-005606,2011,60700013,,,,8,4,12
HND-005611,2011,60700018,,,,2,1,3
HND-005612,2011,60700019,,,,1,2,3
HND-005613,2011,60700021,,,,33,39,72
HND-005617,2011,60700025,,,,9,11,20
HND-005618,2011,60700026,,,,1,7,8
HND-005619,2011,60700027,,,,3,4,7
HND-005620,2011,60700028,,,,27,24,51
HND-005624,2011,60700032,,,,19,12,31
HND-005626,2011,60700034,,,,5,15,20
HND-005628,2011,60700036,,,,11,9,20
HND-005629,2011,60700037,,,,32,29,61
HND-005636,2011,60700044,,,,21,11,32
HND-005637,2011,60700045,,,,53,55,108
HND-005638,2011,60700046,,,,24,23,47
HND-005639,2011,60700047,,,,0,8,8
HND-005661,2011,60700074,,,,15,15,30
HND-005601,2011,60700008,,,,11,18,29
HND-005602,2011,60700009,,,,15,8,23
HND-005607,2011,60700014,,,,9,13,22
HND-005608,2011,60700015,,,,1,1,2
HND-005609,2011,60700016,,,,3,3,6
HND-005610,2011,60700017,,,,2,3,5
,2011,60700020,,,,30,23,53
HND-005614,2011,60700022,,,,3,5,8
HND-005615,2011,60700023,,,,1,0,1
HND-005616,2011,60700024,,,,3,1,4
HND-005621,2011,60700029,,,,1,6,7
HND-005622,2011,60700030,,,,2,4,6
HND-005623,2011,60700031,,,,13,15,28
HND-005625,2011,60700033,,,,3,1,4
HND-005627,2011,60700035,,,,7,6,13
HND-005630,2011,60700038,,,,18,9,27
HND-005631,2011,60700039,,,,51,47,98
HND-005632,2011,60700040,,,,14,15,29
HND-005633,2011,60700041,,,,11,21,32
HND-005634,2011,60700042,,,,1,1,2
HND-005635,2011,60700043,,,,4,9,13
HND-005640,2011,60700048,,,,5,5,10
HND-005658,2011,60700068,,,,0,2,2
HND-005659,2011,60700069,,,,14,16,30
HND-005666,2011,60700098,,,,0,2,2
,2011,60700103,,,,4,4,8
HND-005601,2011,60700008,,,,17,15,32
HND-005620,2011,60700028,,,,22,27,49
HND-005629,2011,60700037,,,,20,23,43
HND-005632,2011,60700040,,,,16,10,26
HND-005638,2011,60700046,,,,61,49,110
,2011,60700071,,,,2,2,4
HND-005661,2011,60700074,,,,16,23,39
,2011,60700081,,,,7,13,20
,2011,60700103,,,,18,17,35
HND-005600,2011,60700007,,,,29,31,60
HND-005602,2011,60700009,,,,25,26,51
HND-005623,2011,60700031,,,,14,16,30
HND-005660,2011,60700072,,,,129,134,263
HND-005601,2011,60700008,,,,14,19,33
HND-005602,2011,60700009,,,,17,23,40
HND-005623,2011,60700031,,,,7,12,19
HND-005632,2011,60700040,,,,2,4,6
,2011,60700103,,,,27,31,58
HND-005600,2011,60700007,,,,26,30,56
HND-005620,2011,60700028,,,,15,21,36
HND-005629,2011,60700037,,,,14,14,28
HND-005638,2011,60700046,,,,35,29,64
,2011,60700071,,,,3,2,5
HND-005660,2011,60700072,,,,97,124,221
HND-005661,2011,60700074,,,,17,19,36
,2011,60700081,,,,1,3,4
HND-005601,2011,60700008,,,,8,9,17
HND-005623,2011,60700031,,,,3,3,6
HND-005632,2011,60700040,,,,17,11,28
,2011,60700071,,,,2,1,3
,2011,60700081,,,,12,3,15
HND-005600,2011,60700007,,,,19,22,41
HND-005602,2011,60700009,,,,16,12,28
HND-005620,2011,60700028,,,,20,11,31
HND-005629,2011,60700037,,,,7,9,16
HND-005638,2011,60700046,,,,25,30,55
HND-005660,2011,60700072,,,,111,120,231
HND-005661,2011,60700074,,,,15,15,30
,2011,60700103,,,,17,13,30
,2011,60700071,,,,1,3,4
HND-005660,2011,60700072,,,,27,71,98
,2011,60700081,,,,5,13,18
,2011,60700103,,,,11,27,38
,2011,60700071,,,,3,1,4
HND-005660,2011,60700072,,,,27,56,83
,2011,60700081,,,,0,5,5
,2011,60700103,,,,14,33,47
,2011,60700071,,,,3,3,6
HND-005660,2011,60700072,,,,9,41,50
,2011,60700081,,,,3,13,16
,2011,60700103,,,,11,14,25
,2011,60800033,,,,5,6,11
,2011,60800039,,,,5,6,11
HND-005693,2011,60800038,,,,4,7,11
,2011,60800020,,,,7,4,11
HND-005689,2011,60800021,,,,6,4,10
HND-005692,2011,60800025,,,,3,7,10
,2011,60800020,,,,2,5,7
HND-005689,2011,60800021,,,,7,6,13
HND-005692,2011,60800025,,,,9,5,14
HND-005672,2011,60800001,,,,10,11,21
HND-005673,2011,60800002,,,,1,0,1
HND-005675,2011,60800004,,,,15,10,25
,2011,60800007,,,,3,4,7
HND-005680,2011,60800009,,,,1,2,3
HND-005681,2011,60800010,,,,6,3,9
HND-005682,2011,60800011,,,,5,4,9
HND-005683,2011,60800012,,,,8,13,21
HND-005684,2011,60800013,,,,4,3,7
HND-005687,2011,60800018,,,,1,1,2
HND-005688,2011,60800019,,,,1,4,5
HND-005690,2011,60800022,,,,3,1,4
HND-005674,2011,60800003,,,,3,3,6
HND-005676,2011,60800005,,,,1,6,7
HND-005677,2011,60800006,,,,4,1,5
HND-005679,2011,60800008,,,,1,2,3
HND-005685,2011,60800014,,,,1,1,2
,2011,60800015,,,,3,4,7
HND-005673,2011,60800002,,,,4,1,5
HND-005674,2011,60800003,,,,1,1,2
HND-005675,2011,60800004,,,,10,8,18
HND-005680,2011,60800009,,,,2,1,3
HND-005681,2011,60800010,,,,7,2,9
HND-005682,2011,60800011,,,,8,4,12
HND-005684,2011,60800013,,,,3,9,12
,2011,60800015,,,,4,5,9
HND-005686,2011,60800016,,,,4,0,4
HND-005687,2011,60800018,,,,3,3,6
HND-005688,2011,60800019,,,,3,1,4
HND-005690,2011,60800022,,,,1,6,7
HND-005672,2011,60800001,,,,13,15,28
HND-005676,2011,60800005,,,,2,2,4
HND-005677,2011,60800006,,,,5,5,10
,2011,60800007,,,,2,3,5
HND-005679,2011,60800008,,,,2,0,2
HND-005683,2011,60800012,,,,6,7,13
HND-005685,2011,60800014,,,,1,1,2
HND-005674,2011,60800003,,,,1,6,7
HND-005676,2011,60800005,,,,1,1,2
HND-005677,2011,60800006,,,,2,6,8
HND-005679,2011,60800008,,,,1,3,4
,2011,60800015,,,,3,1,4
HND-005686,2011,60800016,,,,1,1,2
HND-005672,2011,60800001,,,,15,20,35
HND-005673,2011,60800002,,,,2,5,7
HND-005675,2011,60800004,,,,8,7,15
,2011,60800007,,,,1,0,1
HND-005680,2011,60800009,,,,0,1,1
HND-005681,2011,60800010,,,,2,3,5
HND-005682,2011,60800011,,,,2,3,5
HND-005683,2011,60800012,,,,7,7,14
HND-005684,2011,60800013,,,,2,2,4
HND-005687,2011,60800018,,,,1,1,2
HND-005688,2011,60800019,,,,3,4,7
HND-005673,2011,60800002,,,,3,1,4
HND-005674,2011,60800003,,,,4,3,7
HND-005679,2011,60800008,,,,1,2,3
HND-005680,2011,60800009,,,,3,1,4
HND-005682,2011,60800011,,,,2,0,2
,2011,60800015,,,,2,3,5
HND-005687,2011,60800018,,,,4,2,6
HND-005690,2011,60800022,,,,6,3,9
HND-005672,2011,60800001,,,,10,12,22
HND-005675,2011,60800004,,,,17,11,28
HND-005676,2011,60800005,,,,4,7,11
HND-005677,2011,60800006,,,,3,2,5
,2011,60800007,,,,0,2,2
HND-005681,2011,60800010,,,,4,3,7
HND-005683,2011,60800012,,,,8,4,12
HND-005684,2011,60800013,,,,8,4,12
HND-005685,2011,60800014,,,,4,0,4
HND-005688,2011,60800019,,,,3,2,5
HND-005673,2011,60800002,,,,5,3,8
HND-005674,2011,60800003,,,,3,1,4
HND-005679,2011,60800008,,,,3,1,4
HND-005680,2011,60800009,,,,3,2,5
,2011,60800015,,,,4,4,8
HND-005686,2011,60800016,,,,2,2,4
HND-005687,2011,60800018,,,,4,2,6
HND-005672,2011,60800001,,,,11,12,23
HND-005675,2011,60800004,,,,6,9,15
HND-005676,2011,60800005,,,,1,2,3
HND-005681,2011,60800010,,,,4,7,11
HND-005683,2011,60800012,,,,2,6,8
HND-005684,2011,60800013,,,,6,2,8
HND-005688,2011,60800019,,,,0,3,3
HND-005690,2011,60800022,,,,4,1,5
HND-005672,2011,60800001,,,,15,13,28
HND-005676,2011,60800005,,,,5,3,8
HND-005677,2011,60800006,,,,1,0,1
,2011,60800007,,,,2,1,3
HND-005679,2011,60800008,,,,3,0,3
HND-005683,2011,60800012,,,,10,8,18
HND-005685,2011,60800014,,,,0,1,1
HND-005673,2011,60800002,,,,3,1,4
HND-005674,2011,60800003,,,,1,2,3
HND-005675,2011,60800004,,,,2,4,6
HND-005680,2011,60800009,,,,1,1,2
HND-005681,2011,60800010,,,,5,6,11
HND-005684,2011,60800013,,,,2,3,5
,2011,60800015,,,,5,5,10
HND-005686,2011,60800016,,,,2,1,3
HND-005687,2011,60800018,,,,2,2,4
HND-005688,2011,60800019,,,,0,3,3
HND-005690,2011,60800022,,,,0,1,1
HND-005675,2011,60800004,,,,5,13,18
HND-005691,2011,60800023,,,,21,18,39
HND-005675,2011,60800004,,,,6,3,9
HND-005691,2011,60800023,,,,21,23,44
HND-005675,2011,60800004,,,,2,7,9
HND-005691,2011,60800023,,,,16,18,34
HND-005691,2011,60800023,,,,18,14,32
HND-005691,2011,60800023,,,,16,15,31
HND-005691,2011,60800023,,,,15,18,33
,2011,60900065,,,,3,6,9
,2011,60900066,,,,7,2,9
HND-005747,2011,60900068,,,,4,5,9
,2011,60900070,,,,6,6,12
HND-005748,2011,60900071,,,,22,11,33
HND-005750,2011,60900097,,,,10,13,23
,2011,60900098,,,,4,3,7
HND-005751,2011,60900100,,,,6,3,9
,2011,60900101,,,,6,6,12
HND-005752,2011,60900102,,,,5,3,8
HND-005754,2011,60900104,,,,3,4,7
,2011,60900105,,,,6,6,12
HND-005755,2011,60900106,,,,7,4,11
HND-005756,2011,60900107,,,,2,8,10
,2011,60900108,,,,5,5,10
HND-005746,2011,60900067,,,,8,13,21
,2011,60900099,,,,2,4,6
HND-005753,2011,60900103,,,,10,10,20
,2011,60900001,,,,3,6,9
HND-005725,2011,60900036,,,,1,1,2
HND-005727,2011,60900038,,,,6,7,13
HND-005728,2011,60900039,,,,8,6,14
HND-005733,2011,60900044,,,,10,15,25
HND-005735,2011,60900047,,,,13,11,24
HND-005741,2011,60900054,,,,0,3,3
,2011,60900057,,,,5,5,10
HND-005742,2011,60900059,,,,2,4,6
,2011,60900064,,,,6,4,10
HND-005726,2011,60900037,,,,0,1,1
HND-005732,2011,60900043,,,,2,4,6
HND-005737,2011,60900049,,,,3,2,5
HND-005738,2011,60900050,,,,3,4,7
,2011,60900055,,,,3,6,9
,2011,60900056,,,,2,4,6
,2011,60900058,,,,10,5,15
,2011,60900035,,,,5,5,10
HND-005725,2011,60900036,,,,7,5,12
HND-005726,2011,60900037,,,,10,9,19
HND-005727,2011,60900038,,,,2,2,4
HND-005733,2011,60900044,,,,18,31,49
HND-005735,2011,60900047,,,,13,5,18
HND-005737,2011,60900049,,,,7,9,16
HND-005738,2011,60900050,,,,5,7,12
HND-005741,2011,60900054,,,,11,7,18
HND-005742,2011,60900059,,,,6,8,14
,2011,60900060,,,,11,15,26
HND-005743,2011,60900061,,,,13,22,35
,2011,60900063,,,,13,12,25
HND-005749,2011,60900096,,,,6,11,17
,2011,60900001,,,,5,8,13
HND-005728,2011,60900039,,,,0,1,1
HND-005729,2011,60900040,,,,5,3,8
HND-005732,2011,60900043,,,,11,11,22
HND-005734,2011,60900045,,,,11,13,24
,2011,60900046,,,,8,19,27
HND-005736,2011,60900048,,,,16,13,29
,2011,60900055,,,,8,2,10
,2011,60900056,,,,3,8,11
,2011,60900057,,,,16,20,36
,2011,60900058,,,,3,4,7
,2011,60900064,,,,4,4,8
HND-005695,2011,60900002,,,,36,35,71
HND-005696,2011,60900003,,,,12,4,16
HND-005698,2011,60900005,,,,15,18,33
,2011,60900006,,,,5,7,12
HND-005701,2011,60900008,,,,14,19,33
HND-005703,2011,60900010,,,,18,15,33
,2011,60900011,,,,12,11,23
,2011,60900015,,,,22,24,46
,2011,60900016,,,,16,10,26
HND-005709,2011,60900017,,,,4,3,7
HND-005710,2011,60900018,,,,6,6,12
HND-005712,2011,60900020,,,,26,24,50
HND-005713,2011,60900021,,,,36,31,67
HND-005715,2011,60900023,,,,4,8,12
HND-005719,2011,60900028,,,,10,8,18
HND-005720,2011,60900029,,,,4,5,9
HND-005722,2011,60900031,,,,11,1,12
HND-005725,2011,60900036,,,,7,8,15
HND-005726,2011,60900037,,,,5,2,7
HND-005727,2011,60900038,,,,9,6,15
HND-005697,2011,60900004,,,,12,11,23
HND-005700,2011,60900007,,,,16,15,31
HND-005702,2011,60900009,,,,51,44,95
HND-005704,2011,60900012,,,,25,15,40
HND-005705,2011,60900013,,,,5,2,7
HND-005706,2011,60900014,,,,6,8,14
HND-005711,2011,60900019,,,,3,10,13
HND-005714,2011,60900022,,,,16,12,28
HND-005716,2011,60900024,,,,8,5,13
HND-005717,2011,60900025,,,,11,12,23
,2011,60900026,,,,25,20,45
HND-005718,2011,60900027,,,,10,5,15
HND-005721,2011,60900030,,,,24,16,40
HND-005723,2011,60900032,,,,5,4,9
,2011,60900033,,,,11,11,22
,2011,60900034,,,,5,3,8
HND-005728,2011,60900039,,,,1,1,2
HND-005729,2011,60900040,,,,9,3,12
,2011,60900041,,,,11,6,17
HND-005731,2011,60900042,,,,8,7,15
HND-005740,2011,60900053,,,,2,1,3
HND-005744,2011,60900062,,,,7,4,11
HND-005696,2011,60900003,,,,7,6,13
HND-005697,2011,60900004,,,,11,11,22
HND-005702,2011,60900009,,,,36,66,102
HND-005703,2011,60900010,,,,11,6,17
,2011,60900011,,,,5,9,14
HND-005704,2011,60900012,,,,22,21,43
HND-005705,2011,60900013,,,,4,2,6
HND-005711,2011,60900019,,,,6,9,15
HND-005712,2011,60900020,,,,16,21,37
HND-005714,2011,60900022,,,,17,7,24
HND-005715,2011,60900023,,,,5,7,12
HND-005716,2011,60900024,,,,3,3,6
HND-005720,2011,60900029,,,,4,4,8
,2011,60900034,,,,2,6,8
HND-005725,2011,60900036,,,,11,8,19
HND-005726,2011,60900037,,,,5,5,10
HND-005731,2011,60900042,,,,5,3,8
HND-005740,2011,60900053,,,,1,3,4
HND-005695,2011,60900002,,,,37,27,64
HND-005698,2011,60900005,,,,12,9,21
,2011,60900006,,,,13,5,18
HND-005700,2011,60900007,,,,13,9,22
HND-005701,2011,60900008,,,,10,11,21
HND-005706,2011,60900014,,,,4,10,14
,2011,60900015,,,,17,14,31
,2011,60900016,,,,10,13,23
HND-005709,2011,60900017,,,,6,6,12
HND-005710,2011,60900018,,,,3,2,5
HND-005713,2011,60900021,,,,24,30,54
HND-005717,2011,60900025,,,,13,8,21
,2011,60900026,,,,22,31,53
HND-005718,2011,60900027,,,,15,6,21
HND-005719,2011,60900028,,,,12,11,23
HND-005721,2011,60900030,,,,9,14,23
HND-005722,2011,60900031,,,,4,2,6
HND-005723,2011,60900032,,,,4,1,5
,2011,60900033,,,,3,10,13
HND-005727,2011,60900038,,,,7,3,10
HND-005728,2011,60900039,,,,1,3,4
HND-005729,2011,60900040,,,,6,3,9
,2011,60900041,,,,8,12,20
HND-005744,2011,60900062,,,,5,4,9
HND-005696,2011,60900003,,,,10,5,15
HND-005697,2011,60900004,,,,5,16,21
HND-005700,2011,60900007,,,,16,10,26
HND-005702,2011,60900009,,,,45,48,93
HND-005703,2011,60900010,,,,23,15,38
HND-005704,2011,60900012,,,,13,21,34
HND-005705,2011,60900013,,,,6,9,15
HND-005706,2011,60900014,,,,4,4,8
HND-005711,2011,60900019,,,,10,11,21
HND-005714,2011,60900022,,,,6,11,17
HND-005716,2011,60900024,,,,9,6,15
HND-005718,2011,60900027,,,,7,5,12
HND-005722,2011,60900031,,,,3,5,8
HND-005725,2011,60900036,,,,8,8,16
HND-005726,2011,60900037,,,,6,4,10
HND-005727,2011,60900038,,,,4,9,13
HND-005744,2011,60900062,,,,5,4,9
HND-005695,2011,60900002,,,,32,30,62
HND-005698,2011,60900005,,,,14,21,35
,2011,60900006,,,,9,5,14
HND-005701,2011,60900008,,,,7,15,22
,2011,60900011,,,,7,6,13
,2011,60900015,,,,18,15,33
,2011,60900016,,,,5,8,13
HND-005709,2011,60900017,,,,8,5,13
HND-005710,2011,60900018,,,,8,5,13
HND-005712,2011,60900020,,,,16,13,29
HND-005713,2011,60900021,,,,24,24,48
HND-005715,2011,60900023,,,,9,10,19
HND-005717,2011,60900025,,,,7,9,16
,2011,60900026,,,,29,23,52
HND-005719,2011,60900028,,,,11,12,23
HND-005720,2011,60900029,,,,3,2,5
HND-005721,2011,60900030,,,,10,10,20
HND-005723,2011,60900032,,,,5,5,10
,2011,60900033,,,,13,6,19
,2011,60900034,,,,4,6,10
HND-005728,2011,60900039,,,,4,3,7
HND-005729,2011,60900040,,,,5,6,11
,2011,60900041,,,,10,10,20
HND-005731,2011,60900042,,,,7,8,15
HND-005740,2011,60900053,,,,1,3,4
HND-005695,2011,60900002,,,,38,32,70
HND-005696,2011,60900003,,,,5,4,9
HND-005701,2011,60900008,,,,18,17,35
HND-005702,2011,60900009,,,,43,55,98
HND-005703,2011,60900010,,,,10,10,20
,2011,60900011,,,,9,8,17
HND-005704,2011,60900012,,,,11,17,28
HND-005705,2011,60900013,,,,8,7,15
HND-005710,2011,60900018,,,,3,8,11
HND-005711,2011,60900019,,,,4,13,17
HND-005712,2011,60900020,,,,15,21,36
HND-005713,2011,60900021,,,,18,12,30
HND-005714,2011,60900022,,,,8,12,20
HND-005715,2011,60900023,,,,7,9,16
HND-005719,2011,60900028,,,,13,12,25
HND-005720,2011,60900029,,,,6,7,13
,2011,60900034,,,,3,4,7
HND-005725,2011,60900036,,,,7,4,11
HND-005726,2011,60900037,,,,2,5,7
HND-005729,2011,60900040,,,,5,4,9
HND-005731,2011,60900042,,,,2,1,3
HND-005740,2011,60900053,,,,0,1,1
HND-005697,2011,60900004,,,,13,7,20
HND-005698,2011,60900005,,,,5,13,18
,2011,60900006,,,,11,7,18
HND-005700,2011,60900007,,,,13,12,25
HND-005706,2011,60900014,,,,8,10,18
,2011,60900015,,,,19,14,33
,2011,60900016,,,,9,11,20
HND-005709,2011,60900017,,,,3,3,6
HND-005716,2011,60900024,,,,4,9,13
HND-005717,2011,60900025,,,,11,6,17
,2011,60900026,,,,19,18,37
HND-005718,2011,60900027,,,,4,10,14
HND-005721,2011,60900030,,,,10,4,14
HND-005722,2011,60900031,,,,1,6,7
HND-005723,2011,60900032,,,,4,4,8
,2011,60900033,,,,9,13,22
HND-005727,2011,60900038,,,,5,8,13
HND-005728,2011,60900039,,,,1,6,7
,2011,60900041,,,,8,8,16
HND-005744,2011,60900062,,,,7,2,9
HND-005695,2011,60900002,,,,47,37,84
HND-005696,2011,60900003,,,,1,5,6
HND-005701,2011,60900008,,,,11,11,22
HND-005702,2011,60900009,,,,47,49,96
HND-005703,2011,60900010,,,,7,12,19
,2011,60900011,,,,3,10,13
HND-005705,2011,60900013,,,,5,3,8
,2011,60900015,,,,14,22,36
,2011,60900016,,,,9,12,21
HND-005710,2011,60900018,,,,5,5,10
HND-005711,2011,60900019,,,,7,4,11
HND-005712,2011,60900020,,,,19,18,37
HND-005713,2011,60900021,,,,26,17,43
HND-005714,2011,60900022,,,,11,9,20
HND-005715,2011,60900023,,,,1,7,8
HND-005719,2011,60900028,,,,5,10,15
HND-005720,2011,60900029,,,,8,10,18
HND-005723,2011,60900032,,,,5,7,12
,2011,60900034,,,,5,2,7
HND-005726,2011,60900037,,,,3,3,6
HND-005728,2011,60900039,,,,5,4,9
HND-005729,2011,60900040,,,,7,7,14
,2011,60900041,,,,13,7,20
HND-005731,2011,60900042,,,,3,3,6
HND-005740,2011,60900053,,,,2,4,6
HND-005697,2011,60900004,,,,17,16,33
HND-005698,2011,60900005,,,,20,13,33
,2011,60900006,,,,5,6,11
HND-005700,2011,60900007,,,,16,9,25
HND-005704,2011,60900012,,,,17,12,29
HND-005706,2011,60900014,,,,8,4,12
HND-005709,2011,60900017,,,,10,3,13
HND-005716,2011,60900024,,,,4,7,11
HND-005717,2011,60900025,,,,11,8,19
,2011,60900026,,,,20,18,38
HND-005718,2011,60900027,,,,9,12,21
HND-005721,2011,60900030,,,,12,10,22
HND-005722,2011,60900031,,,,3,0,3
,2011,60900033,,,,9,7,16
HND-005725,2011,60900036,,,,6,4,10
HND-005727,2011,60900038,,,,7,4,11
HND-005744,2011,60900062,,,,6,2,8
HND-005695,2011,60900002,,,,32,32,64
HND-005698,2011,60900005,,,,18,16,34
,2011,60900006,,,,6,9,15
HND-005700,2011,60900007,,,,6,12,18
HND-005701,2011,60900008,,,,9,11,20
HND-005706,2011,60900014,,,,9,3,12
,2011,60900015,,,,14,21,35
,2011,60900016,,,,8,12,20
HND-005709,2011,60900017,,,,4,6,10
HND-005710,2011,60900018,,,,10,6,16
HND-005713,2011,60900021,,,,22,18,40
HND-005717,2011,60900025,,,,8,16,24
,2011,60900026,,,,19,25,44
HND-005718,2011,60900027,,,,7,3,10
HND-005719,2011,60900028,,,,25,19,44
HND-005721,2011,60900030,,,,8,9,17
HND-005722,2011,60900031,,,,4,2,6
HND-005723,2011,60900032,,,,1,4,5
,2011,60900033,,,,11,7,18
HND-005727,2011,60900038,,,,7,3,10
HND-005728,2011,60900039,,,,2,3,5
HND-005729,2011,60900040,,,,8,4,12
,2011,60900041,,,,8,2,10
HND-005744,2011,60900062,,,,5,2,7
HND-005696,2011,60900003,,,,8,7,15
HND-005697,2011,60900004,,,,12,16,28
HND-005702,2011,60900009,,,,40,52,92
HND-005703,2011,60900010,,,,11,7,18
,2011,60900011,,,,16,6,22
HND-005704,2011,60900012,,,,6,19,25
HND-005705,2011,60900013,,,,5,6,11
HND-005711,2011,60900019,,,,8,6,14
HND-005712,2011,60900020,,,,12,24,36
HND-005714,2011,60900022,,,,5,5,10
HND-005715,2011,60900023,,,,9,9,18
HND-005716,2011,60900024,,,,0,6,6
HND-005720,2011,60900029,,,,4,4,8
,2011,60900034,,,,6,4,10
HND-005725,2011,60900036,,,,7,7,14
HND-005726,2011,60900037,,,,4,1,5
HND-005731,2011,60900042,,,,1,6,7
HND-005740,2011,60900053,,,,1,2,3
HND-005698,2011,60900005,,,,42,19,61
HND-005701,2011,60900008,,,,13,18,31
HND-005702,2011,60900009,,,,64,76,140
HND-005700,2011,60900007,,,,16,8,24
HND-005739,2011,60900052,,,,58,50,108
HND-005702,2011,60900009,,,,68,59,127
HND-005739,2011,60900052,,,,41,51,92
HND-005698,2011,60900005,,,,32,16,48
HND-005700,2011,60900007,,,,10,18,28
HND-005701,2011,60900008,,,,11,11,22
HND-005701,2011,60900008,,,,3,8,11
HND-005702,2011,60900009,,,,40,45,85
HND-005698,2011,60900005,,,,15,19,34
HND-005700,2011,60900007,,,,12,21,33
HND-005739,2011,60900052,,,,42,50,92
HND-005739,2011,60900052,,,,19,10,29
HND-005739,2011,60900052,,,,14,12,26
HND-005739,2011,60900052,,,,18,18,36
HND-005813,2011,61000069,,,,7,5,12
,2011,61000070,,,,5,2,7
HND-005815,2011,61000091,,,,4,6,10
HND-005816,2011,61000093,,,,7,3,10
HND-005819,2011,61000100,,,,2,5,7
,2011,61000060,,,,3,4,7
HND-005811,2011,61000061,,,,9,9,18
,2011,61000062,,,,4,5,9
,2011,61000064,,,,6,10,16
,2011,61000065,,,,10,9,19
,2011,61000067,,,,8,2,10
,2011,61000068,,,,15,9,24
HND-005814,2011,61000071,,,,6,2,8
HND-005817,2011,61000094,,,,1,5,6
,2011,61000095,,,,6,3,9
,2011,61000098,,,,3,8,11
,2011,61000099,,,,15,5,20
HND-005757,2011,61000001,,,,1,2,3
,2011,61000043,,,,12,6,18
HND-005812,2011,61000063,,,,4,4,8
HND-005799,2011,61000044,,,,3,4,7
HND-005800,2011,61000045,,,,0,4,4
HND-005801,2011,61000046,,,,4,8,12
,2011,61000047,,,,0,2,2
,2011,61000048,,,,6,4,10
HND-005803,2011,61000050,,,,3,7,10
,2011,61000051,,,,1,2,3
HND-005805,2011,61000053,,,,0,1,1
,2011,61000057,,,,2,0,2
,2011,61000059,,,,3,2,5
HND-005799,2011,61000044,,,,7,3,10
HND-005800,2011,61000045,,,,8,12,20
HND-005801,2011,61000046,,,,1,2,3
,2011,61000047,,,,5,6,11
,2011,61000048,,,,1,2,3
HND-005803,2011,61000050,,,,4,0,4
,2011,61000051,,,,4,2,6
HND-005805,2011,61000053,,,,11,3,14
,2011,61000057,,,,10,7,17
HND-005757,2011,61000001,,,,18,14,32
,2011,61000043,,,,28,27,55
,2011,61000059,,,,3,5,8
HND-005812,2011,61000063,,,,4,6,10
HND-005758,2011,61000002,,,,7,4,11
HND-005760,2011,61000004,,,,1,0,1
HND-005761,2011,61000005,,,,10,12,22
HND-005762,2011,61000006,,,,12,7,19
HND-005764,2011,61000008,,,,11,10,21
HND-005765,2011,61000009,,,,4,0,4
HND-005775,2011,61000019,,,,4,5,9
HND-005776,2011,61000020,,,,2,4,6
HND-005778,2011,61000022,,,,2,5,7
HND-005780,2011,61000024,,,,11,11,22
HND-005781,2011,61000025,,,,4,3,7
HND-005782,2011,61000026,,,,10,10,20
HND-005784,2011,61000029,,,,4,4,8
HND-005786,2011,61000031,,,,2,3,5
HND-005788,2011,61000033,,,,0,4,4
HND-005792,2011,61000037,,,,7,4,11
HND-005796,2011,61000041,,,,3,6,9
HND-005759,2011,61000003,,,,19,36,55
HND-005763,2011,61000007,,,,12,11,23
HND-005766,2011,61000010,,,,4,4,8
HND-005767,2011,61000011,,,,5,2,7
,2011,61000012,,,,7,13,20
HND-005769,2011,61000013,,,,2,1,3
HND-005770,2011,61000014,,,,6,5,11
HND-005771,2011,61000015,,,,7,12,19
HND-005772,2011,61000016,,,,0,6,6
,2011,61000017,,,,1,1,2
HND-005774,2011,61000018,,,,13,8,21
,2011,61000021,,,,5,5,10
HND-005779,2011,61000023,,,,3,4,7
HND-005783,2011,61000027,,,,2,0,2
HND-005785,2011,61000030,,,,7,8,15
,2011,61000032,,,,9,7,16
,2011,61000034,,,,7,8,15
HND-005790,2011,61000035,,,,4,2,6
HND-005791,2011,61000036,,,,10,5,15
HND-005793,2011,61000038,,,,35,27,62
HND-005794,2011,61000039,,,,13,9,22
HND-005795,2011,61000040,,,,8,5,13
HND-005797,2011,61000042,,,,4,4,8
HND-005804,2011,61000052,,,,2,4,6
HND-005806,2011,61000054,,,,10,12,22
HND-005807,2011,61000055,,,,2,0,2
HND-005808,2011,61000056,,,,1,5,6
HND-005809,2011,61000058,,,,6,7,13
HND-005818,2011,61000096,,,,2,3,5
HND-005759,2011,61000003,,,,30,31,61
HND-005765,2011,61000009,,,,1,4,5
HND-005767,2011,61000011,,,,6,5,11
,2011,61000012,,,,12,11,23
HND-005769,2011,61000013,,,,4,5,9
,2011,61000017,,,,3,4,7
HND-005784,2011,61000029,,,,3,2,5
HND-005785,2011,61000030,,,,6,7,13
HND-005786,2011,61000031,,,,3,5,8
,2011,61000032,,,,7,6,13
HND-005788,2011,61000033,,,,1,2,3
,2011,61000034,,,,3,4,7
HND-005790,2011,61000035,,,,1,1,2
HND-005791,2011,61000036,,,,5,10,15
HND-005792,2011,61000037,,,,7,3,10
HND-005793,2011,61000038,,,,21,15,36
HND-005796,2011,61000041,,,,2,0,2
HND-005797,2011,61000042,,,,3,3,6
HND-005804,2011,61000052,,,,4,3,7
HND-005806,2011,61000054,,,,6,7,13
HND-005807,2011,61000055,,,,1,2,3
HND-005808,2011,61000056,,,,6,3,9
HND-005809,2011,61000058,,,,2,4,6
HND-005758,2011,61000002,,,,3,2,5
HND-005760,2011,61000004,,,,1,1,2
HND-005761,2011,61000005,,,,11,8,19
HND-005762,2011,61000006,,,,11,11,22
HND-005763,2011,61000007,,,,9,8,17
HND-005764,2011,61000008,,,,9,9,18
HND-005766,2011,61000010,,,,6,2,8
HND-005770,2011,61000014,,,,3,3,6
HND-005771,2011,61000015,,,,6,9,15
HND-005772,2011,61000016,,,,1,3,4
HND-005774,2011,61000018,,,,5,8,13
HND-005775,2011,61000019,,,,5,2,7
HND-005776,2011,61000020,,,,2,0,2
,2011,61000021,,,,4,6,10
HND-005778,2011,61000022,,,,3,3,6
HND-005779,2011,61000023,,,,1,2,3
HND-005780,2011,61000024,,,,14,9,23
HND-005781,2011,61000025,,,,3,4,7
HND-005782,2011,61000026,,,,9,6,15
HND-005783,2011,61000027,,,,5,2,7
HND-005794,2011,61000039,,,,5,6,11
HND-005795,2011,61000040,,,,10,6,16
HND-005818,2011,61000096,,,,1,2,3
HND-005759,2011,61000003,,,,32,32,64
HND-005763,2011,61000007,,,,8,14,22
HND-005767,2011,61000011,,,,4,3,7
,2011,61000012,,,,8,6,14
HND-005769,2011,61000013,,,,3,3,6
HND-005770,2011,61000014,,,,1,2,3
HND-005771,2011,61000015,,,,10,7,17
HND-005772,2011,61000016,,,,3,2,5
,2011,61000017,,,,3,2,5
HND-005774,2011,61000018,,,,12,12,24
,2011,61000021,,,,10,4,14
HND-005779,2011,61000023,,,,3,4,7
HND-005783,2011,61000027,,,,3,3,6
HND-005785,2011,61000030,,,,5,6,11
,2011,61000032,,,,9,7,16
,2011,61000034,,,,1,2,3
HND-005790,2011,61000035,,,,3,2,5
HND-005791,2011,61000036,,,,6,8,14
HND-005793,2011,61000038,,,,17,27,44
HND-005794,2011,61000039,,,,9,10,19
HND-005795,2011,61000040,,,,7,9,16
HND-005796,2011,61000041,,,,1,2,3
HND-005797,2011,61000042,,,,4,2,6
HND-005804,2011,61000052,,,,2,2,4
HND-005806,2011,61000054,,,,8,6,14
HND-005807,2011,61000055,,,,0,2,2
HND-005808,2011,61000056,,,,6,4,10
HND-005809,2011,61000058,,,,1,7,8
HND-005758,2011,61000002,,,,3,2,5
HND-005760,2011,61000004,,,,3,0,3
HND-005761,2011,61000005,,,,11,12,23
HND-005762,2011,61000006,,,,10,7,17
HND-005764,2011,61000008,,,,6,6,12
HND-005765,2011,61000009,,,,3,2,5
HND-005766,2011,61000010,,,,6,4,10
HND-005775,2011,61000019,,,,4,1,5
HND-005776,2011,61000020,,,,2,4,6
HND-005778,2011,61000022,,,,1,2,3
HND-005780,2011,61000024,,,,13,14,27
HND-005781,2011,61000025,,,,4,4,8
HND-005782,2011,61000026,,,,4,12,16
HND-005784,2011,61000029,,,,0,1,1
HND-005786,2011,61000031,,,,4,1,5
HND-005788,2011,61000033,,,,4,2,6
HND-005792,2011,61000037,,,,4,5,9
HND-005818,2011,61000096,,,,3,3,6
HND-005759,2011,61000003,,,,24,24,48
HND-005761,2011,61000005,,,,12,8,20
HND-005764,2011,61000008,,,,7,9,16
HND-005765,2011,61000009,,,,4,3,7
HND-005767,2011,61000011,,,,10,2,12
HND-005769,2011,61000013,,,,4,7,11
,2011,61000017,,,,1,3,4
HND-005776,2011,61000020,,,,2,2,4
HND-005781,2011,61000025,,,,3,4,7
HND-005784,2011,61000029,,,,2,1,3
HND-005786,2011,61000031,,,,2,1,3
,2011,61000032,,,,9,5,14
HND-005788,2011,61000033,,,,3,1,4
,2011,61000034,,,,5,3,8
HND-005791,2011,61000036,,,,13,5,18
HND-005792,2011,61000037,,,,3,5,8
HND-005796,2011,61000041,,,,1,1,2
HND-005797,2011,61000042,,,,1,4,5
HND-005804,2011,61000052,,,,1,5,6
HND-005806,2011,61000054,,,,7,8,15
HND-005808,2011,61000056,,,,2,3,5
HND-005758,2011,61000002,,,,6,5,11
HND-005760,2011,61000004,,,,1,0,1
HND-005762,2011,61000006,,,,8,9,17
HND-005763,2011,61000007,,,,8,10,18
HND-005766,2011,61000010,,,,3,1,4
,2011,61000012,,,,8,8,16
HND-005770,2011,61000014,,,,5,2,7
HND-005771,2011,61000015,,,,4,4,8
HND-005772,2011,61000016,,,,3,2,5
HND-005774,2011,61000018,,,,4,16,20
HND-005775,2011,61000019,,,,4,4,8
,2011,61000021,,,,4,5,9
HND-005778,2011,61000022,,,,1,2,3
HND-005779,2011,61000023,,,,2,5,7
HND-005780,2011,61000024,,,,11,10,21
HND-005782,2011,61000026,,,,6,8,14
HND-005783,2011,61000027,,,,2,2,4
HND-005785,2011,61000030,,,,9,3,12
HND-005790,2011,61000035,,,,0,1,1
HND-005793,2011,61000038,,,,22,12,34
HND-005794,2011,61000039,,,,13,12,25
HND-005795,2011,61000040,,,,13,4,17
HND-005807,2011,61000055,,,,4,3,7
HND-005809,2011,61000058,,,,7,3,10
HND-005818,2011,61000096,,,,2,3,5
HND-005758,2011,61000002,,,,3,3,6
HND-005763,2011,61000007,,,,2,1,3
HND-005766,2011,61000010,,,,2,7,9
HND-005767,2011,61000011,,,,5,7,12
,2011,61000012,,,,9,11,20
HND-005769,2011,61000013,,,,3,3,6
HND-005770,2011,61000014,,,,3,8,11
HND-005771,2011,61000015,,,,9,4,13
HND-005772,2011,61000016,,,,3,0,3
,2011,61000017,,,,0,2,2
HND-005774,2011,61000018,,,,6,16,22
HND-005775,2011,61000019,,,,4,6,10
,2011,61000021,,,,4,4,8
HND-005778,2011,61000022,,,,3,1,4
HND-005779,2011,61000023,,,,1,3,4
HND-005783,2011,61000027,,,,2,6,8
HND-005786,2011,61000031,,,,1,2,3
,2011,61000032,,,,7,9,16
HND-005788,2011,61000033,,,,2,2,4
HND-005792,2011,61000037,,,,6,4,10
HND-005796,2011,61000041,,,,3,1,4
HND-005804,2011,61000052,,,,2,1,3
HND-005759,2011,61000003,,,,27,34,61
HND-005760,2011,61000004,,,,3,0,3
HND-005761,2011,61000005,,,,15,5,20
HND-005762,2011,61000006,,,,5,11,16
HND-005764,2011,61000008,,,,4,9,13
HND-005765,2011,61000009,,,,6,3,9
HND-005776,2011,61000020,,,,3,2,5
HND-005780,2011,61000024,,,,10,11,21
HND-005781,2011,61000025,,,,4,1,5
HND-005782,2011,61000026,,,,10,7,17
HND-005784,2011,61000029,,,,2,0,2
HND-005785,2011,61000030,,,,5,7,12
,2011,61000034,,,,2,2,4
HND-005790,2011,61000035,,,,0,6,6
HND-005791,2011,61000036,,,,6,2,8
HND-005793,2011,61000038,,,,14,13,27
HND-005794,2011,61000039,,,,4,12,16
HND-005795,2011,61000040,,,,5,3,8
HND-005797,2011,61000042,,,,1,3,4
HND-005806,2011,61000054,,,,5,5,10
HND-005808,2011,61000056,,,,3,6,9
HND-005809,2011,61000058,,,,3,9,12
HND-005818,2011,61000096,,,,2,3,5
HND-005759,2011,61000003,,,,32,29,61
HND-005765,2011,61000009,,,,3,4,7
HND-005767,2011,61000011,,,,2,4,6
,2011,61000012,,,,6,10,16
HND-005769,2011,61000013,,,,3,2,5
,2011,61000017,,,,3,2,5
HND-005784,2011,61000029,,,,1,1,2
HND-005794,2011,61000039,,,,6,10,16
HND-005795,2011,61000040,,,,7,13,20
HND-005818,2011,61000096,,,,6,2,8
HND-005758,2011,61000002,,,,2,2,4
HND-005760,2011,61000004,,,,2,2,4
HND-005761,2011,61000005,,,,10,12,22
HND-005762,2011,61000006,,,,7,6,13
HND-005763,2011,61000007,,,,3,4,7
HND-005764,2011,61000008,,,,9,11,20
HND-005766,2011,61000010,,,,5,4,9
HND-005770,2011,61000014,,,,3,6,9
HND-005771,2011,61000015,,,,8,3,11
HND-005772,2011,61000016,,,,1,5,6
HND-005774,2011,61000018,,,,9,6,15
HND-005775,2011,61000019,,,,5,4,9
HND-005776,2011,61000020,,,,2,1,3
,2011,61000021,,,,6,11,17
HND-005778,2011,61000022,,,,1,4,5
HND-005779,2011,61000023,,,,4,1,5
HND-005780,2011,61000024,,,,12,10,22
HND-005781,2011,61000025,,,,5,5,10
HND-005782,2011,61000026,,,,4,10,14
HND-005783,2011,61000027,,,,2,1,3
HND-005785,2011,61000030,,,,6,0,6
HND-005786,2011,61000031,,,,6,1,7
,2011,61000032,,,,3,10,13
HND-005788,2011,61000033,,,,1,3,4
,2011,61000034,,,,1,3,4
HND-005790,2011,61000035,,,,4,4,8
HND-005791,2011,61000036,,,,5,10,15
HND-005792,2011,61000037,,,,4,12,16
HND-005793,2011,61000038,,,,12,15,27
HND-005796,2011,61000041,,,,3,0,3
HND-005797,2011,61000042,,,,4,5,9
HND-005804,2011,61000052,,,,1,2,3
HND-005806,2011,61000054,,,,3,2,5
HND-005807,2011,61000055,,,,2,0,2
HND-005808,2011,61000056,,,,1,1,2
HND-005809,2011,61000058,,,,2,3,5
HND-005780,2011,61000024,,,,10,11,21
HND-005802,2011,61000049,,,,37,49,86
,2011,61000097,,,,42,35,77
,2011,61000012,,,,21,25,46
HND-005785,2011,61000030,,,,7,10,17
HND-005793,2011,61000038,,,,21,19,40
HND-005794,2011,61000039,,,,20,24,44
,2011,61000012,,,,19,9,28
HND-005785,2011,61000030,,,,3,16,19
HND-005793,2011,61000038,,,,21,20,41
HND-005802,2011,61000049,,,,53,46,99
,2011,61000097,,,,20,31,51
HND-005780,2011,61000024,,,,6,5,11
HND-005794,2011,61000039,,,,14,20,34
HND-005785,2011,61000030,,,,8,8,16
HND-005793,2011,61000038,,,,6,22,28
,2011,61000012,,,,13,13,26
HND-005780,2011,61000024,,,,3,6,9
HND-005794,2011,61000039,,,,16,18,34
HND-005802,2011,61000049,,,,29,32,61
,2011,61000097,,,,16,28,44
HND-005802,2011,61000049,,,,31,49,80
,2011,61000097,,,,21,29,50
HND-005802,2011,61000049,,,,31,41,72
,2011,61000097,,,,16,12,28
HND-005802,2011,61000049,,,,42,32,74
,2011,61100097,,,,4,3,7
,2011,61100100,,,,12,6,18
HND-005900,2011,61100101,,,,6,12,18
HND-005901,2011,61100139,,,,3,7,10
,2011,61100153,,,,6,7,13
,2011,61100154,,,,6,7,13
,2011,61100155,,,,5,6,11
,2011,61100156,,,,6,8,14
HND-005906,2011,61100158,,,,12,5,17
,2011,61100161,,,,9,6,15
,2011,61100160,,,,6,2,8
,2011,61100142,,,,2,5,7
,2011,61100143,,,,2,1,3
HND-005903,2011,61100145,,,,3,1,4
HND-005907,2011,61100159,,,,3,2,5
,2011,61100163,,,,3,5,8
,2011,61100165,,,,2,2,4
HND-005909,2011,61100167,,,,6,3,9
HND-005881,2011,61100065,,,,8,21,29
,2011,61100066,,,,8,8,16
HND-005882,2011,61100067,,,,2,3,5
,2011,61100068,,,,3,3,6
,2011,61100070,,,,2,3,5
,2011,61100071,,,,10,8,18
,2011,61100072,,,,4,2,6
HND-005884,2011,61100073,,,,1,2,3
,2011,61100074,,,,5,2,7
HND-005886,2011,61100075,,,,3,3,6
HND-005887,2011,61100076,,,,2,3,5
HND-005888,2011,61100077,,,,2,2,4
HND-005889,2011,61100078,,,,5,3,8
HND-005890,2011,61100080,,,,0,2,2
,2011,61100082,,,,5,4,9
HND-005892,2011,61100084,,,,2,4,6
,2011,61100085,,,,6,2,8
,2011,61100086,,,,2,6,8
HND-005893,2011,61100087,,,,5,7,12
,2011,61100088,,,,3,5,8
,2011,61100090,,,,2,6,8
,2011,61100093,,,,2,3,5
HND-005895,2011,61100094,,,,1,5,6
HND-005897,2011,61100096,,,,2,3,5
HND-005899,2011,61100099,,,,6,3,9
,2011,61100140,,,,2,3,5
,2011,61100142,,,,4,4,8
,2011,61100143,,,,7,0,7
HND-005903,2011,61100145,,,,10,5,15
HND-005908,2011,61100162,,,,9,9,18
,2011,61100165,,,,8,6,14
,2011,61100069,,,,3,6,9
,2011,61100079,,,,6,10,16
,2011,61100089,,,,4,8,12
,2011,61100146,,,,5,3,8
HND-005907,2011,61100159,,,,1,0,1
,2011,61100163,,,,2,6,8
,2011,61100164,,,,3,1,4
HND-005909,2011,61100167,,,,7,6,13
HND-005881,2011,61100065,,,,21,27,48
,2011,61100066,,,,2,12,14
HND-005882,2011,61100067,,,,4,2,6
,2011,61100070,,,,3,4,7
HND-005886,2011,61100075,,,,3,4,7
HND-005889,2011,61100078,,,,9,3,12
,2011,61100079,,,,9,6,15
HND-005890,2011,61100080,,,,1,9,10
,2011,61100085,,,,4,1,5
,2011,61100089,,,,3,5,8
,2011,61100140,,,,3,1,4
HND-005908,2011,61100162,,,,9,22,31
,2011,61100164,,,,3,13,16
,2011,61100165,,,,6,4,10
,2011,61100068,,,,6,3,9
,2011,61100069,,,,3,2,5
,2011,61100071,,,,9,10,19
,2011,61100072,,,,3,4,7
HND-005884,2011,61100073,,,,4,3,7
,2011,61100074,,,,8,4,12
HND-005887,2011,61100076,,,,5,10,15
HND-005888,2011,61100077,,,,3,2,5
,2011,61100082,,,,3,1,4
HND-005892,2011,61100084,,,,2,8,10
,2011,61100086,,,,5,2,7
HND-005893,2011,61100087,,,,7,4,11
,2011,61100088,,,,2,5,7
,2011,61100090,,,,4,3,7
,2011,61100093,,,,4,6,10
HND-005895,2011,61100094,,,,5,2,7
HND-005897,2011,61100096,,,,9,4,13
HND-005899,2011,61100099,,,,2,4,6
,2011,61100142,,,,2,1,3
,2011,61100143,,,,9,7,16
,2011,61100146,,,,3,4,7
HND-005907,2011,61100159,,,,5,3,8
,2011,61100163,,,,0,3,3
HND-005909,2011,61100167,,,,9,4,13
HND-005820,2011,61100002,,,,3,7,10
HND-005821,2011,61100003,,,,3,8,11
HND-005822,2011,61100004,,,,8,12,20
HND-005823,2011,61100006,,,,7,2,9
HND-005825,2011,61100008,,,,7,6,13
HND-005827,2011,61100010,,,,8,4,12
HND-005832,2011,61100015,,,,8,7,15
HND-005836,2011,61100019,,,,5,3,8
HND-005838,2011,61100021,,,,14,15,29
HND-005839,2011,61100022,,,,9,8,17
HND-005840,2011,61100023,,,,9,12,21
HND-005841,2011,61100024,,,,3,8,11
HND-005844,2011,61100027,,,,2,1,3
HND-005847,2011,61100030,,,,7,5,12
HND-005848,2011,61100031,,,,5,4,9
,2011,61100032,,,,12,4,16
HND-005849,2011,61100033,,,,6,6,12
HND-005850,2011,61100034,,,,3,6,9
HND-005851,2011,61100035,,,,7,5,12
HND-005852,2011,61100036,,,,9,5,14
HND-005853,2011,61100037,,,,19,21,40
HND-005854,2011,61100038,,,,1,2,3
HND-005856,2011,61100040,,,,9,6,15
HND-005860,2011,61100044,,,,2,1,3
HND-005861,2011,61100045,,,,9,10,19
HND-005862,2011,61100046,,,,8,6,14
HND-005864,2011,61100048,,,,6,1,7
HND-005865,2011,61100049,,,,3,6,9
HND-005873,2011,61100057,,,,3,0,3
HND-005876,2011,61100060,,,,16,15,31
HND-005877,2011,61100061,,,,10,9,19
HND-005878,2011,61100062,,,,6,2,8
HND-005879,2011,61100063,,,,4,4,8
HND-005880,2011,61100064,,,,10,7,17
HND-005896,2011,61100095,,,,3,2,5
HND-005905,2011,61100150,,,,1,0,1
HND-005824,2011,61100007,,,,1,3,4
HND-005826,2011,61100009,,,,0,2,2
HND-005828,2011,61100011,,,,1,5,6
HND-005829,2011,61100012,,,,7,3,10
HND-005830,2011,61100013,,,,6,3,9
HND-005831,2011,61100014,,,,11,7,18
HND-005833,2011,61100016,,,,7,7,14
HND-005834,2011,61100017,,,,3,6,9
HND-005835,2011,61100018,,,,6,1,7
HND-005837,2011,61100020,,,,5,9,14
HND-005842,2011,61100025,,,,12,8,20
HND-005843,2011,61100026,,,,5,8,13
HND-005845,2011,61100028,,,,12,12,24
HND-005846,2011,61100029,,,,2,4,6
HND-005855,2011,61100039,,,,9,9,18
HND-005857,2011,61100041,,,,3,3,6
HND-005858,2011,61100042,,,,2,2,4
HND-005859,2011,61100043,,,,4,7,11
HND-005863,2011,61100047,,,,0,1,1
HND-005866,2011,61100050,,,,3,1,4
HND-005867,2011,61100051,,,,8,4,12
HND-005868,2011,61100052,,,,8,9,17
HND-005869,2011,61100053,,,,2,7,9
HND-005870,2011,61100054,,,,0,4,4
HND-005871,2011,61100055,,,,4,5,9
HND-005872,2011,61100056,,,,1,3,4
HND-005874,2011,61100058,,,,5,3,8
HND-005875,2011,61100059,,,,1,2,3
HND-005881,2011,61100065,,,,61,77,138
HND-005894,2011,61100091,,,,2,3,5
HND-005904,2011,61100149,,,,3,2,5
HND-005908,2011,61100162,,,,1,1,2
HND-005820,2011,61100002,,,,4,5,9
HND-005821,2011,61100003,,,,5,1,6
HND-005824,2011,61100007,,,,1,3,4
HND-005827,2011,61100010,,,,11,7,18
HND-005829,2011,61100012,,,,3,2,5
HND-005831,2011,61100014,,,,3,6,9
HND-005832,2011,61100015,,,,3,1,4
HND-005833,2011,61100016,,,,5,3,8
HND-005835,2011,61100018,,,,3,1,4
HND-005836,2011,61100019,,,,2,5,7
HND-005838,2011,61100021,,,,19,8,27
HND-005847,2011,61100030,,,,4,3,7
HND-005851,2011,61100035,,,,4,3,7
HND-005852,2011,61100036,,,,3,9,12
HND-005854,2011,61100038,,,,2,0,2
HND-005855,2011,61100039,,,,5,3,8
HND-005867,2011,61100051,,,,7,5,12
HND-005868,2011,61100052,,,,3,12,15
HND-005869,2011,61100053,,,,6,4,10
HND-005870,2011,61100054,,,,1,1,2
HND-005872,2011,61100056,,,,2,2,4
HND-005873,2011,61100057,,,,2,4,6
HND-005877,2011,61100061,,,,8,5,13
HND-005878,2011,61100062,,,,5,2,7
HND-005879,2011,61100063,,,,3,4,7
HND-005880,2011,61100064,,,,7,4,11
HND-005881,2011,61100065,,,,57,42,99
HND-005908,2011,61100162,,,,2,1,3
HND-005822,2011,61100004,,,,6,2,8
HND-005823,2011,61100006,,,,7,5,12
HND-005825,2011,61100008,,,,11,6,17
HND-005828,2011,61100011,,,,3,1,4
HND-005830,2011,61100013,,,,2,4,6
HND-005834,2011,61100017,,,,4,2,6
HND-005837,2011,61100020,,,,7,3,10
HND-005839,2011,61100022,,,,6,4,10
HND-005840,2011,61100023,,,,4,7,11
HND-005841,2011,61100024,,,,12,6,18
HND-005842,2011,61100025,,,,10,10,20
HND-005843,2011,61100026,,,,10,10,20
HND-005844,2011,61100027,,,,5,1,6
HND-005845,2011,61100028,,,,8,7,15
HND-005846,2011,61100029,,,,0,6,6
HND-005848,2011,61100031,,,,4,2,6
,2011,61100032,,,,5,13,18
HND-005849,2011,61100033,,,,9,1,10
HND-005850,2011,61100034,,,,8,4,12
HND-005853,2011,61100037,,,,12,16,28
HND-005856,2011,61100040,,,,8,7,15
HND-005857,2011,61100041,,,,5,2,7
HND-005858,2011,61100042,,,,2,4,6
HND-005859,2011,61100043,,,,1,7,8
HND-005860,2011,61100044,,,,1,2,3
HND-005861,2011,61100045,,,,5,7,12
HND-005862,2011,61100046,,,,9,4,13
HND-005863,2011,61100047,,,,2,3,5
HND-005864,2011,61100048,,,,6,4,10
HND-005865,2011,61100049,,,,2,4,6
HND-005866,2011,61100050,,,,3,2,5
HND-005871,2011,61100055,,,,9,1,10
HND-005874,2011,61100058,,,,5,3,8
HND-005875,2011,61100059,,,,1,2,3
HND-005876,2011,61100060,,,,19,6,25
HND-005894,2011,61100091,,,,9,3,12
HND-005896,2011,61100095,,,,3,1,4
HND-005904,2011,61100149,,,,2,3,5
HND-005905,2011,61100150,,,,4,2,6
HND-005820,2011,61100002,,,,5,4,9
HND-005821,2011,61100003,,,,5,4,9
HND-005822,2011,61100004,,,,2,3,5
HND-005823,2011,61100006,,,,9,4,13
HND-005825,2011,61100008,,,,5,4,9
HND-005827,2011,61100010,,,,6,8,14
HND-005832,2011,61100015,,,,5,1,6
HND-005835,2011,61100018,,,,4,1,5
HND-005836,2011,61100019,,,,2,4,6
HND-005838,2011,61100021,,,,18,9,27
HND-005839,2011,61100022,,,,10,9,19
HND-005840,2011,61100023,,,,11,7,18
HND-005844,2011,61100027,,,,6,3,9
HND-005855,2011,61100039,,,,7,6,13
HND-005857,2011,61100041,,,,3,1,4
HND-005858,2011,61100042,,,,5,2,7
HND-005859,2011,61100043,,,,5,4,9
HND-005863,2011,61100047,,,,0,2,2
HND-005866,2011,61100050,,,,2,0,2
HND-005867,2011,61100051,,,,5,10,15
HND-005868,2011,61100052,,,,13,8,21
HND-005869,2011,61100053,,,,5,5,10
HND-005870,2011,61100054,,,,3,2,5
HND-005871,2011,61100055,,,,2,3,5
HND-005872,2011,61100056,,,,4,1,5
HND-005874,2011,61100058,,,,5,6,11
HND-005875,2011,61100059,,,,3,1,4
HND-005876,2011,61100060,,,,11,10,21
HND-005877,2011,61100061,,,,8,4,12
HND-005878,2011,61100062,,,,1,7,8
HND-005879,2011,61100063,,,,2,5,7
HND-005880,2011,61100064,,,,2,0,2
HND-005894,2011,61100091,,,,3,3,6
HND-005904,2011,61100149,,,,5,4,9
HND-005824,2011,61100007,,,,2,1,3
HND-005826,2011,61100009,,,,0,2,2
HND-005828,2011,61100011,,,,3,3,6
HND-005829,2011,61100012,,,,3,4,7
HND-005830,2011,61100013,,,,5,1,6
HND-005831,2011,61100014,,,,5,5,10
HND-005833,2011,61100016,,,,5,6,11
HND-005834,2011,61100017,,,,4,5,9
HND-005837,2011,61100020,,,,4,2,6
HND-005841,2011,61100024,,,,5,3,8
HND-005842,2011,61100025,,,,7,9,16
HND-005843,2011,61100026,,,,9,4,13
HND-005845,2011,61100028,,,,5,6,11
HND-005846,2011,61100029,,,,2,2,4
HND-005847,2011,61100030,,,,9,5,14
HND-005848,2011,61100031,,,,7,5,12
,2011,61100032,,,,9,7,16
HND-005849,2011,61100033,,,,6,3,9
HND-005850,2011,61100034,,,,6,4,10
HND-005851,2011,61100035,,,,2,6,8
HND-005852,2011,61100036,,,,8,3,11
HND-005853,2011,61100037,,,,10,7,17
HND-005854,2011,61100038,,,,3,1,4
HND-005856,2011,61100040,,,,14,8,22
HND-005860,2011,61100044,,,,0,1,1
HND-005861,2011,61100045,,,,7,12,19
HND-005862,2011,61100046,,,,10,11,21
HND-005864,2011,61100048,,,,6,7,13
HND-005865,2011,61100049,,,,2,5,7
HND-005873,2011,61100057,,,,3,1,4
HND-005881,2011,61100065,,,,30,46,76
HND-005896,2011,61100095,,,,2,3,5
HND-005905,2011,61100150,,,,2,0,2
HND-005908,2011,61100162,,,,0,1,1
HND-005824,2011,61100007,,,,2,2,4
HND-005827,2011,61100010,,,,15,9,24
HND-005828,2011,61100011,,,,3,4,7
HND-005829,2011,61100012,,,,7,9,16
HND-005830,2011,61100013,,,,2,5,7
HND-005831,2011,61100014,,,,6,3,9
HND-005832,2011,61100015,,,,8,6,14
HND-005833,2011,61100016,,,,4,7,11
HND-005834,2011,61100017,,,,5,3,8
HND-005835,2011,61100018,,,,5,3,8
HND-005836,2011,61100019,,,,7,4,11
HND-005846,2011,61100029,,,,6,4,10
HND-005847,2011,61100030,,,,10,6,16
,2011,61100032,,,,6,6,12
HND-005850,2011,61100034,,,,4,2,6
HND-005851,2011,61100035,,,,4,2,6
HND-005852,2011,61100036,,,,8,5,13
HND-005854,2011,61100038,,,,2,1,3
HND-005855,2011,61100039,,,,4,8,12
HND-005865,2011,61100049,,,,6,3,9
HND-005867,2011,61100051,,,,3,2,5
HND-005868,2011,61100052,,,,8,5,13
HND-005869,2011,61100053,,,,9,7,16
HND-005873,2011,61100057,,,,4,6,10
HND-005877,2011,61100061,,,,9,6,15
HND-005878,2011,61100062,,,,5,1,6
HND-005879,2011,61100063,,,,1,7,8
HND-005881,2011,61100065,,,,47,38,85
HND-005896,2011,61100095,,,,1,4,5
HND-005908,2011,61100162,,,,2,4,6
HND-005820,2011,61100002,,,,4,1,5
HND-005821,2011,61100003,,,,0,3,3
HND-005822,2011,61100004,,,,5,7,12
HND-005823,2011,61100006,,,,8,4,12
HND-005825,2011,61100008,,,,5,4,9
HND-005826,2011,61100009,,,,3,1,4
HND-005837,2011,61100020,,,,5,3,8
HND-005838,2011,61100021,,,,6,16,22
HND-005839,2011,61100022,,,,6,6,12
HND-005840,2011,61100023,,,,7,7,14
HND-005841,2011,61100024,,,,9,6,15
HND-005842,2011,61100025,,,,7,13,20
HND-005843,2011,61100026,,,,9,3,12
HND-005844,2011,61100027,,,,0,3,3
HND-005845,2011,61100028,,,,5,10,15
HND-005848,2011,61100031,,,,5,5,10
HND-005849,2011,61100033,,,,5,6,11
HND-005853,2011,61100037,,,,9,5,14
HND-005856,2011,61100040,,,,0,11,11
HND-005857,2011,61100041,,,,3,1,4
HND-005858,2011,61100042,,,,6,8,14
HND-005859,2011,61100043,,,,4,5,9
HND-005860,2011,61100044,,,,3,3,6
HND-005861,2011,61100045,,,,9,9,18
HND-005862,2011,61100046,,,,2,5,7
HND-005864,2011,61100048,,,,4,8,12
HND-005866,2011,61100050,,,,2,1,3
HND-005870,2011,61100054,,,,6,1,7
HND-005871,2011,61100055,,,,3,1,4
HND-005874,2011,61100058,,,,7,5,12
HND-005875,2011,61100059,,,,5,0,5
HND-005876,2011,61100060,,,,13,9,22
HND-005880,2011,61100064,,,,2,6,8
HND-005894,2011,61100091,,,,4,2,6
HND-005904,2011,61100149,,,,3,5,8
HND-005905,2011,61100150,,,,1,0,1
HND-005824,2011,61100007,,,,0,4,4
HND-005826,2011,61100009,,,,3,3,6
HND-005827,2011,61100010,,,,8,8,16
HND-005828,2011,61100011,,,,1,4,5
HND-005829,2011,61100012,,,,9,3,12
HND-005830,2011,61100013,,,,1,3,4
HND-005831,2011,61100014,,,,4,2,6
HND-005832,2011,61100015,,,,2,6,8
HND-005833,2011,61100016,,,,3,5,8
HND-005834,2011,61100017,,,,5,2,7
HND-005835,2011,61100018,,,,3,2,5
HND-005837,2011,61100020,,,,5,4,9
HND-005842,2011,61100025,,,,9,19,28
HND-005845,2011,61100028,,,,10,4,14
HND-005846,2011,61100029,,,,3,5,8
HND-005847,2011,61100030,,,,5,9,14
HND-005848,2011,61100031,,,,6,4,10
,2011,61100032,,,,11,13,24
HND-005849,2011,61100033,,,,4,4,8
HND-005850,2011,61100034,,,,7,3,10
HND-005851,2011,61100035,,,,5,2,7
HND-005852,2011,61100036,,,,6,3,9
HND-005853,2011,61100037,,,,2,2,4
HND-005854,2011,61100038,,,,0,4,4
HND-005855,2011,61100039,,,,6,3,9
HND-005856,2011,61100040,,,,8,11,19
HND-005861,2011,61100045,,,,4,4,8
HND-005864,2011,61100048,,,,5,1,6
HND-005865,2011,61100049,,,,8,2,10
HND-005867,2011,61100051,,,,3,3,6
HND-005869,2011,61100053,,,,2,4,6
HND-005872,2011,61100056,,,,1,5,6
HND-005873,2011,61100057,,,,2,3,5
HND-005877,2011,61100061,,,,7,20,27
HND-005879,2011,61100063,,,,6,4,10
HND-005881,2011,61100065,,,,38,42,80
HND-005896,2011,61100095,,,,2,4,6
HND-005908,2011,61100162,,,,1,1,2
HND-005820,2011,61100002,,,,2,5,7
HND-005821,2011,61100003,,,,7,2,9
HND-005822,2011,61100004,,,,4,3,7
HND-005823,2011,61100006,,,,6,7,13
HND-005825,2011,61100008,,,,8,8,16
HND-005836,2011,61100019,,,,4,5,9
HND-005838,2011,61100021,,,,11,10,21
HND-005839,2011,61100022,,,,3,7,10
HND-005840,2011,61100023,,,,11,14,25
HND-005841,2011,61100024,,,,7,6,13
HND-005843,2011,61100026,,,,1,6,7
HND-005844,2011,61100027,,,,1,2,3
HND-005857,2011,61100041,,,,2,7,9
HND-005858,2011,61100042,,,,4,1,5
HND-005859,2011,61100043,,,,2,1,3
HND-005860,2011,61100044,,,,4,2,6
HND-005862,2011,61100046,,,,3,9,12
HND-005863,2011,61100047,,,,1,2,3
HND-005866,2011,61100050,,,,3,5,8
HND-005868,2011,61100052,,,,15,7,22
HND-005870,2011,61100054,,,,0,2,2
HND-005871,2011,61100055,,,,6,3,9
HND-005874,2011,61100058,,,,8,2,10
HND-005875,2011,61100059,,,,2,1,3
HND-005876,2011,61100060,,,,9,10,19
HND-005878,2011,61100062,,,,5,2,7
HND-005880,2011,61100064,,,,2,3,5
HND-005894,2011,61100091,,,,7,9,16
HND-005904,2011,61100149,,,,6,1,7
HND-005905,2011,61100150,,,,2,1,3
HND-005822,2011,61100004,,,,4,4,8
HND-005823,2011,61100006,,,,7,3,10
HND-005825,2011,61100008,,,,5,4,9
HND-005826,2011,61100009,,,,3,1,4
HND-005828,2011,61100011,,,,0,2,2
HND-005830,2011,61100013,,,,4,5,9
HND-005834,2011,61100017,,,,8,3,11
HND-005837,2011,61100020,,,,6,4,10
HND-005839,2011,61100022,,,,10,17,27
HND-005840,2011,61100023,,,,8,14,22
HND-005841,2011,61100024,,,,4,11,15
HND-005842,2011,61100025,,,,13,13,26
HND-005843,2011,61100026,,,,2,3,5
HND-005844,2011,61100027,,,,4,1,5
HND-005845,2011,61100028,,,,9,10,19
HND-005846,2011,61100029,,,,4,1,5
HND-005848,2011,61100031,,,,3,3,6
,2011,61100032,,,,9,5,14
HND-005849,2011,61100033,,,,7,6,13
HND-005850,2011,61100034,,,,6,5,11
HND-005853,2011,61100037,,,,3,6,9
HND-005856,2011,61100040,,,,4,5,9
HND-005857,2011,61100041,,,,2,0,2
HND-005858,2011,61100042,,,,2,6,8
HND-005859,2011,61100043,,,,4,2,6
HND-005860,2011,61100044,,,,1,0,1
HND-005861,2011,61100045,,,,7,10,17
HND-005862,2011,61100046,,,,7,2,9
HND-005863,2011,61100047,,,,6,4,10
HND-005864,2011,61100048,,,,5,6,11
HND-005865,2011,61100049,,,,3,4,7
HND-005866,2011,61100050,,,,1,3,4
HND-005871,2011,61100055,,,,2,3,5
HND-005873,2011,61100057,,,,5,6,11
HND-005874,2011,61100058,,,,1,3,4
HND-005875,2011,61100059,,,,0,1,1
HND-005876,2011,61100060,,,,7,6,13
HND-005894,2011,61100091,,,,4,3,7
HND-005896,2011,61100095,,,,3,3,6
HND-005904,2011,61100149,,,,3,3,6
HND-005905,2011,61100150,,,,1,1,2
HND-005820,2011,61100002,,,,3,4,7
HND-005821,2011,61100003,,,,1,5,6
HND-005824,2011,61100007,,,,1,0,1
HND-005827,2011,61100010,,,,2,4,6
HND-005829,2011,61100012,,,,5,7,12
HND-005831,2011,61100014,,,,4,5,9
HND-005832,2011,61100015,,,,2,7,9
HND-005833,2011,61100016,,,,3,5,8
HND-005835,2011,61100018,,,,4,3,7
HND-005836,2011,61100019,,,,8,5,13
HND-005838,2011,61100021,,,,8,13,21
HND-005847,2011,61100030,,,,7,8,15
HND-005851,2011,61100035,,,,1,3,4
HND-005852,2011,61100036,,,,7,6,13
HND-005855,2011,61100039,,,,4,6,10
HND-005867,2011,61100051,,,,3,7,10
HND-005868,2011,61100052,,,,7,9,16
HND-005869,2011,61100053,,,,4,5,9
HND-005870,2011,61100054,,,,0,1,1
HND-005872,2011,61100056,,,,1,0,1
HND-005877,2011,61100061,,,,15,5,20
HND-005878,2011,61100062,,,,5,1,6
HND-005879,2011,61100063,,,,5,4,9
HND-005880,2011,61100064,,,,0,1,1
HND-005881,2011,61100065,,,,48,44,92
HND-005908,2011,61100162,,,,3,0,3
HND-005833,2011,61100016,,,,11,12,23
HND-005838,2011,61100021,,,,9,11,20
HND-005842,2011,61100025,,,,5,10,15
,2011,61100032,,,,15,11,26
HND-005853,2011,61100037,,,,7,8,15
HND-005891,2011,61100081,,,,75,77,152
HND-005898,2011,61100098,,,,157,98,255
HND-005825,2011,61100008,,,,15,18,33
HND-005840,2011,61100023,,,,25,21,46
HND-005833,2011,61100016,,,,7,10,17
HND-005825,2011,61100008,,,,14,14,28
HND-005838,2011,61100021,,,,5,7,12
HND-005840,2011,61100023,,,,11,17,28
HND-005842,2011,61100025,,,,11,12,23
,2011,61100032,,,,9,15,24
HND-005853,2011,61100037,,,,6,3,9
HND-005891,2011,61100081,,,,68,65,133
HND-005898,2011,61100098,,,,104,106,210
HND-005833,2011,61100016,,,,2,7,9
,2011,61100032,,,,6,11,17
HND-005825,2011,61100008,,,,13,16,29
HND-005838,2011,61100021,,,,1,11,12
HND-005840,2011,61100023,,,,16,18,34
HND-005842,2011,61100025,,,,9,11,20
HND-005853,2011,61100037,,,,3,5,8
HND-005891,2011,61100081,,,,66,70,136
HND-005898,2011,61100098,,,,100,93,193
HND-005891,2011,61100081,,,,116,62,178
HND-005898,2011,61100098,,,,65,94,159
HND-005891,2011,61100081,,,,70,61,131
HND-005898,2011,61100098,,,,51,76,127
HND-005891,2011,61100081,,,,67,46,113
,2011,61200028,,,,8,8,16
,2011,61200042,,,,2,3,5
,2011,61200044,,,,2,3,5
,2011,61200014,,,,9,7,16
,2011,61200046,,,,11,9,20
HND-005919,2011,61200010,,,,9,5,14
HND-005920,2011,61200011,,,,3,6,9
HND-005921,2011,61200012,,,,3,4,7
HND-005919,2011,61200010,,,,6,2,8
HND-005920,2011,61200011,,,,6,7,13
HND-005921,2011,61200012,,,,6,5,11
HND-005913,2011,61200004,,,,9,4,13
HND-005914,2011,61200005,,,,8,6,14
HND-005915,2011,61200006,,,,5,6,11
HND-005917,2011,61200008,,,,6,2,8
HND-005918,2011,61200009,,,,2,1,3
HND-005910,2011,61200001,,,,12,10,22
HND-005911,2011,61200002,,,,14,12,26
HND-005912,2011,61200003,,,,10,5,15
HND-005916,2011,61200007,,,,5,4,9
HND-005911,2011,61200002,,,,16,8,24
HND-005910,2011,61200001,,,,6,9,15
HND-005912,2011,61200003,,,,7,7,14
HND-005913,2011,61200004,,,,7,1,8
HND-005914,2011,61200005,,,,9,5,14
HND-005915,2011,61200006,,,,5,7,12
HND-005916,2011,61200007,,,,13,4,17
HND-005917,2011,61200008,,,,7,8,15
HND-005918,2011,61200009,,,,0,1,1
HND-005910,2011,61200001,,,,6,5,11
HND-005911,2011,61200002,,,,15,7,22
HND-005912,2011,61200003,,,,5,5,10
HND-005916,2011,61200007,,,,8,9,17
HND-005913,2011,61200004,,,,6,6,12
HND-005914,2011,61200005,,,,8,9,17
HND-005915,2011,61200006,,,,5,5,10
HND-005917,2011,61200008,,,,6,6,12
HND-005918,2011,61200009,,,,2,2,4
HND-005911,2011,61200002,,,,10,9,19
HND-005918,2011,61200009,,,,2,4,6
HND-005910,2011,61200001,,,,13,3,16
HND-005912,2011,61200003,,,,2,7,9
HND-005913,2011,61200004,,,,2,11,13
HND-005914,2011,61200005,,,,5,13,18
HND-005915,2011,61200006,,,,6,5,11
HND-005916,2011,61200007,,,,1,5,6
HND-005917,2011,61200008,,,,9,5,14
HND-005911,2011,61200002,,,,12,16,28
HND-005914,2011,61200005,,,,15,3,18
HND-005917,2011,61200008,,,,10,7,17
HND-005918,2011,61200009,,,,0,3,3
HND-005910,2011,61200001,,,,3,6,9
HND-005912,2011,61200003,,,,5,9,14
HND-005913,2011,61200004,,,,2,3,5
HND-005915,2011,61200006,,,,8,5,13
HND-005916,2011,61200007,,,,8,4,12
HND-005910,2011,61200001,,,,4,3,7
HND-005912,2011,61200003,,,,4,5,9
HND-005913,2011,61200004,,,,8,6,14
HND-005914,2011,61200005,,,,8,5,13
HND-005915,2011,61200006,,,,6,4,10
HND-005916,2011,61200007,,,,14,12,26
HND-005917,2011,61200008,,,,13,5,18
HND-005918,2011,61200009,,,,1,0,1
HND-005911,2011,61200002,,,,16,13,29
HND-005914,2011,61200005,,,,5,14,19
HND-005911,2011,61200002,,,,18,12,30
HND-005911,2011,61200002,,,,11,9,20
HND-005914,2011,61200005,,,,5,5,10
HND-005911,2011,61200002,,,,8,11,19
HND-005914,2011,61200005,,,,0,3,3
,2011,61300045,,,,9,6,15
,2011,61300046,,,,8,5,13
,2011,61300047,,,,3,7,10
HND-005931,2011,61300010,,,,4,2,6
HND-005932,2011,61300011,,,,6,3,9
HND-005936,2011,61300016,,,,2,1,3
HND-005938,2011,61300048,,,,4,4,8
HND-005930,2011,61300009,,,,3,0,3
HND-005930,2011,61300009,,,,1,3,4
HND-005931,2011,61300010,,,,8,1,9
HND-005932,2011,61300011,,,,3,9,12
HND-005934,2011,61300013,,,,5,6,11
HND-005936,2011,61300016,,,,1,1,2
HND-005938,2011,61300048,,,,6,8,14
HND-005922,2011,61300001,,,,11,7,18
HND-005924,2011,61300003,,,,4,7,11
HND-005928,2011,61300007,,,,2,1,3
HND-005935,2011,61300015,,,,1,3,4
HND-005923,2011,61300002,,,,6,3,9
HND-005925,2011,61300004,,,,3,10,13
HND-005926,2011,61300005,,,,12,16,28
HND-005927,2011,61300006,,,,11,6,17
HND-005929,2011,61300008,,,,6,4,10
HND-005930,2011,61300009,,,,4,7,11
HND-005933,2011,61300012,,,,11,6,17
HND-005937,2011,61300017,,,,1,0,1
HND-005923,2011,61300002,,,,11,5,16
HND-005924,2011,61300003,,,,8,2,10
HND-005925,2011,61300004,,,,3,13,16
HND-005926,2011,61300005,,,,7,9,16
HND-005927,2011,61300006,,,,6,4,10
HND-005928,2011,61300007,,,,1,3,4
HND-005929,2011,61300008,,,,10,3,13
HND-005935,2011,61300015,,,,2,2,4
HND-005922,2011,61300001,,,,7,9,16
HND-005930,2011,61300009,,,,5,5,10
HND-005933,2011,61300012,,,,8,4,12
HND-005937,2011,61300017,,,,4,3,7
HND-005923,2011,61300002,,,,5,7,12
HND-005925,2011,61300004,,,,7,6,13
HND-005926,2011,61300005,,,,8,4,12
HND-005927,2011,61300006,,,,13,3,16
HND-005929,2011,61300008,,,,1,6,7
HND-005930,2011,61300009,,,,3,3,6
HND-005933,2011,61300012,,,,4,3,7
HND-005937,2011,61300017,,,,2,1,3
HND-005922,2011,61300001,,,,5,5,10
HND-005924,2011,61300003,,,,4,4,8
HND-005928,2011,61300007,,,,1,1,2
HND-005923,2011,61300002,,,,3,4,7
HND-005924,2011,61300003,,,,4,3,7
HND-005925,2011,61300004,,,,8,4,12
HND-005927,2011,61300006,,,,10,4,14
HND-005928,2011,61300007,,,,1,3,4
HND-005935,2011,61300015,,,,4,1,5
HND-005922,2011,61300001,,,,13,6,19
HND-005926,2011,61300005,,,,4,9,13
HND-005929,2011,61300008,,,,6,0,6
HND-005930,2011,61300009,,,,3,3,6
HND-005933,2011,61300012,,,,4,8,12
HND-005937,2011,61300017,,,,2,2,4
HND-005923,2011,61300002,,,,3,10,13
HND-005924,2011,61300003,,,,6,1,7
HND-005928,2011,61300007,,,,0,2,2
HND-005935,2011,61300015,,,,0,2,2
HND-005922,2011,61300001,,,,3,12,15
HND-005925,2011,61300004,,,,3,4,7
HND-005926,2011,61300005,,,,9,3,12
HND-005927,2011,61300006,,,,6,9,15
HND-005929,2011,61300008,,,,2,6,8
HND-005930,2011,61300009,,,,6,1,7
HND-005933,2011,61300012,,,,4,5,9
HND-005937,2011,61300017,,,,3,1,4
HND-005922,2011,61300001,,,,8,12,20
HND-005930,2011,61300009,,,,5,4,9
HND-005933,2011,61300012,,,,1,2,3
HND-005937,2011,61300017,,,,1,3,4
HND-005923,2011,61300002,,,,8,8,16
HND-005924,2011,61300003,,,,4,2,6
HND-005925,2011,61300004,,,,3,6,9
HND-005926,2011,61300005,,,,5,5,10
HND-005927,2011,61300006,,,,2,1,3
HND-005928,2011,61300007,,,,0,1,1
HND-005929,2011,61300008,,,,5,4,9
HND-005935,2011,61300015,,,,0,1,1
HND-005922,2011,61300001,,,,26,23,49
HND-005922,2011,61300001,,,,16,14,30
HND-005922,2011,61300001,,,,24,18,42
HND-005952,2011,61400037,,,,6,9,15
,2011,61400001,,,,4,7,11
,2011,61400015,,,,7,4,11
HND-005950,2011,61400035,,,,4,5,9
HND-005951,2011,61400036,,,,2,8,10
HND-005953,2011,61400038,,,,2,8,10
HND-005949,2011,61400014,,,,2,7,9
,2011,61400002,,,,2,3,5
,2011,61400018,,,,3,4,7
HND-005945,2011,61400010,,,,8,4,12
HND-005949,2011,61400014,,,,2,2,4
HND-005945,2011,61400010,,,,12,6,18
,2011,61400002,,,,3,6,9
HND-005949,2011,61400014,,,,5,2,7
,2011,61400018,,,,2,7,9
HND-005940,2011,61400005,,,,10,8,18
HND-005941,2011,61400006,,,,11,9,20
HND-005943,2011,61400008,,,,12,8,20
HND-005944,2011,61400009,,,,4,0,4
HND-005939,2011,61400004,,,,12,26,38
HND-005942,2011,61400007,,,,9,5,14
HND-005946,2011,61400011,,,,2,6,8
HND-005947,2011,61400012,,,,1,2,3
HND-005948,2011,61400013,,,,3,2,5
HND-005939,2011,61400004,,,,14,16,30
HND-005944,2011,61400009,,,,2,0,2
HND-005946,2011,61400011,,,,9,9,18
HND-005948,2011,61400013,,,,3,4,7
HND-005940,2011,61400005,,,,9,7,16
HND-005941,2011,61400006,,,,14,14,28
HND-005942,2011,61400007,,,,8,11,19
HND-005943,2011,61400008,,,,9,7,16
HND-005947,2011,61400012,,,,1,3,4
HND-005939,2011,61400004,,,,12,10,22
HND-005942,2011,61400007,,,,4,7,11
HND-005946,2011,61400011,,,,8,5,13
HND-005947,2011,61400012,,,,1,4,5
HND-005948,2011,61400013,,,,4,1,5
HND-005940,2011,61400005,,,,12,6,18
HND-005941,2011,61400006,,,,9,6,15
HND-005943,2011,61400008,,,,8,11,19
HND-005944,2011,61400009,,,,1,0,1
HND-005940,2011,61400005,,,,3,9,12
HND-005943,2011,61400008,,,,7,7,14
HND-005944,2011,61400009,,,,1,1,2
HND-005946,2011,61400011,,,,3,2,5
HND-005939,2011,61400004,,,,14,14,28
HND-005941,2011,61400006,,,,6,8,14
HND-005942,2011,61400007,,,,11,2,13
HND-005947,2011,61400012,,,,3,5,8
HND-005948,2011,61400013,,,,4,3,7
HND-005940,2011,61400005,,,,8,4,12
HND-005941,2011,61400006,,,,6,6,12
HND-005943,2011,61400008,,,,3,9,12
HND-005944,2011,61400009,,,,0,1,1
HND-005939,2011,61400004,,,,9,16,25
HND-005942,2011,61400007,,,,3,9,12
HND-005946,2011,61400011,,,,0,3,3
HND-005947,2011,61400012,,,,3,4,7
HND-005948,2011,61400013,,,,5,5,10
HND-005940,2011,61400005,,,,7,1,8
HND-005941,2011,61400006,,,,3,4,7
HND-005942,2011,61400007,,,,4,8,12
HND-005943,2011,61400008,,,,10,12,22
HND-005947,2011,61400012,,,,5,6,11
HND-005939,2011,61400004,,,,12,16,28
HND-005944,2011,61400009,,,,1,0,1
HND-005946,2011,61400011,,,,7,3,10
HND-005948,2011,61400013,,,,2,2,4
HND-005939,2011,61400004,,,,19,18,37
HND-005939,2011,61400004,,,,10,18,28
HND-005939,2011,61400004,,,,12,19,31
HND-006012,2011,61500079,,,,14,28,42
,2011,61500103,,,,6,8,14
,2011,61500104,,,,5,2,7
,2011,61500105,,,,3,4,7
,2011,61500097,,,,5,2,7
,2011,61500098,,,,3,2,5
,2011,61500099,,,,3,4,7
,2011,61500001,,,,5,0,5
,2011,61500052,,,,1,2,3
HND-006000,2011,61500056,,,,35,40,75
HND-006003,2011,61500059,,,,1,4,5
,2011,61500070,,,,2,2,4
,2011,61500074,,,,5,4,9
,2011,61500075,,,,2,2,4
HND-006010,2011,61500076,,,,2,7,9
HND-006014,2011,61500102,,,,4,4,8
,2011,61500001,,,,5,0,5
,2011,61500004,,,,6,4,10
,2011,61500052,,,,2,2,4
HND-006001,2011,61500057,,,,7,3,10
HND-006002,2011,61500058,,,,9,8,17
HND-006004,2011,61500060,,,,17,10,27
HND-006005,2011,61500061,,,,8,7,15
HND-006008,2011,61500066,,,,1,5,6
,2011,61500072,,,,10,5,15
HND-006009,2011,61500073,,,,2,3,5
HND-006013,2011,61500080,,,,3,5,8
,2011,61500001,,,,5,3,8
,2011,61500052,,,,2,6,8
HND-006000,2011,61500056,,,,41,56,97
HND-006001,2011,61500057,,,,8,7,15
HND-006002,2011,61500058,,,,10,8,18
,2011,61500072,,,,13,13,26
HND-006013,2011,61500080,,,,5,6,11
,2011,61500004,,,,15,13,28
HND-006003,2011,61500059,,,,1,5,6
HND-006004,2011,61500060,,,,15,18,33
HND-006005,2011,61500061,,,,10,11,21
HND-006008,2011,61500066,,,,4,5,9
,2011,61500070,,,,4,4,8
HND-006009,2011,61500073,,,,2,5,7
,2011,61500074,,,,5,5,10
,2011,61500075,,,,2,8,10
HND-006010,2011,61500076,,,,6,7,13
HND-006014,2011,61500102,,,,5,4,9
HND-005955,2011,61500003,,,,15,15,30
HND-005956,2011,61500005,,,,8,5,13
HND-005957,2011,61500006,,,,0,5,5
HND-005959,2011,61500008,,,,3,1,4
HND-005960,2011,61500009,,,,4,3,7
HND-005961,2011,61500010,,,,6,7,13
HND-005966,2011,61500015,,,,4,8,12
HND-005967,2011,61500016,,,,7,4,11
HND-005969,2011,61500018,,,,7,15,22
HND-005970,2011,61500019,,,,10,13,23
HND-005973,2011,61500022,,,,0,2,2
HND-005975,2011,61500024,,,,2,3,5
HND-005976,2011,61500025,,,,8,2,10
HND-005977,2011,61500026,,,,10,3,13
HND-005979,2011,61500028,,,,6,2,8
HND-005980,2011,61500029,,,,5,3,8
HND-005981,2011,61500030,,,,0,2,2
HND-005986,2011,61500035,,,,0,1,1
HND-005989,2011,61500038,,,,3,6,9
HND-005990,2011,61500040,,,,2,4,6
HND-005992,2011,61500042,,,,2,4,6
HND-005993,2011,61500043,,,,1,4,5
HND-005995,2011,61500048,,,,0,2,2
HND-005996,2011,61500049,,,,2,4,6
HND-005999,2011,61500051,,,,6,1,7
HND-005998,2011,61500051,,,,6,1,7
HND-006006,2011,61500063,,,,0,3,3
HND-006007,2011,61500064,,,,2,0,2
HND-005954,2011,61500002,,,,9,8,17
,2011,61500004,,,,13,14,27
HND-005958,2011,61500007,,,,1,0,1
HND-005962,2011,61500011,,,,7,2,9
HND-005963,2011,61500012,,,,3,1,4
HND-005964,2011,61500013,,,,1,1,2
HND-005965,2011,61500014,,,,9,2,11
HND-005968,2011,61500017,,,,6,3,9
HND-005971,2011,61500020,,,,38,24,62
HND-005972,2011,61500021,,,,2,0,2
HND-005974,2011,61500023,,,,3,2,5
HND-005978,2011,61500027,,,,30,19,49
HND-005982,2011,61500031,,,,2,3,5
HND-005983,2011,61500032,,,,1,0,1
HND-005984,2011,61500033,,,,11,13,24
HND-005985,2011,61500034,,,,2,8,10
HND-005987,2011,61500036,,,,5,5,10
HND-005988,2011,61500037,,,,3,7,10
,2011,61500039,,,,38,38,76
HND-005997,2011,61500050,,,,4,2,6
HND-006011,2011,61500077,,,,1,4,5
HND-005956,2011,61500005,,,,1,7,8
HND-005957,2011,61500006,,,,4,2,6
HND-005958,2011,61500007,,,,3,0,3
HND-005959,2011,61500008,,,,4,2,6
HND-005960,2011,61500009,,,,5,1,6
HND-005961,2011,61500010,,,,7,4,11
HND-005962,2011,61500011,,,,3,5,8
HND-005963,2011,61500012,,,,4,2,6
HND-005964,2011,61500013,,,,0,1,1
HND-005965,2011,61500014,,,,10,5,15
HND-005966,2011,61500015,,,,6,5,11
HND-005967,2011,61500016,,,,6,4,10
HND-005968,2011,61500017,,,,4,2,6
HND-005969,2011,61500018,,,,10,5,15
HND-005970,2011,61500019,,,,10,16,26
HND-005971,2011,61500020,,,,20,28,48
HND-005972,2011,61500021,,,,1,2,3
HND-005973,2011,61500022,,,,0,2,2
HND-005974,2011,61500023,,,,1,4,5
HND-005975,2011,61500024,,,,3,5,8
HND-005976,2011,61500025,,,,0,3,3
HND-005977,2011,61500026,,,,1,6,7
HND-005979,2011,61500028,,,,5,7,12
HND-005982,2011,61500031,,,,4,0,4
HND-005988,2011,61500037,,,,4,5,9
HND-005990,2011,61500040,,,,2,4,6
HND-005994,2011,61500044,,,,2,4,6
HND-005995,2011,61500048,,,,2,1,3
HND-005996,2011,61500049,,,,2,5,7
HND-006011,2011,61500077,,,,2,2,4
HND-005954,2011,61500002,,,,10,2,12
HND-005955,2011,61500003,,,,15,5,20
,2011,61500004,,,,13,17,30
HND-005978,2011,61500027,,,,12,15,27
HND-005980,2011,61500029,,,,7,1,8
HND-005981,2011,61500030,,,,3,2,5
HND-005983,2011,61500032,,,,1,1,2
HND-005984,2011,61500033,,,,17,19,36
HND-005985,2011,61500034,,,,6,4,10
HND-005986,2011,61500035,,,,3,1,4
HND-005987,2011,61500036,,,,3,5,8
HND-005989,2011,61500038,,,,4,3,7
,2011,61500039,,,,46,31,77
HND-005992,2011,61500042,,,,2,0,2
HND-005993,2011,61500043,,,,4,3,7
HND-005997,2011,61500050,,,,3,4,7
HND-005999,2011,61500051,,,,4,2,6
HND-005998,2011,61500051,,,,4,2,6
HND-006006,2011,61500063,,,,3,7,10
HND-006007,2011,61500064,,,,1,1,2
HND-005956,2011,61500005,,,,14,5,19
HND-005957,2011,61500006,,,,2,0,2
HND-005959,2011,61500008,,,,1,3,4
HND-005960,2011,61500009,,,,8,3,11
HND-005962,2011,61500011,,,,5,6,11
HND-005965,2011,61500014,,,,17,13,30
HND-005966,2011,61500015,,,,6,12,18
HND-005967,2011,61500016,,,,13,8,21
HND-005969,2011,61500018,,,,9,6,15
HND-005970,2011,61500019,,,,12,13,25
HND-005971,2011,61500020,,,,24,32,56
HND-005973,2011,61500022,,,,6,4,10
HND-005975,2011,61500024,,,,1,2,3
HND-005976,2011,61500025,,,,1,3,4
HND-005977,2011,61500026,,,,6,6,12
HND-005979,2011,61500028,,,,10,11,21
HND-005980,2011,61500029,,,,1,7,8
HND-005983,2011,61500032,,,,5,1,6
HND-005984,2011,61500033,,,,13,11,24
HND-005985,2011,61500034,,,,8,7,15
HND-005988,2011,61500037,,,,2,4,6
,2011,61500039,,,,31,46,77
HND-005990,2011,61500040,,,,3,7,10
HND-005997,2011,61500050,,,,1,1,2
HND-006006,2011,61500063,,,,8,7,15
HND-006007,2011,61500064,,,,2,0,2
HND-006011,2011,61500077,,,,1,0,1
HND-005954,2011,61500002,,,,14,10,24
HND-005955,2011,61500003,,,,16,20,36
,2011,61500004,,,,10,15,25
HND-005958,2011,61500007,,,,2,3,5
HND-005961,2011,61500010,,,,5,5,10
HND-005963,2011,61500012,,,,2,2,4
HND-005964,2011,61500013,,,,3,0,3
HND-005968,2011,61500017,,,,5,5,10
HND-005974,2011,61500023,,,,5,4,9
HND-005978,2011,61500027,,,,20,14,34
HND-005981,2011,61500030,,,,1,3,4
HND-005987,2011,61500036,,,,11,5,16
HND-005989,2011,61500038,,,,1,1,2
HND-005992,2011,61500042,,,,2,5,7
HND-005993,2011,61500043,,,,2,1,3
HND-005994,2011,61500044,,,,3,3,6
HND-005995,2011,61500048,,,,1,1,2
HND-005996,2011,61500049,,,,0,4,4
HND-005999,2011,61500051,,,,4,1,5
HND-005998,2011,61500051,,,,4,1,5
,2011,61500004,,,,13,16,29
HND-005956,2011,61500005,,,,10,10,20
HND-005957,2011,61500006,,,,6,3,9
HND-005958,2011,61500007,,,,0,4,4
HND-005959,2011,61500008,,,,2,4,6
HND-005961,2011,61500010,,,,13,10,23
HND-005962,2011,61500011,,,,7,12,19
HND-005963,2011,61500012,,,,4,4,8
HND-005964,2011,61500013,,,,5,1,6
HND-005965,2011,61500014,,,,11,2,13
HND-005966,2011,61500015,,,,5,5,10
HND-005967,2011,61500016,,,,12,9,21
HND-005968,2011,61500017,,,,4,6,10
HND-005969,2011,61500018,,,,11,10,21
HND-005971,2011,61500020,,,,16,29,45
HND-005972,2011,61500021,,,,3,2,5
HND-005973,2011,61500022,,,,4,1,5
HND-005974,2011,61500023,,,,2,3,5
HND-005975,2011,61500024,,,,0,2,2
HND-005977,2011,61500026,,,,3,1,4
HND-005990,2011,61500040,,,,1,3,4
HND-005992,2011,61500042,,,,1,0,1
HND-005994,2011,61500044,,,,2,6,8
HND-005995,2011,61500048,,,,1,0,1
HND-005996,2011,61500049,,,,2,4,6
HND-005999,2011,61500051,,,,4,0,4
HND-005998,2011,61500051,,,,4,0,4
HND-006011,2011,61500077,,,,3,2,5
HND-005954,2011,61500002,,,,12,5,17
HND-005955,2011,61500003,,,,16,13,29
HND-005960,2011,61500009,,,,8,7,15
HND-005970,2011,61500019,,,,19,7,26
HND-005976,2011,61500025,,,,5,2,7
HND-005978,2011,61500027,,,,19,24,43
HND-005979,2011,61500028,,,,9,3,12
HND-005980,2011,61500029,,,,4,3,7
HND-005981,2011,61500030,,,,5,2,7
HND-005982,2011,61500031,,,,0,1,1
HND-005983,2011,61500032,,,,0,3,3
HND-005984,2011,61500033,,,,14,13,27
HND-005985,2011,61500034,,,,4,5,9
HND-005986,2011,61500035,,,,4,0,4
HND-005987,2011,61500036,,,,3,3,6
HND-005988,2011,61500037,,,,5,8,13
HND-005989,2011,61500038,,,,3,4,7
,2011,61500039,,,,35,39,74
HND-005993,2011,61500043,,,,6,2,8
HND-005997,2011,61500050,,,,2,2,4
HND-006006,2011,61500063,,,,7,9,16
HND-006007,2011,61500064,,,,1,1,2
,2011,61500004,,,,15,20,35
HND-005957,2011,61500006,,,,2,2,4
HND-005958,2011,61500007,,,,3,1,4
HND-005962,2011,61500011,,,,2,3,5
HND-005963,2011,61500012,,,,2,3,5
HND-005964,2011,61500013,,,,1,1,2
HND-005965,2011,61500014,,,,0,2,2
HND-005967,2011,61500016,,,,14,4,18
HND-005968,2011,61500017,,,,8,8,16
HND-005971,2011,61500020,,,,27,17,44
HND-005972,2011,61500021,,,,1,2,3
HND-005973,2011,61500022,,,,4,6,10
HND-005974,2011,61500023,,,,6,4,10
HND-005981,2011,61500030,,,,3,2,5
HND-005986,2011,61500035,,,,1,2,3
HND-005990,2011,61500040,,,,2,4,6
HND-005992,2011,61500042,,,,3,3,6
HND-005993,2011,61500043,,,,2,2,4
HND-005994,2011,61500044,,,,3,0,3
HND-005995,2011,61500048,,,,1,2,3
HND-005996,2011,61500049,,,,4,1,5
HND-005999,2011,61500051,,,,5,4,9
HND-005998,2011,61500051,,,,5,4,9
HND-005954,2011,61500002,,,,8,6,14
HND-005955,2011,61500003,,,,13,16,29
HND-005956,2011,61500005,,,,5,8,13
HND-005959,2011,61500008,,,,2,3,5
HND-005960,2011,61500009,,,,6,6,12
HND-005961,2011,61500010,,,,13,9,22
HND-005966,2011,61500015,,,,6,6,12
HND-005969,2011,61500018,,,,8,6,14
HND-005970,2011,61500019,,,,3,14,17
HND-005975,2011,61500024,,,,1,4,5
HND-005976,2011,61500025,,,,5,5,10
HND-005977,2011,61500026,,,,3,7,10
HND-005978,2011,61500027,,,,17,11,28
HND-005979,2011,61500028,,,,5,9,14
HND-005980,2011,61500029,,,,2,5,7
HND-005982,2011,61500031,,,,2,2,4
HND-005983,2011,61500032,,,,4,2,6
HND-005984,2011,61500033,,,,8,12,20
HND-005985,2011,61500034,,,,6,3,9
HND-005987,2011,61500036,,,,6,3,9
HND-005988,2011,61500037,,,,5,2,7
HND-005989,2011,61500038,,,,4,6,10
,2011,61500039,,,,59,62,121
HND-005997,2011,61500050,,,,4,7,11
HND-006006,2011,61500063,,,,8,2,10
HND-006007,2011,61500064,,,,1,1,2
HND-006011,2011,61500077,,,,1,4,5
HND-005954,2011,61500002,,,,6,10,16
HND-005955,2011,61500003,,,,23,17,40
,2011,61500004,,,,19,15,34
HND-005978,2011,61500027,,,,19,15,34
HND-005980,2011,61500029,,,,2,3,5
HND-005981,2011,61500030,,,,4,4,8
HND-005983,2011,61500032,,,,1,3,4
HND-005984,2011,61500033,,,,12,10,22
HND-005985,2011,61500034,,,,6,1,7
HND-005986,2011,61500035,,,,2,0,2
HND-005987,2011,61500036,,,,5,5,10
HND-005989,2011,61500038,,,,5,3,8
,2011,61500039,,,,57,57,114
HND-005992,2011,61500042,,,,1,1,2
HND-005993,2011,61500043,,,,1,2,3
HND-005997,2011,61500050,,,,3,2,5
HND-005999,2011,61500051,,,,5,5,10
HND-005998,2011,61500051,,,,5,5,10
HND-006006,2011,61500063,,,,3,5,8
HND-006007,2011,61500064,,,,1,1,2
HND-005956,2011,61500005,,,,5,6,11
HND-005957,2011,61500006,,,,6,4,10
HND-005958,2011,61500007,,,,1,2,3
HND-005959,2011,61500008,,,,1,2,3
HND-005960,2011,61500009,,,,4,4,8
HND-005961,2011,61500010,,,,5,9,14
HND-005962,2011,61500011,,,,7,5,12
HND-005963,2011,61500012,,,,2,1,3
HND-005965,2011,61500014,,,,2,4,6
HND-005966,2011,61500015,,,,6,2,8
HND-005967,2011,61500016,,,,11,5,16
HND-005968,2011,61500017,,,,5,7,12
HND-005969,2011,61500018,,,,8,13,21
HND-005970,2011,61500019,,,,15,16,31
HND-005971,2011,61500020,,,,32,21,53
HND-005972,2011,61500021,,,,1,3,4
HND-005973,2011,61500022,,,,3,0,3
HND-005974,2011,61500023,,,,4,0,4
HND-005975,2011,61500024,,,,1,4,5
HND-005976,2011,61500025,,,,3,2,5
HND-005977,2011,61500026,,,,11,4,15
HND-005979,2011,61500028,,,,7,11,18
HND-005982,2011,61500031,,,,1,1,2
HND-005988,2011,61500037,,,,4,1,5
HND-005990,2011,61500040,,,,2,1,3
HND-005994,2011,61500044,,,,1,2,3
HND-005995,2011,61500048,,,,3,2,5
HND-005996,2011,61500049,,,,0,5,5
HND-006011,2011,61500077,,,,2,2,4
HND-005961,2011,61500010,,,,6,14,20
HND-005970,2011,61500019,,,,31,21,52
HND-005991,2011,61500041,,,,108,92,200
,2011,61500095,,,,9,7,16
,2011,61500039,,,,54,78,132
,2011,61500078,,,,28,26,54
HND-005961,2011,61500010,,,,3,8,11
HND-005970,2011,61500019,,,,16,21,37
,2011,61500078,,,,18,17,35
,2011,61500095,,,,5,13,18
,2011,61500039,,,,53,63,116
HND-005991,2011,61500041,,,,118,119,237
HND-005961,2011,61500010,,,,5,5,10
,2011,61500039,,,,32,71,103
,2011,61500078,,,,22,27,49
HND-005970,2011,61500019,,,,21,28,49
HND-005991,2011,61500041,,,,60,92,152
,2011,61500095,,,,9,20,29
,2011,61500095,,,,7,2,9
,2011,61500039,,,,48,69,117
HND-005991,2011,61500041,,,,78,115,193
,2011,61500095,,,,7,4,11
,2011,61500039,,,,27,50,77
HND-005991,2011,61500041,,,,69,86,155
,2011,61500100,,,,3,8,11
,2011,61500039,,,,22,39,61
HND-005991,2011,61500041,,,,56,111,167
,2011,61500039,,,,0,10,10
,2011,61600047,,,,4,3,7
,2011,61600051,,,,4,1,5
HND-006024,2011,61600012,,,,3,2,5
,2011,61600051,,,,1,7,8
HND-006023,2011,61600011,,,,0,2,2
HND-006025,2011,61600013,,,,9,3,12
HND-006026,2011,61600014,,,,11,9,20
HND-006027,2011,61600015,,,,1,1,2
HND-006028,2011,61600016,,,,4,3,7
HND-006029,2011,61600017,,,,2,1,3
HND-006031,2011,61600048,,,,5,6,11
HND-006023,2011,61600011,,,,33,22,55
HND-006024,2011,61600012,,,,21,22,43
HND-006025,2011,61600013,,,,9,13,22
HND-006026,2011,61600014,,,,8,8,16
HND-006028,2011,61600016,,,,3,9,12
HND-006029,2011,61600017,,,,11,11,22
HND-006027,2011,61600015,,,,13,14,27
HND-006031,2011,61600048,,,,16,11,27
,2011,61600051,,,,2,6,8
HND-006017,2011,61600004,,,,42,22,64
,2011,61600005,,,,22,22,44
HND-006018,2011,61600006,,,,7,3,10
HND-006021,2011,61600009,,,,1,4,5
,2011,61600001,,,,12,9,21
HND-006015,2011,61600002,,,,9,11,20
HND-006016,2011,61600003,,,,6,7,13
HND-006019,2011,61600007,,,,38,32,70
HND-006020,2011,61600008,,,,31,23,54
HND-006022,2011,61600010,,,,3,3,6
HND-006030,2011,61600018,,,,23,18,41
HND-006020,2011,61600008,,,,35,13,48
,2011,61600001,,,,9,10,19
HND-006015,2011,61600002,,,,12,10,22
HND-006016,2011,61600003,,,,6,6,12
HND-006017,2011,61600004,,,,24,24,48
,2011,61600005,,,,23,25,48
HND-006018,2011,61600006,,,,2,7,9
HND-006019,2011,61600007,,,,31,42,73
HND-006021,2011,61600009,,,,2,1,3
HND-006022,2011,61600010,,,,3,5,8
HND-006030,2011,61600018,,,,23,19,42
,2011,61600001,,,,9,9,18
HND-006016,2011,61600003,,,,8,3,11
HND-006019,2011,61600007,,,,38,27,65
HND-006020,2011,61600008,,,,28,28,56
HND-006022,2011,61600010,,,,4,6,10
HND-006030,2011,61600018,,,,11,11,22
HND-006015,2011,61600002,,,,7,13,20
HND-006017,2011,61600004,,,,29,20,49
,2011,61600005,,,,29,32,61
HND-006018,2011,61600006,,,,5,3,8
HND-006021,2011,61600009,,,,1,2,3
,2011,61600005,,,,20,20,40
HND-006021,2011,61600009,,,,1,1,2
,2011,61600001,,,,11,15,26
HND-006015,2011,61600002,,,,10,7,17
HND-006016,2011,61600003,,,,5,9,14
HND-006017,2011,61600004,,,,16,21,37
HND-006018,2011,61600006,,,,5,0,5
HND-006019,2011,61600007,,,,27,31,58
HND-006020,2011,61600008,,,,28,22,50
HND-006022,2011,61600010,,,,4,5,9
HND-006030,2011,61600018,,,,15,12,27
,2011,61600005,,,,21,20,41
HND-006018,2011,61600006,,,,5,6,11
HND-006021,2011,61600009,,,,1,1,2
,2011,61600001,,,,5,12,17
HND-006015,2011,61600002,,,,12,9,21
HND-006016,2011,61600003,,,,4,10,14
HND-006017,2011,61600004,,,,18,22,40
HND-006019,2011,61600007,,,,40,39,79
HND-006020,2011,61600008,,,,38,30,68
HND-006022,2011,61600010,,,,3,6,9
HND-006030,2011,61600018,,,,14,10,24
,2011,61600001,,,,15,10,25
HND-006015,2011,61600002,,,,12,7,19
HND-006016,2011,61600003,,,,9,4,13
HND-006017,2011,61600004,,,,21,24,45
,2011,61600005,,,,25,23,48
HND-006018,2011,61600006,,,,5,2,7
HND-006019,2011,61600007,,,,33,36,69
HND-006021,2011,61600009,,,,1,0,1
HND-006022,2011,61600010,,,,3,6,9
HND-006030,2011,61600018,,,,10,13,23
HND-006020,2011,61600008,,,,31,26,57
HND-006017,2011,61600004,,,,17,15,32
,2011,61600005,,,,14,20,34
HND-006020,2011,61600008,,,,54,64,118
HND-006020,2011,61600008,,,,32,51,83
HND-006017,2011,61600004,,,,3,7,10
,2011,61600005,,,,11,16,27
HND-006017,2011,61600004,,,,7,12,19
,2011,61600005,,,,12,14,26
HND-006020,2011,61600008,,,,27,39,66
,2011,70100064,,,,4,5,9
,2011,70100079,,,,3,5,8
,2011,70100081,,,,6,3,9
HND-006069,2011,70100061,,,,4,4,8
,2011,70100062,,,,4,5,9
,2011,70100063,,,,5,3,8
HND-006070,2011,70100068,,,,7,3,10
,2011,70100069,,,,6,5,11
,2011,70100075,,,,4,6,10
HND-006072,2011,70100078,,,,3,5,8
HND-006073,2011,70100080,,,,3,6,9
HND-006066,2011,70100039,,,,14,1,15
HND-006055,2011,70100025,,,,3,3,6
HND-006057,2011,70100027,,,,5,7,12
HND-006061,2011,70100031,,,,11,11,22
HND-006063,2011,70100035,,,,3,4,7
HND-006065,2011,70100037,,,,4,3,7
HND-006053,2011,70100023,,,,21,18,39
HND-006054,2011,70100024,,,,10,3,13
,2011,70100034,,,,1,2,3
HND-006066,2011,70100039,,,,11,2,13
HND-006053,2011,70100023,,,,22,29,51
,2011,70100034,,,,9,8,17
HND-006063,2011,70100035,,,,2,7,9
HND-006064,2011,70100036,,,,7,10,17
HND-006065,2011,70100037,,,,7,5,12
HND-006054,2011,70100024,,,,7,10,17
HND-006055,2011,70100025,,,,4,6,10
HND-006057,2011,70100027,,,,4,6,10
HND-006061,2011,70100031,,,,24,33,57
HND-006066,2011,70100039,,,,15,7,22
HND-006032,2011,70100002,,,,3,1,4
HND-006033,2011,70100003,,,,7,7,14
HND-006034,2011,70100004,,,,6,2,8
HND-006039,2011,70100009,,,,2,4,6
HND-006040,2011,70100010,,,,6,10,16
HND-006041,2011,70100011,,,,6,5,11
HND-006042,2011,70100012,,,,51,39,90
HND-006043,2011,70100013,,,,3,3,6
HND-006048,2011,70100018,,,,3,3,6
HND-006049,2011,70100019,,,,0,1,1
HND-006050,2011,70100020,,,,3,6,9
HND-006056,2011,70100026,,,,6,3,9
HND-006060,2011,70100030,,,,0,6,6
,2011,70100001,,,,6,7,13
HND-006035,2011,70100005,,,,3,1,4
HND-006036,2011,70100006,,,,10,11,21
HND-006037,2011,70100007,,,,4,4,8
HND-006038,2011,70100008,,,,5,1,6
HND-006044,2011,70100014,,,,25,22,47
HND-006045,2011,70100015,,,,4,6,10
HND-006046,2011,70100016,,,,2,4,6
HND-006047,2011,70100017,,,,5,2,7
HND-006052,2011,70100022,,,,4,2,6
HND-006059,2011,70100029,,,,2,1,3
HND-006067,2011,70100041,,,,5,1,6
HND-006071,2011,70100073,,,,1,4,5
HND-006034,2011,70100004,,,,1,8,9
HND-006035,2011,70100005,,,,5,4,9
HND-006036,2011,70100006,,,,7,7,14
HND-006037,2011,70100007,,,,3,0,3
HND-006040,2011,70100010,,,,7,2,9
HND-006042,2011,70100012,,,,29,41,70
HND-006043,2011,70100013,,,,1,2,3
HND-006044,2011,70100014,,,,28,26,54
HND-006049,2011,70100019,,,,1,3,4
HND-006050,2011,70100020,,,,4,5,9
HND-006051,2011,70100021,,,,0,1,1
HND-006052,2011,70100022,,,,2,3,5
HND-006067,2011,70100041,,,,1,1,2
HND-006071,2011,70100073,,,,4,2,6
,2011,70100001,,,,6,1,7
HND-006032,2011,70100002,,,,3,2,5
HND-006033,2011,70100003,,,,4,3,7
HND-006038,2011,70100008,,,,2,1,3
HND-006039,2011,70100009,,,,2,2,4
HND-006041,2011,70100011,,,,5,6,11
HND-006045,2011,70100015,,,,1,1,2
HND-006046,2011,70100016,,,,2,1,3
HND-006047,2011,70100017,,,,1,2,3
HND-006048,2011,70100018,,,,4,3,7
HND-006056,2011,70100026,,,,5,5,10
HND-006060,2011,70100030,,,,1,0,1
,2011,70100001,,,,3,8,11
HND-006035,2011,70100005,,,,2,2,4
HND-006036,2011,70100006,,,,7,13,20
HND-006037,2011,70100007,,,,2,4,6
HND-006038,2011,70100008,,,,1,3,4
HND-006044,2011,70100014,,,,19,19,38
HND-006045,2011,70100015,,,,2,2,4
HND-006046,2011,70100016,,,,1,3,4
HND-006047,2011,70100017,,,,3,2,5
HND-006050,2011,70100020,,,,6,5,11
HND-006052,2011,70100022,,,,2,3,5
HND-006059,2011,70100029,,,,1,0,1
HND-006032,2011,70100002,,,,2,2,4
HND-006033,2011,70100003,,,,6,4,10
HND-006034,2011,70100004,,,,7,2,9
HND-006039,2011,70100009,,,,3,2,5
HND-006040,2011,70100010,,,,11,8,19
HND-006041,2011,70100011,,,,6,4,10
HND-006042,2011,70100012,,,,42,32,74
HND-006043,2011,70100013,,,,4,5,9
HND-006048,2011,70100018,,,,5,2,7
HND-006049,2011,70100019,,,,0,1,1
HND-006051,2011,70100021,,,,3,0,3
HND-006056,2011,70100026,,,,4,5,9
HND-006060,2011,70100030,,,,1,0,1
HND-006067,2011,70100041,,,,1,0,1
HND-006071,2011,70100073,,,,0,3,3
HND-006034,2011,70100004,,,,2,6,8
HND-006035,2011,70100005,,,,5,0,5
HND-006036,2011,70100006,,,,6,11,17
HND-006037,2011,70100007,,,,3,3,6
HND-006040,2011,70100010,,,,7,9,16
HND-006041,2011,70100011,,,,5,5,10
HND-006042,2011,70100012,,,,31,26,57
HND-006043,2011,70100013,,,,8,2,10
HND-006044,2011,70100014,,,,21,34,55
HND-006049,2011,70100019,,,,1,0,1
HND-006050,2011,70100020,,,,6,6,12
HND-006051,2011,70100021,,,,0,1,1
HND-006052,2011,70100022,,,,4,1,5
HND-006059,2011,70100029,,,,3,0,3
HND-006067,2011,70100041,,,,3,4,7
HND-006071,2011,70100073,,,,3,2,5
,2011,70100001,,,,7,4,11
HND-006032,2011,70100002,,,,2,2,4
HND-006033,2011,70100003,,,,7,8,15
HND-006038,2011,70100008,,,,5,2,7
HND-006039,2011,70100009,,,,6,4,10
HND-006045,2011,70100015,,,,3,1,4
HND-006046,2011,70100016,,,,4,2,6
HND-006047,2011,70100017,,,,3,2,5
HND-006048,2011,70100018,,,,5,6,11
HND-006056,2011,70100026,,,,1,5,6
HND-006060,2011,70100030,,,,1,0,1
HND-006032,2011,70100002,,,,2,2,4
HND-006034,2011,70100004,,,,7,6,13
HND-006037,2011,70100007,,,,3,2,5
HND-006039,2011,70100009,,,,1,2,3
HND-006040,2011,70100010,,,,6,7,13
HND-006041,2011,70100011,,,,13,6,19
HND-006042,2011,70100012,,,,37,42,79
HND-006043,2011,70100013,,,,9,3,12
HND-006048,2011,70100018,,,,4,3,7
HND-006049,2011,70100019,,,,3,0,3
HND-006050,2011,70100020,,,,5,7,12
HND-006051,2011,70100021,,,,3,1,4
HND-006056,2011,70100026,,,,9,5,14
HND-006059,2011,70100029,,,,1,1,2
HND-006071,2011,70100073,,,,3,2,5
,2011,70100001,,,,5,7,12
HND-006033,2011,70100003,,,,8,7,15
HND-006035,2011,70100005,,,,5,0,5
HND-006036,2011,70100006,,,,13,10,23
HND-006038,2011,70100008,,,,7,8,15
HND-006044,2011,70100014,,,,33,21,54
HND-006045,2011,70100015,,,,2,1,3
HND-006046,2011,70100016,,,,0,2,2
HND-006047,2011,70100017,,,,1,2,3
HND-006052,2011,70100022,,,,3,2,5
HND-006060,2011,70100030,,,,3,1,4
,2011,70100001,,,,7,3,10
HND-006032,2011,70100002,,,,3,2,5
HND-006033,2011,70100003,,,,6,8,14
HND-006038,2011,70100008,,,,6,4,10
HND-006039,2011,70100009,,,,3,2,5
HND-006041,2011,70100011,,,,3,4,7
HND-006045,2011,70100015,,,,2,2,4
HND-006046,2011,70100016,,,,1,1,2
HND-006047,2011,70100017,,,,3,1,4
HND-006048,2011,70100018,,,,5,2,7
HND-006056,2011,70100026,,,,6,7,13
HND-006060,2011,70100030,,,,0,2,2
HND-006034,2011,70100004,,,,2,1,3
HND-006035,2011,70100005,,,,2,2,4
HND-006036,2011,70100006,,,,10,13,23
HND-006037,2011,70100007,,,,4,1,5
HND-006040,2011,70100010,,,,15,11,26
HND-006042,2011,70100012,,,,38,24,62
HND-006043,2011,70100013,,,,0,4,4
HND-006044,2011,70100014,,,,27,30,57
HND-006049,2011,70100019,,,,2,0,2
HND-006050,2011,70100020,,,,5,3,8
HND-006051,2011,70100021,,,,0,2,2
HND-006052,2011,70100022,,,,4,0,4
HND-006067,2011,70100041,,,,1,0,1
HND-006071,2011,70100073,,,,0,2,2
HND-006058,2011,70100028,,,,51,34,85
HND-006062,2011,70100033,,,,32,31,63
HND-006068,2011,70100042,,,,48,33,81
HND-006068,2011,70100042,,,,27,27,54
HND-006058,2011,70100028,,,,38,31,69
HND-006062,2011,70100033,,,,31,33,64
HND-006058,2011,70100028,,,,33,22,55
HND-006062,2011,70100033,,,,20,34,54
HND-006068,2011,70100042,,,,30,39,69
HND-006062,2011,70100033,,,,14,21,35
HND-006068,2011,70100042,,,,33,46,79
HND-006058,2011,70100028,,,,48,32,80
HND-006062,2011,70100033,,,,10,20,30
HND-006068,2011,70100042,,,,15,12,27
HND-006058,2011,70100028,,,,25,27,52
HND-006058,2011,70100028,,,,35,16,51
HND-006062,2011,70100033,,,,7,21,28
HND-006096,2011,70200029,,,,3,6,9
HND-006105,2011,70200039,,,,3,6,9
,2011,70200059,,,,6,5,11
HND-006112,2011,70200060,,,,7,6,13
HND-006113,2011,70200062,,,,8,10,18
,2011,70200063,,,,5,4,9
HND-006114,2011,70200064,,,,5,7,12
HND-006111,2011,70200058,,,,3,4,7
,2011,70200065,,,,4,4,8
,2011,70200040,,,,3,0,3
HND-006101,2011,70200034,,,,5,2,7
HND-006106,2011,70200041,,,,2,2,4
,2011,70200056,,,,0,2,2
HND-006085,2011,70200012,,,,0,2,2
HND-006101,2011,70200034,,,,3,1,4
HND-006110,2011,70200053,,,,2,2,4
HND-006094,2011,70200025,,,,1,2,3
HND-006097,2011,70200030,,,,4,7,11
HND-006098,2011,70200031,,,,1,3,4
,2011,70200040,,,,2,2,4
HND-006106,2011,70200041,,,,4,3,7
HND-006109,2011,70200052,,,,7,3,10
,2011,70200055,,,,4,3,7
,2011,70200056,,,,2,3,5
HND-006094,2011,70200025,,,,6,10,16
HND-006098,2011,70200031,,,,7,7,14
,2011,70200040,,,,3,3,6
HND-006106,2011,70200041,,,,2,2,4
HND-006109,2011,70200052,,,,8,8,16
,2011,70200055,,,,7,4,11
,2011,70200056,,,,2,4,6
HND-006085,2011,70200012,,,,8,4,12
HND-006097,2011,70200030,,,,5,3,8
HND-006101,2011,70200034,,,,4,2,6
HND-006110,2011,70200053,,,,12,8,20
HND-006074,2011,70200001,,,,10,17,27
HND-006075,2011,70200002,,,,2,10,12
HND-006076,2011,70200003,,,,10,8,18
HND-006077,2011,70200004,,,,4,2,6
HND-006080,2011,70200007,,,,5,2,7
HND-006082,2011,70200009,,,,0,4,4
HND-006083,2011,70200010,,,,2,1,3
HND-006085,2011,70200012,,,,10,12,22
HND-006086,2011,70200013,,,,2,0,2
HND-006090,2011,70200019,,,,1,0,1
HND-006102,2011,70200035,,,,3,5,8
HND-006103,2011,70200037,,,,4,5,9
HND-006078,2011,70200005,,,,2,4,6
HND-006079,2011,70200006,,,,8,10,18
HND-006084,2011,70200011,,,,11,14,25
HND-006087,2011,70200015,,,,1,2,3
HND-006088,2011,70200017,,,,1,1,2
HND-006089,2011,70200018,,,,8,6,14
HND-006091,2011,70200020,,,,3,4,7
HND-006092,2011,70200021,,,,8,2,10
HND-006093,2011,70200022,,,,2,4,6
HND-006099,2011,70200032,,,,4,0,4
HND-006100,2011,70200033,,,,1,0,1
HND-006104,2011,70200038,,,,2,1,3
HND-006105,2011,70200039,,,,5,5,10
HND-006107,2011,70200042,,,,3,7,10
HND-006108,2011,70200051,,,,4,7,11
HND-006074,2011,70200001,,,,17,17,34
HND-006077,2011,70200004,,,,4,4,8
HND-006078,2011,70200005,,,,9,3,12
HND-006079,2011,70200006,,,,7,4,11
HND-006080,2011,70200007,,,,4,1,5
HND-006081,2011,70200008,,,,1,1,2
HND-006087,2011,70200015,,,,2,3,5
HND-006092,2011,70200021,,,,3,2,5
HND-006102,2011,70200035,,,,9,8,17
HND-006103,2011,70200037,,,,5,2,7
HND-006104,2011,70200038,,,,3,4,7
HND-006108,2011,70200051,,,,11,8,19
HND-006075,2011,70200002,,,,3,1,4
HND-006076,2011,70200003,,,,8,12,20
HND-006083,2011,70200010,,,,2,2,4
HND-006084,2011,70200011,,,,17,15,32
HND-006085,2011,70200012,,,,7,8,15
HND-006086,2011,70200013,,,,2,8,10
HND-006089,2011,70200018,,,,3,1,4
HND-006090,2011,70200019,,,,2,2,4
HND-006091,2011,70200020,,,,4,1,5
HND-006093,2011,70200022,,,,9,4,13
HND-006099,2011,70200032,,,,1,6,7
HND-006100,2011,70200033,,,,2,0,2
HND-006105,2011,70200039,,,,1,5,6
HND-006107,2011,70200042,,,,4,4,8
HND-006078,2011,70200005,,,,9,5,14
HND-006079,2011,70200006,,,,5,9,14
HND-006080,2011,70200007,,,,2,1,3
HND-006081,2011,70200008,,,,1,1,2
HND-006087,2011,70200015,,,,1,1,2
HND-006088,2011,70200017,,,,2,3,5
HND-006089,2011,70200018,,,,3,7,10
HND-006091,2011,70200020,,,,5,2,7
HND-006092,2011,70200021,,,,2,1,3
HND-006093,2011,70200022,,,,4,3,7
HND-006100,2011,70200033,,,,0,1,1
HND-006104,2011,70200038,,,,2,3,5
HND-006105,2011,70200039,,,,6,1,7
HND-006107,2011,70200042,,,,4,7,11
HND-006108,2011,70200051,,,,6,8,14
HND-006074,2011,70200001,,,,6,15,21
HND-006075,2011,70200002,,,,0,3,3
HND-006076,2011,70200003,,,,10,4,14
HND-006077,2011,70200004,,,,3,1,4
HND-006082,2011,70200009,,,,3,4,7
HND-006083,2011,70200010,,,,5,2,7
HND-006084,2011,70200011,,,,15,14,29
HND-006085,2011,70200012,,,,6,5,11
HND-006086,2011,70200013,,,,7,3,10
HND-006090,2011,70200019,,,,1,3,4
HND-006099,2011,70200032,,,,2,3,5
HND-006102,2011,70200035,,,,4,4,8
HND-006103,2011,70200037,,,,2,3,5
HND-006074,2011,70200001,,,,17,13,30
HND-006077,2011,70200004,,,,3,2,5
HND-006078,2011,70200005,,,,4,1,5
HND-006079,2011,70200006,,,,10,4,14
HND-006080,2011,70200007,,,,1,1,2
HND-006085,2011,70200012,,,,5,8,13
HND-006086,2011,70200013,,,,7,4,11
HND-006088,2011,70200017,,,,0,5,5
HND-006090,2011,70200019,,,,3,1,4
HND-006092,2011,70200021,,,,2,2,4
HND-006102,2011,70200035,,,,7,7,14
HND-006103,2011,70200037,,,,4,2,6
HND-006104,2011,70200038,,,,5,5,10
HND-006075,2011,70200002,,,,2,4,6
HND-006076,2011,70200003,,,,12,9,21
HND-006081,2011,70200008,,,,1,1,2
HND-006082,2011,70200009,,,,6,4,10
HND-006083,2011,70200010,,,,2,3,5
HND-006084,2011,70200011,,,,7,15,22
HND-006087,2011,70200015,,,,2,1,3
HND-006089,2011,70200018,,,,1,6,7
HND-006091,2011,70200020,,,,4,5,9
HND-006093,2011,70200022,,,,5,5,10
HND-006099,2011,70200032,,,,3,1,4
HND-006100,2011,70200033,,,,1,1,2
HND-006105,2011,70200039,,,,2,3,5
HND-006107,2011,70200042,,,,5,3,8
HND-006108,2011,70200051,,,,7,8,15
HND-006076,2011,70200003,,,,15,7,22
HND-006078,2011,70200005,,,,8,4,12
HND-006079,2011,70200006,,,,7,10,17
HND-006082,2011,70200009,,,,2,1,3
HND-006084,2011,70200011,,,,21,27,48
HND-006087,2011,70200015,,,,1,1,2
HND-006088,2011,70200017,,,,7,3,10
HND-006089,2011,70200018,,,,3,7,10
HND-006091,2011,70200020,,,,5,2,7
HND-006092,2011,70200021,,,,1,1,2
HND-006093,2011,70200022,,,,9,4,13
HND-006102,2011,70200035,,,,4,9,13
HND-006103,2011,70200037,,,,4,4,8
HND-006074,2011,70200001,,,,17,15,32
HND-006075,2011,70200002,,,,1,5,6
HND-006077,2011,70200004,,,,4,6,10
HND-006080,2011,70200007,,,,1,1,2
HND-006083,2011,70200010,,,,3,3,6
HND-006085,2011,70200012,,,,13,9,22
HND-006086,2011,70200013,,,,6,2,8
HND-006090,2011,70200019,,,,1,1,2
HND-006099,2011,70200032,,,,4,2,6
HND-006100,2011,70200033,,,,1,4,5
HND-006104,2011,70200038,,,,1,1,2
HND-006105,2011,70200039,,,,3,1,4
HND-006107,2011,70200042,,,,5,5,10
HND-006108,2011,70200051,,,,2,9,11
HND-006074,2011,70200001,,,,15,22,37
HND-006077,2011,70200004,,,,5,5,10
HND-006078,2011,70200005,,,,8,8,16
HND-006079,2011,70200006,,,,12,4,16
HND-006081,2011,70200008,,,,2,0,2
HND-006087,2011,70200015,,,,2,1,3
HND-006088,2011,70200017,,,,3,1,4
HND-006092,2011,70200021,,,,4,2,6
HND-006099,2011,70200032,,,,0,3,3
HND-006100,2011,70200033,,,,2,1,3
HND-006105,2011,70200039,,,,4,4,8
HND-006107,2011,70200042,,,,2,5,7
HND-006075,2011,70200002,,,,6,2,8
HND-006076,2011,70200003,,,,8,6,14
HND-006082,2011,70200009,,,,4,0,4
HND-006083,2011,70200010,,,,2,4,6
HND-006084,2011,70200011,,,,10,17,27
HND-006085,2011,70200012,,,,4,11,15
HND-006086,2011,70200013,,,,4,6,10
HND-006089,2011,70200018,,,,2,5,7
HND-006090,2011,70200019,,,,1,0,1
HND-006091,2011,70200020,,,,2,6,8
HND-006093,2011,70200022,,,,3,4,7
HND-006102,2011,70200035,,,,5,6,11
HND-006103,2011,70200037,,,,5,2,7
HND-006104,2011,70200038,,,,1,0,1
HND-006108,2011,70200051,,,,6,7,13
HND-006079,2011,70200006,,,,18,18,36
HND-006084,2011,70200011,,,,32,33,65
HND-006107,2011,70200042,,,,10,10,20
HND-006084,2011,70200011,,,,22,22,44
HND-006079,2011,70200006,,,,9,16,25
HND-006107,2011,70200042,,,,10,7,17
HND-006079,2011,70200006,,,,7,17,24
HND-006084,2011,70200011,,,,27,26,53
HND-006107,2011,70200042,,,,8,5,13
HND-006132,2011,70300022,,,,4,2,6
HND-006175,2011,70300070,,,,4,3,7
HND-006191,2011,70300087,,,,2,5,7
HND-006244,2011,70300146,,,,4,3,7
HND-006279,2011,70300188,,,,0,9,9
HND-006388,2011,70300357,,,,7,8,15
HND-006459,2011,70300560,,,,5,4,9
,2011,70300570,,,,2,2,4
,2011,70300572,,,,7,5,12
HND-006466,2011,70300588,,,,4,4,8
,2011,70300594,,,,4,4,8
,2011,70300600,,,,5,3,8
,2011,70300602,,,,6,4,10
,2011,70300603,,,,5,5,10
,2011,70300604,,,,7,4,11
HND-006472,2011,70300606,,,,3,3,6
,2011,70300607,,,,6,3,9
HND-006473,2011,70300608,,,,6,5,11
,2011,70300613,,,,6,5,11
HND-006475,2011,70300614,,,,2,4,6
,2011,70300617,,,,4,4,8
,2011,70300620,,,,7,4,11
,2011,70300622,,,,5,0,5
,2011,70300623,,,,4,7,11
HND-006476,2011,70300627,,,,4,6,10
,2011,70300637,,,,3,9,12
,2011,70300638,,,,5,4,9
,2011,70300645,,,,3,3,6
HND-006480,2011,70300647,,,,2,3,5
,2011,70300648,,,,4,3,7
HND-006481,2011,70300651,,,,2,6,8
HND-006482,2011,70300655,,,,9,3,12
,2011,70300656,,,,18,12,30
,2011,70300658,,,,1,5,6
,2011,70300659,,,,6,2,8
,2011,70300661,,,,7,6,13
HND-006485,2011,70300665,,,,5,5,10
,2011,70300668,,,,2,3,5
,2011,70300669,,,,2,4,6
,2011,70300670,,,,2,4,6
,2011,70300671,,,,1,6,7
,2011,70300672,,,,8,2,10
HND-006487,2011,70300676,,,,4,3,7
,2011,70300684,,,,2,3,5
HND-006489,2011,70300688,,,,9,3,12
HND-006491,2011,70300690,,,,6,4,10
HND-006492,2011,70300692,,,,2,5,7
HND-006493,2011,70300693,,,,3,3,6
,2011,70300694,,,,4,1,5
,2011,70300696,,,,6,1,7
,2011,70300697,,,,3,2,5
,2011,70300701,,,,3,2,5
,2011,70300707,,,,6,4,10
,2011,70300711,,,,11,3,14
,2011,70300712,,,,13,7,20
,2011,70300713,,,,2,6,8
,2011,70300716,,,,4,4,8
,2011,70300717,,,,7,2,9
,2011,70300725,,,,1,8,9
,2011,70300731,,,,4,4,8
,2011,70300734,,,,3,4,7
HND-006502,2011,70300736,,,,8,7,15
,2011,70300737,,,,7,8,15
HND-006503,2011,70300738,,,,8,2,10
,2011,70300739,,,,5,4,9
,2011,70300740,,,,5,1,6
,2011,70300741,,,,4,3,7
,2011,70300742,,,,5,0,5
,2011,70300743,,,,7,4,11
,2011,70300744,,,,3,7,10
,2011,70300746,,,,4,7,11
,2011,70300747,,,,4,1,5
HND-006147,2011,70300038,,,,3,4,7
HND-006315,2011,70300237,,,,4,4,8
,2011,70300358,,,,7,5,12
HND-006405,2011,70300389,,,,5,2,7
HND-006426,2011,70300417,,,,2,5,7
,2011,70300563,,,,3,3,6
,2011,70300567,,,,3,4,7
,2011,70300575,,,,4,2,6
,2011,70300576,,,,3,4,7
,2011,70300578,,,,7,4,11
,2011,70300599,,,,3,3,6
,2011,70300605,,,,6,3,9
HND-006474,2011,70300611,,,,5,5,10
,2011,70300619,,,,4,2,6
,2011,70300625,,,,4,8,12
,2011,70300628,,,,3,5,8
,2011,70300629,,,,6,1,7
,2011,70300639,,,,2,3,5
,2011,70300640,,,,2,2,4
,2011,70300641,,,,5,4,9
,2011,70300643,,,,3,3,6
,2011,70300646,,,,7,2,9
,2011,70300650,,,,2,3,5
,2011,70300652,,,,8,5,13
,2011,70300653,,,,6,2,8
,2011,70300654,,,,2,4,6
HND-006483,2011,70300657,,,,3,2,5
,2011,70300660,,,,3,5,8
HND-006484,2011,70300662,,,,2,3,5
,2011,70300663,,,,4,0,4
,2011,70300664,,,,2,3,5
HND-006486,2011,70300666,,,,3,3,6
,2011,70300667,,,,2,4,6
,2011,70300678,,,,4,1,5
,2011,70300679,,,,9,6,15
,2011,70300680,,,,7,3,10
,2011,70300681,,,,4,2,6
,2011,70300682,,,,4,4,8
,2011,70300683,,,,3,6,9
,2011,70300687,,,,9,7,16
HND-006490,2011,70300689,,,,4,2,6
,2011,70300691,,,,2,3,5
,2011,70300695,,,,4,5,9
,2011,70300698,,,,2,3,5
,2011,70300699,,,,3,2,5
,2011,70300700,,,,3,2,5
HND-006494,2011,70300703,,,,7,6,13
,2011,70300704,,,,3,7,10
,2011,70300705,,,,7,3,10
,2011,70300708,,,,4,2,6
,2011,70300709,,,,4,8,12
,2011,70300710,,,,2,5,7
,2011,70300714,,,,1,5,6
HND-006495,2011,70300715,,,,6,5,11
,2011,70300718,,,,6,3,9
HND-006496,2011,70300719,,,,2,4,6
,2011,70300722,,,,5,3,8
HND-006497,2011,70300723,,,,3,2,5
HND-006498,2011,70300727,,,,13,9,22
,2011,70300728,,,,5,5,10
,2011,70300729,,,,4,4,8
,2011,70300735,,,,2,5,7
,2011,70300745,,,,3,6,9
,2011,70300288,,,,2,1,3
,2011,70300321,,,,2,0,2
,2011,70300336,,,,1,0,1
,2011,70300337,,,,10,4,14
HND-006387,2011,70300356,,,,2,0,2
HND-006402,2011,70300384,,,,10,12,22
,2011,70300541,,,,9,13,22
,2011,70300273,,,,13,2,15
,2011,70300341,,,,12,10,22
,2011,70300529,,,,2,2,4
,2011,70300537,,,,3,6,9
,2011,70300538,,,,2,0,2
HND-006444,2011,70300540,,,,0,4,4
,2011,70300633,,,,14,12,26
,2011,70300730,,,,7,3,10
,2011,70300748,,,,2,1,3
HND-006141,2011,70300031,,,,7,8,15
HND-006272,2011,70300181,,,,2,1,3
,2011,70300273,,,,12,12,24
HND-006341,2011,70300274,,,,3,1,4
,2011,70300275,,,,4,6,10
,2011,70300276,,,,6,5,11
HND-006344,2011,70300281,,,,4,4,8
HND-006348,2011,70300287,,,,1,5,6
HND-006350,2011,70300290,,,,0,1,1
HND-006354,2011,70300299,,,,1,2,3
HND-006355,2011,70300300,,,,9,8,17
HND-006356,2011,70300302,,,,3,0,3
HND-006361,2011,70300307,,,,5,2,7
HND-006369,2011,70300316,,,,3,3,6
,2011,70300318,,,,15,15,30
HND-006370,2011,70300319,,,,3,2,5
,2011,70300321,,,,2,2,4
,2011,70300328,,,,0,1,1
,2011,70300329,,,,3,0,3
HND-006376,2011,70300330,,,,2,3,5
,2011,70300333,,,,0,2,2
HND-006379,2011,70300340,,,,2,2,4
,2011,70300341,,,,8,15,23
HND-006382,2011,70300344,,,,9,12,21
HND-006387,2011,70300356,,,,8,2,10
HND-006398,2011,70300375,,,,2,1,3
,2011,70300376,,,,2,6,8
,2011,70300381,,,,3,4,7
,2011,70300523,,,,2,10,12
,2011,70300528,,,,2,5,7
HND-006440,2011,70300530,,,,2,3,5
,2011,70300537,,,,1,2,3
,2011,70300538,,,,0,1,1
,2011,70300541,,,,21,27,48
,2011,70300730,,,,3,5,8
HND-006270,2011,70300178,,,,2,4,6
HND-006342,2011,70300277,,,,17,19,36
,2011,70300278,,,,7,11,18
HND-006345,2011,70300282,,,,3,6,9
,2011,70300283,,,,3,3,6
HND-006346,2011,70300284,,,,17,11,28
,2011,70300288,,,,3,0,3
HND-006352,2011,70300295,,,,0,1,1
HND-006357,2011,70300303,,,,16,12,28
HND-006359,2011,70300305,,,,2,4,6
HND-006360,2011,70300306,,,,4,11,15
HND-006362,2011,70300308,,,,1,2,3
,2011,70300327,,,,1,1,2
,2011,70300332,,,,1,1,2
,2011,70300334,,,,0,2,2
,2011,70300335,,,,3,2,5
,2011,70300336,,,,4,5,9
,2011,70300337,,,,8,6,14
,2011,70300349,,,,1,0,1
,2011,70300359,,,,2,2,4
,2011,70300379,,,,2,1,3
HND-006400,2011,70300380,,,,35,38,73
HND-006402,2011,70300384,,,,11,10,21
,2011,70300385,,,,5,1,6
,2011,70300529,,,,14,21,35
,2011,70300536,,,,7,3,10
HND-006443,2011,70300539,,,,0,1,1
HND-006444,2011,70300540,,,,4,3,7
HND-006445,2011,70300543,,,,1,3,4
HND-006455,2011,70300555,,,,3,3,6
HND-006477,2011,70300631,,,,1,2,3
HND-006478,2011,70300632,,,,3,4,7
,2011,70300633,,,,11,12,23
,2011,70300748,,,,5,3,8
,2011,70300755,,,,4,1,5
HND-006270,2011,70300178,,,,6,2,8
HND-006342,2011,70300277,,,,67,75,142
,2011,70300278,,,,11,11,22
HND-006343,2011,70300280,,,,11,12,23
HND-006345,2011,70300282,,,,19,14,33
,2011,70300283,,,,11,4,15
HND-006346,2011,70300284,,,,15,18,33
,2011,70300288,,,,4,6,10
HND-006349,2011,70300289,,,,4,14,18
,2011,70300294,,,,6,15,21
HND-006352,2011,70300295,,,,5,11,16
HND-006357,2011,70300303,,,,33,36,69
HND-006358,2011,70300304,,,,7,12,19
HND-006359,2011,70300305,,,,15,13,28
HND-006360,2011,70300306,,,,22,19,41
HND-006362,2011,70300308,,,,19,18,37
HND-006372,2011,70300322,,,,10,16,26
,2011,70300327,,,,8,7,15
HND-006377,2011,70300331,,,,6,7,13
,2011,70300332,,,,4,5,9
,2011,70300334,,,,6,9,15
,2011,70300335,,,,4,6,10
,2011,70300336,,,,5,7,12
,2011,70300337,,,,14,9,23
HND-006378,2011,70300339,,,,6,5,11
,2011,70300349,,,,3,4,7
,2011,70300359,,,,8,10,18
HND-006392,2011,70300363,,,,9,7,16
HND-006395,2011,70300371,,,,6,8,14
HND-006400,2011,70300380,,,,124,103,227
,2011,70300385,,,,4,7,11
,2011,70300528,,,,3,7,10
,2011,70300529,,,,17,16,33
,2011,70300536,,,,3,5,8
HND-006444,2011,70300540,,,,4,1,5
HND-006445,2011,70300543,,,,4,8,12
HND-006455,2011,70300555,,,,6,4,10
HND-006477,2011,70300631,,,,12,5,17
HND-006478,2011,70300632,,,,9,7,16
,2011,70300633,,,,7,5,12
,2011,70300748,,,,1,6,7
,2011,70300754,,,,2,3,5
,2011,70300755,,,,3,1,4
HND-006141,2011,70300031,,,,21,17,38
HND-006272,2011,70300181,,,,7,11,18
,2011,70300273,,,,31,26,57
HND-006341,2011,70300274,,,,33,30,63
,2011,70300275,,,,21,24,45
,2011,70300276,,,,11,11,22
HND-006344,2011,70300281,,,,16,20,36
HND-006347,2011,70300285,,,,11,23,34
,2011,70300286,,,,11,10,21
HND-006348,2011,70300287,,,,12,16,28
HND-006350,2011,70300290,,,,20,12,32
HND-006351,2011,70300291,,,,9,7,16
,2011,70300292,,,,6,5,11
,2011,70300293,,,,11,9,20
HND-006354,2011,70300299,,,,15,14,29
HND-006355,2011,70300300,,,,29,47,76
HND-006356,2011,70300302,,,,6,9,15
HND-006361,2011,70300307,,,,12,14,26
HND-006368,2011,70300315,,,,9,15,24
HND-006369,2011,70300316,,,,3,1,4
,2011,70300318,,,,63,45,108
HND-006370,2011,70300319,,,,10,3,13
HND-006371,2011,70300320,,,,7,7,14
,2011,70300321,,,,3,5,8
,2011,70300328,,,,5,7,12
,2011,70300329,,,,8,11,19
HND-006376,2011,70300330,,,,6,4,10
,2011,70300333,,,,6,9,15
HND-006379,2011,70300340,,,,4,1,5
,2011,70300341,,,,9,20,29
HND-006382,2011,70300344,,,,20,19,39
HND-006387,2011,70300356,,,,15,7,22
,2011,70300364,,,,14,12,26
HND-006398,2011,70300375,,,,6,6,12
,2011,70300376,,,,6,3,9
,2011,70300379,,,,10,9,19
,2011,70300381,,,,7,8,15
HND-006402,2011,70300384,,,,19,11,30
HND-006404,2011,70300388,,,,14,5,19
,2011,70300523,,,,6,1,7
HND-006440,2011,70300530,,,,8,15,23
,2011,70300537,,,,1,2,3
,2011,70300538,,,,9,4,13
HND-006443,2011,70300539,,,,18,6,24
,2011,70300636,,,,9,4,13
,2011,70300730,,,,9,6,15
,2011,70300753,,,,0,5,5
HND-006117,2011,70300005,,,,3,3,6
HND-006118,2011,70300006,,,,9,6,15
HND-006122,2011,70300011,,,,35,30,65
HND-006125,2011,70300014,,,,10,8,18
HND-006126,2011,70300015,,,,8,4,12
HND-006127,2011,70300017,,,,32,22,54
HND-006129,2011,70300019,,,,41,26,67
HND-006130,2011,70300020,,,,9,9,18
HND-006131,2011,70300021,,,,17,15,32
HND-006132,2011,70300022,,,,4,1,5
HND-006133,2011,70300023,,,,2,2,4
HND-006136,2011,70300026,,,,81,80,161
HND-006139,2011,70300029,,,,6,4,10
HND-006141,2011,70300031,,,,53,51,104
HND-006144,2011,70300035,,,,27,21,48
HND-006145,2011,70300036,,,,4,6,10
HND-006146,2011,70300037,,,,8,14,22
HND-006149,2011,70300041,,,,7,14,21
HND-006153,2011,70300045,,,,3,3,6
,2011,70300046,,,,2,3,5
HND-006155,2011,70300048,,,,5,10,15
HND-006157,2011,70300050,,,,3,1,4
HND-006159,2011,70300052,,,,3,2,5
HND-006160,2011,70300053,,,,7,8,15
HND-006161,2011,70300054,,,,16,12,28
HND-006162,2011,70300056,,,,38,44,82
HND-006165,2011,70300059,,,,18,12,30
HND-006166,2011,70300060,,,,3,1,4
HND-006167,2011,70300061,,,,3,3,6
HND-006168,2011,70300062,,,,25,28,53
HND-006174,2011,70300069,,,,4,5,9
HND-006179,2011,70300075,,,,11,9,20
HND-006180,2011,70300076,,,,26,18,44
HND-006181,2011,70300077,,,,25,20,45
HND-006188,2011,70300084,,,,6,1,7
HND-006189,2011,70300085,,,,3,5,8
HND-006190,2011,70300086,,,,4,4,8
HND-006191,2011,70300087,,,,9,2,11
HND-006192,2011,70300088,,,,131,132,263
HND-006195,2011,70300092,,,,6,7,13
HND-006197,2011,70300094,,,,23,21,44
HND-006199,2011,70300096,,,,8,12,20
HND-006200,2011,70300097,,,,26,22,48
HND-006201,2011,70300098,,,,42,44,86
HND-006203,2011,70300100,,,,24,24,48
HND-006205,2011,70300102,,,,5,8,13
HND-006206,2011,70300105,,,,5,6,11
HND-006207,2011,70300106,,,,4,0,4
HND-006208,2011,70300107,,,,4,6,10
,2011,70300111,,,,5,6,11
HND-006214,2011,70300114,,,,47,43,90
HND-006215,2011,70300115,,,,47,31,78
HND-006216,2011,70300116,,,,10,5,15
HND-006217,2011,70300117,,,,4,7,11
HND-006220,2011,70300120,,,,9,5,14
HND-006221,2011,70300121,,,,10,13,23
HND-006222,2011,70300122,,,,27,23,50
HND-006224,2011,70300125,,,,8,3,11
HND-006225,2011,70300126,,,,7,5,12
HND-006226,2011,70300127,,,,12,4,16
HND-006227,2011,70300128,,,,6,7,13
HND-006229,2011,70300130,,,,5,5,10
HND-006230,2011,70300131,,,,6,6,12
HND-006231,2011,70300132,,,,2,5,7
HND-006233,2011,70300134,,,,40,48,88
HND-006234,2011,70300135,,,,18,16,34
HND-006235,2011,70300136,,,,8,13,21
HND-006236,2011,70300137,,,,7,8,15
HND-006238,2011,70300140,,,,19,5,24
HND-006240,2011,70300142,,,,15,12,27
HND-006241,2011,70300143,,,,5,0,5
HND-006243,2011,70300145,,,,16,17,33
HND-006244,2011,70300146,,,,8,2,10
HND-006246,2011,70300148,,,,15,15,30
HND-006248,2011,70300150,,,,13,10,23
HND-006249,2011,70300151,,,,16,13,29
HND-006252,2011,70300154,,,,4,2,6
HND-006253,2011,70300155,,,,32,28,60
HND-006254,2011,70300156,,,,6,6,12
HND-006255,2011,70300157,,,,3,4,7
HND-006258,2011,70300161,,,,0,1,1
HND-006261,2011,70300164,,,,7,3,10
HND-006263,2011,70300166,,,,4,3,7
HND-006264,2011,70300167,,,,9,5,14
HND-006268,2011,70300176,,,,4,6,10
HND-006269,2011,70300177,,,,15,21,36
HND-006273,2011,70300182,,,,0,1,1
HND-006279,2011,70300188,,,,5,6,11
HND-006280,2011,70300190,,,,2,2,4
HND-006282,2011,70300195,,,,9,10,19
HND-006283,2011,70300198,,,,67,57,124
HND-006286,2011,70300201,,,,2,7,9
HND-006289,2011,70300205,,,,13,5,18
HND-006290,2011,70300206,,,,6,13,19
HND-006291,2011,70300207,,,,7,11,18
HND-006292,2011,70300208,,,,4,3,7
HND-006299,2011,70300215,,,,4,4,8
HND-006300,2011,70300216,,,,7,6,13
HND-006301,2011,70300217,,,,8,6,14
HND-006302,2011,70300218,,,,5,4,9
HND-006304,2011,70300220,,,,6,5,11
HND-006305,2011,70300221,,,,0,2,2
HND-006306,2011,70300222,,,,2,0,2
HND-006307,2011,70300223,,,,11,9,20
HND-006311,2011,70300229,,,,5,3,8
HND-006313,2011,70300235,,,,4,5,9
HND-006314,2011,70300236,,,,7,6,13
HND-006315,2011,70300237,,,,10,4,14
HND-006321,2011,70300245,,,,4,4,8
HND-006322,2011,70300246,,,,17,13,30
,2011,70300247,,,,5,3,8
HND-006326,2011,70300250,,,,4,5,9
HND-006327,2011,70300251,,,,1,3,4
,2011,70300252,,,,8,11,19
HND-006328,2011,70300253,,,,2,1,3
HND-006330,2011,70300255,,,,3,3,6
HND-006331,2011,70300256,,,,10,5,15
HND-006333,2011,70300258,,,,4,0,4
HND-006334,2011,70300259,,,,5,0,5
HND-006336,2011,70300262,,,,5,7,12
HND-006337,2011,70300264,,,,3,7,10
HND-006338,2011,70300265,,,,3,4,7
HND-006339,2011,70300267,,,,1,6,7
HND-006352,2011,70300295,,,,12,7,19
,2011,70300298,,,,16,11,27
HND-006363,2011,70300309,,,,23,26,49
HND-006373,2011,70300324,,,,11,5,16
HND-006374,2011,70300325,,,,2,1,3
HND-006375,2011,70300326,,,,1,4,5
HND-006379,2011,70300340,,,,6,5,11
HND-006383,2011,70300345,,,,12,10,22
HND-006384,2011,70300347,,,,5,1,6
HND-006391,2011,70300362,,,,4,6,10
HND-006394,2011,70300368,,,,4,5,9
HND-006397,2011,70300374,,,,7,3,10
HND-006405,2011,70300389,,,,5,7,12
HND-006407,2011,70300392,,,,8,4,12
HND-006408,2011,70300393,,,,4,0,4
HND-006409,2011,70300394,,,,4,2,6
HND-006410,2011,70300396,,,,9,11,20
HND-006411,2011,70300397,,,,4,7,11
,2011,70300402,,,,2,2,4
HND-006415,2011,70300404,,,,7,9,16
HND-006416,2011,70300405,,,,5,6,11
,2011,70300409,,,,8,4,12
HND-006421,2011,70300410,,,,4,0,4
HND-006423,2011,70300413,,,,9,7,16
HND-006425,2011,70300416,,,,11,7,18
HND-006427,2011,70300418,,,,4,5,9
HND-006428,2011,70300419,,,,1,3,4
HND-006429,2011,70300420,,,,5,3,8
HND-006433,2011,70300430,,,,5,3,8
HND-006436,2011,70300518,,,,0,3,3
HND-006437,2011,70300520,,,,5,6,11
HND-006438,2011,70300524,,,,4,5,9
,2011,70300526,,,,4,5,9
HND-006439,2011,70300527,,,,1,1,2
,2011,70300528,,,,4,5,9
HND-006442,2011,70300533,,,,7,3,10
,2011,70300541,,,,4,7,11
HND-006447,2011,70300545,,,,10,7,17
HND-006448,2011,70300546,,,,4,6,10
HND-006451,2011,70300550,,,,4,4,8
HND-006456,2011,70300557,,,,10,9,19
HND-006457,2011,70300558,,,,5,5,10
HND-006460,2011,70300580,,,,3,0,3
HND-006461,2011,70300581,,,,3,1,4
HND-006463,2011,70300584,,,,3,2,5
HND-006464,2011,70300585,,,,1,5,6
HND-006466,2011,70300588,,,,4,2,6
HND-006469,2011,70300591,,,,2,2,4
HND-006504,2011,70300749,,,,1,1,2
HND-006115,2011,70300002,,,,7,7,14
HND-006116,2011,70300004,,,,3,3,6
HND-006119,2011,70300007,,,,3,3,6
HND-006120,2011,70300009,,,,4,2,6
HND-006121,2011,70300010,,,,6,4,10
HND-006123,2011,70300012,,,,12,21,33
HND-006124,2011,70300013,,,,10,5,15
HND-006128,2011,70300018,,,,7,4,11
HND-006134,2011,70300024,,,,9,7,16
HND-006135,2011,70300025,,,,11,9,20
HND-006137,2011,70300027,,,,5,3,8
HND-006138,2011,70300028,,,,5,8,13
HND-006140,2011,70300030,,,,5,4,9
HND-006142,2011,70300032,,,,12,12,24
HND-006143,2011,70300034,,,,74,53,127
HND-006147,2011,70300038,,,,7,7,14
HND-006148,2011,70300040,,,,1,3,4
HND-006150,2011,70300042,,,,6,8,14
HND-006151,2011,70300043,,,,7,5,12
HND-006152,2011,70300044,,,,5,4,9
HND-006156,2011,70300049,,,,10,9,19
HND-006158,2011,70300051,,,,4,5,9
HND-006163,2011,70300057,,,,4,2,6
HND-006164,2011,70300058,,,,2,4,6
HND-006169,2011,70300064,,,,3,4,7
HND-006170,2011,70300065,,,,7,4,11
HND-006171,2011,70300066,,,,7,9,16
HND-006172,2011,70300067,,,,8,4,12
HND-006173,2011,70300068,,,,29,12,41
HND-006175,2011,70300070,,,,11,9,20
HND-006176,2011,70300071,,,,10,3,13
HND-006177,2011,70300072,,,,13,11,24
HND-006178,2011,70300073,,,,2,3,5
HND-006182,2011,70300078,,,,4,4,8
HND-006183,2011,70300079,,,,25,15,40
HND-006184,2011,70300080,,,,5,3,8
HND-006185,2011,70300081,,,,20,20,40
HND-006186,2011,70300082,,,,6,2,8
HND-006187,2011,70300083,,,,6,4,10
HND-006193,2011,70300089,,,,11,7,18
HND-006194,2011,70300091,,,,13,7,20
HND-006196,2011,70300093,,,,29,18,47
HND-006198,2011,70300095,,,,6,4,10
HND-006202,2011,70300099,,,,5,2,7
HND-006204,2011,70300101,,,,77,73,150
HND-006209,2011,70300109,,,,8,11,19
HND-006210,2011,70300110,,,,13,5,18
HND-006212,2011,70300112,,,,12,4,16
HND-006213,2011,70300113,,,,24,26,50
HND-006218,2011,70300118,,,,13,10,23
HND-006219,2011,70300119,,,,7,5,12
HND-006223,2011,70300124,,,,9,9,18
HND-006228,2011,70300129,,,,15,14,29
HND-006232,2011,70300133,,,,14,5,19
HND-006237,2011,70300139,,,,4,5,9
HND-006239,2011,70300141,,,,8,5,13
HND-006242,2011,70300144,,,,11,3,14
HND-006245,2011,70300147,,,,11,12,23
HND-006247,2011,70300149,,,,4,1,5
HND-006250,2011,70300152,,,,7,5,12
HND-006251,2011,70300153,,,,26,22,48
HND-006256,2011,70300158,,,,5,4,9
HND-006257,2011,70300159,,,,17,11,28
HND-006259,2011,70300162,,,,2,1,3
HND-006260,2011,70300163,,,,9,9,18
HND-006262,2011,70300165,,,,8,6,14
HND-006265,2011,70300168,,,,14,13,27
HND-006266,2011,70300169,,,,3,3,6
HND-006267,2011,70300173,,,,7,1,8
HND-006270,2011,70300178,,,,13,4,17
HND-006271,2011,70300179,,,,4,5,9
HND-006272,2011,70300181,,,,5,2,7
HND-006275,2011,70300184,,,,1,2,3
HND-006276,2011,70300185,,,,1,5,6
HND-006277,2011,70300186,,,,6,4,10
HND-006278,2011,70300187,,,,3,12,15
HND-006281,2011,70300193,,,,7,6,13
HND-006284,2011,70300199,,,,8,17,25
HND-006285,2011,70300200,,,,17,8,25
HND-006287,2011,70300203,,,,7,8,15
HND-006288,2011,70300204,,,,1,2,3
HND-006293,2011,70300209,,,,1,1,2
HND-006294,2011,70300210,,,,4,1,5
HND-006295,2011,70300211,,,,6,4,10
HND-006296,2011,70300212,,,,2,4,6
HND-006297,2011,70300213,,,,10,15,25
HND-006298,2011,70300214,,,,6,4,10
HND-006303,2011,70300219,,,,19,4,23
HND-006308,2011,70300224,,,,2,0,2
HND-006309,2011,70300226,,,,10,16,26
HND-006310,2011,70300227,,,,1,1,2
HND-006312,2011,70300231,,,,7,9,16
HND-006316,2011,70300238,,,,15,4,19
,2011,70300239,,,,4,10,14
HND-006318,2011,70300240,,,,12,10,22
HND-006319,2011,70300242,,,,1,1,2
HND-006320,2011,70300243,,,,8,7,15
HND-006324,2011,70300248,,,,5,4,9
HND-006325,2011,70300249,,,,9,1,10
HND-006329,2011,70300254,,,,4,5,9
HND-006332,2011,70300257,,,,10,4,14
,2011,70300260,,,,10,4,14
HND-006335,2011,70300261,,,,2,2,4
HND-006340,2011,70300271,,,,10,5,15
HND-006353,2011,70300297,,,,11,2,13
HND-006380,2011,70300342,,,,6,6,12
HND-006381,2011,70300343,,,,8,8,16
HND-006385,2011,70300353,,,,1,0,1
HND-006386,2011,70300355,,,,3,3,6
HND-006389,2011,70300360,,,,2,4,6
HND-006390,2011,70300361,,,,9,8,17
HND-006393,2011,70300367,,,,7,6,13
,2011,70300390,,,,6,7,13
HND-006412,2011,70300398,,,,3,2,5
HND-006413,2011,70300401,,,,2,0,2
HND-006414,2011,70300403,,,,11,2,13
HND-006417,2011,70300406,,,,2,3,5
HND-006418,2011,70300407,,,,4,5,9
HND-006426,2011,70300417,,,,1,2,3
HND-006432,2011,70300427,,,,6,8,14
,2011,70300438,,,,2,0,2
,2011,70300529,,,,25,15,40
HND-006441,2011,70300531,,,,7,5,12
,2011,70300532,,,,6,8,14
HND-006446,2011,70300544,,,,1,4,5
HND-006449,2011,70300547,,,,10,9,19
HND-006450,2011,70300548,,,,11,7,18
HND-006453,2011,70300552,,,,5,4,9
HND-006454,2011,70300553,,,,13,12,25
HND-006458,2011,70300559,,,,5,4,9
HND-006459,2011,70300560,,,,4,2,6
HND-006462,2011,70300583,,,,9,8,17
HND-006465,2011,70300587,,,,6,8,14
HND-006467,2011,70300589,,,,1,2,3
HND-006468,2011,70300590,,,,6,6,12
,2011,70300592,,,,7,2,9
,2011,70300633,,,,2,1,3
HND-006499,2011,70300732,,,,1,0,1
HND-006505,2011,70300750,,,,5,4,9
HND-006506,2011,70300751,,,,4,4,8
HND-006507,2011,70300752,,,,6,6,12
HND-006115,2011,70300002,,,,3,3,6
HND-006116,2011,70300004,,,,4,4,8
HND-006120,2011,70300009,,,,5,8,13
HND-006121,2011,70300010,,,,3,1,4
HND-006126,2011,70300015,,,,2,5,7
HND-006128,2011,70300018,,,,6,5,11
HND-006129,2011,70300019,,,,38,25,63
HND-006132,2011,70300022,,,,2,1,3
HND-006134,2011,70300024,,,,8,11,19
HND-006135,2011,70300025,,,,4,6,10
HND-006136,2011,70300026,,,,55,55,110
HND-006137,2011,70300027,,,,1,5,6
HND-006140,2011,70300030,,,,6,2,8
HND-006143,2011,70300034,,,,55,63,118
HND-006144,2011,70300035,,,,16,19,35
HND-006145,2011,70300036,,,,5,4,9
HND-006147,2011,70300038,,,,4,7,11
HND-006148,2011,70300040,,,,7,3,10
HND-006149,2011,70300041,,,,10,11,21
HND-006150,2011,70300042,,,,6,8,14
HND-006151,2011,70300043,,,,3,6,9
HND-006155,2011,70300048,,,,5,5,10
HND-006156,2011,70300049,,,,7,12,19
HND-006161,2011,70300054,,,,14,16,30
HND-006163,2011,70300057,,,,4,1,5
HND-006168,2011,70300062,,,,38,23,61
HND-006169,2011,70300064,,,,5,3,8
HND-006172,2011,70300067,,,,4,7,11
HND-006173,2011,70300068,,,,12,14,26
HND-006174,2011,70300069,,,,3,4,7
HND-006176,2011,70300071,,,,7,1,8
HND-006179,2011,70300075,,,,9,10,19
HND-006180,2011,70300076,,,,12,21,33
HND-006181,2011,70300077,,,,26,15,41
HND-006182,2011,70300078,,,,10,6,16
HND-006183,2011,70300079,,,,20,18,38
HND-006184,2011,70300080,,,,5,6,11
HND-006185,2011,70300081,,,,9,8,17
HND-006189,2011,70300085,,,,7,2,9
HND-006190,2011,70300086,,,,8,4,12
HND-006194,2011,70300091,,,,5,1,6
HND-006198,2011,70300095,,,,6,8,14
HND-006199,2011,70300096,,,,8,10,18
HND-006200,2011,70300097,,,,24,22,46
HND-006201,2011,70300098,,,,30,21,51
HND-006203,2011,70300100,,,,30,19,49
HND-006204,2011,70300101,,,,68,73,141
HND-006205,2011,70300102,,,,8,2,10
HND-006209,2011,70300109,,,,4,4,8
HND-006210,2011,70300110,,,,8,7,15
,2011,70300111,,,,12,12,24
HND-006212,2011,70300112,,,,8,7,15
HND-006215,2011,70300115,,,,56,48,104
HND-006216,2011,70300116,,,,5,4,9
HND-006217,2011,70300117,,,,7,9,16
HND-006218,2011,70300118,,,,16,6,22
HND-006220,2011,70300120,,,,4,2,6
HND-006222,2011,70300122,,,,21,16,37
HND-006227,2011,70300128,,,,5,8,13
HND-006228,2011,70300129,,,,15,8,23
HND-006229,2011,70300130,,,,5,2,7
HND-006231,2011,70300132,,,,4,3,7
HND-006232,2011,70300133,,,,5,3,8
HND-006234,2011,70300135,,,,19,14,33
HND-006237,2011,70300139,,,,4,4,8
HND-006241,2011,70300143,,,,2,6,8
HND-006242,2011,70300144,,,,3,11,14
HND-006247,2011,70300149,,,,3,4,7
HND-006248,2011,70300150,,,,10,7,17
HND-006250,2011,70300152,,,,4,6,10
HND-006253,2011,70300155,,,,18,21,39
HND-006254,2011,70300156,,,,5,6,11
HND-006256,2011,70300158,,,,5,1,6
HND-006258,2011,70300161,,,,5,0,5
HND-006259,2011,70300162,,,,2,0,2
HND-006262,2011,70300165,,,,4,6,10
HND-006263,2011,70300166,,,,12,7,19
HND-006264,2011,70300167,,,,6,5,11
HND-006265,2011,70300168,,,,8,7,15
HND-006268,2011,70300176,,,,8,6,14
HND-006269,2011,70300177,,,,15,22,37
HND-006270,2011,70300178,,,,15,13,28
HND-006275,2011,70300184,,,,2,2,4
HND-006280,2011,70300190,,,,3,1,4
HND-006281,2011,70300193,,,,5,2,7
HND-006282,2011,70300195,,,,6,10,16
HND-006285,2011,70300200,,,,7,3,10
HND-006286,2011,70300201,,,,8,6,14
HND-006287,2011,70300203,,,,4,3,7
HND-006292,2011,70300208,,,,4,1,5
HND-006293,2011,70300209,,,,4,7,11
HND-006294,2011,70300210,,,,5,5,10
HND-006295,2011,70300211,,,,9,7,16
HND-006297,2011,70300213,,,,15,12,27
HND-006302,2011,70300218,,,,4,6,10
HND-006303,2011,70300219,,,,10,14,24
HND-006304,2011,70300220,,,,3,5,8
HND-006306,2011,70300222,,,,5,6,11
HND-006307,2011,70300223,,,,9,8,17
HND-006308,2011,70300224,,,,1,0,1
HND-006309,2011,70300226,,,,18,9,27
HND-006311,2011,70300229,,,,2,2,4
HND-006315,2011,70300237,,,,3,2,5
,2011,70300239,,,,3,5,8
HND-006318,2011,70300240,,,,9,7,16
HND-006319,2011,70300242,,,,2,0,2
HND-006320,2011,70300243,,,,6,4,10
HND-006325,2011,70300249,,,,2,2,4
,2011,70300252,,,,8,8,16
HND-006330,2011,70300255,,,,2,8,10
HND-006331,2011,70300256,,,,3,11,14
HND-006332,2011,70300257,,,,5,1,6
HND-006333,2011,70300258,,,,2,1,3
HND-006335,2011,70300261,,,,2,3,5
HND-006338,2011,70300265,,,,2,3,5
HND-006339,2011,70300267,,,,2,0,2
HND-006340,2011,70300271,,,,13,18,31
HND-006352,2011,70300295,,,,14,6,20
HND-006353,2011,70300297,,,,4,6,10
,2011,70300298,,,,14,9,23
HND-006363,2011,70300309,,,,32,27,59
HND-006374,2011,70300325,,,,5,0,5
HND-006375,2011,70300326,,,,1,2,3
HND-006380,2011,70300342,,,,6,3,9
HND-006381,2011,70300343,,,,5,3,8
HND-006383,2011,70300345,,,,3,4,7
HND-006385,2011,70300353,,,,2,3,5
HND-006390,2011,70300361,,,,4,5,9
HND-006391,2011,70300362,,,,3,2,5
HND-006393,2011,70300367,,,,6,12,18
HND-006397,2011,70300374,,,,14,8,22
HND-006405,2011,70300389,,,,2,4,6
,2011,70300390,,,,6,9,15
HND-006417,2011,70300406,,,,6,5,11
,2011,70300409,,,,11,15,26
HND-006421,2011,70300410,,,,7,0,7
HND-006424,2011,70300415,,,,3,3,6
HND-006425,2011,70300416,,,,2,5,7
HND-006426,2011,70300417,,,,2,4,6
HND-006427,2011,70300418,,,,6,8,14
HND-006428,2011,70300419,,,,2,3,5
HND-006432,2011,70300427,,,,9,6,15
HND-006433,2011,70300430,,,,6,5,11
,2011,70300438,,,,1,2,3
HND-006437,2011,70300520,,,,4,6,10
HND-006438,2011,70300524,,,,5,5,10
,2011,70300526,,,,2,2,4
HND-006439,2011,70300527,,,,2,1,3
,2011,70300528,,,,2,2,4
,2011,70300529,,,,23,15,38
HND-006449,2011,70300547,,,,12,6,18
HND-006453,2011,70300552,,,,4,3,7
HND-006457,2011,70300558,,,,7,3,10
HND-006458,2011,70300559,,,,5,3,8
HND-006459,2011,70300560,,,,5,5,10
HND-006464,2011,70300585,,,,2,1,3
HND-006467,2011,70300589,,,,5,3,8
HND-006469,2011,70300591,,,,1,3,4
,2011,70300592,,,,1,1,2
HND-006504,2011,70300749,,,,7,4,11
HND-006507,2011,70300752,,,,2,0,2
HND-006117,2011,70300005,,,,2,2,4
HND-006118,2011,70300006,,,,4,12,16
HND-006119,2011,70300007,,,,3,7,10
HND-006122,2011,70300011,,,,22,24,46
HND-006123,2011,70300012,,,,18,9,27
HND-006124,2011,70300013,,,,6,8,14
HND-006125,2011,70300014,,,,5,4,9
HND-006127,2011,70300017,,,,14,18,32
HND-006130,2011,70300020,,,,6,9,15
HND-006131,2011,70300021,,,,14,12,26
HND-006133,2011,70300023,,,,6,2,8
HND-006138,2011,70300028,,,,3,4,7
HND-006139,2011,70300029,,,,5,5,10
HND-006141,2011,70300031,,,,63,57,120
HND-006142,2011,70300032,,,,7,7,14
HND-006146,2011,70300037,,,,9,11,20
HND-006152,2011,70300044,,,,6,2,8
HND-006153,2011,70300045,,,,5,4,9
,2011,70300046,,,,1,2,3
HND-006157,2011,70300050,,,,6,5,11
HND-006158,2011,70300051,,,,6,4,10
HND-006159,2011,70300052,,,,2,2,4
HND-006160,2011,70300053,,,,4,4,8
HND-006162,2011,70300056,,,,29,25,54
HND-006164,2011,70300058,,,,2,1,3
HND-006165,2011,70300059,,,,11,11,22
HND-006166,2011,70300060,,,,1,1,2
HND-006170,2011,70300065,,,,5,3,8
HND-006171,2011,70300066,,,,6,8,14
HND-006175,2011,70300070,,,,4,7,11
HND-006177,2011,70300072,,,,5,7,12
HND-006178,2011,70300073,,,,3,4,7
HND-006186,2011,70300082,,,,2,4,6
HND-006187,2011,70300083,,,,6,2,8
HND-006188,2011,70300084,,,,5,4,9
HND-006191,2011,70300087,,,,5,1,6
HND-006192,2011,70300088,,,,134,134,268
HND-006193,2011,70300089,,,,8,4,12
HND-006195,2011,70300092,,,,11,15,26
HND-006196,2011,70300093,,,,17,9,26
HND-006197,2011,70300094,,,,26,17,43
HND-006202,2011,70300099,,,,6,12,18
HND-006206,2011,70300105,,,,5,4,9
HND-006207,2011,70300106,,,,2,4,6
HND-006208,2011,70300107,,,,6,4,10
HND-006213,2011,70300113,,,,16,14,30
HND-006214,2011,70300114,,,,25,27,52
HND-006219,2011,70300119,,,,5,3,8
HND-006221,2011,70300121,,,,18,8,26
HND-006223,2011,70300124,,,,12,10,22
HND-006224,2011,70300125,,,,5,8,13
HND-006225,2011,70300126,,,,4,4,8
HND-006226,2011,70300127,,,,12,11,23
HND-006230,2011,70300131,,,,7,2,9
HND-006233,2011,70300134,,,,45,52,97
HND-006235,2011,70300136,,,,8,10,18
HND-006236,2011,70300137,,,,5,8,13
HND-006238,2011,70300140,,,,9,8,17
HND-006239,2011,70300141,,,,7,3,10
HND-006240,2011,70300142,,,,17,16,33
HND-006243,2011,70300145,,,,18,12,30
HND-006244,2011,70300146,,,,5,3,8
HND-006245,2011,70300147,,,,18,9,27
HND-006246,2011,70300148,,,,16,9,25
HND-006249,2011,70300151,,,,4,10,14
HND-006251,2011,70300153,,,,14,14,28
HND-006252,2011,70300154,,,,3,9,12
HND-006255,2011,70300157,,,,4,3,7
HND-006257,2011,70300159,,,,20,9,29
HND-006260,2011,70300163,,,,9,8,17
HND-006261,2011,70300164,,,,9,9,18
HND-006266,2011,70300169,,,,9,1,10
HND-006267,2011,70300173,,,,5,5,10
HND-006271,2011,70300179,,,,2,1,3
HND-006272,2011,70300181,,,,9,3,12
HND-006273,2011,70300182,,,,2,3,5
HND-006276,2011,70300185,,,,4,1,5
HND-006277,2011,70300186,,,,7,4,11
HND-006278,2011,70300187,,,,8,4,12
HND-006279,2011,70300188,,,,4,6,10
HND-006283,2011,70300198,,,,57,52,109
HND-006284,2011,70300199,,,,8,12,20
HND-006288,2011,70300204,,,,4,1,5
HND-006289,2011,70300205,,,,5,3,8
HND-006290,2011,70300206,,,,7,9,16
HND-006291,2011,70300207,,,,5,4,9
HND-006296,2011,70300212,,,,12,10,22
HND-006298,2011,70300214,,,,1,2,3
HND-006299,2011,70300215,,,,4,3,7
HND-006300,2011,70300216,,,,3,6,9
HND-006301,2011,70300217,,,,7,5,12
HND-006305,2011,70300221,,,,4,1,5
HND-006310,2011,70300227,,,,2,2,4
HND-006312,2011,70300231,,,,9,5,14
HND-006314,2011,70300236,,,,5,8,13
HND-006316,2011,70300238,,,,1,3,4
HND-006321,2011,70300245,,,,3,6,9
HND-006322,2011,70300246,,,,14,8,22
,2011,70300247,,,,4,2,6
HND-006324,2011,70300248,,,,1,1,2
HND-006326,2011,70300250,,,,8,5,13
HND-006328,2011,70300253,,,,14,3,17
HND-006329,2011,70300254,,,,2,1,3
HND-006334,2011,70300259,,,,6,1,7
,2011,70300260,,,,7,4,11
HND-006336,2011,70300262,,,,9,3,12
HND-006337,2011,70300264,,,,6,7,13
HND-006373,2011,70300324,,,,11,5,16
HND-006379,2011,70300340,,,,7,8,15
HND-006384,2011,70300347,,,,8,8,16
HND-006386,2011,70300355,,,,6,5,11
HND-006389,2011,70300360,,,,1,0,1
HND-006394,2011,70300368,,,,2,4,6
HND-006407,2011,70300392,,,,1,1,2
HND-006408,2011,70300393,,,,4,1,5
HND-006409,2011,70300394,,,,4,4,8
HND-006410,2011,70300396,,,,9,4,13
HND-006411,2011,70300397,,,,3,3,6
HND-006412,2011,70300398,,,,3,2,5
HND-006413,2011,70300401,,,,2,3,5
,2011,70300402,,,,2,1,3
HND-006414,2011,70300403,,,,12,3,15
HND-006415,2011,70300404,,,,10,6,16
HND-006416,2011,70300405,,,,3,7,10
HND-006418,2011,70300407,,,,4,6,10
HND-006423,2011,70300413,,,,2,3,5
HND-006429,2011,70300420,,,,3,4,7
HND-006436,2011,70300518,,,,1,0,1
HND-006441,2011,70300531,,,,7,6,13
,2011,70300532,,,,6,6,12
HND-006442,2011,70300533,,,,2,3,5
HND-006446,2011,70300544,,,,9,2,11
HND-006447,2011,70300545,,,,7,4,11
HND-006448,2011,70300546,,,,3,3,6
HND-006450,2011,70300548,,,,7,16,23
HND-006451,2011,70300550,,,,1,0,1
HND-006454,2011,70300553,,,,7,6,13
HND-006456,2011,70300557,,,,2,8,10
HND-006460,2011,70300580,,,,0,3,3
HND-006461,2011,70300581,,,,3,4,7
HND-006462,2011,70300583,,,,4,3,7
HND-006463,2011,70300584,,,,4,4,8
HND-006465,2011,70300587,,,,1,3,4
HND-006466,2011,70300588,,,,5,2,7
HND-006468,2011,70300590,,,,6,5,11
HND-006471,2011,70300593,,,,1,1,2
HND-006499,2011,70300732,,,,1,0,1
HND-006505,2011,70300750,,,,2,3,5
HND-006506,2011,70300751,,,,1,4,5
HND-006115,2011,70300002,,,,8,3,11
HND-006116,2011,70300004,,,,4,1,5
HND-006119,2011,70300007,,,,4,1,5
HND-006120,2011,70300009,,,,3,0,3
HND-006121,2011,70300010,,,,5,2,7
HND-006123,2011,70300012,,,,19,13,32
HND-006124,2011,70300013,,,,8,8,16
HND-006128,2011,70300018,,,,5,6,11
HND-006134,2011,70300024,,,,5,5,10
HND-006135,2011,70300025,,,,10,4,14
HND-006137,2011,70300027,,,,2,2,4
HND-006140,2011,70300030,,,,5,7,12
HND-006142,2011,70300032,,,,12,8,20
HND-006143,2011,70300034,,,,65,57,122
HND-006147,2011,70300038,,,,3,6,9
HND-006148,2011,70300040,,,,5,1,6
HND-006150,2011,70300042,,,,5,14,19
HND-006151,2011,70300043,,,,1,4,5
HND-006152,2011,70300044,,,,4,5,9
HND-006156,2011,70300049,,,,7,9,16
HND-006158,2011,70300051,,,,5,8,13
HND-006163,2011,70300057,,,,5,4,9
HND-006164,2011,70300058,,,,1,3,4
HND-006169,2011,70300064,,,,4,0,4
HND-006170,2011,70300065,,,,5,4,9
HND-006171,2011,70300066,,,,4,2,6
HND-006172,2011,70300067,,,,7,4,11
HND-006173,2011,70300068,,,,14,14,28
HND-006175,2011,70300070,,,,7,7,14
HND-006176,2011,70300071,,,,6,4,10
HND-006178,2011,70300073,,,,2,2,4
HND-006182,2011,70300078,,,,5,4,9
HND-006183,2011,70300079,,,,24,19,43
HND-006184,2011,70300080,,,,8,6,14
HND-006185,2011,70300081,,,,8,10,18
HND-006186,2011,70300082,,,,0,5,5
HND-006187,2011,70300083,,,,4,5,9
HND-006193,2011,70300089,,,,9,11,20
HND-006194,2011,70300091,,,,3,8,11
HND-006196,2011,70300093,,,,14,12,26
HND-006198,2011,70300095,,,,4,3,7
HND-006199,2011,70300096,,,,11,9,20
HND-006204,2011,70300101,,,,67,69,136
HND-006209,2011,70300109,,,,4,3,7
HND-006210,2011,70300110,,,,7,6,13
HND-006212,2011,70300112,,,,9,8,17
HND-006213,2011,70300113,,,,14,18,32
HND-006215,2011,70300115,,,,40,39,79
HND-006216,2011,70300116,,,,3,5,8
HND-006218,2011,70300118,,,,9,12,21
HND-006219,2011,70300119,,,,5,6,11
HND-006227,2011,70300128,,,,5,5,10
HND-006228,2011,70300129,,,,8,12,20
HND-006231,2011,70300132,,,,4,1,5
HND-006232,2011,70300133,,,,6,7,13
HND-006237,2011,70300139,,,,3,4,7
HND-006239,2011,70300141,,,,3,4,7
HND-006242,2011,70300144,,,,7,7,14
HND-006247,2011,70300149,,,,4,5,9
HND-006250,2011,70300152,,,,4,7,11
HND-006251,2011,70300153,,,,20,25,45
HND-006256,2011,70300158,,,,1,6,7
HND-006257,2011,70300159,,,,4,4,8
HND-006259,2011,70300162,,,,2,2,4
HND-006260,2011,70300163,,,,8,2,10
HND-006262,2011,70300165,,,,1,6,7
HND-006263,2011,70300166,,,,3,6,9
HND-006265,2011,70300168,,,,10,11,21
HND-006267,2011,70300173,,,,8,5,13
HND-006270,2011,70300178,,,,8,8,16
HND-006271,2011,70300179,,,,2,3,5
HND-006272,2011,70300181,,,,2,4,6
HND-006275,2011,70300184,,,,1,1,2
HND-006278,2011,70300187,,,,5,7,12
HND-006281,2011,70300193,,,,2,5,7
HND-006284,2011,70300199,,,,10,3,13
HND-006285,2011,70300200,,,,15,4,19
HND-006287,2011,70300203,,,,6,5,11
HND-006288,2011,70300204,,,,2,3,5
HND-006293,2011,70300209,,,,3,1,4
HND-006294,2011,70300210,,,,5,3,8
HND-006295,2011,70300211,,,,5,11,16
HND-006296,2011,70300212,,,,10,4,14
HND-006297,2011,70300213,,,,8,9,17
HND-006303,2011,70300219,,,,10,12,22
HND-006309,2011,70300226,,,,8,16,24
HND-006310,2011,70300227,,,,2,0,2
HND-006313,2011,70300235,,,,4,4,8
HND-006314,2011,70300236,,,,13,14,27
HND-006315,2011,70300237,,,,8,5,13
HND-006321,2011,70300245,,,,8,1,9
HND-006322,2011,70300246,,,,12,12,24
,2011,70300247,,,,8,3,11
HND-006326,2011,70300250,,,,3,6,9
HND-006327,2011,70300251,,,,2,1,3
,2011,70300252,,,,12,8,20
HND-006328,2011,70300253,,,,0,1,1
HND-006330,2011,70300255,,,,5,2,7
HND-006331,2011,70300256,,,,5,2,7
HND-006333,2011,70300258,,,,1,2,3
,2011,70300260,,,,6,5,11
HND-006335,2011,70300261,,,,1,1,2
HND-006338,2011,70300265,,,,4,2,6
HND-006352,2011,70300295,,,,3,2,5
HND-006353,2011,70300297,,,,6,6,12
,2011,70300298,,,,12,5,17
HND-006380,2011,70300342,,,,3,7,10
HND-006381,2011,70300343,,,,2,6,8
HND-006385,2011,70300353,,,,2,1,3
HND-006386,2011,70300355,,,,3,3,6
HND-006389,2011,70300360,,,,4,1,5
HND-006390,2011,70300361,,,,9,7,16
HND-006393,2011,70300367,,,,9,9,18
HND-006397,2011,70300374,,,,4,3,7
,2011,70300390,,,,1,1,2
HND-006412,2011,70300398,,,,1,2,3
HND-006413,2011,70300401,,,,2,1,3
HND-006414,2011,70300403,,,,5,4,9
,2011,70300409,,,,1,4,5
HND-006424,2011,70300415,,,,3,4,7
HND-006425,2011,70300416,,,,4,3,7
HND-006426,2011,70300417,,,,1,1,2
HND-006427,2011,70300418,,,,10,3,13
HND-006428,2011,70300419,,,,0,2,2
,2011,70300438,,,,5,4,9
,2011,70300526,,,,3,1,4
,2011,70300529,,,,19,12,31
HND-006441,2011,70300531,,,,6,4,10
,2011,70300532,,,,6,13,19
HND-006446,2011,70300544,,,,2,5,7
HND-006449,2011,70300547,,,,9,10,19
HND-006450,2011,70300548,,,,10,8,18
HND-006453,2011,70300552,,,,3,7,10
HND-006458,2011,70300559,,,,2,4,6
HND-006459,2011,70300560,,,,1,3,4
HND-006462,2011,70300583,,,,1,3,4
HND-006467,2011,70300589,,,,2,4,6
HND-006468,2011,70300590,,,,4,6,10
,2011,70300592,,,,1,2,3
HND-006499,2011,70300732,,,,2,0,2
HND-006505,2011,70300750,,,,4,0,4
HND-006506,2011,70300751,,,,3,1,4
HND-006507,2011,70300752,,,,3,3,6
HND-006117,2011,70300005,,,,4,2,6
HND-006118,2011,70300006,,,,8,6,14
HND-006122,2011,70300011,,,,37,39,76
HND-006125,2011,70300014,,,,12,8,20
HND-006126,2011,70300015,,,,2,3,5
HND-006127,2011,70300017,,,,22,17,39
HND-006129,2011,70300019,,,,35,43,78
HND-006130,2011,70300020,,,,6,2,8
HND-006131,2011,70300021,,,,11,11,22
HND-006132,2011,70300022,,,,3,4,7
HND-006133,2011,70300023,,,,4,3,7
HND-006136,2011,70300026,,,,53,53,106
HND-006138,2011,70300028,,,,6,4,10
HND-006139,2011,70300029,,,,4,3,7
HND-006141,2011,70300031,,,,88,56,144
HND-006144,2011,70300035,,,,17,25,42
HND-006145,2011,70300036,,,,7,4,11
HND-006146,2011,70300037,,,,7,10,17
HND-006149,2011,70300041,,,,8,8,16
HND-006153,2011,70300045,,,,6,7,13
,2011,70300046,,,,0,1,1
HND-006155,2011,70300048,,,,5,1,6
HND-006157,2011,70300050,,,,1,2,3
HND-006159,2011,70300052,,,,2,5,7
HND-006160,2011,70300053,,,,9,5,14
HND-006161,2011,70300054,,,,14,14,28
HND-006162,2011,70300056,,,,38,30,68
HND-006165,2011,70300059,,,,8,14,22
HND-006166,2011,70300060,,,,7,1,8
HND-006167,2011,70300061,,,,1,2,3
HND-006168,2011,70300062,,,,27,30,57
HND-006174,2011,70300069,,,,2,5,7
HND-006177,2011,70300072,,,,4,5,9
HND-006179,2011,70300075,,,,10,6,16
HND-006180,2011,70300076,,,,17,16,33
HND-006181,2011,70300077,,,,23,11,34
HND-006188,2011,70300084,,,,5,3,8
HND-006189,2011,70300085,,,,4,4,8
HND-006190,2011,70300086,,,,1,2,3
HND-006191,2011,70300087,,,,8,8,16
HND-006192,2011,70300088,,,,118,120,238
HND-006195,2011,70300092,,,,10,15,25
HND-006197,2011,70300094,,,,22,25,47
HND-006200,2011,70300097,,,,23,24,47
HND-006201,2011,70300098,,,,31,32,63
HND-006202,2011,70300099,,,,3,2,5
HND-006203,2011,70300100,,,,29,20,49
HND-006205,2011,70300102,,,,2,4,6
HND-006206,2011,70300105,,,,8,5,13
HND-006207,2011,70300106,,,,2,1,3
HND-006208,2011,70300107,,,,6,4,10
,2011,70300111,,,,5,4,9
HND-006214,2011,70300114,,,,30,23,53
HND-006217,2011,70300117,,,,11,4,15
HND-006220,2011,70300120,,,,8,6,14
HND-006221,2011,70300121,,,,12,7,19
HND-006222,2011,70300122,,,,28,19,47
HND-006223,2011,70300124,,,,9,5,14
HND-006224,2011,70300125,,,,7,9,16
HND-006225,2011,70300126,,,,4,1,5
HND-006226,2011,70300127,,,,9,8,17
HND-006229,2011,70300130,,,,6,3,9
HND-006230,2011,70300131,,,,7,8,15
HND-006233,2011,70300134,,,,43,42,85
HND-006234,2011,70300135,,,,12,18,30
HND-006235,2011,70300136,,,,4,7,11
HND-006236,2011,70300137,,,,5,7,12
HND-006238,2011,70300140,,,,15,16,31
HND-006240,2011,70300142,,,,15,15,30
HND-006243,2011,70300145,,,,18,17,35
HND-006244,2011,70300146,,,,3,6,9
HND-006245,2011,70300147,,,,14,14,28
HND-006246,2011,70300148,,,,15,13,28
HND-006248,2011,70300150,,,,8,7,15
HND-006249,2011,70300151,,,,10,12,22
HND-006252,2011,70300154,,,,4,5,9
HND-006253,2011,70300155,,,,15,16,31
HND-006254,2011,70300156,,,,2,6,8
HND-006255,2011,70300157,,,,4,5,9
HND-006258,2011,70300161,,,,7,4,11
HND-006261,2011,70300164,,,,10,8,18
HND-006264,2011,70300167,,,,5,4,9
HND-006266,2011,70300169,,,,6,4,10
HND-006268,2011,70300176,,,,6,8,14
HND-006269,2011,70300177,,,,15,11,26
HND-006273,2011,70300182,,,,3,1,4
HND-006276,2011,70300185,,,,7,2,9
HND-006277,2011,70300186,,,,6,6,12
HND-006279,2011,70300188,,,,4,2,6
HND-006280,2011,70300190,,,,4,4,8
HND-006282,2011,70300195,,,,2,2,4
HND-006283,2011,70300198,,,,49,58,107
HND-006286,2011,70300201,,,,9,5,14
HND-006289,2011,70300205,,,,5,7,12
HND-006290,2011,70300206,,,,12,8,20
HND-006291,2011,70300207,,,,4,7,11
HND-006292,2011,70300208,,,,1,1,2
HND-006298,2011,70300214,,,,5,7,12
HND-006299,2011,70300215,,,,2,3,5
HND-006300,2011,70300216,,,,9,1,10
HND-006301,2011,70300217,,,,5,7,12
HND-006302,2011,70300218,,,,9,5,14
HND-006304,2011,70300220,,,,2,3,5
HND-006305,2011,70300221,,,,3,3,6
HND-006306,2011,70300222,,,,4,2,6
HND-006307,2011,70300223,,,,10,5,15
HND-006311,2011,70300229,,,,1,2,3
HND-006312,2011,70300231,,,,6,5,11
HND-006316,2011,70300238,,,,2,3,5
,2011,70300239,,,,4,6,10
HND-006318,2011,70300240,,,,3,3,6
HND-006319,2011,70300242,,,,5,2,7
HND-006320,2011,70300243,,,,4,8,12
HND-006324,2011,70300248,,,,2,2,4
HND-006325,2011,70300249,,,,1,3,4
HND-006329,2011,70300254,,,,5,1,6
HND-006332,2011,70300257,,,,5,4,9
HND-006334,2011,70300259,,,,4,1,5
HND-006336,2011,70300262,,,,4,3,7
HND-006337,2011,70300264,,,,13,5,18
HND-006339,2011,70300267,,,,1,1,2
HND-006340,2011,70300271,,,,12,9,21
HND-006363,2011,70300309,,,,22,21,43
HND-006373,2011,70300324,,,,8,7,15
HND-006374,2011,70300325,,,,1,0,1
HND-006375,2011,70300326,,,,2,1,3
HND-006379,2011,70300340,,,,8,6,14
HND-006383,2011,70300345,,,,3,4,7
HND-006384,2011,70300347,,,,7,8,15
HND-006391,2011,70300362,,,,1,0,1
HND-006394,2011,70300368,,,,3,6,9
HND-006405,2011,70300389,,,,3,2,5
HND-006407,2011,70300392,,,,3,4,7
HND-006408,2011,70300393,,,,6,3,9
HND-006410,2011,70300396,,,,6,7,13
HND-006411,2011,70300397,,,,5,3,8
,2011,70300402,,,,2,0,2
HND-006415,2011,70300404,,,,5,5,10
HND-006416,2011,70300405,,,,2,6,8
HND-006417,2011,70300406,,,,4,4,8
HND-006418,2011,70300407,,,,4,2,6
HND-006421,2011,70300410,,,,3,3,6
HND-006423,2011,70300413,,,,9,1,10
HND-006429,2011,70300420,,,,2,1,3
HND-006432,2011,70300427,,,,10,7,17
HND-006433,2011,70300430,,,,7,3,10
HND-006436,2011,70300518,,,,2,1,3
HND-006437,2011,70300520,,,,6,5,11
HND-006438,2011,70300524,,,,7,6,13
HND-006439,2011,70300527,,,,4,1,5
,2011,70300528,,,,3,1,4
HND-006442,2011,70300533,,,,6,2,8
HND-006447,2011,70300545,,,,5,1,6
HND-006448,2011,70300546,,,,6,5,11
HND-006451,2011,70300550,,,,1,4,5
HND-006454,2011,70300553,,,,5,4,9
HND-006456,2011,70300557,,,,5,12,17
HND-006457,2011,70300558,,,,6,3,9
HND-006460,2011,70300580,,,,4,1,5
HND-006461,2011,70300581,,,,3,2,5
HND-006463,2011,70300584,,,,3,0,3
HND-006464,2011,70300585,,,,6,2,8
HND-006465,2011,70300587,,,,2,2,4
HND-006466,2011,70300588,,,,3,2,5
HND-006469,2011,70300591,,,,1,2,3
HND-006471,2011,70300593,,,,1,1,2
HND-006504,2011,70300749,,,,2,2,4
HND-006115,2011,70300002,,,,3,3,6
HND-006120,2011,70300009,,,,2,3,5
HND-006122,2011,70300011,,,,29,34,63
HND-006126,2011,70300015,,,,3,2,5
HND-006127,2011,70300017,,,,13,11,24
HND-006128,2011,70300018,,,,4,4,8
HND-006129,2011,70300019,,,,29,28,57
HND-006130,2011,70300020,,,,2,5,7
HND-006132,2011,70300022,,,,2,4,6
HND-006133,2011,70300023,,,,3,2,5
HND-006134,2011,70300024,,,,5,2,7
HND-006136,2011,70300026,,,,47,44,91
HND-006139,2011,70300029,,,,0,1,1
HND-006143,2011,70300034,,,,48,65,113
HND-006144,2011,70300035,,,,22,17,39
HND-006145,2011,70300036,,,,4,5,9
HND-006146,2011,70300037,,,,8,3,11
HND-006147,2011,70300038,,,,2,7,9
HND-006148,2011,70300040,,,,2,2,4
HND-006149,2011,70300041,,,,6,14,20
HND-006151,2011,70300043,,,,3,4,7
HND-006153,2011,70300045,,,,3,3,6
,2011,70300046,,,,2,2,4
HND-006155,2011,70300048,,,,5,6,11
HND-006156,2011,70300049,,,,9,5,14
HND-006159,2011,70300052,,,,4,8,12
HND-006161,2011,70300054,,,,14,10,24
HND-006162,2011,70300056,,,,30,34,64
HND-006163,2011,70300057,,,,6,4,10
HND-006166,2011,70300060,,,,3,1,4
HND-006168,2011,70300062,,,,23,25,48
HND-006169,2011,70300064,,,,3,2,5
HND-006174,2011,70300069,,,,8,5,13
HND-006179,2011,70300075,,,,9,8,17
HND-006180,2011,70300076,,,,14,16,30
HND-006181,2011,70300077,,,,17,21,38
HND-006182,2011,70300078,,,,6,8,14
HND-006183,2011,70300079,,,,27,16,43
HND-006185,2011,70300081,,,,12,15,27
HND-006189,2011,70300085,,,,3,3,6
HND-006190,2011,70300086,,,,1,2,3
HND-006191,2011,70300087,,,,4,4,8
HND-006192,2011,70300088,,,,123,130,253
HND-006197,2011,70300094,,,,16,29,45
HND-006198,2011,70300095,,,,6,4,10
HND-006199,2011,70300096,,,,10,6,16
HND-006200,2011,70300097,,,,23,34,57
HND-006201,2011,70300098,,,,38,31,69
HND-006203,2011,70300100,,,,16,13,29
HND-006205,2011,70300102,,,,1,2,3
HND-006206,2011,70300105,,,,8,6,14
HND-006207,2011,70300106,,,,2,0,2
HND-006210,2011,70300110,,,,6,3,9
,2011,70300111,,,,14,6,20
HND-006212,2011,70300112,,,,7,10,17
HND-006214,2011,70300114,,,,13,18,31
HND-006215,2011,70300115,,,,39,38,77
HND-006216,2011,70300116,,,,9,7,16
HND-006217,2011,70300117,,,,9,8,17
HND-006218,2011,70300118,,,,13,12,25
HND-006220,2011,70300120,,,,9,6,15
HND-006222,2011,70300122,,,,18,19,37
HND-006224,2011,70300125,,,,5,5,10
HND-006225,2011,70300126,,,,2,5,7
HND-006226,2011,70300127,,,,11,7,18
HND-006227,2011,70300128,,,,5,6,11
HND-006229,2011,70300130,,,,4,4,8
HND-006230,2011,70300131,,,,8,2,10
HND-006231,2011,70300132,,,,0,4,4
HND-006234,2011,70300135,,,,17,17,34
HND-006235,2011,70300136,,,,8,8,16
HND-006236,2011,70300137,,,,5,6,11
HND-006240,2011,70300142,,,,16,13,29
HND-006241,2011,70300143,,,,2,2,4
HND-006246,2011,70300148,,,,9,4,13
HND-006247,2011,70300149,,,,5,3,8
HND-006248,2011,70300150,,,,14,11,25
HND-006249,2011,70300151,,,,9,16,25
HND-006250,2011,70300152,,,,10,11,21
HND-006253,2011,70300155,,,,12,17,29
HND-006254,2011,70300156,,,,5,5,10
HND-006255,2011,70300157,,,,4,4,8
HND-006256,2011,70300158,,,,3,3,6
HND-006258,2011,70300161,,,,4,3,7
HND-006261,2011,70300164,,,,13,5,18
HND-006262,2011,70300165,,,,5,3,8
HND-006263,2011,70300166,,,,4,6,10
HND-006264,2011,70300167,,,,7,3,10
HND-006268,2011,70300176,,,,8,8,16
HND-006269,2011,70300177,,,,21,17,38
HND-006270,2011,70300178,,,,4,12,16
HND-006279,2011,70300188,,,,4,1,5
HND-006280,2011,70300190,,,,5,1,6
HND-006282,2011,70300195,,,,6,3,9
HND-006285,2011,70300200,,,,6,7,13
HND-006286,2011,70300201,,,,3,2,5
HND-006287,2011,70300203,,,,5,2,7
HND-006292,2011,70300208,,,,4,1,5
HND-006293,2011,70300209,,,,3,2,5
HND-006294,2011,70300210,,,,2,1,3
HND-006295,2011,70300211,,,,5,4,9
HND-006299,2011,70300215,,,,1,4,5
HND-006300,2011,70300216,,,,4,7,11
HND-006301,2011,70300217,,,,11,11,22
HND-006302,2011,70300218,,,,3,4,7
HND-006304,2011,70300220,,,,3,1,4
HND-006306,2011,70300222,,,,2,1,3
HND-006307,2011,70300223,,,,7,1,8
HND-006308,2011,70300224,,,,2,0,2
HND-006309,2011,70300226,,,,17,9,26
HND-006311,2011,70300229,,,,1,2,3
,2011,70300239,,,,3,6,9
HND-006318,2011,70300240,,,,6,2,8
HND-006319,2011,70300242,,,,0,2,2
HND-006320,2011,70300243,,,,8,2,10
HND-006325,2011,70300249,,,,1,1,2
,2011,70300252,,,,5,7,12
HND-006329,2011,70300254,,,,2,1,3
HND-006330,2011,70300255,,,,2,1,3
HND-006331,2011,70300256,,,,4,0,4
HND-006332,2011,70300257,,,,3,4,7
HND-006337,2011,70300264,,,,7,8,15
HND-006338,2011,70300265,,,,3,2,5
HND-006339,2011,70300267,,,,4,0,4
HND-006340,2011,70300271,,,,13,10,23
HND-006352,2011,70300295,,,,4,6,10
HND-006353,2011,70300297,,,,2,6,8
,2011,70300298,,,,14,12,26
HND-006363,2011,70300309,,,,26,30,56
HND-006374,2011,70300325,,,,2,0,2
HND-006375,2011,70300326,,,,3,3,6
HND-006379,2011,70300340,,,,9,4,13
HND-006380,2011,70300342,,,,3,3,6
HND-006381,2011,70300343,,,,4,1,5
HND-006383,2011,70300345,,,,9,4,13
HND-006391,2011,70300362,,,,0,1,1
HND-006397,2011,70300374,,,,6,5,11
HND-006405,2011,70300389,,,,5,1,6
HND-006411,2011,70300397,,,,7,3,10
HND-006415,2011,70300404,,,,5,1,6
HND-006416,2011,70300405,,,,4,0,4
HND-006417,2011,70300406,,,,7,8,15
HND-006418,2011,70300407,,,,4,3,7
,2011,70300409,,,,3,3,6
HND-006421,2011,70300410,,,,4,3,7
HND-006425,2011,70300416,,,,3,5,8
HND-006426,2011,70300417,,,,4,1,5
HND-006429,2011,70300420,,,,2,10,12
HND-006432,2011,70300427,,,,3,8,11
HND-006433,2011,70300430,,,,2,7,9
,2011,70300438,,,,7,2,9
HND-006437,2011,70300520,,,,6,1,7
HND-006438,2011,70300524,,,,5,5,10
,2011,70300526,,,,2,2,4
HND-006449,2011,70300547,,,,10,17,27
HND-006451,2011,70300550,,,,2,1,3
HND-006453,2011,70300552,,,,5,3,8
HND-006457,2011,70300558,,,,2,5,7
HND-006459,2011,70300560,,,,4,3,7
HND-006464,2011,70300585,,,,3,7,10
HND-006466,2011,70300588,,,,5,1,6
HND-006467,2011,70300589,,,,2,4,6
HND-006469,2011,70300591,,,,3,3,6
HND-006504,2011,70300749,,,,2,2,4
HND-006116,2011,70300004,,,,3,3,6
HND-006117,2011,70300005,,,,1,4,5
HND-006118,2011,70300006,,,,6,12,18
HND-006119,2011,70300007,,,,4,4,8
HND-006121,2011,70300010,,,,2,6,8
HND-006123,2011,70300012,,,,9,9,18
HND-006124,2011,70300013,,,,3,3,6
HND-006125,2011,70300014,,,,5,6,11
HND-006131,2011,70300021,,,,12,15,27
HND-006135,2011,70300025,,,,7,8,15
HND-006137,2011,70300027,,,,5,6,11
HND-006138,2011,70300028,,,,6,3,9
HND-006140,2011,70300030,,,,3,3,6
HND-006141,2011,70300031,,,,59,70,129
HND-006142,2011,70300032,,,,9,7,16
HND-006150,2011,70300042,,,,8,4,12
HND-006152,2011,70300044,,,,3,5,8
HND-006157,2011,70300050,,,,0,3,3
HND-006158,2011,70300051,,,,4,6,10
HND-006160,2011,70300053,,,,2,8,10
HND-006164,2011,70300058,,,,0,5,5
HND-006165,2011,70300059,,,,14,10,24
HND-006167,2011,70300061,,,,2,2,4
HND-006170,2011,70300065,,,,6,8,14
HND-006171,2011,70300066,,,,5,6,11
HND-006172,2011,70300067,,,,4,2,6
HND-006173,2011,70300068,,,,18,11,29
HND-006175,2011,70300070,,,,3,6,9
HND-006176,2011,70300071,,,,4,3,7
HND-006177,2011,70300072,,,,8,3,11
HND-006178,2011,70300073,,,,2,2,4
HND-006184,2011,70300080,,,,4,3,7
HND-006186,2011,70300082,,,,2,3,5
HND-006187,2011,70300083,,,,3,7,10
HND-006188,2011,70300084,,,,3,4,7
HND-006193,2011,70300089,,,,11,9,20
HND-006194,2011,70300091,,,,8,4,12
HND-006195,2011,70300092,,,,12,8,20
HND-006196,2011,70300093,,,,4,5,9
HND-006202,2011,70300099,,,,1,4,5
HND-006204,2011,70300101,,,,68,59,127
HND-006208,2011,70300107,,,,3,1,4
HND-006209,2011,70300109,,,,5,7,12
HND-006213,2011,70300113,,,,31,32,63
HND-006219,2011,70300119,,,,5,6,11
HND-006221,2011,70300121,,,,8,10,18
HND-006223,2011,70300124,,,,7,4,11
HND-006228,2011,70300129,,,,7,14,21
HND-006232,2011,70300133,,,,5,5,10
HND-006233,2011,70300134,,,,39,32,71
HND-006237,2011,70300139,,,,6,3,9
HND-006238,2011,70300140,,,,19,8,27
HND-006239,2011,70300141,,,,1,1,2
HND-006242,2011,70300144,,,,4,8,12
HND-006243,2011,70300145,,,,12,14,26
HND-006244,2011,70300146,,,,2,5,7
HND-006245,2011,70300147,,,,6,5,11
HND-006251,2011,70300153,,,,21,24,45
HND-006252,2011,70300154,,,,3,6,9
HND-006257,2011,70300159,,,,8,7,15
HND-006259,2011,70300162,,,,0,2,2
HND-006260,2011,70300163,,,,3,4,7
HND-006265,2011,70300168,,,,9,12,21
HND-006266,2011,70300169,,,,5,6,11
HND-006267,2011,70300173,,,,3,4,7
HND-006271,2011,70300179,,,,1,7,8
HND-006272,2011,70300181,,,,8,3,11
HND-006273,2011,70300182,,,,1,0,1
HND-006275,2011,70300184,,,,1,3,4
HND-006276,2011,70300185,,,,2,1,3
HND-006277,2011,70300186,,,,3,7,10
HND-006278,2011,70300187,,,,6,7,13
HND-006281,2011,70300193,,,,1,3,4
HND-006283,2011,70300198,,,,61,53,114
HND-006284,2011,70300199,,,,10,8,18
HND-006288,2011,70300204,,,,4,2,6
HND-006289,2011,70300205,,,,5,3,8
HND-006290,2011,70300206,,,,7,9,16
HND-006291,2011,70300207,,,,8,14,22
HND-006296,2011,70300212,,,,6,6,12
HND-006297,2011,70300213,,,,13,10,23
HND-006298,2011,70300214,,,,0,1,1
HND-006303,2011,70300219,,,,8,9,17
HND-006305,2011,70300221,,,,2,2,4
HND-006312,2011,70300231,,,,4,10,14
HND-006313,2011,70300235,,,,5,5,10
HND-006314,2011,70300236,,,,8,5,13
HND-006315,2011,70300237,,,,1,4,5
HND-006316,2011,70300238,,,,4,2,6
HND-006321,2011,70300245,,,,1,1,2
HND-006322,2011,70300246,,,,9,8,17
,2011,70300247,,,,0,1,1
HND-006324,2011,70300248,,,,2,2,4
HND-006326,2011,70300250,,,,3,6,9
HND-006327,2011,70300251,,,,0,1,1
HND-006333,2011,70300258,,,,1,0,1
HND-006334,2011,70300259,,,,2,2,4
,2011,70300260,,,,6,3,9
HND-006335,2011,70300261,,,,3,4,7
HND-006336,2011,70300262,,,,7,0,7
HND-006373,2011,70300324,,,,3,3,6
HND-006384,2011,70300347,,,,6,5,11
HND-006385,2011,70300353,,,,2,3,5
HND-006386,2011,70300355,,,,5,5,10
HND-006389,2011,70300360,,,,2,3,5
HND-006393,2011,70300367,,,,8,5,13
HND-006394,2011,70300368,,,,2,2,4
,2011,70300390,,,,0,6,6
HND-006407,2011,70300392,,,,1,1,2
HND-006408,2011,70300393,,,,5,5,10
HND-006409,2011,70300394,,,,0,1,1
HND-006410,2011,70300396,,,,4,4,8
HND-006412,2011,70300398,,,,3,4,7
HND-006413,2011,70300401,,,,1,4,5
,2011,70300402,,,,4,0,4
HND-006414,2011,70300403,,,,3,5,8
HND-006423,2011,70300413,,,,5,4,9
HND-006424,2011,70300415,,,,3,1,4
HND-006427,2011,70300418,,,,6,5,11
HND-006428,2011,70300419,,,,6,3,9
HND-006436,2011,70300518,,,,3,1,4
HND-006439,2011,70300527,,,,2,4,6
,2011,70300528,,,,2,2,4
,2011,70300529,,,,12,17,29
HND-006441,2011,70300531,,,,6,2,8
,2011,70300532,,,,6,4,10
HND-006442,2011,70300533,,,,5,4,9
HND-006446,2011,70300544,,,,2,6,8
HND-006447,2011,70300545,,,,1,0,1
HND-006448,2011,70300546,,,,2,1,3
HND-006450,2011,70300548,,,,6,8,14
HND-006454,2011,70300553,,,,7,5,12
HND-006456,2011,70300557,,,,8,16,24
HND-006458,2011,70300559,,,,5,2,7
HND-006460,2011,70300580,,,,0,3,3
HND-006461,2011,70300581,,,,2,2,4
HND-006462,2011,70300583,,,,3,5,8
HND-006463,2011,70300584,,,,4,5,9
HND-006465,2011,70300587,,,,2,4,6
HND-006468,2011,70300590,,,,5,3,8
,2011,70300592,,,,0,1,1
HND-006471,2011,70300593,,,,2,2,4
HND-006499,2011,70300732,,,,4,2,6
HND-006505,2011,70300750,,,,3,2,5
HND-006506,2011,70300751,,,,2,2,4
HND-006115,2011,70300002,,,,9,7,16
HND-006120,2011,70300009,,,,5,1,6
HND-006122,2011,70300011,,,,47,27,74
HND-006125,2011,70300014,,,,2,4,6
HND-006126,2011,70300015,,,,2,6,8
HND-006127,2011,70300017,,,,16,16,32
HND-006128,2011,70300018,,,,2,5,7
HND-006129,2011,70300019,,,,23,42,65
HND-006130,2011,70300020,,,,4,1,5
HND-006132,2011,70300022,,,,2,4,6
HND-006133,2011,70300023,,,,4,3,7
HND-006134,2011,70300024,,,,6,2,8
HND-006136,2011,70300026,,,,48,63,111
HND-006139,2011,70300029,,,,3,5,8
HND-006140,2011,70300030,,,,6,2,8
HND-006142,2011,70300032,,,,8,4,12
HND-006143,2011,70300034,,,,63,74,137
HND-006148,2011,70300040,,,,3,6,9
HND-006150,2011,70300042,,,,4,6,10
HND-006151,2011,70300043,,,,6,3,9
HND-006152,2011,70300044,,,,5,3,8
HND-006156,2011,70300049,,,,4,10,14
HND-006157,2011,70300050,,,,2,1,3
HND-006158,2011,70300051,,,,5,7,12
HND-006163,2011,70300057,,,,5,2,7
HND-006164,2011,70300058,,,,1,2,3
HND-006166,2011,70300060,,,,6,4,10
HND-006167,2011,70300061,,,,1,1,2
HND-006168,2011,70300062,,,,26,31,57
HND-006174,2011,70300069,,,,5,8,13
HND-006175,2011,70300070,,,,4,2,6
HND-006176,2011,70300071,,,,2,2,4
HND-006177,2011,70300072,,,,1,7,8
HND-006178,2011,70300073,,,,4,1,5
HND-006182,2011,70300078,,,,3,6,9
HND-006184,2011,70300080,,,,3,2,5
HND-006185,2011,70300081,,,,11,4,15
HND-006186,2011,70300082,,,,1,2,3
HND-006187,2011,70300083,,,,4,4,8
HND-006193,2011,70300089,,,,7,4,11
HND-006194,2011,70300091,,,,8,5,13
HND-006195,2011,70300092,,,,10,12,22
HND-006196,2011,70300093,,,,9,18,27
HND-006202,2011,70300099,,,,2,4,6
HND-006203,2011,70300100,,,,20,21,41
HND-006205,2011,70300102,,,,5,4,9
HND-006206,2011,70300105,,,,3,9,12
HND-006207,2011,70300106,,,,3,1,4
HND-006208,2011,70300107,,,,2,3,5
HND-006210,2011,70300110,,,,4,5,9
,2011,70300111,,,,6,6,12
HND-006214,2011,70300114,,,,28,28,56
HND-006215,2011,70300115,,,,27,37,64
HND-006216,2011,70300116,,,,8,3,11
HND-006217,2011,70300117,,,,2,4,6
HND-006220,2011,70300120,,,,4,5,9
HND-006221,2011,70300121,,,,9,6,15
HND-006222,2011,70300122,,,,19,17,36
HND-006224,2011,70300125,,,,3,7,10
HND-006225,2011,70300126,,,,2,3,5
HND-006226,2011,70300127,,,,8,8,16
HND-006227,2011,70300128,,,,4,4,8
HND-006232,2011,70300133,,,,4,2,6
HND-006233,2011,70300134,,,,39,39,78
HND-006237,2011,70300139,,,,3,3,6
HND-006239,2011,70300141,,,,4,4,8
HND-006242,2011,70300144,,,,3,8,11
HND-006243,2011,70300145,,,,19,15,34
HND-006244,2011,70300146,,,,1,2,3
HND-006245,2011,70300147,,,,15,8,23
HND-006251,2011,70300153,,,,17,17,34
HND-006257,2011,70300159,,,,9,3,12
HND-006258,2011,70300161,,,,1,4,5
HND-006261,2011,70300164,,,,5,4,9
HND-006262,2011,70300165,,,,1,2,3
HND-006263,2011,70300166,,,,3,4,7
HND-006264,2011,70300167,,,,4,3,7
HND-006267,2011,70300173,,,,3,7,10
HND-006270,2011,70300178,,,,7,6,13
HND-006272,2011,70300181,,,,1,4,5
HND-006275,2011,70300184,,,,3,1,4
HND-006276,2011,70300185,,,,1,4,5
HND-006277,2011,70300186,,,,4,2,6
HND-006278,2011,70300187,,,,6,4,10
HND-006281,2011,70300193,,,,5,6,11
HND-006284,2011,70300199,,,,4,9,13
HND-006285,2011,70300200,,,,6,7,13
HND-006286,2011,70300201,,,,3,4,7
HND-006289,2011,70300205,,,,6,1,7
HND-006290,2011,70300206,,,,7,11,18
HND-006292,2011,70300208,,,,1,0,1
HND-006295,2011,70300211,,,,6,7,13
HND-006299,2011,70300215,,,,2,2,4
HND-006300,2011,70300216,,,,4,2,6
HND-006301,2011,70300217,,,,5,8,13
HND-006302,2011,70300218,,,,3,6,9
HND-006304,2011,70300220,,,,2,3,5
HND-006305,2011,70300221,,,,0,3,3
HND-006306,2011,70300222,,,,2,1,3
HND-006307,2011,70300223,,,,4,2,6
HND-006309,2011,70300226,,,,8,12,20
HND-006311,2011,70300229,,,,0,2,2
HND-006312,2011,70300231,,,,1,6,7
,2011,70300239,,,,4,4,8
HND-006318,2011,70300240,,,,3,4,7
HND-006319,2011,70300242,,,,0,1,1
HND-006320,2011,70300243,,,,0,1,1
HND-006324,2011,70300248,,,,0,1,1
HND-006325,2011,70300249,,,,3,1,4
HND-006329,2011,70300254,,,,6,2,8
HND-006330,2011,70300255,,,,7,5,12
HND-006331,2011,70300256,,,,4,2,6
HND-006332,2011,70300257,,,,3,3,6
HND-006337,2011,70300264,,,,8,2,10
HND-006338,2011,70300265,,,,3,4,7
HND-006339,2011,70300267,,,,0,2,2
HND-006340,2011,70300271,,,,2,6,8
HND-006353,2011,70300297,,,,12,6,18
,2011,70300298,,,,11,10,21
HND-006379,2011,70300340,,,,7,8,15
HND-006381,2011,70300343,,,,4,1,5
HND-006383,2011,70300345,,,,1,0,1
HND-006389,2011,70300360,,,,0,4,4
HND-006393,2011,70300367,,,,2,4,6
HND-006394,2011,70300368,,,,0,2,2
HND-006397,2011,70300374,,,,6,3,9
HND-006405,2011,70300389,,,,4,4,8
HND-006407,2011,70300392,,,,1,0,1
HND-006411,2011,70300397,,,,2,2,4
HND-006415,2011,70300404,,,,1,1,2
HND-006416,2011,70300405,,,,1,5,6
HND-006417,2011,70300406,,,,3,7,10
HND-006418,2011,70300407,,,,0,2,2
,2011,70300409,,,,2,2,4
HND-006421,2011,70300410,,,,1,0,1
HND-006423,2011,70300413,,,,2,2,4
HND-006426,2011,70300417,,,,1,3,4
HND-006429,2011,70300420,,,,3,1,4
HND-006432,2011,70300427,,,,4,7,11
HND-006433,2011,70300430,,,,4,3,7
,2011,70300529,,,,10,13,23
HND-006442,2011,70300533,,,,2,0,2
HND-006447,2011,70300545,,,,4,8,12
HND-006456,2011,70300557,,,,8,9,17
HND-006457,2011,70300558,,,,4,2,6
HND-006460,2011,70300580,,,,1,2,3
HND-006461,2011,70300581,,,,4,1,5
HND-006463,2011,70300584,,,,5,4,9
HND-006464,2011,70300585,,,,1,3,4
HND-006466,2011,70300588,,,,4,2,6
HND-006467,2011,70300589,,,,1,0,1
HND-006469,2011,70300591,,,,1,0,1
HND-006471,2011,70300593,,,,0,2,2
HND-006504,2011,70300749,,,,1,0,1
HND-006116,2011,70300004,,,,2,1,3
HND-006117,2011,70300005,,,,3,4,7
HND-006118,2011,70300006,,,,9,5,14
HND-006119,2011,70300007,,,,1,2,3
HND-006121,2011,70300010,,,,3,2,5
HND-006123,2011,70300012,,,,8,8,16
HND-006124,2011,70300013,,,,8,6,14
HND-006131,2011,70300021,,,,14,13,27
HND-006135,2011,70300025,,,,5,3,8
HND-006137,2011,70300027,,,,3,3,6
HND-006138,2011,70300028,,,,3,7,10
HND-006141,2011,70300031,,,,79,81,160
HND-006144,2011,70300035,,,,15,10,25
HND-006145,2011,70300036,,,,2,2,4
HND-006146,2011,70300037,,,,5,9,14
HND-006147,2011,70300038,,,,4,5,9
HND-006149,2011,70300041,,,,13,7,20
HND-006153,2011,70300045,,,,5,3,8
,2011,70300046,,,,0,3,3
HND-006155,2011,70300048,,,,2,2,4
HND-006159,2011,70300052,,,,2,5,7
HND-006160,2011,70300053,,,,4,3,7
HND-006161,2011,70300054,,,,14,8,22
HND-006162,2011,70300056,,,,38,21,59
HND-006165,2011,70300059,,,,11,11,22
HND-006169,2011,70300064,,,,3,4,7
HND-006170,2011,70300065,,,,7,5,12
HND-006171,2011,70300066,,,,2,5,7
HND-006172,2011,70300067,,,,4,4,8
HND-006173,2011,70300068,,,,11,13,24
HND-006179,2011,70300075,,,,5,4,9
HND-006180,2011,70300076,,,,17,20,37
HND-006181,2011,70300077,,,,24,18,42
HND-006183,2011,70300079,,,,20,18,38
HND-006188,2011,70300084,,,,1,5,6
HND-006189,2011,70300085,,,,2,2,4
HND-006190,2011,70300086,,,,1,1,2
HND-006191,2011,70300087,,,,2,1,3
HND-006192,2011,70300088,,,,114,105,219
HND-006197,2011,70300094,,,,27,21,48
HND-006198,2011,70300095,,,,5,4,9
HND-006199,2011,70300096,,,,15,2,17
HND-006200,2011,70300097,,,,9,20,29
HND-006201,2011,70300098,,,,28,35,63
HND-006204,2011,70300101,,,,67,55,122
HND-006209,2011,70300109,,,,1,1,2
HND-006212,2011,70300112,,,,6,11,17
HND-006213,2011,70300113,,,,11,17,28
HND-006218,2011,70300118,,,,13,11,24
HND-006219,2011,70300119,,,,9,9,18
HND-006223,2011,70300124,,,,7,6,13
HND-006228,2011,70300129,,,,9,13,22
HND-006229,2011,70300130,,,,6,5,11
HND-006230,2011,70300131,,,,9,5,14
HND-006231,2011,70300132,,,,3,5,8
HND-006234,2011,70300135,,,,15,8,23
HND-006235,2011,70300136,,,,3,9,12
HND-006236,2011,70300137,,,,3,3,6
HND-006238,2011,70300140,,,,12,6,18
HND-006240,2011,70300142,,,,15,15,30
HND-006241,2011,70300143,,,,2,1,3
HND-006246,2011,70300148,,,,12,12,24
HND-006247,2011,70300149,,,,2,4,6
HND-006248,2011,70300150,,,,7,10,17
HND-006249,2011,70300151,,,,3,5,8
HND-006250,2011,70300152,,,,5,7,12
HND-006252,2011,70300154,,,,11,4,15
HND-006253,2011,70300155,,,,10,27,37
HND-006254,2011,70300156,,,,5,4,9
HND-006255,2011,70300157,,,,3,0,3
HND-006256,2011,70300158,,,,1,3,4
HND-006259,2011,70300162,,,,4,3,7
HND-006260,2011,70300163,,,,4,4,8
HND-006265,2011,70300168,,,,9,8,17
HND-006266,2011,70300169,,,,2,5,7
HND-006268,2011,70300176,,,,10,2,12
HND-006269,2011,70300177,,,,16,14,30
HND-006273,2011,70300182,,,,6,2,8
HND-006279,2011,70300188,,,,3,3,6
HND-006280,2011,70300190,,,,3,3,6
HND-006282,2011,70300195,,,,2,0,2
HND-006283,2011,70300198,,,,54,55,109
HND-006287,2011,70300203,,,,7,3,10
HND-006288,2011,70300204,,,,3,4,7
HND-006291,2011,70300207,,,,9,4,13
HND-006293,2011,70300209,,,,0,2,2
HND-006294,2011,70300210,,,,5,5,10
HND-006296,2011,70300212,,,,11,8,19
HND-006297,2011,70300213,,,,14,17,31
HND-006298,2011,70300214,,,,4,4,8
HND-006303,2011,70300219,,,,7,11,18
HND-006308,2011,70300224,,,,3,2,5
HND-006310,2011,70300227,,,,3,1,4
HND-006313,2011,70300235,,,,0,8,8
HND-006314,2011,70300236,,,,10,3,13
HND-006315,2011,70300237,,,,3,3,6
HND-006316,2011,70300238,,,,1,1,2
HND-006321,2011,70300245,,,,1,0,1
HND-006322,2011,70300246,,,,7,6,13
,2011,70300247,,,,1,5,6
HND-006326,2011,70300250,,,,2,2,4
HND-006327,2011,70300251,,,,0,1,1
,2011,70300252,,,,8,3,11
HND-006328,2011,70300253,,,,2,2,4
HND-006333,2011,70300258,,,,1,2,3
HND-006334,2011,70300259,,,,2,4,6
,2011,70300260,,,,0,3,3
HND-006335,2011,70300261,,,,1,0,1
HND-006336,2011,70300262,,,,5,4,9
HND-006352,2011,70300295,,,,10,6,16
HND-006363,2011,70300309,,,,33,27,60
HND-006373,2011,70300324,,,,10,6,16
HND-006374,2011,70300325,,,,1,0,1
HND-006380,2011,70300342,,,,7,2,9
HND-006384,2011,70300347,,,,10,7,17
HND-006385,2011,70300353,,,,1,0,1
HND-006386,2011,70300355,,,,7,3,10
HND-006391,2011,70300362,,,,4,1,5
,2011,70300390,,,,4,2,6
HND-006408,2011,70300393,,,,3,3,6
HND-006409,2011,70300394,,,,1,2,3
HND-006410,2011,70300396,,,,8,5,13
HND-006412,2011,70300398,,,,3,1,4
HND-006413,2011,70300401,,,,3,1,4
,2011,70300402,,,,2,2,4
HND-006414,2011,70300403,,,,3,3,6
HND-006424,2011,70300415,,,,2,1,3
HND-006425,2011,70300416,,,,4,5,9
HND-006427,2011,70300418,,,,2,5,7
HND-006428,2011,70300419,,,,4,3,7
,2011,70300438,,,,1,2,3
HND-006436,2011,70300518,,,,2,1,3
HND-006437,2011,70300520,,,,5,3,8
HND-006438,2011,70300524,,,,3,8,11
,2011,70300526,,,,6,2,8
HND-006439,2011,70300527,,,,3,1,4
,2011,70300528,,,,6,2,8
HND-006441,2011,70300531,,,,4,5,9
,2011,70300532,,,,6,17,23
HND-006446,2011,70300544,,,,5,3,8
HND-006448,2011,70300546,,,,1,5,6
HND-006449,2011,70300547,,,,3,6,9
HND-006450,2011,70300548,,,,7,7,14
HND-006453,2011,70300552,,,,2,6,8
HND-006454,2011,70300553,,,,6,8,14
HND-006458,2011,70300559,,,,1,4,5
HND-006459,2011,70300560,,,,3,5,8
HND-006462,2011,70300583,,,,5,1,6
HND-006465,2011,70300587,,,,1,2,3
HND-006468,2011,70300590,,,,4,2,6
,2011,70300592,,,,0,1,1
HND-006499,2011,70300732,,,,0,3,3
HND-006505,2011,70300750,,,,5,6,11
HND-006506,2011,70300751,,,,1,1,2
HND-006507,2011,70300752,,,,0,1,1
HND-006117,2011,70300005,,,,2,1,3
HND-006118,2011,70300006,,,,3,6,9
HND-006119,2011,70300007,,,,1,2,3
HND-006122,2011,70300011,,,,39,34,73
HND-006123,2011,70300012,,,,4,9,13
HND-006124,2011,70300013,,,,9,1,10
HND-006125,2011,70300014,,,,7,4,11
HND-006127,2011,70300017,,,,18,22,40
HND-006130,2011,70300020,,,,6,4,10
HND-006131,2011,70300021,,,,13,4,17
HND-006133,2011,70300023,,,,5,4,9
HND-006138,2011,70300028,,,,1,3,4
HND-006139,2011,70300029,,,,3,3,6
HND-006140,2011,70300030,,,,2,2,4
HND-006143,2011,70300034,,,,59,74,133
HND-006144,2011,70300035,,,,23,10,33
HND-006145,2011,70300036,,,,3,4,7
HND-006147,2011,70300038,,,,4,5,9
HND-006148,2011,70300040,,,,2,6,8
HND-006149,2011,70300041,,,,5,7,12
HND-006150,2011,70300042,,,,6,5,11
HND-006151,2011,70300043,,,,3,1,4
HND-006155,2011,70300048,,,,4,2,6
HND-006156,2011,70300049,,,,4,4,8
HND-006161,2011,70300054,,,,13,11,24
HND-006163,2011,70300057,,,,4,5,9
HND-006166,2011,70300060,,,,1,2,3
HND-006167,2011,70300061,,,,4,1,5
HND-006170,2011,70300065,,,,3,3,6
HND-006171,2011,70300066,,,,1,2,3
HND-006176,2011,70300071,,,,1,2,3
HND-006179,2011,70300075,,,,5,7,12
HND-006180,2011,70300076,,,,9,12,21
HND-006181,2011,70300077,,,,28,18,46
HND-006183,2011,70300079,,,,18,18,36
HND-006184,2011,70300080,,,,1,3,4
HND-006185,2011,70300081,,,,6,10,16
HND-006189,2011,70300085,,,,4,2,6
HND-006190,2011,70300086,,,,1,2,3
HND-006194,2011,70300091,,,,4,7,11
HND-006198,2011,70300095,,,,4,3,7
HND-006199,2011,70300096,,,,4,6,10
HND-006200,2011,70300097,,,,19,22,41
HND-006201,2011,70300098,,,,26,33,59
HND-006206,2011,70300105,,,,5,4,9
HND-006207,2011,70300106,,,,2,5,7
HND-006208,2011,70300107,,,,1,2,3
HND-006213,2011,70300113,,,,14,10,24
HND-006214,2011,70300114,,,,22,22,44
HND-006219,2011,70300119,,,,6,9,15
HND-006221,2011,70300121,,,,6,6,12
HND-006223,2011,70300124,,,,8,9,17
HND-006224,2011,70300125,,,,4,7,11
HND-006225,2011,70300126,,,,3,1,4
HND-006226,2011,70300127,,,,4,8,12
HND-006229,2011,70300130,,,,6,1,7
HND-006231,2011,70300132,,,,2,1,3
HND-006232,2011,70300133,,,,3,5,8
HND-006237,2011,70300139,,,,3,0,3
HND-006241,2011,70300143,,,,2,0,2
HND-006242,2011,70300144,,,,10,5,15
HND-006247,2011,70300149,,,,0,6,6
HND-006248,2011,70300150,,,,12,10,22
HND-006250,2011,70300152,,,,6,0,6
HND-006253,2011,70300155,,,,21,16,37
HND-006254,2011,70300156,,,,0,4,4
HND-006256,2011,70300158,,,,3,0,3
HND-006260,2011,70300163,,,,7,5,12
HND-006261,2011,70300164,,,,3,5,8
HND-006266,2011,70300169,,,,4,4,8
HND-006268,2011,70300176,,,,14,6,20
HND-006269,2011,70300177,,,,11,20,31
HND-006270,2011,70300178,,,,9,5,14
HND-006275,2011,70300184,,,,0,7,7
HND-006280,2011,70300190,,,,5,2,7
HND-006281,2011,70300193,,,,5,2,7
HND-006282,2011,70300195,,,,5,0,5
HND-006288,2011,70300204,,,,0,4,4
HND-006289,2011,70300205,,,,4,3,7
HND-006290,2011,70300206,,,,10,2,12
HND-006291,2011,70300207,,,,5,2,7
HND-006296,2011,70300212,,,,4,7,11
HND-006298,2011,70300214,,,,2,0,2
HND-006299,2011,70300215,,,,4,2,6
HND-006300,2011,70300216,,,,5,5,10
HND-006301,2011,70300217,,,,7,3,10
HND-006305,2011,70300221,,,,2,3,5
HND-006310,2011,70300227,,,,4,0,4
HND-006312,2011,70300231,,,,1,6,7
HND-006313,2011,70300235,,,,4,0,4
HND-006314,2011,70300236,,,,10,4,14
HND-006316,2011,70300238,,,,2,7,9
HND-006321,2011,70300245,,,,1,0,1
HND-006322,2011,70300246,,,,7,3,10
,2011,70300247,,,,1,3,4
HND-006324,2011,70300248,,,,1,1,2
HND-006326,2011,70300250,,,,0,2,2
HND-006328,2011,70300253,,,,2,3,5
HND-006334,2011,70300259,,,,3,2,5
,2011,70300260,,,,4,2,6
HND-006336,2011,70300262,,,,2,2,4
HND-006337,2011,70300264,,,,2,4,6
HND-006363,2011,70300309,,,,37,31,68
HND-006375,2011,70300326,,,,0,4,4
HND-006379,2011,70300340,,,,7,7,14
HND-006384,2011,70300347,,,,10,2,12
HND-006386,2011,70300355,,,,5,3,8
HND-006393,2011,70300367,,,,10,6,16
HND-006407,2011,70300392,,,,0,1,1
HND-006408,2011,70300393,,,,1,1,2
HND-006409,2011,70300394,,,,2,1,3
HND-006410,2011,70300396,,,,5,1,6
HND-006411,2011,70300397,,,,3,3,6
HND-006412,2011,70300398,,,,1,3,4
,2011,70300402,,,,2,1,3
HND-006414,2011,70300403,,,,2,2,4
HND-006415,2011,70300404,,,,1,2,3
HND-006416,2011,70300405,,,,2,3,5
HND-006418,2011,70300407,,,,2,2,4
HND-006423,2011,70300413,,,,5,1,6
HND-006429,2011,70300420,,,,2,1,3
HND-006433,2011,70300430,,,,3,4,7
HND-006437,2011,70300520,,,,2,3,5
HND-006438,2011,70300524,,,,4,3,7
,2011,70300526,,,,1,1,2
HND-006439,2011,70300527,,,,0,1,1
,2011,70300528,,,,1,1,2
,2011,70300529,,,,13,14,27
HND-006441,2011,70300531,,,,4,3,7
,2011,70300532,,,,6,2,8
HND-006442,2011,70300533,,,,2,3,5
HND-006446,2011,70300544,,,,6,3,9
HND-006447,2011,70300545,,,,1,2,3
HND-006448,2011,70300546,,,,2,1,3
HND-006450,2011,70300548,,,,4,7,11
HND-006451,2011,70300550,,,,1,0,1
HND-006454,2011,70300553,,,,3,1,4
HND-006456,2011,70300557,,,,2,4,6
HND-006459,2011,70300560,,,,0,1,1
HND-006460,2011,70300580,,,,1,1,2
HND-006461,2011,70300581,,,,2,0,2
HND-006462,2011,70300583,,,,1,3,4
HND-006463,2011,70300584,,,,2,0,2
HND-006465,2011,70300587,,,,1,1,2
HND-006466,2011,70300588,,,,2,3,5
HND-006468,2011,70300590,,,,0,4,4
HND-006471,2011,70300593,,,,1,2,3
HND-006499,2011,70300732,,,,3,5,8
HND-006505,2011,70300750,,,,1,0,1
HND-006115,2011,70300002,,,,7,5,12
HND-006116,2011,70300004,,,,1,4,5
HND-006120,2011,70300009,,,,3,2,5
HND-006121,2011,70300010,,,,4,1,5
HND-006126,2011,70300015,,,,4,4,8
HND-006128,2011,70300018,,,,5,5,10
HND-006129,2011,70300019,,,,31,40,71
HND-006132,2011,70300022,,,,1,3,4
HND-006134,2011,70300024,,,,6,4,10
HND-006135,2011,70300025,,,,3,9,12
HND-006136,2011,70300026,,,,62,53,115
HND-006137,2011,70300027,,,,1,3,4
HND-006141,2011,70300031,,,,63,82,145
HND-006142,2011,70300032,,,,9,4,13
HND-006146,2011,70300037,,,,8,3,11
HND-006152,2011,70300044,,,,4,9,13
HND-006153,2011,70300045,,,,5,3,8
,2011,70300046,,,,1,3,4
HND-006158,2011,70300051,,,,5,2,7
HND-006159,2011,70300052,,,,3,1,4
HND-006160,2011,70300053,,,,8,2,10
HND-006162,2011,70300056,,,,28,25,53
HND-006164,2011,70300058,,,,2,1,3
HND-006165,2011,70300059,,,,11,8,19
HND-006168,2011,70300062,,,,26,28,54
HND-006169,2011,70300064,,,,1,1,2
HND-006172,2011,70300067,,,,1,3,4
HND-006173,2011,70300068,,,,6,5,11
HND-006174,2011,70300069,,,,5,1,6
HND-006175,2011,70300070,,,,3,8,11
HND-006177,2011,70300072,,,,10,8,18
HND-006178,2011,70300073,,,,3,2,5
HND-006186,2011,70300082,,,,0,3,3
HND-006187,2011,70300083,,,,5,5,10
HND-006188,2011,70300084,,,,2,7,9
HND-006191,2011,70300087,,,,4,3,7
HND-006192,2011,70300088,,,,96,105,201
HND-006193,2011,70300089,,,,9,8,17
HND-006195,2011,70300092,,,,15,13,28
HND-006196,2011,70300093,,,,10,6,16
HND-006197,2011,70300094,,,,17,25,42
HND-006202,2011,70300099,,,,0,3,3
HND-006203,2011,70300100,,,,32,25,57
HND-006204,2011,70300101,,,,63,84,147
HND-006205,2011,70300102,,,,2,3,5
HND-006209,2011,70300109,,,,5,7,12
HND-006210,2011,70300110,,,,6,8,14
,2011,70300111,,,,5,3,8
HND-006212,2011,70300112,,,,5,1,6
HND-006215,2011,70300115,,,,37,57,94
HND-006216,2011,70300116,,,,9,10,19
HND-006217,2011,70300117,,,,2,5,7
HND-006218,2011,70300118,,,,10,14,24
HND-006220,2011,70300120,,,,8,8,16
HND-006222,2011,70300122,,,,23,16,39
HND-006227,2011,70300128,,,,4,3,7
HND-006228,2011,70300129,,,,12,13,25
HND-006230,2011,70300131,,,,6,1,7
HND-006233,2011,70300134,,,,38,30,68
HND-006234,2011,70300135,,,,11,21,32
HND-006235,2011,70300136,,,,12,4,16
HND-006236,2011,70300137,,,,7,6,13
HND-006238,2011,70300140,,,,11,15,26
HND-006239,2011,70300141,,,,7,4,11
HND-006240,2011,70300142,,,,10,12,22
HND-006243,2011,70300145,,,,14,17,31
HND-006244,2011,70300146,,,,3,4,7
HND-006245,2011,70300147,,,,8,15,23
HND-006246,2011,70300148,,,,7,10,17
HND-006249,2011,70300151,,,,2,2,4
HND-006251,2011,70300153,,,,21,23,44
HND-006252,2011,70300154,,,,2,3,5
HND-006255,2011,70300157,,,,4,4,8
HND-006257,2011,70300159,,,,2,6,8
HND-006258,2011,70300161,,,,2,4,6
HND-006259,2011,70300162,,,,2,3,5
HND-006262,2011,70300165,,,,4,2,6
HND-006263,2011,70300166,,,,2,3,5
HND-006264,2011,70300167,,,,7,2,9
HND-006265,2011,70300168,,,,6,3,9
HND-006267,2011,70300173,,,,10,4,14
HND-006271,2011,70300179,,,,1,1,2
HND-006272,2011,70300181,,,,1,2,3
HND-006273,2011,70300182,,,,1,1,2
HND-006276,2011,70300185,,,,3,3,6
HND-006277,2011,70300186,,,,4,2,6
HND-006278,2011,70300187,,,,4,5,9
HND-006279,2011,70300188,,,,1,0,1
HND-006283,2011,70300198,,,,55,66,121
HND-006284,2011,70300199,,,,4,2,6
HND-006285,2011,70300200,,,,6,12,18
HND-006286,2011,70300201,,,,2,4,6
HND-006287,2011,70300203,,,,6,9,15
HND-006292,2011,70300208,,,,3,0,3
HND-006294,2011,70300210,,,,3,6,9
HND-006295,2011,70300211,,,,12,3,15
HND-006297,2011,70300213,,,,8,6,14
HND-006302,2011,70300218,,,,2,3,5
HND-006303,2011,70300219,,,,4,6,10
HND-006304,2011,70300220,,,,2,0,2
HND-006307,2011,70300223,,,,5,1,6
HND-006309,2011,70300226,,,,16,12,28
HND-006311,2011,70300229,,,,4,2,6
HND-006315,2011,70300237,,,,1,6,7
,2011,70300239,,,,1,0,1
HND-006318,2011,70300240,,,,2,3,5
HND-006319,2011,70300242,,,,0,4,4
HND-006320,2011,70300243,,,,3,2,5
HND-006325,2011,70300249,,,,0,2,2
HND-006327,2011,70300251,,,,4,2,6
,2011,70300252,,,,6,8,14
HND-006330,2011,70300255,,,,2,6,8
HND-006331,2011,70300256,,,,1,3,4
HND-006332,2011,70300257,,,,9,4,13
HND-006333,2011,70300258,,,,2,3,5
HND-006335,2011,70300261,,,,1,3,4
HND-006338,2011,70300265,,,,2,2,4
HND-006339,2011,70300267,,,,1,0,1
HND-006340,2011,70300271,,,,4,8,12
HND-006352,2011,70300295,,,,7,3,10
HND-006353,2011,70300297,,,,6,6,12
,2011,70300298,,,,12,13,25
HND-006373,2011,70300324,,,,2,9,11
HND-006380,2011,70300342,,,,2,1,3
HND-006381,2011,70300343,,,,0,3,3
HND-006383,2011,70300345,,,,3,5,8
HND-006385,2011,70300353,,,,1,2,3
HND-006389,2011,70300360,,,,2,1,3
HND-006394,2011,70300368,,,,0,3,3
HND-006397,2011,70300374,,,,6,2,8
HND-006405,2011,70300389,,,,7,2,9
,2011,70300390,,,,1,2,3
,2011,70300409,,,,2,1,3
HND-006421,2011,70300410,,,,1,1,2
HND-006424,2011,70300415,,,,4,2,6
HND-006425,2011,70300416,,,,3,7,10
HND-006426,2011,70300417,,,,3,2,5
HND-006427,2011,70300418,,,,4,5,9
HND-006428,2011,70300419,,,,5,1,6
HND-006432,2011,70300427,,,,3,1,4
,2011,70300438,,,,5,2,7
HND-006436,2011,70300518,,,,1,0,1
HND-006449,2011,70300547,,,,15,11,26
HND-006453,2011,70300552,,,,5,2,7
HND-006457,2011,70300558,,,,1,2,3
HND-006458,2011,70300559,,,,0,4,4
,2011,70300592,,,,2,0,2
HND-006504,2011,70300749,,,,0,1,1
HND-006127,2011,70300017,,,,24,23,47
HND-006129,2011,70300019,,,,23,19,42
HND-006130,2011,70300020,,,,9,5,14
HND-006136,2011,70300026,,,,37,38,75
HND-006153,2011,70300045,,,,4,5,9
HND-006162,2011,70300056,,,,27,14,41
HND-006192,2011,70300088,,,,101,100,201
HND-006197,2011,70300094,,,,19,36,55
HND-006200,2011,70300097,,,,22,23,45
HND-006203,2011,70300100,,,,22,15,37
,2011,70300111,,,,10,14,24
HND-006214,2011,70300114,,,,30,32,62
HND-006226,2011,70300127,,,,13,14,27
HND-006234,2011,70300135,,,,10,10,20
HND-006243,2011,70300145,,,,18,9,27
HND-006244,2011,70300146,,,,13,21,34
HND-006253,2011,70300155,,,,22,14,36
HND-006269,2011,70300177,,,,19,61,80
HND-006309,2011,70300226,,,,16,13,29
HND-006365,2011,70300311,,,,54,48,102
HND-006366,2011,70300313,,,,103,108,211
HND-006384,2011,70300347,,,,15,6,21
HND-006396,2011,70300372,,,,182,114,296
,2011,70300422,,,,13,8,21
,2011,70300528,,,,4,3,7
,2011,70300579,,,,3,2,5
HND-006467,2011,70300589,,,,3,2,5
HND-006137,2011,70300027,,,,3,4,7
HND-006173,2011,70300068,,,,25,32,57
HND-006175,2011,70300070,,,,15,14,29
HND-006185,2011,70300081,,,,5,8,13
HND-006195,2011,70300092,,,,10,12,22
HND-006196,2011,70300093,,,,10,12,22
HND-006212,2011,70300112,,,,6,9,15
HND-006213,2011,70300113,,,,13,20,33
HND-006223,2011,70300124,,,,6,8,14
HND-006232,2011,70300133,,,,15,12,27
HND-006251,2011,70300153,,,,16,16,32
,2011,70300191,,,,6,15,21
HND-006284,2011,70300199,,,,4,10,14
HND-006297,2011,70300213,,,,15,23,38
HND-006303,2011,70300219,,,,9,7,16
HND-006322,2011,70300246,,,,11,18,29
HND-006364,2011,70300310,,,,517,558,1075
HND-006368,2011,70300315,,,,43,44,87
HND-006419,2011,70300408,,,,41,81,122
HND-006422,2011,70300412,,,,25,11,36
,2011,70300424,,,,25,32,57
,2011,70300425,,,,40,37,77
HND-006431,2011,70300426,,,,69,64,133
,2011,70300526,,,,4,3,7
,2011,70300529,,,,5,21,26
,2011,70300532,,,,16,16,32
HND-006129,2011,70300019,,,,11,9,20
HND-006136,2011,70300026,,,,17,28,45
HND-006137,2011,70300027,,,,4,8,12
HND-006153,2011,70300045,,,,2,2,4
HND-006173,2011,70300068,,,,12,14,26
HND-006175,2011,70300070,,,,10,10,20
HND-006192,2011,70300088,,,,52,93,145
HND-006195,2011,70300092,,,,12,10,22
HND-006196,2011,70300093,,,,6,12,18
HND-006197,2011,70300094,,,,23,27,50
HND-006203,2011,70300100,,,,18,21,39
,2011,70300111,,,,10,10,20
HND-006212,2011,70300112,,,,3,5,8
HND-006232,2011,70300133,,,,9,6,15
HND-006234,2011,70300135,,,,16,12,28
HND-006253,2011,70300155,,,,9,14,23
HND-006269,2011,70300177,,,,5,38,43
HND-006297,2011,70300213,,,,10,14,24
HND-006303,2011,70300219,,,,7,7,14
HND-006309,2011,70300226,,,,9,8,17
HND-006364,2011,70300310,,,,386,497,883
HND-006368,2011,70300315,,,,31,15,46
HND-006396,2011,70300372,,,,103,87,190
HND-006419,2011,70300408,,,,44,75,119
HND-006422,2011,70300412,,,,18,7,25
,2011,70300425,,,,43,31,74
HND-006431,2011,70300426,,,,41,52,93
,2011,70300526,,,,1,1,2
,2011,70300528,,,,1,1,2
HND-006127,2011,70300017,,,,18,11,29
HND-006130,2011,70300020,,,,6,2,8
HND-006162,2011,70300056,,,,21,7,28
HND-006185,2011,70300081,,,,4,6,10
HND-006200,2011,70300097,,,,19,15,34
HND-006213,2011,70300113,,,,8,8,16
HND-006214,2011,70300114,,,,25,26,51
HND-006223,2011,70300124,,,,8,11,19
HND-006226,2011,70300127,,,,5,3,8
HND-006243,2011,70300145,,,,9,12,21
HND-006244,2011,70300146,,,,12,13,25
HND-006251,2011,70300153,,,,15,18,33
,2011,70300191,,,,8,9,17
HND-006284,2011,70300199,,,,5,3,8
HND-006322,2011,70300246,,,,4,14,18
HND-006365,2011,70300311,,,,32,42,74
HND-006366,2011,70300313,,,,45,61,106
HND-006384,2011,70300347,,,,15,8,23
,2011,70300422,,,,26,26,52
,2011,70300424,,,,27,26,53
,2011,70300529,,,,9,16,25
,2011,70300532,,,,7,6,13
,2011,70300579,,,,2,6,8
HND-006467,2011,70300589,,,,2,6,8
HND-006127,2011,70300017,,,,9,20,29
HND-006129,2011,70300019,,,,9,10,19
HND-006136,2011,70300026,,,,20,18,38
HND-006137,2011,70300027,,,,5,6,11
HND-006162,2011,70300056,,,,14,19,33
HND-006173,2011,70300068,,,,15,18,33
HND-006185,2011,70300081,,,,9,1,10
HND-006197,2011,70300094,,,,10,25,35
HND-006200,2011,70300097,,,,13,21,34
HND-006203,2011,70300100,,,,17,17,34
,2011,70300111,,,,11,6,17
HND-006212,2011,70300112,,,,6,5,11
HND-006234,2011,70300135,,,,15,12,27
HND-006253,2011,70300155,,,,7,17,24
HND-006269,2011,70300177,,,,17,39,56
,2011,70300191,,,,6,12,18
HND-006297,2011,70300213,,,,6,12,18
HND-006309,2011,70300226,,,,4,11,15
HND-006364,2011,70300310,,,,357,497,854
HND-006366,2011,70300313,,,,28,72,100
HND-006368,2011,70300315,,,,16,24,40
,2011,70300422,,,,25,25,50
HND-006431,2011,70300426,,,,40,46,86
,2011,70300532,,,,11,16,27
HND-006130,2011,70300020,,,,5,6,11
HND-006153,2011,70300045,,,,3,6,9
HND-006175,2011,70300070,,,,9,6,15
HND-006192,2011,70300088,,,,48,63,111
HND-006195,2011,70300092,,,,5,10,15
HND-006196,2011,70300093,,,,5,7,12
HND-006213,2011,70300113,,,,12,11,23
HND-006214,2011,70300114,,,,17,27,44
HND-006223,2011,70300124,,,,2,3,5
HND-006226,2011,70300127,,,,4,5,9
HND-006232,2011,70300133,,,,4,6,10
HND-006243,2011,70300145,,,,3,7,10
HND-006244,2011,70300146,,,,7,11,18
HND-006251,2011,70300153,,,,14,13,27
HND-006284,2011,70300199,,,,2,3,5
HND-006303,2011,70300219,,,,4,7,11
HND-006322,2011,70300246,,,,8,6,14
HND-006365,2011,70300311,,,,28,41,69
HND-006384,2011,70300347,,,,4,9,13
HND-006396,2011,70300372,,,,96,55,151
HND-006419,2011,70300408,,,,39,58,97
HND-006422,2011,70300412,,,,15,6,21
,2011,70300424,,,,19,20,39
,2011,70300425,,,,70,56,126
,2011,70300526,,,,1,0,1
,2011,70300528,,,,1,0,1
,2011,70300529,,,,4,14,18
,2011,70300579,,,,3,2,5
HND-006467,2011,70300589,,,,3,2,5
,2011,70300422,,,,22,31,53
HND-006430,2011,70300423,,,,12,17,29
,2011,70300424,,,,15,18,33
,2011,70300526,,,,1,2,3
,2011,70300528,,,,1,2,3
,2011,70300529,,,,0,8,8
,2011,70300532,,,,10,16,26
HND-006500,2011,70300733,,,,8,15,23
HND-006364,2011,70300310,,,,482,632,1114
HND-006365,2011,70300311,,,,20,35,55
HND-006366,2011,70300313,,,,47,83,130
HND-006367,2011,70300314,,,,181,579,760
HND-006368,2011,70300315,,,,33,23,56
HND-006396,2011,70300372,,,,88,34,122
HND-006419,2011,70300408,,,,23,38,61
HND-006422,2011,70300412,,,,11,20,31
,2011,70300425,,,,100,85,185
HND-006431,2011,70300426,,,,46,60,106
HND-006365,2011,70300311,,,,14,14,28
HND-006396,2011,70300372,,,,64,17,81
HND-006419,2011,70300408,,,,15,33,48
HND-006422,2011,70300412,,,,13,5,18
,2011,70300425,,,,80,71,151
HND-006431,2011,70300426,,,,24,21,45
,2011,70300526,,,,3,1,4
,2011,70300528,,,,3,1,4
,2011,70300529,,,,7,5,12
HND-006364,2011,70300310,,,,321,455,776
HND-006366,2011,70300313,,,,48,65,113
HND-006367,2011,70300314,,,,184,582,766
HND-006368,2011,70300315,,,,18,18,36
,2011,70300422,,,,22,33,55
HND-006430,2011,70300423,,,,8,10,18
,2011,70300424,,,,17,18,35
,2011,70300532,,,,12,11,23
HND-006364,2011,70300310,,,,150,301,451
HND-006366,2011,70300313,,,,39,59,98
HND-006367,2011,70300314,,,,174,509,683
HND-006368,2011,70300315,,,,13,2,15
,2011,70300422,,,,8,17,25
HND-006430,2011,70300423,,,,13,8,21
,2011,70300424,,,,19,26,45
HND-006431,2011,70300426,,,,22,34,56
HND-006365,2011,70300311,,,,20,26,46
HND-006396,2011,70300372,,,,58,26,84
HND-006422,2011,70300412,,,,3,15,18
,2011,70300425,,,,55,47,102
HND-006526,2011,70400012,,,,3,3,6
HND-006531,2011,70400017,,,,6,3,9
HND-006580,2011,70400080,,,,3,3,6
HND-006581,2011,70400081,,,,4,4,8
HND-006611,2011,70400130,,,,12,10,22
,2011,70400131,,,,5,4,9
,2011,70400134,,,,7,11,18
HND-006613,2011,70400135,,,,5,5,10
HND-006614,2011,70400136,,,,5,3,8
,2011,70400137,,,,12,11,23
HND-006618,2011,70400204,,,,8,6,14
HND-006619,2011,70400205,,,,4,4,8
HND-006620,2011,70400207,,,,4,4,8
,2011,70400210,,,,3,6,9
HND-006623,2011,70400211,,,,7,3,10
,2011,70400219,,,,5,1,6
HND-006624,2011,70400220,,,,3,3,6
,2011,70400228,,,,4,3,7
,2011,70400229,,,,5,3,8
,2011,70400234,,,,10,7,17
,2011,70400235,,,,7,14,21
,2011,70400236,,,,6,5,11
,2011,70400237,,,,4,5,9
,2011,70400244,,,,3,3,6
HND-006631,2011,70400245,,,,10,9,19
,2011,70400247,,,,3,4,7
,2011,70400248,,,,3,3,6
,2011,70400250,,,,3,3,6
,2011,70400251,,,,4,4,8
,2011,70400255,,,,5,3,8
HND-006637,2011,70400256,,,,2,4,6
,2011,70400258,,,,3,3,6
,2011,70400261,,,,2,5,7
HND-006639,2011,70400265,,,,6,11,17
HND-006640,2011,70400266,,,,5,4,9
,2011,70400267,,,,5,5,10
,2011,70400268,,,,7,13,20
HND-006597,2011,70400104,,,,9,2,11
HND-006612,2011,70400132,,,,5,9,14
HND-006615,2011,70400138,,,,5,3,8
,2011,70400139,,,,6,4,10
HND-006616,2011,70400183,,,,3,2,5
,2011,70400201,,,,7,2,9
,2011,70400217,,,,7,3,10
,2011,70400227,,,,8,4,12
HND-006627,2011,70400230,,,,4,2,6
,2011,70400232,,,,2,4,6
HND-006628,2011,70400238,,,,1,6,7
HND-006629,2011,70400239,,,,5,2,7
,2011,70400240,,,,3,6,9
,2011,70400241,,,,4,3,7
,2011,70400243,,,,6,1,7
HND-006632,2011,70400246,,,,2,4,6
HND-006634,2011,70400252,,,,4,6,10
HND-006635,2011,70400253,,,,4,4,8
HND-006636,2011,70400254,,,,7,6,13
,2011,70400257,,,,3,3,6
HND-006638,2011,70400259,,,,7,0,7
,2011,70400260,,,,9,3,12
,2011,70400262,,,,7,3,10
,2011,70400263,,,,7,7,14
HND-006582,2011,70400082,,,,4,5,9
,2011,70400085,,,,4,3,7
HND-006584,2011,70400088,,,,16,8,24
,2011,70400095,,,,0,1,1
HND-006593,2011,70400100,,,,1,0,1
,2011,70400231,,,,2,3,5
HND-006569,2011,70400059,,,,10,10,20
HND-006571,2011,70400063,,,,2,2,4
HND-006573,2011,70400065,,,,1,0,1
,2011,70400066,,,,3,0,3
HND-006575,2011,70400069,,,,3,3,6
HND-006596,2011,70400103,,,,11,3,14
HND-006607,2011,70400123,,,,0,2,2
HND-006608,2011,70400124,,,,0,1,1
,2011,70400126,,,,2,5,7
HND-006625,2011,70400223,,,,1,2,3
HND-006626,2011,70400224,,,,1,0,1
,2011,70400226,,,,2,0,2
,2011,70400233,,,,1,1,2
,2011,70400060,,,,7,8,15
HND-006571,2011,70400063,,,,10,10,20
HND-006573,2011,70400065,,,,4,4,8
,2011,70400066,,,,1,6,7
HND-006574,2011,70400067,,,,2,4,6
HND-006578,2011,70400076,,,,1,2,3
HND-006579,2011,70400078,,,,2,2,4
HND-006582,2011,70400082,,,,0,1,1
,2011,70400083,,,,5,5,10
HND-006596,2011,70400103,,,,12,2,14
HND-006607,2011,70400123,,,,2,1,3
HND-006625,2011,70400223,,,,2,5,7
,2011,70400231,,,,8,9,17
HND-006543,2011,70400030,,,,0,1,1
,2011,70400034,,,,1,7,8
HND-006567,2011,70400056,,,,8,8,16
HND-006568,2011,70400057,,,,2,3,5
HND-006569,2011,70400059,,,,25,32,57
HND-006570,2011,70400062,,,,25,14,39
HND-006572,2011,70400064,,,,10,12,22
HND-006575,2011,70400069,,,,14,10,24
,2011,70400085,,,,6,1,7
HND-006583,2011,70400087,,,,2,2,4
HND-006584,2011,70400088,,,,44,33,77
,2011,70400095,,,,5,3,8
HND-006593,2011,70400100,,,,4,4,8
HND-006608,2011,70400124,,,,2,3,5
,2011,70400126,,,,10,11,21
,2011,70400128,,,,2,3,5
,2011,70400200,,,,2,4,6
HND-006626,2011,70400224,,,,3,3,6
,2011,70400225,,,,7,11,18
,2011,70400226,,,,1,1,2
,2011,70400233,,,,2,2,4
,2011,70400264,,,,2,1,3
HND-006543,2011,70400030,,,,5,4,9
,2011,70400034,,,,5,3,8
HND-006567,2011,70400056,,,,16,18,34
HND-006568,2011,70400057,,,,6,11,17
HND-006569,2011,70400059,,,,34,29,63
,2011,70400060,,,,23,17,40
HND-006571,2011,70400063,,,,18,14,32
HND-006572,2011,70400064,,,,17,18,35
HND-006573,2011,70400065,,,,5,1,6
HND-006575,2011,70400069,,,,19,13,32
,2011,70400085,,,,5,4,9
HND-006583,2011,70400087,,,,3,1,4
HND-006584,2011,70400088,,,,47,42,89
,2011,70400095,,,,5,8,13
HND-006593,2011,70400100,,,,3,6,9
HND-006608,2011,70400124,,,,5,7,12
,2011,70400126,,,,11,8,19
,2011,70400128,,,,3,3,6
HND-006625,2011,70400223,,,,5,5,10
,2011,70400233,,,,6,3,9
HND-006570,2011,70400062,,,,23,20,43
,2011,70400066,,,,3,3,6
HND-006574,2011,70400067,,,,6,4,10
HND-006578,2011,70400076,,,,6,2,8
HND-006579,2011,70400078,,,,8,5,13
HND-006582,2011,70400082,,,,1,4,5
,2011,70400083,,,,3,5,8
HND-006596,2011,70400103,,,,23,21,44
HND-006607,2011,70400123,,,,7,5,12
,2011,70400200,,,,6,1,7
HND-006626,2011,70400224,,,,12,13,25
,2011,70400225,,,,8,5,13
,2011,70400226,,,,3,2,5
,2011,70400231,,,,9,3,12
,2011,70400264,,,,2,2,4
HND-006516,2011,70400002,,,,1,3,4
HND-006518,2011,70400004,,,,1,2,3
HND-006523,2011,70400009,,,,8,10,18
HND-006528,2011,70400014,,,,5,1,6
HND-006530,2011,70400016,,,,7,1,8
HND-006531,2011,70400017,,,,2,1,3
HND-006532,2011,70400018,,,,5,6,11
HND-006535,2011,70400021,,,,12,9,21
HND-006538,2011,70400025,,,,10,6,16
HND-006539,2011,70400026,,,,5,4,9
HND-006540,2011,70400027,,,,1,2,3
HND-006541,2011,70400028,,,,9,7,16
HND-006544,2011,70400031,,,,10,8,18
HND-006548,2011,70400036,,,,24,27,51
HND-006549,2011,70400037,,,,4,7,11
HND-006550,2011,70400038,,,,4,4,8
HND-006554,2011,70400043,,,,7,6,13
HND-006555,2011,70400044,,,,4,1,5
HND-006558,2011,70400047,,,,70,77,147
HND-006560,2011,70400049,,,,5,5,10
HND-006563,2011,70400052,,,,6,7,13
HND-006565,2011,70400054,,,,2,3,5
HND-006573,2011,70400065,,,,9,4,13
HND-006577,2011,70400073,,,,8,7,15
HND-006580,2011,70400080,,,,2,2,4
HND-006581,2011,70400081,,,,7,3,10
HND-006586,2011,70400091,,,,2,10,12
HND-006587,2011,70400092,,,,8,1,9
HND-006588,2011,70400093,,,,7,9,16
HND-006589,2011,70400094,,,,2,8,10
HND-006591,2011,70400098,,,,3,5,8
HND-006592,2011,70400099,,,,2,3,5
HND-006593,2011,70400100,,,,14,13,27
HND-006595,2011,70400102,,,,6,5,11
HND-006597,2011,70400104,,,,6,4,10
HND-006600,2011,70400113,,,,1,1,2
HND-006603,2011,70400119,,,,10,5,15
HND-006605,2011,70400121,,,,6,3,9
HND-006622,2011,70400209,,,,4,8,12
,2011,70400231,,,,19,16,35
HND-006517,2011,70400003,,,,45,46,91
HND-006519,2011,70400005,,,,6,5,11
HND-006520,2011,70400006,,,,5,5,10
HND-006521,2011,70400007,,,,4,4,8
HND-006522,2011,70400008,,,,7,8,15
HND-006524,2011,70400010,,,,7,5,12
HND-006525,2011,70400011,,,,7,7,14
HND-006526,2011,70400012,,,,4,1,5
HND-006527,2011,70400013,,,,3,2,5
HND-006529,2011,70400015,,,,49,55,104
HND-006533,2011,70400019,,,,5,0,5
HND-006534,2011,70400020,,,,7,2,9
HND-006536,2011,70400022,,,,5,7,12
HND-006537,2011,70400023,,,,9,8,17
HND-006542,2011,70400029,,,,11,10,21
HND-006543,2011,70400030,,,,7,6,13
HND-006545,2011,70400032,,,,32,28,60
HND-006546,2011,70400033,,,,15,17,32
,2011,70400034,,,,17,11,28
HND-006547,2011,70400035,,,,33,27,60
HND-006551,2011,70400039,,,,4,3,7
HND-006552,2011,70400040,,,,53,52,105
HND-006553,2011,70400041,,,,8,11,19
HND-006556,2011,70400045,,,,4,4,8
HND-006557,2011,70400046,,,,3,2,5
HND-006559,2011,70400048,,,,4,3,7
HND-006561,2011,70400050,,,,1,8,9
HND-006562,2011,70400051,,,,2,4,6
HND-006566,2011,70400055,,,,8,5,13
,2011,70400074,,,,2,0,2
HND-006582,2011,70400082,,,,1,2,3
HND-006585,2011,70400090,,,,5,3,8
HND-006590,2011,70400096,,,,6,3,9
HND-006594,2011,70400101,,,,4,8,12
,2011,70400106,,,,4,9,13
HND-006599,2011,70400107,,,,8,5,13
,2011,70400112,,,,3,11,14
HND-006604,2011,70400120,,,,3,0,3
HND-006606,2011,70400122,,,,9,3,12
,2011,70400126,,,,10,11,21
HND-006609,2011,70400127,,,,6,6,12
,2011,70400225,,,,21,22,43
HND-006518,2011,70400004,,,,2,0,2
HND-006519,2011,70400005,,,,7,6,13
HND-006520,2011,70400006,,,,5,3,8
HND-006521,2011,70400007,,,,4,3,7
HND-006524,2011,70400010,,,,2,3,5
HND-006525,2011,70400011,,,,7,4,11
HND-006527,2011,70400013,,,,8,3,11
HND-006530,2011,70400016,,,,4,6,10
HND-006532,2011,70400018,,,,7,4,11
HND-006533,2011,70400019,,,,2,3,5
HND-006534,2011,70400020,,,,8,6,14
HND-006535,2011,70400021,,,,6,5,11
HND-006536,2011,70400022,,,,9,9,18
HND-006537,2011,70400023,,,,6,9,15
HND-006541,2011,70400028,,,,7,2,9
HND-006542,2011,70400029,,,,7,6,13
HND-006543,2011,70400030,,,,8,6,14
HND-006544,2011,70400031,,,,10,6,16
HND-006545,2011,70400032,,,,28,22,50
HND-006546,2011,70400033,,,,18,10,28
,2011,70400034,,,,8,12,20
HND-006550,2011,70400038,,,,1,6,7
HND-006551,2011,70400039,,,,3,3,6
HND-006552,2011,70400040,,,,41,42,83
HND-006555,2011,70400044,,,,2,4,6
HND-006556,2011,70400045,,,,7,2,9
HND-006557,2011,70400046,,,,5,4,9
HND-006566,2011,70400055,,,,10,4,14
HND-006573,2011,70400065,,,,13,1,14
HND-006581,2011,70400081,,,,2,0,2
HND-006582,2011,70400082,,,,2,2,4
HND-006587,2011,70400092,,,,4,5,9
HND-006588,2011,70400093,,,,3,6,9
HND-006592,2011,70400099,,,,1,2,3
HND-006594,2011,70400101,,,,5,2,7
HND-006595,2011,70400102,,,,1,2,3
HND-006597,2011,70400104,,,,3,2,5
,2011,70400106,,,,7,4,11
HND-006599,2011,70400107,,,,4,6,10
HND-006600,2011,70400113,,,,3,3,6
HND-006603,2011,70400119,,,,11,8,19
HND-006605,2011,70400121,,,,1,4,5
,2011,70400126,,,,8,9,17
HND-006622,2011,70400209,,,,2,4,6
HND-006516,2011,70400002,,,,2,2,4
HND-006517,2011,70400003,,,,43,41,84
HND-006522,2011,70400008,,,,5,9,14
HND-006523,2011,70400009,,,,6,5,11
HND-006526,2011,70400012,,,,0,2,2
HND-006528,2011,70400014,,,,3,3,6
HND-006529,2011,70400015,,,,44,67,111
HND-006531,2011,70400017,,,,4,3,7
HND-006538,2011,70400025,,,,7,6,13
HND-006539,2011,70400026,,,,5,8,13
HND-006540,2011,70400027,,,,5,3,8
HND-006547,2011,70400035,,,,36,34,70
HND-006548,2011,70400036,,,,28,19,47
HND-006549,2011,70400037,,,,5,4,9
HND-006553,2011,70400041,,,,7,6,13
HND-006554,2011,70400043,,,,3,3,6
HND-006558,2011,70400047,,,,71,77,148
HND-006559,2011,70400048,,,,3,1,4
HND-006560,2011,70400049,,,,4,3,7
HND-006561,2011,70400050,,,,6,6,12
HND-006562,2011,70400051,,,,1,7,8
HND-006563,2011,70400052,,,,7,10,17
HND-006564,2011,70400053,,,,2,1,3
HND-006565,2011,70400054,,,,2,4,6
HND-006577,2011,70400073,,,,9,5,14
,2011,70400074,,,,2,4,6
HND-006580,2011,70400080,,,,4,3,7
HND-006585,2011,70400090,,,,4,6,10
HND-006586,2011,70400091,,,,6,3,9
HND-006589,2011,70400094,,,,2,1,3
HND-006590,2011,70400096,,,,1,2,3
HND-006591,2011,70400098,,,,2,2,4
HND-006593,2011,70400100,,,,6,8,14
,2011,70400112,,,,2,2,4
HND-006604,2011,70400120,,,,0,6,6
HND-006606,2011,70400122,,,,5,4,9
,2011,70400225,,,,22,13,35
,2011,70400231,,,,12,11,23
HND-006517,2011,70400003,,,,31,42,73
HND-006518,2011,70400004,,,,5,0,5
HND-006519,2011,70400005,,,,2,6,8
HND-006520,2011,70400006,,,,4,3,7
HND-006521,2011,70400007,,,,3,1,4
HND-006522,2011,70400008,,,,6,4,10
HND-006524,2011,70400010,,,,6,4,10
HND-006525,2011,70400011,,,,3,3,6
HND-006526,2011,70400012,,,,2,2,4
HND-006527,2011,70400013,,,,5,5,10
HND-006529,2011,70400015,,,,46,46,92
HND-006532,2011,70400018,,,,3,4,7
HND-006533,2011,70400019,,,,3,6,9
HND-006534,2011,70400020,,,,6,4,10
HND-006536,2011,70400022,,,,6,8,14
HND-006537,2011,70400023,,,,7,6,13
HND-006542,2011,70400029,,,,14,13,27
HND-006543,2011,70400030,,,,4,6,10
HND-006545,2011,70400032,,,,29,26,55
HND-006546,2011,70400033,,,,24,16,40
,2011,70400034,,,,10,4,14
HND-006547,2011,70400035,,,,22,24,46
HND-006551,2011,70400039,,,,3,4,7
HND-006552,2011,70400040,,,,32,34,66
HND-006555,2011,70400044,,,,5,3,8
HND-006556,2011,70400045,,,,2,1,3
HND-006557,2011,70400046,,,,8,2,10
HND-006559,2011,70400048,,,,2,5,7
HND-006562,2011,70400051,,,,0,4,4
HND-006566,2011,70400055,,,,6,5,11
,2011,70400074,,,,1,3,4
HND-006582,2011,70400082,,,,4,1,5
HND-006585,2011,70400090,,,,6,5,11
HND-006590,2011,70400096,,,,0,1,1
HND-006594,2011,70400101,,,,2,2,4
,2011,70400106,,,,6,6,12
HND-006599,2011,70400107,,,,3,8,11
,2011,70400112,,,,2,0,2
HND-006604,2011,70400120,,,,2,2,4
HND-006606,2011,70400122,,,,8,5,13
,2011,70400126,,,,13,6,19
HND-006609,2011,70400127,,,,3,3,6
HND-006622,2011,70400209,,,,4,2,6
HND-006516,2011,70400002,,,,0,3,3
HND-006523,2011,70400009,,,,10,8,18
HND-006528,2011,70400014,,,,11,3,14
HND-006530,2011,70400016,,,,9,3,12
HND-006531,2011,70400017,,,,6,0,6
HND-006535,2011,70400021,,,,5,6,11
HND-006538,2011,70400025,,,,9,9,18
HND-006539,2011,70400026,,,,2,3,5
HND-006540,2011,70400027,,,,3,0,3
HND-006541,2011,70400028,,,,9,8,17
HND-006544,2011,70400031,,,,8,8,16
HND-006548,2011,70400036,,,,13,12,25
HND-006549,2011,70400037,,,,3,5,8
HND-006550,2011,70400038,,,,3,2,5
HND-006553,2011,70400041,,,,12,3,15
HND-006554,2011,70400043,,,,2,4,6
HND-006558,2011,70400047,,,,77,61,138
HND-006560,2011,70400049,,,,2,1,3
HND-006561,2011,70400050,,,,4,5,9
HND-006563,2011,70400052,,,,3,1,4
HND-006564,2011,70400053,,,,2,2,4
HND-006565,2011,70400054,,,,2,2,4
HND-006573,2011,70400065,,,,7,6,13
HND-006577,2011,70400073,,,,3,8,11
HND-006580,2011,70400080,,,,2,2,4
HND-006581,2011,70400081,,,,3,0,3
HND-006586,2011,70400091,,,,4,3,7
HND-006587,2011,70400092,,,,6,3,9
HND-006588,2011,70400093,,,,7,2,9
HND-006589,2011,70400094,,,,1,0,1
HND-006591,2011,70400098,,,,2,2,4
HND-006592,2011,70400099,,,,1,3,4
HND-006593,2011,70400100,,,,8,4,12
HND-006595,2011,70400102,,,,3,2,5
HND-006597,2011,70400104,,,,7,2,9
HND-006600,2011,70400113,,,,1,0,1
HND-006603,2011,70400119,,,,2,4,6
HND-006605,2011,70400121,,,,4,3,7
,2011,70400225,,,,18,13,31
,2011,70400226,,,,2,1,3
,2011,70400231,,,,6,11,17
HND-006516,2011,70400002,,,,3,5,8
HND-006518,2011,70400004,,,,0,2,2
HND-006521,2011,70400007,,,,3,3,6
HND-006523,2011,70400009,,,,4,8,12
HND-006525,2011,70400011,,,,5,5,10
HND-006530,2011,70400016,,,,5,5,10
HND-006531,2011,70400017,,,,2,2,4
HND-006532,2011,70400018,,,,9,4,13
HND-006534,2011,70400020,,,,3,6,9
HND-006535,2011,70400021,,,,8,6,14
HND-006537,2011,70400023,,,,5,6,11
HND-006538,2011,70400025,,,,3,11,14
HND-006539,2011,70400026,,,,7,3,10
HND-006541,2011,70400028,,,,10,3,13
HND-006543,2011,70400030,,,,6,6,12
HND-006544,2011,70400031,,,,3,11,14
HND-006546,2011,70400033,,,,19,17,36
,2011,70400034,,,,7,9,16
HND-006548,2011,70400036,,,,15,16,31
HND-006550,2011,70400038,,,,5,2,7
HND-006551,2011,70400039,,,,2,3,5
HND-006554,2011,70400043,,,,3,4,7
HND-006555,2011,70400044,,,,0,3,3
HND-006558,2011,70400047,,,,82,96,178
HND-006560,2011,70400049,,,,0,3,3
HND-006565,2011,70400054,,,,1,1,2
HND-006566,2011,70400055,,,,7,3,10
HND-006573,2011,70400065,,,,8,5,13
HND-006581,2011,70400081,,,,0,1,1
HND-006582,2011,70400082,,,,0,4,4
HND-006587,2011,70400092,,,,1,3,4
HND-006588,2011,70400093,,,,2,2,4
HND-006592,2011,70400099,,,,0,2,2
HND-006593,2011,70400100,,,,4,10,14
HND-006594,2011,70400101,,,,3,5,8
HND-006595,2011,70400102,,,,5,1,6
HND-006597,2011,70400104,,,,3,2,5
,2011,70400106,,,,6,9,15
HND-006599,2011,70400107,,,,7,5,12
HND-006600,2011,70400113,,,,1,2,3
HND-006603,2011,70400119,,,,7,8,15
HND-006605,2011,70400121,,,,4,2,6
,2011,70400126,,,,5,7,12
HND-006517,2011,70400003,,,,30,23,53
HND-006519,2011,70400005,,,,7,9,16
HND-006520,2011,70400006,,,,5,2,7
HND-006522,2011,70400008,,,,5,8,13
HND-006524,2011,70400010,,,,4,3,7
HND-006526,2011,70400012,,,,2,2,4
HND-006527,2011,70400013,,,,3,5,8
HND-006528,2011,70400014,,,,3,5,8
HND-006529,2011,70400015,,,,57,56,113
HND-006533,2011,70400019,,,,4,4,8
HND-006536,2011,70400022,,,,9,3,12
HND-006540,2011,70400027,,,,9,2,11
HND-006542,2011,70400029,,,,6,10,16
HND-006545,2011,70400032,,,,24,26,50
HND-006547,2011,70400035,,,,23,23,46
HND-006549,2011,70400037,,,,6,6,12
HND-006552,2011,70400040,,,,36,48,84
HND-006553,2011,70400041,,,,5,5,10
HND-006556,2011,70400045,,,,6,1,7
HND-006557,2011,70400046,,,,4,1,5
HND-006559,2011,70400048,,,,4,0,4
HND-006561,2011,70400050,,,,3,2,5
HND-006562,2011,70400051,,,,5,2,7
HND-006563,2011,70400052,,,,4,0,4
HND-006564,2011,70400053,,,,0,1,1
HND-006577,2011,70400073,,,,8,6,14
HND-006580,2011,70400080,,,,2,1,3
HND-006585,2011,70400090,,,,3,5,8
HND-006586,2011,70400091,,,,5,6,11
HND-006590,2011,70400096,,,,3,1,4
HND-006591,2011,70400098,,,,1,4,5
,2011,70400112,,,,1,0,1
HND-006604,2011,70400120,,,,6,2,8
HND-006606,2011,70400122,,,,2,5,7
HND-006609,2011,70400127,,,,1,1,2
HND-006622,2011,70400209,,,,4,1,5
,2011,70400225,,,,8,10,18
,2011,70400231,,,,5,9,14
HND-006516,2011,70400002,,,,3,0,3
HND-006518,2011,70400004,,,,0,2,2
HND-006523,2011,70400009,,,,7,7,14
HND-006525,2011,70400011,,,,6,3,9
HND-006530,2011,70400016,,,,8,6,14
HND-006531,2011,70400017,,,,4,7,11
HND-006532,2011,70400018,,,,2,3,5
HND-006535,2011,70400021,,,,18,11,29
HND-006538,2011,70400025,,,,4,4,8
HND-006539,2011,70400026,,,,3,6,9
HND-006540,2011,70400027,,,,7,2,9
HND-006541,2011,70400028,,,,11,9,20
HND-006544,2011,70400031,,,,8,11,19
HND-006548,2011,70400036,,,,9,9,18
HND-006549,2011,70400037,,,,7,7,14
HND-006550,2011,70400038,,,,4,4,8
HND-006554,2011,70400043,,,,1,2,3
HND-006555,2011,70400044,,,,3,5,8
HND-006558,2011,70400047,,,,95,87,182
HND-006560,2011,70400049,,,,0,4,4
HND-006563,2011,70400052,,,,3,2,5
HND-006565,2011,70400054,,,,1,0,1
HND-006566,2011,70400055,,,,1,5,6
HND-006573,2011,70400065,,,,5,2,7
HND-006577,2011,70400073,,,,3,4,7
HND-006581,2011,70400081,,,,0,2,2
HND-006586,2011,70400091,,,,4,4,8
HND-006587,2011,70400092,,,,2,6,8
HND-006588,2011,70400093,,,,5,4,9
HND-006591,2011,70400098,,,,2,0,2
HND-006592,2011,70400099,,,,5,4,9
HND-006593,2011,70400100,,,,6,4,10
HND-006594,2011,70400101,,,,6,3,9
HND-006595,2011,70400102,,,,8,0,8
HND-006597,2011,70400104,,,,1,4,5
HND-006599,2011,70400107,,,,4,8,12
HND-006600,2011,70400113,,,,2,3,5
HND-006603,2011,70400119,,,,6,6,12
HND-006605,2011,70400121,,,,0,1,1
,2011,70400126,,,,2,8,10
,2011,70400231,,,,15,12,27
HND-006517,2011,70400003,,,,33,34,67
HND-006519,2011,70400005,,,,8,10,18
HND-006520,2011,70400006,,,,4,4,8
HND-006521,2011,70400007,,,,3,4,7
HND-006522,2011,70400008,,,,9,5,14
HND-006524,2011,70400010,,,,3,3,6
HND-006526,2011,70400012,,,,1,1,2
HND-006527,2011,70400013,,,,4,2,6
HND-006528,2011,70400014,,,,7,3,10
HND-006529,2011,70400015,,,,57,62,119
HND-006533,2011,70400019,,,,4,8,12
HND-006534,2011,70400020,,,,3,8,11
HND-006536,2011,70400022,,,,3,7,10
HND-006537,2011,70400023,,,,5,4,9
HND-006542,2011,70400029,,,,10,16,26
HND-006543,2011,70400030,,,,5,1,6
HND-006545,2011,70400032,,,,23,25,48
HND-006546,2011,70400033,,,,24,26,50
,2011,70400034,,,,11,13,24
HND-006547,2011,70400035,,,,24,28,52
HND-006551,2011,70400039,,,,4,3,7
HND-006552,2011,70400040,,,,15,33,48
HND-006553,2011,70400041,,,,4,5,9
HND-006556,2011,70400045,,,,4,3,7
HND-006557,2011,70400046,,,,3,4,7
HND-006559,2011,70400048,,,,4,6,10
HND-006561,2011,70400050,,,,6,0,6
HND-006562,2011,70400051,,,,3,3,6
HND-006564,2011,70400053,,,,1,1,2
,2011,70400074,,,,1,1,2
HND-006580,2011,70400080,,,,1,1,2
HND-006582,2011,70400082,,,,2,1,3
HND-006585,2011,70400090,,,,2,5,7
HND-006590,2011,70400096,,,,2,3,5
,2011,70400106,,,,5,6,11
,2011,70400112,,,,1,1,2
HND-006604,2011,70400120,,,,1,3,4
HND-006606,2011,70400122,,,,3,1,4
HND-006609,2011,70400127,,,,3,1,4
HND-006622,2011,70400209,,,,0,1,1
,2011,70400225,,,,12,10,22
HND-006516,2011,70400002,,,,5,2,7
HND-006517,2011,70400003,,,,30,30,60
HND-006522,2011,70400008,,,,4,1,5
HND-006523,2011,70400009,,,,11,2,13
HND-006526,2011,70400012,,,,2,1,3
HND-006528,2011,70400014,,,,1,2,3
HND-006529,2011,70400015,,,,59,56,115
HND-006530,2011,70400016,,,,7,1,8
HND-006531,2011,70400017,,,,4,4,8
HND-006538,2011,70400025,,,,6,5,11
HND-006539,2011,70400026,,,,2,3,5
HND-006540,2011,70400027,,,,4,3,7
HND-006547,2011,70400035,,,,31,25,56
HND-006548,2011,70400036,,,,12,5,17
HND-006549,2011,70400037,,,,4,5,9
HND-006553,2011,70400041,,,,12,3,15
HND-006554,2011,70400043,,,,2,1,3
HND-006558,2011,70400047,,,,90,97,187
HND-006559,2011,70400048,,,,4,3,7
HND-006560,2011,70400049,,,,3,1,4
HND-006561,2011,70400050,,,,10,10,20
HND-006562,2011,70400051,,,,1,1,2
HND-006563,2011,70400052,,,,1,0,1
HND-006565,2011,70400054,,,,2,4,6
HND-006577,2011,70400073,,,,3,12,15
,2011,70400074,,,,4,2,6
HND-006580,2011,70400080,,,,4,4,8
HND-006585,2011,70400090,,,,5,1,6
HND-006586,2011,70400091,,,,4,3,7
HND-006590,2011,70400096,,,,2,2,4
HND-006591,2011,70400098,,,,2,0,2
HND-006593,2011,70400100,,,,5,5,10
HND-006604,2011,70400120,,,,2,4,6
HND-006606,2011,70400122,,,,6,0,6
,2011,70400225,,,,12,18,30
,2011,70400226,,,,1,1,2
,2011,70400231,,,,7,7,14
HND-006518,2011,70400004,,,,3,1,4
HND-006519,2011,70400005,,,,4,6,10
HND-006520,2011,70400006,,,,1,8,9
HND-006521,2011,70400007,,,,6,2,8
HND-006524,2011,70400010,,,,1,5,6
HND-006525,2011,70400011,,,,8,7,15
HND-006527,2011,70400013,,,,1,4,5
HND-006532,2011,70400018,,,,4,4,8
HND-006533,2011,70400019,,,,2,3,5
HND-006534,2011,70400020,,,,2,4,6
HND-006535,2011,70400021,,,,5,6,11
HND-006536,2011,70400022,,,,2,9,11
HND-006537,2011,70400023,,,,4,3,7
HND-006541,2011,70400028,,,,8,8,16
HND-006542,2011,70400029,,,,13,9,22
HND-006543,2011,70400030,,,,4,6,10
HND-006544,2011,70400031,,,,11,11,22
HND-006545,2011,70400032,,,,21,17,38
HND-006546,2011,70400033,,,,10,22,32
,2011,70400034,,,,11,12,23
HND-006550,2011,70400038,,,,2,4,6
HND-006551,2011,70400039,,,,4,4,8
HND-006552,2011,70400040,,,,28,44,72
HND-006555,2011,70400044,,,,3,2,5
HND-006556,2011,70400045,,,,2,0,2
HND-006557,2011,70400046,,,,1,3,4
HND-006566,2011,70400055,,,,5,4,9
HND-006573,2011,70400065,,,,6,5,11
HND-006582,2011,70400082,,,,2,3,5
HND-006587,2011,70400092,,,,1,4,5
HND-006588,2011,70400093,,,,6,3,9
HND-006592,2011,70400099,,,,0,2,2
HND-006594,2011,70400101,,,,2,1,3
HND-006595,2011,70400102,,,,2,4,6
HND-006597,2011,70400104,,,,2,3,5
,2011,70400106,,,,3,4,7
HND-006599,2011,70400107,,,,4,9,13
HND-006600,2011,70400113,,,,2,2,4
HND-006603,2011,70400119,,,,3,7,10
HND-006605,2011,70400121,,,,3,4,7
,2011,70400126,,,,9,4,13
HND-006609,2011,70400127,,,,0,2,2
HND-006622,2011,70400209,,,,1,2,3
HND-006549,2011,70400037,,,,9,7,16
HND-006601,2011,70400117,,,,228,224,452
HND-006603,2011,70400119,,,,3,4,7
HND-006610,2011,70400129,,,,47,57,104
HND-006621,2011,70400208,,,,119,102,221
HND-006542,2011,70400029,,,,18,12,30
HND-006543,2011,70400030,,,,9,18,27
HND-006545,2011,70400032,,,,29,16,45
HND-006552,2011,70400040,,,,19,21,40
HND-006576,2011,70400071,,,,34,24,58
,2011,70400225,,,,32,61,93
HND-006542,2011,70400029,,,,16,17,33
HND-006543,2011,70400030,,,,14,14,28
HND-006545,2011,70400032,,,,14,14,28
HND-006552,2011,70400040,,,,5,18,23
HND-006576,2011,70400071,,,,34,35,69
HND-006601,2011,70400117,,,,170,194,364
HND-006603,2011,70400119,,,,1,8,9
HND-006549,2011,70400037,,,,9,7,16
HND-006610,2011,70400129,,,,40,72,112
HND-006621,2011,70400208,,,,74,78,152
,2011,70400225,,,,28,58,86
HND-006542,2011,70400029,,,,10,18,28
HND-006543,2011,70400030,,,,11,20,31
HND-006603,2011,70400119,,,,1,8,9
HND-006621,2011,70400208,,,,59,77,136
HND-006545,2011,70400032,,,,14,27,41
HND-006549,2011,70400037,,,,9,5,14
HND-006552,2011,70400040,,,,13,17,30
HND-006576,2011,70400071,,,,21,24,45
HND-006601,2011,70400117,,,,182,154,336
HND-006610,2011,70400129,,,,51,48,99
,2011,70400225,,,,47,65,112
HND-006601,2011,70400117,,,,208,137,345
HND-006610,2011,70400129,,,,71,62,133
,2011,70400225,,,,57,85,142
HND-006576,2011,70400071,,,,17,11,28
HND-006621,2011,70400208,,,,72,136,208
HND-006576,2011,70400071,,,,9,10,19
HND-006601,2011,70400117,,,,171,123,294
HND-006610,2011,70400129,,,,37,61,98
,2011,70400225,,,,31,41,72
HND-006621,2011,70400208,,,,44,91,135
HND-006576,2011,70400071,,,,7,9,16
HND-006621,2011,70400208,,,,11,48,59
HND-006601,2011,70400117,,,,114,88,202
,2011,70400225,,,,10,7,17
,2011,70500046,,,,4,8,12
,2011,70500047,,,,10,3,13
,2011,70500018,,,,8,3,11
,2011,70500024,,,,5,5,10
,2011,70500043,,,,3,2,5
HND-006666,2011,70500044,,,,6,10,16
HND-006663,2011,70500025,,,,7,8,15
HND-006664,2011,70500026,,,,9,5,14
HND-006658,2011,70500014,,,,1,1,2
HND-006662,2011,70500023,,,,4,9,13
HND-006662,2011,70500023,,,,6,7,13
HND-006663,2011,70500025,,,,9,17,26
HND-006664,2011,70500026,,,,19,17,36
HND-006658,2011,70500014,,,,4,6,10
,2011,70500022,,,,4,3,7
HND-006646,2011,70500002,,,,2,11,13
HND-006647,2011,70500003,,,,10,5,15
HND-006648,2011,70500004,,,,2,4,6
HND-006653,2011,70500009,,,,5,3,8
HND-006655,2011,70500011,,,,3,3,6
HND-006661,2011,70500017,,,,4,3,7
HND-006645,2011,70500001,,,,34,40,74
HND-006649,2011,70500005,,,,0,4,4
HND-006650,2011,70500006,,,,8,5,13
HND-006651,2011,70500007,,,,15,20,35
HND-006652,2011,70500008,,,,1,4,5
HND-006654,2011,70500010,,,,1,1,2
HND-006656,2011,70500012,,,,5,1,6
HND-006657,2011,70500013,,,,10,7,17
HND-006665,2011,70500042,,,,4,5,9
HND-006645,2011,70500001,,,,39,28,67
HND-006646,2011,70500002,,,,8,6,14
HND-006648,2011,70500004,,,,1,3,4
HND-006649,2011,70500005,,,,1,6,7
HND-006650,2011,70500006,,,,9,4,13
HND-006651,2011,70500007,,,,23,17,40
HND-006654,2011,70500010,,,,0,2,2
HND-006655,2011,70500011,,,,4,10,14
HND-006656,2011,70500012,,,,1,1,2
HND-006657,2011,70500013,,,,6,6,12
HND-006647,2011,70500003,,,,5,7,12
HND-006652,2011,70500008,,,,0,1,1
HND-006653,2011,70500009,,,,0,1,1
HND-006661,2011,70500017,,,,1,3,4
HND-006665,2011,70500042,,,,5,5,10
HND-006645,2011,70500001,,,,32,28,60
HND-006648,2011,70500004,,,,5,2,7
HND-006649,2011,70500005,,,,2,3,5
HND-006650,2011,70500006,,,,5,0,5
HND-006651,2011,70500007,,,,17,17,34
HND-006654,2011,70500010,,,,7,2,9
HND-006657,2011,70500013,,,,5,8,13
HND-006667,2011,70500045,,,,1,1,2
HND-006646,2011,70500002,,,,2,3,5
HND-006647,2011,70500003,,,,9,11,20
HND-006652,2011,70500008,,,,2,2,4
HND-006653,2011,70500009,,,,0,7,7
HND-006655,2011,70500011,,,,4,3,7
HND-006661,2011,70500017,,,,3,1,4
HND-006665,2011,70500042,,,,5,2,7
HND-006645,2011,70500001,,,,39,26,65
HND-006646,2011,70500002,,,,9,7,16
HND-006647,2011,70500003,,,,11,9,20
HND-006648,2011,70500004,,,,2,4,6
HND-006653,2011,70500009,,,,1,5,6
HND-006654,2011,70500010,,,,5,2,7
HND-006655,2011,70500011,,,,11,10,21
HND-006657,2011,70500013,,,,16,6,22
HND-006665,2011,70500042,,,,3,5,8
HND-006649,2011,70500005,,,,8,0,8
HND-006650,2011,70500006,,,,9,8,17
HND-006651,2011,70500007,,,,22,19,41
HND-006652,2011,70500008,,,,3,2,5
HND-006661,2011,70500017,,,,0,7,7
HND-006667,2011,70500045,,,,3,4,7
HND-006646,2011,70500002,,,,8,6,14
HND-006647,2011,70500003,,,,8,5,13
HND-006648,2011,70500004,,,,0,4,4
HND-006653,2011,70500009,,,,4,3,7
HND-006654,2011,70500010,,,,4,3,7
HND-006655,2011,70500011,,,,7,1,8
HND-006665,2011,70500042,,,,7,4,11
HND-006645,2011,70500001,,,,33,39,72
HND-006649,2011,70500005,,,,3,6,9
HND-006650,2011,70500006,,,,4,6,10
HND-006651,2011,70500007,,,,19,13,32
HND-006652,2011,70500008,,,,8,4,12
HND-006656,2011,70500012,,,,0,1,1
HND-006657,2011,70500013,,,,9,6,15
HND-006661,2011,70500017,,,,5,1,6
HND-006647,2011,70500003,,,,3,11,14
HND-006652,2011,70500008,,,,4,2,6
HND-006653,2011,70500009,,,,3,3,6
HND-006661,2011,70500017,,,,5,4,9
HND-006665,2011,70500042,,,,1,3,4
HND-006645,2011,70500001,,,,29,37,66
HND-006646,2011,70500002,,,,4,12,16
HND-006648,2011,70500004,,,,2,4,6
HND-006649,2011,70500005,,,,2,2,4
HND-006650,2011,70500006,,,,4,12,16
HND-006651,2011,70500007,,,,22,18,40
HND-006654,2011,70500010,,,,4,2,6
HND-006655,2011,70500011,,,,5,2,7
HND-006656,2011,70500012,,,,2,1,3
HND-006657,2011,70500013,,,,7,6,13
HND-006667,2011,70500045,,,,1,0,1
HND-006646,2011,70500002,,,,10,12,22
HND-006647,2011,70500003,,,,6,6,12
,2011,70500048,,,,21,15,36
HND-006651,2011,70500007,,,,14,18,32
HND-006659,2011,70500015,,,,29,45,74
HND-006646,2011,70500002,,,,10,8,18
HND-006651,2011,70500007,,,,5,18,23
HND-006659,2011,70500015,,,,30,33,63
HND-006647,2011,70500003,,,,5,3,8
,2011,70500048,,,,12,10,22
HND-006646,2011,70500002,,,,7,8,15
HND-006647,2011,70500003,,,,8,10,18
HND-006651,2011,70500007,,,,14,8,22
HND-006659,2011,70500015,,,,35,30,65
,2011,70500048,,,,14,9,23
HND-006659,2011,70500015,,,,33,26,59
,2011,70500048,,,,5,6,11
HND-006659,2011,70500015,,,,18,26,44
,2011,70500048,,,,6,2,8
HND-006659,2011,70500015,,,,8,11,19
HND-006676,2011,70600009,,,,4,1,5
HND-006671,2011,70600004,,,,5,4,9
HND-006672,2011,70600005,,,,2,2,4
HND-006676,2011,70600009,,,,4,7,11
HND-006671,2011,70600004,,,,14,10,24
HND-006672,2011,70600005,,,,10,8,18
HND-006675,2011,70600008,,,,8,3,11
HND-006676,2011,70600009,,,,10,6,16
HND-006674,2011,70600007,,,,5,1,6
HND-006668,2011,70600001,,,,11,9,20
HND-006669,2011,70600002,,,,21,28,49
HND-006677,2011,70600010,,,,3,0,3
HND-006670,2011,70600003,,,,4,2,6
HND-006668,2011,70600001,,,,7,7,14
HND-006670,2011,70600003,,,,5,3,8
HND-006669,2011,70600002,,,,28,26,54
HND-006677,2011,70600010,,,,1,3,4
HND-006670,2011,70600003,,,,5,8,13
HND-006668,2011,70600001,,,,7,5,12
HND-006669,2011,70600002,,,,27,30,57
HND-006677,2011,70600010,,,,1,0,1
HND-006668,2011,70600001,,,,0,8,8
HND-006669,2011,70600002,,,,25,30,55
HND-006670,2011,70600003,,,,4,3,7
HND-006677,2011,70600010,,,,1,2,3
HND-006668,2011,70600001,,,,2,4,6
HND-006669,2011,70600002,,,,32,30,62
HND-006670,2011,70600003,,,,4,5,9
HND-006668,2011,70600001,,,,4,1,5
HND-006670,2011,70600003,,,,3,4,7
HND-006669,2011,70600002,,,,25,29,54
HND-006677,2011,70600010,,,,2,2,4
HND-006673,2011,70600006,,,,36,38,74
HND-006673,2011,70600006,,,,32,28,60
HND-006673,2011,70600006,,,,24,29,53
HND-006673,2011,70600006,,,,32,18,50
HND-006673,2011,70600006,,,,14,9,23
HND-006673,2011,70600006,,,,13,12,25
,2011,70700080,,,,10,6,16
,2011,70700081,,,,7,4,11
HND-006711,2011,70700089,,,,7,5,12
HND-006713,2011,70700092,,,,10,4,14
HND-006714,2011,70700093,,,,4,3,7
,2011,70700079,,,,13,8,21
HND-006708,2011,70700084,,,,8,11,19
,2011,70700085,,,,6,4,10
,2011,70700086,,,,6,7,13
HND-006709,2011,70700087,,,,10,10,20
HND-006710,2011,70700088,,,,7,8,15
HND-006715,2011,70700094,,,,4,8,12
HND-006716,2011,70700095,,,,5,5,10
HND-006717,2011,70700096,,,,4,7,11
HND-006679,2011,70700004,,,,3,11,14
HND-006701,2011,70700027,,,,3,2,5
HND-006704,2011,70700030,,,,7,5,12
,2011,70700032,,,,3,4,7
HND-006706,2011,70700033,,,,3,6,9
HND-006705,2011,70700031,,,,5,10,15
,2011,70700037,,,,2,4,6
HND-006701,2011,70700027,,,,11,10,21
HND-006704,2011,70700030,,,,5,1,6
HND-006705,2011,70700031,,,,12,7,19
,2011,70700032,,,,4,6,10
HND-006706,2011,70700033,,,,3,5,8
HND-006679,2011,70700004,,,,11,11,22
,2011,70700037,,,,6,3,9
HND-006682,2011,70700007,,,,2,5,7
HND-006687,2011,70700012,,,,6,8,14
HND-006688,2011,70700013,,,,10,17,27
HND-006689,2011,70700014,,,,12,9,21
HND-006692,2011,70700017,,,,9,4,13
HND-006694,2011,70700019,,,,5,13,18
HND-006695,2011,70700020,,,,15,10,25
HND-006696,2011,70700021,,,,5,2,7
HND-006697,2011,70700022,,,,4,1,5
HND-006698,2011,70700023,,,,6,7,13
HND-006700,2011,70700025,,,,25,20,45
HND-006703,2011,70700029,,,,3,1,4
HND-006712,2011,70700091,,,,6,6,12
HND-006678,2011,70700001,,,,5,5,10
HND-006680,2011,70700005,,,,17,17,34
HND-006681,2011,70700006,,,,5,7,12
HND-006683,2011,70700008,,,,5,2,7
HND-006684,2011,70700009,,,,6,9,15
HND-006685,2011,70700010,,,,1,5,6
HND-006686,2011,70700011,,,,8,6,14
HND-006690,2011,70700015,,,,3,2,5
HND-006691,2011,70700016,,,,4,4,8
HND-006693,2011,70700018,,,,5,10,15
HND-006699,2011,70700024,,,,11,16,27
HND-006704,2011,70700030,,,,8,11,19
HND-006706,2011,70700033,,,,10,13,23
HND-006707,2011,70700038,,,,8,7,15
HND-006678,2011,70700001,,,,3,2,5
HND-006680,2011,70700005,,,,8,8,16
HND-006681,2011,70700006,,,,3,8,11
HND-006682,2011,70700007,,,,4,3,7
HND-006683,2011,70700008,,,,3,3,6
HND-006690,2011,70700015,,,,3,1,4
HND-006691,2011,70700016,,,,7,1,8
HND-006692,2011,70700017,,,,5,1,6
HND-006693,2011,70700018,,,,9,3,12
HND-006699,2011,70700024,,,,8,20,28
HND-006700,2011,70700025,,,,24,19,43
HND-006703,2011,70700029,,,,1,6,7
HND-006704,2011,70700030,,,,6,6,12
HND-006706,2011,70700033,,,,2,2,4
HND-006684,2011,70700009,,,,7,7,14
HND-006685,2011,70700010,,,,1,1,2
HND-006686,2011,70700011,,,,13,1,14
HND-006687,2011,70700012,,,,12,6,18
HND-006688,2011,70700013,,,,16,12,28
HND-006689,2011,70700014,,,,11,11,22
HND-006694,2011,70700019,,,,3,2,5
HND-006695,2011,70700020,,,,10,8,18
HND-006696,2011,70700021,,,,2,5,7
HND-006698,2011,70700023,,,,4,2,6
HND-006707,2011,70700038,,,,2,3,5
HND-006712,2011,70700091,,,,2,6,8
HND-006678,2011,70700001,,,,3,4,7
HND-006680,2011,70700005,,,,6,6,12
HND-006681,2011,70700006,,,,1,5,6
HND-006683,2011,70700008,,,,3,2,5
HND-006686,2011,70700011,,,,8,6,14
HND-006690,2011,70700015,,,,2,3,5
HND-006691,2011,70700016,,,,3,4,7
HND-006692,2011,70700017,,,,4,5,9
HND-006693,2011,70700018,,,,9,2,11
HND-006699,2011,70700024,,,,11,6,17
HND-006700,2011,70700025,,,,22,21,43
HND-006704,2011,70700030,,,,7,8,15
HND-006707,2011,70700038,,,,6,4,10
HND-006712,2011,70700091,,,,3,3,6
HND-006682,2011,70700007,,,,4,3,7
HND-006684,2011,70700009,,,,12,8,20
HND-006685,2011,70700010,,,,5,2,7
HND-006687,2011,70700012,,,,9,3,12
HND-006688,2011,70700013,,,,9,5,14
HND-006689,2011,70700014,,,,10,7,17
HND-006694,2011,70700019,,,,2,3,5
HND-006695,2011,70700020,,,,5,4,9
HND-006696,2011,70700021,,,,4,5,9
HND-006697,2011,70700022,,,,2,2,4
HND-006698,2011,70700023,,,,2,2,4
HND-006703,2011,70700029,,,,2,5,7
HND-006706,2011,70700033,,,,2,3,5
HND-006680,2011,70700005,,,,6,1,7
HND-006681,2011,70700006,,,,4,6,10
HND-006682,2011,70700007,,,,3,0,3
HND-006689,2011,70700014,,,,6,15,21
HND-006690,2011,70700015,,,,2,2,4
HND-006691,2011,70700016,,,,7,3,10
HND-006692,2011,70700017,,,,5,8,13
HND-006695,2011,70700020,,,,6,6,12
HND-006697,2011,70700022,,,,5,0,5
HND-006698,2011,70700023,,,,1,4,5
HND-006699,2011,70700024,,,,8,11,19
HND-006700,2011,70700025,,,,30,31,61
HND-006703,2011,70700029,,,,3,0,3
HND-006704,2011,70700030,,,,7,4,11
HND-006706,2011,70700033,,,,4,5,9
HND-006707,2011,70700038,,,,3,4,7
HND-006678,2011,70700001,,,,7,1,8
HND-006683,2011,70700008,,,,6,3,9
HND-006684,2011,70700009,,,,4,2,6
HND-006685,2011,70700010,,,,7,4,11
HND-006686,2011,70700011,,,,5,3,8
HND-006687,2011,70700012,,,,12,8,20
HND-006688,2011,70700013,,,,6,1,7
HND-006693,2011,70700018,,,,2,7,9
HND-006694,2011,70700019,,,,7,2,9
HND-006696,2011,70700021,,,,2,5,7
HND-006712,2011,70700091,,,,4,2,6
HND-006680,2011,70700005,,,,11,11,22
HND-006681,2011,70700006,,,,2,5,7
HND-006682,2011,70700007,,,,3,5,8
HND-006687,2011,70700012,,,,5,4,9
HND-006689,2011,70700014,,,,2,5,7
HND-006691,2011,70700016,,,,5,2,7
HND-006692,2011,70700017,,,,3,4,7
HND-006695,2011,70700020,,,,2,0,2
HND-006696,2011,70700021,,,,5,7,12
HND-006697,2011,70700022,,,,5,4,9
HND-006698,2011,70700023,,,,5,2,7
HND-006699,2011,70700024,,,,4,2,6
HND-006700,2011,70700025,,,,19,22,41
HND-006703,2011,70700029,,,,2,3,5
HND-006704,2011,70700030,,,,6,7,13
HND-006706,2011,70700033,,,,1,1,2
HND-006707,2011,70700038,,,,4,5,9
HND-006678,2011,70700001,,,,4,6,10
HND-006683,2011,70700008,,,,2,2,4
HND-006684,2011,70700009,,,,7,3,10
HND-006685,2011,70700010,,,,0,5,5
HND-006686,2011,70700011,,,,5,4,9
HND-006688,2011,70700013,,,,7,11,18
HND-006690,2011,70700015,,,,5,2,7
HND-006693,2011,70700018,,,,7,9,16
HND-006694,2011,70700019,,,,5,2,7
HND-006712,2011,70700091,,,,0,4,4
HND-006684,2011,70700009,,,,5,5,10
HND-006685,2011,70700010,,,,9,1,10
HND-006686,2011,70700011,,,,2,5,7
HND-006687,2011,70700012,,,,7,9,16
HND-006688,2011,70700013,,,,7,6,13
HND-006689,2011,70700014,,,,6,5,11
HND-006694,2011,70700019,,,,3,4,7
HND-006695,2011,70700020,,,,1,1,2
HND-006696,2011,70700021,,,,7,5,12
HND-006698,2011,70700023,,,,3,2,5
HND-006707,2011,70700038,,,,8,4,12
HND-006712,2011,70700091,,,,2,5,7
HND-006678,2011,70700001,,,,3,3,6
HND-006680,2011,70700005,,,,6,5,11
HND-006681,2011,70700006,,,,6,7,13
HND-006682,2011,70700007,,,,6,3,9
HND-006683,2011,70700008,,,,3,2,5
HND-006690,2011,70700015,,,,5,2,7
HND-006691,2011,70700016,,,,4,5,9
HND-006692,2011,70700017,,,,5,2,7
HND-006693,2011,70700018,,,,4,3,7
HND-006697,2011,70700022,,,,0,4,4
HND-006699,2011,70700024,,,,8,7,15
HND-006700,2011,70700025,,,,30,17,47
HND-006703,2011,70700029,,,,3,1,4
HND-006704,2011,70700030,,,,3,8,11
HND-006706,2011,70700033,,,,2,2,4
HND-006692,2011,70700017,,,,10,9,19
HND-006702,2011,70700028,,,,38,35,73
HND-006683,2011,70700008,,,,12,7,19
HND-006683,2011,70700008,,,,6,10,16
HND-006692,2011,70700017,,,,7,9,16
HND-006702,2011,70700028,,,,29,33,62
HND-006683,2011,70700008,,,,7,2,9
HND-006692,2011,70700017,,,,9,5,14
HND-006702,2011,70700028,,,,18,18,36
HND-006702,2011,70700028,,,,17,21,38
HND-006702,2011,70700028,,,,14,6,20
HND-006702,2011,70700028,,,,13,11,24
HND-006752,2011,70800032,,,,2,3,5
,2011,70800044,,,,3,4,7
,2011,70800052,,,,11,12,23
,2011,70800065,,,,7,7,14
,2011,70800066,,,,7,6,13
,2011,70800067,,,,6,6,12
,2011,70800068,,,,5,12,17
HND-006771,2011,70800071,,,,3,6,9
,2011,70800677,,,,4,3,7
HND-006725,2011,70800004,,,,5,5,10
HND-006748,2011,70800028,,,,2,3,5
HND-006760,2011,70800043,,,,10,6,16
,2011,70800049,,,,5,2,7
,2011,70800050,,,,7,6,13
HND-006764,2011,70800051,,,,5,3,8
,2011,70800063,,,,4,9,13
HND-006769,2011,70800064,,,,2,4,6
,2011,70800069,,,,8,1,9
,2011,70800675,,,,7,4,11
HND-006772,2011,70800676,,,,10,9,19
HND-006763,2011,70800048,,,,1,1,2
HND-006751,2011,70800031,,,,2,2,4
,2011,70800035,,,,2,1,3
HND-006755,2011,70800037,,,,3,2,5
HND-006762,2011,70800047,,,,3,2,5
HND-006750,2011,70800030,,,,4,3,7
HND-006753,2011,70800033,,,,7,4,11
HND-006759,2011,70800042,,,,5,8,13
HND-006763,2011,70800048,,,,10,7,17
HND-006750,2011,70800030,,,,7,2,9
HND-006753,2011,70800033,,,,8,5,13
HND-006763,2011,70800048,,,,8,9,17
HND-006751,2011,70800031,,,,4,12,16
HND-006752,2011,70800032,,,,7,11,18
,2011,70800035,,,,2,5,7
HND-006755,2011,70800037,,,,13,13,26
HND-006762,2011,70800047,,,,4,4,8
HND-006722,2011,70800001,,,,15,10,25
,2011,70800003,,,,5,8,13
,2011,70800005,,,,3,4,7
HND-006727,2011,70800006,,,,3,4,7
HND-006729,2011,70800008,,,,7,6,13
HND-006730,2011,70800009,,,,5,7,12
HND-006732,2011,70800011,,,,10,6,16
HND-006736,2011,70800015,,,,23,20,43
HND-006737,2011,70800016,,,,5,8,13
HND-006738,2011,70800017,,,,1,1,2
HND-006739,2011,70800018,,,,3,4,7
HND-006745,2011,70800024,,,,3,0,3
HND-006747,2011,70800027,,,,7,6,13
HND-006749,2011,70800029,,,,4,3,7
HND-006758,2011,70800041,,,,2,1,3
HND-006761,2011,70800045,,,,3,2,5
HND-006767,2011,70800060,,,,0,2,2
HND-006768,2011,70800061,,,,4,0,4
HND-006770,2011,70800070,,,,4,4,8
HND-006723,2011,70800002,,,,9,7,16
HND-006725,2011,70800004,,,,1,3,4
HND-006728,2011,70800007,,,,41,32,73
HND-006731,2011,70800010,,,,3,2,5
HND-006733,2011,70800012,,,,0,7,7
HND-006734,2011,70800013,,,,3,5,8
HND-006740,2011,70800019,,,,6,3,9
HND-006741,2011,70800020,,,,2,4,6
HND-006742,2011,70800021,,,,1,3,4
HND-006744,2011,70800023,,,,7,6,13
HND-006746,2011,70800025,,,,7,2,9
HND-006750,2011,70800030,,,,7,7,14
HND-006757,2011,70800039,,,,23,18,41
HND-006765,2011,70800058,,,,5,0,5
HND-006766,2011,70800059,,,,7,7,14
HND-006723,2011,70800002,,,,4,12,16
,2011,70800003,,,,4,9,13
HND-006725,2011,70800004,,,,8,2,10
HND-006730,2011,70800009,,,,1,5,6
HND-006731,2011,70800010,,,,1,2,3
HND-006732,2011,70800011,,,,10,9,19
HND-006733,2011,70800012,,,,1,4,5
HND-006734,2011,70800013,,,,4,4,8
HND-006739,2011,70800018,,,,6,1,7
HND-006740,2011,70800019,,,,2,4,6
HND-006742,2011,70800021,,,,2,0,2
HND-006746,2011,70800025,,,,4,2,6
HND-006747,2011,70800027,,,,3,2,5
HND-006750,2011,70800030,,,,6,7,13
HND-006757,2011,70800039,,,,11,21,32
HND-006758,2011,70800041,,,,3,3,6
HND-006765,2011,70800058,,,,4,3,7
HND-006722,2011,70800001,,,,14,10,24
,2011,70800005,,,,3,5,8
HND-006727,2011,70800006,,,,5,14,19
HND-006728,2011,70800007,,,,45,37,82
HND-006729,2011,70800008,,,,4,2,6
HND-006735,2011,70800014,,,,1,1,2
HND-006736,2011,70800015,,,,19,24,43
HND-006737,2011,70800016,,,,4,0,4
HND-006738,2011,70800017,,,,4,3,7
HND-006741,2011,70800020,,,,0,2,2
HND-006743,2011,70800022,,,,2,3,5
HND-006744,2011,70800023,,,,8,5,13
HND-006745,2011,70800024,,,,1,1,2
HND-006749,2011,70800029,,,,1,2,3
HND-006761,2011,70800045,,,,1,3,4
HND-006766,2011,70800059,,,,6,4,10
HND-006768,2011,70800061,,,,3,1,4
HND-006770,2011,70800070,,,,4,7,11
HND-006723,2011,70800002,,,,7,7,14
HND-006725,2011,70800004,,,,2,1,3
HND-006728,2011,70800007,,,,31,38,69
HND-006730,2011,70800009,,,,3,6,9
HND-006731,2011,70800010,,,,0,2,2
HND-006733,2011,70800012,,,,10,4,14
HND-006734,2011,70800013,,,,1,4,5
HND-006740,2011,70800019,,,,2,4,6
HND-006741,2011,70800020,,,,6,2,8
HND-006742,2011,70800021,,,,3,2,5
HND-006746,2011,70800025,,,,3,1,4
HND-006750,2011,70800030,,,,8,10,18
HND-006757,2011,70800039,,,,24,17,41
HND-006758,2011,70800041,,,,0,1,1
HND-006765,2011,70800058,,,,5,4,9
HND-006766,2011,70800059,,,,3,10,13
HND-006722,2011,70800001,,,,14,13,27
,2011,70800003,,,,10,5,15
,2011,70800005,,,,2,1,3
HND-006727,2011,70800006,,,,2,6,8
HND-006729,2011,70800008,,,,6,3,9
HND-006732,2011,70800011,,,,6,3,9
HND-006736,2011,70800015,,,,15,14,29
HND-006737,2011,70800016,,,,6,2,8
HND-006738,2011,70800017,,,,1,1,2
HND-006739,2011,70800018,,,,7,2,9
HND-006743,2011,70800022,,,,2,1,3
HND-006744,2011,70800023,,,,4,6,10
HND-006747,2011,70800027,,,,5,5,10
HND-006749,2011,70800029,,,,2,1,3
HND-006761,2011,70800045,,,,2,4,6
HND-006767,2011,70800060,,,,1,3,4
HND-006768,2011,70800061,,,,2,4,6
HND-006770,2011,70800070,,,,4,5,9
HND-006722,2011,70800001,,,,8,9,17
HND-006723,2011,70800002,,,,6,7,13
,2011,70800003,,,,9,3,12
HND-006729,2011,70800008,,,,3,3,6
HND-006730,2011,70800009,,,,9,3,12
HND-006732,2011,70800011,,,,6,5,11
HND-006733,2011,70800012,,,,1,5,6
HND-006734,2011,70800013,,,,1,2,3
HND-006739,2011,70800018,,,,4,5,9
HND-006740,2011,70800019,,,,5,8,13
HND-006745,2011,70800024,,,,0,1,1
HND-006746,2011,70800025,,,,5,6,11
HND-006747,2011,70800027,,,,4,2,6
HND-006750,2011,70800030,,,,4,5,9
HND-006757,2011,70800039,,,,13,16,29
HND-006761,2011,70800045,,,,1,1,2
HND-006765,2011,70800058,,,,7,4,11
HND-006767,2011,70800060,,,,0,1,1
HND-006725,2011,70800004,,,,4,3,7
,2011,70800005,,,,6,2,8
HND-006727,2011,70800006,,,,11,7,18
HND-006728,2011,70800007,,,,36,41,77
HND-006736,2011,70800015,,,,16,17,33
HND-006737,2011,70800016,,,,2,6,8
HND-006738,2011,70800017,,,,6,2,8
HND-006741,2011,70800020,,,,2,4,6
HND-006742,2011,70800021,,,,2,0,2
HND-006743,2011,70800022,,,,3,1,4
HND-006744,2011,70800023,,,,9,5,14
HND-006749,2011,70800029,,,,1,1,2
HND-006766,2011,70800059,,,,2,7,9
HND-006768,2011,70800061,,,,1,1,2
HND-006770,2011,70800070,,,,1,2,3
HND-006725,2011,70800004,,,,3,5,8
,2011,70800005,,,,6,2,8
HND-006727,2011,70800006,,,,5,11,16
HND-006728,2011,70800007,,,,43,43,86
HND-006733,2011,70800012,,,,6,3,9
HND-006735,2011,70800014,,,,1,1,2
HND-006738,2011,70800017,,,,0,2,2
HND-006740,2011,70800019,,,,4,1,5
HND-006741,2011,70800020,,,,4,2,6
HND-006742,2011,70800021,,,,3,2,5
HND-006743,2011,70800022,,,,1,4,5
HND-006744,2011,70800023,,,,4,9,13
HND-006749,2011,70800029,,,,4,1,5
HND-006750,2011,70800030,,,,8,7,15
HND-006758,2011,70800041,,,,1,0,1
HND-006761,2011,70800045,,,,2,1,3
HND-006765,2011,70800058,,,,3,3,6
HND-006770,2011,70800070,,,,5,5,10
HND-006722,2011,70800001,,,,10,15,25
HND-006723,2011,70800002,,,,13,7,20
,2011,70800003,,,,11,4,15
HND-006729,2011,70800008,,,,4,9,13
HND-006730,2011,70800009,,,,5,7,12
HND-006732,2011,70800011,,,,2,8,10
HND-006734,2011,70800013,,,,2,3,5
HND-006736,2011,70800015,,,,21,13,34
HND-006737,2011,70800016,,,,7,2,9
HND-006739,2011,70800018,,,,8,2,10
HND-006745,2011,70800024,,,,1,0,1
HND-006746,2011,70800025,,,,1,4,5
HND-006747,2011,70800027,,,,6,3,9
HND-006757,2011,70800039,,,,21,17,38
HND-006766,2011,70800059,,,,5,5,10
HND-006767,2011,70800060,,,,0,2,2
HND-006768,2011,70800061,,,,2,1,3
HND-006723,2011,70800002,,,,11,7,18
,2011,70800003,,,,5,9,14
HND-006725,2011,70800004,,,,1,2,3
HND-006730,2011,70800009,,,,7,3,10
HND-006731,2011,70800010,,,,2,2,4
HND-006732,2011,70800011,,,,6,3,9
HND-006733,2011,70800012,,,,4,8,12
HND-006734,2011,70800013,,,,1,2,3
HND-006739,2011,70800018,,,,7,2,9
HND-006740,2011,70800019,,,,2,8,10
HND-006742,2011,70800021,,,,2,0,2
HND-006746,2011,70800025,,,,1,1,2
HND-006747,2011,70800027,,,,2,1,3
HND-006761,2011,70800045,,,,4,1,5
HND-006766,2011,70800059,,,,1,4,5
HND-006767,2011,70800060,,,,4,2,6
HND-006770,2011,70800070,,,,5,3,8
HND-006722,2011,70800001,,,,4,11,15
,2011,70800005,,,,6,3,9
HND-006727,2011,70800006,,,,5,7,12
HND-006728,2011,70800007,,,,31,38,69
HND-006729,2011,70800008,,,,5,7,12
HND-006735,2011,70800014,,,,3,2,5
HND-006736,2011,70800015,,,,14,8,22
HND-006737,2011,70800016,,,,2,4,6
HND-006738,2011,70800017,,,,1,2,3
HND-006741,2011,70800020,,,,1,2,3
HND-006743,2011,70800022,,,,3,2,5
HND-006744,2011,70800023,,,,4,5,9
HND-006745,2011,70800024,,,,0,1,1
HND-006749,2011,70800029,,,,2,2,4
HND-006750,2011,70800030,,,,6,5,11
HND-006757,2011,70800039,,,,19,14,33
HND-006765,2011,70800058,,,,2,0,2
HND-006768,2011,70800061,,,,3,2,5
HND-006722,2011,70800001,,,,8,6,14
,2011,70800003,,,,11,13,24
HND-006729,2011,70800008,,,,6,13,19
HND-006757,2011,70800039,,,,95,104,199
HND-006740,2011,70800019,,,,17,9,26
HND-006756,2011,70800038,,,,92,67,159
,2011,70800003,,,,7,7,14
HND-006740,2011,70800019,,,,13,13,26
HND-006722,2011,70800001,,,,5,11,16
HND-006729,2011,70800008,,,,11,9,20
HND-006738,2011,70800017,,,,2,2,4
HND-006756,2011,70800038,,,,64,75,139
HND-006757,2011,70800039,,,,95,90,185
HND-006722,2011,70800001,,,,11,6,17
,2011,70800003,,,,3,6,9
HND-006740,2011,70800019,,,,9,9,18
HND-006756,2011,70800038,,,,66,61,127
HND-006729,2011,70800008,,,,9,10,19
HND-006738,2011,70800017,,,,9,6,15
HND-006757,2011,70800039,,,,57,88,145
HND-006756,2011,70800038,,,,55,82,137
HND-006757,2011,70800039,,,,38,23,61
HND-006757,2011,70800039,,,,26,25,51
HND-006756,2011,70800038,,,,40,61,101
HND-006756,2011,70800038,,,,29,49,78
HND-006757,2011,70800039,,,,26,33,59
,2011,70900027,,,,6,3,9
HND-006796,2011,70900028,,,,7,3,10
HND-006797,2011,70900029,,,,4,5,9
,2011,70900030,,,,5,4,9
,2011,70900044,,,,10,10,20
,2011,70900045,,,,4,3,7
HND-006789,2011,70900019,,,,3,0,3
HND-006788,2011,70900018,,,,1,1,2
HND-006787,2011,70900017,,,,5,3,8
HND-006794,2011,70900025,,,,7,5,12
HND-006788,2011,70900018,,,,5,2,7
HND-006789,2011,70900019,,,,1,4,5
,2011,70900022,,,,4,1,5
HND-006792,2011,70900023,,,,2,0,2
HND-006793,2011,70900024,,,,1,2,3
HND-006795,2011,70900026,,,,5,7,12
HND-006789,2011,70900019,,,,6,4,10
,2011,70900022,,,,4,7,11
HND-006792,2011,70900023,,,,6,8,14
HND-006793,2011,70900024,,,,4,6,10
HND-006795,2011,70900026,,,,13,6,19
HND-006787,2011,70900017,,,,7,6,13
HND-006788,2011,70900018,,,,4,3,7
,2011,70900001,,,,6,5,11
HND-006774,2011,70900003,,,,10,5,15
HND-006780,2011,70900009,,,,1,2,3
HND-006781,2011,70900010,,,,10,7,17
HND-006782,2011,70900011,,,,2,2,4
HND-006784,2011,70900013,,,,2,0,2
HND-006786,2011,70900016,,,,7,10,17
HND-006791,2011,70900021,,,,3,4,7
HND-006773,2011,70900002,,,,23,20,43
HND-006775,2011,70900004,,,,1,3,4
HND-006776,2011,70900005,,,,14,11,25
HND-006777,2011,70900006,,,,0,1,1
HND-006778,2011,70900007,,,,2,3,5
HND-006779,2011,70900008,,,,3,4,7
HND-006783,2011,70900012,,,,3,8,11
HND-006785,2011,70900014,,,,6,3,9
HND-006775,2011,70900004,,,,4,6,10
HND-006778,2011,70900007,,,,0,3,3
HND-006781,2011,70900010,,,,6,11,17
HND-006783,2011,70900012,,,,4,2,6
HND-006784,2011,70900013,,,,1,1,2
HND-006785,2011,70900014,,,,5,2,7
,2011,70900001,,,,2,7,9
HND-006773,2011,70900002,,,,18,16,34
HND-006774,2011,70900003,,,,4,8,12
HND-006776,2011,70900005,,,,3,4,7
HND-006777,2011,70900006,,,,5,2,7
HND-006779,2011,70900008,,,,11,5,16
HND-006782,2011,70900011,,,,7,4,11
HND-006786,2011,70900016,,,,13,7,20
HND-006791,2011,70900021,,,,2,4,6
HND-006773,2011,70900002,,,,22,19,41
HND-006775,2011,70900004,,,,1,2,3
HND-006776,2011,70900005,,,,4,7,11
HND-006777,2011,70900006,,,,4,3,7
HND-006778,2011,70900007,,,,1,0,1
HND-006783,2011,70900012,,,,4,8,12
HND-006785,2011,70900014,,,,4,2,6
,2011,70900001,,,,1,2,3
HND-006774,2011,70900003,,,,8,2,10
HND-006779,2011,70900008,,,,7,6,13
HND-006780,2011,70900009,,,,2,0,2
HND-006781,2011,70900010,,,,7,5,12
HND-006782,2011,70900011,,,,4,6,10
HND-006784,2011,70900013,,,,1,0,1
HND-006786,2011,70900016,,,,8,6,14
HND-006791,2011,70900021,,,,1,2,3
HND-006774,2011,70900003,,,,2,2,4
HND-006775,2011,70900004,,,,1,1,2
HND-006780,2011,70900009,,,,3,2,5
HND-006781,2011,70900010,,,,13,3,16
HND-006782,2011,70900011,,,,4,2,6
HND-006783,2011,70900012,,,,5,6,11
HND-006784,2011,70900013,,,,0,2,2
HND-006791,2011,70900021,,,,5,1,6
,2011,70900001,,,,2,1,3
HND-006773,2011,70900002,,,,18,16,34
HND-006776,2011,70900005,,,,6,6,12
HND-006777,2011,70900006,,,,2,1,3
HND-006778,2011,70900007,,,,2,2,4
HND-006779,2011,70900008,,,,5,8,13
HND-006785,2011,70900014,,,,8,3,11
HND-006786,2011,70900016,,,,4,2,6
HND-006774,2011,70900003,,,,8,2,10
HND-006775,2011,70900004,,,,6,3,9
HND-006781,2011,70900010,,,,9,8,17
HND-006782,2011,70900011,,,,6,9,15
HND-006783,2011,70900012,,,,2,4,6
HND-006784,2011,70900013,,,,3,0,3
HND-006791,2011,70900021,,,,0,5,5
,2011,70900001,,,,4,1,5
HND-006773,2011,70900002,,,,8,21,29
HND-006776,2011,70900005,,,,3,4,7
HND-006777,2011,70900006,,,,2,2,4
HND-006778,2011,70900007,,,,0,2,2
HND-006779,2011,70900008,,,,10,6,16
HND-006785,2011,70900014,,,,6,7,13
HND-006786,2011,70900016,,,,9,7,16
,2011,70900001,,,,1,0,1
HND-006773,2011,70900002,,,,12,23,35
HND-006774,2011,70900003,,,,5,5,10
HND-006776,2011,70900005,,,,6,5,11
HND-006779,2011,70900008,,,,10,7,17
HND-006780,2011,70900009,,,,2,1,3
HND-006782,2011,70900011,,,,2,6,8
HND-006786,2011,70900016,,,,6,3,9
HND-006791,2011,70900021,,,,3,1,4
HND-006775,2011,70900004,,,,3,5,8
HND-006778,2011,70900007,,,,0,6,6
HND-006781,2011,70900010,,,,4,8,12
HND-006783,2011,70900012,,,,6,4,10
HND-006784,2011,70900013,,,,1,0,1
HND-006785,2011,70900014,,,,2,4,6
HND-006783,2011,70900012,,,,20,12,32
,2011,70900020,,,,46,37,83
HND-006783,2011,70900012,,,,14,15,29
,2011,70900020,,,,31,34,65
,2011,70900020,,,,33,34,67
HND-006783,2011,70900012,,,,14,17,31
,2011,70900020,,,,37,29,66
,2011,70900020,,,,19,21,40
,2011,70900020,,,,19,23,42
HND-006817,2011,71000021,,,,4,2,6
,2011,71000022,,,,5,3,8
,2011,71000023,,,,4,3,7
HND-006814,2011,71000018,,,,2,6,8
HND-006815,2011,71000019,,,,5,3,8
HND-006816,2011,71000020,,,,0,1,1
HND-006813,2011,71000017,,,,0,2,2
HND-006816,2011,71000020,,,,1,6,7
HND-006810,2011,71000014,,,,1,0,1
HND-006810,2011,71000014,,,,3,5,8
HND-006811,2011,71000015,,,,7,5,12
HND-006813,2011,71000017,,,,4,1,5
HND-006816,2011,71000020,,,,5,6,11
HND-006798,2011,71000001,,,,2,6,8
HND-006799,2011,71000002,,,,3,2,5
HND-006800,2011,71000003,,,,2,1,3
HND-006804,2011,71000007,,,,9,11,20
HND-006808,2011,71000011,,,,4,2,6
HND-006809,2011,71000012,,,,1,2,3
HND-006812,2011,71000016,,,,0,2,2
HND-006801,2011,71000004,,,,8,9,17
HND-006802,2011,71000005,,,,3,0,3
HND-006803,2011,71000006,,,,3,2,5
HND-006805,2011,71000008,,,,3,3,6
HND-006806,2011,71000009,,,,14,4,18
HND-006807,2011,71000010,,,,5,3,8
HND-006798,2011,71000001,,,,6,4,10
HND-006800,2011,71000003,,,,2,0,2
HND-006801,2011,71000004,,,,8,10,18
HND-006802,2011,71000005,,,,0,1,1
HND-006803,2011,71000006,,,,5,4,9
HND-006804,2011,71000007,,,,7,6,13
HND-006805,2011,71000008,,,,4,3,7
HND-006806,2011,71000009,,,,8,6,14
HND-006807,2011,71000010,,,,6,4,10
HND-006809,2011,71000012,,,,2,3,5
HND-006812,2011,71000016,,,,2,1,3
HND-006799,2011,71000002,,,,0,2,2
HND-006808,2011,71000011,,,,4,0,4
HND-006801,2011,71000004,,,,10,9,19
HND-006802,2011,71000005,,,,1,2,3
HND-006803,2011,71000006,,,,3,3,6
HND-006805,2011,71000008,,,,1,8,9
HND-006806,2011,71000009,,,,6,10,16
HND-006807,2011,71000010,,,,3,4,7
HND-006798,2011,71000001,,,,2,6,8
HND-006799,2011,71000002,,,,3,3,6
HND-006800,2011,71000003,,,,2,0,2
HND-006804,2011,71000007,,,,4,9,13
HND-006808,2011,71000011,,,,5,0,5
HND-006809,2011,71000012,,,,1,0,1
HND-006812,2011,71000016,,,,1,2,3
HND-006798,2011,71000001,,,,5,6,11
HND-006800,2011,71000003,,,,1,1,2
HND-006801,2011,71000004,,,,14,8,22
HND-006802,2011,71000005,,,,0,1,1
HND-006803,2011,71000006,,,,3,1,4
HND-006804,2011,71000007,,,,3,8,11
HND-006805,2011,71000008,,,,3,3,6
HND-006807,2011,71000010,,,,2,5,7
HND-006808,2011,71000011,,,,4,3,7
HND-006809,2011,71000012,,,,0,1,1
HND-006812,2011,71000016,,,,1,0,1
HND-006806,2011,71000009,,,,9,9,18
HND-006798,2011,71000001,,,,7,2,9
HND-006800,2011,71000003,,,,3,5,8
HND-006801,2011,71000004,,,,15,3,18
HND-006803,2011,71000006,,,,2,5,7
HND-006804,2011,71000007,,,,2,7,9
HND-006807,2011,71000010,,,,2,7,9
HND-006808,2011,71000011,,,,2,3,5
HND-006809,2011,71000012,,,,0,2,2
HND-006812,2011,71000016,,,,1,1,2
HND-006799,2011,71000002,,,,4,3,7
HND-006802,2011,71000005,,,,3,3,6
HND-006805,2011,71000008,,,,2,5,7
HND-006806,2011,71000009,,,,10,5,15
HND-006799,2011,71000002,,,,3,4,7
HND-006808,2011,71000011,,,,0,6,6
HND-006798,2011,71000001,,,,2,4,6
HND-006800,2011,71000003,,,,1,3,4
HND-006801,2011,71000004,,,,5,8,13
HND-006802,2011,71000005,,,,2,2,4
HND-006803,2011,71000006,,,,8,6,14
HND-006804,2011,71000007,,,,3,6,9
HND-006805,2011,71000008,,,,2,4,6
HND-006806,2011,71000009,,,,8,7,15
HND-006807,2011,71000010,,,,3,4,7
HND-006809,2011,71000012,,,,1,2,3
HND-006812,2011,71000016,,,,2,2,4
HND-006799,2011,71000002,,,,7,7,14
HND-006801,2011,71000004,,,,7,12,19
HND-006804,2011,71000007,,,,15,31,46
HND-006799,2011,71000002,,,,7,5,12
HND-006801,2011,71000004,,,,7,7,14
HND-006804,2011,71000007,,,,14,12,26
HND-006799,2011,71000002,,,,5,5,10
HND-006801,2011,71000004,,,,8,12,20
HND-006804,2011,71000007,,,,17,10,27
HND-006840,2011,71100030,,,,9,8,17
,2011,71100034,,,,9,11,20
HND-006843,2011,71100065,,,,8,11,19
,2011,71100066,,,,6,4,10
HND-006839,2011,71100027,,,,0,4,4
HND-006832,2011,71100015,,,,5,4,9
,2011,71100023,,,,10,3,13
HND-006839,2011,71100027,,,,3,3,6
,2011,71100064,,,,4,6,10
HND-006833,2011,71100016,,,,4,2,6
HND-006834,2011,71100017,,,,4,2,6
,2011,71100020,,,,5,2,7
HND-006837,2011,71100025,,,,4,2,6
,2011,71100028,,,,7,3,10
HND-006833,2011,71100016,,,,5,4,9
,2011,71100020,,,,4,1,5
,2011,71100023,,,,12,8,20
HND-006837,2011,71100025,,,,8,5,13
HND-006839,2011,71100027,,,,5,2,7
,2011,71100028,,,,5,6,11
HND-006832,2011,71100015,,,,3,2,5
HND-006834,2011,71100017,,,,8,4,12
,2011,71100064,,,,4,2,6
HND-006818,2011,71100001,,,,9,14,23
HND-006821,2011,71100004,,,,1,5,6
HND-006822,2011,71100005,,,,5,5,10
HND-006823,2011,71100006,,,,0,4,4
HND-006825,2011,71100008,,,,3,4,7
HND-006826,2011,71100009,,,,6,6,12
HND-006827,2011,71100010,,,,9,4,13
HND-006832,2011,71100015,,,,7,8,15
HND-006840,2011,71100030,,,,2,1,3
HND-006819,2011,71100002,,,,13,13,26
HND-006820,2011,71100003,,,,16,18,34
HND-006824,2011,71100007,,,,0,3,3
HND-006828,2011,71100011,,,,2,1,3
HND-006829,2011,71100012,,,,4,5,9
HND-006830,2011,71100013,,,,9,6,15
HND-006841,2011,71100031,,,,5,5,10
HND-006842,2011,71100032,,,,2,2,4
HND-006819,2011,71100002,,,,10,12,22
HND-006820,2011,71100003,,,,5,8,13
HND-006821,2011,71100004,,,,3,0,3
HND-006822,2011,71100005,,,,4,5,9
HND-006823,2011,71100006,,,,4,4,8
HND-006824,2011,71100007,,,,2,1,3
HND-006825,2011,71100008,,,,6,2,8
HND-006826,2011,71100009,,,,10,5,15
HND-006827,2011,71100010,,,,7,8,15
HND-006828,2011,71100011,,,,3,2,5
HND-006829,2011,71100012,,,,2,0,2
HND-006830,2011,71100013,,,,8,6,14
HND-006831,2011,71100014,,,,2,2,4
HND-006832,2011,71100015,,,,11,8,19
HND-006841,2011,71100031,,,,5,0,5
HND-006818,2011,71100001,,,,7,9,16
HND-006836,2011,71100024,,,,1,1,2
HND-006838,2011,71100026,,,,5,2,7
HND-006840,2011,71100030,,,,3,2,5
HND-006842,2011,71100032,,,,1,2,3
HND-006818,2011,71100001,,,,10,8,18
HND-006820,2011,71100003,,,,8,11,19
HND-006824,2011,71100007,,,,0,4,4
HND-006828,2011,71100011,,,,1,2,3
HND-006829,2011,71100012,,,,3,3,6
HND-006830,2011,71100013,,,,9,2,11
HND-006836,2011,71100024,,,,1,2,3
HND-006838,2011,71100026,,,,0,2,2
HND-006841,2011,71100031,,,,0,1,1
HND-006842,2011,71100032,,,,1,1,2
HND-006819,2011,71100002,,,,8,12,20
HND-006821,2011,71100004,,,,2,6,8
HND-006822,2011,71100005,,,,6,3,9
HND-006823,2011,71100006,,,,3,3,6
HND-006825,2011,71100008,,,,4,2,6
HND-006826,2011,71100009,,,,7,6,13
HND-006827,2011,71100010,,,,5,10,15
HND-006831,2011,71100014,,,,3,1,4
HND-006832,2011,71100015,,,,11,4,15
HND-006840,2011,71100030,,,,1,1,2
HND-006819,2011,71100002,,,,15,11,26
HND-006820,2011,71100003,,,,4,6,10
HND-006821,2011,71100004,,,,4,6,10
HND-006822,2011,71100005,,,,2,2,4
HND-006823,2011,71100006,,,,3,4,7
HND-006824,2011,71100007,,,,0,2,2
HND-006825,2011,71100008,,,,1,7,8
HND-006827,2011,71100010,,,,6,13,19
HND-006828,2011,71100011,,,,2,2,4
HND-006829,2011,71100012,,,,3,3,6
HND-006830,2011,71100013,,,,4,6,10
HND-006831,2011,71100014,,,,3,2,5
HND-006832,2011,71100015,,,,5,6,11
HND-006818,2011,71100001,,,,11,8,19
HND-006826,2011,71100009,,,,9,4,13
HND-006836,2011,71100024,,,,1,0,1
HND-006838,2011,71100026,,,,2,1,3
HND-006840,2011,71100030,,,,1,4,5
HND-006841,2011,71100031,,,,1,1,2
HND-006842,2011,71100032,,,,2,0,2
HND-006819,2011,71100002,,,,14,12,26
HND-006820,2011,71100003,,,,7,6,13
HND-006821,2011,71100004,,,,2,4,6
HND-006823,2011,71100006,,,,4,3,7
HND-006828,2011,71100011,,,,6,1,7
HND-006829,2011,71100012,,,,2,3,5
HND-006830,2011,71100013,,,,2,8,10
HND-006831,2011,71100014,,,,2,0,2
HND-006840,2011,71100030,,,,8,1,9
HND-006818,2011,71100001,,,,13,10,23
HND-006822,2011,71100005,,,,5,3,8
HND-006825,2011,71100008,,,,4,3,7
HND-006826,2011,71100009,,,,6,2,8
HND-006827,2011,71100010,,,,8,2,10
HND-006832,2011,71100015,,,,6,1,7
HND-006836,2011,71100024,,,,1,1,2
HND-006838,2011,71100026,,,,2,2,4
HND-006841,2011,71100031,,,,1,2,3
HND-006842,2011,71100032,,,,2,2,4
HND-006818,2011,71100001,,,,9,12,21
HND-006828,2011,71100011,,,,2,2,4
HND-006836,2011,71100024,,,,3,3,6
HND-006838,2011,71100026,,,,2,3,5
HND-006840,2011,71100030,,,,0,4,4
HND-006842,2011,71100032,,,,4,2,6
HND-006819,2011,71100002,,,,8,11,19
HND-006820,2011,71100003,,,,13,17,30
HND-006821,2011,71100004,,,,5,1,6
HND-006822,2011,71100005,,,,0,2,2
HND-006823,2011,71100006,,,,4,4,8
HND-006824,2011,71100007,,,,0,1,1
HND-006825,2011,71100008,,,,7,3,10
HND-006826,2011,71100009,,,,8,5,13
HND-006827,2011,71100010,,,,6,7,13
HND-006829,2011,71100012,,,,4,2,6
HND-006830,2011,71100013,,,,7,10,17
HND-006831,2011,71100014,,,,2,2,4
HND-006832,2011,71100015,,,,2,1,3
HND-006841,2011,71100031,,,,1,1,2
HND-006819,2011,71100002,,,,21,27,48
HND-006820,2011,71100003,,,,20,30,50
HND-006835,2011,71100018,,,,33,14,47
HND-006819,2011,71100002,,,,18,22,40
HND-006820,2011,71100003,,,,22,14,36
HND-006835,2011,71100018,,,,16,12,28
HND-006819,2011,71100002,,,,11,16,27
HND-006820,2011,71100003,,,,20,12,32
HND-006835,2011,71100018,,,,14,13,27
HND-006835,2011,71100018,,,,12,5,17
HND-006835,2011,71100018,,,,5,6,11
HND-006835,2011,71100018,,,,13,7,20
HND-006871,2011,71200074,,,,3,6,9
,2011,71200078,,,,6,6,12
,2011,71200083,,,,7,3,10
HND-006874,2011,71200080,,,,6,4,10
HND-006875,2011,71200082,,,,5,5,10
,2011,71200076,,,,1,1,2
HND-006870,2011,71200037,,,,1,3,4
HND-006859,2011,71200016,,,,3,1,4
,2011,71200019,,,,3,6,9
HND-006870,2011,71200037,,,,3,3,6
,2011,71200076,,,,2,2,4
,2011,71200079,,,,6,3,9
HND-006858,2011,71200015,,,,3,10,13
,2011,71200038,,,,7,8,15
HND-006858,2011,71200015,,,,18,13,31
HND-006870,2011,71200037,,,,5,3,8
,2011,71200038,,,,16,19,35
HND-006859,2011,71200016,,,,2,4,6
,2011,71200019,,,,5,10,15
,2011,71200076,,,,2,4,6
,2011,71200079,,,,2,3,5
HND-006844,2011,71200001,,,,19,18,37
HND-006848,2011,71200005,,,,6,5,11
HND-006852,2011,71200009,,,,9,7,16
HND-006863,2011,71200028,,,,3,3,6
HND-006864,2011,71200029,,,,8,9,17
HND-006867,2011,71200033,,,,2,3,5
HND-006868,2011,71200034,,,,2,7,9
HND-006845,2011,71200002,,,,2,0,2
HND-006846,2011,71200003,,,,11,3,14
HND-006847,2011,71200004,,,,19,18,37
HND-006849,2011,71200006,,,,7,5,12
HND-006850,2011,71200007,,,,11,9,20
HND-006851,2011,71200008,,,,43,33,76
HND-006853,2011,71200010,,,,9,9,18
HND-006854,2011,71200011,,,,3,1,4
HND-006855,2011,71200012,,,,4,1,5
HND-006856,2011,71200013,,,,6,4,10
HND-006857,2011,71200014,,,,5,6,11
HND-006861,2011,71200018,,,,2,1,3
HND-006862,2011,71200027,,,,9,7,16
HND-006869,2011,71200035,,,,1,1,2
HND-006872,2011,71200075,,,,0,1,1
HND-006844,2011,71200001,,,,18,21,39
HND-006846,2011,71200003,,,,7,6,13
HND-006850,2011,71200007,,,,7,4,11
HND-006854,2011,71200011,,,,5,2,7
HND-006855,2011,71200012,,,,0,2,2
HND-006856,2011,71200013,,,,7,3,10
HND-006864,2011,71200029,,,,3,5,8
HND-006867,2011,71200033,,,,0,2,2
HND-006868,2011,71200034,,,,2,7,9
HND-006869,2011,71200035,,,,1,4,5
HND-006845,2011,71200002,,,,3,1,4
HND-006847,2011,71200004,,,,19,9,28
HND-006848,2011,71200005,,,,4,6,10
HND-006849,2011,71200006,,,,9,4,13
HND-006851,2011,71200008,,,,14,12,26
HND-006852,2011,71200009,,,,7,2,9
HND-006853,2011,71200010,,,,5,2,7
HND-006857,2011,71200014,,,,9,3,12
HND-006861,2011,71200018,,,,2,0,2
HND-006862,2011,71200027,,,,5,11,16
HND-006863,2011,71200028,,,,2,4,6
HND-006872,2011,71200075,,,,0,1,1
HND-006845,2011,71200002,,,,3,3,6
HND-006846,2011,71200003,,,,2,7,9
HND-006847,2011,71200004,,,,10,19,29
HND-006849,2011,71200006,,,,4,7,11
HND-006850,2011,71200007,,,,5,3,8
HND-006854,2011,71200011,,,,1,0,1
HND-006855,2011,71200012,,,,4,3,7
HND-006856,2011,71200013,,,,3,2,5
HND-006857,2011,71200014,,,,4,2,6
HND-006861,2011,71200018,,,,3,2,5
HND-006862,2011,71200027,,,,1,0,1
HND-006868,2011,71200034,,,,4,1,5
HND-006869,2011,71200035,,,,2,2,4
HND-006844,2011,71200001,,,,21,15,36
HND-006848,2011,71200005,,,,6,4,10
HND-006851,2011,71200008,,,,16,21,37
HND-006852,2011,71200009,,,,5,3,8
HND-006853,2011,71200010,,,,5,6,11
HND-006863,2011,71200028,,,,4,1,5
HND-006864,2011,71200029,,,,0,2,2
HND-006867,2011,71200033,,,,2,0,2
HND-006872,2011,71200075,,,,1,2,3
HND-006844,2011,71200001,,,,19,10,29
HND-006863,2011,71200028,,,,2,2,4
HND-006864,2011,71200029,,,,5,3,8
HND-006868,2011,71200034,,,,5,1,6
HND-006869,2011,71200035,,,,2,0,2
HND-006845,2011,71200002,,,,0,2,2
HND-006846,2011,71200003,,,,5,3,8
HND-006847,2011,71200004,,,,14,12,26
HND-006848,2011,71200005,,,,6,3,9
HND-006849,2011,71200006,,,,5,8,13
HND-006850,2011,71200007,,,,7,9,16
HND-006851,2011,71200008,,,,11,15,26
HND-006852,2011,71200009,,,,2,4,6
HND-006853,2011,71200010,,,,4,10,14
HND-006855,2011,71200012,,,,5,4,9
HND-006856,2011,71200013,,,,2,3,5
HND-006857,2011,71200014,,,,2,5,7
HND-006861,2011,71200018,,,,0,2,2
HND-006862,2011,71200027,,,,0,2,2
HND-006872,2011,71200075,,,,1,0,1
HND-006844,2011,71200001,,,,3,23,26
HND-006852,2011,71200009,,,,3,2,5
HND-006863,2011,71200028,,,,1,4,5
HND-006864,2011,71200029,,,,0,3,3
HND-006869,2011,71200035,,,,3,0,3
HND-006872,2011,71200075,,,,1,5,6
HND-006845,2011,71200002,,,,2,1,3
HND-006846,2011,71200003,,,,2,3,5
HND-006847,2011,71200004,,,,13,14,27
HND-006848,2011,71200005,,,,7,4,11
HND-006849,2011,71200006,,,,4,5,9
HND-006850,2011,71200007,,,,6,3,9
HND-006851,2011,71200008,,,,3,5,8
HND-006853,2011,71200010,,,,5,5,10
HND-006855,2011,71200012,,,,7,8,15
HND-006856,2011,71200013,,,,1,6,7
HND-006857,2011,71200014,,,,3,2,5
HND-006861,2011,71200018,,,,0,3,3
HND-006862,2011,71200027,,,,2,3,5
HND-006867,2011,71200033,,,,0,2,2
HND-006868,2011,71200034,,,,4,1,5
HND-006845,2011,71200002,,,,2,0,2
HND-006847,2011,71200004,,,,15,12,27
HND-006848,2011,71200005,,,,2,5,7
HND-006849,2011,71200006,,,,2,8,10
HND-006851,2011,71200008,,,,7,21,28
HND-006852,2011,71200009,,,,1,2,3
HND-006853,2011,71200010,,,,6,7,13
HND-006857,2011,71200014,,,,1,4,5
HND-006861,2011,71200018,,,,1,2,3
HND-006862,2011,71200027,,,,1,3,4
HND-006863,2011,71200028,,,,3,1,4
HND-006867,2011,71200033,,,,1,1,2
HND-006869,2011,71200035,,,,0,1,1
HND-006844,2011,71200001,,,,20,10,30
HND-006846,2011,71200003,,,,5,1,6
HND-006850,2011,71200007,,,,4,6,10
HND-006854,2011,71200011,,,,0,1,1
HND-006855,2011,71200012,,,,3,6,9
HND-006856,2011,71200013,,,,4,2,6
HND-006864,2011,71200029,,,,0,3,3
HND-006872,2011,71200075,,,,1,1,2
,2011,71200084,,,,4,4,8
HND-006847,2011,71200004,,,,13,8,21
HND-006851,2011,71200008,,,,3,4,7
HND-006860,2011,71200017,,,,20,33,53
HND-006860,2011,71200017,,,,20,22,42
HND-006847,2011,71200004,,,,4,5,9
HND-006851,2011,71200008,,,,2,5,7
,2011,71200084,,,,2,2,4
HND-006860,2011,71200017,,,,16,16,32
HND-006847,2011,71200004,,,,2,0,2
HND-006851,2011,71200008,,,,6,4,10
HND-006860,2011,71200017,,,,25,19,44
,2011,71200084,,,,4,2,6
HND-006860,2011,71200017,,,,19,7,26
HND-006860,2011,71200017,,,,15,18,33
,2011,71300019,,,,5,3,8
,2011,71300020,,,,4,6,10
HND-006884,2011,71300009,,,,1,3,4
HND-006885,2011,71300010,,,,0,3,3
HND-006887,2011,71300012,,,,2,3,5
HND-006890,2011,71300018,,,,14,16,30
HND-006884,2011,71300009,,,,2,5,7
HND-006885,2011,71300010,,,,3,3,6
HND-006884,2011,71300009,,,,6,1,7
HND-006885,2011,71300010,,,,8,2,10
HND-006887,2011,71300012,,,,5,10,15
HND-006890,2011,71300018,,,,10,9,19
HND-006877,2011,71300002,,,,2,7,9
HND-006878,2011,71300003,,,,6,7,13
HND-006879,2011,71300004,,,,5,3,8
HND-006882,2011,71300007,,,,4,7,11
HND-006876,2011,71300001,,,,25,15,40
HND-006880,2011,71300005,,,,5,5,10
HND-006881,2011,71300006,,,,1,0,1
HND-006883,2011,71300008,,,,0,2,2
HND-006877,2011,71300002,,,,4,5,9
HND-006878,2011,71300003,,,,10,14,24
HND-006879,2011,71300004,,,,10,4,14
HND-006880,2011,71300005,,,,2,4,6
HND-006881,2011,71300006,,,,2,1,3
HND-006882,2011,71300007,,,,5,5,10
HND-006883,2011,71300008,,,,1,1,2
HND-006876,2011,71300001,,,,16,12,28
HND-006876,2011,71300001,,,,14,14,28
HND-006879,2011,71300004,,,,6,2,8
HND-006880,2011,71300005,,,,2,2,4
HND-006881,2011,71300006,,,,1,4,5
HND-006883,2011,71300008,,,,1,3,4
HND-006877,2011,71300002,,,,4,3,7
HND-006878,2011,71300003,,,,5,7,12
HND-006882,2011,71300007,,,,6,5,11
HND-006877,2011,71300002,,,,3,4,7
HND-006878,2011,71300003,,,,5,6,11
HND-006879,2011,71300004,,,,4,6,10
HND-006880,2011,71300005,,,,2,2,4
HND-006881,2011,71300006,,,,1,1,2
HND-006882,2011,71300007,,,,6,8,14
HND-006883,2011,71300008,,,,2,1,3
HND-006876,2011,71300001,,,,14,19,33
HND-006877,2011,71300002,,,,5,1,6
HND-006878,2011,71300003,,,,8,8,16
HND-006879,2011,71300004,,,,6,5,11
HND-006881,2011,71300006,,,,3,0,3
HND-006882,2011,71300007,,,,9,6,15
HND-006876,2011,71300001,,,,23,13,36
HND-006880,2011,71300005,,,,3,2,5
HND-006883,2011,71300008,,,,0,1,1
HND-006876,2011,71300001,,,,20,10,30
HND-006877,2011,71300002,,,,3,4,7
HND-006878,2011,71300003,,,,8,11,19
HND-006879,2011,71300004,,,,11,4,15
HND-006880,2011,71300005,,,,1,2,3
HND-006881,2011,71300006,,,,1,0,1
HND-006882,2011,71300007,,,,7,7,14
HND-006883,2011,71300008,,,,3,1,4
HND-006876,2011,71300001,,,,29,26,55
HND-006876,2011,71300001,,,,25,20,45
HND-006876,2011,71300001,,,,16,20,36
HND-006888,2011,71300015,,,,11,14,25
HND-006888,2011,71300015,,,,16,8,24
HND-006888,2011,71300015,,,,15,6,21
,2011,71400037,,,,7,5,12
,2011,71400095,,,,9,3,12
,2011,71400096,,,,2,3,5
,2011,71400089,,,,10,7,17
,2011,71400093,,,,6,6,12
,2011,71400097,,,,3,3,6
,2011,71400052,,,,2,1,3
HND-006921,2011,71400030,,,,2,7,9
HND-006922,2011,71400031,,,,4,7,11
HND-006923,2011,71400032,,,,5,5,10
HND-006924,2011,71400033,,,,3,1,4
HND-006925,2011,71400034,,,,2,2,4
,2011,71400052,,,,4,0,4
,2011,71400053,,,,4,3,7
,2011,71400035,,,,4,6,10
HND-006927,2011,71400039,,,,3,1,4
,2011,71400040,,,,2,4,6
HND-006928,2011,71400041,,,,3,4,7
HND-006930,2011,71400043,,,,2,9,11
HND-006931,2011,71400044,,,,7,5,12
,2011,71400035,,,,3,0,3
HND-006927,2011,71400039,,,,8,3,11
,2011,71400040,,,,2,6,8
HND-006928,2011,71400041,,,,1,6,7
HND-006930,2011,71400043,,,,3,4,7
HND-006931,2011,71400044,,,,10,13,23
,2011,71400052,,,,4,2,6
HND-006921,2011,71400030,,,,10,5,15
HND-006922,2011,71400031,,,,3,4,7
HND-006923,2011,71400032,,,,9,4,13
HND-006924,2011,71400033,,,,5,2,7
HND-006925,2011,71400034,,,,9,7,16
,2011,71400053,,,,2,2,4
HND-006893,2011,71400001,,,,18,10,28
HND-006894,2011,71400002,,,,7,3,10
HND-006896,2011,71400004,,,,7,4,11
HND-006899,2011,71400007,,,,10,3,13
HND-006902,2011,71400010,,,,8,7,15
HND-006903,2011,71400011,,,,1,1,2
HND-006904,2011,71400012,,,,10,7,17
HND-006905,2011,71400013,,,,0,3,3
HND-006906,2011,71400014,,,,2,3,5
HND-006907,2011,71400015,,,,0,3,3
HND-006908,2011,71400016,,,,3,2,5
HND-006909,2011,71400017,,,,3,3,6
HND-006911,2011,71400020,,,,5,2,7
HND-006913,2011,71400022,,,,3,5,8
HND-006915,2011,71400024,,,,5,4,9
HND-006916,2011,71400025,,,,5,2,7
HND-006917,2011,71400026,,,,12,15,27
HND-006919,2011,71400028,,,,4,3,7
HND-006934,2011,71400047,,,,6,2,8
HND-006935,2011,71400049,,,,1,2,3
HND-006895,2011,71400003,,,,12,5,17
HND-006897,2011,71400005,,,,7,9,16
HND-006898,2011,71400006,,,,2,0,2
HND-006900,2011,71400008,,,,13,10,23
HND-006901,2011,71400009,,,,3,7,10
HND-006910,2011,71400019,,,,2,3,5
HND-006912,2011,71400021,,,,5,4,9
HND-006914,2011,71400023,,,,0,3,3
HND-006918,2011,71400027,,,,3,3,6
HND-006932,2011,71400045,,,,5,2,7
HND-006933,2011,71400046,,,,5,1,6
HND-006936,2011,71400050,,,,2,0,2
HND-006938,2011,71400092,,,,2,4,6
HND-006893,2011,71400001,,,,11,7,18
HND-006894,2011,71400002,,,,4,2,6
HND-006897,2011,71400005,,,,2,5,7
HND-006898,2011,71400006,,,,2,2,4
HND-006899,2011,71400007,,,,7,5,12
HND-006900,2011,71400008,,,,10,4,14
HND-006901,2011,71400009,,,,6,2,8
HND-006902,2011,71400010,,,,4,2,6
HND-006906,2011,71400014,,,,1,2,3
HND-006907,2011,71400015,,,,2,0,2
HND-006908,2011,71400016,,,,2,2,4
HND-006910,2011,71400019,,,,1,1,2
HND-006920,2011,71400029,,,,0,2,2
HND-006932,2011,71400045,,,,4,3,7
HND-006933,2011,71400046,,,,3,3,6
HND-006934,2011,71400047,,,,1,2,3
HND-006935,2011,71400049,,,,2,2,4
HND-006936,2011,71400050,,,,0,2,2
HND-006895,2011,71400003,,,,16,11,27
HND-006896,2011,71400004,,,,3,5,8
HND-006903,2011,71400011,,,,0,2,2
HND-006904,2011,71400012,,,,5,5,10
HND-006905,2011,71400013,,,,2,1,3
HND-006909,2011,71400017,,,,2,2,4
HND-006911,2011,71400020,,,,5,4,9
HND-006912,2011,71400021,,,,2,3,5
HND-006913,2011,71400022,,,,2,2,4
HND-006914,2011,71400023,,,,0,3,3
HND-006915,2011,71400024,,,,3,6,9
HND-006916,2011,71400025,,,,1,1,2
HND-006917,2011,71400026,,,,13,12,25
HND-006918,2011,71400027,,,,1,2,3
HND-006919,2011,71400028,,,,3,3,6
HND-006938,2011,71400092,,,,3,2,5
HND-006895,2011,71400003,,,,11,16,27
HND-006897,2011,71400005,,,,6,6,12
HND-006900,2011,71400008,,,,13,12,25
HND-006901,2011,71400009,,,,4,2,6
HND-006910,2011,71400019,,,,1,2,3
HND-006912,2011,71400021,,,,3,2,5
HND-006914,2011,71400023,,,,5,1,6
HND-006918,2011,71400027,,,,3,3,6
HND-006932,2011,71400045,,,,2,2,4
HND-006933,2011,71400046,,,,4,0,4
HND-006936,2011,71400050,,,,3,1,4
HND-006938,2011,71400092,,,,1,3,4
HND-006893,2011,71400001,,,,5,11,16
HND-006894,2011,71400002,,,,6,2,8
HND-006896,2011,71400004,,,,4,2,6
HND-006899,2011,71400007,,,,11,9,20
HND-006902,2011,71400010,,,,2,5,7
HND-006903,2011,71400011,,,,10,2,12
HND-006904,2011,71400012,,,,10,10,20
HND-006905,2011,71400013,,,,0,2,2
HND-006906,2011,71400014,,,,1,1,2
HND-006907,2011,71400015,,,,1,1,2
HND-006908,2011,71400016,,,,2,1,3
HND-006909,2011,71400017,,,,4,4,8
HND-006911,2011,71400020,,,,2,7,9
HND-006913,2011,71400022,,,,2,3,5
HND-006915,2011,71400024,,,,3,3,6
HND-006916,2011,71400025,,,,2,3,5
HND-006917,2011,71400026,,,,17,22,39
HND-006919,2011,71400028,,,,1,3,4
HND-006920,2011,71400029,,,,1,1,2
HND-006934,2011,71400047,,,,3,2,5
HND-006935,2011,71400049,,,,0,1,1
HND-006893,2011,71400001,,,,15,9,24
HND-006894,2011,71400002,,,,4,4,8
HND-006897,2011,71400005,,,,3,4,7
HND-006898,2011,71400006,,,,3,3,6
HND-006899,2011,71400007,,,,11,6,17
HND-006900,2011,71400008,,,,6,7,13
HND-006902,2011,71400010,,,,5,2,7
HND-006904,2011,71400012,,,,4,4,8
HND-006906,2011,71400014,,,,1,2,3
HND-006908,2011,71400016,,,,4,3,7
HND-006910,2011,71400019,,,,2,1,3
HND-006911,2011,71400020,,,,3,3,6
HND-006916,2011,71400025,,,,2,1,3
HND-006919,2011,71400028,,,,2,3,5
HND-006920,2011,71400029,,,,1,2,3
HND-006933,2011,71400046,,,,2,2,4
HND-006934,2011,71400047,,,,0,2,2
HND-006935,2011,71400049,,,,2,1,3
HND-006936,2011,71400050,,,,1,4,5
HND-006895,2011,71400003,,,,7,12,19
HND-006896,2011,71400004,,,,0,2,2
HND-006901,2011,71400009,,,,3,2,5
HND-006903,2011,71400011,,,,4,6,10
HND-006905,2011,71400013,,,,1,0,1
HND-006909,2011,71400017,,,,2,0,2
HND-006912,2011,71400021,,,,4,3,7
HND-006913,2011,71400022,,,,6,1,7
HND-006914,2011,71400023,,,,1,2,3
HND-006915,2011,71400024,,,,6,1,7
HND-006917,2011,71400026,,,,17,11,28
HND-006918,2011,71400027,,,,2,0,2
HND-006932,2011,71400045,,,,6,3,9
HND-006938,2011,71400092,,,,0,7,7
HND-006893,2011,71400001,,,,12,14,26
HND-006894,2011,71400002,,,,4,2,6
HND-006896,2011,71400004,,,,3,3,6
HND-006898,2011,71400006,,,,6,1,7
HND-006899,2011,71400007,,,,9,8,17
HND-006902,2011,71400010,,,,1,4,5
HND-006903,2011,71400011,,,,7,7,14
HND-006904,2011,71400012,,,,7,9,16
HND-006905,2011,71400013,,,,2,1,3
HND-006906,2011,71400014,,,,2,4,6
HND-006907,2011,71400015,,,,3,2,5
HND-006908,2011,71400016,,,,4,2,6
HND-006909,2011,71400017,,,,5,7,12
HND-006910,2011,71400019,,,,1,2,3
HND-006911,2011,71400020,,,,2,0,2
HND-006915,2011,71400024,,,,10,6,16
HND-006916,2011,71400025,,,,1,2,3
HND-006917,2011,71400026,,,,15,15,30
HND-006919,2011,71400028,,,,4,0,4
HND-006920,2011,71400029,,,,2,1,3
HND-006934,2011,71400047,,,,4,0,4
HND-006935,2011,71400049,,,,1,2,3
HND-006936,2011,71400050,,,,0,1,1
HND-006895,2011,71400003,,,,14,9,23
HND-006897,2011,71400005,,,,5,4,9
HND-006900,2011,71400008,,,,4,8,12
HND-006901,2011,71400009,,,,3,4,7
HND-006912,2011,71400021,,,,4,3,7
HND-006913,2011,71400022,,,,5,2,7
HND-006914,2011,71400023,,,,0,7,7
HND-006918,2011,71400027,,,,3,1,4
HND-006932,2011,71400045,,,,7,6,13
HND-006933,2011,71400046,,,,2,0,2
HND-006938,2011,71400092,,,,3,1,4
HND-006895,2011,71400003,,,,18,13,31
HND-006896,2011,71400004,,,,3,6,9
HND-006903,2011,71400011,,,,9,9,18
HND-006904,2011,71400012,,,,4,7,11
HND-006905,2011,71400013,,,,0,2,2
HND-006909,2011,71400017,,,,4,4,8
HND-006911,2011,71400020,,,,1,3,4
HND-006912,2011,71400021,,,,3,4,7
HND-006913,2011,71400022,,,,2,1,3
HND-006914,2011,71400023,,,,1,2,3
HND-006915,2011,71400024,,,,4,3,7
HND-006916,2011,71400025,,,,2,3,5
HND-006917,2011,71400026,,,,15,12,27
HND-006919,2011,71400028,,,,2,1,3
HND-006938,2011,71400092,,,,2,1,3
HND-006893,2011,71400001,,,,8,12,20
HND-006894,2011,71400002,,,,3,3,6
HND-006897,2011,71400005,,,,2,6,8
HND-006898,2011,71400006,,,,0,4,4
HND-006899,2011,71400007,,,,3,4,7
HND-006900,2011,71400008,,,,7,8,15
HND-006901,2011,71400009,,,,6,4,10
HND-006902,2011,71400010,,,,1,1,2
HND-006906,2011,71400014,,,,2,4,6
HND-006907,2011,71400015,,,,2,0,2
HND-006908,2011,71400016,,,,7,5,12
HND-006910,2011,71400019,,,,1,3,4
HND-006920,2011,71400029,,,,2,1,3
HND-006932,2011,71400045,,,,5,5,10
HND-006933,2011,71400046,,,,2,2,4
HND-006934,2011,71400047,,,,1,4,5
HND-006935,2011,71400049,,,,2,3,5
HND-006936,2011,71400050,,,,1,1,2
HND-006903,2011,71400011,,,,6,16,22
HND-006917,2011,71400026,,,,18,13,31
HND-006901,2011,71400009,,,,11,15,26
HND-006926,2011,71400036,,,,26,27,53
HND-006901,2011,71400009,,,,10,7,17
HND-006903,2011,71400011,,,,2,10,12
HND-006917,2011,71400026,,,,14,10,24
HND-006926,2011,71400036,,,,33,16,49
HND-006926,2011,71400036,,,,26,23,49
HND-006901,2011,71400009,,,,7,14,21
HND-006903,2011,71400011,,,,9,4,13
HND-006917,2011,71400026,,,,14,15,29
HND-006926,2011,71400036,,,,16,7,23
HND-006926,2011,71400036,,,,12,7,19
HND-006926,2011,71400036,,,,12,9,21
HND-006939,2011,71500006,,,,8,5,13
HND-006953,2011,71500020,,,,4,7,11
,2011,71500142,,,,7,9,16
HND-007063,2011,71500169,,,,6,7,13
,2011,71500236,,,,5,4,9
HND-007076,2011,71500239,,,,5,7,12
,2011,71500241,,,,3,2,5
,2011,71500243,,,,1,6,7
,2011,71500251,,,,2,3,5
,2011,71500256,,,,8,5,13
,2011,71500257,,,,3,6,9
HND-007081,2011,71500258,,,,7,5,12
,2011,71500261,,,,5,3,8
,2011,71500262,,,,5,9,14
HND-007083,2011,71500263,,,,2,3,5
HND-007084,2011,71500264,,,,13,5,18
,2011,71500266,,,,6,2,8
,2011,71500270,,,,3,7,10
,2011,71500271,,,,4,5,9
HND-007086,2011,71500272,,,,4,3,7
,2011,71500273,,,,4,4,8
,2011,71500274,,,,4,4,8
HND-007087,2011,71500275,,,,5,6,11
HND-007088,2011,71500276,,,,3,4,7
,2011,71500277,,,,1,5,6
HND-007089,2011,71500278,,,,1,7,8
HND-007090,2011,71500279,,,,0,6,6
,2011,71500281,,,,7,2,9
,2011,71500290,,,,5,8,13
,2011,71500295,,,,5,5,10
,2011,71500298,,,,3,5,8
,2011,71500299,,,,4,3,7
HND-006946,2011,71500013,,,,3,8,11
HND-006950,2011,71500017,,,,10,12,22
HND-006972,2011,71500039,,,,2,5,7
HND-006991,2011,71500058,,,,2,3,5
HND-006994,2011,71500061,,,,7,2,9
HND-007062,2011,71500147,,,,3,5,8
,2011,71500151,,,,9,9,18
,2011,71500159,,,,5,3,8
HND-007064,2011,71500188,,,,7,3,10
,2011,71500237,,,,4,6,10
HND-007077,2011,71500240,,,,1,5,6
,2011,71500248,,,,5,4,9
HND-007080,2011,71500249,,,,9,5,14
,2011,71500260,,,,8,8,16
,2011,71500265,,,,4,7,11
,2011,71500280,,,,6,5,11
,2011,71500282,,,,7,6,13
,2011,71500283,,,,2,8,10
,2011,71500284,,,,7,4,11
HND-007091,2011,71500285,,,,3,5,8
,2011,71500286,,,,4,4,8
,2011,71500287,,,,2,4,6
,2011,71500288,,,,5,2,7
HND-007092,2011,71500289,,,,6,4,10
,2011,71500291,,,,9,6,15
HND-007093,2011,71500292,,,,5,2,7
,2011,71500293,,,,2,4,6
,2011,71500294,,,,3,2,5
,2011,71500296,,,,7,3,10
,2011,71500297,,,,3,3,6
HND-007012,2011,71500082,,,,5,8,13
HND-007013,2011,71500083,,,,15,21,36
HND-007014,2011,71500084,,,,4,5,9
,2011,71500086,,,,3,4,7
,2011,71500102,,,,11,14,25
HND-007037,2011,71500113,,,,2,4,6
HND-007038,2011,71500114,,,,1,2,3
HND-007039,2011,71500115,,,,2,1,3
HND-007040,2011,71500116,,,,8,5,13
HND-007041,2011,71500117,,,,0,1,1
HND-007042,2011,71500118,,,,1,2,3
HND-007056,2011,71500136,,,,1,3,4
HND-007057,2011,71500137,,,,5,5,10
HND-007085,2011,71500267,,,,1,0,1
HND-007014,2011,71500084,,,,14,11,25
,2011,71500086,,,,4,3,7
HND-007037,2011,71500113,,,,4,5,9
HND-007038,2011,71500114,,,,5,6,11
HND-007039,2011,71500115,,,,6,7,13
HND-007040,2011,71500116,,,,3,4,7
HND-007041,2011,71500117,,,,5,11,16
HND-007042,2011,71500118,,,,8,3,11
HND-007056,2011,71500136,,,,6,4,10
HND-007057,2011,71500137,,,,7,8,15
HND-007085,2011,71500267,,,,8,5,13
HND-007012,2011,71500082,,,,19,13,32
HND-007013,2011,71500083,,,,16,10,26
,2011,71500102,,,,10,7,17
,2011,71500269,,,,5,3,8
HND-006940,2011,71500007,,,,5,1,6
HND-006945,2011,71500012,,,,6,11,17
HND-006948,2011,71500015,,,,14,15,29
HND-006949,2011,71500016,,,,10,7,17
HND-006951,2011,71500018,,,,13,14,27
HND-006954,2011,71500021,,,,6,5,11
HND-006955,2011,71500022,,,,7,20,27
HND-006956,2011,71500023,,,,4,6,10
HND-006960,2011,71500027,,,,4,8,12
HND-006963,2011,71500030,,,,8,6,14
HND-006968,2011,71500035,,,,9,7,16
HND-006969,2011,71500036,,,,6,10,16
HND-006971,2011,71500038,,,,11,10,21
HND-006972,2011,71500039,,,,3,2,5
HND-006973,2011,71500040,,,,5,6,11
HND-006977,2011,71500044,,,,11,5,16
HND-006978,2011,71500045,,,,12,4,16
HND-006979,2011,71500046,,,,1,1,2
,2011,71500048,,,,16,8,24
HND-006982,2011,71500049,,,,2,3,5
HND-006983,2011,71500050,,,,9,5,14
HND-006985,2011,71500052,,,,21,17,38
HND-006987,2011,71500054,,,,10,5,15
,2011,71500055,,,,10,10,20
HND-006989,2011,71500056,,,,4,6,10
HND-006991,2011,71500058,,,,8,3,11
HND-006992,2011,71500059,,,,19,10,29
HND-006994,2011,71500061,,,,3,4,7
HND-006995,2011,71500062,,,,1,3,4
HND-006996,2011,71500063,,,,9,9,18
HND-006997,2011,71500064,,,,3,2,5
HND-006999,2011,71500066,,,,3,3,6
HND-007000,2011,71500067,,,,5,3,8
HND-007004,2011,71500071,,,,9,8,17
HND-007011,2011,71500081,,,,3,8,11
HND-007017,2011,71500088,,,,7,5,12
HND-007020,2011,71500091,,,,16,6,22
HND-007019,2011,71500091,,,,16,6,22
HND-007021,2011,71500093,,,,1,3,4
HND-007027,2011,71500100,,,,5,4,9
HND-007028,2011,71500101,,,,4,6,10
HND-007032,2011,71500105,,,,8,4,12
HND-007035,2011,71500108,,,,5,1,6
HND-007036,2011,71500109,,,,5,9,14
HND-007043,2011,71500120,,,,3,4,7
,2011,71500122,,,,8,4,12
,2011,71500125,,,,4,3,7
HND-007049,2011,71500128,,,,13,5,18
HND-007050,2011,71500129,,,,1,1,2
HND-007061,2011,71500141,,,,6,1,7
HND-007066,2011,71500225,,,,13,9,22
HND-007069,2011,71500229,,,,9,3,12
HND-007072,2011,71500232,,,,2,4,6
,2011,71500233,,,,2,5,7
HND-006939,2011,71500006,,,,12,5,17
HND-006941,2011,71500008,,,,2,4,6
HND-006942,2011,71500009,,,,6,3,9
HND-006943,2011,71500010,,,,21,6,27
HND-006944,2011,71500011,,,,16,14,30
HND-006946,2011,71500013,,,,4,0,4
,2011,71500014,,,,5,5,10
HND-006950,2011,71500017,,,,8,5,13
HND-006952,2011,71500019,,,,49,41,90
HND-006953,2011,71500020,,,,7,17,24
HND-006957,2011,71500024,,,,4,0,4
HND-006958,2011,71500025,,,,4,2,6
HND-006959,2011,71500026,,,,4,2,6
HND-006961,2011,71500028,,,,25,16,41
HND-006962,2011,71500029,,,,10,13,23
HND-006964,2011,71500031,,,,5,1,6
HND-006965,2011,71500032,,,,19,11,30
HND-006966,2011,71500033,,,,16,5,21
HND-006967,2011,71500034,,,,9,10,19
HND-006970,2011,71500037,,,,8,3,11
HND-006974,2011,71500041,,,,5,9,14
HND-006975,2011,71500042,,,,8,6,14
HND-006976,2011,71500043,,,,32,26,58
HND-006980,2011,71500047,,,,6,6,12
HND-006984,2011,71500051,,,,7,2,9
HND-006986,2011,71500053,,,,4,3,7
HND-006990,2011,71500057,,,,3,4,7
HND-006993,2011,71500060,,,,7,4,11
HND-006998,2011,71500065,,,,3,3,6
HND-007001,2011,71500068,,,,3,9,12
HND-007002,2011,71500069,,,,12,10,22
HND-007003,2011,71500070,,,,1,4,5
HND-007005,2011,71500072,,,,5,4,9
HND-007006,2011,71500074,,,,12,3,15
,2011,71500075,,,,2,3,5
HND-007008,2011,71500076,,,,0,1,1
HND-007009,2011,71500078,,,,9,10,19
HND-007010,2011,71500079,,,,4,5,9
HND-007018,2011,71500089,,,,6,7,13
HND-007022,2011,71500094,,,,12,5,17
HND-007023,2011,71500095,,,,11,8,19
HND-007024,2011,71500097,,,,5,5,10
HND-007025,2011,71500098,,,,6,3,9
,2011,71500099,,,,6,3,9
,2011,71500103,,,,36,20,56
,2011,71500104,,,,1,3,4
HND-007033,2011,71500106,,,,9,15,24
HND-007034,2011,71500107,,,,7,6,13
,2011,71500121,,,,21,21,42
HND-007047,2011,71500126,,,,10,3,13
,2011,71500127,,,,0,2,2
HND-007051,2011,71500130,,,,5,4,9
HND-007052,2011,71500131,,,,4,9,13
HND-007053,2011,71500132,,,,3,0,3
HND-007054,2011,71500133,,,,5,11,16
HND-007055,2011,71500134,,,,17,17,34
HND-007058,2011,71500138,,,,3,1,4
HND-007059,2011,71500139,,,,14,9,23
HND-007060,2011,71500140,,,,6,2,8
HND-007065,2011,71500223,,,,9,4,13
HND-007067,2011,71500226,,,,4,2,6
HND-007068,2011,71500227,,,,3,3,6
HND-007070,2011,71500230,,,,3,2,5
HND-007071,2011,71500231,,,,5,9,14
HND-007074,2011,71500234,,,,5,5,10
HND-007075,2011,71500235,,,,2,4,6
HND-007078,2011,71500246,,,,5,3,8
HND-007079,2011,71500247,,,,3,1,4
HND-006939,2011,71500006,,,,4,5,9
HND-006940,2011,71500007,,,,6,3,9
HND-006941,2011,71500008,,,,3,7,10
HND-006953,2011,71500020,,,,5,6,11
HND-006954,2011,71500021,,,,4,11,15
HND-006955,2011,71500022,,,,8,0,8
HND-006956,2011,71500023,,,,7,3,10
HND-006957,2011,71500024,,,,3,0,3
HND-006958,2011,71500025,,,,2,7,9
HND-006959,2011,71500026,,,,3,8,11
HND-006960,2011,71500027,,,,9,7,16
HND-006961,2011,71500028,,,,19,18,37
HND-006962,2011,71500029,,,,6,9,15
HND-006983,2011,71500050,,,,4,5,9
HND-006992,2011,71500059,,,,10,11,21
HND-006993,2011,71500060,,,,8,11,19
HND-006995,2011,71500062,,,,3,3,6
HND-006997,2011,71500064,,,,7,4,11
HND-006998,2011,71500065,,,,5,4,9
HND-006999,2011,71500066,,,,4,3,7
HND-007001,2011,71500068,,,,3,2,5
HND-007002,2011,71500069,,,,1,5,6
HND-007003,2011,71500070,,,,7,5,12
HND-007004,2011,71500071,,,,2,7,9
HND-007005,2011,71500072,,,,5,4,9
HND-007006,2011,71500074,,,,6,5,11
,2011,71500075,,,,6,6,12
HND-007008,2011,71500076,,,,4,2,6
HND-007009,2011,71500078,,,,6,8,14
HND-007018,2011,71500089,,,,4,7,11
HND-007020,2011,71500091,,,,7,3,10
HND-007019,2011,71500091,,,,7,3,10
HND-007021,2011,71500093,,,,5,0,5
HND-007022,2011,71500094,,,,4,8,12
HND-007024,2011,71500097,,,,1,3,4
HND-007025,2011,71500098,,,,2,4,6
HND-007027,2011,71500100,,,,5,2,7
,2011,71500103,,,,18,18,36
HND-007034,2011,71500107,,,,5,11,16
HND-007043,2011,71500120,,,,5,4,9
,2011,71500121,,,,16,18,34
,2011,71500127,,,,3,0,3
HND-007052,2011,71500131,,,,3,6,9
HND-007054,2011,71500133,,,,5,6,11
HND-007055,2011,71500134,,,,9,10,19
HND-007058,2011,71500138,,,,2,0,2
HND-007060,2011,71500140,,,,2,3,5
HND-007061,2011,71500141,,,,1,2,3
HND-007065,2011,71500223,,,,6,4,10
HND-007068,2011,71500227,,,,4,3,7
HND-007071,2011,71500231,,,,2,1,3
HND-007072,2011,71500232,,,,4,2,6
,2011,71500233,,,,4,4,8
HND-007075,2011,71500235,,,,2,3,5
HND-007079,2011,71500247,,,,4,5,9
HND-006942,2011,71500009,,,,2,0,2
HND-006943,2011,71500010,,,,13,13,26
HND-006944,2011,71500011,,,,12,5,17
HND-006945,2011,71500012,,,,9,10,19
HND-006946,2011,71500013,,,,7,4,11
HND-006948,2011,71500015,,,,0,1,1
HND-006949,2011,71500016,,,,6,1,7
HND-006950,2011,71500017,,,,10,7,17
HND-006951,2011,71500018,,,,9,7,16
HND-006952,2011,71500019,,,,37,41,78
HND-006963,2011,71500030,,,,3,6,9
HND-006964,2011,71500031,,,,3,2,5
HND-006965,2011,71500032,,,,11,5,16
HND-006966,2011,71500033,,,,3,9,12
HND-006967,2011,71500034,,,,10,10,20
HND-006968,2011,71500035,,,,8,4,12
HND-006969,2011,71500036,,,,6,3,9
HND-006970,2011,71500037,,,,1,0,1
HND-006971,2011,71500038,,,,12,10,22
HND-006972,2011,71500039,,,,1,3,4
HND-006974,2011,71500041,,,,1,2,3
HND-006975,2011,71500042,,,,5,8,13
HND-006976,2011,71500043,,,,9,17,26
HND-006977,2011,71500044,,,,9,4,13
HND-006978,2011,71500045,,,,15,15,30
HND-006979,2011,71500046,,,,2,1,3
HND-006980,2011,71500047,,,,5,1,6
,2011,71500048,,,,10,6,16
HND-006982,2011,71500049,,,,1,8,9
HND-006984,2011,71500051,,,,2,8,10
HND-006985,2011,71500052,,,,6,5,11
HND-006986,2011,71500053,,,,2,5,7
HND-006987,2011,71500054,,,,7,5,12
,2011,71500055,,,,6,12,18
HND-006989,2011,71500056,,,,3,2,5
HND-006990,2011,71500057,,,,8,2,10
HND-006991,2011,71500058,,,,1,4,5
HND-006994,2011,71500061,,,,5,3,8
HND-006996,2011,71500063,,,,4,4,8
HND-007000,2011,71500067,,,,5,4,9
HND-007010,2011,71500079,,,,1,1,2
HND-007011,2011,71500081,,,,5,7,12
HND-007017,2011,71500088,,,,3,3,6
HND-007023,2011,71500095,,,,5,12,17
,2011,71500099,,,,4,2,6
HND-007028,2011,71500101,,,,2,3,5
,2011,71500104,,,,2,1,3
HND-007032,2011,71500105,,,,2,4,6
HND-007033,2011,71500106,,,,14,7,21
HND-007035,2011,71500108,,,,6,0,6
HND-007036,2011,71500109,,,,5,3,8
,2011,71500122,,,,4,6,10
,2011,71500125,,,,3,6,9
HND-007047,2011,71500126,,,,2,1,3
HND-007049,2011,71500128,,,,7,2,9
HND-007050,2011,71500129,,,,1,1,2
HND-007051,2011,71500130,,,,2,5,7
HND-007053,2011,71500132,,,,3,2,5
HND-007059,2011,71500139,,,,4,3,7
HND-007066,2011,71500225,,,,5,6,11
HND-007067,2011,71500226,,,,2,3,5
HND-007069,2011,71500229,,,,5,2,7
HND-007074,2011,71500234,,,,3,4,7
HND-007078,2011,71500246,,,,6,6,12
HND-006939,2011,71500006,,,,1,0,1
HND-006941,2011,71500008,,,,5,3,8
HND-006942,2011,71500009,,,,6,3,9
HND-006943,2011,71500010,,,,3,8,11
HND-006944,2011,71500011,,,,4,5,9
HND-006946,2011,71500013,,,,1,2,3
,2011,71500014,,,,2,0,2
HND-006950,2011,71500017,,,,13,9,22
HND-006952,2011,71500019,,,,40,35,75
HND-006953,2011,71500020,,,,4,8,12
HND-006957,2011,71500024,,,,1,2,3
HND-006958,2011,71500025,,,,1,1,2
HND-006959,2011,71500026,,,,5,3,8
HND-006961,2011,71500028,,,,10,14,24
HND-006962,2011,71500029,,,,7,9,16
HND-006964,2011,71500031,,,,0,6,6
HND-006965,2011,71500032,,,,8,6,14
HND-006966,2011,71500033,,,,3,7,10
HND-006970,2011,71500037,,,,2,2,4
HND-006974,2011,71500041,,,,0,3,3
HND-006976,2011,71500043,,,,5,6,11
HND-006980,2011,71500047,,,,2,8,10
HND-006993,2011,71500060,,,,6,5,11
HND-006998,2011,71500065,,,,2,2,4
HND-006999,2011,71500066,,,,2,1,3
HND-007001,2011,71500068,,,,7,3,10
HND-007002,2011,71500069,,,,0,5,5
HND-007003,2011,71500070,,,,2,2,4
HND-007005,2011,71500072,,,,5,1,6
HND-007006,2011,71500074,,,,4,6,10
,2011,71500075,,,,2,6,8
HND-007008,2011,71500076,,,,3,1,4
HND-007009,2011,71500078,,,,4,3,7
HND-007010,2011,71500079,,,,0,4,4
HND-007018,2011,71500089,,,,6,7,13
HND-007021,2011,71500093,,,,4,1,5
HND-007022,2011,71500094,,,,6,5,11
HND-007023,2011,71500095,,,,3,6,9
HND-007024,2011,71500097,,,,5,1,6
HND-007025,2011,71500098,,,,2,4,6
,2011,71500099,,,,5,3,8
,2011,71500103,,,,23,25,48
,2011,71500104,,,,3,1,4
HND-007034,2011,71500107,,,,7,4,11
,2011,71500121,,,,4,3,7
HND-007047,2011,71500126,,,,1,1,2
,2011,71500127,,,,2,3,5
HND-007051,2011,71500130,,,,3,8,11
HND-007052,2011,71500131,,,,3,7,10
HND-007053,2011,71500132,,,,2,6,8
HND-007054,2011,71500133,,,,6,3,9
HND-007055,2011,71500134,,,,7,4,11
HND-007058,2011,71500138,,,,1,3,4
HND-007059,2011,71500139,,,,3,3,6
HND-007060,2011,71500140,,,,2,2,4
HND-007065,2011,71500223,,,,5,5,10
HND-007067,2011,71500226,,,,1,1,2
HND-007068,2011,71500227,,,,3,1,4
HND-007070,2011,71500230,,,,4,0,4
HND-007075,2011,71500235,,,,3,1,4
HND-007078,2011,71500246,,,,2,3,5
HND-007079,2011,71500247,,,,0,2,2
HND-006940,2011,71500007,,,,2,4,6
HND-006945,2011,71500012,,,,6,7,13
HND-006948,2011,71500015,,,,0,2,2
HND-006949,2011,71500016,,,,4,3,7
HND-006951,2011,71500018,,,,8,8,16
HND-006954,2011,71500021,,,,8,2,10
HND-006955,2011,71500022,,,,3,4,7
HND-006956,2011,71500023,,,,5,3,8
HND-006960,2011,71500027,,,,2,4,6
HND-006963,2011,71500030,,,,3,1,4
HND-006967,2011,71500034,,,,8,9,17
HND-006968,2011,71500035,,,,5,10,15
HND-006969,2011,71500036,,,,11,4,15
HND-006971,2011,71500038,,,,1,2,3
HND-006972,2011,71500039,,,,2,1,3
HND-006973,2011,71500040,,,,0,3,3
HND-006975,2011,71500042,,,,6,7,13
HND-006977,2011,71500044,,,,5,7,12
HND-006978,2011,71500045,,,,10,6,16
HND-006979,2011,71500046,,,,1,2,3
,2011,71500048,,,,5,5,10
HND-006982,2011,71500049,,,,2,0,2
HND-006983,2011,71500050,,,,9,5,14
HND-006984,2011,71500051,,,,3,2,5
HND-006985,2011,71500052,,,,14,8,22
HND-006986,2011,71500053,,,,2,0,2
HND-006987,2011,71500054,,,,6,6,12
,2011,71500055,,,,10,11,21
HND-006989,2011,71500056,,,,0,6,6
HND-006990,2011,71500057,,,,5,3,8
HND-006991,2011,71500058,,,,5,4,9
HND-006992,2011,71500059,,,,4,9,13
HND-006994,2011,71500061,,,,5,3,8
HND-006995,2011,71500062,,,,3,2,5
HND-006996,2011,71500063,,,,8,4,12
HND-006997,2011,71500064,,,,2,4,6
HND-007000,2011,71500067,,,,1,3,4
HND-007011,2011,71500081,,,,6,2,8
HND-007017,2011,71500088,,,,4,1,5
HND-007020,2011,71500091,,,,2,4,6
HND-007019,2011,71500091,,,,2,4,6
HND-007027,2011,71500100,,,,2,1,3
HND-007028,2011,71500101,,,,1,3,4
HND-007032,2011,71500105,,,,2,6,8
HND-007033,2011,71500106,,,,6,5,11
HND-007035,2011,71500108,,,,0,4,4
HND-007036,2011,71500109,,,,2,1,3
HND-007043,2011,71500120,,,,2,3,5
,2011,71500122,,,,3,4,7
,2011,71500125,,,,3,3,6
HND-007049,2011,71500128,,,,3,3,6
HND-007050,2011,71500129,,,,1,2,3
HND-007061,2011,71500141,,,,0,3,3
HND-007066,2011,71500225,,,,1,2,3
HND-007069,2011,71500229,,,,2,2,4
HND-007072,2011,71500232,,,,1,2,3
,2011,71500233,,,,2,0,2
HND-007074,2011,71500234,,,,8,1,9
HND-006939,2011,71500006,,,,1,0,1
HND-006940,2011,71500007,,,,1,0,1
HND-006948,2011,71500015,,,,5,3,8
HND-006951,2011,71500018,,,,1,2,3
HND-006953,2011,71500020,,,,4,5,9
HND-006954,2011,71500021,,,,4,1,5
HND-006955,2011,71500022,,,,2,3,5
HND-006956,2011,71500023,,,,4,5,9
HND-006957,2011,71500024,,,,3,3,6
HND-006958,2011,71500025,,,,1,5,6
HND-006959,2011,71500026,,,,4,3,7
HND-006960,2011,71500027,,,,3,5,8
HND-006961,2011,71500028,,,,13,12,25
HND-006972,2011,71500039,,,,5,1,6
HND-006973,2011,71500040,,,,4,0,4
HND-006978,2011,71500045,,,,1,8,9
HND-006982,2011,71500049,,,,2,6,8
HND-006983,2011,71500050,,,,1,2,3
,2011,71500055,,,,4,9,13
HND-006989,2011,71500056,,,,3,0,3
HND-006991,2011,71500058,,,,3,0,3
HND-006992,2011,71500059,,,,7,8,15
HND-006993,2011,71500060,,,,6,10,16
HND-006994,2011,71500061,,,,9,5,14
HND-006995,2011,71500062,,,,2,1,3
HND-006996,2011,71500063,,,,3,6,9
HND-006997,2011,71500064,,,,0,2,2
HND-006998,2011,71500065,,,,1,0,1
HND-006999,2011,71500066,,,,3,2,5
HND-007000,2011,71500067,,,,4,8,12
HND-007001,2011,71500068,,,,5,5,10
HND-007002,2011,71500069,,,,3,2,5
HND-007004,2011,71500071,,,,4,4,8
HND-007005,2011,71500072,,,,10,5,15
HND-007006,2011,71500074,,,,5,4,9
HND-007008,2011,71500076,,,,3,0,3
HND-007011,2011,71500081,,,,2,4,6
HND-007017,2011,71500088,,,,4,1,5
HND-007018,2011,71500089,,,,2,1,3
HND-007020,2011,71500091,,,,12,5,17
HND-007019,2011,71500091,,,,12,5,17
HND-007021,2011,71500093,,,,2,6,8
HND-007022,2011,71500094,,,,3,4,7
HND-007024,2011,71500097,,,,3,2,5
HND-007027,2011,71500100,,,,3,2,5
HND-007036,2011,71500109,,,,1,2,3
HND-007043,2011,71500120,,,,7,1,8
,2011,71500122,,,,4,4,8
HND-007055,2011,71500134,,,,4,6,10
HND-007061,2011,71500141,,,,2,5,7
HND-007070,2011,71500230,,,,3,1,4
,2011,71500233,,,,2,7,9
HND-007075,2011,71500235,,,,3,1,4
HND-006941,2011,71500008,,,,6,6,12
HND-006942,2011,71500009,,,,1,0,1
HND-006943,2011,71500010,,,,6,7,13
HND-006944,2011,71500011,,,,3,7,10
HND-006945,2011,71500012,,,,4,6,10
HND-006946,2011,71500013,,,,5,1,6
,2011,71500014,,,,3,1,4
HND-006949,2011,71500016,,,,8,4,12
HND-006950,2011,71500017,,,,3,5,8
HND-006952,2011,71500019,,,,33,42,75
HND-006962,2011,71500029,,,,7,7,14
HND-006963,2011,71500030,,,,3,1,4
HND-006964,2011,71500031,,,,4,2,6
HND-006965,2011,71500032,,,,7,2,9
HND-006966,2011,71500033,,,,6,3,9
HND-006967,2011,71500034,,,,9,3,12
HND-006968,2011,71500035,,,,3,10,13
HND-006969,2011,71500036,,,,2,3,5
HND-006970,2011,71500037,,,,3,2,5
HND-006971,2011,71500038,,,,4,7,11
HND-006974,2011,71500041,,,,3,3,6
HND-006975,2011,71500042,,,,2,9,11
HND-006976,2011,71500043,,,,1,2,3
HND-006977,2011,71500044,,,,4,5,9
HND-006979,2011,71500046,,,,1,1,2
HND-006980,2011,71500047,,,,3,2,5
,2011,71500048,,,,4,4,8
HND-006984,2011,71500051,,,,5,6,11
HND-006985,2011,71500052,,,,4,5,9
HND-006986,2011,71500053,,,,5,0,5
HND-006987,2011,71500054,,,,6,4,10
HND-006990,2011,71500057,,,,0,3,3
HND-007003,2011,71500070,,,,6,2,8
,2011,71500075,,,,3,1,4
HND-007009,2011,71500078,,,,4,5,9
HND-007010,2011,71500079,,,,4,2,6
HND-007023,2011,71500095,,,,2,1,3
HND-007025,2011,71500098,,,,2,4,6
,2011,71500099,,,,1,5,6
HND-007028,2011,71500101,,,,1,2,3
,2011,71500103,,,,23,28,51
,2011,71500104,,,,1,4,5
HND-007032,2011,71500105,,,,3,1,4
HND-007033,2011,71500106,,,,2,4,6
HND-007034,2011,71500107,,,,5,3,8
HND-007035,2011,71500108,,,,1,1,2
,2011,71500121,,,,11,8,19
,2011,71500125,,,,5,2,7
HND-007047,2011,71500126,,,,4,4,8
,2011,71500127,,,,3,1,4
HND-007049,2011,71500128,,,,5,4,9
HND-007050,2011,71500129,,,,1,0,1
HND-007051,2011,71500130,,,,5,2,7
HND-007052,2011,71500131,,,,4,3,7
HND-007053,2011,71500132,,,,0,3,3
HND-007054,2011,71500133,,,,7,7,14
HND-007058,2011,71500138,,,,1,3,4
HND-007059,2011,71500139,,,,5,4,9
HND-007060,2011,71500140,,,,0,1,1
HND-007065,2011,71500223,,,,4,3,7
HND-007066,2011,71500225,,,,3,3,6
HND-007067,2011,71500226,,,,2,1,3
HND-007068,2011,71500227,,,,2,1,3
HND-007069,2011,71500229,,,,7,2,9
HND-007071,2011,71500231,,,,1,4,5
HND-007074,2011,71500234,,,,4,3,7
HND-007078,2011,71500246,,,,8,2,10
HND-007079,2011,71500247,,,,3,6,9
HND-006940,2011,71500007,,,,4,2,6
HND-006948,2011,71500015,,,,6,4,10
HND-006949,2011,71500016,,,,3,5,8
HND-006951,2011,71500018,,,,2,5,7
HND-006954,2011,71500021,,,,2,7,9
HND-006955,2011,71500022,,,,2,4,6
HND-006956,2011,71500023,,,,1,4,5
HND-006957,2011,71500024,,,,4,2,6
HND-006959,2011,71500026,,,,2,2,4
HND-006960,2011,71500027,,,,2,5,7
HND-006964,2011,71500031,,,,4,3,7
HND-006965,2011,71500032,,,,9,12,21
HND-006966,2011,71500033,,,,5,3,8
HND-006967,2011,71500034,,,,8,17,25
HND-006969,2011,71500036,,,,2,0,2
HND-006970,2011,71500037,,,,2,2,4
HND-006974,2011,71500041,,,,0,1,1
HND-006975,2011,71500042,,,,8,6,14
HND-006976,2011,71500043,,,,1,4,5
HND-006977,2011,71500044,,,,6,5,11
HND-006980,2011,71500047,,,,2,2,4
HND-006984,2011,71500051,,,,1,3,4
HND-006986,2011,71500053,,,,4,5,9
HND-006990,2011,71500057,,,,3,4,7
HND-006994,2011,71500061,,,,9,7,16
HND-006995,2011,71500062,,,,3,3,6
HND-006996,2011,71500063,,,,3,5,8
HND-006997,2011,71500064,,,,1,2,3
HND-006998,2011,71500065,,,,0,2,2
HND-006999,2011,71500066,,,,0,1,1
HND-007000,2011,71500067,,,,2,4,6
HND-007001,2011,71500068,,,,3,3,6
HND-007003,2011,71500070,,,,1,2,3
HND-007006,2011,71500074,,,,1,4,5
,2011,71500075,,,,4,2,6
HND-007008,2011,71500076,,,,3,1,4
HND-007009,2011,71500078,,,,3,7,10
HND-007010,2011,71500079,,,,3,0,3
HND-007018,2011,71500089,,,,3,4,7
HND-007022,2011,71500094,,,,4,3,7
HND-007023,2011,71500095,,,,2,5,7
HND-007024,2011,71500097,,,,0,1,1
HND-007025,2011,71500098,,,,5,2,7
,2011,71500099,,,,4,2,6
HND-007027,2011,71500100,,,,3,1,4
HND-007028,2011,71500101,,,,0,3,3
HND-007032,2011,71500105,,,,2,3,5
HND-007036,2011,71500109,,,,0,3,3
HND-007043,2011,71500120,,,,2,2,4
,2011,71500122,,,,3,4,7
HND-007050,2011,71500129,,,,2,2,4
HND-007061,2011,71500141,,,,1,2,3
HND-007069,2011,71500229,,,,4,3,7
HND-007072,2011,71500232,,,,1,1,2
,2011,71500233,,,,1,2,3
HND-006939,2011,71500006,,,,2,1,3
HND-006941,2011,71500008,,,,4,4,8
HND-006942,2011,71500009,,,,7,3,10
HND-006943,2011,71500010,,,,7,7,14
HND-006944,2011,71500011,,,,6,3,9
HND-006945,2011,71500012,,,,3,3,6
HND-006946,2011,71500013,,,,2,3,5
HND-006950,2011,71500017,,,,10,9,19
HND-006952,2011,71500019,,,,35,44,79
HND-006953,2011,71500020,,,,4,3,7
HND-006958,2011,71500025,,,,2,3,5
HND-006961,2011,71500028,,,,18,19,37
HND-006962,2011,71500029,,,,9,5,14
HND-006963,2011,71500030,,,,1,1,2
HND-006968,2011,71500035,,,,5,4,9
HND-006971,2011,71500038,,,,3,4,7
HND-006972,2011,71500039,,,,2,2,4
HND-006973,2011,71500040,,,,3,1,4
HND-006978,2011,71500045,,,,3,9,12
HND-006979,2011,71500046,,,,3,2,5
,2011,71500048,,,,5,3,8
HND-006982,2011,71500049,,,,5,2,7
HND-006983,2011,71500050,,,,2,2,4
HND-006985,2011,71500052,,,,4,9,13
HND-006987,2011,71500054,,,,9,6,15
,2011,71500055,,,,5,5,10
HND-006989,2011,71500056,,,,5,4,9
HND-006991,2011,71500058,,,,7,5,12
HND-006992,2011,71500059,,,,6,5,11
HND-006993,2011,71500060,,,,4,8,12
HND-007002,2011,71500069,,,,4,5,9
HND-007004,2011,71500071,,,,0,1,1
HND-007005,2011,71500072,,,,3,4,7
HND-007011,2011,71500081,,,,1,3,4
HND-007017,2011,71500088,,,,6,4,10
HND-007020,2011,71500091,,,,4,3,7
HND-007019,2011,71500091,,,,4,3,7
HND-007021,2011,71500093,,,,0,1,1
,2011,71500103,,,,13,15,28
,2011,71500104,,,,1,2,3
HND-007033,2011,71500106,,,,4,6,10
HND-007034,2011,71500107,,,,7,3,10
HND-007035,2011,71500108,,,,0,3,3
,2011,71500121,,,,7,7,14
,2011,71500125,,,,3,4,7
HND-007047,2011,71500126,,,,0,2,2
,2011,71500127,,,,1,0,1
HND-007049,2011,71500128,,,,3,4,7
HND-007051,2011,71500130,,,,1,6,7
HND-007052,2011,71500131,,,,3,2,5
HND-007053,2011,71500132,,,,1,1,2
HND-007054,2011,71500133,,,,12,6,18
HND-007055,2011,71500134,,,,1,7,8
HND-007058,2011,71500138,,,,2,0,2
HND-007059,2011,71500139,,,,0,3,3
HND-007060,2011,71500140,,,,2,6,8
HND-007065,2011,71500223,,,,4,3,7
HND-007066,2011,71500225,,,,2,3,5
HND-007067,2011,71500226,,,,0,5,5
HND-007068,2011,71500227,,,,1,0,1
HND-007074,2011,71500234,,,,10,2,12
HND-007075,2011,71500235,,,,5,1,6
HND-007078,2011,71500246,,,,7,6,13
HND-007079,2011,71500247,,,,1,1,2
HND-006942,2011,71500009,,,,2,0,2
HND-006943,2011,71500010,,,,10,12,22
HND-006944,2011,71500011,,,,4,2,6
HND-006945,2011,71500012,,,,4,5,9
HND-006946,2011,71500013,,,,1,3,4
HND-006948,2011,71500015,,,,3,5,8
HND-006949,2011,71500016,,,,2,3,5
HND-006950,2011,71500017,,,,1,6,7
HND-006951,2011,71500018,,,,5,1,6
HND-006952,2011,71500019,,,,45,44,89
HND-006983,2011,71500050,,,,2,0,2
HND-006992,2011,71500059,,,,6,4,10
HND-006994,2011,71500061,,,,5,5,10
HND-006996,2011,71500063,,,,3,3,6
HND-007000,2011,71500067,,,,2,1,3
HND-007003,2011,71500070,,,,12,7,19
HND-007005,2011,71500072,,,,2,1,3
HND-007006,2011,71500074,,,,6,5,11
,2011,71500075,,,,1,1,2
HND-007008,2011,71500076,,,,1,2,3
HND-007009,2011,71500078,,,,2,1,3
HND-007018,2011,71500089,,,,1,4,5
HND-007020,2011,71500091,,,,10,12,22
HND-007019,2011,71500091,,,,10,12,22
HND-007021,2011,71500093,,,,3,3,6
HND-007022,2011,71500094,,,,3,5,8
HND-007024,2011,71500097,,,,2,1,3
HND-007025,2011,71500098,,,,1,3,4
HND-007028,2011,71500101,,,,2,2,4
,2011,71500104,,,,0,2,2
HND-007032,2011,71500105,,,,1,1,2
HND-007033,2011,71500106,,,,2,5,7
HND-007035,2011,71500108,,,,3,3,6
HND-007036,2011,71500109,,,,1,0,1
,2011,71500122,,,,4,2,6
,2011,71500125,,,,5,3,8
HND-007047,2011,71500126,,,,4,0,4
HND-007049,2011,71500128,,,,2,1,3
HND-007050,2011,71500129,,,,3,4,7
HND-007051,2011,71500130,,,,4,3,7
HND-007053,2011,71500132,,,,3,2,5
HND-007059,2011,71500139,,,,3,3,6
HND-007065,2011,71500223,,,,2,1,3
HND-007068,2011,71500227,,,,3,0,3
HND-007074,2011,71500234,,,,1,1,2
HND-007078,2011,71500246,,,,5,2,7
HND-006939,2011,71500006,,,,2,2,4
HND-006940,2011,71500007,,,,1,3,4
HND-006941,2011,71500008,,,,8,4,12
HND-006953,2011,71500020,,,,3,4,7
HND-006954,2011,71500021,,,,4,8,12
HND-006955,2011,71500022,,,,5,7,12
HND-006956,2011,71500023,,,,4,4,8
HND-006957,2011,71500024,,,,0,2,2
HND-006958,2011,71500025,,,,3,0,3
HND-006959,2011,71500026,,,,2,7,9
HND-006960,2011,71500027,,,,2,5,7
HND-006961,2011,71500028,,,,10,11,21
HND-006962,2011,71500029,,,,9,7,16
HND-006963,2011,71500030,,,,5,1,6
HND-006964,2011,71500031,,,,5,5,10
HND-006965,2011,71500032,,,,8,3,11
HND-006966,2011,71500033,,,,3,7,10
HND-006967,2011,71500034,,,,8,21,29
HND-006968,2011,71500035,,,,2,2,4
HND-006969,2011,71500036,,,,4,5,9
HND-006970,2011,71500037,,,,2,4,6
HND-006971,2011,71500038,,,,2,4,6
HND-006972,2011,71500039,,,,2,3,5
HND-006973,2011,71500040,,,,0,1,1
HND-006974,2011,71500041,,,,1,3,4
HND-006975,2011,71500042,,,,2,8,10
HND-006976,2011,71500043,,,,0,3,3
HND-006977,2011,71500044,,,,5,13,18
HND-006978,2011,71500045,,,,1,5,6
HND-006979,2011,71500046,,,,1,1,2
HND-006980,2011,71500047,,,,1,1,2
,2011,71500048,,,,8,3,11
HND-006982,2011,71500049,,,,0,2,2
HND-006984,2011,71500051,,,,2,2,4
HND-006985,2011,71500052,,,,2,3,5
HND-006986,2011,71500053,,,,2,4,6
HND-006987,2011,71500054,,,,2,3,5
,2011,71500055,,,,1,4,5
HND-006989,2011,71500056,,,,6,2,8
HND-006990,2011,71500057,,,,5,1,6
HND-006991,2011,71500058,,,,3,3,6
HND-006993,2011,71500060,,,,6,8,14
HND-006995,2011,71500062,,,,5,5,10
HND-006997,2011,71500064,,,,2,6,8
HND-006998,2011,71500065,,,,0,2,2
HND-006999,2011,71500066,,,,2,2,4
HND-007001,2011,71500068,,,,5,7,12
HND-007002,2011,71500069,,,,0,4,4
HND-007010,2011,71500079,,,,0,3,3
HND-007011,2011,71500081,,,,1,4,5
HND-007017,2011,71500088,,,,6,1,7
HND-007023,2011,71500095,,,,2,5,7
,2011,71500099,,,,6,5,11
HND-007027,2011,71500100,,,,2,1,3
,2011,71500103,,,,12,20,32
HND-007034,2011,71500107,,,,2,0,2
HND-007043,2011,71500120,,,,4,3,7
,2011,71500121,,,,5,4,9
,2011,71500127,,,,1,1,2
HND-007052,2011,71500131,,,,3,1,4
HND-007054,2011,71500133,,,,5,1,6
HND-007055,2011,71500134,,,,2,2,4
HND-007058,2011,71500138,,,,2,5,7
HND-007060,2011,71500140,,,,1,0,1
HND-007061,2011,71500141,,,,3,1,4
HND-007066,2011,71500225,,,,1,1,2
HND-007067,2011,71500226,,,,5,3,8
HND-007069,2011,71500229,,,,2,3,5
HND-007070,2011,71500230,,,,1,0,1
HND-007071,2011,71500231,,,,1,2,3
HND-007072,2011,71500232,,,,1,0,1
,2011,71500233,,,,0,2,2
HND-007079,2011,71500247,,,,1,0,1
HND-006956,2011,71500023,,,,34,23,57
HND-006961,2011,71500028,,,,15,16,31
HND-006962,2011,71500029,,,,11,11,22
HND-006967,2011,71500034,,,,23,19,42
HND-006975,2011,71500042,,,,6,11,17
HND-006993,2011,71500060,,,,12,11,23
HND-007015,2011,71500085,,,,92,118,210
HND-006956,2011,71500023,,,,10,8,18
HND-006961,2011,71500028,,,,8,9,17
HND-006962,2011,71500029,,,,6,14,20
HND-006993,2011,71500060,,,,6,12,18
HND-007015,2011,71500085,,,,82,103,185
HND-006967,2011,71500034,,,,22,20,42
HND-006975,2011,71500042,,,,7,4,11
HND-006956,2011,71500023,,,,9,15,24
HND-006961,2011,71500028,,,,3,14,17
HND-006993,2011,71500060,,,,10,13,23
HND-007015,2011,71500085,,,,79,99,178
HND-006962,2011,71500029,,,,6,7,13
HND-006967,2011,71500034,,,,14,14,28
HND-006975,2011,71500042,,,,4,14,18
HND-007015,2011,71500085,,,,95,103,198
HND-007015,2011,71500085,,,,78,109,187
HND-007015,2011,71500085,,,,71,72,143
,2011,71600042,,,,4,3,7
,2011,71600079,,,,6,5,11
HND-007157,2011,71600080,,,,7,5,12
,2011,71600082,,,,9,5,14
,2011,71600083,,,,3,2,5
,2011,71600084,,,,1,4,5
,2011,71600086,,,,2,3,5
,2011,71600087,,,,4,7,11
HND-007158,2011,71600088,,,,1,4,5
HND-007142,2011,71600034,,,,5,9,14
,2011,71600039,,,,6,4,10
,2011,71600072,,,,11,6,17
HND-007154,2011,71600073,,,,3,6,9
,2011,71600074,,,,4,3,7
,2011,71600075,,,,3,7,10
HND-007155,2011,71600076,,,,4,3,7
HND-007156,2011,71600077,,,,11,7,18
,2011,71600078,,,,7,9,16
HND-007139,2011,71600030,,,,5,5,10
HND-007143,2011,71600035,,,,4,3,7
HND-007144,2011,71600036,,,,2,2,4
HND-007153,2011,71600071,,,,1,10,11
HND-007122,2011,71600013,,,,4,6,10
HND-007145,2011,71600037,,,,5,4,9
HND-007152,2011,71600050,,,,3,3,6
HND-007122,2011,71600013,,,,8,8,16
HND-007152,2011,71600050,,,,6,3,9
HND-007139,2011,71600030,,,,1,3,4
HND-007143,2011,71600035,,,,5,4,9
HND-007144,2011,71600036,,,,2,6,8
HND-007145,2011,71600037,,,,5,7,12
HND-007153,2011,71600071,,,,8,4,12
HND-007110,2011,71600001,,,,4,5,9
HND-007116,2011,71600007,,,,10,12,22
HND-007119,2011,71600010,,,,2,2,4
HND-007121,2011,71600012,,,,3,1,4
HND-007123,2011,71600014,,,,0,5,5
HND-007124,2011,71600015,,,,6,6,12
HND-007125,2011,71600016,,,,6,7,13
HND-007126,2011,71600017,,,,15,15,30
HND-007127,2011,71600018,,,,11,8,19
HND-007111,2011,71600002,,,,2,2,4
HND-007112,2011,71600003,,,,8,6,14
HND-007113,2011,71600004,,,,4,6,10
HND-007114,2011,71600005,,,,9,3,12
HND-007115,2011,71600006,,,,6,1,7
HND-007117,2011,71600008,,,,6,7,13
HND-007118,2011,71600009,,,,8,6,14
HND-007120,2011,71600011,,,,23,21,44
HND-007128,2011,71600019,,,,6,7,13
HND-007129,2011,71600020,,,,1,0,1
HND-007130,2011,71600021,,,,3,6,9
HND-007131,2011,71600022,,,,6,7,13
HND-007132,2011,71600023,,,,5,6,11
HND-007133,2011,71600024,,,,6,3,9
HND-007134,2011,71600025,,,,5,1,6
HND-007135,2011,71600026,,,,11,10,21
HND-007136,2011,71600027,,,,13,14,27
HND-007137,2011,71600028,,,,10,5,15
HND-007140,2011,71600031,,,,1,3,4
HND-007141,2011,71600032,,,,7,8,15
HND-007146,2011,71600043,,,,2,8,10
HND-007147,2011,71600044,,,,6,6,12
HND-007148,2011,71600045,,,,3,2,5
HND-007149,2011,71600046,,,,2,2,4
HND-007150,2011,71600048,,,,4,4,8
HND-007151,2011,71600049,,,,5,3,8
HND-007114,2011,71600005,,,,4,4,8
HND-007118,2011,71600009,,,,5,5,10
HND-007126,2011,71600017,,,,7,13,20
HND-007129,2011,71600020,,,,1,1,2
HND-007134,2011,71600025,,,,5,4,9
HND-007137,2011,71600028,,,,8,3,11
HND-007146,2011,71600043,,,,2,2,4
HND-007147,2011,71600044,,,,7,6,13
HND-007149,2011,71600046,,,,0,3,3
HND-007110,2011,71600001,,,,1,4,5
HND-007111,2011,71600002,,,,1,1,2
HND-007112,2011,71600003,,,,6,10,16
HND-007113,2011,71600004,,,,10,4,14
HND-007115,2011,71600006,,,,5,4,9
HND-007116,2011,71600007,,,,2,0,2
HND-007117,2011,71600008,,,,5,3,8
HND-007119,2011,71600010,,,,1,0,1
HND-007120,2011,71600011,,,,15,19,34
HND-007123,2011,71600014,,,,1,3,4
HND-007124,2011,71600015,,,,4,7,11
HND-007125,2011,71600016,,,,5,3,8
HND-007127,2011,71600018,,,,5,4,9
HND-007128,2011,71600019,,,,4,3,7
HND-007130,2011,71600021,,,,3,8,11
HND-007131,2011,71600022,,,,13,8,21
HND-007132,2011,71600023,,,,2,1,3
HND-007133,2011,71600024,,,,2,3,5
HND-007135,2011,71600026,,,,6,8,14
HND-007136,2011,71600027,,,,8,2,10
HND-007140,2011,71600031,,,,2,1,3
HND-007141,2011,71600032,,,,2,3,5
HND-007148,2011,71600045,,,,2,1,3
HND-007150,2011,71600048,,,,3,1,4
HND-007151,2011,71600049,,,,2,1,3
HND-007121,2011,71600012,,,,1,2,3
HND-007123,2011,71600014,,,,2,3,5
HND-007125,2011,71600016,,,,6,5,11
HND-007126,2011,71600017,,,,4,7,11
HND-007127,2011,71600018,,,,9,7,16
HND-007140,2011,71600031,,,,1,2,3
HND-007141,2011,71600032,,,,6,3,9
HND-007146,2011,71600043,,,,2,2,4
HND-007147,2011,71600044,,,,5,5,10
HND-007148,2011,71600045,,,,1,3,4
HND-007149,2011,71600046,,,,1,1,2
HND-007150,2011,71600048,,,,1,1,2
HND-007151,2011,71600049,,,,2,2,4
HND-007110,2011,71600001,,,,1,1,2
HND-007111,2011,71600002,,,,2,2,4
HND-007112,2011,71600003,,,,5,8,13
HND-007113,2011,71600004,,,,5,4,9
HND-007114,2011,71600005,,,,6,8,14
HND-007115,2011,71600006,,,,5,3,8
HND-007116,2011,71600007,,,,4,6,10
HND-007117,2011,71600008,,,,10,8,18
HND-007118,2011,71600009,,,,5,5,10
HND-007120,2011,71600011,,,,17,15,32
HND-007124,2011,71600015,,,,6,10,16
HND-007128,2011,71600019,,,,8,0,8
HND-007129,2011,71600020,,,,1,0,1
HND-007130,2011,71600021,,,,3,4,7
HND-007131,2011,71600022,,,,0,6,6
HND-007132,2011,71600023,,,,2,1,3
HND-007133,2011,71600024,,,,1,2,3
HND-007134,2011,71600025,,,,1,3,4
HND-007135,2011,71600026,,,,4,3,7
HND-007136,2011,71600027,,,,3,5,8
HND-007137,2011,71600028,,,,3,5,8
HND-007113,2011,71600004,,,,3,6,9
HND-007114,2011,71600005,,,,5,3,8
HND-007115,2011,71600006,,,,3,1,4
HND-007117,2011,71600008,,,,6,12,18
HND-007118,2011,71600009,,,,3,4,7
HND-007120,2011,71600011,,,,19,20,39
HND-007126,2011,71600017,,,,6,5,11
HND-007129,2011,71600020,,,,3,0,3
HND-007133,2011,71600024,,,,0,4,4
HND-007134,2011,71600025,,,,4,2,6
HND-007135,2011,71600026,,,,2,4,6
HND-007137,2011,71600028,,,,1,6,7
HND-007146,2011,71600043,,,,2,2,4
HND-007110,2011,71600001,,,,0,1,1
HND-007112,2011,71600003,,,,3,5,8
HND-007116,2011,71600007,,,,7,3,10
HND-007119,2011,71600010,,,,2,2,4
HND-007121,2011,71600012,,,,1,0,1
HND-007123,2011,71600014,,,,2,5,7
HND-007124,2011,71600015,,,,4,6,10
HND-007125,2011,71600016,,,,4,5,9
HND-007127,2011,71600018,,,,3,5,8
HND-007128,2011,71600019,,,,9,4,13
HND-007130,2011,71600021,,,,9,6,15
HND-007131,2011,71600022,,,,0,2,2
HND-007132,2011,71600023,,,,1,1,2
HND-007136,2011,71600027,,,,4,7,11
HND-007140,2011,71600031,,,,1,2,3
HND-007141,2011,71600032,,,,6,3,9
HND-007147,2011,71600044,,,,5,4,9
HND-007148,2011,71600045,,,,1,2,3
HND-007149,2011,71600046,,,,2,3,5
HND-007150,2011,71600048,,,,0,3,3
HND-007151,2011,71600049,,,,4,4,8
HND-007111,2011,71600002,,,,4,2,6
HND-007113,2011,71600004,,,,4,2,6
HND-007114,2011,71600005,,,,6,5,11
HND-007115,2011,71600006,,,,5,1,6
HND-007117,2011,71600008,,,,5,3,8
HND-007118,2011,71600009,,,,3,2,5
HND-007120,2011,71600011,,,,13,18,31
HND-007128,2011,71600019,,,,14,6,20
HND-007129,2011,71600020,,,,2,2,4
HND-007131,2011,71600022,,,,5,7,12
HND-007132,2011,71600023,,,,3,4,7
HND-007133,2011,71600024,,,,2,0,2
HND-007134,2011,71600025,,,,2,0,2
HND-007135,2011,71600026,,,,5,3,8
HND-007137,2011,71600028,,,,4,4,8
HND-007146,2011,71600043,,,,2,3,5
HND-007110,2011,71600001,,,,3,6,9
HND-007112,2011,71600003,,,,5,12,17
HND-007116,2011,71600007,,,,4,3,7
HND-007119,2011,71600010,,,,1,2,3
HND-007121,2011,71600012,,,,2,1,3
HND-007123,2011,71600014,,,,1,3,4
HND-007124,2011,71600015,,,,10,5,15
HND-007125,2011,71600016,,,,5,5,10
HND-007126,2011,71600017,,,,5,10,15
HND-007127,2011,71600018,,,,3,3,6
HND-007130,2011,71600021,,,,6,3,9
HND-007136,2011,71600027,,,,7,5,12
HND-007140,2011,71600031,,,,1,2,3
HND-007141,2011,71600032,,,,0,1,1
HND-007147,2011,71600044,,,,4,7,11
HND-007148,2011,71600045,,,,2,3,5
HND-007149,2011,71600046,,,,2,0,2
HND-007150,2011,71600048,,,,0,1,1
HND-007151,2011,71600049,,,,2,7,9
HND-007110,2011,71600001,,,,4,1,5
HND-007111,2011,71600002,,,,0,1,1
HND-007112,2011,71600003,,,,2,3,5
HND-007113,2011,71600004,,,,5,7,12
HND-007115,2011,71600006,,,,1,2,3
HND-007116,2011,71600007,,,,3,3,6
HND-007117,2011,71600008,,,,5,4,9
HND-007120,2011,71600011,,,,18,25,43
HND-007123,2011,71600014,,,,1,3,4
HND-007124,2011,71600015,,,,9,8,17
HND-007125,2011,71600016,,,,6,0,6
HND-007127,2011,71600018,,,,1,6,7
HND-007128,2011,71600019,,,,1,3,4
HND-007130,2011,71600021,,,,2,7,9
HND-007131,2011,71600022,,,,3,6,9
HND-007132,2011,71600023,,,,3,2,5
HND-007133,2011,71600024,,,,1,2,3
HND-007135,2011,71600026,,,,3,3,6
HND-007136,2011,71600027,,,,0,3,3
HND-007140,2011,71600031,,,,0,2,2
HND-007141,2011,71600032,,,,6,5,11
HND-007148,2011,71600045,,,,1,2,3
HND-007150,2011,71600048,,,,0,3,3
HND-007151,2011,71600049,,,,1,3,4
HND-007114,2011,71600005,,,,2,6,8
HND-007118,2011,71600009,,,,3,3,6
HND-007121,2011,71600012,,,,2,0,2
HND-007126,2011,71600017,,,,2,3,5
HND-007129,2011,71600020,,,,1,0,1
HND-007134,2011,71600025,,,,4,1,5
HND-007137,2011,71600028,,,,9,2,11
HND-007146,2011,71600043,,,,0,1,1
HND-007147,2011,71600044,,,,5,2,7
HND-007149,2011,71600046,,,,6,1,7
HND-007126,2011,71600017,,,,24,23,47
HND-007138,2011,71600029,,,,23,24,47
HND-007126,2011,71600017,,,,21,17,38
HND-007138,2011,71600029,,,,20,20,40
HND-007138,2011,71600029,,,,16,15,31
HND-007126,2011,71600017,,,,13,17,30
HND-007138,2011,71600029,,,,26,13,39
HND-007138,2011,71600029,,,,30,18,48
HND-007138,2011,71600029,,,,11,17,28
HND-007181,2011,71700029,,,,5,7,12
,2011,71700031,,,,7,6,13
,2011,71700032,,,,5,5,10
HND-007182,2011,71700033,,,,4,6,10
,2011,71700037,,,,5,6,11
,2011,71700008,,,,6,1,7
,2011,71700019,,,,6,3,9
HND-007180,2011,71700026,,,,2,9,11
,2011,71700027,,,,6,2,8
,2011,71700028,,,,5,4,9
,2011,71700030,,,,11,7,18
HND-007183,2011,71700034,,,,10,3,13
HND-007184,2011,71700035,,,,5,6,11
,2011,71700036,,,,5,5,10
HND-007185,2011,71700038,,,,4,6,10
,2011,71700039,,,,1,4,5
HND-007169,2011,71700007,,,,4,8,12
HND-007169,2011,71700007,,,,3,9,12
HND-007166,2011,71700004,,,,3,2,5
HND-007167,2011,71700005,,,,2,5,7
HND-007168,2011,71700006,,,,3,3,6
HND-007170,2011,71700009,,,,4,6,10
HND-007172,2011,71700011,,,,6,5,11
HND-007174,2011,71700013,,,,9,3,12
HND-007178,2011,71700017,,,,6,5,11
HND-007163,2011,71700001,,,,3,9,12
HND-007164,2011,71700002,,,,2,3,5
HND-007165,2011,71700003,,,,4,5,9
HND-007171,2011,71700010,,,,6,1,7
HND-007173,2011,71700012,,,,2,0,2
HND-007175,2011,71700014,,,,8,6,14
HND-007176,2011,71700015,,,,1,1,2
HND-007177,2011,71700016,,,,5,4,9
HND-007179,2011,71700018,,,,9,6,15
HND-007165,2011,71700003,,,,3,0,3
HND-007171,2011,71700010,,,,3,3,6
HND-007172,2011,71700011,,,,3,1,4
HND-007173,2011,71700012,,,,3,4,7
HND-007174,2011,71700013,,,,6,2,8
HND-007175,2011,71700014,,,,8,5,13
HND-007176,2011,71700015,,,,1,4,5
HND-007177,2011,71700016,,,,4,7,11
HND-007178,2011,71700017,,,,2,1,3
HND-007179,2011,71700018,,,,7,2,9
HND-007163,2011,71700001,,,,5,1,6
HND-007164,2011,71700002,,,,4,6,10
HND-007166,2011,71700004,,,,2,8,10
HND-007167,2011,71700005,,,,4,2,6
HND-007168,2011,71700006,,,,5,5,10
HND-007170,2011,71700009,,,,1,1,2
HND-007163,2011,71700001,,,,4,10,14
HND-007165,2011,71700003,,,,1,2,3
HND-007171,2011,71700010,,,,1,2,3
HND-007173,2011,71700012,,,,1,3,4
HND-007174,2011,71700013,,,,3,4,7
HND-007175,2011,71700014,,,,7,9,16
HND-007176,2011,71700015,,,,4,1,5
HND-007177,2011,71700016,,,,2,2,4
HND-007179,2011,71700018,,,,8,3,11
HND-007164,2011,71700002,,,,6,2,8
HND-007166,2011,71700004,,,,2,1,3
HND-007167,2011,71700005,,,,1,4,5
HND-007168,2011,71700006,,,,5,8,13
HND-007170,2011,71700009,,,,4,0,4
HND-007172,2011,71700011,,,,1,1,2
HND-007178,2011,71700017,,,,6,4,10
HND-007165,2011,71700003,,,,7,6,13
HND-007167,2011,71700005,,,,9,5,14
HND-007170,2011,71700009,,,,3,4,7
HND-007172,2011,71700011,,,,4,3,7
HND-007173,2011,71700012,,,,1,1,2
HND-007174,2011,71700013,,,,5,8,13
HND-007175,2011,71700014,,,,7,8,15
HND-007178,2011,71700017,,,,5,1,6
HND-007163,2011,71700001,,,,11,2,13
HND-007164,2011,71700002,,,,5,3,8
HND-007166,2011,71700004,,,,5,3,8
HND-007168,2011,71700006,,,,6,5,11
HND-007171,2011,71700010,,,,4,2,6
HND-007176,2011,71700015,,,,2,2,4
HND-007177,2011,71700016,,,,5,8,13
HND-007179,2011,71700018,,,,5,2,7
HND-007165,2011,71700003,,,,5,1,6
HND-007167,2011,71700005,,,,3,2,5
HND-007168,2011,71700006,,,,4,3,7
HND-007170,2011,71700009,,,,3,5,8
HND-007172,2011,71700011,,,,2,1,3
HND-007174,2011,71700013,,,,9,6,15
HND-007178,2011,71700017,,,,2,7,9
HND-007163,2011,71700001,,,,9,2,11
HND-007164,2011,71700002,,,,3,2,5
HND-007166,2011,71700004,,,,5,0,5
HND-007171,2011,71700010,,,,0,2,2
HND-007173,2011,71700012,,,,1,2,3
HND-007175,2011,71700014,,,,9,8,17
HND-007176,2011,71700015,,,,1,1,2
HND-007177,2011,71700016,,,,3,4,7
HND-007179,2011,71700018,,,,4,3,7
HND-007163,2011,71700001,,,,3,5,8
HND-007164,2011,71700002,,,,4,4,8
HND-007166,2011,71700004,,,,4,1,5
HND-007167,2011,71700005,,,,2,3,5
HND-007168,2011,71700006,,,,3,8,11
HND-007170,2011,71700009,,,,1,2,3
HND-007165,2011,71700003,,,,3,2,5
HND-007171,2011,71700010,,,,1,1,2
HND-007172,2011,71700011,,,,1,0,1
HND-007173,2011,71700012,,,,0,1,1
HND-007174,2011,71700013,,,,3,2,5
HND-007175,2011,71700014,,,,8,3,11
HND-007176,2011,71700015,,,,3,1,4
HND-007177,2011,71700016,,,,2,6,8
HND-007178,2011,71700017,,,,7,4,11
HND-007179,2011,71700018,,,,5,4,9
HND-007165,2011,71700003,,,,12,18,30
HND-007163,2011,71700001,,,,14,8,22
HND-007165,2011,71700003,,,,12,14,26
HND-007163,2011,71700001,,,,17,15,32
HND-007165,2011,71700003,,,,9,4,13
HND-007163,2011,71700001,,,,5,9,14
,2011,71800008,,,,1,1,2
,2011,71800006,,,,5,1,6
,2011,71800008,,,,1,1,2
,2011,71800008,,,,4,1,5
,2011,71800006,,,,7,8,15
HND-007188,2011,71800002,,,,5,1,6
HND-007189,2011,71800003,,,,0,2,2
HND-007192,2011,71800007,,,,1,2,3
HND-007187,2011,71800001,,,,7,3,10
HND-007190,2011,71800004,,,,3,2,5
HND-007191,2011,71800005,,,,1,1,2
HND-007188,2011,71800002,,,,2,2,4
HND-007189,2011,71800003,,,,3,1,4
HND-007190,2011,71800004,,,,9,5,14
HND-007191,2011,71800005,,,,3,1,4
HND-007192,2011,71800007,,,,2,0,2
HND-007187,2011,71800001,,,,6,5,11
HND-007187,2011,71800001,,,,6,7,13
HND-007190,2011,71800004,,,,3,3,6
HND-007191,2011,71800005,,,,1,2,3
HND-007188,2011,71800002,,,,0,3,3
HND-007189,2011,71800003,,,,4,2,6
HND-007192,2011,71800007,,,,2,1,3
HND-007188,2011,71800002,,,,0,2,2
HND-007189,2011,71800003,,,,2,0,2
HND-007190,2011,71800004,,,,10,3,13
HND-007191,2011,71800005,,,,2,1,3
HND-007192,2011,71800007,,,,2,3,5
HND-007187,2011,71800001,,,,5,8,13
HND-007188,2011,71800002,,,,1,1,2
HND-007189,2011,71800003,,,,1,3,4
HND-007190,2011,71800004,,,,4,3,7
HND-007192,2011,71800007,,,,1,0,1
HND-007187,2011,71800001,,,,11,7,18
HND-007191,2011,71800005,,,,3,0,3
HND-007187,2011,71800001,,,,7,9,16
HND-007188,2011,71800002,,,,3,1,4
HND-007189,2011,71800003,,,,1,2,3
HND-007190,2011,71800004,,,,6,8,14
HND-007191,2011,71800005,,,,0,3,3
HND-007192,2011,71800007,,,,4,1,5
HND-007187,2011,71800001,,,,19,13,32
HND-007187,2011,71800001,,,,15,12,27
HND-007187,2011,71800001,,,,9,4,13
HND-007201,2011,71900012,,,,8,9,17
HND-007227,2011,71900039,,,,8,7,15
HND-007245,2011,71900059,,,,3,5,8
HND-007249,2011,71900063,,,,3,5,8
,2011,71900118,,,,2,4,6
HND-007297,2011,71900124,,,,5,5,10
HND-007335,2011,71900168,,,,5,0,5
HND-007352,2011,71900242,,,,10,9,19
,2011,71900267,,,,3,5,8
,2011,71900290,,,,3,3,6
,2011,71900295,,,,7,3,10
,2011,71900298,,,,3,7,10
,2011,71900299,,,,3,4,7
,2011,71900304,,,,3,2,5
,2011,71900306,,,,3,5,8
HND-007373,2011,71900307,,,,3,3,6
,2011,71900308,,,,2,10,12
,2011,71900310,,,,2,3,5
,2011,71900311,,,,9,4,13
HND-007375,2011,71900313,,,,5,3,8
,2011,71900315,,,,3,3,6
HND-007376,2011,71900318,,,,4,8,12
,2011,71900324,,,,5,7,12
HND-007381,2011,71900326,,,,8,9,17
,2011,71900327,,,,3,7,10
HND-007195,2011,71900006,,,,6,7,13
HND-007214,2011,71900025,,,,8,11,19
HND-007226,2011,71900038,,,,4,2,6
HND-007237,2011,71900049,,,,4,7,11
HND-007240,2011,71900052,,,,4,7,11
HND-007256,2011,71900070,,,,5,2,7
HND-007261,2011,71900076,,,,3,5,8
,2011,71900090,,,,3,5,8
,2011,71900096,,,,5,2,7
,2011,71900098,,,,3,2,5
HND-007281,2011,71900101,,,,6,6,12
,2011,71900105,,,,3,2,5
HND-007324,2011,71900155,,,,7,9,16
,2011,71900228,,,,3,3,6
HND-007365,2011,71900266,,,,3,2,5
HND-007366,2011,71900268,,,,5,5,10
,2011,71900273,,,,2,3,5
,2011,71900277,,,,6,6,12
,2011,71900278,,,,4,1,5
,2011,71900285,,,,2,4,6
,2011,71900289,,,,1,4,5
,2011,71900291,,,,3,2,5
,2011,71900292,,,,5,7,12
,2011,71900294,,,,7,4,11
,2011,71900296,,,,1,4,5
,2011,71900297,,,,4,2,6
,2011,71900300,,,,5,4,9
,2011,71900301,,,,7,2,9
,2011,71900302,,,,5,3,8
,2011,71900303,,,,12,5,17
,2011,71900305,,,,5,8,13
,2011,71900309,,,,6,4,10
HND-007374,2011,71900312,,,,8,7,15
,2011,71900314,,,,4,4,8
,2011,71900316,,,,2,3,5
,2011,71900317,,,,8,10,18
,2011,71900325,,,,4,5,9
,2011,71900328,,,,3,5,8
HND-007382,2011,71900330,,,,3,3,6
HND-007277,2011,71900094,,,,1,1,2
,2011,71900329,,,,0,2,2
HND-007273,2011,71900088,,,,0,1,1
HND-007273,2011,71900088,,,,11,6,17
HND-007277,2011,71900094,,,,1,1,2
,2011,71900097,,,,1,0,1
HND-007279,2011,71900099,,,,2,0,2
HND-007361,2011,71900260,,,,3,3,6
,2011,71900261,,,,0,1,1
,2011,71900329,,,,1,2,3
,2011,71900058,,,,0,2,2
HND-007274,2011,71900089,,,,1,2,3
HND-007280,2011,71900100,,,,0,1,1
HND-007314,2011,71900143,,,,2,1,3
,2011,71900058,,,,2,1,3
HND-007274,2011,71900089,,,,7,24,31
HND-007280,2011,71900100,,,,11,14,25
HND-007314,2011,71900143,,,,2,2,4
,2011,71900261,,,,2,3,5
,2011,71900329,,,,3,2,5
HND-007273,2011,71900088,,,,26,18,44
HND-007275,2011,71900091,,,,8,12,20
HND-007276,2011,71900093,,,,10,7,17
HND-007277,2011,71900094,,,,4,7,11
,2011,71900097,,,,10,5,15
HND-007279,2011,71900099,,,,9,8,17
,2011,71900118,,,,9,7,16
HND-007361,2011,71900260,,,,24,31,55
HND-007193,2011,71900004,,,,62,55,117
HND-007195,2011,71900006,,,,11,5,16
HND-007196,2011,71900007,,,,1,3,4
HND-007199,2011,71900010,,,,6,5,11
HND-007204,2011,71900015,,,,1,8,9
HND-007207,2011,71900018,,,,5,4,9
HND-007208,2011,71900019,,,,6,4,10
,2011,71900020,,,,5,15,20
HND-007210,2011,71900021,,,,15,12,27
HND-007211,2011,71900022,,,,2,2,4
HND-007212,2011,71900023,,,,2,5,7
HND-007213,2011,71900024,,,,5,5,10
HND-007214,2011,71900025,,,,11,15,26
HND-007215,2011,71900026,,,,7,1,8
HND-007216,2011,71900027,,,,8,9,17
HND-007217,2011,71900028,,,,15,12,27
HND-007218,2011,71900029,,,,7,2,9
HND-007220,2011,71900031,,,,3,2,5
HND-007221,2011,71900033,,,,6,7,13
HND-007225,2011,71900037,,,,2,2,4
,2011,71900040,,,,2,1,3
HND-007229,2011,71900041,,,,8,5,13
HND-007230,2011,71900042,,,,4,4,8
HND-007231,2011,71900043,,,,9,4,13
HND-007232,2011,71900044,,,,2,4,6
HND-007233,2011,71900045,,,,9,11,20
HND-007234,2011,71900046,,,,5,7,12
HND-007235,2011,71900047,,,,6,4,10
,2011,71900048,,,,1,3,4
HND-007237,2011,71900049,,,,4,5,9
HND-007245,2011,71900059,,,,2,0,2
HND-007247,2011,71900061,,,,5,4,9
HND-007248,2011,71900062,,,,13,14,27
HND-007250,2011,71900064,,,,5,6,11
HND-007251,2011,71900065,,,,8,5,13
,2011,71900066,,,,1,3,4
HND-007253,2011,71900067,,,,3,4,7
HND-007254,2011,71900068,,,,43,39,82
HND-007257,2011,71900071,,,,4,8,12
HND-007258,2011,71900072,,,,3,0,3
HND-007262,2011,71900077,,,,2,1,3
HND-007266,2011,71900081,,,,6,5,11
HND-007267,2011,71900082,,,,12,3,15
HND-007268,2011,71900083,,,,6,7,13
HND-007272,2011,71900087,,,,7,13,20
HND-007278,2011,71900095,,,,15,7,22
HND-007285,2011,71900110,,,,9,2,11
HND-007286,2011,71900111,,,,6,2,8
HND-007287,2011,71900112,,,,6,4,10
,2011,71900115,,,,5,1,6
HND-007291,2011,71900116,,,,2,2,4
HND-007293,2011,71900120,,,,7,5,12
HND-007295,2011,71900122,,,,21,21,42
HND-007296,2011,71900123,,,,9,3,12
HND-007297,2011,71900124,,,,8,9,17
HND-007298,2011,71900125,,,,8,4,12
HND-007299,2011,71900126,,,,2,2,4
HND-007301,2011,71900129,,,,13,12,25
HND-007302,2011,71900130,,,,2,1,3
HND-007304,2011,71900132,,,,3,6,9
HND-007311,2011,71900140,,,,2,3,5
HND-007313,2011,71900142,,,,1,3,4
HND-007314,2011,71900143,,,,4,4,8
HND-007318,2011,71900149,,,,7,8,15
HND-007319,2011,71900150,,,,9,8,17
HND-007322,2011,71900153,,,,4,4,8
HND-007326,2011,71900159,,,,3,8,11
,2011,71900160,,,,7,5,12
HND-007329,2011,71900162,,,,5,6,11
HND-007336,2011,71900169,,,,11,12,23
HND-007338,2011,71900171,,,,8,10,18
HND-007342,2011,71900175,,,,2,3,5
HND-007345,2011,71900179,,,,1,1,2
HND-007347,2011,71900181,,,,4,2,6
,2011,71900184,,,,3,2,5
HND-007354,2011,71900244,,,,4,4,8
,2011,71900246,,,,4,2,6
HND-007356,2011,71900247,,,,5,2,7
,2011,71900249,,,,2,2,4
,2011,71900255,,,,6,4,10
HND-007360,2011,71900258,,,,4,4,8
HND-007363,2011,71900264,,,,2,1,3
HND-007365,2011,71900266,,,,13,13,26
HND-007368,2011,71900280,,,,5,3,8
,2011,71900281,,,,8,3,11
,2011,71900282,,,,7,3,10
HND-007371,2011,71900283,,,,7,4,11
,2011,71900284,,,,6,0,6
,2011,71900288,,,,0,5,5
,2011,71900319,,,,2,2,4
HND-007194,2011,71900005,,,,8,9,17
HND-007197,2011,71900008,,,,10,7,17
HND-007198,2011,71900009,,,,6,6,12
HND-007200,2011,71900011,,,,3,3,6
HND-007201,2011,71900012,,,,8,3,11
HND-007202,2011,71900013,,,,2,7,9
HND-007203,2011,71900014,,,,12,4,16
HND-007205,2011,71900016,,,,2,4,6
HND-007206,2011,71900017,,,,13,11,24
HND-007219,2011,71900030,,,,3,1,4
HND-007222,2011,71900034,,,,9,6,15
HND-007223,2011,71900035,,,,8,5,13
,2011,71900036,,,,2,3,5
HND-007226,2011,71900038,,,,5,2,7
HND-007227,2011,71900039,,,,14,9,23
HND-007238,2011,71900050,,,,6,5,11
HND-007239,2011,71900051,,,,5,4,9
HND-007240,2011,71900052,,,,3,3,6
HND-007241,2011,71900053,,,,11,2,13
HND-007242,2011,71900054,,,,3,2,5
HND-007243,2011,71900056,,,,16,5,21
HND-007244,2011,71900057,,,,6,6,12
,2011,71900058,,,,7,9,16
HND-007246,2011,71900060,,,,7,4,11
HND-007249,2011,71900063,,,,3,7,10
HND-007255,2011,71900069,,,,2,8,10
HND-007256,2011,71900070,,,,9,4,13
HND-007259,2011,71900074,,,,3,10,13
HND-007260,2011,71900075,,,,6,6,12
HND-007261,2011,71900076,,,,7,6,13
,2011,71900078,,,,14,13,27
HND-007264,2011,71900079,,,,4,3,7
HND-007265,2011,71900080,,,,9,7,16
HND-007269,2011,71900084,,,,6,9,15
HND-007270,2011,71900085,,,,4,2,6
HND-007271,2011,71900086,,,,3,1,4
HND-007277,2011,71900094,,,,17,22,39
HND-007282,2011,71900103,,,,2,1,3
HND-007283,2011,71900104,,,,6,3,9
HND-007289,2011,71900114,,,,5,1,6
HND-007292,2011,71900117,,,,10,6,16
HND-007294,2011,71900121,,,,7,6,13
HND-007300,2011,71900128,,,,9,11,20
HND-007303,2011,71900131,,,,6,8,14
,2011,71900134,,,,8,2,10
HND-007306,2011,71900135,,,,5,10,15
HND-007307,2011,71900136,,,,5,2,7
HND-007308,2011,71900137,,,,3,6,9
HND-007309,2011,71900138,,,,3,1,4
HND-007310,2011,71900139,,,,7,8,15
HND-007312,2011,71900141,,,,2,2,4
HND-007315,2011,71900144,,,,10,5,15
HND-007316,2011,71900146,,,,4,5,9
HND-007317,2011,71900148,,,,3,4,7
HND-007320,2011,71900151,,,,3,4,7
HND-007321,2011,71900152,,,,4,2,6
HND-007323,2011,71900154,,,,6,3,9
HND-007324,2011,71900155,,,,10,8,18
HND-007325,2011,71900158,,,,6,3,9
HND-007328,2011,71900161,,,,11,7,18
HND-007330,2011,71900163,,,,13,3,16
,2011,71900164,,,,4,5,9
HND-007332,2011,71900165,,,,2,3,5
HND-007333,2011,71900166,,,,4,4,8
HND-007334,2011,71900167,,,,10,3,13
HND-007335,2011,71900168,,,,19,23,42
HND-007337,2011,71900170,,,,6,2,8
HND-007340,2011,71900173,,,,5,11,16
HND-007341,2011,71900174,,,,8,14,22
HND-007343,2011,71900176,,,,6,6,12
HND-007344,2011,71900177,,,,3,1,4
,2011,71900180,,,,6,9,15
HND-007348,2011,71900182,,,,2,6,8
HND-007349,2011,71900183,,,,2,0,2
HND-007351,2011,71900241,,,,4,4,8
HND-007352,2011,71900242,,,,4,7,11
,2011,71900243,,,,16,11,27
,2011,71900248,,,,9,7,16
HND-007359,2011,71900252,,,,6,5,11
HND-007362,2011,71900263,,,,6,5,11
HND-007364,2011,71900265,,,,6,5,11
HND-007367,2011,71900279,,,,7,3,10
,2011,71900320,,,,12,6,18
,2011,71900323,,,,6,0,6
HND-007193,2011,71900004,,,,73,48,121
HND-007196,2011,71900007,,,,9,3,12
HND-007199,2011,71900010,,,,5,7,12
HND-007201,2011,71900012,,,,5,11,16
HND-007203,2011,71900014,,,,8,5,13
HND-007204,2011,71900015,,,,6,3,9
HND-007205,2011,71900016,,,,8,4,12
HND-007207,2011,71900018,,,,2,5,7
HND-007208,2011,71900019,,,,4,4,8
HND-007210,2011,71900021,,,,8,8,16
HND-007211,2011,71900022,,,,1,6,7
HND-007212,2011,71900023,,,,3,8,11
HND-007213,2011,71900024,,,,3,2,5
HND-007215,2011,71900026,,,,0,3,3
HND-007216,2011,71900027,,,,9,8,17
HND-007219,2011,71900030,,,,1,1,2
HND-007220,2011,71900031,,,,4,8,12
HND-007221,2011,71900033,,,,3,2,5
HND-007222,2011,71900034,,,,8,13,21
HND-007223,2011,71900035,,,,6,4,10
,2011,71900036,,,,4,3,7
HND-007225,2011,71900037,,,,1,2,3
HND-007226,2011,71900038,,,,7,5,12
,2011,71900040,,,,1,1,2
HND-007233,2011,71900045,,,,14,10,24
,2011,71900048,,,,4,3,7
HND-007237,2011,71900049,,,,4,11,15
HND-007239,2011,71900051,,,,1,3,4
HND-007240,2011,71900052,,,,3,7,10
HND-007241,2011,71900053,,,,8,3,11
HND-007244,2011,71900057,,,,4,1,5
,2011,71900058,,,,6,8,14
HND-007247,2011,71900061,,,,1,3,4
HND-007249,2011,71900063,,,,2,7,9
HND-007253,2011,71900067,,,,2,1,3
HND-007254,2011,71900068,,,,37,40,77
HND-007256,2011,71900070,,,,7,1,8
HND-007257,2011,71900071,,,,5,3,8
HND-007258,2011,71900072,,,,2,1,3
HND-007259,2011,71900074,,,,6,4,10
HND-007260,2011,71900075,,,,4,4,8
HND-007261,2011,71900076,,,,3,3,6
HND-007262,2011,71900077,,,,1,5,6
,2011,71900078,,,,0,5,5
HND-007264,2011,71900079,,,,5,4,9
HND-007265,2011,71900080,,,,14,7,21
HND-007266,2011,71900081,,,,2,2,4
HND-007267,2011,71900082,,,,7,5,12
HND-007268,2011,71900083,,,,4,4,8
HND-007269,2011,71900084,,,,6,4,10
HND-007270,2011,71900085,,,,2,2,4
HND-007271,2011,71900086,,,,3,1,4
HND-007272,2011,71900087,,,,4,3,7
HND-007278,2011,71900095,,,,10,5,15
HND-007282,2011,71900103,,,,0,1,1
HND-007283,2011,71900104,,,,2,1,3
HND-007285,2011,71900110,,,,2,2,4
HND-007289,2011,71900114,,,,3,0,3
HND-007292,2011,71900117,,,,10,7,17
HND-007293,2011,71900120,,,,4,5,9
HND-007302,2011,71900130,,,,5,1,6
HND-007303,2011,71900131,,,,5,1,6
HND-007307,2011,71900136,,,,2,2,4
HND-007309,2011,71900138,,,,3,2,5
HND-007310,2011,71900139,,,,6,4,10
HND-007311,2011,71900140,,,,3,2,5
HND-007312,2011,71900141,,,,4,5,9
HND-007313,2011,71900142,,,,1,6,7
HND-007315,2011,71900144,,,,2,9,11
HND-007316,2011,71900146,,,,4,1,5
HND-007317,2011,71900148,,,,3,0,3
HND-007318,2011,71900149,,,,10,8,18
HND-007320,2011,71900151,,,,4,5,9
HND-007321,2011,71900152,,,,7,8,15
HND-007322,2011,71900153,,,,8,5,13
HND-007323,2011,71900154,,,,5,4,9
HND-007324,2011,71900155,,,,9,8,17
HND-007325,2011,71900158,,,,5,1,6
HND-007326,2011,71900159,,,,1,7,8
HND-007334,2011,71900167,,,,3,2,5
HND-007338,2011,71900171,,,,6,10,16
HND-007340,2011,71900173,,,,4,9,13
HND-007341,2011,71900174,,,,5,5,10
HND-007342,2011,71900175,,,,6,4,10
HND-007343,2011,71900176,,,,5,2,7
HND-007344,2011,71900177,,,,4,0,4
,2011,71900184,,,,6,2,8
HND-007356,2011,71900247,,,,1,8,9
,2011,71900248,,,,1,0,1
HND-007363,2011,71900264,,,,4,1,5
HND-007364,2011,71900265,,,,2,4,6
,2011,71900282,,,,4,2,6
,2011,71900284,,,,3,4,7
,2011,71900320,,,,0,1,1
,2011,71900323,,,,5,0,5
HND-007194,2011,71900005,,,,8,10,18
HND-007195,2011,71900006,,,,5,6,11
HND-007197,2011,71900008,,,,6,7,13
HND-007198,2011,71900009,,,,6,5,11
HND-007200,2011,71900011,,,,5,1,6
HND-007202,2011,71900013,,,,4,1,5
HND-007206,2011,71900017,,,,4,4,8
,2011,71900020,,,,7,12,19
HND-007214,2011,71900025,,,,10,8,18
HND-007217,2011,71900028,,,,21,13,34
HND-007218,2011,71900029,,,,3,5,8
HND-007227,2011,71900039,,,,10,13,23
HND-007229,2011,71900041,,,,4,5,9
HND-007230,2011,71900042,,,,6,1,7
HND-007231,2011,71900043,,,,2,3,5
HND-007232,2011,71900044,,,,1,3,4
HND-007234,2011,71900046,,,,7,1,8
HND-007235,2011,71900047,,,,3,7,10
HND-007238,2011,71900050,,,,8,11,19
HND-007242,2011,71900054,,,,3,1,4
HND-007243,2011,71900056,,,,12,11,23
HND-007245,2011,71900059,,,,4,3,7
HND-007246,2011,71900060,,,,4,7,11
HND-007248,2011,71900062,,,,9,8,17
HND-007250,2011,71900064,,,,4,5,9
HND-007251,2011,71900065,,,,2,3,5
,2011,71900066,,,,5,6,11
HND-007255,2011,71900069,,,,6,6,12
HND-007277,2011,71900094,,,,20,16,36
,2011,71900109,,,,5,5,10
HND-007286,2011,71900111,,,,3,2,5
HND-007287,2011,71900112,,,,5,1,6
HND-007288,2011,71900113,,,,2,1,3
,2011,71900115,,,,11,7,18
HND-007291,2011,71900116,,,,5,2,7
HND-007294,2011,71900121,,,,6,4,10
HND-007295,2011,71900122,,,,9,10,19
HND-007296,2011,71900123,,,,3,2,5
HND-007297,2011,71900124,,,,5,5,10
HND-007298,2011,71900125,,,,8,5,13
HND-007299,2011,71900126,,,,4,5,9
HND-007300,2011,71900128,,,,7,3,10
HND-007301,2011,71900129,,,,4,5,9
,2011,71900134,,,,5,2,7
HND-007306,2011,71900135,,,,6,3,9
HND-007308,2011,71900137,,,,2,1,3
HND-007314,2011,71900143,,,,4,2,6
HND-007319,2011,71900150,,,,10,7,17
,2011,71900160,,,,2,2,4
HND-007328,2011,71900161,,,,4,7,11
HND-007329,2011,71900162,,,,3,3,6
HND-007330,2011,71900163,,,,1,2,3
,2011,71900164,,,,5,2,7
HND-007332,2011,71900165,,,,0,4,4
HND-007333,2011,71900166,,,,7,5,12
HND-007335,2011,71900168,,,,5,6,11
HND-007336,2011,71900169,,,,9,8,17
HND-007337,2011,71900170,,,,3,11,14
HND-007345,2011,71900179,,,,6,6,12
,2011,71900180,,,,1,2,3
HND-007347,2011,71900181,,,,2,3,5
HND-007349,2011,71900183,,,,4,3,7
HND-007351,2011,71900241,,,,1,3,4
HND-007352,2011,71900242,,,,5,5,10
,2011,71900243,,,,2,1,3
HND-007354,2011,71900244,,,,5,3,8
,2011,71900246,,,,3,2,5
,2011,71900249,,,,2,3,5
HND-007359,2011,71900252,,,,3,1,4
,2011,71900255,,,,2,2,4
HND-007360,2011,71900258,,,,2,1,3
HND-007362,2011,71900263,,,,2,2,4
HND-007365,2011,71900266,,,,7,6,13
HND-007367,2011,71900279,,,,2,3,5
HND-007368,2011,71900280,,,,7,3,10
,2011,71900281,,,,5,3,8
HND-007371,2011,71900283,,,,7,3,10
,2011,71900288,,,,2,1,3
,2011,71900319,,,,2,5,7
HND-007193,2011,71900004,,,,48,42,90
HND-007196,2011,71900007,,,,4,5,9
HND-007199,2011,71900010,,,,5,3,8
HND-007204,2011,71900015,,,,6,7,13
HND-007207,2011,71900018,,,,0,4,4
HND-007208,2011,71900019,,,,2,5,7
,2011,71900020,,,,12,6,18
HND-007210,2011,71900021,,,,4,5,9
HND-007211,2011,71900022,,,,2,4,6
HND-007212,2011,71900023,,,,4,9,13
HND-007213,2011,71900024,,,,3,2,5
HND-007214,2011,71900025,,,,9,3,12
HND-007215,2011,71900026,,,,3,1,4
HND-007216,2011,71900027,,,,2,7,9
HND-007217,2011,71900028,,,,11,12,23
HND-007218,2011,71900029,,,,5,2,7
HND-007219,2011,71900030,,,,1,2,3
HND-007221,2011,71900033,,,,3,2,5
HND-007222,2011,71900034,,,,8,9,17
HND-007223,2011,71900035,,,,2,3,5
,2011,71900036,,,,3,1,4
HND-007226,2011,71900038,,,,4,1,5
HND-007227,2011,71900039,,,,14,7,21
HND-007239,2011,71900051,,,,3,3,6
HND-007240,2011,71900052,,,,6,2,8
HND-007241,2011,71900053,,,,3,3,6
HND-007242,2011,71900054,,,,2,1,3
HND-007243,2011,71900056,,,,13,11,24
HND-007244,2011,71900057,,,,7,5,12
,2011,71900058,,,,7,7,14
HND-007247,2011,71900061,,,,6,6,12
HND-007248,2011,71900062,,,,10,20,30
HND-007250,2011,71900064,,,,10,8,18
,2011,71900066,,,,2,1,3
HND-007253,2011,71900067,,,,2,1,3
HND-007254,2011,71900068,,,,45,35,80
HND-007256,2011,71900070,,,,5,2,7
HND-007258,2011,71900072,,,,3,2,5
HND-007259,2011,71900074,,,,3,4,7
HND-007260,2011,71900075,,,,1,2,3
HND-007261,2011,71900076,,,,2,4,6
,2011,71900078,,,,4,3,7
HND-007264,2011,71900079,,,,5,4,9
HND-007265,2011,71900080,,,,17,7,24
HND-007267,2011,71900082,,,,4,7,11
HND-007269,2011,71900084,,,,2,3,5
HND-007270,2011,71900085,,,,1,4,5
HND-007271,2011,71900086,,,,3,3,6
HND-007278,2011,71900095,,,,2,9,11
HND-007282,2011,71900103,,,,2,1,3
HND-007283,2011,71900104,,,,3,4,7
,2011,71900109,,,,3,1,4
HND-007289,2011,71900114,,,,3,9,12
HND-007292,2011,71900117,,,,5,4,9
HND-007293,2011,71900120,,,,3,3,6
HND-007294,2011,71900121,,,,3,5,8
HND-007300,2011,71900128,,,,7,6,13
HND-007302,2011,71900130,,,,1,3,4
HND-007310,2011,71900139,,,,8,5,13
HND-007311,2011,71900140,,,,3,5,8
HND-007312,2011,71900141,,,,2,3,5
HND-007318,2011,71900149,,,,8,4,12
HND-007319,2011,71900150,,,,9,3,12
HND-007321,2011,71900152,,,,6,3,9
HND-007322,2011,71900153,,,,4,3,7
HND-007326,2011,71900159,,,,2,2,4
HND-007328,2011,71900161,,,,2,4,6
,2011,71900164,,,,1,1,2
HND-007332,2011,71900165,,,,3,3,6
HND-007333,2011,71900166,,,,4,4,8
HND-007334,2011,71900167,,,,6,2,8
HND-007335,2011,71900168,,,,5,5,10
HND-007338,2011,71900171,,,,9,5,14
HND-007340,2011,71900173,,,,1,4,5
HND-007342,2011,71900175,,,,3,2,5
HND-007345,2011,71900179,,,,6,3,9
HND-007347,2011,71900181,,,,6,2,8
HND-007348,2011,71900182,,,,10,7,17
HND-007349,2011,71900183,,,,0,3,3
,2011,71900184,,,,2,3,5
HND-007351,2011,71900241,,,,5,1,6
,2011,71900243,,,,1,1,2
,2011,71900248,,,,0,1,1
HND-007359,2011,71900252,,,,2,0,2
HND-007362,2011,71900263,,,,2,1,3
HND-007364,2011,71900265,,,,4,4,8
HND-007367,2011,71900279,,,,3,2,5
,2011,71900320,,,,0,1,1
,2011,71900323,,,,1,6,7
HND-007194,2011,71900005,,,,8,5,13
HND-007195,2011,71900006,,,,4,4,8
HND-007197,2011,71900008,,,,2,5,7
HND-007198,2011,71900009,,,,6,6,12
HND-007200,2011,71900011,,,,8,1,9
HND-007201,2011,71900012,,,,8,10,18
HND-007202,2011,71900013,,,,3,3,6
HND-007203,2011,71900014,,,,5,5,10
HND-007205,2011,71900016,,,,0,1,1
HND-007206,2011,71900017,,,,3,3,6
HND-007220,2011,71900031,,,,5,1,6
HND-007225,2011,71900037,,,,4,6,10
,2011,71900040,,,,0,1,1
HND-007229,2011,71900041,,,,6,3,9
HND-007230,2011,71900042,,,,2,0,2
HND-007231,2011,71900043,,,,2,3,5
HND-007232,2011,71900044,,,,1,2,3
HND-007233,2011,71900045,,,,15,10,25
HND-007234,2011,71900046,,,,10,1,11
HND-007235,2011,71900047,,,,7,7,14
,2011,71900048,,,,2,3,5
HND-007237,2011,71900049,,,,4,3,7
HND-007238,2011,71900050,,,,10,8,18
HND-007245,2011,71900059,,,,1,3,4
HND-007246,2011,71900060,,,,2,8,10
HND-007249,2011,71900063,,,,1,1,2
HND-007251,2011,71900065,,,,6,1,7
HND-007255,2011,71900069,,,,10,6,16
HND-007257,2011,71900071,,,,4,7,11
HND-007262,2011,71900077,,,,4,1,5
HND-007266,2011,71900081,,,,4,0,4
HND-007268,2011,71900083,,,,6,2,8
HND-007272,2011,71900087,,,,2,5,7
HND-007277,2011,71900094,,,,8,16,24
HND-007285,2011,71900110,,,,3,6,9
HND-007286,2011,71900111,,,,2,1,3
HND-007287,2011,71900112,,,,5,10,15
HND-007288,2011,71900113,,,,1,4,5
,2011,71900115,,,,3,1,4
HND-007291,2011,71900116,,,,2,0,2
HND-007295,2011,71900122,,,,12,6,18
HND-007296,2011,71900123,,,,3,3,6
HND-007297,2011,71900124,,,,7,4,11
HND-007298,2011,71900125,,,,3,8,11
HND-007299,2011,71900126,,,,6,3,9
HND-007301,2011,71900129,,,,3,3,6
HND-007303,2011,71900131,,,,6,5,11
,2011,71900134,,,,3,1,4
HND-007306,2011,71900135,,,,3,4,7
HND-007307,2011,71900136,,,,1,1,2
HND-007308,2011,71900137,,,,1,1,2
HND-007309,2011,71900138,,,,1,5,6
HND-007313,2011,71900142,,,,3,2,5
HND-007314,2011,71900143,,,,3,7,10
HND-007315,2011,71900144,,,,6,3,9
HND-007316,2011,71900146,,,,4,3,7
HND-007317,2011,71900148,,,,1,3,4
HND-007320,2011,71900151,,,,5,6,11
HND-007323,2011,71900154,,,,3,1,4
HND-007324,2011,71900155,,,,12,11,23
HND-007325,2011,71900158,,,,4,1,5
,2011,71900160,,,,5,2,7
HND-007329,2011,71900162,,,,1,3,4
HND-007330,2011,71900163,,,,1,1,2
HND-007336,2011,71900169,,,,9,8,17
HND-007337,2011,71900170,,,,2,3,5
HND-007341,2011,71900174,,,,7,5,12
HND-007343,2011,71900176,,,,6,1,7
HND-007344,2011,71900177,,,,4,3,7
,2011,71900180,,,,6,3,9
HND-007352,2011,71900242,,,,5,7,12
HND-007354,2011,71900244,,,,1,3,4
,2011,71900246,,,,1,2,3
HND-007356,2011,71900247,,,,1,1,2
,2011,71900249,,,,4,0,4
,2011,71900255,,,,1,2,3
HND-007360,2011,71900258,,,,1,1,2
HND-007365,2011,71900266,,,,4,10,14
HND-007368,2011,71900280,,,,4,11,15
,2011,71900281,,,,7,5,12
,2011,71900282,,,,4,2,6
HND-007371,2011,71900283,,,,5,5,10
,2011,71900284,,,,4,2,6
,2011,71900288,,,,1,2,3
HND-007193,2011,71900004,,,,60,52,112
HND-007198,2011,71900009,,,,1,8,9
HND-007199,2011,71900010,,,,2,3,5
HND-007200,2011,71900011,,,,1,2,3
HND-007201,2011,71900012,,,,2,5,7
HND-007202,2011,71900013,,,,1,2,3
HND-007203,2011,71900014,,,,9,9,18
HND-007204,2011,71900015,,,,4,6,10
HND-007205,2011,71900016,,,,3,2,5
HND-007206,2011,71900017,,,,4,5,9
HND-007207,2011,71900018,,,,0,3,3
HND-007208,2011,71900019,,,,4,5,9
HND-007210,2011,71900021,,,,6,4,10
HND-007211,2011,71900022,,,,1,4,5
HND-007212,2011,71900023,,,,1,2,3
HND-007216,2011,71900027,,,,4,2,6
HND-007220,2011,71900031,,,,5,3,8
HND-007221,2011,71900033,,,,1,2,3
HND-007222,2011,71900034,,,,7,5,12
,2011,71900036,,,,3,3,6
HND-007225,2011,71900037,,,,2,3,5
,2011,71900040,,,,2,1,3
HND-007232,2011,71900044,,,,5,3,8
HND-007233,2011,71900045,,,,4,12,16
HND-007234,2011,71900046,,,,5,2,7
,2011,71900048,,,,4,5,9
HND-007237,2011,71900049,,,,7,9,16
HND-007239,2011,71900051,,,,5,1,6
HND-007244,2011,71900057,,,,4,2,6
HND-007247,2011,71900061,,,,2,2,4
HND-007249,2011,71900063,,,,2,3,5
HND-007254,2011,71900068,,,,30,37,67
HND-007257,2011,71900071,,,,0,2,2
HND-007258,2011,71900072,,,,4,2,6
HND-007259,2011,71900074,,,,2,5,7
HND-007261,2011,71900076,,,,2,1,3
HND-007262,2011,71900077,,,,5,5,10
,2011,71900078,,,,5,4,9
HND-007266,2011,71900081,,,,1,3,4
HND-007267,2011,71900082,,,,2,2,4
HND-007268,2011,71900083,,,,6,4,10
HND-007269,2011,71900084,,,,9,7,16
HND-007270,2011,71900085,,,,0,1,1
HND-007271,2011,71900086,,,,0,4,4
HND-007272,2011,71900087,,,,1,1,2
HND-007278,2011,71900095,,,,3,8,11
HND-007283,2011,71900104,,,,2,1,3
HND-007285,2011,71900110,,,,3,6,9
HND-007287,2011,71900112,,,,5,2,7
HND-007292,2011,71900117,,,,6,3,9
HND-007293,2011,71900120,,,,1,3,4
HND-007295,2011,71900122,,,,5,3,8
HND-007296,2011,71900123,,,,0,2,2
HND-007301,2011,71900129,,,,0,1,1
HND-007303,2011,71900131,,,,1,1,2
,2011,71900134,,,,3,3,6
HND-007307,2011,71900136,,,,4,0,4
HND-007310,2011,71900139,,,,6,2,8
HND-007311,2011,71900140,,,,7,2,9
HND-007312,2011,71900141,,,,2,3,5
HND-007313,2011,71900142,,,,2,3,5
HND-007314,2011,71900143,,,,7,3,10
HND-007315,2011,71900144,,,,2,7,9
HND-007316,2011,71900146,,,,0,1,1
HND-007317,2011,71900148,,,,2,1,3
HND-007318,2011,71900149,,,,5,6,11
HND-007320,2011,71900151,,,,5,6,11
HND-007321,2011,71900152,,,,6,3,9
HND-007322,2011,71900153,,,,2,3,5
HND-007323,2011,71900154,,,,0,1,1
HND-007324,2011,71900155,,,,8,6,14
HND-007325,2011,71900158,,,,4,0,4
HND-007326,2011,71900159,,,,1,5,6
HND-007334,2011,71900167,,,,4,6,10
HND-007341,2011,71900174,,,,7,4,11
HND-007343,2011,71900176,,,,2,4,6
HND-007344,2011,71900177,,,,2,2,4
,2011,71900184,,,,2,2,4
HND-007356,2011,71900247,,,,1,1,2
,2011,71900248,,,,3,2,5
HND-007363,2011,71900264,,,,2,5,7
HND-007364,2011,71900265,,,,1,1,2
HND-007365,2011,71900266,,,,2,10,12
HND-007368,2011,71900280,,,,3,4,7
,2011,71900281,,,,7,5,12
,2011,71900282,,,,6,2,8
HND-007371,2011,71900283,,,,3,6,9
,2011,71900284,,,,2,2,4
,2011,71900288,,,,4,2,6
HND-007194,2011,71900005,,,,6,4,10
HND-007195,2011,71900006,,,,1,4,5
HND-007196,2011,71900007,,,,3,1,4
HND-007197,2011,71900008,,,,1,1,2
,2011,71900020,,,,6,8,14
HND-007213,2011,71900024,,,,3,6,9
HND-007214,2011,71900025,,,,5,12,17
HND-007215,2011,71900026,,,,1,1,2
HND-007217,2011,71900028,,,,12,8,20
HND-007218,2011,71900029,,,,3,0,3
HND-007223,2011,71900035,,,,2,3,5
HND-007226,2011,71900038,,,,7,5,12
HND-007227,2011,71900039,,,,8,10,18
HND-007229,2011,71900041,,,,5,6,11
HND-007230,2011,71900042,,,,0,4,4
HND-007231,2011,71900043,,,,3,5,8
HND-007235,2011,71900047,,,,2,7,9
HND-007238,2011,71900050,,,,11,8,19
HND-007240,2011,71900052,,,,4,2,6
HND-007241,2011,71900053,,,,2,4,6
HND-007242,2011,71900054,,,,1,3,4
HND-007243,2011,71900056,,,,9,7,16
,2011,71900058,,,,8,3,11
HND-007245,2011,71900059,,,,3,1,4
HND-007246,2011,71900060,,,,5,2,7
HND-007248,2011,71900062,,,,8,7,15
HND-007250,2011,71900064,,,,1,1,2
HND-007251,2011,71900065,,,,2,1,3
,2011,71900066,,,,8,3,11
HND-007253,2011,71900067,,,,1,2,3
HND-007255,2011,71900069,,,,2,2,4
HND-007256,2011,71900070,,,,3,3,6
HND-007260,2011,71900075,,,,6,4,10
HND-007264,2011,71900079,,,,3,6,9
HND-007265,2011,71900080,,,,2,4,6
HND-007277,2011,71900094,,,,17,18,35
HND-007282,2011,71900103,,,,1,3,4
,2011,71900109,,,,3,4,7
HND-007286,2011,71900111,,,,3,4,7
HND-007288,2011,71900113,,,,3,1,4
HND-007289,2011,71900114,,,,2,3,5
,2011,71900115,,,,2,5,7
HND-007291,2011,71900116,,,,1,4,5
HND-007294,2011,71900121,,,,4,5,9
HND-007297,2011,71900124,,,,4,8,12
HND-007298,2011,71900125,,,,4,4,8
HND-007299,2011,71900126,,,,6,0,6
HND-007300,2011,71900128,,,,4,10,14
HND-007302,2011,71900130,,,,1,5,6
HND-007306,2011,71900135,,,,10,3,13
HND-007308,2011,71900137,,,,2,2,4
HND-007319,2011,71900150,,,,1,3,4
,2011,71900160,,,,2,1,3
HND-007328,2011,71900161,,,,3,2,5
HND-007329,2011,71900162,,,,4,0,4
HND-007330,2011,71900163,,,,1,1,2
,2011,71900164,,,,1,1,2
HND-007332,2011,71900165,,,,2,1,3
HND-007333,2011,71900166,,,,3,8,11
HND-007335,2011,71900168,,,,3,5,8
HND-007336,2011,71900169,,,,3,0,3
HND-007337,2011,71900170,,,,3,1,4
HND-007338,2011,71900171,,,,4,3,7
HND-007340,2011,71900173,,,,2,1,3
HND-007342,2011,71900175,,,,1,4,5
HND-007345,2011,71900179,,,,11,3,14
,2011,71900180,,,,4,6,10
HND-007347,2011,71900181,,,,3,3,6
HND-007348,2011,71900182,,,,2,7,9
HND-007349,2011,71900183,,,,5,2,7
HND-007351,2011,71900241,,,,2,0,2
HND-007352,2011,71900242,,,,6,7,13
,2011,71900243,,,,2,1,3
HND-007354,2011,71900244,,,,0,3,3
,2011,71900246,,,,0,2,2
HND-007359,2011,71900252,,,,2,2,4
,2011,71900255,,,,1,1,2
HND-007360,2011,71900258,,,,2,1,3
HND-007362,2011,71900263,,,,1,1,2
HND-007367,2011,71900279,,,,3,2,5
,2011,71900319,,,,0,1,1
,2011,71900323,,,,1,1,2
HND-007194,2011,71900005,,,,8,13,21
HND-007198,2011,71900009,,,,5,7,12
HND-007199,2011,71900010,,,,1,8,9
HND-007200,2011,71900011,,,,2,4,6
HND-007201,2011,71900012,,,,7,5,12
HND-007202,2011,71900013,,,,0,1,1
HND-007203,2011,71900014,,,,7,5,12
HND-007204,2011,71900015,,,,5,5,10
HND-007205,2011,71900016,,,,3,1,4
HND-007206,2011,71900017,,,,5,3,8
HND-007207,2011,71900018,,,,1,2,3
HND-007210,2011,71900021,,,,3,2,5
HND-007212,2011,71900023,,,,1,3,4
HND-007216,2011,71900027,,,,4,3,7
HND-007220,2011,71900031,,,,4,2,6
HND-007221,2011,71900033,,,,1,1,2
HND-007225,2011,71900037,,,,2,0,2
,2011,71900040,,,,4,1,5
HND-007230,2011,71900042,,,,0,3,3
HND-007232,2011,71900044,,,,1,3,4
HND-007233,2011,71900045,,,,10,7,17
HND-007234,2011,71900046,,,,4,6,10
,2011,71900048,,,,2,3,5
HND-007237,2011,71900049,,,,1,3,4
HND-007249,2011,71900063,,,,0,1,1
HND-007255,2011,71900069,,,,3,3,6
HND-007257,2011,71900071,,,,4,2,6
HND-007258,2011,71900072,,,,1,2,3
HND-007259,2011,71900074,,,,1,4,5
HND-007262,2011,71900077,,,,0,3,3
HND-007266,2011,71900081,,,,1,2,3
HND-007267,2011,71900082,,,,6,3,9
HND-007268,2011,71900083,,,,1,6,7
HND-007269,2011,71900084,,,,2,3,5
HND-007272,2011,71900087,,,,2,1,3
HND-007278,2011,71900095,,,,1,3,4
HND-007285,2011,71900110,,,,4,1,5
HND-007286,2011,71900111,,,,1,3,4
HND-007287,2011,71900112,,,,9,7,16
HND-007288,2011,71900113,,,,0,2,2
,2011,71900115,,,,2,1,3
HND-007292,2011,71900117,,,,3,3,6
HND-007293,2011,71900120,,,,1,1,2
HND-007295,2011,71900122,,,,4,2,6
HND-007298,2011,71900125,,,,4,4,8
HND-007301,2011,71900129,,,,3,8,11
HND-007303,2011,71900131,,,,3,1,4
,2011,71900134,,,,3,3,6
HND-007306,2011,71900135,,,,1,2,3
HND-007307,2011,71900136,,,,0,6,6
HND-007309,2011,71900138,,,,2,1,3
HND-007310,2011,71900139,,,,1,1,2
HND-007311,2011,71900140,,,,5,4,9
HND-007312,2011,71900141,,,,4,2,6
HND-007313,2011,71900142,,,,0,1,1
HND-007314,2011,71900143,,,,4,1,5
HND-007315,2011,71900144,,,,4,1,5
HND-007316,2011,71900146,,,,1,0,1
HND-007317,2011,71900148,,,,1,1,2
HND-007318,2011,71900149,,,,10,4,14
HND-007320,2011,71900151,,,,5,3,8
HND-007322,2011,71900153,,,,3,3,6
HND-007323,2011,71900154,,,,0,4,4
HND-007324,2011,71900155,,,,4,3,7
HND-007325,2011,71900158,,,,4,1,5
HND-007326,2011,71900159,,,,0,1,1
HND-007329,2011,71900162,,,,1,3,4
HND-007341,2011,71900174,,,,3,6,9
HND-007343,2011,71900176,,,,8,5,13
HND-007344,2011,71900177,,,,0,3,3
HND-007351,2011,71900241,,,,3,1,4
HND-007352,2011,71900242,,,,0,6,6
HND-007354,2011,71900244,,,,2,1,3
,2011,71900248,,,,2,0,2
HND-007359,2011,71900252,,,,0,1,1
,2011,71900255,,,,0,1,1
HND-007360,2011,71900258,,,,0,3,3
HND-007365,2011,71900266,,,,2,2,4
HND-007367,2011,71900279,,,,0,4,4
HND-007193,2011,71900004,,,,52,52,104
HND-007195,2011,71900006,,,,8,3,11
HND-007196,2011,71900007,,,,3,2,5
HND-007197,2011,71900008,,,,7,3,10
HND-007208,2011,71900019,,,,4,5,9
,2011,71900020,,,,9,3,12
HND-007211,2011,71900022,,,,1,4,5
HND-007213,2011,71900024,,,,2,2,4
HND-007214,2011,71900025,,,,4,2,6
HND-007215,2011,71900026,,,,2,1,3
HND-007217,2011,71900028,,,,8,13,21
HND-007218,2011,71900029,,,,5,7,12
HND-007219,2011,71900030,,,,1,0,1
HND-007222,2011,71900034,,,,7,10,17
HND-007223,2011,71900035,,,,3,6,9
,2011,71900036,,,,1,6,7
HND-007226,2011,71900038,,,,5,4,9
HND-007227,2011,71900039,,,,9,10,19
HND-007229,2011,71900041,,,,1,3,4
HND-007231,2011,71900043,,,,1,2,3
HND-007235,2011,71900047,,,,4,3,7
HND-007238,2011,71900050,,,,2,4,6
HND-007239,2011,71900051,,,,3,2,5
HND-007240,2011,71900052,,,,2,3,5
HND-007242,2011,71900054,,,,1,3,4
HND-007243,2011,71900056,,,,7,6,13
HND-007244,2011,71900057,,,,4,3,7
,2011,71900058,,,,11,6,17
HND-007245,2011,71900059,,,,1,3,4
HND-007246,2011,71900060,,,,12,3,15
HND-007247,2011,71900061,,,,6,6,12
HND-007248,2011,71900062,,,,9,10,19
HND-007250,2011,71900064,,,,1,3,4
HND-007251,2011,71900065,,,,5,1,6
,2011,71900066,,,,0,3,3
HND-007253,2011,71900067,,,,1,1,2
HND-007254,2011,71900068,,,,25,40,65
HND-007256,2011,71900070,,,,4,4,8
HND-007260,2011,71900075,,,,1,3,4
HND-007261,2011,71900076,,,,3,4,7
,2011,71900078,,,,3,3,6
HND-007264,2011,71900079,,,,2,2,4
HND-007265,2011,71900080,,,,2,6,8
HND-007270,2011,71900085,,,,1,2,3
HND-007271,2011,71900086,,,,3,5,8
HND-007277,2011,71900094,,,,24,13,37
HND-007282,2011,71900103,,,,1,3,4
HND-007283,2011,71900104,,,,3,3,6
,2011,71900109,,,,5,2,7
HND-007289,2011,71900114,,,,5,2,7
HND-007291,2011,71900116,,,,3,1,4
HND-007294,2011,71900121,,,,2,3,5
HND-007297,2011,71900124,,,,4,5,9
HND-007299,2011,71900126,,,,4,7,11
HND-007300,2011,71900128,,,,7,6,13
HND-007302,2011,71900130,,,,1,3,4
HND-007319,2011,71900150,,,,3,5,8
HND-007321,2011,71900152,,,,2,7,9
,2011,71900160,,,,2,0,2
HND-007328,2011,71900161,,,,2,2,4
HND-007330,2011,71900163,,,,1,2,3
,2011,71900164,,,,1,0,1
HND-007332,2011,71900165,,,,2,2,4
HND-007333,2011,71900166,,,,2,5,7
HND-007334,2011,71900167,,,,0,2,2
HND-007335,2011,71900168,,,,3,6,9
HND-007336,2011,71900169,,,,3,0,3
HND-007337,2011,71900170,,,,3,1,4
HND-007338,2011,71900171,,,,3,3,6
HND-007340,2011,71900173,,,,2,3,5
HND-007342,2011,71900175,,,,8,2,10
HND-007345,2011,71900179,,,,5,1,6
HND-007347,2011,71900181,,,,3,1,4
HND-007348,2011,71900182,,,,6,7,13
HND-007349,2011,71900183,,,,2,0,2
,2011,71900184,,,,2,3,5
,2011,71900246,,,,2,1,3
HND-007356,2011,71900247,,,,3,1,4
,2011,71900249,,,,0,3,3
HND-007362,2011,71900263,,,,2,4,6
HND-007364,2011,71900265,,,,1,1,2
HND-007368,2011,71900280,,,,0,3,3
,2011,71900281,,,,1,3,4
,2011,71900282,,,,2,3,5
HND-007371,2011,71900283,,,,2,6,8
,2011,71900284,,,,2,1,3
,2011,71900288,,,,2,1,3
,2011,71900319,,,,1,3,4
,2011,71900323,,,,0,2,2
HND-007194,2011,71900005,,,,13,19,32
HND-007195,2011,71900006,,,,1,3,4
HND-007197,2011,71900008,,,,4,3,7
HND-007198,2011,71900009,,,,7,3,10
HND-007200,2011,71900011,,,,3,1,4
HND-007202,2011,71900013,,,,3,2,5
HND-007206,2011,71900017,,,,3,3,6
,2011,71900020,,,,7,7,14
HND-007214,2011,71900025,,,,5,6,11
HND-007217,2011,71900028,,,,9,9,18
HND-007218,2011,71900029,,,,8,3,11
HND-007227,2011,71900039,,,,3,8,11
HND-007229,2011,71900041,,,,3,6,9
HND-007230,2011,71900042,,,,0,3,3
HND-007231,2011,71900043,,,,6,2,8
HND-007232,2011,71900044,,,,4,1,5
HND-007234,2011,71900046,,,,0,4,4
HND-007235,2011,71900047,,,,5,4,9
HND-007238,2011,71900050,,,,5,5,10
HND-007242,2011,71900054,,,,1,3,4
HND-007243,2011,71900056,,,,7,6,13
HND-007245,2011,71900059,,,,1,2,3
HND-007246,2011,71900060,,,,8,4,12
HND-007248,2011,71900062,,,,5,13,18
HND-007250,2011,71900064,,,,1,2,3
HND-007251,2011,71900065,,,,2,1,3
,2011,71900066,,,,4,3,7
HND-007255,2011,71900069,,,,2,4,6
HND-007277,2011,71900094,,,,8,7,15
,2011,71900109,,,,1,4,5
HND-007286,2011,71900111,,,,5,3,8
HND-007287,2011,71900112,,,,5,4,9
HND-007288,2011,71900113,,,,1,3,4
,2011,71900115,,,,2,3,5
HND-007291,2011,71900116,,,,0,3,3
HND-007294,2011,71900121,,,,4,1,5
HND-007295,2011,71900122,,,,6,3,9
HND-007296,2011,71900123,,,,1,5,6
HND-007297,2011,71900124,,,,3,3,6
HND-007298,2011,71900125,,,,2,0,2
HND-007299,2011,71900126,,,,3,5,8
HND-007300,2011,71900128,,,,2,5,7
HND-007301,2011,71900129,,,,4,1,5
,2011,71900134,,,,3,2,5
HND-007306,2011,71900135,,,,2,0,2
HND-007308,2011,71900137,,,,0,1,1
HND-007314,2011,71900143,,,,5,1,6
,2011,71900160,,,,1,0,1
HND-007328,2011,71900161,,,,4,3,7
HND-007329,2011,71900162,,,,2,1,3
HND-007330,2011,71900163,,,,0,1,1
,2011,71900164,,,,1,0,1
HND-007332,2011,71900165,,,,1,1,2
HND-007333,2011,71900166,,,,6,4,10
HND-007335,2011,71900168,,,,3,4,7
HND-007336,2011,71900169,,,,3,1,4
HND-007337,2011,71900170,,,,2,1,3
HND-007345,2011,71900179,,,,7,2,9
,2011,71900180,,,,2,0,2
HND-007347,2011,71900181,,,,0,1,1
HND-007348,2011,71900182,,,,2,5,7
HND-007356,2011,71900247,,,,3,0,3
,2011,71900248,,,,0,1,1
HND-007362,2011,71900263,,,,1,0,1
HND-007365,2011,71900266,,,,1,1,2
,2011,71900282,,,,2,1,3
,2011,71900284,,,,0,2,2
,2011,71900319,,,,1,0,1
HND-007193,2011,71900004,,,,45,61,106
HND-007196,2011,71900007,,,,0,1,1
HND-007199,2011,71900010,,,,5,4,9
HND-007201,2011,71900012,,,,6,3,9
HND-007203,2011,71900014,,,,8,4,12
HND-007204,2011,71900015,,,,6,1,7
HND-007205,2011,71900016,,,,2,3,5
HND-007208,2011,71900019,,,,3,5,8
HND-007210,2011,71900021,,,,1,2,3
HND-007211,2011,71900022,,,,3,1,4
HND-007212,2011,71900023,,,,5,0,5
HND-007213,2011,71900024,,,,4,5,9
HND-007215,2011,71900026,,,,2,1,3
HND-007216,2011,71900027,,,,2,3,5
HND-007219,2011,71900030,,,,0,2,2
HND-007220,2011,71900031,,,,5,3,8
HND-007221,2011,71900033,,,,1,2,3
HND-007222,2011,71900034,,,,4,7,11
HND-007223,2011,71900035,,,,4,2,6
,2011,71900036,,,,2,1,3
HND-007225,2011,71900037,,,,1,2,3
HND-007226,2011,71900038,,,,2,0,2
HND-007233,2011,71900045,,,,12,1,13
,2011,71900048,,,,3,1,4
HND-007237,2011,71900049,,,,5,2,7
HND-007239,2011,71900051,,,,5,3,8
HND-007240,2011,71900052,,,,1,3,4
HND-007241,2011,71900053,,,,5,4,9
HND-007244,2011,71900057,,,,5,4,9
,2011,71900058,,,,12,9,21
HND-007247,2011,71900061,,,,0,3,3
HND-007249,2011,71900063,,,,3,1,4
HND-007253,2011,71900067,,,,3,0,3
HND-007254,2011,71900068,,,,33,30,63
HND-007256,2011,71900070,,,,0,4,4
HND-007257,2011,71900071,,,,3,8,11
HND-007258,2011,71900072,,,,1,2,3
HND-007259,2011,71900074,,,,3,4,7
HND-007260,2011,71900075,,,,5,5,10
HND-007261,2011,71900076,,,,6,1,7
HND-007262,2011,71900077,,,,2,3,5
,2011,71900078,,,,0,2,2
HND-007264,2011,71900079,,,,2,3,5
HND-007265,2011,71900080,,,,5,1,6
HND-007266,2011,71900081,,,,0,1,1
HND-007267,2011,71900082,,,,1,3,4
HND-007268,2011,71900083,,,,1,4,5
HND-007269,2011,71900084,,,,4,1,5
HND-007270,2011,71900085,,,,4,3,7
HND-007271,2011,71900086,,,,4,0,4
HND-007272,2011,71900087,,,,2,0,2
HND-007278,2011,71900095,,,,1,4,5
HND-007282,2011,71900103,,,,6,1,7
HND-007283,2011,71900104,,,,0,1,1
HND-007285,2011,71900110,,,,2,2,4
HND-007289,2011,71900114,,,,2,4,6
HND-007292,2011,71900117,,,,2,3,5
HND-007293,2011,71900120,,,,0,5,5
HND-007302,2011,71900130,,,,0,1,1
HND-007303,2011,71900131,,,,2,1,3
HND-007307,2011,71900136,,,,2,1,3
HND-007309,2011,71900138,,,,2,1,3
HND-007310,2011,71900139,,,,3,2,5
HND-007311,2011,71900140,,,,6,3,9
HND-007312,2011,71900141,,,,8,0,8
HND-007313,2011,71900142,,,,5,2,7
HND-007315,2011,71900144,,,,4,2,6
HND-007316,2011,71900146,,,,1,2,3
HND-007317,2011,71900148,,,,2,1,3
HND-007318,2011,71900149,,,,0,8,8
HND-007319,2011,71900150,,,,2,2,4
HND-007320,2011,71900151,,,,2,2,4
HND-007321,2011,71900152,,,,5,3,8
HND-007322,2011,71900153,,,,3,4,7
HND-007323,2011,71900154,,,,0,2,2
HND-007324,2011,71900155,,,,1,3,4
HND-007325,2011,71900158,,,,0,2,2
HND-007326,2011,71900159,,,,1,1,2
HND-007334,2011,71900167,,,,1,6,7
HND-007338,2011,71900171,,,,4,4,8
HND-007340,2011,71900173,,,,8,6,14
HND-007341,2011,71900174,,,,4,7,11
HND-007342,2011,71900175,,,,4,1,5
HND-007343,2011,71900176,,,,0,2,2
HND-007344,2011,71900177,,,,4,2,6
,2011,71900184,,,,3,3,6
HND-007351,2011,71900241,,,,2,2,4
HND-007352,2011,71900242,,,,4,0,4
HND-007354,2011,71900244,,,,2,5,7
,2011,71900246,,,,1,1,2
,2011,71900249,,,,0,1,1
,2011,71900255,,,,1,0,1
HND-007360,2011,71900258,,,,2,0,2
HND-007363,2011,71900264,,,,2,0,2
HND-007364,2011,71900265,,,,2,1,3
HND-007367,2011,71900279,,,,0,1,1
HND-007368,2011,71900280,,,,2,0,2
,2011,71900281,,,,0,3,3
HND-007371,2011,71900283,,,,1,3,4
,2011,71900288,,,,0,2,2
,2011,71900323,,,,1,2,3
,2011,71900020,,,,12,11,23
HND-007217,2011,71900028,,,,6,9,15
HND-007247,2011,71900061,,,,7,8,15
HND-007248,2011,71900062,,,,11,11,22
HND-007257,2011,71900071,,,,5,1,6
HND-007339,2011,71900172,,,,154,155,309
,2011,71900288,,,,15,17,32
HND-007194,2011,71900005,,,,9,8,17
HND-007223,2011,71900035,,,,3,7,10
HND-007226,2011,71900038,,,,10,13,23
HND-007223,2011,71900035,,,,7,1,8
HND-007226,2011,71900038,,,,6,9,15
HND-007247,2011,71900061,,,,1,3,4
HND-007257,2011,71900071,,,,6,6,12
HND-007339,2011,71900172,,,,117,127,244
,2011,71900288,,,,13,20,33
HND-007194,2011,71900005,,,,8,9,17
,2011,71900020,,,,6,9,15
HND-007217,2011,71900028,,,,4,5,9
HND-007248,2011,71900062,,,,11,12,23
HND-007247,2011,71900061,,,,2,1,3
HND-007257,2011,71900071,,,,6,4,10
HND-007339,2011,71900172,,,,80,129,209
,2011,71900288,,,,10,4,14
HND-007194,2011,71900005,,,,10,13,23
,2011,71900020,,,,4,6,10
HND-007217,2011,71900028,,,,12,8,20
HND-007223,2011,71900035,,,,5,7,12
HND-007226,2011,71900038,,,,4,11,15
HND-007248,2011,71900062,,,,14,13,27
,2011,71900288,,,,9,8,17
HND-007339,2011,71900172,,,,72,78,150
HND-007339,2011,71900172,,,,64,84,148
,2011,71900288,,,,17,19,36
HND-007339,2011,71900172,,,,38,50,88
HND-007436,2011,80100058,,,,3,4,7
HND-007442,2011,80100064,,,,12,12,24
HND-007523,2011,80100166,,,,6,6,12
HND-007588,2011,80100263,,,,7,8,15
,2011,80100711,,,,26,37,63
,2011,80100712,,,,16,19,35
HND-007792,2011,80100721,,,,17,9,26
,2011,80100773,,,,15,15,30
HND-007811,2011,80100777,,,,32,21,53
HND-007819,2011,80100799,,,,37,28,65
HND-007832,2011,80100835,,,,29,53,82
HND-007844,2011,80100856,,,,11,19,30
HND-007878,2011,80100955,,,,22,14,36
HND-007879,2011,80100956,,,,26,17,43
,2011,80100961,,,,16,7,23
,2011,80100962,,,,11,13,24
HND-007882,2011,80100967,,,,38,39,77
,2011,80100983,,,,51,55,106
,2011,80100994,,,,5,1,6
HND-007891,2011,80101022,,,,7,10,17
HND-007895,2011,80101036,,,,13,8,21
,2011,80101043,,,,5,9,14
HND-007906,2011,80101119,,,,25,31,56
HND-007908,2011,80101123,,,,9,9,18
HND-007909,2011,80101144,,,,5,9,14
,2011,80101172,,,,8,8,16
HND-007916,2011,80101175,,,,17,23,40
,2011,80101178,,,,13,11,24
,2011,80101179,,,,5,3,8
,2011,80101181,,,,3,2,5
HND-007918,2011,80101185,,,,6,4,10
HND-007922,2011,80101199,,,,12,15,27
,2011,80101277,,,,19,12,31
,2011,80101295,,,,29,31,60
,2011,80101296,,,,27,28,55
,2011,80101397,,,,10,6,16
HND-007934,2011,80101505,,,,14,11,25
HND-007936,2011,80101507,,,,5,4,9
,2011,80101513,,,,2,4,6
,2011,80101519,,,,6,9,15
HND-007940,2011,80101521,,,,22,15,37
HND-007941,2011,80101523,,,,9,14,23
,2011,80101565,,,,9,17,26
HND-007945,2011,80101566,,,,6,11,17
,2011,80101567,,,,29,17,46
,2011,80101568,,,,3,6,9
,2011,80101575,,,,9,7,16
,2011,80101576,,,,3,3,6
,2011,80101579,,,,5,4,9
HND-007953,2011,80101591,,,,13,12,25
,2011,80101596,,,,6,2,8
,2011,80101598,,,,2,2,4
HND-007956,2011,80101600,,,,26,12,38
,2011,80101609,,,,3,4,7
,2011,80101610,,,,4,4,8
,2011,80101611,,,,9,5,14
HND-007959,2011,80101612,,,,16,22,38
HND-007960,2011,80101613,,,,26,19,45
,2011,80101619,,,,4,1,5
,2011,80101621,,,,5,4,9
,2011,80101631,,,,10,10,20
HND-007965,2011,80101632,,,,22,27,49
,2011,80101638,,,,3,6,9
,2011,80101639,,,,3,4,7
,2011,80101640,,,,6,4,10
,2011,80101644,,,,2,2,4
HND-007969,2011,80101645,,,,7,6,13
HND-007972,2011,80101648,,,,9,11,20
HND-007975,2011,80101655,,,,15,24,39
HND-007977,2011,80101662,,,,8,11,19
HND-007978,2011,80101663,,,,38,51,89
HND-007980,2011,80101667,,,,24,19,43
HND-007983,2011,80101678,,,,12,10,22
,2011,80101688,,,,3,10,13
HND-007986,2011,80101713,,,,2,6,8
,2011,80101715,,,,4,5,9
,2011,80101720,,,,31,37,68
HND-007405,2011,80100020,,,,6,6,12
HND-007452,2011,80100078,,,,6,7,13
HND-007477,2011,80100106,,,,5,8,13
HND-007532,2011,80100177,,,,1,5,6
HND-007535,2011,80100180,,,,5,5,10
,2011,80100703,,,,17,23,40
HND-007790,2011,80100718,,,,18,13,31
,2011,80100745,,,,44,59,103
HND-007801,2011,80100748,,,,31,27,58
HND-007808,2011,80100774,,,,41,43,84
HND-007809,2011,80100775,,,,16,13,29
HND-007810,2011,80100776,,,,14,21,35
HND-007812,2011,80100778,,,,30,23,53
HND-007874,2011,80100937,,,,20,21,41
HND-007880,2011,80100957,,,,19,17,36
HND-007881,2011,80100959,,,,26,25,51
HND-007883,2011,80100986,,,,8,1,9
HND-007884,2011,80100991,,,,58,43,101
,2011,80100993,,,,31,28,59
,2011,80100996,,,,6,8,14
HND-007887,2011,80101008,,,,6,1,7
,2011,80101021,,,,3,5,8
HND-007896,2011,80101038,,,,11,15,26
,2011,80101118,,,,3,3,6
HND-007907,2011,80101120,,,,19,27,46
HND-007913,2011,80101170,,,,7,11,18
HND-007914,2011,80101173,,,,38,28,66
,2011,80101177,,,,5,5,10
HND-007917,2011,80101180,,,,6,4,10
,2011,80101191,,,,15,13,28
,2011,80101272,,,,11,12,23
,2011,80101273,,,,8,15,23
HND-007926,2011,80101285,,,,12,10,22
,2011,80101286,,,,19,17,36
HND-007929,2011,80101440,,,,14,11,25
,2011,80101506,,,,6,9,15
,2011,80101508,,,,4,5,9
,2011,80101511,,,,9,5,14
HND-007937,2011,80101512,,,,6,4,10
,2011,80101514,,,,6,5,11
HND-007938,2011,80101517,,,,4,10,14
,2011,80101522,,,,17,15,32
HND-007942,2011,80101524,,,,16,13,29
,2011,80101569,,,,9,2,11
HND-007948,2011,80101573,,,,5,9,14
,2011,80101574,,,,3,4,7
,2011,80101577,,,,8,7,15
HND-007949,2011,80101578,,,,11,9,20
,2011,80101594,,,,28,26,54
HND-007954,2011,80101595,,,,7,5,12
,2011,80101601,,,,7,8,15
,2011,80101602,,,,4,4,8
HND-007957,2011,80101603,,,,8,7,15
,2011,80101606,,,,5,4,9
HND-007958,2011,80101608,,,,7,14,21
,2011,80101614,,,,2,2,4
HND-007961,2011,80101616,,,,4,5,9
,2011,80101618,,,,5,4,9
,2011,80101623,,,,11,17,28
HND-007962,2011,80101628,,,,25,32,57
,2011,80101629,,,,21,27,48
,2011,80101636,,,,4,2,6
,2011,80101637,,,,1,2,3
,2011,80101641,,,,2,3,5
,2011,80101642,,,,6,4,10
HND-007970,2011,80101646,,,,13,11,24
HND-007971,2011,80101647,,,,17,11,28
HND-007974,2011,80101654,,,,23,19,42
HND-007976,2011,80101656,,,,6,4,10
HND-007979,2011,80101664,,,,27,21,48
,2011,80101693,,,,5,4,9
,2011,80101694,,,,14,6,20
,2011,80101698,,,,11,18,29
HND-007985,2011,80101711,,,,6,5,11
,2011,80101712,,,,5,6,11
,2011,80101714,,,,3,5,8
,2011,80101716,,,,11,8,19
,2011,80101717,,,,9,7,16
,2011,80101718,,,,7,4,11
,2011,80101719,,,,3,5,8
,2011,80101721,,,,4,4,8
,2011,80100009,,,,27,25,52
HND-007404,2011,80100019,,,,1,1,2
HND-007403,2011,80100019,,,,1,1,2
HND-007441,2011,80100063,,,,12,0,12
,2011,80100069,,,,2,3,5
HND-007444,2011,80100070,,,,1,2,3
,2011,80100156,,,,4,6,10
,2011,80100173,,,,1,1,2
HND-007538,2011,80100183,,,,0,5,5
HND-007540,2011,80100185,,,,10,8,18
,2011,80100216,,,,1,0,1
,2011,80100230,,,,4,9,13
,2011,80100250,,,,13,11,24
,2011,80100257,,,,5,5,10
,2011,80100278,,,,4,8,12
,2011,80100284,,,,2,3,5
,2011,80100297,,,,0,1,1
,2011,80100300,,,,1,1,2
,2011,80100312,,,,1,1,2
,2011,80100320,,,,1,0,1
,2011,80100330,,,,0,1,1
,2011,80100337,,,,1,1,2
,2011,80100344,,,,6,4,10
,2011,80100345,,,,4,2,6
,2011,80100361,,,,3,5,8
,2011,80100380,,,,0,2,2
,2011,80100407,,,,16,14,30
,2011,80100428,,,,4,1,5
HND-007659,2011,80100429,,,,28,13,41
,2011,80100432,,,,0,1,1
HND-007662,2011,80100441,,,,1,0,1
HND-007666,2011,80100445,,,,9,16,25
HND-007669,2011,80100450,,,,15,9,24
,2011,80100451,,,,1,1,2
HND-007673,2011,80100456,,,,1,1,2
HND-007677,2011,80100460,,,,20,32,52
HND-007681,2011,80100467,,,,9,9,18
,2011,80100477,,,,1,0,1
,2011,80100500,,,,5,16,21
HND-007704,2011,80100510,,,,27,35,62
HND-007705,2011,80100513,,,,7,6,13
HND-007716,2011,80100530,,,,5,4,9
,2011,80100546,,,,5,5,10
HND-007725,2011,80100552,,,,2,1,3
,2011,80100581,,,,1,1,2
,2011,80100660,,,,2,2,4
,2011,80100663,,,,8,6,14
,2011,80100696,,,,3,2,5
,2011,80100710,,,,2,3,5
HND-007793,2011,80100724,,,,0,3,3
,2011,80100729,,,,19,25,44
,2011,80100732,,,,6,3,9
,2011,80100733,,,,10,8,18
,2011,80100742,,,,6,8,14
,2011,80100744,,,,6,4,10
,2011,80100750,,,,13,3,16
,2011,80100751,,,,4,5,9
,2011,80100752,,,,11,9,20
,2011,80100754,,,,3,5,8
,2011,80100791,,,,0,3,3
,2011,80100794,,,,0,1,1
HND-007821,2011,80100801,,,,10,0,10
,2011,80100808,,,,15,23,38
,2011,80100815,,,,15,0,15
,2011,80100817,,,,15,11,26
,2011,80100830,,,,1,1,2
HND-007834,2011,80100839,,,,7,8,15
HND-007834,2011,80100839,,,,3,3,6
,2011,80100846,,,,7,1,8
,2011,80100871,,,,5,5,10
HND-007854,2011,80100881,,,,2,2,4
,2011,80100883,,,,7,5,12
,2011,80100884,,,,12,9,21
,2011,80100886,,,,3,2,5
,2011,80100917,,,,10,8,18
,2011,80100920,,,,5,6,11
HND-007873,2011,80100932,,,,5,1,6
,2011,80100934,,,,1,3,4
,2011,80100939,,,,53,77,130
,2011,80100963,,,,22,26,48
,2011,80100980,,,,1,2,3
,2011,80100985,,,,0,2,2
,2011,80100990,,,,8,11,19
,2011,80101013,,,,6,4,10
HND-007889,2011,80101018,,,,6,4,10
,2011,80101063,,,,3,3,6
HND-007899,2011,80101086,,,,6,5,11
,2011,80101129,,,,25,20,45
,2011,80101186,,,,1,1,2
,2011,80101187,,,,0,1,1
HND-007921,2011,80101193,,,,5,5,10
,2011,80101204,,,,7,9,16
,2011,80101207,,,,0,1,1
,2011,80101210,,,,5,2,7
,2011,80101215,,,,2,0,2
,2011,80101260,,,,2,2,4
,2011,80101268,,,,2,0,2
HND-007923,2011,80101274,,,,1,2,3
,2011,80101309,,,,1,0,1
,2011,80101312,,,,3,2,5
,2011,80101323,,,,4,3,7
,2011,80101326,,,,4,4,8
,2011,80101335,,,,8,8,16
,2011,80101336,,,,3,5,8
,2011,80101495,,,,2,1,3
,2011,80101542,,,,1,3,4
,2011,80101543,,,,5,5,10
,2011,80101547,,,,2,2,4
,2011,80101551,,,,1,1,2
,2011,80101552,,,,4,4,8
,2011,80101553,,,,14,8,22
,2011,80101586,,,,1,0,1
,2011,80101599,,,,6,6,12
,2011,80101605,,,,2,2,4
,2011,80101617,,,,1,2,3
,2011,80101620,,,,3,3,6
,2011,80101627,,,,2,2,4
HND-007973,2011,80101649,,,,1,0,1
,2011,80101650,,,,1,1,2
,2011,80101652,,,,2,0,2
,2011,80101653,,,,1,1,2
,2011,80101674,,,,1,3,4
,2011,80101683,,,,2,3,5
,2011,80101690,,,,6,1,7
,2011,80101707,,,,3,1,4
HND-007424,2011,80100042,,,,1,1,2
HND-007465,2011,80100091,,,,7,1,8
HND-007516,2011,80100157,,,,5,4,9
,2011,80100205,,,,3,1,4
,2011,80100213,,,,2,1,3
,2011,80100219,,,,3,1,4
,2011,80100224,,,,8,8,16
,2011,80100237,,,,41,37,78
,2011,80100306,,,,0,1,1
,2011,80100329,,,,1,0,1
,2011,80100375,,,,3,1,4
,2011,80100378,,,,2,2,4
,2011,80100383,,,,4,2,6
,2011,80100384,,,,1,0,1
,2011,80100396,,,,1,1,2
HND-007651,2011,80100417,,,,1,1,2
,2011,80100435,,,,1,0,1
HND-007663,2011,80100442,,,,4,3,7
,2011,80100448,,,,4,6,10
HND-007675,2011,80100458,,,,5,4,9
,2011,80100465,,,,1,0,1
,2011,80100468,,,,1,3,4
HND-007684,2011,80100471,,,,3,2,5
,2011,80100473,,,,58,52,110
,2011,80100493,,,,1,2,3
HND-007697,2011,80100496,,,,15,17,32
HND-007699,2011,80100498,,,,24,22,46
,2011,80100499,,,,4,1,5
,2011,80100508,,,,15,28,43
HND-007709,2011,80100519,,,,4,5,9
HND-007714,2011,80100528,,,,14,17,31
HND-007715,2011,80100529,,,,2,3,5
HND-007723,2011,80100544,,,,13,7,20
,2011,80100566,,,,4,4,8
HND-007731,2011,80100573,,,,8,7,15
HND-007736,2011,80100580,,,,36,24,60
,2011,80100583,,,,1,0,1
,2011,80100595,,,,3,1,4
,2011,80100606,,,,5,7,12
,2011,80100637,,,,1,4,5
,2011,80100658,,,,1,2,3
,2011,80100675,,,,14,16,30
,2011,80100738,,,,0,1,1
,2011,80100743,,,,10,3,13
,2011,80100755,,,,6,8,14
,2011,80100757,,,,3,3,6
,2011,80100758,,,,6,8,14
,2011,80100759,,,,5,5,10
,2011,80100767,,,,0,1,1
,2011,80100780,,,,2,2,4
HND-007814,2011,80100781,,,,18,9,27
,2011,80100807,,,,1,2,3
,2011,80100818,,,,10,8,18
,2011,80100819,,,,17,15,32
HND-007826,2011,80100823,,,,3,4,7
HND-007829,2011,80100827,,,,3,1,4
,2011,80100828,,,,8,8,16
,2011,80100831,,,,1,1,2
HND-007831,2011,80100833,,,,5,1,6
,2011,80100838,,,,2,0,2
,2011,80100861,,,,10,6,16
HND-007849,2011,80100866,,,,6,7,13
HND-007852,2011,80100870,,,,4,3,7
,2011,80100925,,,,2,2,4
,2011,80100944,,,,0,2,2
,2011,80100948,,,,4,5,9
,2011,80100954,,,,0,1,1
,2011,80100969,,,,2,5,7
,2011,80101005,,,,4,3,7
,2011,80101006,,,,1,0,1
,2011,80101007,,,,0,1,1
,2011,80101014,,,,0,1,1
,2011,80101016,,,,5,3,8
,2011,80101017,,,,225,44,269
,2011,80101071,,,,2,6,8
,2011,80101088,,,,2,2,4
,2011,80101125,,,,1,0,1
,2011,80101161,,,,1,0,1
,2011,80101164,,,,0,1,1
,2011,80101200,,,,3,5,8
,2011,80101203,,,,2,0,2
,2011,80101205,,,,1,3,4
,2011,80101206,,,,0,1,1
,2011,80101209,,,,0,1,1
,2011,80101212,,,,2,0,2
,2011,80101219,,,,8,8,16
,2011,80101308,,,,4,0,4
,2011,80101310,,,,2,0,2
,2011,80101318,,,,4,4,8
,2011,80101320,,,,9,6,15
,2011,80101321,,,,12,9,21
,2011,80101334,,,,9,11,20
,2011,80101344,,,,7,5,12
,2011,80101345,,,,3,2,5
,2011,80101348,,,,0,39,39
,2011,80101436,,,,1,0,1
,2011,80101476,,,,2,0,2
,2011,80101483,,,,0,1,1
,2011,80101488,,,,0,2,2
,2011,80101491,,,,7,4,11
,2011,80101492,,,,2,1,3
,2011,80101496,,,,8,6,14
,2011,80101499,,,,0,2,2
,2011,80101501,,,,1,0,1
,2011,80101527,,,,9,9,18
,2011,80101544,,,,4,2,6
,2011,80101546,,,,0,1,1
,2011,80101548,,,,0,1,1
,2011,80101550,,,,4,2,6
,2011,80101554,,,,1,1,2
,2011,80101555,,,,2,1,3
,2011,80101564,,,,4,2,6
,2011,80101588,,,,0,1,1
,2011,80101590,,,,2,8,10
,2011,80101592,,,,0,1,1
HND-007964,2011,80101630,,,,1,0,1
,2011,80101634,,,,0,1,1
,2011,80101659,,,,2,2,4
,2011,80101666,,,,0,2,2
,2011,80101682,,,,8,5,13
,2011,80101684,,,,5,6,11
,2011,80101687,,,,6,11,17
,2011,80100009,,,,29,35,64
HND-007404,2011,80100019,,,,2,2,4
HND-007403,2011,80100019,,,,2,2,4
HND-007409,2011,80100024,,,,2,2,4
HND-007422,2011,80100040,,,,3,9,12
HND-007441,2011,80100063,,,,14,1,15
HND-007449,2011,80100075,,,,2,2,4
HND-007465,2011,80100091,,,,9,3,12
,2011,80100099,,,,24,22,46
HND-007483,2011,80100116,,,,1,1,2
HND-007496,2011,80100129,,,,2,2,4
HND-007508,2011,80100144,,,,5,5,10
HND-007515,2011,80100152,,,,6,10,16
,2011,80100156,,,,19,15,34
HND-007516,2011,80100157,,,,8,6,14
HND-007527,2011,80100170,,,,11,18,29
HND-007543,2011,80100187,,,,4,8,12
HND-007542,2011,80100187,,,,4,8,12
HND-007546,2011,80100190,,,,6,12,18
HND-007548,2011,80100192,,,,10,11,21
,2011,80100204,,,,3,4,7
,2011,80100205,,,,2,8,10
,2011,80100207,,,,9,15,24
,2011,80100211,,,,8,12,20
,2011,80100213,,,,6,3,9
,2011,80100219,,,,5,4,9
HND-007559,2011,80100221,,,,1,1,2
,2011,80100225,,,,48,43,91
,2011,80100237,,,,39,38,77
,2011,80100257,,,,9,6,15
,2011,80100270,,,,2,2,4
,2011,80100273,,,,1,3,4
,2011,80100278,,,,12,11,23
,2011,80100284,,,,17,5,22
,2011,80100288,,,,2,1,3
,2011,80100300,,,,1,0,1
,2011,80100301,,,,6,4,10
,2011,80100303,,,,5,5,10
,2011,80100308,,,,5,6,11
,2011,80100312,,,,1,1,2
,2011,80100319,,,,2,7,9
HND-007609,2011,80100322,,,,35,31,66
,2011,80100324,,,,3,3,6
,2011,80100329,,,,4,9,13
,2011,80100330,,,,4,3,7
,2011,80100337,,,,7,10,17
,2011,80100345,,,,5,6,11
,2011,80100346,,,,8,13,21
,2011,80100361,,,,3,6,9
,2011,80100371,,,,5,2,7
,2011,80100375,,,,18,12,30
,2011,80100378,,,,6,1,7
,2011,80100383,,,,12,5,17
,2011,80100384,,,,8,9,17
HND-007636,2011,80100385,,,,3,2,5
,2011,80100388,,,,11,7,18
HND-007638,2011,80100391,,,,16,12,28
,2011,80100395,,,,11,12,23
,2011,80100396,,,,3,5,8
,2011,80100405,,,,0,1,1
,2011,80100406,,,,9,17,26
,2011,80100407,,,,21,17,38
,2011,80100410,,,,4,5,9
HND-007646,2011,80100411,,,,5,5,10
,2011,80100420,,,,3,3,6
,2011,80100428,,,,20,23,43
HND-007659,2011,80100429,,,,37,16,53
,2011,80100432,,,,2,1,3
,2011,80100435,,,,1,0,1
,2011,80100436,,,,1,5,6
HND-007665,2011,80100444,,,,9,8,17
HND-007666,2011,80100445,,,,19,23,42
HND-007667,2011,80100447,,,,33,29,62
,2011,80100448,,,,15,8,23
HND-007668,2011,80100449,,,,19,19,38
HND-007669,2011,80100450,,,,25,22,47
,2011,80100453,,,,5,5,10
HND-007671,2011,80100454,,,,10,17,27
HND-007673,2011,80100456,,,,4,6,10
HND-007674,2011,80100457,,,,27,30,57
HND-007675,2011,80100458,,,,9,12,21
HND-007676,2011,80100459,,,,14,8,22
HND-007677,2011,80100460,,,,70,64,134
HND-007680,2011,80100464,,,,21,12,33
,2011,80100465,,,,3,3,6
HND-007681,2011,80100467,,,,30,28,58
,2011,80100468,,,,3,4,7
HND-007682,2011,80100469,,,,21,22,43
HND-007687,2011,80100478,,,,8,7,15
HND-007688,2011,80100479,,,,14,20,34
,2011,80100480,,,,11,17,28
HND-007689,2011,80100482,,,,17,9,26
,2011,80100487,,,,6,11,17
HND-007694,2011,80100490,,,,6,6,12
HND-007696,2011,80100492,,,,1,1,2
,2011,80100493,,,,7,4,11
,2011,80100494,,,,2,3,5
HND-007697,2011,80100496,,,,51,46,97
HND-007698,2011,80100497,,,,28,25,53
,2011,80100500,,,,19,36,55
,2011,80100508,,,,18,26,44
HND-007704,2011,80100510,,,,56,54,110
,2011,80100514,,,,9,4,13
HND-007707,2011,80100516,,,,6,11,17
HND-007713,2011,80100525,,,,28,36,64
HND-007714,2011,80100528,,,,73,73,146
HND-007716,2011,80100530,,,,13,9,22
HND-007721,2011,80100538,,,,37,37,74
HND-007724,2011,80100545,,,,16,12,28
,2011,80100551,,,,0,2,2
HND-007726,2011,80100553,,,,15,19,34
,2011,80100560,,,,0,5,5
,2011,80100566,,,,21,20,41
,2011,80100571,,,,2,5,7
HND-007731,2011,80100573,,,,17,25,42
HND-007733,2011,80100575,,,,8,7,15
HND-007734,2011,80100577,,,,17,15,32
HND-007736,2011,80100580,,,,11,7,18
,2011,80100586,,,,3,2,5
HND-007739,2011,80100589,,,,7,10,17
,2011,80100591,,,,5,4,9
HND-007740,2011,80100592,,,,3,7,10
HND-007741,2011,80100593,,,,11,11,22
,2011,80100599,,,,4,3,7
HND-007749,2011,80100609,,,,6,7,13
,2011,80100611,,,,2,1,3
HND-007750,2011,80100613,,,,12,12,24
,2011,80100635,,,,34,50,84
,2011,80100658,,,,1,2,3
,2011,80100660,,,,9,14,23
,2011,80100663,,,,7,5,12
,2011,80100696,,,,11,20,31
HND-007789,2011,80100717,,,,4,2,6
,2011,80100722,,,,5,0,5
HND-007793,2011,80100724,,,,7,14,21
HND-007795,2011,80100726,,,,3,4,7
,2011,80100732,,,,4,4,8
,2011,80100733,,,,4,7,11
,2011,80100736,,,,2,1,3
,2011,80100742,,,,3,4,7
,2011,80100743,,,,3,7,10
,2011,80100744,,,,9,2,11
,2011,80100749,,,,1,4,5
,2011,80100751,,,,9,2,11
,2011,80100752,,,,11,12,23
,2011,80100757,,,,5,2,7
HND-007805,2011,80100765,,,,3,4,7
HND-007807,2011,80100770,,,,10,10,20
HND-007813,2011,80100779,,,,10,15,25
,2011,80100780,,,,2,4,6
HND-007814,2011,80100781,,,,17,18,35
HND-007815,2011,80100782,,,,36,29,65
,2011,80100791,,,,3,5,8
,2011,80100792,,,,2,1,3
,2011,80100794,,,,5,7,12
HND-007818,2011,80100795,,,,3,4,7
,2011,80100802,,,,10,11,21
,2011,80100808,,,,12,8,20
,2011,80100815,,,,18,0,18
HND-007824,2011,80100816,,,,1,1,2
,2011,80100819,,,,15,16,31
HND-007826,2011,80100823,,,,2,2,4
,2011,80100828,,,,14,11,25
,2011,80100831,,,,2,2,4
HND-007831,2011,80100833,,,,3,4,7
,2011,80100838,,,,4,4,8
HND-007834,2011,80100839,,,,8,9,17
HND-007834,2011,80100839,,,,16,21,37
HND-007837,2011,80100843,,,,7,10,17
,2011,80100846,,,,8,7,15
HND-007839,2011,80100848,,,,8,16,24
HND-007840,2011,80100851,,,,13,3,16
,2011,80100853,,,,3,5,8
HND-007843,2011,80100855,,,,4,4,8
HND-007849,2011,80100866,,,,13,9,22
HND-007852,2011,80100870,,,,6,4,10
HND-007854,2011,80100881,,,,5,3,8
,2011,80100884,,,,14,11,25
,2011,80100889,,,,9,0,9
,2011,80100920,,,,5,4,9
,2011,80100925,,,,3,3,6
HND-007872,2011,80100929,,,,18,25,43
HND-007873,2011,80100932,,,,4,0,4
,2011,80100935,,,,7,3,10
,2011,80100939,,,,76,102,178
,2011,80100963,,,,16,32,48
,2011,80100966,,,,12,9,21
,2011,80100970,,,,5,3,8
,2011,80100971,,,,2,3,5
,2011,80100985,,,,1,2,3
,2011,80100990,,,,32,39,71
,2011,80101006,,,,3,3,6
,2011,80101007,,,,2,14,16
,2011,80101016,,,,11,25,36
,2011,80101017,,,,131,41,172
HND-007889,2011,80101018,,,,3,3,6
,2011,80101028,,,,3,0,3
HND-007894,2011,80101035,,,,8,7,15
,2011,80101063,,,,4,3,7
,2011,80101071,,,,21,17,38
,2011,80101129,,,,15,14,29
,2011,80101139,,,,4,2,6
,2011,80101157,,,,3,3,6
,2011,80101161,,,,5,6,11
,2011,80101186,,,,1,1,2
,2011,80101187,,,,3,2,5
HND-007919,2011,80101188,,,,3,6,9
HND-007921,2011,80101193,,,,4,4,8
,2011,80101205,,,,3,8,11
,2011,80101206,,,,11,3,14
,2011,80101207,,,,2,1,3
,2011,80101210,,,,2,2,4
,2011,80101212,,,,1,0,1
,2011,80101219,,,,3,3,6
,2011,80101258,,,,2,1,3
,2011,80101260,,,,2,4,6
,2011,80101264,,,,4,2,6
HND-007924,2011,80101275,,,,13,21,34
HND-007925,2011,80101282,,,,2,2,4
,2011,80101300,,,,3,2,5
,2011,80101307,,,,0,2,2
,2011,80101310,,,,1,1,2
,2011,80101317,,,,2,3,5
,2011,80101318,,,,5,2,7
,2011,80101321,,,,14,11,25
,2011,80101323,,,,7,3,10
,2011,80101326,,,,8,4,12
,2011,80101328,,,,4,5,9
,2011,80101335,,,,12,8,20
,2011,80101336,,,,11,3,14
,2011,80101345,,,,4,3,7
,2011,80101361,,,,6,3,9
,2011,80101365,,,,3,1,4
,2011,80101370,,,,3,0,3
,2011,80101476,,,,0,1,1
,2011,80101483,,,,12,10,22
,2011,80101488,,,,0,2,2
,2011,80101495,,,,7,13,20
,2011,80101496,,,,8,7,15
,2011,80101499,,,,2,1,3
,2011,80101500,,,,2,6,8
,2011,80101504,,,,3,0,3
,2011,80101542,,,,7,3,10
,2011,80101543,,,,15,11,26
,2011,80101547,,,,1,1,2
,2011,80101550,,,,2,6,8
,2011,80101552,,,,6,2,8
,2011,80101553,,,,24,28,52
,2011,80101554,,,,1,4,5
,2011,80101564,,,,1,1,2
,2011,80101571,,,,1,3,4
,2011,80101581,,,,16,5,21
,2011,80101585,,,,4,1,5
,2011,80101592,,,,1,1,2
,2011,80101599,,,,9,8,17
,2011,80101605,,,,3,2,5
,2011,80101617,,,,4,7,11
,2011,80101620,,,,5,6,11
,2011,80101622,,,,5,1,6
,2011,80101627,,,,3,2,5
HND-007964,2011,80101630,,,,12,5,17
HND-007981,2011,80101670,,,,12,8,20
,2011,80101676,,,,18,21,39
,2011,80101677,,,,1,4,5
,2011,80101687,,,,7,7,14
,2011,80101696,,,,10,14,24
HND-007396,2011,80100011,,,,4,1,5
HND-007411,2011,80100026,,,,0,2,2
HND-007417,2011,80100033,,,,10,7,17
,2011,80100036,,,,2,1,3
HND-007424,2011,80100042,,,,5,7,12
HND-007433,2011,80100055,,,,8,3,11
,2011,80100069,,,,16,21,37
HND-007444,2011,80100070,,,,6,5,11
HND-007453,2011,80100079,,,,31,38,69
HND-007455,2011,80100081,,,,4,10,14
HND-007456,2011,80100082,,,,4,5,9
HND-007505,2011,80100140,,,,0,3,3
,2011,80100143,,,,9,12,21
,2011,80100154,,,,1,2,3
,2011,80100164,,,,5,5,10
HND-007525,2011,80100168,,,,11,10,21
,2011,80100173,,,,4,1,5
HND-007538,2011,80100183,,,,0,13,13
HND-007540,2011,80100185,,,,7,10,17
,2011,80100202,,,,7,4,11
,2011,80100208,,,,46,34,80
,2011,80100216,,,,3,1,4
,2011,80100217,,,,5,4,9
,2011,80100224,,,,10,10,20
,2011,80100230,,,,20,24,44
,2011,80100239,,,,4,4,8
HND-007572,2011,80100241,,,,35,42,77
HND-007577,2011,80100248,,,,36,29,65
,2011,80100250,,,,33,33,66
,2011,80100253,,,,6,6,12
HND-007585,2011,80100259,,,,5,6,11
,2011,80100265,,,,8,8,16
,2011,80100282,,,,4,6,10
,2011,80100283,,,,2,1,3
,2011,80100291,,,,2,6,8
HND-007601,2011,80100296,,,,8,5,13
,2011,80100297,,,,0,5,5
,2011,80100306,,,,4,8,12
HND-007608,2011,80100318,,,,2,4,6
,2011,80100326,,,,1,1,2
,2011,80100336,,,,2,3,5
HND-007615,2011,80100341,,,,17,25,42
,2011,80100343,,,,2,4,6
,2011,80100344,,,,10,9,19
HND-007617,2011,80100348,,,,5,5,10
,2011,80100349,,,,9,5,14
,2011,80100350,,,,4,2,6
,2011,80100355,,,,9,7,16
HND-007633,2011,80100376,,,,9,10,19
,2011,80100380,,,,3,4,7
,2011,80100397,,,,10,11,21
HND-007641,2011,80100398,,,,8,8,16
HND-007642,2011,80100399,,,,5,12,17
HND-007644,2011,80100401,,,,10,2,12
,2011,80100403,,,,3,2,5
HND-007651,2011,80100417,,,,5,2,7
,2011,80100427,,,,2,0,2
,2011,80100438,,,,1,7,8
HND-007662,2011,80100441,,,,19,18,37
HND-007663,2011,80100442,,,,15,17,32
HND-007664,2011,80100443,,,,21,14,35
,2011,80100451,,,,16,15,31
HND-007670,2011,80100452,,,,10,10,20
HND-007678,2011,80100462,,,,3,6,9
HND-007679,2011,80100463,,,,25,27,52
,2011,80100470,,,,10,10,20
HND-007684,2011,80100471,,,,9,3,12
HND-007685,2011,80100472,,,,35,35,70
,2011,80100473,,,,40,38,78
,2011,80100474,,,,23,17,40
,2011,80100477,,,,0,2,2
HND-007691,2011,80100486,,,,11,10,21
HND-007693,2011,80100489,,,,10,8,18
,2011,80100495,,,,3,18,21
HND-007699,2011,80100498,,,,21,21,42
HND-007699,2011,80100498,,,,9,7,16
,2011,80100499,,,,10,7,17
HND-007700,2011,80100502,,,,11,12,23
HND-007701,2011,80100503,,,,35,28,63
HND-007703,2011,80100507,,,,18,25,43
HND-007705,2011,80100513,,,,10,9,19
HND-007706,2011,80100515,,,,2,2,4
HND-007708,2011,80100517,,,,12,16,28
HND-007709,2011,80100519,,,,23,19,42
HND-007711,2011,80100522,,,,3,5,8
,2011,80100523,,,,6,4,10
HND-007715,2011,80100529,,,,6,12,18
HND-007717,2011,80100531,,,,31,23,54
HND-007720,2011,80100535,,,,5,1,6
,2011,80100539,,,,4,5,9
,2011,80100541,,,,3,2,5
,2011,80100542,,,,4,3,7
HND-007723,2011,80100544,,,,26,25,51
,2011,80100546,,,,9,0,9
HND-007725,2011,80100552,,,,13,12,25
,2011,80100554,,,,14,17,31
,2011,80100557,,,,0,4,4
,2011,80100565,,,,6,4,10
HND-007730,2011,80100569,,,,10,9,19
HND-007732,2011,80100574,,,,31,26,57
,2011,80100581,,,,5,3,8
,2011,80100582,,,,3,4,7
,2011,80100583,,,,1,0,1
HND-007738,2011,80100588,,,,6,6,12
,2011,80100590,,,,12,13,25
,2011,80100595,,,,0,7,7
,2011,80100606,,,,18,8,26
HND-007747,2011,80100607,,,,8,5,13
HND-007748,2011,80100608,,,,9,7,16
,2011,80100615,,,,3,3,6
,2011,80100622,,,,10,9,19
,2011,80100637,,,,8,13,21
,2011,80100675,,,,39,31,70
,2011,80100692,,,,0,3,3
,2011,80100710,,,,5,7,12
HND-007788,2011,80100716,,,,0,1,1
,2011,80100720,,,,1,2,3
HND-007794,2011,80100725,,,,15,15,30
,2011,80100729,,,,22,23,45
,2011,80100738,,,,3,3,6
,2011,80100750,,,,10,5,15
,2011,80100754,,,,11,13,24
,2011,80100755,,,,9,7,16
,2011,80100758,,,,7,13,20
,2011,80100759,,,,4,13,17
HND-007804,2011,80100762,,,,3,2,5
,2011,80100767,,,,5,5,10
HND-007806,2011,80100769,,,,13,12,25
,2011,80100786,,,,1,0,1
,2011,80100788,,,,42,30,72
HND-007821,2011,80100801,,,,14,0,14
,2011,80100807,,,,2,5,7
,2011,80100811,,,,6,5,11
,2011,80100817,,,,9,12,21
,2011,80100818,,,,13,9,22
HND-007829,2011,80100827,,,,4,4,8
,2011,80100830,,,,2,0,2
,2011,80100836,,,,4,5,9
HND-007835,2011,80100840,,,,10,9,19
HND-007845,2011,80100857,,,,27,16,43
HND-007851,2011,80100868,,,,17,15,32
,2011,80100871,,,,9,5,14
,2011,80100877,,,,2,0,2
,2011,80100883,,,,6,6,12
,2011,80100886,,,,0,8,8
HND-007858,2011,80100893,,,,11,14,25
HND-007864,2011,80100904,,,,17,13,30
,2011,80100917,,,,7,5,12
HND-007870,2011,80100924,,,,15,10,25
HND-007871,2011,80100928,,,,6,2,8
,2011,80100933,,,,6,1,7
,2011,80100934,,,,3,2,5
,2011,80100944,,,,1,5,6
,2011,80100948,,,,15,19,34
HND-007877,2011,80100949,,,,2,1,3
,2011,80100953,,,,4,5,9
,2011,80100954,,,,1,1,2
,2011,80100969,,,,9,4,13
,2011,80100980,,,,2,0,2
,2011,80100997,,,,2,1,3
,2011,80101010,,,,2,1,3
,2011,80101013,,,,14,7,21
,2011,80101014,,,,10,15,25
HND-007892,2011,80101023,,,,2,2,4
,2011,80101030,,,,5,6,11
,2011,80101033,,,,2,5,7
,2011,80101039,,,,10,14,24
HND-007897,2011,80101041,,,,5,4,9
,2011,80101044,,,,4,1,5
,2011,80101049,,,,4,6,10
HND-007899,2011,80101086,,,,5,7,12
,2011,80101088,,,,6,5,11
,2011,80101134,,,,57,44,101
HND-007910,2011,80101148,,,,14,11,25
HND-007911,2011,80101153,,,,0,2,2
,2011,80101158,,,,1,1,2
,2011,80101164,,,,2,7,9
,2011,80101184,,,,2,1,3
,2011,80101195,,,,0,1,1
,2011,80101197,,,,3,4,7
,2011,80101200,,,,13,11,24
,2011,80101203,,,,5,3,8
,2011,80101204,,,,23,22,45
,2011,80101209,,,,0,1,1
,2011,80101222,,,,1,3,4
,2011,80101259,,,,10,11,21
,2011,80101268,,,,4,3,7
HND-007923,2011,80101274,,,,11,6,17
,2011,80101293,,,,2,2,4
,2011,80101297,,,,10,7,17
,2011,80101308,,,,15,14,29
,2011,80101309,,,,3,4,7
,2011,80101312,,,,5,6,11
,2011,80101320,,,,10,11,21
,2011,80101333,,,,9,3,12
,2011,80101334,,,,5,22,27
,2011,80101344,,,,5,7,12
,2011,80101348,,,,0,35,35
,2011,80101436,,,,2,1,3
HND-007930,2011,80101445,,,,15,10,25
,2011,80101464,,,,3,7,10
,2011,80101480,,,,7,6,13
,2011,80101481,,,,1,2,3
,2011,80101491,,,,6,6,12
,2011,80101492,,,,2,2,4
,2011,80101493,,,,9,9,18
,2011,80101501,,,,1,0,1
HND-007939,2011,80101518,,,,11,7,18
,2011,80101527,,,,11,10,21
,2011,80101541,,,,2,5,7
,2011,80101545,,,,1,4,5
,2011,80101546,,,,0,2,2
,2011,80101548,,,,4,4,8
,2011,80101549,,,,1,1,2
,2011,80101551,,,,1,2,3
,2011,80101555,,,,3,1,4
,2011,80101556,,,,2,1,3
HND-007950,2011,80101580,,,,2,2,4
,2011,80101582,,,,3,2,5
HND-007951,2011,80101584,,,,3,4,7
,2011,80101586,,,,5,2,7
,2011,80101588,,,,2,0,2
,2011,80101590,,,,6,3,9
,2011,80101593,,,,2,0,2
,2011,80101607,,,,6,4,10
,2011,80101615,,,,3,0,3
HND-007966,2011,80101633,,,,1,1,2
HND-007973,2011,80101649,,,,7,2,9
,2011,80101650,,,,1,7,8
,2011,80101652,,,,4,2,6
,2011,80101653,,,,6,3,9
,2011,80101659,,,,5,7,12
,2011,80101665,,,,2,3,5
,2011,80101666,,,,1,0,1
,2011,80101674,,,,16,11,27
,2011,80101681,,,,2,4,6
,2011,80101682,,,,10,5,15
,2011,80101683,,,,8,6,14
,2011,80101684,,,,0,2,2
,2011,80101690,,,,4,4,8
,2011,80101692,,,,5,12,17
,2011,80101700,,,,1,2,3
,2011,80101703,,,,3,4,7
,2011,80101707,,,,4,3,7
HND-007411,2011,80100026,,,,11,9,20
HND-007417,2011,80100033,,,,13,14,27
,2011,80100036,,,,10,12,22
HND-007422,2011,80100040,,,,7,10,17
HND-007424,2011,80100042,,,,9,7,16
HND-007433,2011,80100055,,,,8,11,19
HND-007441,2011,80100063,,,,18,2,20
,2011,80100069,,,,23,27,50
HND-007444,2011,80100070,,,,6,2,8
HND-007449,2011,80100075,,,,5,2,7
HND-007453,2011,80100079,,,,13,15,28
HND-007455,2011,80100081,,,,24,15,39
HND-007456,2011,80100082,,,,28,33,61
HND-007494,2011,80100127,,,,18,21,39
HND-007505,2011,80100140,,,,11,9,20
,2011,80100143,,,,17,12,29
HND-007512,2011,80100149,,,,29,33,62
,2011,80100154,,,,3,6,9
,2011,80100164,,,,8,11,19
HND-007525,2011,80100168,,,,22,21,43
HND-007527,2011,80100170,,,,17,35,52
HND-007538,2011,80100183,,,,0,29,29
HND-007540,2011,80100185,,,,13,14,27
,2011,80100202,,,,8,5,13
,2011,80100204,,,,8,14,22
,2011,80100205,,,,4,4,8
,2011,80100207,,,,16,17,33
,2011,80100211,,,,7,21,28
,2011,80100213,,,,8,9,17
,2011,80100219,,,,3,7,10
HND-007559,2011,80100221,,,,6,6,12
,2011,80100225,,,,47,46,93
,2011,80100239,,,,10,2,12
HND-007572,2011,80100241,,,,80,78,158
,2011,80100244,,,,41,30,71
HND-007577,2011,80100248,,,,78,73,151
,2011,80100250,,,,41,40,81
,2011,80100253,,,,7,5,12
,2011,80100257,,,,7,9,16
HND-007585,2011,80100259,,,,3,7,10
,2011,80100265,,,,9,13,22
HND-007589,2011,80100266,,,,18,20,38
,2011,80100282,,,,2,4,6
,2011,80100283,,,,6,1,7
,2011,80100288,,,,2,2,4
,2011,80100291,,,,7,3,10
HND-007599,2011,80100294,,,,25,23,48
,2011,80100300,,,,2,2,4
,2011,80100301,,,,3,7,10
,2011,80100308,,,,6,4,10
,2011,80100312,,,,4,3,7
HND-007608,2011,80100318,,,,9,5,14
,2011,80100319,,,,4,8,12
,2011,80100320,,,,1,1,2
HND-007609,2011,80100322,,,,43,37,80
,2011,80100324,,,,2,3,5
,2011,80100329,,,,13,3,16
,2011,80100332,,,,7,4,11
,2011,80100335,,,,15,13,28
,2011,80100336,,,,7,10,17
,2011,80100343,,,,4,8,12
,2011,80100344,,,,11,7,18
HND-007617,2011,80100348,,,,6,9,15
,2011,80100349,,,,7,5,12
,2011,80100355,,,,27,24,51
,2011,80100361,,,,11,11,22
HND-007629,2011,80100368,,,,34,38,72
,2011,80100375,,,,19,21,40
HND-007633,2011,80100376,,,,13,23,36
HND-007636,2011,80100385,,,,25,29,54
,2011,80100397,,,,11,10,21
HND-007641,2011,80100398,,,,25,25,50
HND-007643,2011,80100400,,,,32,37,69
,2011,80100406,,,,30,29,59
,2011,80100407,,,,17,15,32
,2011,80100407,,,,71,85,156
HND-007645,2011,80100408,,,,26,15,41
,2011,80100410,,,,6,4,10
HND-007646,2011,80100411,,,,45,48,93
,2011,80100420,,,,8,8,16
,2011,80100427,,,,6,6,12
,2011,80100428,,,,36,25,61
HND-007659,2011,80100429,,,,53,25,78
,2011,80100435,,,,7,5,12
,2011,80100438,,,,19,18,37
HND-007662,2011,80100441,,,,29,36,65
HND-007663,2011,80100442,,,,6,12,18
HND-007664,2011,80100443,,,,22,20,42
HND-007675,2011,80100458,,,,7,13,20
HND-007677,2011,80100460,,,,105,91,196
HND-007680,2011,80100464,,,,42,37,79
HND-007681,2011,80100467,,,,49,41,90
HND-007682,2011,80100469,,,,35,24,59
,2011,80100470,,,,17,13,30
HND-007684,2011,80100471,,,,4,8,12
HND-007685,2011,80100472,,,,56,51,107
,2011,80100473,,,,36,30,66
,2011,80100474,,,,68,66,134
HND-007691,2011,80100486,,,,19,20,39
,2011,80100487,,,,33,20,53
HND-007693,2011,80100489,,,,10,14,24
HND-007696,2011,80100492,,,,16,12,28
,2011,80100494,,,,4,6,10
,2011,80100495,,,,7,12,19
HND-007697,2011,80100496,,,,61,49,110
HND-007699,2011,80100498,,,,21,28,49
,2011,80100499,,,,7,9,16
HND-007700,2011,80100502,,,,12,15,27
HND-007701,2011,80100503,,,,46,48,94
HND-007705,2011,80100513,,,,16,13,29
HND-007706,2011,80100515,,,,18,14,32
HND-007709,2011,80100519,,,,41,42,83
,2011,80100523,,,,19,11,30
HND-007713,2011,80100525,,,,54,42,96
,2011,80100526,,,,19,14,33
HND-007715,2011,80100529,,,,5,13,18
HND-007717,2011,80100531,,,,39,25,64
HND-007721,2011,80100538,,,,65,75,140
,2011,80100539,,,,2,5,7
,2011,80100541,,,,5,2,7
,2011,80100542,,,,9,3,12
,2011,80100546,,,,9,10,19
HND-007725,2011,80100552,,,,28,34,62
HND-007726,2011,80100553,,,,16,15,31
,2011,80100554,,,,34,28,62
,2011,80100557,,,,3,0,3
HND-007727,2011,80100561,,,,31,35,66
,2011,80100565,,,,7,8,15
HND-007730,2011,80100569,,,,27,24,51
,2011,80100570,,,,15,13,28
HND-007732,2011,80100574,,,,31,39,70
HND-007735,2011,80100578,,,,19,23,42
,2011,80100581,,,,1,7,8
,2011,80100582,,,,5,6,11
,2011,80100583,,,,3,1,4
HND-007738,2011,80100588,,,,18,15,33
HND-007739,2011,80100589,,,,7,4,11
,2011,80100590,,,,17,15,32
HND-007743,2011,80100598,,,,12,10,22
HND-007744,2011,80100602,,,,28,40,68
,2011,80100606,,,,15,20,35
HND-007747,2011,80100607,,,,18,27,45
HND-007748,2011,80100608,,,,10,13,23
,2011,80100611,,,,5,16,21
,2011,80100637,,,,12,17,29
,2011,80100675,,,,47,41,88
,2011,80100710,,,,10,9,19
HND-007788,2011,80100716,,,,20,14,34
,2011,80100720,,,,14,24,38
HND-007794,2011,80100725,,,,20,25,45
,2011,80100729,,,,12,13,25
,2011,80100736,,,,5,4,9
,2011,80100742,,,,6,4,10
,2011,80100744,,,,10,8,18
,2011,80100749,,,,3,1,4
,2011,80100750,,,,15,9,24
,2011,80100751,,,,11,10,21
,2011,80100752,,,,15,25,40
,2011,80100754,,,,11,15,26
,2011,80100757,,,,8,8,16
,2011,80100758,,,,15,20,35
,2011,80100759,,,,6,14,20
HND-007804,2011,80100762,,,,17,13,30
,2011,80100767,,,,13,7,20
HND-007807,2011,80100770,,,,19,17,36
,2011,80100772,,,,32,28,60
HND-007813,2011,80100779,,,,20,20,40
HND-007814,2011,80100781,,,,17,11,28
HND-007815,2011,80100782,,,,21,17,38
,2011,80100791,,,,5,5,10
,2011,80100792,,,,2,3,5
,2011,80100794,,,,17,17,34
HND-007818,2011,80100795,,,,36,31,67
HND-007821,2011,80100801,,,,14,2,16
,2011,80100802,,,,11,10,21
,2011,80100811,,,,4,3,7
,2011,80100817,,,,11,10,21
,2011,80100818,,,,9,10,19
HND-007829,2011,80100827,,,,18,24,42
,2011,80100830,,,,2,8,10
HND-007833,2011,80100837,,,,20,22,42
HND-007834,2011,80100839,,,,31,30,61
HND-007835,2011,80100840,,,,7,24,31
HND-007836,2011,80100842,,,,26,17,43
HND-007841,2011,80100852,,,,15,9,24
,2011,80100853,,,,9,7,16
HND-007842,2011,80100854,,,,32,25,57
HND-007851,2011,80100868,,,,36,51,87
,2011,80100871,,,,14,14,28
,2011,80100877,,,,11,4,15
HND-007854,2011,80100881,,,,4,3,7
,2011,80100883,,,,12,12,24
,2011,80100886,,,,9,6,15
HND-007861,2011,80100896,,,,20,20,40
,2011,80100920,,,,16,9,25
HND-007870,2011,80100924,,,,20,20,40
,2011,80100933,,,,3,4,7
,2011,80100944,,,,7,7,14
,2011,80100948,,,,16,13,29
HND-007877,2011,80100949,,,,15,6,21
,2011,80100953,,,,22,14,36
,2011,80100954,,,,1,1,2
,2011,80100965,,,,12,13,25
,2011,80100969,,,,12,19,31
,2011,80100980,,,,5,1,6
,2011,80101005,,,,2,3,5
,2011,80101006,,,,4,2,6
,2011,80101010,,,,1,2,3
,2011,80101013,,,,12,10,22
,2011,80101014,,,,20,14,34
,2011,80101028,,,,3,8,11
HND-007894,2011,80101035,,,,9,6,15
,2011,80101063,,,,7,5,12
,2011,80101071,,,,28,20,48
HND-007899,2011,80101086,,,,2,7,9
HND-007904,2011,80101114,,,,26,15,41
,2011,80101129,,,,11,12,23
,2011,80101134,,,,53,72,125
,2011,80101139,,,,10,5,15
HND-007910,2011,80101148,,,,18,12,30
HND-007911,2011,80101153,,,,17,20,37
,2011,80101157,,,,5,11,16
,2011,80101158,,,,4,7,11
,2011,80101184,,,,3,2,5
HND-007921,2011,80101193,,,,5,5,10
,2011,80101197,,,,2,6,8
,2011,80101200,,,,21,19,40
,2011,80101203,,,,6,3,9
,2011,80101209,,,,1,2,3
,2011,80101215,,,,1,0,1
,2011,80101222,,,,2,3,5
,2011,80101258,,,,0,3,3
,2011,80101259,,,,27,31,58
,2011,80101264,,,,6,2,8
HND-007923,2011,80101274,,,,13,14,27
,2011,80101293,,,,10,8,18
,2011,80101300,,,,0,4,4
,2011,80101308,,,,12,11,23
,2011,80101309,,,,7,7,14
,2011,80101312,,,,11,9,20
,2011,80101326,,,,10,9,19
,2011,80101333,,,,8,7,15
,2011,80101348,,,,0,36,36
,2011,80101365,,,,5,5,10
,2011,80101436,,,,2,2,4
,2011,80101464,,,,13,13,26
,2011,80101480,,,,7,15,22
,2011,80101481,,,,13,5,18
,2011,80101483,,,,18,18,36
,2011,80101491,,,,6,6,12
,2011,80101492,,,,1,1,2
,2011,80101493,,,,12,19,31
HND-007939,2011,80101518,,,,14,17,31
,2011,80101527,,,,10,10,20
,2011,80101541,,,,9,9,18
,2011,80101545,,,,5,5,10
,2011,80101546,,,,1,1,2
,2011,80101548,,,,5,4,9
,2011,80101549,,,,0,4,4
,2011,80101554,,,,3,4,7
,2011,80101555,,,,2,6,8
,2011,80101556,,,,7,1,8
HND-007950,2011,80101580,,,,5,6,11
,2011,80101582,,,,6,4,10
HND-007951,2011,80101584,,,,5,5,10
,2011,80101586,,,,2,1,3
,2011,80101588,,,,3,3,6
,2011,80101590,,,,4,6,10
,2011,80101592,,,,7,4,11
,2011,80101593,,,,3,2,5
,2011,80101615,,,,2,1,3
,2011,80101627,,,,1,3,4
HND-007966,2011,80101633,,,,12,7,19
,2011,80101650,,,,5,8,13
,2011,80101652,,,,8,7,15
,2011,80101653,,,,10,3,13
,2011,80101666,,,,1,1,2
HND-007982,2011,80101671,,,,7,9,16
,2011,80101674,,,,14,12,26
,2011,80101676,,,,29,22,51
,2011,80101677,,,,6,9,15
,2011,80101681,,,,4,2,6
,2011,80101682,,,,1,5,6
,2011,80101683,,,,8,10,18
,2011,80101687,,,,2,3,5
,2011,80101690,,,,17,24,41
,2011,80101692,,,,11,16,27
,2011,80101696,,,,13,7,20
,2011,80101703,,,,1,0,1
,2011,80101707,,,,7,5,12
,2011,80100009,,,,41,46,87
HND-007396,2011,80100011,,,,10,15,25
HND-007404,2011,80100019,,,,6,6,12
HND-007403,2011,80100019,,,,6,6,12
HND-007409,2011,80100024,,,,12,2,14
HND-007419,2011,80100035,,,,43,37,80
,2011,80100045,,,,16,19,35
HND-007445,2011,80100071,,,,20,24,44
HND-007464,2011,80100090,,,,17,23,40
HND-007465,2011,80100091,,,,5,7,12
,2011,80100099,,,,19,22,41
HND-007483,2011,80100116,,,,10,9,19
HND-007484,2011,80100117,,,,26,20,46
HND-007496,2011,80100129,,,,11,11,22
HND-007508,2011,80100144,,,,37,23,60
HND-007515,2011,80100152,,,,16,26,42
,2011,80100156,,,,18,27,45
HND-007516,2011,80100157,,,,13,12,25
,2011,80100173,,,,4,6,10
HND-007543,2011,80100187,,,,29,21,50
HND-007542,2011,80100187,,,,29,21,50
HND-007546,2011,80100190,,,,56,43,99
HND-007548,2011,80100192,,,,29,32,61
,2011,80100201,,,,4,0,4
,2011,80100208,,,,55,39,94
,2011,80100216,,,,1,1,2
,2011,80100217,,,,11,14,25
,2011,80100224,,,,10,7,17
,2011,80100237,,,,40,36,76
HND-007574,2011,80100243,,,,7,8,15
HND-007587,2011,80100262,,,,86,81,167
,2011,80100270,,,,3,10,13
,2011,80100271,,,,1,1,2
,2011,80100273,,,,1,2,3
,2011,80100278,,,,14,14,28
,2011,80100284,,,,19,20,39
HND-007601,2011,80100296,,,,7,10,17
,2011,80100297,,,,5,7,12
HND-007602,2011,80100298,,,,32,32,64
,2011,80100303,,,,12,15,27
,2011,80100306,,,,11,15,26
,2011,80100310,,,,3,1,4
,2011,80100326,,,,1,2,3
,2011,80100330,,,,4,3,7
,2011,80100337,,,,10,10,20
,2011,80100345,,,,5,6,11
,2011,80100346,,,,17,25,42
,2011,80100350,,,,8,4,12
HND-007621,2011,80100353,,,,17,13,30
,2011,80100362,,,,4,2,6
,2011,80100371,,,,11,4,15
,2011,80100378,,,,4,4,8
,2011,80100380,,,,7,6,13
HND-007635,2011,80100382,,,,17,18,35
,2011,80100383,,,,13,10,23
,2011,80100384,,,,2,4,6
,2011,80100388,,,,11,20,31
HND-007638,2011,80100391,,,,21,24,45
,2011,80100395,,,,13,9,22
,2011,80100396,,,,11,7,18
HND-007642,2011,80100399,,,,19,18,37
HND-007644,2011,80100401,,,,38,38,76
,2011,80100403,,,,8,14,22
,2011,80100405,,,,4,4,8
HND-007651,2011,80100417,,,,9,5,14
,2011,80100432,,,,1,0,1
,2011,80100436,,,,8,8,16
HND-007665,2011,80100444,,,,20,11,31
HND-007666,2011,80100445,,,,22,26,48
HND-007667,2011,80100447,,,,44,32,76
,2011,80100448,,,,18,14,32
HND-007668,2011,80100449,,,,32,28,60
HND-007669,2011,80100450,,,,38,36,74
,2011,80100451,,,,21,14,35
HND-007670,2011,80100452,,,,48,57,105
,2011,80100453,,,,10,3,13
HND-007671,2011,80100454,,,,24,20,44
HND-007672,2011,80100455,,,,29,21,50
HND-007673,2011,80100456,,,,7,2,9
HND-007674,2011,80100457,,,,87,74,161
HND-007676,2011,80100459,,,,32,31,63
HND-007678,2011,80100462,,,,18,13,31
HND-007679,2011,80100463,,,,23,12,35
,2011,80100465,,,,2,10,12
,2011,80100468,,,,3,6,9
,2011,80100477,,,,3,2,5
HND-007687,2011,80100478,,,,36,25,61
HND-007688,2011,80100479,,,,5,6,11
,2011,80100480,,,,51,43,94
HND-007689,2011,80100482,,,,19,17,36
HND-007690,2011,80100484,,,,23,18,41
HND-007694,2011,80100490,,,,9,10,19
,2011,80100493,,,,12,13,25
HND-007698,2011,80100497,,,,28,31,59
HND-007699,2011,80100498,,,,22,15,37
,2011,80100500,,,,30,32,62
HND-007702,2011,80100506,,,,19,18,37
HND-007703,2011,80100507,,,,21,31,52
,2011,80100508,,,,21,19,40
HND-007704,2011,80100510,,,,65,78,143
,2011,80100511,,,,9,13,22
,2011,80100514,,,,12,11,23
HND-007707,2011,80100516,,,,10,16,26
HND-007708,2011,80100517,,,,39,45,84
HND-007711,2011,80100522,,,,10,3,13
HND-007714,2011,80100528,,,,95,73,168
HND-007716,2011,80100530,,,,14,12,26
HND-007718,2011,80100533,,,,30,36,66
HND-007719,2011,80100534,,,,46,49,95
HND-007720,2011,80100535,,,,9,8,17
HND-007723,2011,80100544,,,,26,25,51
HND-007724,2011,80100545,,,,36,30,66
,2011,80100551,,,,1,1,2
,2011,80100555,,,,26,43,69
,2011,80100560,,,,5,5,10
,2011,80100566,,,,52,35,87
,2011,80100571,,,,6,2,8
HND-007731,2011,80100573,,,,36,29,65
HND-007733,2011,80100575,,,,8,7,15
HND-007734,2011,80100577,,,,30,32,62
HND-007736,2011,80100580,,,,11,7,18
,2011,80100586,,,,10,10,20
,2011,80100591,,,,16,12,28
HND-007740,2011,80100592,,,,40,14,54
HND-007741,2011,80100593,,,,18,23,41
,2011,80100595,,,,3,1,4
,2011,80100599,,,,3,6,9
HND-007746,2011,80100605,,,,25,42,67
HND-007749,2011,80100609,,,,8,11,19
HND-007750,2011,80100613,,,,16,7,23
,2011,80100615,,,,2,5,7
,2011,80100622,,,,12,17,29
,2011,80100635,,,,34,50,84
,2011,80100658,,,,2,2,4
,2011,80100660,,,,12,10,22
,2011,80100663,,,,15,13,28
,2011,80100692,,,,25,13,38
,2011,80100696,,,,29,22,51
HND-007789,2011,80100717,,,,16,7,23
,2011,80100722,,,,3,1,4
HND-007793,2011,80100724,,,,19,17,36
HND-007795,2011,80100726,,,,15,10,25
HND-007796,2011,80100728,,,,8,2,10
,2011,80100732,,,,10,7,17
,2011,80100733,,,,8,9,17
,2011,80100738,,,,7,7,14
,2011,80100743,,,,9,12,21
,2011,80100755,,,,8,12,20
HND-007805,2011,80100765,,,,14,11,25
,2011,80100780,,,,11,10,21
HND-007816,2011,80100785,,,,23,25,48
,2011,80100786,,,,13,6,19
HND-007817,2011,80100789,,,,9,13,22
HND-007820,2011,80100800,,,,34,32,66
,2011,80100807,,,,8,5,13
,2011,80100808,,,,15,22,37
,2011,80100815,,,,14,0,14
HND-007824,2011,80100816,,,,12,14,26
,2011,80100819,,,,20,17,37
HND-007826,2011,80100823,,,,10,4,14
,2011,80100828,,,,14,16,30
,2011,80100829,,,,12,8,20
,2011,80100831,,,,5,5,10
HND-007831,2011,80100833,,,,3,4,7
,2011,80100836,,,,9,8,17
,2011,80100838,,,,3,8,11
HND-007834,2011,80100839,,,,9,15,24
HND-007837,2011,80100843,,,,22,23,45
HND-007838,2011,80100844,,,,9,22,31
,2011,80100846,,,,6,4,10
HND-007839,2011,80100848,,,,36,30,66
HND-007840,2011,80100851,,,,20,15,35
HND-007843,2011,80100855,,,,6,7,13
HND-007845,2011,80100857,,,,21,25,46
,2011,80100861,,,,6,12,18
HND-007849,2011,80100866,,,,13,13,26
HND-007852,2011,80100870,,,,8,7,15
,2011,80100884,,,,17,13,30
,2011,80100889,,,,18,2,20
HND-007858,2011,80100893,,,,26,22,48
HND-007864,2011,80100904,,,,15,15,30
,2011,80100917,,,,10,7,17
,2011,80100925,,,,0,2,2
HND-007871,2011,80100928,,,,7,3,10
HND-007872,2011,80100929,,,,18,21,39
HND-007873,2011,80100932,,,,1,1,2
,2011,80100934,,,,0,3,3
,2011,80100935,,,,8,12,20
,2011,80100939,,,,167,194,361
,2011,80100963,,,,6,14,20
,2011,80100966,,,,13,20,33
,2011,80100970,,,,13,9,22
,2011,80100971,,,,3,3,6
,2011,80100985,,,,4,3,7
,2011,80100990,,,,36,45,81
,2011,80100997,,,,1,0,1
,2011,80101007,,,,9,5,14
,2011,80101016,,,,4,9,13
,2011,80101017,,,,185,91,276
HND-007889,2011,80101018,,,,3,2,5
HND-007892,2011,80101023,,,,17,14,31
,2011,80101030,,,,20,18,38
,2011,80101033,,,,11,15,26
,2011,80101039,,,,16,16,32
HND-007897,2011,80101041,,,,5,8,13
,2011,80101044,,,,22,33,55
,2011,80101049,,,,7,8,15
,2011,80101088,,,,4,5,9
,2011,80101125,,,,4,7,11
HND-007912,2011,80101159,,,,11,11,22
,2011,80101161,,,,7,6,13
,2011,80101164,,,,5,8,13
,2011,80101186,,,,1,1,2
,2011,80101187,,,,7,2,9
HND-007919,2011,80101188,,,,38,35,73
HND-007920,2011,80101192,,,,40,30,70
,2011,80101195,,,,4,4,8
,2011,80101204,,,,31,32,63
,2011,80101205,,,,19,10,29
,2011,80101206,,,,6,7,13
,2011,80101207,,,,1,1,2
,2011,80101210,,,,2,3,5
,2011,80101212,,,,0,2,2
,2011,80101213,,,,1,3,4
,2011,80101219,,,,3,3,6
,2011,80101260,,,,3,1,4
,2011,80101268,,,,5,8,13
HND-007924,2011,80101275,,,,34,27,61
HND-007925,2011,80101282,,,,8,8,16
,2011,80101297,,,,10,4,14
,2011,80101307,,,,3,4,7
,2011,80101310,,,,0,4,4
,2011,80101315,,,,4,3,7
,2011,80101317,,,,6,2,8
,2011,80101320,,,,12,11,23
,2011,80101321,,,,17,13,30
,2011,80101323,,,,13,5,18
,2011,80101328,,,,28,24,52
,2011,80101334,,,,10,13,23
,2011,80101335,,,,9,12,21
,2011,80101336,,,,8,17,25
,2011,80101344,,,,2,7,9
,2011,80101345,,,,3,2,5
,2011,80101361,,,,5,2,7
,2011,80101370,,,,7,5,12
HND-007930,2011,80101445,,,,45,35,80
,2011,80101476,,,,1,4,5
,2011,80101488,,,,2,2,4
,2011,80101495,,,,11,19,30
,2011,80101496,,,,6,10,16
,2011,80101499,,,,4,10,14
,2011,80101500,,,,14,5,19
,2011,80101504,,,,3,3,6
,2011,80101542,,,,7,3,10
,2011,80101543,,,,20,8,28
,2011,80101544,,,,4,6,10
,2011,80101547,,,,6,4,10
,2011,80101550,,,,6,2,8
,2011,80101551,,,,1,2,3
,2011,80101552,,,,16,8,24
,2011,80101553,,,,30,30,60
,2011,80101564,,,,2,0,2
HND-007946,2011,80101570,,,,27,23,50
,2011,80101571,,,,1,2,3
,2011,80101581,,,,15,17,32
,2011,80101585,,,,3,6,9
,2011,80101599,,,,4,4,8
,2011,80101605,,,,6,7,13
,2011,80101607,,,,9,5,14
,2011,80101617,,,,4,8,12
,2011,80101620,,,,2,4,6
,2011,80101622,,,,5,6,11
HND-007964,2011,80101630,,,,15,20,35
,2011,80101634,,,,6,5,11
HND-007973,2011,80101649,,,,6,5,11
,2011,80101659,,,,9,1,10
,2011,80101665,,,,1,3,4
HND-007981,2011,80101670,,,,19,21,40
,2011,80101675,,,,16,16,32
,2011,80101684,,,,6,2,8
,2011,80101700,,,,2,1,3
,2011,80101701,,,,7,6,13
HND-007389,2011,80100002,,,,16,12,28
HND-007390,2011,80100003,,,,13,5,18
HND-007395,2011,80100008,,,,84,63,147
,2011,80100009,,,,40,44,84
HND-007397,2011,80100012,,,,4,1,5
HND-007398,2011,80100014,,,,5,4,9
HND-007399,2011,80100015,,,,93,74,167
HND-007401,2011,80100017,,,,63,46,109
HND-007402,2011,80100018,,,,59,61,120
HND-007404,2011,80100019,,,,13,8,21
HND-007403,2011,80100019,,,,13,8,21
HND-007409,2011,80100024,,,,8,7,15
HND-007410,2011,80100025,,,,27,30,57
HND-007411,2011,80100026,,,,11,7,18
HND-007412,2011,80100027,,,,6,3,9
HND-007416,2011,80100032,,,,1,0,1
HND-007418,2011,80100034,,,,3,1,4
HND-007419,2011,80100035,,,,90,86,176
HND-007420,2011,80100038,,,,49,27,76
HND-007422,2011,80100040,,,,39,29,68
HND-007423,2011,80100041,,,,10,15,25
HND-007425,2011,80100043,,,,17,22,39
HND-007427,2011,80100048,,,,5,1,6
HND-007428,2011,80100049,,,,63,50,113
HND-007432,2011,80100054,,,,49,42,91
HND-007433,2011,80100055,,,,20,20,40
HND-007434,2011,80100056,,,,32,33,65
HND-007436,2011,80100058,,,,2,1,3
HND-007440,2011,80100062,,,,2,6,8
HND-007443,2011,80100066,,,,6,4,10
,2011,80100067,,,,2,3,5
HND-007445,2011,80100071,,,,64,57,121
HND-007446,2011,80100072,,,,20,15,35
HND-007449,2011,80100075,,,,2,4,6
HND-007450,2011,80100076,,,,12,8,20
HND-007451,2011,80100077,,,,13,11,24
HND-007452,2011,80100078,,,,8,5,13
HND-007453,2011,80100079,,,,92,72,164
HND-007456,2011,80100082,,,,34,49,83
,2011,80100083,,,,2,3,5
HND-007462,2011,80100088,,,,7,5,12
HND-007463,2011,80100089,,,,3,6,9
HND-007466,2011,80100092,,,,9,9,18
HND-007467,2011,80100093,,,,5,5,10
HND-007472,2011,80100098,,,,10,4,14
,2011,80100099,,,,30,23,53
HND-007475,2011,80100104,,,,5,1,6
HND-007476,2011,80100105,,,,5,7,12
HND-007477,2011,80100106,,,,7,6,13
,2011,80100113,,,,76,53,129
HND-007483,2011,80100116,,,,9,10,19
HND-007484,2011,80100117,,,,36,38,74
HND-007485,2011,80100118,,,,5,9,14
HND-007488,2011,80100121,,,,18,6,24
HND-007491,2011,80100124,,,,19,20,39
HND-007494,2011,80100127,,,,16,31,47
HND-007496,2011,80100129,,,,9,11,20
HND-007499,2011,80100132,,,,9,9,18
HND-007503,2011,80100137,,,,12,13,25
HND-007504,2011,80100138,,,,15,5,20
,2011,80100139,,,,3,3,6
HND-007509,2011,80100146,,,,49,57,106
HND-007510,2011,80100147,,,,27,28,55
HND-007511,2011,80100148,,,,107,0,107
HND-007515,2011,80100152,,,,59,41,100
HND-007517,2011,80100158,,,,13,18,31
HND-007520,2011,80100162,,,,13,7,20
HND-007521,2011,80100163,,,,3,6,9
,2011,80100164,,,,8,9,17
HND-007524,2011,80100167,,,,49,38,87
HND-007526,2011,80100169,,,,40,21,61
HND-007527,2011,80100170,,,,55,34,89
HND-007528,2011,80100172,,,,0,156,156
HND-007529,2011,80100174,,,,42,50,92
HND-007533,2011,80100178,,,,16,17,33
HND-007534,2011,80100179,,,,1,2,3
HND-007536,2011,80100181,,,,53,28,81
HND-007539,2011,80100184,,,,60,50,110
HND-007540,2011,80100185,,,,116,108,224
HND-007541,2011,80100186,,,,24,30,54
HND-007543,2011,80100187,,,,36,40,76
HND-007542,2011,80100187,,,,36,40,76
HND-007546,2011,80100190,,,,92,79,171
HND-007548,2011,80100192,,,,64,93,157
,2011,80100193,,,,69,68,137
HND-007552,2011,80100198,,,,44,42,86
HND-007553,2011,80100199,,,,63,73,136
,2011,80100205,,,,10,7,17
,2011,80100207,,,,26,22,48
,2011,80100208,,,,41,60,101
,2011,80100213,,,,16,9,25
HND-007556,2011,80100214,,,,6,3,9
,2011,80100219,,,,8,9,17
HND-007558,2011,80100220,,,,54,59,113
HND-007559,2011,80100221,,,,12,21,33
HND-007560,2011,80100222,,,,68,76,144
HND-007563,2011,80100227,,,,4,6,10
HND-007564,2011,80100228,,,,27,28,55
HND-007566,2011,80100231,,,,15,23,38
HND-007567,2011,80100232,,,,12,8,20
HND-007570,2011,80100235,,,,41,49,90
HND-007571,2011,80100236,,,,96,68,164
,2011,80100237,,,,50,31,81
,2011,80100244,,,,41,41,82
,2011,80100245,,,,56,58,114
HND-007575,2011,80100246,,,,14,11,25
HND-007576,2011,80100247,,,,19,14,33
HND-007579,2011,80100251,,,,8,10,18
HND-007583,2011,80100256,,,,35,59,94
HND-007584,2011,80100258,,,,25,27,52
HND-007586,2011,80100260,,,,62,47,109
HND-007587,2011,80100262,,,,72,108,180
HND-007591,2011,80100268,,,,51,35,86
,2011,80100270,,,,11,7,18
,2011,80100271,,,,1,1,2
,2011,80100273,,,,3,5,8
,2011,80100279,,,,49,47,96
HND-007594,2011,80100286,,,,7,3,10
,2011,80100288,,,,7,1,8
HND-007596,2011,80100290,,,,29,35,64
HND-007597,2011,80100292,,,,20,29,49
HND-007598,2011,80100293,,,,57,33,90
HND-007602,2011,80100298,,,,49,57,106
HND-007603,2011,80100299,,,,54,48,102
,2011,80100301,,,,8,5,13
HND-007604,2011,80100302,,,,8,6,14
,2011,80100303,,,,27,25,52
,2011,80100304,,,,2,2,4
,2011,80100308,,,,5,7,12
HND-007607,2011,80100316,,,,4,4,8
,2011,80100317,,,,50,51,101
HND-007609,2011,80100322,,,,19,27,46
,2011,80100324,,,,5,7,12
HND-007610,2011,80100325,,,,90,69,159
,2011,80100326,,,,7,2,9
,2011,80100329,,,,2,9,11
,2011,80100330,,,,3,1,4
HND-007612,2011,80100333,,,,41,37,78
HND-007613,2011,80100334,,,,19,24,43
HND-007614,2011,80100340,,,,18,16,34
HND-007615,2011,80100341,,,,40,32,72
HND-007619,2011,80100351,,,,10,10,20
HND-007620,2011,80100352,,,,58,37,95
HND-007621,2011,80100353,,,,29,32,61
HND-007622,2011,80100354,,,,3,6,9
,2011,80100355,,,,33,23,56
,2011,80100356,,,,14,9,23
HND-007624,2011,80100359,,,,15,20,35
,2011,80100361,,,,6,7,13
,2011,80100362,,,,11,5,16
HND-007625,2011,80100363,,,,15,8,23
HND-007626,2011,80100364,,,,35,23,58
HND-007627,2011,80100366,,,,51,41,92
HND-007630,2011,80100369,,,,39,30,69
,2011,80100374,,,,7,12,19
,2011,80100375,,,,12,18,30
HND-007634,2011,80100377,,,,3,2,5
,2011,80100378,,,,5,1,6
,2011,80100383,,,,11,10,21
,2011,80100384,,,,6,1,7
HND-007636,2011,80100385,,,,60,45,105
HND-007639,2011,80100392,,,,3,0,3
HND-007640,2011,80100393,,,,6,2,8
,2011,80100395,,,,10,11,21
,2011,80100396,,,,13,10,23
,2011,80100404,,,,4,3,7
,2011,80100405,,,,7,4,11
,2011,80100406,,,,35,28,63
,2011,80100407,,,,184,162,346
HND-007645,2011,80100408,,,,18,17,35
,2011,80100409,,,,22,39,61
,2011,80100410,,,,4,11,15
,2011,80100418,,,,24,24,48
,2011,80100420,,,,14,13,27
HND-007654,2011,80100422,,,,31,32,63
HND-007655,2011,80100423,,,,14,10,24
,2011,80100428,,,,34,29,63
,2011,80100430,,,,8,11,19
,2011,80100435,,,,9,7,16
,2011,80100436,,,,15,5,20
,2011,80100438,,,,26,23,49
,2011,80100446,,,,4,6,10
HND-007676,2011,80100459,,,,26,20,46
,2011,80100494,,,,1,4,5
,2011,80100508,,,,19,14,33
HND-007722,2011,80100543,,,,23,24,47
,2011,80100560,,,,14,5,19
,2011,80100565,,,,13,18,31
HND-007729,2011,80100568,,,,21,17,38
,2011,80100581,,,,6,5,11
,2011,80100582,,,,15,14,29
,2011,80100583,,,,1,1,2
HND-007745,2011,80100603,,,,65,51,116
,2011,80100658,,,,5,2,7
,2011,80100663,,,,10,21,31
,2011,80100675,,,,51,40,91
,2011,80100722,,,,5,8,13
HND-007798,2011,80100734,,,,36,69,105
,2011,80100736,,,,0,5,5
,2011,80100738,,,,11,3,14
,2011,80100749,,,,2,5,7
,2011,80100757,,,,4,9,13
HND-007803,2011,80100760,,,,8,6,14
HND-007820,2011,80100800,,,,29,16,45
,2011,80100802,,,,8,9,17
HND-007823,2011,80100804,,,,6,10,16
,2011,80100846,,,,6,7,13
,2011,80100882,,,,19,20,39
HND-007856,2011,80100890,,,,35,21,56
HND-007861,2011,80100896,,,,26,25,51
HND-007865,2011,80100905,,,,30,35,65
HND-007868,2011,80100911,,,,23,20,43
,2011,80100915,,,,13,22,35
HND-007872,2011,80100929,,,,15,19,34
,2011,80100935,,,,19,22,41
,2011,80100944,,,,16,13,29
,2011,80100954,,,,4,1,5
,2011,80100966,,,,13,11,24
,2011,80100968,,,,2,4,6
,2011,80100970,,,,8,14,22
,2011,80100971,,,,0,4,4
,2011,80101004,,,,2,1,3
,2011,80101006,,,,7,7,14
,2011,80101007,,,,31,28,59
HND-007888,2011,80101009,,,,21,15,36
,2011,80101025,,,,5,5,10
,2011,80101028,,,,6,6,12
HND-007894,2011,80101035,,,,23,17,40
,2011,80101071,,,,20,21,41
,2011,80101087,,,,2,1,3
HND-007901,2011,80101103,,,,26,39,65
HND-007903,2011,80101111,,,,30,24,54
HND-007905,2011,80101117,,,,4,1,5
HND-007908,2011,80101123,,,,10,5,15
,2011,80101139,,,,5,8,13
,2011,80101145,,,,10,13,23
,2011,80101157,,,,11,13,24
,2011,80101161,,,,13,7,20
,2011,80101186,,,,6,6,12
,2011,80101205,,,,13,10,23
,2011,80101206,,,,12,5,17
,2011,80101207,,,,4,0,4
,2011,80101210,,,,0,4,4
,2011,80101212,,,,2,1,3
,2011,80101213,,,,1,1,2
,2011,80101260,,,,6,5,11
,2011,80101262,,,,3,3,6
,2011,80101263,,,,3,4,7
,2011,80101264,,,,8,6,14
,2011,80101293,,,,13,8,21
,2011,80101300,,,,7,7,14
,2011,80101307,,,,4,9,13
,2011,80101308,,,,23,17,40
,2011,80101310,,,,4,2,6
,2011,80101317,,,,4,2,6
,2011,80101318,,,,5,1,6
,2011,80101357,,,,1,4,5
,2011,80101365,,,,7,8,15
,2011,80101370,,,,8,8,16
HND-007931,2011,80101448,,,,27,25,52
,2011,80101476,,,,1,3,4
,2011,80101483,,,,18,25,43
,2011,80101495,,,,14,13,27
,2011,80101499,,,,4,8,12
,2011,80101500,,,,9,12,21
,2011,80101542,,,,5,7,12
,2011,80101547,,,,4,4,8
,2011,80101548,,,,3,2,5
,2011,80101550,,,,3,2,5
,2011,80101552,,,,1,2,3
,2011,80101554,,,,1,2,3
HND-007944,2011,80101560,,,,38,27,65
HND-007947,2011,80101572,,,,10,8,18
,2011,80101592,,,,8,6,14
,2011,80101617,,,,16,8,24
,2011,80101622,,,,1,4,5
,2011,80101634,,,,15,12,27
,2011,80101652,,,,4,2,6
,2011,80101674,,,,8,3,11
,2011,80101675,,,,0,28,28
,2011,80101676,,,,35,29,64
,2011,80101683,,,,4,6,10
,2011,80101686,,,,3,2,5
,2011,80101692,,,,15,19,34
,2011,80101705,,,,3,0,3
HND-007984,2011,80101709,,,,7,9,16
HND-007388,2011,80100001,,,,24,12,36
HND-007391,2011,80100004,,,,3,2,5
HND-007392,2011,80100005,,,,31,28,59
HND-007393,2011,80100006,,,,48,41,89
HND-007394,2011,80100007,,,,8,2,10
HND-007396,2011,80100011,,,,24,20,44
HND-007400,2011,80100016,,,,20,25,45
HND-007405,2011,80100020,,,,9,13,22
HND-007406,2011,80100021,,,,3,2,5
HND-007407,2011,80100022,,,,34,26,60
HND-007408,2011,80100023,,,,9,8,17
HND-007413,2011,80100029,,,,8,9,17
HND-007414,2011,80100030,,,,30,45,75
HND-007415,2011,80100031,,,,8,7,15
HND-007417,2011,80100033,,,,16,5,21
HND-007421,2011,80100039,,,,53,56,109
HND-007426,2011,80100044,,,,40,28,68
,2011,80100045,,,,18,19,37
HND-007429,2011,80100050,,,,29,43,72
HND-007430,2011,80100051,,,,41,43,84
HND-007431,2011,80100052,,,,34,37,71
,2011,80100053,,,,39,42,81
HND-007435,2011,80100057,,,,5,8,13
,2011,80100059,,,,56,41,97
HND-007438,2011,80100060,,,,25,24,49
HND-007439,2011,80100061,,,,62,48,110
HND-007442,2011,80100064,,,,39,39,78
,2011,80100069,,,,41,48,89
HND-007444,2011,80100070,,,,5,9,14
HND-007447,2011,80100073,,,,11,8,19
HND-007448,2011,80100074,,,,16,22,38
HND-007454,2011,80100080,,,,44,46,90
HND-007455,2011,80100081,,,,39,53,92
HND-007458,2011,80100084,,,,10,20,30
HND-007459,2011,80100085,,,,5,5,10
HND-007460,2011,80100086,,,,2,4,6
HND-007464,2011,80100090,,,,19,24,43
HND-007465,2011,80100091,,,,53,47,100
HND-007468,2011,80100094,,,,12,12,24
HND-007469,2011,80100095,,,,2,0,2
HND-007470,2011,80100096,,,,20,26,46
HND-007471,2011,80100097,,,,34,13,47
HND-007473,2011,80100102,,,,12,10,22
HND-007474,2011,80100103,,,,17,10,27
HND-007478,2011,80100108,,,,17,18,35
HND-007479,2011,80100109,,,,39,43,82
HND-007480,2011,80100110,,,,29,33,62
HND-007481,2011,80100111,,,,19,23,42
HND-007482,2011,80100112,,,,30,27,57
,2011,80100115,,,,38,43,81
HND-007486,2011,80100119,,,,14,13,27
HND-007487,2011,80100120,,,,1,0,1
HND-007489,2011,80100122,,,,14,10,24
HND-007490,2011,80100123,,,,3,3,6
HND-007492,2011,80100125,,,,4,1,5
,2011,80100126,,,,2,1,3
HND-007495,2011,80100128,,,,15,12,27
HND-007497,2011,80100130,,,,24,26,50
HND-007498,2011,80100131,,,,26,13,39
HND-007500,2011,80100133,,,,101,58,159
HND-007501,2011,80100134,,,,16,18,34
HND-007502,2011,80100135,,,,9,8,17
HND-007505,2011,80100140,,,,23,4,27
HND-007506,2011,80100141,,,,6,6,12
HND-007507,2011,80100142,,,,5,8,13
,2011,80100143,,,,36,31,67
HND-007508,2011,80100144,,,,56,64,120
HND-007512,2011,80100149,,,,62,65,127
HND-007513,2011,80100150,,,,19,12,31
HND-007514,2011,80100151,,,,12,3,15
,2011,80100154,,,,12,10,22
,2011,80100156,,,,22,29,51
HND-007516,2011,80100157,,,,46,38,84
HND-007518,2011,80100159,,,,6,4,10
HND-007519,2011,80100161,,,,13,19,32
HND-007522,2011,80100165,,,,8,6,14
HND-007523,2011,80100166,,,,12,5,17
HND-007525,2011,80100168,,,,35,51,86
,2011,80100173,,,,18,10,28
HND-007530,2011,80100175,,,,17,17,34
HND-007531,2011,80100176,,,,3,5,8
HND-007532,2011,80100177,,,,5,2,7
HND-007535,2011,80100180,,,,9,5,14
HND-007537,2011,80100182,,,,8,4,12
HND-007538,2011,80100183,,,,0,29,29
HND-007544,2011,80100188,,,,41,37,78
HND-007545,2011,80100189,,,,89,84,173
HND-007547,2011,80100191,,,,55,61,116
HND-007549,2011,80100194,,,,28,36,64
HND-007550,2011,80100195,,,,73,0,73
HND-007551,2011,80100196,,,,0,56,56
,2011,80100197,,,,28,18,46
HND-007554,2011,80100200,,,,6,14,20
,2011,80100201,,,,7,3,10
,2011,80100202,,,,9,11,20
,2011,80100203,,,,18,23,41
,2011,80100204,,,,6,6,12
HND-007555,2011,80100210,,,,20,17,37
,2011,80100211,,,,0,30,30
,2011,80100215,,,,7,4,11
,2011,80100216,,,,3,5,8
,2011,80100217,,,,23,15,38
HND-007557,2011,80100218,,,,5,1,6
HND-007561,2011,80100223,,,,9,10,19
,2011,80100224,,,,28,32,60
,2011,80100225,,,,56,49,105
HND-007562,2011,80100226,,,,38,41,79
HND-007565,2011,80100229,,,,2,3,5
HND-007568,2011,80100233,,,,9,10,19
HND-007569,2011,80100234,,,,25,20,45
,2011,80100239,,,,12,15,27
HND-007572,2011,80100241,,,,98,99,197
HND-007573,2011,80100242,,,,25,26,51
HND-007574,2011,80100243,,,,36,24,60
HND-007578,2011,80100249,,,,29,24,53
,2011,80100250,,,,37,30,67
HND-007580,2011,80100252,,,,21,27,48
,2011,80100253,,,,8,7,15
HND-007581,2011,80100254,,,,9,10,19
HND-007582,2011,80100255,,,,8,0,8
HND-007585,2011,80100259,,,,34,32,66
HND-007588,2011,80100263,,,,4,1,5
,2011,80100264,,,,69,55,124
,2011,80100265,,,,16,20,36
HND-007589,2011,80100266,,,,28,26,54
HND-007590,2011,80100267,,,,26,20,46
HND-007592,2011,80100275,,,,33,45,78
HND-007593,2011,80100276,,,,11,7,18
,2011,80100278,,,,11,12,23
,2011,80100282,,,,9,5,14
,2011,80100283,,,,3,0,3
,2011,80100284,,,,31,23,54
HND-007595,2011,80100287,,,,9,8,17
,2011,80100291,,,,7,4,11
HND-007599,2011,80100294,,,,45,31,76
HND-007600,2011,80100295,,,,31,26,57
HND-007601,2011,80100296,,,,22,22,44
,2011,80100300,,,,3,2,5
,2011,80100305,,,,9,2,11
,2011,80100306,,,,24,23,47
HND-007605,2011,80100307,,,,42,44,86
,2011,80100310,,,,4,3,7
,2011,80100312,,,,8,2,10
HND-007606,2011,80100315,,,,41,35,76
HND-007608,2011,80100318,,,,4,3,7
,2011,80100319,,,,13,11,24
,2011,80100320,,,,0,2,2
HND-007611,2011,80100328,,,,21,13,34
,2011,80100332,,,,10,13,23
,2011,80100335,,,,26,37,63
,2011,80100336,,,,11,9,20
,2011,80100337,,,,8,8,16
HND-007616,2011,80100342,,,,44,46,90
,2011,80100344,,,,11,15,26
,2011,80100345,,,,6,8,14
,2011,80100346,,,,32,26,58
,2011,80100350,,,,13,9,22
HND-007623,2011,80100357,,,,63,65,128
HND-007628,2011,80100367,,,,19,23,42
HND-007629,2011,80100368,,,,25,25,50
HND-007631,2011,80100370,,,,10,9,19
,2011,80100371,,,,22,10,32
HND-007632,2011,80100373,,,,24,26,50
HND-007633,2011,80100376,,,,8,9,17
,2011,80100380,,,,10,4,14
HND-007637,2011,80100387,,,,40,35,75
,2011,80100388,,,,12,15,27
HND-007638,2011,80100391,,,,91,81,172
HND-007641,2011,80100398,,,,17,12,29
HND-007642,2011,80100399,,,,28,25,53
HND-007643,2011,80100400,,,,48,44,92
HND-007644,2011,80100401,,,,35,40,75
,2011,80100403,,,,14,22,36
HND-007646,2011,80100411,,,,44,41,85
HND-007647,2011,80100413,,,,6,9,15
HND-007648,2011,80100414,,,,4,1,5
HND-007649,2011,80100415,,,,7,5,12
HND-007650,2011,80100416,,,,1,3,4
HND-007651,2011,80100417,,,,6,8,14
HND-007653,2011,80100421,,,,6,6,12
HND-007656,2011,80100424,,,,49,64,113
HND-007657,2011,80100425,,,,39,34,73
,2011,80100426,,,,21,20,41
,2011,80100427,,,,8,6,14
HND-007659,2011,80100429,,,,18,6,24
,2011,80100432,,,,5,3,8
HND-007660,2011,80100433,,,,48,50,98
HND-007661,2011,80100434,,,,10,7,17
,2011,80100453,,,,2,4,6
,2011,80100465,,,,4,8,12
,2011,80100499,,,,8,9,17
HND-007700,2011,80100502,,,,40,31,71
HND-007710,2011,80100521,,,,72,68,140
,2011,80100541,,,,9,17,26
,2011,80100547,,,,4,2,6
,2011,80100557,,,,1,1,2
,2011,80100586,,,,18,15,33
,2011,80100595,,,,9,2,11
HND-007743,2011,80100598,,,,10,17,27
,2011,80100599,,,,6,16,22
,2011,80100615,,,,4,7,11
HND-007752,2011,80100619,,,,23,16,39
,2011,80100622,,,,30,15,45
,2011,80100635,,,,46,46,92
,2011,80100660,,,,24,20,44
HND-007768,2011,80100677,,,,38,27,65
HND-007797,2011,80100730,,,,1,0,1
,2011,80100742,,,,6,8,14
HND-007802,2011,80100753,,,,22,22,44
HND-007804,2011,80100762,,,,21,34,55
,2011,80100767,,,,7,5,12
,2011,80100791,,,,5,5,10
,2011,80100792,,,,2,4,6
,2011,80100811,,,,3,4,7
HND-007824,2011,80100816,,,,16,18,34
HND-007825,2011,80100822,,,,29,30,59
HND-007826,2011,80100823,,,,102,91,193
HND-007827,2011,80100825,,,,15,5,20
HND-007828,2011,80100826,,,,17,14,31
,2011,80100829,,,,18,14,32
,2011,80100831,,,,5,2,7
HND-007846,2011,80100860,,,,2,1,3
HND-007847,2011,80100864,,,,20,19,39
HND-007848,2011,80100865,,,,72,63,135
HND-007849,2011,80100866,,,,27,20,47
HND-007850,2011,80100867,,,,26,29,55
HND-007851,2011,80100868,,,,45,41,86
,2011,80100877,,,,8,3,11
HND-007855,2011,80100885,,,,20,20,40
,2011,80100892,,,,7,15,22
HND-007858,2011,80100893,,,,14,14,28
HND-007862,2011,80100897,,,,15,16,31
HND-007867,2011,80100910,,,,27,35,62
HND-007873,2011,80100932,,,,4,3,7
,2011,80100933,,,,11,7,18
,2011,80100934,,,,7,2,9
,2011,80100948,,,,19,28,47
,2011,80100969,,,,7,7,14
,2011,80100980,,,,1,3,4
,2011,80100985,,,,4,3,7
,2011,80100990,,,,41,45,86
,2011,80100997,,,,1,1,2
HND-007885,2011,80100999,,,,3,3,6
HND-007886,2011,80101002,,,,4,1,5
HND-007887,2011,80101008,,,,4,2,6
,2011,80101010,,,,5,2,7
,2011,80101014,,,,21,23,44
HND-007890,2011,80101020,,,,5,0,5
,2011,80101021,,,,12,5,17
HND-007891,2011,80101022,,,,29,30,59
HND-007892,2011,80101023,,,,20,9,29
,2011,80101030,,,,14,16,30
HND-007893,2011,80101032,,,,4,2,6
,2011,80101033,,,,18,12,30
,2011,80101039,,,,11,12,23
,2011,80101083,,,,1,1,2
HND-007900,2011,80101100,,,,42,40,82
HND-007902,2011,80101106,,,,33,27,60
,2011,80101125,,,,8,4,12
,2011,80101130,,,,14,13,27
,2011,80101134,,,,83,75,158
HND-007911,2011,80101153,,,,38,23,61
,2011,80101158,,,,11,4,15
,2011,80101164,,,,13,11,24
,2011,80101184,,,,3,11,14
,2011,80101187,,,,2,3,5
,2011,80101195,,,,4,2,6
,2011,80101197,,,,3,2,5
,2011,80101200,,,,17,16,33
,2011,80101203,,,,3,5,8
,2011,80101204,,,,19,20,39
,2011,80101209,,,,2,2,4
,2011,80101215,,,,3,2,5
,2011,80101222,,,,8,8,16
,2011,80101259,,,,51,48,99
,2011,80101268,,,,7,8,15
HND-007923,2011,80101274,,,,13,15,28
HND-007924,2011,80101275,,,,11,6,17
HND-007925,2011,80101282,,,,12,14,26
,2011,80101297,,,,8,4,12
,2011,80101309,,,,6,4,10
,2011,80101312,,,,12,7,19
,2011,80101315,,,,3,2,5
,2011,80101361,,,,8,6,14
,2011,80101436,,,,3,0,3
,2011,80101464,,,,20,14,34
,2011,80101480,,,,17,18,35
,2011,80101481,,,,12,9,21
HND-007933,2011,80101486,,,,10,4,14
,2011,80101488,,,,3,3,6
,2011,80101491,,,,5,5,10
,2011,80101492,,,,7,1,8
,2011,80101493,,,,6,12,18
,2011,80101496,,,,12,19,31
,2011,80101501,,,,1,2,3
,2011,80101543,,,,14,12,26
,2011,80101545,,,,2,2,4
,2011,80101546,,,,2,2,4
,2011,80101549,,,,4,3,7
,2011,80101551,,,,6,4,10
,2011,80101553,,,,16,21,37
,2011,80101555,,,,11,4,15
,2011,80101556,,,,3,1,4
,2011,80101571,,,,11,4,15
,2011,80101586,,,,1,3,4
HND-007952,2011,80101587,,,,3,5,8
,2011,80101588,,,,1,3,4
,2011,80101593,,,,4,5,9
,2011,80101599,,,,3,2,5
,2011,80101605,,,,10,7,17
,2011,80101607,,,,14,12,26
,2011,80101615,,,,2,3,5
HND-007973,2011,80101649,,,,5,11,16
,2011,80101650,,,,15,11,26
,2011,80101651,,,,4,7,11
,2011,80101653,,,,6,6,12
,2011,80101659,,,,7,4,11
,2011,80101665,,,,5,6,11
,2011,80101672,,,,8,6,14
,2011,80101673,,,,76,0,76
,2011,80101681,,,,0,3,3
,2011,80101685,,,,8,6,14
,2011,80101690,,,,17,21,38
,2011,80101691,,,,15,17,32
,2011,80101700,,,,4,3,7
,2011,80101703,,,,1,1,2
,2011,80101707,,,,2,4,6
HND-007388,2011,80100001,,,,27,17,44
HND-007389,2011,80100002,,,,11,9,20
HND-007391,2011,80100004,,,,4,2,6
HND-007394,2011,80100007,,,,1,4,5
HND-007398,2011,80100014,,,,6,5,11
HND-007400,2011,80100016,,,,14,23,37
HND-007402,2011,80100018,,,,71,62,133
HND-007405,2011,80100020,,,,6,9,15
HND-007406,2011,80100021,,,,3,1,4
HND-007407,2011,80100022,,,,28,25,53
HND-007411,2011,80100026,,,,7,6,13
HND-007412,2011,80100027,,,,9,6,15
,2011,80100028,,,,3,0,3
HND-007414,2011,80100030,,,,53,54,107
HND-007415,2011,80100031,,,,13,7,20
HND-007417,2011,80100033,,,,10,14,24
HND-007420,2011,80100038,,,,44,42,86
HND-007421,2011,80100039,,,,51,40,91
HND-007422,2011,80100040,,,,36,22,58
HND-007425,2011,80100043,,,,21,22,43
HND-007426,2011,80100044,,,,45,22,67
HND-007427,2011,80100048,,,,5,7,12
HND-007428,2011,80100049,,,,44,47,91
HND-007430,2011,80100051,,,,50,50,100
HND-007433,2011,80100055,,,,14,14,28
HND-007434,2011,80100056,,,,26,28,54
HND-007435,2011,80100057,,,,9,3,12
HND-007438,2011,80100060,,,,22,19,41
HND-007439,2011,80100061,,,,67,45,112
,2011,80100067,,,,2,3,5
,2011,80100069,,,,25,28,53
HND-007444,2011,80100070,,,,6,9,15
HND-007446,2011,80100072,,,,22,23,45
HND-007447,2011,80100073,,,,14,16,30
HND-007448,2011,80100074,,,,18,10,28
HND-007449,2011,80100075,,,,4,6,10
HND-007450,2011,80100076,,,,8,11,19
HND-007452,2011,80100078,,,,5,7,12
HND-007453,2011,80100079,,,,60,74,134
HND-007455,2011,80100081,,,,48,49,97
,2011,80100083,,,,5,3,8
HND-007458,2011,80100084,,,,5,5,10
HND-007461,2011,80100087,,,,0,1,1
HND-007463,2011,80100089,,,,5,9,14
HND-007466,2011,80100092,,,,12,2,14
HND-007467,2011,80100093,,,,9,5,14
HND-007468,2011,80100094,,,,5,7,12
HND-007470,2011,80100096,,,,13,23,36
HND-007473,2011,80100102,,,,16,10,26
HND-007476,2011,80100105,,,,5,3,8
HND-007477,2011,80100106,,,,9,7,16
HND-007478,2011,80100108,,,,20,14,34
HND-007479,2011,80100109,,,,33,41,74
HND-007481,2011,80100111,,,,27,22,49
HND-007485,2011,80100118,,,,1,2,3
HND-007486,2011,80100119,,,,12,8,20
HND-007488,2011,80100121,,,,10,12,22
HND-007489,2011,80100122,,,,7,7,14
HND-007492,2011,80100125,,,,9,6,15
,2011,80100126,,,,3,2,5
HND-007494,2011,80100127,,,,14,19,33
HND-007495,2011,80100128,,,,10,10,20
HND-007498,2011,80100131,,,,16,17,33
HND-007501,2011,80100134,,,,21,9,30
HND-007502,2011,80100135,,,,9,8,17
HND-007503,2011,80100137,,,,13,17,30
HND-007505,2011,80100140,,,,14,10,24
HND-007506,2011,80100141,,,,5,1,6
,2011,80100143,,,,32,31,63
HND-007511,2011,80100148,,,,93,0,93
HND-007512,2011,80100149,,,,78,59,137
HND-007514,2011,80100151,,,,6,13,19
,2011,80100154,,,,4,5,9
HND-007516,2011,80100157,,,,38,37,75
HND-007517,2011,80100158,,,,13,13,26
HND-007518,2011,80100159,,,,12,7,19
HND-007521,2011,80100163,,,,3,0,3
,2011,80100164,,,,20,11,31
HND-007524,2011,80100167,,,,40,45,85
HND-007525,2011,80100168,,,,41,21,62
HND-007527,2011,80100170,,,,44,31,75
HND-007528,2011,80100172,,,,0,155,155
HND-007530,2011,80100175,,,,13,16,29
HND-007531,2011,80100176,,,,1,6,7
HND-007532,2011,80100177,,,,0,3,3
HND-007533,2011,80100178,,,,33,30,63
HND-007535,2011,80100180,,,,4,5,9
HND-007537,2011,80100182,,,,10,7,17
HND-007538,2011,80100183,,,,0,28,28
HND-007540,2011,80100185,,,,118,108,226
HND-007541,2011,80100186,,,,31,37,68
HND-007544,2011,80100188,,,,44,55,99
,2011,80100193,,,,72,74,146
HND-007549,2011,80100194,,,,38,41,79
HND-007553,2011,80100199,,,,58,51,109
,2011,80100202,,,,10,8,18
,2011,80100204,,,,16,10,26
,2011,80100205,,,,10,5,15
,2011,80100207,,,,28,27,55
HND-007555,2011,80100210,,,,20,16,36
,2011,80100211,,,,0,33,33
,2011,80100213,,,,7,8,15
,2011,80100219,,,,8,9,17
HND-007558,2011,80100220,,,,60,67,127
HND-007559,2011,80100221,,,,14,20,34
,2011,80100225,,,,48,50,98
HND-007562,2011,80100226,,,,41,35,76
HND-007563,2011,80100227,,,,7,11,18
HND-007566,2011,80100231,,,,16,20,36
,2011,80100239,,,,15,11,26
HND-007572,2011,80100241,,,,103,90,193
,2011,80100244,,,,53,46,99
,2011,80100245,,,,36,36,72
HND-007575,2011,80100246,,,,13,8,21
HND-007576,2011,80100247,,,,23,12,35
,2011,80100250,,,,46,37,83
HND-007579,2011,80100251,,,,13,6,19
HND-007580,2011,80100252,,,,28,19,47
,2011,80100253,,,,10,3,13
HND-007582,2011,80100255,,,,8,0,8
HND-007584,2011,80100258,,,,28,29,57
HND-007585,2011,80100259,,,,43,39,82
HND-007586,2011,80100260,,,,34,29,63
,2011,80100265,,,,15,16,31
HND-007589,2011,80100266,,,,19,23,42
HND-007591,2011,80100268,,,,46,46,92
HND-007592,2011,80100275,,,,28,25,53
HND-007593,2011,80100276,,,,14,8,22
,2011,80100282,,,,11,8,19
,2011,80100283,,,,4,1,5
HND-007594,2011,80100286,,,,7,5,12
,2011,80100288,,,,3,0,3
,2011,80100291,,,,13,6,19
HND-007597,2011,80100292,,,,15,17,32
HND-007599,2011,80100294,,,,40,26,66
,2011,80100300,,,,6,4,10
,2011,80100301,,,,10,8,18
HND-007604,2011,80100302,,,,7,9,16
,2011,80100304,,,,1,2,3
,2011,80100308,,,,2,9,11
,2011,80100312,,,,4,8,12
HND-007606,2011,80100315,,,,43,27,70
HND-007608,2011,80100318,,,,6,4,10
,2011,80100319,,,,10,9,19
,2011,80100320,,,,6,2,8
HND-007609,2011,80100322,,,,24,17,41
,2011,80100324,,,,4,5,9
HND-007611,2011,80100328,,,,17,21,38
,2011,80100329,,,,12,12,24
,2011,80100332,,,,10,7,17
,2011,80100335,,,,31,20,51
,2011,80100336,,,,15,10,25
HND-007615,2011,80100341,,,,27,18,45
HND-007616,2011,80100342,,,,62,45,107
,2011,80100344,,,,14,9,23
HND-007622,2011,80100354,,,,3,3,6
,2011,80100355,,,,25,14,39
,2011,80100356,,,,10,14,24
HND-007623,2011,80100357,,,,61,56,117
,2011,80100361,,,,7,10,17
HND-007625,2011,80100363,,,,8,6,14
HND-007626,2011,80100364,,,,34,27,61
HND-007629,2011,80100368,,,,20,12,32
HND-007630,2011,80100369,,,,29,26,55
,2011,80100375,,,,19,17,36
HND-007633,2011,80100376,,,,3,6,9
HND-007634,2011,80100377,,,,1,3,4
HND-007636,2011,80100385,,,,54,51,105
HND-007637,2011,80100387,,,,28,38,66
HND-007641,2011,80100398,,,,10,16,26
HND-007643,2011,80100400,,,,45,37,82
,2011,80100404,,,,2,3,5
,2011,80100406,,,,28,31,59
,2011,80100407,,,,223,200,423
HND-007645,2011,80100408,,,,26,18,44
,2011,80100410,,,,5,6,11
HND-007646,2011,80100411,,,,48,37,85
HND-007647,2011,80100413,,,,3,8,11
HND-007649,2011,80100415,,,,4,4,8
,2011,80100420,,,,8,11,19
HND-007653,2011,80100421,,,,4,6,10
HND-007657,2011,80100425,,,,39,34,73
,2011,80100427,,,,7,7,14
,2011,80100428,,,,39,34,73
HND-007659,2011,80100429,,,,13,6,19
HND-007660,2011,80100433,,,,46,48,94
,2011,80100435,,,,12,9,21
,2011,80100438,,,,23,20,43
,2011,80100494,,,,1,4,5
,2011,80100499,,,,9,5,14
HND-007700,2011,80100502,,,,32,34,66
HND-007710,2011,80100521,,,,61,54,115
,2011,80100541,,,,16,9,25
HND-007722,2011,80100543,,,,22,23,45
,2011,80100557,,,,2,2,4
,2011,80100565,,,,14,13,27
HND-007729,2011,80100568,,,,12,11,23
,2011,80100581,,,,5,14,19
,2011,80100582,,,,12,14,26
,2011,80100583,,,,1,2,3
HND-007743,2011,80100598,,,,22,24,46
,2011,80100675,,,,43,35,78
HND-007798,2011,80100734,,,,48,48,96
,2011,80100736,,,,3,2,5
,2011,80100742,,,,1,0,1
,2011,80100749,,,,1,1,2
HND-007802,2011,80100753,,,,24,19,43
,2011,80100757,,,,6,11,17
,2011,80100767,,,,7,13,20
,2011,80100791,,,,12,7,19
,2011,80100792,,,,3,2,5
HND-007820,2011,80100800,,,,30,22,52
,2011,80100802,,,,6,7,13
,2011,80100811,,,,3,3,6
HND-007825,2011,80100822,,,,37,19,56
HND-007826,2011,80100823,,,,78,74,152
HND-007828,2011,80100826,,,,22,23,45
HND-007846,2011,80100860,,,,2,3,5
HND-007847,2011,80100864,,,,28,28,56
HND-007851,2011,80100868,,,,47,37,84
,2011,80100877,,,,7,3,10
HND-007855,2011,80100885,,,,21,19,40
HND-007861,2011,80100896,,,,57,41,98
HND-007865,2011,80100905,,,,34,25,59
HND-007868,2011,80100911,,,,19,11,30
,2011,80100933,,,,2,9,11
,2011,80100944,,,,20,18,38
,2011,80100948,,,,33,17,50
,2011,80100954,,,,2,2,4
,2011,80100968,,,,3,4,7
,2011,80100969,,,,6,9,15
,2011,80100980,,,,4,6,10
HND-007885,2011,80100999,,,,4,2,6
HND-007886,2011,80101002,,,,6,7,13
,2011,80101005,,,,1,2,3
,2011,80101006,,,,5,9,14
HND-007887,2011,80101008,,,,2,2,4
,2011,80101010,,,,3,2,5
,2011,80101014,,,,23,29,52
,2011,80101021,,,,7,9,16
,2011,80101028,,,,11,8,19
HND-007893,2011,80101032,,,,4,1,5
HND-007894,2011,80101035,,,,13,14,27
,2011,80101071,,,,28,28,56
,2011,80101083,,,,3,1,4
HND-007900,2011,80101100,,,,37,20,57
HND-007901,2011,80101103,,,,25,29,54
,2011,80101134,,,,84,69,153
,2011,80101139,,,,5,17,22
,2011,80101145,,,,12,15,27
HND-007911,2011,80101153,,,,29,31,60
,2011,80101157,,,,10,16,26
,2011,80101158,,,,5,9,14
,2011,80101184,,,,4,1,5
,2011,80101197,,,,4,2,6
,2011,80101200,,,,22,24,46
,2011,80101203,,,,4,3,7
,2011,80101209,,,,3,7,10
,2011,80101215,,,,5,1,6
,2011,80101222,,,,5,6,11
,2011,80101259,,,,52,43,95
,2011,80101262,,,,5,5,10
,2011,80101264,,,,5,5,10
HND-007923,2011,80101274,,,,17,8,25
,2011,80101293,,,,6,6,12
,2011,80101308,,,,6,15,21
,2011,80101309,,,,2,5,7
,2011,80101312,,,,9,7,16
,2011,80101318,,,,6,2,8
,2011,80101365,,,,19,9,28
,2011,80101436,,,,1,4,5
,2011,80101464,,,,18,23,41
,2011,80101480,,,,18,16,34
,2011,80101481,,,,16,8,24
,2011,80101483,,,,15,11,26
HND-007933,2011,80101486,,,,6,9,15
,2011,80101491,,,,4,2,6
,2011,80101493,,,,10,14,24
,2011,80101501,,,,2,2,4
,2011,80101547,,,,0,2,2
,2011,80101554,,,,3,0,3
HND-007947,2011,80101572,,,,10,15,25
,2011,80101592,,,,2,8,10
,2011,80101593,,,,5,4,9
,2011,80101599,,,,4,3,7
,2011,80101615,,,,7,4,11
HND-007973,2011,80101649,,,,17,10,27
,2011,80101650,,,,7,9,16
,2011,80101652,,,,2,4,6
,2011,80101653,,,,4,6,10
,2011,80101672,,,,7,4,11
,2011,80101673,,,,69,0,69
,2011,80101674,,,,8,2,10
,2011,80101676,,,,23,37,60
,2011,80101681,,,,1,1,2
,2011,80101683,,,,1,5,6
,2011,80101690,,,,11,5,16
,2011,80101691,,,,8,12,20
,2011,80101692,,,,17,17,34
,2011,80101705,,,,1,0,1
,2011,80101707,,,,0,4,4
HND-007390,2011,80100003,,,,12,4,16
HND-007392,2011,80100005,,,,28,35,63
HND-007393,2011,80100006,,,,31,36,67
HND-007395,2011,80100008,,,,71,60,131
,2011,80100009,,,,37,49,86
HND-007396,2011,80100011,,,,19,19,38
HND-007397,2011,80100012,,,,5,6,11
HND-007399,2011,80100015,,,,76,76,152
HND-007401,2011,80100017,,,,55,50,105
HND-007404,2011,80100019,,,,10,13,23
HND-007403,2011,80100019,,,,10,13,23
HND-007408,2011,80100023,,,,13,3,16
HND-007409,2011,80100024,,,,8,9,17
HND-007410,2011,80100025,,,,50,28,78
HND-007413,2011,80100029,,,,10,13,23
HND-007416,2011,80100032,,,,4,3,7
HND-007419,2011,80100035,,,,89,76,165
HND-007423,2011,80100041,,,,17,14,31
,2011,80100045,,,,13,22,35
HND-007429,2011,80100050,,,,44,33,77
HND-007431,2011,80100052,,,,28,25,53
,2011,80100053,,,,38,36,74
HND-007432,2011,80100054,,,,56,43,99
HND-007436,2011,80100058,,,,4,2,6
,2011,80100059,,,,65,66,131
HND-007440,2011,80100062,,,,1,1,2
HND-007442,2011,80100064,,,,45,33,78
HND-007443,2011,80100066,,,,4,5,9
HND-007445,2011,80100071,,,,61,58,119
HND-007451,2011,80100077,,,,18,17,35
HND-007454,2011,80100080,,,,40,48,88
HND-007456,2011,80100082,,,,29,27,56
HND-007459,2011,80100085,,,,7,6,13
HND-007460,2011,80100086,,,,2,2,4
HND-007462,2011,80100088,,,,6,2,8
HND-007464,2011,80100090,,,,17,18,35
HND-007465,2011,80100091,,,,54,57,111
HND-007469,2011,80100095,,,,3,4,7
HND-007471,2011,80100097,,,,12,10,22
HND-007472,2011,80100098,,,,6,7,13
,2011,80100099,,,,25,36,61
HND-007474,2011,80100103,,,,9,14,23
HND-007475,2011,80100104,,,,1,4,5
HND-007480,2011,80100110,,,,32,24,56
HND-007482,2011,80100112,,,,36,26,62
,2011,80100113,,,,56,56,112
,2011,80100115,,,,40,44,84
HND-007483,2011,80100116,,,,12,8,20
HND-007484,2011,80100117,,,,31,32,63
HND-007490,2011,80100123,,,,0,3,3
HND-007491,2011,80100124,,,,15,14,29
HND-007496,2011,80100129,,,,12,7,19
HND-007497,2011,80100130,,,,23,15,38
HND-007499,2011,80100132,,,,8,2,10
HND-007500,2011,80100133,,,,88,56,144
HND-007504,2011,80100138,,,,13,7,20
,2011,80100139,,,,4,3,7
HND-007507,2011,80100142,,,,5,12,17
HND-007508,2011,80100144,,,,44,57,101
HND-007509,2011,80100146,,,,41,35,76
HND-007510,2011,80100147,,,,38,32,70
HND-007513,2011,80100150,,,,9,9,18
HND-007515,2011,80100152,,,,33,47,80
,2011,80100156,,,,16,29,45
HND-007519,2011,80100161,,,,18,13,31
HND-007520,2011,80100162,,,,7,6,13
HND-007522,2011,80100165,,,,5,7,12
HND-007523,2011,80100166,,,,12,3,15
HND-007526,2011,80100169,,,,47,37,84
,2011,80100173,,,,12,13,25
HND-007529,2011,80100174,,,,31,44,75
HND-007534,2011,80100179,,,,3,3,6
HND-007536,2011,80100181,,,,37,36,73
HND-007539,2011,80100184,,,,64,59,123
HND-007543,2011,80100187,,,,36,34,70
HND-007542,2011,80100187,,,,36,34,70
HND-007545,2011,80100189,,,,99,68,167
HND-007546,2011,80100190,,,,62,55,117
HND-007547,2011,80100191,,,,59,70,129
HND-007548,2011,80100192,,,,83,77,160
HND-007550,2011,80100195,,,,73,0,73
HND-007551,2011,80100196,,,,0,54,54
,2011,80100197,,,,20,28,48
HND-007552,2011,80100198,,,,45,32,77
HND-007554,2011,80100200,,,,14,12,26
,2011,80100201,,,,1,0,1
,2011,80100203,,,,24,19,43
,2011,80100208,,,,42,51,93
HND-007556,2011,80100214,,,,8,6,14
,2011,80100215,,,,11,6,17
,2011,80100216,,,,0,8,8
,2011,80100217,,,,27,22,49
HND-007557,2011,80100218,,,,6,4,10
HND-007560,2011,80100222,,,,82,80,162
HND-007561,2011,80100223,,,,10,6,16
,2011,80100224,,,,39,35,74
HND-007564,2011,80100228,,,,28,26,54
HND-007565,2011,80100229,,,,4,2,6
HND-007567,2011,80100232,,,,8,10,18
HND-007568,2011,80100233,,,,7,9,16
HND-007569,2011,80100234,,,,18,17,35
HND-007570,2011,80100235,,,,46,39,85
HND-007571,2011,80100236,,,,73,77,150
,2011,80100237,,,,33,39,72
HND-007573,2011,80100242,,,,25,15,40
HND-007574,2011,80100243,,,,31,27,58
HND-007578,2011,80100249,,,,36,24,60
HND-007581,2011,80100254,,,,2,4,6
HND-007583,2011,80100256,,,,46,45,91
HND-007587,2011,80100262,,,,64,85,149
HND-007588,2011,80100263,,,,6,4,10
,2011,80100264,,,,68,54,122
HND-007590,2011,80100267,,,,37,24,61
,2011,80100270,,,,5,5,10
,2011,80100271,,,,1,0,1
,2011,80100273,,,,3,1,4
,2011,80100278,,,,6,11,17
,2011,80100279,,,,29,48,77
,2011,80100284,,,,30,23,53
HND-007595,2011,80100287,,,,10,12,22
HND-007596,2011,80100290,,,,36,34,70
HND-007598,2011,80100293,,,,33,37,70
HND-007600,2011,80100295,,,,30,27,57
HND-007601,2011,80100296,,,,25,26,51
HND-007602,2011,80100298,,,,47,49,96
HND-007603,2011,80100299,,,,21,21,42
,2011,80100303,,,,28,26,54
,2011,80100305,,,,6,7,13
,2011,80100306,,,,35,38,73
HND-007605,2011,80100307,,,,38,23,61
,2011,80100310,,,,2,0,2
HND-007607,2011,80100316,,,,3,5,8
,2011,80100317,,,,41,40,81
HND-007610,2011,80100325,,,,78,84,162
,2011,80100326,,,,6,5,11
,2011,80100330,,,,6,4,10
HND-007612,2011,80100333,,,,29,32,61
HND-007613,2011,80100334,,,,18,15,33
,2011,80100337,,,,8,8,16
HND-007614,2011,80100340,,,,15,13,28
,2011,80100345,,,,3,8,11
,2011,80100346,,,,35,33,68
,2011,80100350,,,,13,10,23
HND-007619,2011,80100351,,,,13,14,27
HND-007620,2011,80100352,,,,44,42,86
HND-007621,2011,80100353,,,,28,19,47
HND-007624,2011,80100359,,,,23,15,38
,2011,80100362,,,,7,3,10
HND-007627,2011,80100366,,,,46,33,79
HND-007628,2011,80100367,,,,9,16,25
HND-007631,2011,80100370,,,,8,13,21
,2011,80100371,,,,13,7,20
HND-007632,2011,80100373,,,,33,27,60
,2011,80100374,,,,4,11,15
,2011,80100378,,,,5,1,6
,2011,80100380,,,,5,5,10
,2011,80100383,,,,8,14,22
,2011,80100384,,,,0,5,5
,2011,80100388,,,,12,13,25
HND-007638,2011,80100391,,,,81,66,147
HND-007639,2011,80100392,,,,1,3,4
HND-007640,2011,80100393,,,,0,3,3
,2011,80100395,,,,10,12,22
,2011,80100396,,,,14,13,27
HND-007642,2011,80100399,,,,25,22,47
HND-007644,2011,80100401,,,,37,21,58
,2011,80100403,,,,10,11,21
,2011,80100405,,,,3,7,10
,2011,80100409,,,,33,33,66
HND-007650,2011,80100416,,,,1,1,2
HND-007651,2011,80100417,,,,4,9,13
,2011,80100418,,,,27,18,45
HND-007654,2011,80100422,,,,34,32,66
HND-007655,2011,80100423,,,,13,16,29
HND-007656,2011,80100424,,,,30,38,68
,2011,80100426,,,,20,17,37
,2011,80100430,,,,14,11,25
,2011,80100432,,,,6,3,9
HND-007661,2011,80100434,,,,23,8,31
,2011,80100436,,,,15,8,23
,2011,80100446,,,,2,4,6
,2011,80100453,,,,2,2,4
HND-007676,2011,80100459,,,,14,14,28
,2011,80100465,,,,2,4,6
,2011,80100508,,,,10,18,28
,2011,80100547,,,,6,2,8
,2011,80100560,,,,12,13,25
,2011,80100586,,,,19,19,38
,2011,80100595,,,,1,5,6
,2011,80100599,,,,12,11,23
HND-007745,2011,80100603,,,,73,50,123
,2011,80100615,,,,6,11,17
HND-007752,2011,80100619,,,,17,15,32
,2011,80100622,,,,21,23,44
,2011,80100635,,,,45,41,86
,2011,80100658,,,,0,3,3
,2011,80100660,,,,17,17,34
,2011,80100663,,,,14,20,34
HND-007768,2011,80100677,,,,37,41,78
,2011,80100722,,,,2,8,10
HND-007796,2011,80100728,,,,1,0,1
HND-007797,2011,80100730,,,,1,3,4
,2011,80100738,,,,4,5,9
HND-007803,2011,80100760,,,,10,8,18
HND-007804,2011,80100762,,,,25,23,48
HND-007823,2011,80100804,,,,11,9,20
HND-007824,2011,80100816,,,,16,21,37
HND-007827,2011,80100825,,,,18,14,32
,2011,80100829,,,,14,10,24
,2011,80100831,,,,3,5,8
,2011,80100846,,,,6,2,8
HND-007848,2011,80100865,,,,66,76,142
HND-007849,2011,80100866,,,,20,14,34
HND-007850,2011,80100867,,,,36,34,70
,2011,80100882,,,,36,26,62
HND-007856,2011,80100890,,,,16,16,32
,2011,80100892,,,,15,10,25
HND-007858,2011,80100893,,,,13,16,29
HND-007862,2011,80100897,,,,16,9,25
HND-007867,2011,80100910,,,,40,33,73
,2011,80100915,,,,20,24,44
HND-007872,2011,80100929,,,,15,23,38
HND-007873,2011,80100932,,,,3,2,5
,2011,80100934,,,,2,0,2
,2011,80100935,,,,18,20,38
,2011,80100966,,,,20,18,38
,2011,80100970,,,,12,11,23
,2011,80100971,,,,4,2,6
,2011,80100985,,,,1,2,3
,2011,80100990,,,,39,43,82
,2011,80100997,,,,1,1,2
,2011,80101004,,,,7,7,14
,2011,80101007,,,,29,15,44
HND-007888,2011,80101009,,,,28,26,54
HND-007890,2011,80101020,,,,4,1,5
HND-007891,2011,80101022,,,,21,25,46
HND-007892,2011,80101023,,,,8,7,15
,2011,80101025,,,,6,2,8
,2011,80101030,,,,21,29,50
,2011,80101033,,,,20,9,29
,2011,80101039,,,,4,7,11
,2011,80101087,,,,3,4,7
HND-007902,2011,80101106,,,,32,20,52
HND-007903,2011,80101111,,,,35,29,64
HND-007905,2011,80101117,,,,3,2,5
HND-007908,2011,80101123,,,,12,9,21
,2011,80101125,,,,6,2,8
,2011,80101130,,,,6,9,15
,2011,80101161,,,,13,13,26
,2011,80101164,,,,10,7,17
,2011,80101186,,,,8,3,11
,2011,80101187,,,,5,2,7
,2011,80101195,,,,6,2,8
,2011,80101204,,,,34,33,67
,2011,80101205,,,,17,13,30
,2011,80101206,,,,4,3,7
,2011,80101207,,,,1,2,3
,2011,80101210,,,,4,3,7
,2011,80101212,,,,3,1,4
,2011,80101213,,,,2,2,4
,2011,80101260,,,,3,2,5
,2011,80101263,,,,5,2,7
,2011,80101268,,,,15,3,18
HND-007925,2011,80101282,,,,24,18,42
,2011,80101297,,,,8,6,14
,2011,80101307,,,,5,6,11
,2011,80101310,,,,1,3,4
,2011,80101315,,,,1,6,7
,2011,80101317,,,,2,1,3
,2011,80101361,,,,5,10,15
,2011,80101370,,,,5,7,12
HND-007931,2011,80101448,,,,31,26,57
,2011,80101476,,,,3,3,6
,2011,80101488,,,,4,3,7
,2011,80101495,,,,12,9,21
,2011,80101496,,,,12,14,26
,2011,80101499,,,,5,6,11
,2011,80101500,,,,6,5,11
,2011,80101542,,,,8,5,13
,2011,80101543,,,,19,4,23
,2011,80101546,,,,0,2,2
,2011,80101548,,,,3,5,8
,2011,80101549,,,,1,6,7
,2011,80101550,,,,2,2,4
,2011,80101551,,,,3,5,8
,2011,80101552,,,,0,2,2
,2011,80101553,,,,17,16,33
,2011,80101555,,,,1,4,5
,2011,80101556,,,,3,3,6
HND-007944,2011,80101560,,,,13,23,36
,2011,80101571,,,,4,14,18
,2011,80101586,,,,2,0,2
HND-007952,2011,80101587,,,,8,8,16
,2011,80101588,,,,2,3,5
,2011,80101605,,,,7,8,15
,2011,80101607,,,,11,13,24
,2011,80101617,,,,6,13,19
,2011,80101622,,,,5,1,6
,2011,80101634,,,,4,12,16
,2011,80101651,,,,3,5,8
,2011,80101665,,,,4,2,6
,2011,80101675,,,,0,34,34
,2011,80101685,,,,5,10,15
,2011,80101700,,,,1,1,2
HND-007984,2011,80101709,,,,15,11,26
HND-007388,2011,80100001,,,,18,14,32
HND-007392,2011,80100005,,,,35,25,60
HND-007393,2011,80100006,,,,37,34,71
HND-007394,2011,80100007,,,,4,10,14
HND-007396,2011,80100011,,,,15,11,26
HND-007400,2011,80100016,,,,13,20,33
HND-007405,2011,80100020,,,,4,5,9
HND-007406,2011,80100021,,,,2,1,3
HND-007407,2011,80100022,,,,29,15,44
HND-007408,2011,80100023,,,,4,8,12
,2011,80100028,,,,1,2,3
HND-007413,2011,80100029,,,,11,6,17
HND-007414,2011,80100030,,,,61,51,112
HND-007415,2011,80100031,,,,7,7,14
HND-007417,2011,80100033,,,,18,12,30
HND-007421,2011,80100039,,,,42,41,83
HND-007426,2011,80100044,,,,37,39,76
,2011,80100045,,,,20,17,37
HND-007427,2011,80100048,,,,4,5,9
HND-007429,2011,80100050,,,,47,58,105
HND-007430,2011,80100051,,,,58,36,94
,2011,80100053,,,,47,47,94
HND-007433,2011,80100055,,,,10,13,23
HND-007435,2011,80100057,,,,3,8,11
,2011,80100059,,,,50,51,101
HND-007438,2011,80100060,,,,26,34,60
HND-007439,2011,80100061,,,,57,61,118
,2011,80100069,,,,33,24,57
HND-007444,2011,80100070,,,,6,4,10
HND-007447,2011,80100073,,,,11,15,26
HND-007448,2011,80100074,,,,23,24,47
HND-007452,2011,80100078,,,,8,7,15
HND-007454,2011,80100080,,,,41,50,91
HND-007455,2011,80100081,,,,57,54,111
HND-007458,2011,80100084,,,,6,5,11
HND-007459,2011,80100085,,,,6,5,11
HND-007460,2011,80100086,,,,4,3,7
HND-007461,2011,80100087,,,,3,0,3
HND-007465,2011,80100091,,,,56,58,114
HND-007466,2011,80100092,,,,14,11,25
HND-007468,2011,80100094,,,,5,7,12
HND-007469,2011,80100095,,,,4,2,6
HND-007470,2011,80100096,,,,17,13,30
HND-007471,2011,80100097,,,,33,21,54
HND-007473,2011,80100102,,,,12,15,27
HND-007474,2011,80100103,,,,14,12,26
HND-007478,2011,80100108,,,,8,18,26
HND-007479,2011,80100109,,,,27,34,61
HND-007480,2011,80100110,,,,34,27,61
HND-007481,2011,80100111,,,,30,24,54
,2011,80100115,,,,41,45,86
HND-007486,2011,80100119,,,,7,12,19
HND-007489,2011,80100122,,,,5,6,11
HND-007492,2011,80100125,,,,5,10,15
,2011,80100126,,,,1,0,1
HND-007495,2011,80100128,,,,11,6,17
HND-007497,2011,80100130,,,,23,21,44
HND-007498,2011,80100131,,,,13,14,27
HND-007500,2011,80100133,,,,65,66,131
HND-007501,2011,80100134,,,,16,14,30
HND-007502,2011,80100135,,,,11,11,22
HND-007505,2011,80100140,,,,6,16,22
HND-007506,2011,80100141,,,,5,7,12
HND-007507,2011,80100142,,,,7,7,14
,2011,80100143,,,,38,37,75
HND-007511,2011,80100148,,,,113,0,113
HND-007512,2011,80100149,,,,73,56,129
HND-007513,2011,80100150,,,,15,7,22
HND-007514,2011,80100151,,,,6,9,15
,2011,80100154,,,,7,7,14
,2011,80100156,,,,20,25,45
HND-007516,2011,80100157,,,,43,42,85
HND-007518,2011,80100159,,,,7,10,17
HND-007519,2011,80100161,,,,14,8,22
HND-007522,2011,80100165,,,,9,10,19
HND-007523,2011,80100166,,,,3,5,8
HND-007525,2011,80100168,,,,28,33,61
HND-007528,2011,80100172,,,,0,154,154
,2011,80100173,,,,13,7,20
HND-007530,2011,80100175,,,,18,11,29
HND-007531,2011,80100176,,,,2,3,5
HND-007532,2011,80100177,,,,0,1,1
HND-007533,2011,80100178,,,,26,18,44
HND-007535,2011,80100180,,,,4,7,11
HND-007537,2011,80100182,,,,10,10,20
HND-007538,2011,80100183,,,,0,24,24
HND-007544,2011,80100188,,,,58,51,109
HND-007545,2011,80100189,,,,92,74,166
HND-007547,2011,80100191,,,,67,63,130
HND-007549,2011,80100194,,,,40,30,70
HND-007550,2011,80100195,,,,56,0,56
HND-007551,2011,80100196,,,,0,83,83
,2011,80100197,,,,19,24,43
,2011,80100204,,,,14,8,22
,2011,80100205,,,,18,13,31
,2011,80100207,,,,20,24,44
,2011,80100208,,,,51,37,88
HND-007555,2011,80100210,,,,20,19,39
,2011,80100212,,,,25,0,25
,2011,80100213,,,,14,6,20
HND-007556,2011,80100214,,,,9,4,13
,2011,80100219,,,,14,6,20
HND-007558,2011,80100220,,,,66,54,120
HND-007559,2011,80100221,,,,15,15,30
HND-007560,2011,80100222,,,,68,78,146
HND-007563,2011,80100227,,,,6,3,9
HND-007564,2011,80100228,,,,20,33,53
,2011,80100230,,,,0,28,28
HND-007568,2011,80100233,,,,6,8,14
HND-007569,2011,80100234,,,,19,27,46
,2011,80100239,,,,15,6,21
HND-007572,2011,80100241,,,,109,91,200
HND-007574,2011,80100243,,,,30,25,55
HND-007578,2011,80100249,,,,18,31,49
,2011,80100250,,,,43,30,73
HND-007580,2011,80100252,,,,27,16,43
,2011,80100253,,,,7,7,14
HND-007581,2011,80100254,,,,7,3,10
HND-007582,2011,80100255,,,,8,0,8
HND-007585,2011,80100259,,,,27,29,56
HND-007586,2011,80100260,,,,54,46,100
HND-007587,2011,80100262,,,,78,91,169
HND-007591,2011,80100268,,,,47,47,94
HND-007592,2011,80100275,,,,33,28,61
HND-007593,2011,80100276,,,,11,15,26
,2011,80100282,,,,14,10,24
,2011,80100283,,,,8,4,12
,2011,80100284,,,,21,27,48
HND-007595,2011,80100287,,,,12,14,26
,2011,80100291,,,,7,7,14
HND-007599,2011,80100294,,,,40,43,83
HND-007600,2011,80100295,,,,25,26,51
HND-007601,2011,80100296,,,,16,18,34
,2011,80100300,,,,4,6,10
,2011,80100301,,,,15,11,26
HND-007604,2011,80100302,,,,8,11,19
,2011,80100303,,,,24,16,40
,2011,80100304,,,,1,3,4
,2011,80100308,,,,3,5,8
HND-007606,2011,80100315,,,,30,37,67
HND-007607,2011,80100316,,,,5,3,8
,2011,80100317,,,,39,36,75
HND-007609,2011,80100322,,,,22,22,44
,2011,80100324,,,,9,3,12
HND-007610,2011,80100325,,,,87,87,174
,2011,80100329,,,,11,15,26
,2011,80100332,,,,9,8,17
,2011,80100335,,,,25,19,44
,2011,80100336,,,,7,13,20
,2011,80100337,,,,14,13,27
HND-007616,2011,80100342,,,,61,57,118
,2011,80100344,,,,8,10,18
,2011,80100345,,,,8,10,18
,2011,80100346,,,,35,31,66
,2011,80100350,,,,14,5,19
,2011,80100355,,,,20,27,47
HND-007623,2011,80100357,,,,54,52,106
,2011,80100361,,,,9,12,21
,2011,80100362,,,,9,5,14
HND-007625,2011,80100363,,,,10,13,23
HND-007626,2011,80100364,,,,32,15,47
HND-007627,2011,80100366,,,,42,47,89
HND-007630,2011,80100369,,,,41,37,78
,2011,80100371,,,,13,19,32
HND-007633,2011,80100376,,,,10,6,16
,2011,80100380,,,,4,13,17
HND-007637,2011,80100387,,,,24,34,58
HND-007641,2011,80100398,,,,17,15,32
HND-007642,2011,80100399,,,,21,17,38
,2011,80100404,,,,2,2,4
,2011,80100405,,,,5,4,9
,2011,80100410,,,,7,3,10
HND-007646,2011,80100411,,,,37,38,75
HND-007650,2011,80100416,,,,2,1,3
HND-007651,2011,80100417,,,,7,11,18
,2011,80100418,,,,19,31,50
,2011,80100420,,,,15,10,25
HND-007654,2011,80100422,,,,38,45,83
HND-007655,2011,80100423,,,,11,10,21
,2011,80100426,,,,8,22,30
,2011,80100427,,,,6,3,9
HND-007659,2011,80100429,,,,13,6,19
,2011,80100432,,,,4,4,8
HND-007660,2011,80100433,,,,36,49,85
HND-007661,2011,80100434,,,,14,11,25
,2011,80100453,,,,2,1,3
,2011,80100499,,,,14,10,24
HND-007700,2011,80100502,,,,36,28,64
HND-007710,2011,80100521,,,,82,70,152
HND-007722,2011,80100543,,,,27,24,51
,2011,80100547,,,,4,8,12
,2011,80100557,,,,2,5,7
HND-007729,2011,80100568,,,,12,8,20
,2011,80100581,,,,9,10,19
,2011,80100582,,,,11,9,20
,2011,80100583,,,,2,0,2
,2011,80100595,,,,0,6,6
HND-007743,2011,80100598,,,,26,21,47
,2011,80100615,,,,5,4,9
HND-007752,2011,80100619,,,,15,23,38
,2011,80100622,,,,23,23,46
,2011,80100635,,,,32,43,75
,2011,80100637,,,,13,17,30
HND-007768,2011,80100677,,,,30,26,56
HND-007798,2011,80100734,,,,66,61,127
,2011,80100736,,,,2,2,4
,2011,80100738,,,,10,7,17
,2011,80100749,,,,0,3,3
HND-007802,2011,80100753,,,,26,23,49
,2011,80100757,,,,5,8,13
HND-007804,2011,80100762,,,,27,16,43
,2011,80100767,,,,16,15,31
,2011,80100811,,,,4,3,7
HND-007824,2011,80100816,,,,24,13,37
HND-007825,2011,80100822,,,,28,22,50
HND-007826,2011,80100823,,,,69,79,148
HND-007827,2011,80100825,,,,11,11,22
HND-007828,2011,80100826,,,,23,16,39
,2011,80100829,,,,8,10,18
,2011,80100831,,,,9,4,13
HND-007846,2011,80100860,,,,0,1,1
HND-007847,2011,80100864,,,,27,31,58
HND-007848,2011,80100865,,,,64,72,136
HND-007849,2011,80100866,,,,24,23,47
HND-007850,2011,80100867,,,,38,25,63
HND-007851,2011,80100868,,,,37,31,68
,2011,80100877,,,,10,9,19
HND-007855,2011,80100885,,,,9,13,22
,2011,80100892,,,,18,13,31
HND-007858,2011,80100893,,,,16,16,32
HND-007862,2011,80100897,,,,11,16,27
HND-007865,2011,80100905,,,,38,30,68
HND-007873,2011,80100932,,,,2,2,4
,2011,80100933,,,,7,4,11
,2011,80100934,,,,1,2,3
,2011,80100948,,,,22,34,56
,2011,80100969,,,,13,8,21
,2011,80100980,,,,1,1,2
,2011,80100985,,,,1,2,3
,2011,80100997,,,,1,2,3
HND-007885,2011,80100999,,,,4,4,8
HND-007886,2011,80101002,,,,10,13,23
HND-007887,2011,80101008,,,,3,3,6
,2011,80101010,,,,3,2,5
,2011,80101014,,,,29,20,49
HND-007890,2011,80101020,,,,4,4,8
,2011,80101021,,,,2,3,5
HND-007891,2011,80101022,,,,23,21,44
HND-007892,2011,80101023,,,,16,20,36
HND-007894,2011,80101035,,,,19,21,40
,2011,80101071,,,,22,35,57
,2011,80101087,,,,2,1,3
HND-007900,2011,80101100,,,,36,35,71
HND-007902,2011,80101106,,,,23,27,50
,2011,80101125,,,,4,7,11
,2011,80101130,,,,11,18,29
,2011,80101134,,,,44,66,110
HND-007911,2011,80101153,,,,25,25,50
,2011,80101158,,,,2,5,7
,2011,80101164,,,,11,9,20
,2011,80101184,,,,4,11,15
,2011,80101187,,,,2,5,7
,2011,80101195,,,,3,4,7
,2011,80101197,,,,2,1,3
,2011,80101200,,,,15,21,36
,2011,80101203,,,,2,3,5
,2011,80101204,,,,22,20,42
,2011,80101209,,,,1,5,6
,2011,80101215,,,,7,3,10
,2011,80101222,,,,9,5,14
,2011,80101259,,,,30,39,69
,2011,80101268,,,,11,8,19
HND-007923,2011,80101274,,,,8,9,17
HND-007925,2011,80101282,,,,24,15,39
,2011,80101297,,,,11,10,21
,2011,80101309,,,,6,11,17
,2011,80101312,,,,9,18,27
,2011,80101315,,,,0,2,2
,2011,80101361,,,,3,4,7
,2011,80101436,,,,2,0,2
,2011,80101464,,,,12,14,26
,2011,80101480,,,,17,12,29
,2011,80101481,,,,8,10,18
HND-007933,2011,80101486,,,,4,5,9
,2011,80101491,,,,7,2,9
,2011,80101493,,,,3,8,11
,2011,80101496,,,,8,6,14
,2011,80101501,,,,1,3,4
,2011,80101543,,,,9,9,18
,2011,80101546,,,,0,1,1
,2011,80101549,,,,1,1,2
,2011,80101551,,,,2,2,4
,2011,80101555,,,,1,0,1
,2011,80101556,,,,2,3,5
,2011,80101571,,,,10,5,15
,2011,80101586,,,,1,0,1
HND-007952,2011,80101587,,,,11,8,19
,2011,80101588,,,,1,3,4
,2011,80101593,,,,0,3,3
,2011,80101605,,,,5,4,9
,2011,80101607,,,,16,10,26
,2011,80101615,,,,2,4,6
,2011,80101634,,,,8,3,11
,2011,80101652,,,,1,1,2
,2011,80101665,,,,1,3,4
,2011,80101674,,,,6,7,13
,2011,80101676,,,,21,27,48
,2011,80101683,,,,2,2,4
,2011,80101692,,,,18,15,33
,2011,80101700,,,,6,6,12
,2011,80101705,,,,3,0,3
HND-007389,2011,80100002,,,,9,18,27
HND-007390,2011,80100003,,,,11,12,23
HND-007395,2011,80100008,,,,55,60,115
,2011,80100009,,,,36,45,81
HND-007397,2011,80100012,,,,5,1,6
HND-007398,2011,80100014,,,,6,9,15
HND-007399,2011,80100015,,,,63,59,122
HND-007401,2011,80100017,,,,63,45,108
HND-007402,2011,80100018,,,,69,45,114
HND-007404,2011,80100019,,,,9,11,20
HND-007403,2011,80100019,,,,9,11,20
HND-007409,2011,80100024,,,,6,9,15
HND-007410,2011,80100025,,,,30,29,59
HND-007411,2011,80100026,,,,5,6,11
HND-007412,2011,80100027,,,,4,8,12
HND-007416,2011,80100032,,,,2,2,4
HND-007418,2011,80100034,,,,4,1,5
HND-007419,2011,80100035,,,,80,70,150
HND-007420,2011,80100038,,,,26,45,71
HND-007422,2011,80100040,,,,35,28,63
HND-007423,2011,80100041,,,,8,12,20
HND-007425,2011,80100043,,,,20,11,31
HND-007428,2011,80100049,,,,52,48,100
HND-007431,2011,80100052,,,,30,21,51
HND-007432,2011,80100054,,,,51,43,94
HND-007434,2011,80100056,,,,28,41,69
HND-007436,2011,80100058,,,,2,2,4
HND-007440,2011,80100062,,,,5,2,7
HND-007442,2011,80100064,,,,47,48,95
HND-007443,2011,80100066,,,,12,5,17
,2011,80100067,,,,2,6,8
HND-007445,2011,80100071,,,,55,43,98
HND-007446,2011,80100072,,,,18,20,38
HND-007449,2011,80100075,,,,3,4,7
HND-007450,2011,80100076,,,,11,11,22
HND-007451,2011,80100077,,,,16,9,25
HND-007453,2011,80100079,,,,66,86,152
HND-007456,2011,80100082,,,,26,23,49
,2011,80100083,,,,4,7,11
HND-007462,2011,80100088,,,,4,4,8
HND-007463,2011,80100089,,,,7,4,11
HND-007464,2011,80100090,,,,27,14,41
HND-007467,2011,80100093,,,,6,6,12
HND-007472,2011,80100098,,,,3,2,5
,2011,80100099,,,,27,35,62
HND-007475,2011,80100104,,,,3,3,6
HND-007476,2011,80100105,,,,10,2,12
HND-007477,2011,80100106,,,,12,7,19
HND-007482,2011,80100112,,,,41,24,65
,2011,80100113,,,,64,63,127
HND-007483,2011,80100116,,,,12,15,27
HND-007484,2011,80100117,,,,31,31,62
HND-007485,2011,80100118,,,,4,1,5
HND-007488,2011,80100121,,,,10,9,19
HND-007490,2011,80100123,,,,2,0,2
HND-007491,2011,80100124,,,,15,11,26
HND-007494,2011,80100127,,,,14,30,44
HND-007496,2011,80100129,,,,11,4,15
HND-007499,2011,80100132,,,,5,6,11
HND-007503,2011,80100137,,,,19,17,36
HND-007504,2011,80100138,,,,12,8,20
,2011,80100139,,,,3,4,7
HND-007508,2011,80100144,,,,46,39,85
HND-007509,2011,80100146,,,,49,49,98
HND-007510,2011,80100147,,,,38,28,66
HND-007515,2011,80100152,,,,54,42,96
HND-007517,2011,80100158,,,,15,11,26
HND-007520,2011,80100162,,,,9,9,18
HND-007521,2011,80100163,,,,3,1,4
,2011,80100164,,,,10,19,29
HND-007524,2011,80100167,,,,34,43,77
HND-007526,2011,80100169,,,,34,36,70
HND-007527,2011,80100170,,,,51,37,88
HND-007529,2011,80100174,,,,27,38,65
HND-007534,2011,80100179,,,,0,4,4
HND-007536,2011,80100181,,,,32,33,65
HND-007539,2011,80100184,,,,50,47,97
HND-007540,2011,80100185,,,,112,122,234
HND-007541,2011,80100186,,,,32,24,56
HND-007543,2011,80100187,,,,35,33,68
HND-007542,2011,80100187,,,,35,33,68
HND-007546,2011,80100190,,,,75,73,148
HND-007548,2011,80100192,,,,66,69,135
,2011,80100193,,,,76,71,147
HND-007552,2011,80100198,,,,43,38,81
HND-007553,2011,80100199,,,,64,68,132
HND-007554,2011,80100200,,,,12,8,20
,2011,80100201,,,,4,2,6
,2011,80100202,,,,20,9,29
,2011,80100203,,,,11,19,30
,2011,80100211,,,,0,35,35
,2011,80100215,,,,6,4,10
,2011,80100216,,,,3,5,8
,2011,80100217,,,,20,26,46
HND-007557,2011,80100218,,,,4,2,6
HND-007561,2011,80100223,,,,10,7,17
,2011,80100224,,,,35,35,70
,2011,80100225,,,,42,42,84
HND-007562,2011,80100226,,,,36,40,76
HND-007565,2011,80100229,,,,2,2,4
HND-007566,2011,80100231,,,,17,11,28
HND-007567,2011,80100232,,,,5,5,10
HND-007570,2011,80100235,,,,41,44,85
HND-007571,2011,80100236,,,,65,67,132
,2011,80100237,,,,41,36,77
HND-007573,2011,80100242,,,,29,11,40
,2011,80100244,,,,44,38,82
,2011,80100245,,,,23,39,62
HND-007575,2011,80100246,,,,10,10,20
HND-007576,2011,80100247,,,,19,15,34
HND-007579,2011,80100251,,,,13,4,17
HND-007583,2011,80100256,,,,46,32,78
HND-007584,2011,80100258,,,,29,27,56
HND-007588,2011,80100263,,,,2,4,6
,2011,80100264,,,,55,61,116
,2011,80100265,,,,18,16,34
HND-007589,2011,80100266,,,,29,19,48
HND-007590,2011,80100267,,,,39,34,73
,2011,80100270,,,,8,6,14
,2011,80100273,,,,3,3,6
,2011,80100278,,,,10,11,21
,2011,80100279,,,,48,45,93
HND-007594,2011,80100286,,,,8,6,14
,2011,80100288,,,,1,3,4
HND-007596,2011,80100290,,,,30,36,66
HND-007597,2011,80100292,,,,18,12,30
HND-007598,2011,80100293,,,,55,45,100
HND-007602,2011,80100298,,,,38,55,93
HND-007603,2011,80100299,,,,31,20,51
,2011,80100305,,,,16,5,21
,2011,80100306,,,,38,39,77
HND-007605,2011,80100307,,,,28,34,62
,2011,80100310,,,,3,2,5
,2011,80100312,,,,8,12,20
HND-007608,2011,80100318,,,,6,5,11
,2011,80100319,,,,14,18,32
,2011,80100320,,,,4,2,6
,2011,80100326,,,,6,4,10
HND-007611,2011,80100328,,,,12,20,32
,2011,80100330,,,,3,1,4
HND-007612,2011,80100333,,,,28,30,58
HND-007613,2011,80100334,,,,15,25,40
HND-007614,2011,80100340,,,,9,15,24
HND-007615,2011,80100341,,,,25,37,62
HND-007619,2011,80100351,,,,10,7,17
HND-007620,2011,80100352,,,,51,51,102
HND-007621,2011,80100353,,,,30,22,52
HND-007622,2011,80100354,,,,1,1,2
,2011,80100356,,,,11,8,19
HND-007624,2011,80100359,,,,18,14,32
HND-007628,2011,80100367,,,,19,16,35
HND-007629,2011,80100368,,,,22,27,49
HND-007631,2011,80100370,,,,9,5,14
HND-007632,2011,80100373,,,,24,22,46
,2011,80100374,,,,6,4,10
,2011,80100375,,,,8,20,28
HND-007634,2011,80100377,,,,4,0,4
,2011,80100378,,,,2,4,6
,2011,80100383,,,,12,7,19
,2011,80100384,,,,3,5,8
HND-007636,2011,80100385,,,,64,56,120
,2011,80100388,,,,13,11,24
HND-007638,2011,80100391,,,,53,69,122
HND-007639,2011,80100392,,,,2,1,3
HND-007640,2011,80100393,,,,3,2,5
,2011,80100395,,,,13,7,20
,2011,80100396,,,,11,9,20
HND-007643,2011,80100400,,,,49,58,107
HND-007644,2011,80100401,,,,25,23,48
,2011,80100403,,,,11,7,18
,2011,80100406,,,,36,33,69
,2011,80100407,,,,232,185,417
HND-007645,2011,80100408,,,,24,17,41
,2011,80100409,,,,16,35,51
HND-007647,2011,80100413,,,,4,9,13
HND-007648,2011,80100414,,,,5,1,6
HND-007649,2011,80100415,,,,3,5,8
HND-007653,2011,80100421,,,,6,4,10
HND-007656,2011,80100424,,,,27,42,69
HND-007657,2011,80100425,,,,42,41,83
,2011,80100428,,,,43,36,79
,2011,80100430,,,,9,15,24
,2011,80100435,,,,13,15,28
,2011,80100436,,,,6,10,16
,2011,80100438,,,,19,17,36
,2011,80100446,,,,10,12,22
HND-007676,2011,80100459,,,,17,10,27
,2011,80100465,,,,6,1,7
,2011,80100494,,,,2,1,3
,2011,80100508,,,,16,26,42
,2011,80100541,,,,14,10,24
,2011,80100560,,,,5,9,14
,2011,80100565,,,,16,10,26
,2011,80100586,,,,16,12,28
,2011,80100599,,,,8,9,17
HND-007745,2011,80100603,,,,48,64,112
,2011,80100658,,,,3,4,7
,2011,80100660,,,,7,14,21
,2011,80100663,,,,17,18,35
,2011,80100675,,,,39,37,76
,2011,80100722,,,,5,5,10
HND-007796,2011,80100728,,,,3,1,4
HND-007797,2011,80100730,,,,1,5,6
,2011,80100742,,,,12,6,18
HND-007803,2011,80100760,,,,4,6,10
,2011,80100791,,,,8,5,13
,2011,80100792,,,,1,4,5
HND-007820,2011,80100800,,,,20,22,42
,2011,80100802,,,,10,9,19
HND-007823,2011,80100804,,,,12,10,22
,2011,80100846,,,,7,7,14
,2011,80100882,,,,38,26,64
HND-007856,2011,80100890,,,,15,14,29
HND-007861,2011,80100896,,,,36,34,70
HND-007867,2011,80100910,,,,39,34,73
HND-007868,2011,80100911,,,,13,12,25
,2011,80100915,,,,21,10,31
HND-007872,2011,80100929,,,,18,12,30
,2011,80100935,,,,19,19,38
,2011,80100944,,,,13,10,23
,2011,80100954,,,,0,3,3
,2011,80100966,,,,20,15,35
,2011,80100968,,,,1,4,5
,2011,80100970,,,,14,8,22
,2011,80100971,,,,4,4,8
,2011,80100990,,,,45,49,94
,2011,80101004,,,,9,6,15
,2011,80101005,,,,1,0,1
,2011,80101006,,,,2,6,8
,2011,80101007,,,,15,30,45
HND-007888,2011,80101009,,,,19,12,31
,2011,80101025,,,,3,4,7
,2011,80101028,,,,6,8,14
,2011,80101030,,,,20,19,39
HND-007893,2011,80101032,,,,2,1,3
,2011,80101033,,,,16,11,27
,2011,80101039,,,,2,5,7
,2011,80101083,,,,1,2,3
HND-007901,2011,80101103,,,,38,32,70
HND-007903,2011,80101111,,,,29,24,53
HND-007905,2011,80101117,,,,5,4,9
HND-007908,2011,80101123,,,,10,15,25
,2011,80101139,,,,10,10,20
,2011,80101145,,,,11,9,20
,2011,80101157,,,,20,14,34
,2011,80101161,,,,15,15,30
,2011,80101186,,,,4,6,10
,2011,80101205,,,,11,13,24
,2011,80101206,,,,9,9,18
,2011,80101207,,,,1,2,3
,2011,80101210,,,,0,4,4
,2011,80101212,,,,2,4,6
,2011,80101213,,,,1,2,3
,2011,80101260,,,,3,2,5
,2011,80101262,,,,5,4,9
,2011,80101263,,,,4,2,6
,2011,80101264,,,,7,2,9
,2011,80101293,,,,14,3,17
,2011,80101307,,,,10,5,15
,2011,80101308,,,,19,15,34
,2011,80101310,,,,1,1,2
,2011,80101317,,,,1,2,3
,2011,80101318,,,,5,5,10
,2011,80101357,,,,1,1,2
,2011,80101365,,,,8,11,19
,2011,80101370,,,,5,7,12
HND-007931,2011,80101448,,,,19,23,42
,2011,80101476,,,,4,2,6
,2011,80101483,,,,17,13,30
,2011,80101488,,,,0,2,2
,2011,80101495,,,,12,11,23
,2011,80101499,,,,5,4,9
,2011,80101500,,,,5,11,16
,2011,80101542,,,,5,4,9
,2011,80101547,,,,1,2,3
,2011,80101548,,,,1,4,5
,2011,80101550,,,,2,2,4
,2011,80101552,,,,1,1,2
,2011,80101553,,,,13,14,27
,2011,80101554,,,,1,1,2
HND-007944,2011,80101560,,,,23,31,54
HND-007947,2011,80101572,,,,4,5,9
,2011,80101592,,,,3,3,6
,2011,80101599,,,,1,1,2
,2011,80101617,,,,11,8,19
,2011,80101622,,,,3,5,8
HND-007973,2011,80101649,,,,8,7,15
,2011,80101650,,,,8,8,16
,2011,80101651,,,,5,1,6
,2011,80101653,,,,5,4,9
,2011,80101672,,,,3,4,7
,2011,80101673,,,,60,0,60
,2011,80101685,,,,3,4,7
,2011,80101690,,,,3,3,6
HND-007984,2011,80101709,,,,3,3,6
HND-007389,2011,80100002,,,,11,14,25
HND-007390,2011,80100003,,,,7,7,14
HND-007391,2011,80100004,,,,2,3,5
HND-007398,2011,80100014,,,,10,6,16
HND-007399,2011,80100015,,,,81,77,158
HND-007400,2011,80100016,,,,21,21,42
HND-007402,2011,80100018,,,,67,64,131
HND-007406,2011,80100021,,,,3,3,6
HND-007407,2011,80100022,,,,27,22,49
HND-007411,2011,80100026,,,,11,6,17
HND-007412,2011,80100027,,,,6,5,11
,2011,80100028,,,,3,3,6
HND-007414,2011,80100030,,,,57,38,95
HND-007417,2011,80100033,,,,15,9,24
HND-007418,2011,80100034,,,,2,4,6
HND-007420,2011,80100038,,,,45,42,87
HND-007421,2011,80100039,,,,65,63,128
HND-007422,2011,80100040,,,,28,28,56
HND-007425,2011,80100043,,,,21,15,36
HND-007426,2011,80100044,,,,41,34,75
HND-007427,2011,80100048,,,,3,5,8
HND-007428,2011,80100049,,,,48,46,94
HND-007432,2011,80100054,,,,53,43,96
HND-007433,2011,80100055,,,,14,18,32
HND-007434,2011,80100056,,,,23,28,51
HND-007438,2011,80100060,,,,24,19,43
HND-007439,2011,80100061,,,,47,58,105
HND-007443,2011,80100066,,,,14,8,22
,2011,80100067,,,,6,3,9
HND-007446,2011,80100072,,,,31,24,55
HND-007448,2011,80100074,,,,17,25,42
HND-007449,2011,80100075,,,,4,4,8
HND-007450,2011,80100076,,,,3,6,9
HND-007451,2011,80100077,,,,11,10,21
HND-007452,2011,80100078,,,,5,4,9
HND-007453,2011,80100079,,,,73,76,149
,2011,80100083,,,,3,2,5
HND-007458,2011,80100084,,,,7,8,15
HND-007463,2011,80100089,,,,4,3,7
HND-007466,2011,80100092,,,,8,4,12
HND-007467,2011,80100093,,,,4,7,11
HND-007468,2011,80100094,,,,5,10,15
HND-007470,2011,80100096,,,,11,11,22
,2011,80100099,,,,31,33,64
HND-007473,2011,80100102,,,,11,6,17
HND-007475,2011,80100104,,,,1,0,1
HND-007476,2011,80100105,,,,7,4,11
HND-007477,2011,80100106,,,,10,5,15
HND-007478,2011,80100108,,,,19,12,31
HND-007479,2011,80100109,,,,27,36,63
,2011,80100113,,,,78,69,147
HND-007485,2011,80100118,,,,4,5,9
HND-007486,2011,80100119,,,,6,15,21
HND-007487,2011,80100120,,,,0,3,3
HND-007488,2011,80100121,,,,14,16,30
HND-007491,2011,80100124,,,,15,12,27
HND-007492,2011,80100125,,,,3,8,11
,2011,80100126,,,,1,3,4
HND-007494,2011,80100127,,,,17,30,47
HND-007501,2011,80100134,,,,11,17,28
HND-007502,2011,80100135,,,,9,11,20
HND-007503,2011,80100137,,,,18,23,41
HND-007506,2011,80100141,,,,3,5,8
HND-007509,2011,80100146,,,,72,51,123
HND-007510,2011,80100147,,,,25,27,52
HND-007511,2011,80100148,,,,125,0,125
HND-007517,2011,80100158,,,,12,7,19
HND-007521,2011,80100163,,,,5,0,5
,2011,80100164,,,,16,17,33
HND-007524,2011,80100167,,,,44,45,89
HND-007527,2011,80100170,,,,44,45,89
HND-007528,2011,80100172,,,,0,158,158
HND-007531,2011,80100176,,,,9,2,11
HND-007532,2011,80100177,,,,1,5,6
HND-007533,2011,80100178,,,,19,23,42
HND-007536,2011,80100181,,,,23,44,67
HND-007537,2011,80100182,,,,9,10,19
HND-007540,2011,80100185,,,,125,118,243
HND-007541,2011,80100186,,,,39,31,70
HND-007543,2011,80100187,,,,37,40,77
HND-007542,2011,80100187,,,,37,40,77
HND-007544,2011,80100188,,,,62,48,110
,2011,80100193,,,,88,66,154
HND-007549,2011,80100194,,,,47,37,84
HND-007553,2011,80100199,,,,60,78,138
,2011,80100202,,,,12,18,30
,2011,80100204,,,,9,11,20
,2011,80100207,,,,27,24,51
HND-007555,2011,80100210,,,,17,13,30
,2011,80100211,,,,0,55,55
,2011,80100213,,,,9,6,15
,2011,80100216,,,,10,4,14
HND-007557,2011,80100218,,,,6,5,11
HND-007559,2011,80100221,,,,18,23,41
,2011,80100225,,,,36,35,71
HND-007562,2011,80100226,,,,38,45,83
HND-007563,2011,80100227,,,,8,6,14
HND-007566,2011,80100231,,,,17,15,32
,2011,80100237,,,,41,34,75
,2011,80100244,,,,38,39,77
,2011,80100245,,,,41,50,91
HND-007575,2011,80100246,,,,13,13,26
HND-007576,2011,80100247,,,,20,14,34
HND-007579,2011,80100251,,,,9,8,17
HND-007582,2011,80100255,,,,6,0,6
HND-007583,2011,80100256,,,,42,49,91
HND-007584,2011,80100258,,,,38,29,67
HND-007585,2011,80100259,,,,40,43,83
HND-007588,2011,80100263,,,,1,2,3
,2011,80100265,,,,19,14,33
HND-007589,2011,80100266,,,,32,32,64
HND-007590,2011,80100267,,,,29,36,65
HND-007591,2011,80100268,,,,39,36,75
,2011,80100270,,,,8,5,13
,2011,80100273,,,,3,4,7
HND-007592,2011,80100275,,,,38,35,73
HND-007593,2011,80100276,,,,18,15,33
,2011,80100279,,,,51,36,87
,2011,80100283,,,,4,1,5
HND-007594,2011,80100286,,,,4,5,9
,2011,80100288,,,,4,3,7
HND-007596,2011,80100290,,,,36,29,65
,2011,80100291,,,,5,15,20
HND-007597,2011,80100292,,,,20,19,39
HND-007598,2011,80100293,,,,41,42,83
HND-007599,2011,80100294,,,,27,36,63
HND-007603,2011,80100299,,,,33,31,64
,2011,80100300,,,,4,4,8
,2011,80100301,,,,15,12,27
,2011,80100308,,,,5,2,7
,2011,80100312,,,,23,13,36
HND-007606,2011,80100315,,,,27,22,49
HND-007608,2011,80100318,,,,7,6,13
,2011,80100319,,,,17,17,34
,2011,80100320,,,,0,2,2
HND-007611,2011,80100328,,,,21,30,51
,2011,80100332,,,,13,16,29
HND-007612,2011,80100333,,,,32,38,70
HND-007613,2011,80100334,,,,21,18,39
,2011,80100335,,,,37,25,62
,2011,80100336,,,,9,5,14
HND-007614,2011,80100340,,,,18,24,42
HND-007615,2011,80100341,,,,29,23,52
HND-007616,2011,80100342,,,,52,49,101
,2011,80100344,,,,7,8,15
HND-007619,2011,80100351,,,,13,10,23
HND-007620,2011,80100352,,,,40,35,75
HND-007622,2011,80100354,,,,0,1,1
,2011,80100355,,,,20,22,42
,2011,80100356,,,,7,8,15
HND-007623,2011,80100357,,,,66,56,122
,2011,80100361,,,,13,9,22
HND-007625,2011,80100363,,,,9,8,17
HND-007626,2011,80100364,,,,30,43,73
HND-007629,2011,80100368,,,,16,16,32
,2011,80100375,,,,15,14,29
HND-007633,2011,80100376,,,,11,8,19
HND-007634,2011,80100377,,,,1,6,7
,2011,80100378,,,,9,1,10
,2011,80100383,,,,11,13,24
,2011,80100384,,,,2,1,3
HND-007636,2011,80100385,,,,57,50,107
HND-007637,2011,80100387,,,,41,33,74
HND-007639,2011,80100392,,,,1,1,2
HND-007640,2011,80100393,,,,2,4,6
,2011,80100395,,,,18,17,35
HND-007641,2011,80100398,,,,11,5,16
HND-007643,2011,80100400,,,,28,40,68
HND-007644,2011,80100401,,,,38,31,69
,2011,80100403,,,,13,6,19
,2011,80100404,,,,3,2,5
,2011,80100407,,,,202,200,402
HND-007646,2011,80100411,,,,42,42,84
HND-007647,2011,80100413,,,,6,7,13
HND-007649,2011,80100415,,,,5,2,7
,2011,80100420,,,,9,12,21
HND-007653,2011,80100421,,,,7,3,10
HND-007657,2011,80100425,,,,52,56,108
,2011,80100426,,,,15,9,24
,2011,80100427,,,,11,12,23
,2011,80100428,,,,32,35,67
HND-007659,2011,80100429,,,,7,9,16
HND-007660,2011,80100433,,,,48,40,88
,2011,80100435,,,,14,6,20
,2011,80100436,,,,14,18,32
,2011,80100438,,,,27,21,48
HND-007676,2011,80100459,,,,16,14,30
,2011,80100465,,,,4,4,8
,2011,80100494,,,,5,4,9
,2011,80100499,,,,21,9,30
,2011,80100508,,,,18,20,38
HND-007710,2011,80100521,,,,73,59,132
,2011,80100541,,,,17,8,25
HND-007722,2011,80100543,,,,31,21,52
,2011,80100557,,,,9,4,13
,2011,80100565,,,,11,9,20
HND-007729,2011,80100568,,,,10,11,21
,2011,80100581,,,,7,10,17
,2011,80100586,,,,16,12,28
HND-007743,2011,80100598,,,,18,24,42
HND-007745,2011,80100603,,,,55,57,112
,2011,80100635,,,,33,40,73
,2011,80100637,,,,13,11,24
,2011,80100658,,,,5,3,8
HND-007796,2011,80100728,,,,1,0,1
HND-007798,2011,80100734,,,,37,44,81
,2011,80100742,,,,5,10,15
HND-007802,2011,80100753,,,,19,22,41
,2011,80100767,,,,17,17,34
,2011,80100791,,,,2,4,6
,2011,80100792,,,,1,2,3
HND-007820,2011,80100800,,,,21,19,40
,2011,80100802,,,,10,11,21
,2011,80100811,,,,5,3,8
HND-007826,2011,80100823,,,,77,81,158
HND-007828,2011,80100826,,,,20,15,35
,2011,80100846,,,,9,7,16
HND-007846,2011,80100860,,,,1,3,4
HND-007847,2011,80100864,,,,19,14,33
,2011,80100877,,,,8,4,12
HND-007861,2011,80100896,,,,37,35,72
HND-007865,2011,80100905,,,,40,28,68
HND-007868,2011,80100911,,,,19,19,38
HND-007872,2011,80100929,,,,13,14,27
,2011,80100933,,,,6,7,13
,2011,80100944,,,,12,11,23
,2011,80100948,,,,24,24,48
,2011,80100954,,,,4,2,6
,2011,80100968,,,,2,1,3
,2011,80100969,,,,4,8,12
,2011,80100970,,,,11,11,22
,2011,80100980,,,,6,5,11
,2011,80101006,,,,2,0,2
,2011,80101007,,,,26,21,47
,2011,80101010,,,,1,0,1
,2011,80101014,,,,23,32,55
,2011,80101028,,,,6,8,14
HND-007893,2011,80101032,,,,2,5,7
HND-007894,2011,80101035,,,,12,14,26
,2011,80101083,,,,2,2,4
HND-007900,2011,80101100,,,,30,38,68
HND-007902,2011,80101106,,,,28,26,54
,2011,80101134,,,,53,68,121
,2011,80101139,,,,15,7,22
,2011,80101145,,,,10,12,22
,2011,80101157,,,,12,12,24
,2011,80101158,,,,3,7,10
,2011,80101200,,,,11,14,25
,2011,80101203,,,,2,1,3
,2011,80101209,,,,7,2,9
,2011,80101212,,,,1,0,1
,2011,80101222,,,,6,7,13
,2011,80101259,,,,32,32,64
,2011,80101262,,,,10,7,17
,2011,80101264,,,,3,1,4
HND-007923,2011,80101274,,,,12,9,21
,2011,80101293,,,,6,11,17
,2011,80101308,,,,6,7,13
,2011,80101318,,,,1,3,4
,2011,80101357,,,,1,0,1
,2011,80101365,,,,13,8,21
,2011,80101370,,,,8,7,15
HND-007931,2011,80101448,,,,17,17,34
,2011,80101480,,,,9,17,26
,2011,80101481,,,,11,11,22
,2011,80101483,,,,12,12,24
HND-007933,2011,80101486,,,,2,0,2
,2011,80101491,,,,2,7,9
,2011,80101493,,,,1,9,10
,2011,80101501,,,,0,1,1
,2011,80101542,,,,2,2,4
,2011,80101543,,,,6,4,10
,2011,80101551,,,,1,2,3
,2011,80101552,,,,1,2,3
,2011,80101553,,,,11,11,22
,2011,80101571,,,,4,4,8
,2011,80101586,,,,0,2,2
,2011,80101615,,,,3,2,5
,2011,80101622,,,,0,7,7
HND-007973,2011,80101649,,,,6,10,16
,2011,80101650,,,,5,5,10
,2011,80101651,,,,0,1,1
,2011,80101652,,,,4,4,8
,2011,80101653,,,,2,2,4
,2011,80101672,,,,4,1,5
,2011,80101673,,,,55,0,55
,2011,80101676,,,,16,22,38
,2011,80101683,,,,2,3,5
,2011,80101690,,,,6,5,11
,2011,80101692,,,,9,14,23
,2011,80101705,,,,4,3,7
HND-007388,2011,80100001,,,,17,14,31
HND-007392,2011,80100005,,,,30,35,65
HND-007393,2011,80100006,,,,50,40,90
HND-007394,2011,80100007,,,,5,3,8
HND-007395,2011,80100008,,,,66,47,113
,2011,80100009,,,,39,32,71
HND-007396,2011,80100011,,,,24,7,31
HND-007397,2011,80100012,,,,5,2,7
HND-007401,2011,80100017,,,,75,43,118
HND-007404,2011,80100019,,,,15,17,32
HND-007403,2011,80100019,,,,15,17,32
HND-007405,2011,80100020,,,,4,6,10
HND-007408,2011,80100023,,,,6,4,10
HND-007409,2011,80100024,,,,11,14,25
HND-007410,2011,80100025,,,,28,26,54
HND-007413,2011,80100029,,,,8,10,18
HND-007415,2011,80100031,,,,5,6,11
HND-007416,2011,80100032,,,,2,2,4
HND-007419,2011,80100035,,,,82,69,151
HND-007423,2011,80100041,,,,12,9,21
,2011,80100045,,,,17,19,36
HND-007429,2011,80100050,,,,53,49,102
HND-007430,2011,80100051,,,,67,40,107
HND-007431,2011,80100052,,,,25,20,45
,2011,80100053,,,,48,37,85
HND-007435,2011,80100057,,,,5,3,8
HND-007436,2011,80100058,,,,1,1,2
,2011,80100059,,,,62,55,117
HND-007442,2011,80100064,,,,58,63,121
,2011,80100069,,,,40,31,71
HND-007444,2011,80100070,,,,4,10,14
HND-007445,2011,80100071,,,,56,62,118
HND-007447,2011,80100073,,,,9,15,24
HND-007454,2011,80100080,,,,48,50,98
HND-007455,2011,80100081,,,,52,59,111
HND-007456,2011,80100082,,,,24,35,59
HND-007459,2011,80100085,,,,6,5,11
HND-007460,2011,80100086,,,,5,1,6
HND-007461,2011,80100087,,,,7,3,10
HND-007462,2011,80100088,,,,4,5,9
HND-007464,2011,80100090,,,,31,25,56
HND-007465,2011,80100091,,,,48,54,102
HND-007469,2011,80100095,,,,1,3,4
HND-007471,2011,80100097,,,,15,19,34
HND-007472,2011,80100098,,,,5,7,12
HND-007474,2011,80100103,,,,10,10,20
HND-007480,2011,80100110,,,,39,22,61
HND-007481,2011,80100111,,,,28,26,54
HND-007482,2011,80100112,,,,37,21,58
,2011,80100115,,,,37,37,74
HND-007483,2011,80100116,,,,13,18,31
HND-007484,2011,80100117,,,,33,28,61
HND-007489,2011,80100122,,,,16,11,27
HND-007490,2011,80100123,,,,4,0,4
HND-007495,2011,80100128,,,,4,9,13
HND-007496,2011,80100129,,,,12,7,19
HND-007497,2011,80100130,,,,34,14,48
HND-007498,2011,80100131,,,,19,14,33
HND-007499,2011,80100132,,,,4,7,11
HND-007500,2011,80100133,,,,83,73,156
HND-007504,2011,80100138,,,,12,11,23
,2011,80100139,,,,4,4,8
HND-007505,2011,80100140,,,,4,8,12
HND-007507,2011,80100142,,,,7,7,14
,2011,80100143,,,,43,34,77
HND-007508,2011,80100144,,,,46,42,88
HND-007512,2011,80100149,,,,48,43,91
HND-007513,2011,80100150,,,,16,13,29
HND-007514,2011,80100151,,,,9,6,15
HND-007515,2011,80100152,,,,47,37,84
,2011,80100154,,,,6,10,16
,2011,80100156,,,,35,23,58
HND-007516,2011,80100157,,,,24,45,69
HND-007518,2011,80100159,,,,9,9,18
HND-007519,2011,80100161,,,,7,7,14
HND-007520,2011,80100162,,,,7,9,16
HND-007522,2011,80100165,,,,6,12,18
HND-007523,2011,80100166,,,,5,7,12
HND-007525,2011,80100168,,,,46,41,87
HND-007526,2011,80100169,,,,42,44,86
,2011,80100173,,,,13,13,26
HND-007529,2011,80100174,,,,36,38,74
HND-007530,2011,80100175,,,,17,18,35
HND-007534,2011,80100179,,,,2,0,2
HND-007535,2011,80100180,,,,3,6,9
HND-007538,2011,80100183,,,,0,25,25
HND-007539,2011,80100184,,,,56,41,97
HND-007545,2011,80100189,,,,87,99,186
HND-007546,2011,80100190,,,,87,67,154
HND-007547,2011,80100191,,,,53,55,108
HND-007548,2011,80100192,,,,60,84,144
HND-007550,2011,80100195,,,,76,0,76
HND-007551,2011,80100196,,,,0,68,68
,2011,80100197,,,,27,16,43
HND-007552,2011,80100198,,,,37,34,71
HND-007554,2011,80100200,,,,14,6,20
,2011,80100201,,,,15,2,17
,2011,80100203,,,,15,12,27
,2011,80100205,,,,18,9,27
,2011,80100208,,,,41,46,87
,2011,80100212,,,,32,0,32
HND-007556,2011,80100214,,,,9,3,12
,2011,80100215,,,,7,7,14
,2011,80100217,,,,18,18,36
,2011,80100219,,,,14,15,29
HND-007558,2011,80100220,,,,58,74,132
HND-007560,2011,80100222,,,,30,38,68
HND-007561,2011,80100223,,,,8,13,21
,2011,80100224,,,,41,37,78
HND-007564,2011,80100228,,,,26,22,48
HND-007565,2011,80100229,,,,0,5,5
,2011,80100230,,,,0,39,39
HND-007567,2011,80100232,,,,7,6,13
HND-007568,2011,80100233,,,,10,9,19
HND-007569,2011,80100234,,,,20,15,35
HND-007570,2011,80100235,,,,25,32,57
HND-007571,2011,80100236,,,,56,47,103
,2011,80100239,,,,8,10,18
HND-007572,2011,80100241,,,,93,87,180
HND-007573,2011,80100242,,,,35,12,47
HND-007574,2011,80100243,,,,32,27,59
HND-007578,2011,80100249,,,,20,32,52
,2011,80100250,,,,43,49,92
HND-007580,2011,80100252,,,,34,23,57
,2011,80100253,,,,7,4,11
HND-007581,2011,80100254,,,,3,3,6
HND-007586,2011,80100260,,,,33,45,78
HND-007587,2011,80100262,,,,60,73,133
,2011,80100264,,,,57,61,118
,2011,80100278,,,,14,11,25
,2011,80100282,,,,9,11,20
,2011,80100284,,,,31,25,56
HND-007595,2011,80100287,,,,14,15,29
HND-007600,2011,80100295,,,,28,25,53
HND-007601,2011,80100296,,,,22,24,46
HND-007602,2011,80100298,,,,57,50,107
HND-007604,2011,80100302,,,,10,8,18
,2011,80100303,,,,27,21,48
,2011,80100304,,,,1,3,4
,2011,80100305,,,,17,4,21
,2011,80100306,,,,35,22,57
HND-007605,2011,80100307,,,,35,44,79
,2011,80100310,,,,1,0,1
HND-007607,2011,80100316,,,,0,3,3
,2011,80100317,,,,39,43,82
HND-007609,2011,80100322,,,,19,19,38
,2011,80100324,,,,7,4,11
HND-007610,2011,80100325,,,,95,79,174
,2011,80100326,,,,3,2,5
,2011,80100329,,,,12,9,21
,2011,80100330,,,,5,6,11
,2011,80100337,,,,21,18,39
,2011,80100345,,,,3,4,7
,2011,80100346,,,,31,26,57
,2011,80100350,,,,18,11,29
HND-007621,2011,80100353,,,,28,25,53
HND-007624,2011,80100359,,,,12,22,34
,2011,80100362,,,,9,4,13
HND-007627,2011,80100366,,,,30,34,64
HND-007628,2011,80100367,,,,14,13,27
HND-007630,2011,80100369,,,,25,34,59
HND-007631,2011,80100370,,,,11,4,15
,2011,80100371,,,,8,10,18
HND-007632,2011,80100373,,,,20,16,36
,2011,80100374,,,,8,1,9
,2011,80100380,,,,6,9,15
,2011,80100388,,,,13,14,27
HND-007638,2011,80100391,,,,80,72,152
,2011,80100396,,,,15,13,28
HND-007642,2011,80100399,,,,30,30,60
,2011,80100405,,,,4,2,6
,2011,80100406,,,,26,35,61
HND-007645,2011,80100408,,,,24,19,43
,2011,80100409,,,,23,35,58
,2011,80100410,,,,4,2,6
HND-007648,2011,80100414,,,,3,1,4
HND-007650,2011,80100416,,,,3,2,5
HND-007651,2011,80100417,,,,4,9,13
,2011,80100418,,,,29,24,53
HND-007654,2011,80100422,,,,28,27,55
HND-007655,2011,80100423,,,,10,15,25
HND-007656,2011,80100424,,,,42,31,73
,2011,80100430,,,,13,12,25
,2011,80100432,,,,7,2,9
HND-007661,2011,80100434,,,,9,7,16
,2011,80100446,,,,9,3,12
HND-007700,2011,80100502,,,,27,27,54
,2011,80100547,,,,14,13,27
,2011,80100560,,,,14,12,26
,2011,80100582,,,,11,17,28
,2011,80100583,,,,3,1,4
,2011,80100599,,,,11,15,26
,2011,80100615,,,,6,9,15
HND-007752,2011,80100619,,,,12,19,31
,2011,80100622,,,,21,21,42
,2011,80100660,,,,8,16,24
,2011,80100663,,,,18,13,31
,2011,80100675,,,,48,36,84
HND-007768,2011,80100677,,,,40,37,77
,2011,80100722,,,,9,7,16
HND-007797,2011,80100730,,,,3,1,4
,2011,80100736,,,,6,3,9
,2011,80100749,,,,1,5,6
,2011,80100757,,,,9,7,16
HND-007803,2011,80100760,,,,5,14,19
HND-007804,2011,80100762,,,,27,32,59
HND-007823,2011,80100804,,,,14,10,24
HND-007824,2011,80100816,,,,27,18,45
HND-007825,2011,80100822,,,,31,37,68
HND-007827,2011,80100825,,,,3,1,4
,2011,80100829,,,,8,10,18
,2011,80100831,,,,5,3,8
HND-007848,2011,80100865,,,,75,59,134
HND-007849,2011,80100866,,,,21,20,41
HND-007850,2011,80100867,,,,25,34,59
HND-007851,2011,80100868,,,,49,40,89
,2011,80100882,,,,42,44,86
HND-007855,2011,80100885,,,,16,20,36
HND-007856,2011,80100890,,,,17,30,47
,2011,80100892,,,,11,13,24
HND-007858,2011,80100893,,,,12,14,26
HND-007862,2011,80100897,,,,25,11,36
HND-007867,2011,80100910,,,,37,41,78
,2011,80100915,,,,15,9,24
HND-007873,2011,80100932,,,,2,7,9
,2011,80100934,,,,1,1,2
,2011,80100935,,,,21,17,38
,2011,80100966,,,,11,20,31
,2011,80100971,,,,8,4,12
,2011,80100985,,,,1,0,1
,2011,80100990,,,,39,40,79
,2011,80100997,,,,2,0,2
HND-007885,2011,80100999,,,,3,3,6
HND-007886,2011,80101002,,,,8,4,12
,2011,80101004,,,,7,3,10
HND-007887,2011,80101008,,,,3,4,7
HND-007888,2011,80101009,,,,24,12,36
HND-007890,2011,80101020,,,,1,2,3
,2011,80101021,,,,10,6,16
HND-007891,2011,80101022,,,,19,22,41
HND-007892,2011,80101023,,,,11,13,24
,2011,80101025,,,,2,5,7
,2011,80101030,,,,11,28,39
,2011,80101033,,,,16,19,35
,2011,80101039,,,,3,9,12
,2011,80101071,,,,36,26,62
,2011,80101087,,,,4,2,6
HND-007901,2011,80101103,,,,29,30,59
HND-007903,2011,80101111,,,,36,30,66
HND-007905,2011,80101117,,,,5,6,11
HND-007908,2011,80101123,,,,7,5,12
,2011,80101125,,,,6,4,10
,2011,80101130,,,,8,13,21
HND-007911,2011,80101153,,,,28,23,51
,2011,80101161,,,,14,13,27
,2011,80101164,,,,12,4,16
,2011,80101184,,,,7,7,14
,2011,80101186,,,,1,6,7
,2011,80101187,,,,1,3,4
,2011,80101195,,,,2,6,8
,2011,80101197,,,,4,3,7
,2011,80101204,,,,32,31,63
,2011,80101205,,,,12,11,23
,2011,80101206,,,,10,8,18
,2011,80101207,,,,2,3,5
,2011,80101210,,,,0,2,2
,2011,80101213,,,,3,2,5
,2011,80101215,,,,6,2,8
,2011,80101260,,,,2,2,4
,2011,80101263,,,,4,3,7
,2011,80101268,,,,6,5,11
HND-007925,2011,80101282,,,,17,15,32
,2011,80101297,,,,7,5,12
,2011,80101307,,,,4,5,9
,2011,80101309,,,,4,12,16
,2011,80101312,,,,7,13,20
,2011,80101315,,,,2,4,6
,2011,80101317,,,,3,3,6
,2011,80101361,,,,1,6,7
,2011,80101436,,,,0,3,3
,2011,80101464,,,,12,16,28
,2011,80101476,,,,3,5,8
,2011,80101488,,,,2,2,4
,2011,80101495,,,,7,5,12
,2011,80101496,,,,15,13,28
,2011,80101499,,,,5,5,10
,2011,80101500,,,,5,7,12
,2011,80101546,,,,1,1,2
,2011,80101548,,,,0,1,1
,2011,80101549,,,,0,4,4
,2011,80101550,,,,1,2,3
,2011,80101554,,,,0,2,2
,2011,80101555,,,,1,0,1
,2011,80101556,,,,2,2,4
HND-007944,2011,80101560,,,,16,19,35
HND-007947,2011,80101572,,,,4,10,14
HND-007952,2011,80101587,,,,1,3,4
,2011,80101588,,,,1,0,1
,2011,80101592,,,,0,2,2
,2011,80101593,,,,1,6,7
,2011,80101605,,,,5,2,7
,2011,80101607,,,,10,12,22
,2011,80101617,,,,9,5,14
,2011,80101634,,,,8,7,15
,2011,80101665,,,,0,8,8
,2011,80101685,,,,1,6,7
,2011,80101700,,,,3,3,6
,2011,80101707,,,,0,2,2
HND-007984,2011,80101709,,,,1,0,1
HND-007389,2011,80100002,,,,13,13,26
HND-007390,2011,80100003,,,,13,9,22
HND-007391,2011,80100004,,,,4,2,6
,2011,80100009,,,,34,48,82
HND-007397,2011,80100012,,,,5,3,8
HND-007398,2011,80100014,,,,4,10,14
HND-007399,2011,80100015,,,,94,93,187
HND-007401,2011,80100017,,,,66,68,134
HND-007402,2011,80100018,,,,76,63,139
HND-007404,2011,80100019,,,,15,8,23
HND-007403,2011,80100019,,,,15,8,23
HND-007407,2011,80100022,,,,34,31,65
HND-007409,2011,80100024,,,,12,9,21
HND-007411,2011,80100026,,,,10,4,14
HND-007412,2011,80100027,,,,5,7,12
HND-007415,2011,80100031,,,,7,6,13
HND-007416,2011,80100032,,,,2,3,5
HND-007421,2011,80100039,,,,49,39,88
HND-007426,2011,80100044,,,,39,35,74
,2011,80100045,,,,22,14,36
HND-007429,2011,80100050,,,,63,39,102
HND-007430,2011,80100051,,,,65,39,104
HND-007431,2011,80100052,,,,19,28,47
,2011,80100053,,,,39,38,77
HND-007435,2011,80100057,,,,5,3,8
HND-007436,2011,80100058,,,,3,1,4
,2011,80100059,,,,58,50,108
HND-007439,2011,80100061,,,,65,49,114
HND-007440,2011,80100062,,,,2,0,2
HND-007443,2011,80100066,,,,5,3,8
,2011,80100067,,,,6,1,7
HND-007444,2011,80100070,,,,5,1,6
HND-007447,2011,80100073,,,,7,16,23
HND-007448,2011,80100074,,,,20,13,33
HND-007454,2011,80100080,,,,42,48,90
HND-007455,2011,80100081,,,,58,44,102
HND-007456,2011,80100082,,,,24,30,54
HND-007458,2011,80100084,,,,11,6,17
HND-007459,2011,80100085,,,,6,7,13
HND-007460,2011,80100086,,,,0,2,2
HND-007461,2011,80100087,,,,4,0,4
HND-007462,2011,80100088,,,,6,4,10
HND-007464,2011,80100090,,,,21,16,37
HND-007465,2011,80100091,,,,61,58,119
HND-007468,2011,80100094,,,,3,8,11
HND-007469,2011,80100095,,,,2,4,6
HND-007471,2011,80100097,,,,25,19,44
HND-007475,2011,80100104,,,,0,2,2
HND-007476,2011,80100105,,,,9,4,13
HND-007477,2011,80100106,,,,6,3,9
HND-007479,2011,80100109,,,,39,28,67
,2011,80100113,,,,69,65,134
HND-007483,2011,80100116,,,,16,8,24
HND-007484,2011,80100117,,,,35,41,76
HND-007485,2011,80100118,,,,3,3,6
HND-007488,2011,80100121,,,,13,16,29
HND-007491,2011,80100124,,,,17,13,30
HND-007492,2011,80100125,,,,12,6,18
,2011,80100126,,,,3,1,4
HND-007494,2011,80100127,,,,11,18,29
HND-007502,2011,80100135,,,,22,14,36
HND-007503,2011,80100137,,,,17,10,27
,2011,80100139,,,,5,5,10
HND-007506,2011,80100141,,,,8,6,14
HND-007509,2011,80100146,,,,61,49,110
HND-007510,2011,80100147,,,,47,46,93
HND-007511,2011,80100148,,,,76,0,76
HND-007517,2011,80100158,,,,6,15,21
HND-007520,2011,80100162,,,,12,8,20
HND-007521,2011,80100163,,,,3,1,4
,2011,80100164,,,,13,18,31
HND-007524,2011,80100167,,,,44,44,88
HND-007527,2011,80100170,,,,50,47,97
HND-007528,2011,80100172,,,,0,149,149
HND-007533,2011,80100178,,,,28,30,58
HND-007534,2011,80100179,,,,2,2,4
HND-007536,2011,80100181,,,,40,41,81
HND-007537,2011,80100182,,,,13,14,27
HND-007540,2011,80100185,,,,131,117,248
HND-007541,2011,80100186,,,,27,20,47
HND-007543,2011,80100187,,,,29,39,68
HND-007542,2011,80100187,,,,29,39,68
HND-007544,2011,80100188,,,,48,54,102
HND-007548,2011,80100192,,,,72,82,154
,2011,80100193,,,,69,84,153
HND-007552,2011,80100198,,,,54,49,103
HND-007553,2011,80100199,,,,67,72,139
,2011,80100202,,,,17,15,32
,2011,80100204,,,,11,13,24
HND-007555,2011,80100210,,,,14,13,27
,2011,80100211,,,,0,44,44
,2011,80100215,,,,10,6,16
,2011,80100216,,,,3,6,9
,2011,80100217,,,,32,26,58
HND-007557,2011,80100218,,,,12,5,17
HND-007559,2011,80100221,,,,12,27,39
HND-007561,2011,80100223,,,,6,5,11
,2011,80100225,,,,39,31,70
HND-007562,2011,80100226,,,,33,39,72
HND-007565,2011,80100229,,,,5,0,5
HND-007566,2011,80100231,,,,22,18,40
HND-007570,2011,80100235,,,,31,29,60
HND-007571,2011,80100236,,,,79,86,165
,2011,80100237,,,,42,39,81
,2011,80100244,,,,34,35,69
,2011,80100245,,,,50,53,103
HND-007575,2011,80100246,,,,16,17,33
HND-007576,2011,80100247,,,,19,16,35
HND-007579,2011,80100251,,,,13,9,22
HND-007582,2011,80100255,,,,5,0,5
HND-007583,2011,80100256,,,,44,44,88
HND-007584,2011,80100258,,,,23,24,47
HND-007588,2011,80100263,,,,3,5,8
,2011,80100264,,,,47,56,103
,2011,80100265,,,,21,17,38
HND-007589,2011,80100266,,,,27,29,56
HND-007590,2011,80100267,,,,36,26,62
HND-007591,2011,80100268,,,,56,48,104
,2011,80100270,,,,7,11,18
,2011,80100273,,,,4,1,5
,2011,80100279,,,,40,57,97
HND-007594,2011,80100286,,,,4,6,10
,2011,80100288,,,,1,5,6
HND-007596,2011,80100290,,,,23,26,49
,2011,80100291,,,,15,7,22
HND-007597,2011,80100292,,,,24,21,45
HND-007598,2011,80100293,,,,56,44,100
HND-007599,2011,80100294,,,,59,46,105
HND-007603,2011,80100299,,,,14,25,39
,2011,80100300,,,,6,6,12
HND-007605,2011,80100307,,,,35,41,76
,2011,80100312,,,,6,8,14
HND-007606,2011,80100315,,,,28,23,51
HND-007608,2011,80100318,,,,5,5,10
,2011,80100319,,,,15,15,30
HND-007611,2011,80100328,,,,18,23,41
,2011,80100332,,,,12,14,26
HND-007612,2011,80100333,,,,27,20,47
HND-007613,2011,80100334,,,,10,22,32
HND-007614,2011,80100340,,,,20,15,35
HND-007615,2011,80100341,,,,37,28,65
HND-007619,2011,80100351,,,,14,11,25
HND-007620,2011,80100352,,,,43,36,79
HND-007621,2011,80100353,,,,27,17,44
HND-007622,2011,80100354,,,,3,0,3
,2011,80100355,,,,27,31,58
,2011,80100356,,,,2,5,7
HND-007623,2011,80100357,,,,51,70,121
HND-007624,2011,80100359,,,,13,19,32
HND-007628,2011,80100367,,,,16,21,37
HND-007629,2011,80100368,,,,13,27,40
,2011,80100375,,,,33,24,57
HND-007634,2011,80100377,,,,5,4,9
,2011,80100378,,,,4,2,6
,2011,80100383,,,,10,14,24
,2011,80100384,,,,3,5,8
HND-007636,2011,80100385,,,,60,62,122
HND-007637,2011,80100387,,,,31,47,78
HND-007639,2011,80100392,,,,2,1,3
HND-007640,2011,80100393,,,,7,4,11
,2011,80100395,,,,11,15,26
,2011,80100396,,,,6,11,17
HND-007641,2011,80100398,,,,7,9,16
HND-007643,2011,80100400,,,,45,56,101
HND-007644,2011,80100401,,,,37,35,72
,2011,80100403,,,,12,10,22
,2011,80100404,,,,3,3,6
HND-007646,2011,80100411,,,,41,41,82
HND-007647,2011,80100413,,,,2,5,7
HND-007649,2011,80100415,,,,4,6,10
HND-007650,2011,80100416,,,,3,1,4
HND-007653,2011,80100421,,,,8,6,14
HND-007656,2011,80100424,,,,42,40,82
HND-007657,2011,80100425,,,,48,48,96
,2011,80100426,,,,24,19,43
,2011,80100427,,,,7,7,14
HND-007659,2011,80100429,,,,6,9,15
,2011,80100430,,,,10,8,18
,2011,80100435,,,,9,10,19
,2011,80100436,,,,15,14,29
,2011,80100438,,,,23,14,37
,2011,80100446,,,,7,6,13
HND-007676,2011,80100459,,,,14,20,34
,2011,80100465,,,,5,5,10
,2011,80100494,,,,1,4,5
,2011,80100508,,,,20,16,36
HND-007710,2011,80100521,,,,83,74,157
,2011,80100541,,,,22,9,31
HND-007722,2011,80100543,,,,24,17,41
,2011,80100560,,,,15,17,32
,2011,80100565,,,,15,15,30
HND-007729,2011,80100568,,,,13,6,19
,2011,80100581,,,,8,3,11
,2011,80100586,,,,10,15,25
HND-007745,2011,80100603,,,,70,60,130
,2011,80100635,,,,29,32,61
HND-007768,2011,80100677,,,,33,47,80
HND-007796,2011,80100728,,,,1,0,1
,2011,80100742,,,,9,9,18
HND-007802,2011,80100753,,,,32,25,57
,2011,80100791,,,,1,2,3
,2011,80100792,,,,2,3,5
HND-007820,2011,80100800,,,,24,22,46
,2011,80100802,,,,8,10,18
HND-007823,2011,80100804,,,,7,8,15
HND-007828,2011,80100826,,,,26,30,56
,2011,80100846,,,,5,5,10
HND-007847,2011,80100864,,,,22,18,40
,2011,80100877,,,,5,4,9
HND-007856,2011,80100890,,,,15,18,33
HND-007861,2011,80100896,,,,33,27,60
HND-007865,2011,80100905,,,,39,41,80
HND-007868,2011,80100911,,,,17,19,36
HND-007872,2011,80100929,,,,14,22,36
HND-007873,2011,80100932,,,,3,3,6
,2011,80100933,,,,6,2,8
,2011,80100934,,,,1,1,2
,2011,80100966,,,,13,16,29
,2011,80100968,,,,0,1,1
,2011,80100980,,,,8,5,13
,2011,80100990,,,,51,45,96
,2011,80101005,,,,1,0,1
,2011,80101006,,,,1,8,9
,2011,80101007,,,,17,23,40
,2011,80101014,,,,29,22,51
,2011,80101025,,,,2,6,8
,2011,80101028,,,,16,9,25
HND-007893,2011,80101032,,,,0,1,1
,2011,80101033,,,,23,16,39
HND-007894,2011,80101035,,,,11,13,24
,2011,80101039,,,,2,4,6
,2011,80101083,,,,2,3,5
HND-007900,2011,80101100,,,,24,22,46
HND-007902,2011,80101106,,,,26,36,62
,2011,80101125,,,,3,0,3
,2011,80101134,,,,48,55,103
,2011,80101139,,,,12,11,23
,2011,80101145,,,,7,5,12
,2011,80101157,,,,26,18,44
,2011,80101203,,,,2,2,4
,2011,80101204,,,,26,29,55
,2011,80101207,,,,3,2,5
,2011,80101209,,,,5,7,12
,2011,80101215,,,,2,3,5
,2011,80101222,,,,7,5,12
,2011,80101260,,,,2,1,3
,2011,80101268,,,,12,11,23
,2011,80101293,,,,13,10,23
,2011,80101307,,,,9,9,18
,2011,80101308,,,,3,4,7
,2011,80101310,,,,3,0,3
,2011,80101318,,,,3,2,5
,2011,80101357,,,,3,1,4
,2011,80101365,,,,8,15,23
,2011,80101370,,,,3,8,11
HND-007931,2011,80101448,,,,12,20,32
,2011,80101464,,,,13,19,32
,2011,80101476,,,,3,2,5
,2011,80101481,,,,5,10,15
,2011,80101483,,,,8,15,23
,2011,80101501,,,,0,1,1
,2011,80101543,,,,8,10,18
,2011,80101549,,,,3,0,3
,2011,80101553,,,,14,6,20
,2011,80101555,,,,0,4,4
HND-007944,2011,80101560,,,,22,23,45
,2011,80101571,,,,8,4,12
HND-007952,2011,80101587,,,,2,6,8
,2011,80101588,,,,3,0,3
,2011,80101593,,,,1,5,6
,2011,80101599,,,,1,0,1
,2011,80101615,,,,4,4,8
,2011,80101617,,,,9,10,19
,2011,80101622,,,,5,5,10
HND-007973,2011,80101649,,,,4,3,7
,2011,80101650,,,,3,2,5
,2011,80101651,,,,2,3,5
,2011,80101652,,,,3,1,4
,2011,80101653,,,,0,1,1
,2011,80101672,,,,1,2,3
,2011,80101676,,,,10,14,24
,2011,80101681,,,,1,1,2
,2011,80101685,,,,2,6,8
,2011,80101690,,,,3,3,6
,2011,80101707,,,,2,0,2
HND-007388,2011,80100001,,,,23,30,53
HND-007392,2011,80100005,,,,36,36,72
HND-007393,2011,80100006,,,,30,35,65
HND-007394,2011,80100007,,,,3,4,7
HND-007395,2011,80100008,,,,62,34,96
HND-007396,2011,80100011,,,,20,12,32
HND-007400,2011,80100016,,,,17,19,36
HND-007405,2011,80100020,,,,1,13,14
HND-007406,2011,80100021,,,,1,5,6
HND-007408,2011,80100023,,,,6,5,11
HND-007410,2011,80100025,,,,29,29,58
,2011,80100028,,,,7,0,7
HND-007413,2011,80100029,,,,13,7,20
HND-007414,2011,80100030,,,,65,52,117
HND-007417,2011,80100033,,,,28,22,50
HND-007418,2011,80100034,,,,4,4,8
HND-007419,2011,80100035,,,,86,67,153
HND-007420,2011,80100038,,,,41,39,80
HND-007422,2011,80100040,,,,32,36,68
HND-007423,2011,80100041,,,,17,10,27
HND-007425,2011,80100043,,,,31,25,56
HND-007427,2011,80100048,,,,8,5,13
HND-007428,2011,80100049,,,,51,52,103
HND-007432,2011,80100054,,,,46,52,98
HND-007433,2011,80100055,,,,19,14,33
HND-007434,2011,80100056,,,,24,33,57
HND-007438,2011,80100060,,,,15,23,38
HND-007442,2011,80100064,,,,53,51,104
,2011,80100069,,,,37,42,79
HND-007445,2011,80100071,,,,75,55,130
HND-007446,2011,80100072,,,,25,21,46
HND-007449,2011,80100075,,,,4,4,8
HND-007450,2011,80100076,,,,8,7,15
HND-007451,2011,80100077,,,,18,13,31
HND-007452,2011,80100078,,,,7,4,11
HND-007453,2011,80100079,,,,70,59,129
,2011,80100083,,,,2,4,6
HND-007463,2011,80100089,,,,2,5,7
HND-007466,2011,80100092,,,,10,9,19
HND-007467,2011,80100093,,,,9,2,11
HND-007470,2011,80100096,,,,13,8,21
HND-007472,2011,80100098,,,,8,3,11
,2011,80100099,,,,36,27,63
HND-007473,2011,80100102,,,,8,14,22
HND-007474,2011,80100103,,,,10,8,18
HND-007478,2011,80100108,,,,12,23,35
HND-007480,2011,80100110,,,,38,28,66
HND-007481,2011,80100111,,,,50,36,86
HND-007482,2011,80100112,,,,44,34,78
,2011,80100115,,,,51,51,102
HND-007486,2011,80100119,,,,13,7,20
HND-007487,2011,80100120,,,,2,1,3
HND-007489,2011,80100122,,,,4,8,12
HND-007490,2011,80100123,,,,2,1,3
HND-007495,2011,80100128,,,,7,6,13
HND-007496,2011,80100129,,,,12,9,21
HND-007497,2011,80100130,,,,21,19,40
HND-007498,2011,80100131,,,,19,19,38
HND-007499,2011,80100132,,,,5,5,10
HND-007500,2011,80100133,,,,70,75,145
HND-007501,2011,80100134,,,,16,12,28
HND-007504,2011,80100138,,,,10,10,20
HND-007505,2011,80100140,,,,10,7,17
HND-007507,2011,80100142,,,,11,4,15
,2011,80100143,,,,39,28,67
HND-007508,2011,80100144,,,,56,55,111
HND-007512,2011,80100149,,,,71,55,126
HND-007513,2011,80100150,,,,15,14,29
HND-007514,2011,80100151,,,,10,9,19
HND-007515,2011,80100152,,,,40,46,86
,2011,80100154,,,,8,9,17
,2011,80100156,,,,29,30,59
HND-007516,2011,80100157,,,,52,36,88
HND-007518,2011,80100159,,,,15,8,23
HND-007519,2011,80100161,,,,11,9,20
HND-007522,2011,80100165,,,,10,9,19
HND-007523,2011,80100166,,,,6,7,13
HND-007525,2011,80100168,,,,41,51,92
HND-007526,2011,80100169,,,,52,37,89
,2011,80100173,,,,42,29,71
HND-007529,2011,80100174,,,,51,45,96
HND-007530,2011,80100175,,,,12,15,27
HND-007531,2011,80100176,,,,2,0,2
HND-007532,2011,80100177,,,,4,4,8
HND-007535,2011,80100180,,,,5,5,10
HND-007538,2011,80100183,,,,0,25,25
HND-007539,2011,80100184,,,,67,52,119
HND-007545,2011,80100189,,,,99,82,181
HND-007546,2011,80100190,,,,75,76,151
HND-007547,2011,80100191,,,,63,50,113
HND-007549,2011,80100194,,,,45,42,87
HND-007550,2011,80100195,,,,85,0,85
HND-007551,2011,80100196,,,,0,89,89
,2011,80100197,,,,33,32,65
HND-007554,2011,80100200,,,,13,24,37
,2011,80100201,,,,13,4,17
,2011,80100203,,,,15,18,33
,2011,80100205,,,,11,14,25
,2011,80100207,,,,22,40,62
,2011,80100208,,,,46,49,95
,2011,80100212,,,,68,0,68
,2011,80100213,,,,8,8,16
HND-007556,2011,80100214,,,,13,3,16
,2011,80100219,,,,13,15,28
HND-007558,2011,80100220,,,,72,73,145
HND-007560,2011,80100222,,,,34,64,98
,2011,80100224,,,,42,52,94
HND-007563,2011,80100227,,,,5,8,13
HND-007564,2011,80100228,,,,33,36,69
,2011,80100230,,,,0,33,33
HND-007567,2011,80100232,,,,9,7,16
HND-007568,2011,80100233,,,,13,9,22
HND-007569,2011,80100234,,,,25,21,46
,2011,80100239,,,,24,20,44
HND-007572,2011,80100241,,,,79,113,192
HND-007573,2011,80100242,,,,22,28,50
HND-007574,2011,80100243,,,,24,18,42
HND-007578,2011,80100249,,,,21,32,53
,2011,80100250,,,,41,35,76
HND-007580,2011,80100252,,,,24,24,48
,2011,80100253,,,,13,11,24
HND-007581,2011,80100254,,,,6,0,6
HND-007585,2011,80100259,,,,32,31,63
HND-007586,2011,80100260,,,,34,38,72
HND-007587,2011,80100262,,,,74,76,150
,2011,80100271,,,,1,0,1
HND-007592,2011,80100275,,,,34,47,81
HND-007593,2011,80100276,,,,13,12,25
,2011,80100278,,,,15,9,24
,2011,80100282,,,,15,7,22
,2011,80100283,,,,3,1,4
,2011,80100284,,,,31,37,68
HND-007595,2011,80100287,,,,5,8,13
HND-007600,2011,80100295,,,,41,19,60
HND-007601,2011,80100296,,,,22,20,42
HND-007602,2011,80100298,,,,62,55,117
,2011,80100301,,,,12,13,25
HND-007604,2011,80100302,,,,8,8,16
,2011,80100303,,,,29,29,58
,2011,80100304,,,,3,7,10
,2011,80100305,,,,9,5,14
,2011,80100306,,,,36,42,78
,2011,80100308,,,,8,7,15
,2011,80100310,,,,9,2,11
HND-007607,2011,80100316,,,,6,1,7
,2011,80100317,,,,32,46,78
HND-007609,2011,80100322,,,,22,21,43
,2011,80100324,,,,9,1,10
HND-007610,2011,80100325,,,,77,85,162
,2011,80100326,,,,5,6,11
,2011,80100329,,,,13,12,25
,2011,80100330,,,,5,5,10
,2011,80100335,,,,20,19,39
,2011,80100336,,,,12,13,25
,2011,80100337,,,,20,21,41
HND-007616,2011,80100342,,,,48,42,90
,2011,80100344,,,,7,5,12
,2011,80100345,,,,3,11,14
,2011,80100346,,,,31,35,66
,2011,80100350,,,,24,9,33
,2011,80100361,,,,11,14,25
,2011,80100362,,,,5,3,8
HND-007625,2011,80100363,,,,12,9,21
HND-007626,2011,80100364,,,,33,35,68
HND-007627,2011,80100366,,,,45,30,75
HND-007630,2011,80100369,,,,28,32,60
HND-007631,2011,80100370,,,,8,10,18
,2011,80100371,,,,9,13,22
HND-007632,2011,80100373,,,,27,22,49
,2011,80100374,,,,7,4,11
HND-007633,2011,80100376,,,,7,6,13
,2011,80100380,,,,6,10,16
,2011,80100388,,,,19,11,30
HND-007638,2011,80100391,,,,76,71,147
HND-007642,2011,80100399,,,,25,25,50
,2011,80100405,,,,4,7,11
,2011,80100406,,,,33,34,67
,2011,80100407,,,,185,187,372
HND-007645,2011,80100408,,,,19,17,36
,2011,80100409,,,,18,25,43
,2011,80100410,,,,2,11,13
HND-007648,2011,80100414,,,,1,1,2
HND-007651,2011,80100417,,,,6,4,10
,2011,80100418,,,,25,38,63
,2011,80100420,,,,16,13,29
HND-007654,2011,80100422,,,,44,43,87
HND-007655,2011,80100423,,,,17,15,32
,2011,80100428,,,,36,40,76
,2011,80100432,,,,4,1,5
HND-007660,2011,80100433,,,,52,49,101
HND-007661,2011,80100434,,,,9,9,18
,2011,80100499,,,,13,6,19
HND-007700,2011,80100502,,,,35,55,90
,2011,80100547,,,,9,13,22
,2011,80100557,,,,5,4,9
,2011,80100582,,,,11,17,28
,2011,80100583,,,,2,1,3
,2011,80100595,,,,5,7,12
HND-007743,2011,80100598,,,,27,24,51
,2011,80100599,,,,12,12,24
,2011,80100615,,,,5,3,8
HND-007752,2011,80100619,,,,30,10,40
,2011,80100622,,,,20,18,38
,2011,80100637,,,,24,18,42
,2011,80100658,,,,4,2,6
,2011,80100660,,,,6,7,13
,2011,80100663,,,,15,21,36
,2011,80100675,,,,47,49,96
,2011,80100722,,,,3,2,5
HND-007797,2011,80100730,,,,2,1,3
HND-007798,2011,80100734,,,,47,55,102
,2011,80100736,,,,1,3,4
,2011,80100749,,,,5,4,9
,2011,80100757,,,,9,7,16
HND-007803,2011,80100760,,,,2,9,11
HND-007804,2011,80100762,,,,17,25,42
,2011,80100767,,,,13,16,29
,2011,80100811,,,,3,2,5
HND-007824,2011,80100816,,,,24,27,51
HND-007825,2011,80100822,,,,40,38,78
HND-007826,2011,80100823,,,,81,87,168
HND-007827,2011,80100825,,,,10,13,23
,2011,80100829,,,,18,14,32
,2011,80100831,,,,3,5,8
HND-007846,2011,80100860,,,,0,2,2
HND-007848,2011,80100865,,,,75,58,133
HND-007849,2011,80100866,,,,25,24,49
HND-007850,2011,80100867,,,,32,29,61
HND-007851,2011,80100868,,,,55,34,89
,2011,80100882,,,,62,34,96
HND-007855,2011,80100885,,,,31,27,58
,2011,80100892,,,,8,8,16
HND-007858,2011,80100893,,,,22,22,44
HND-007862,2011,80100897,,,,20,15,35
HND-007867,2011,80100910,,,,40,41,81
,2011,80100915,,,,22,13,35
,2011,80100935,,,,15,21,36
,2011,80100944,,,,14,10,24
,2011,80100948,,,,20,30,50
,2011,80100954,,,,2,2,4
,2011,80100969,,,,8,6,14
,2011,80100970,,,,7,8,15
,2011,80100971,,,,4,2,6
HND-007886,2011,80101002,,,,11,9,20
,2011,80101004,,,,15,6,21
HND-007887,2011,80101008,,,,0,3,3
HND-007888,2011,80101009,,,,28,25,53
,2011,80101010,,,,2,0,2
HND-007890,2011,80101020,,,,2,0,2
,2011,80101021,,,,3,4,7
HND-007891,2011,80101022,,,,22,19,41
HND-007892,2011,80101023,,,,11,21,32
,2011,80101030,,,,17,23,40
,2011,80101071,,,,31,27,58
,2011,80101087,,,,2,3,5
HND-007901,2011,80101103,,,,33,34,67
HND-007903,2011,80101111,,,,27,31,58
HND-007905,2011,80101117,,,,7,2,9
HND-007908,2011,80101123,,,,16,16,32
,2011,80101130,,,,8,9,17
HND-007911,2011,80101153,,,,20,18,38
,2011,80101158,,,,8,4,12
,2011,80101161,,,,16,19,35
,2011,80101164,,,,12,8,20
,2011,80101184,,,,11,5,16
,2011,80101186,,,,3,1,4
,2011,80101187,,,,0,2,2
,2011,80101195,,,,6,1,7
,2011,80101197,,,,4,8,12
,2011,80101200,,,,6,7,13
,2011,80101205,,,,18,8,26
,2011,80101206,,,,5,12,17
,2011,80101210,,,,1,1,2
,2011,80101212,,,,1,0,1
,2011,80101213,,,,2,3,5
,2011,80101259,,,,42,41,83
,2011,80101262,,,,3,6,9
,2011,80101263,,,,4,2,6
,2011,80101264,,,,5,1,6
HND-007923,2011,80101274,,,,12,14,26
HND-007925,2011,80101282,,,,20,17,37
,2011,80101297,,,,3,5,8
,2011,80101309,,,,6,5,11
,2011,80101312,,,,3,2,5
,2011,80101315,,,,2,2,4
,2011,80101317,,,,3,2,5
,2011,80101361,,,,2,6,8
,2011,80101436,,,,0,1,1
,2011,80101480,,,,7,7,14
HND-007933,2011,80101486,,,,2,6,8
,2011,80101491,,,,4,2,6
,2011,80101495,,,,4,3,7
,2011,80101496,,,,10,9,19
,2011,80101546,,,,1,1,2
,2011,80101548,,,,2,2,4
,2011,80101550,,,,2,1,3
,2011,80101552,,,,2,0,2
HND-007947,2011,80101572,,,,5,7,12
,2011,80101592,,,,1,2,3
,2011,80101605,,,,3,2,5
,2011,80101607,,,,4,10,14
,2011,80101634,,,,9,5,14
,2011,80101665,,,,6,6,12
,2011,80101683,,,,6,1,7
,2011,80101692,,,,16,12,28
,2011,80101705,,,,3,0,3
HND-007984,2011,80101709,,,,2,1,3
HND-007390,2011,80100003,,,,14,6,20
HND-007392,2011,80100005,,,,27,28,55
HND-007393,2011,80100006,,,,35,52,87
HND-007395,2011,80100008,,,,46,51,97
,2011,80100009,,,,30,43,73
HND-007396,2011,80100011,,,,8,12,20
HND-007397,2011,80100012,,,,2,7,9
HND-007399,2011,80100015,,,,73,67,140
HND-007401,2011,80100017,,,,81,71,152
HND-007404,2011,80100019,,,,18,12,30
HND-007403,2011,80100019,,,,18,12,30
HND-007408,2011,80100023,,,,6,7,13
HND-007409,2011,80100024,,,,11,3,14
HND-007410,2011,80100025,,,,21,30,51
HND-007412,2011,80100027,,,,5,5,10
HND-007413,2011,80100029,,,,4,7,11
HND-007414,2011,80100030,,,,48,59,107
HND-007415,2011,80100031,,,,2,5,7
HND-007417,2011,80100033,,,,16,12,28
HND-007420,2011,80100038,,,,49,45,94
HND-007421,2011,80100039,,,,54,44,98
HND-007422,2011,80100040,,,,32,27,59
HND-007425,2011,80100043,,,,19,15,34
HND-007426,2011,80100044,,,,50,40,90
HND-007427,2011,80100048,,,,7,2,9
HND-007428,2011,80100049,,,,46,63,109
HND-007430,2011,80100051,,,,50,62,112
HND-007433,2011,80100055,,,,13,14,27
HND-007434,2011,80100056,,,,33,24,57
HND-007435,2011,80100057,,,,2,3,5
HND-007440,2011,80100062,,,,3,7,10
HND-007442,2011,80100064,,,,32,57,89
HND-007443,2011,80100066,,,,6,3,9
HND-007444,2011,80100070,,,,5,4,9
HND-007446,2011,80100072,,,,18,20,38
HND-007447,2011,80100073,,,,12,7,19
HND-007448,2011,80100074,,,,22,17,39
HND-007449,2011,80100075,,,,2,8,10
HND-007450,2011,80100076,,,,2,3,5
HND-007452,2011,80100078,,,,2,6,8
HND-007453,2011,80100079,,,,45,66,111
HND-007455,2011,80100081,,,,54,46,100
,2011,80100083,,,,1,2,3
HND-007458,2011,80100084,,,,13,4,17
HND-007461,2011,80100087,,,,3,2,5
HND-007463,2011,80100089,,,,9,4,13
HND-007466,2011,80100092,,,,6,5,11
HND-007467,2011,80100093,,,,5,8,13
HND-007468,2011,80100094,,,,4,3,7
HND-007470,2011,80100096,,,,7,8,15
HND-007474,2011,80100103,,,,1,13,14
HND-007475,2011,80100104,,,,3,3,6
HND-007480,2011,80100110,,,,24,22,46
HND-007482,2011,80100112,,,,34,32,66
,2011,80100113,,,,72,68,140
,2011,80100115,,,,49,37,86
HND-007483,2011,80100116,,,,12,8,20
HND-007484,2011,80100117,,,,35,32,67
HND-007490,2011,80100123,,,,2,3,5
HND-007491,2011,80100124,,,,17,17,34
HND-007496,2011,80100129,,,,14,14,28
HND-007497,2011,80100130,,,,18,20,38
HND-007499,2011,80100132,,,,1,6,7
HND-007500,2011,80100133,,,,65,68,133
HND-007504,2011,80100138,,,,9,16,25
,2011,80100139,,,,0,3,3
HND-007507,2011,80100142,,,,7,11,18
HND-007508,2011,80100144,,,,37,45,82
HND-007509,2011,80100146,,,,45,56,101
HND-007510,2011,80100147,,,,40,33,73
HND-007513,2011,80100150,,,,22,15,37
HND-007515,2011,80100152,,,,47,54,101
,2011,80100156,,,,16,37,53
HND-007519,2011,80100161,,,,20,8,28
HND-007520,2011,80100162,,,,3,9,12
HND-007522,2011,80100165,,,,11,5,16
HND-007523,2011,80100166,,,,9,4,13
HND-007526,2011,80100169,,,,42,37,79
HND-007529,2011,80100174,,,,40,35,75
HND-007534,2011,80100179,,,,1,2,3
HND-007536,2011,80100181,,,,39,50,89
HND-007539,2011,80100184,,,,54,53,107
HND-007543,2011,80100187,,,,36,46,82
HND-007542,2011,80100187,,,,36,46,82
HND-007545,2011,80100189,,,,85,104,189
HND-007546,2011,80100190,,,,82,78,160
HND-007547,2011,80100191,,,,61,79,140
HND-007548,2011,80100192,,,,59,79,138
HND-007550,2011,80100195,,,,80,0,80
HND-007551,2011,80100196,,,,0,82,82
,2011,80100197,,,,26,27,53
HND-007552,2011,80100198,,,,26,43,69
HND-007554,2011,80100200,,,,11,14,25
,2011,80100201,,,,18,5,23
,2011,80100203,,,,9,5,14
,2011,80100208,,,,50,49,99
,2011,80100209,,,,0,8,8
HND-007556,2011,80100214,,,,7,6,13
,2011,80100215,,,,7,11,18
,2011,80100216,,,,1,10,11
,2011,80100217,,,,31,28,59
HND-007557,2011,80100218,,,,6,6,12
HND-007560,2011,80100222,,,,38,38,76
HND-007561,2011,80100223,,,,10,8,18
,2011,80100224,,,,40,40,80
HND-007564,2011,80100228,,,,18,28,46
HND-007565,2011,80100229,,,,4,5,9
HND-007567,2011,80100232,,,,4,6,10
HND-007568,2011,80100233,,,,10,10,20
HND-007569,2011,80100234,,,,35,22,57
HND-007570,2011,80100235,,,,31,31,62
HND-007571,2011,80100236,,,,66,82,148
,2011,80100237,,,,40,41,81
HND-007573,2011,80100242,,,,12,21,33
HND-007574,2011,80100243,,,,22,30,52
HND-007578,2011,80100249,,,,31,29,60
HND-007581,2011,80100254,,,,1,2,3
HND-007583,2011,80100256,,,,47,41,88
HND-007587,2011,80100262,,,,57,71,128
HND-007588,2011,80100263,,,,3,2,5
,2011,80100264,,,,57,59,116
HND-007590,2011,80100267,,,,31,31,62
,2011,80100270,,,,7,5,12
,2011,80100273,,,,4,2,6
,2011,80100278,,,,17,14,31
,2011,80100279,,,,45,48,93
,2011,80100284,,,,23,29,52
HND-007595,2011,80100287,,,,6,6,12
HND-007596,2011,80100290,,,,19,22,41
HND-007598,2011,80100293,,,,24,37,61
HND-007600,2011,80100295,,,,24,23,47
HND-007601,2011,80100296,,,,15,28,43
HND-007602,2011,80100298,,,,40,42,82
HND-007603,2011,80100299,,,,21,27,48
,2011,80100303,,,,19,29,48
,2011,80100305,,,,15,0,15
,2011,80100306,,,,41,31,72
HND-007605,2011,80100307,,,,36,34,70
,2011,80100310,,,,6,5,11
HND-007607,2011,80100316,,,,5,2,7
,2011,80100317,,,,27,35,62
HND-007610,2011,80100325,,,,95,82,177
,2011,80100326,,,,2,3,5
,2011,80100330,,,,5,5,10
HND-007612,2011,80100333,,,,16,15,31
HND-007613,2011,80100334,,,,15,15,30
,2011,80100337,,,,18,14,32
HND-007614,2011,80100340,,,,14,18,32
,2011,80100345,,,,11,13,24
,2011,80100346,,,,31,31,62
,2011,80100350,,,,25,17,42
HND-007619,2011,80100351,,,,11,4,15
HND-007620,2011,80100352,,,,47,39,86
HND-007621,2011,80100353,,,,32,24,56
HND-007624,2011,80100359,,,,25,22,47
,2011,80100362,,,,10,5,15
HND-007627,2011,80100366,,,,54,51,105
HND-007628,2011,80100367,,,,9,14,23
HND-007631,2011,80100370,,,,6,11,17
,2011,80100371,,,,14,13,27
HND-007632,2011,80100373,,,,19,33,52
,2011,80100374,,,,4,5,9
,2011,80100378,,,,6,2,8
,2011,80100380,,,,6,9,15
,2011,80100383,,,,8,6,14
,2011,80100384,,,,1,1,2
,2011,80100388,,,,11,9,20
HND-007638,2011,80100391,,,,72,77,149
HND-007639,2011,80100392,,,,2,1,3
HND-007640,2011,80100393,,,,2,2,4
,2011,80100395,,,,12,9,21
,2011,80100396,,,,11,17,28
HND-007642,2011,80100399,,,,30,28,58
HND-007644,2011,80100401,,,,32,40,72
,2011,80100403,,,,6,10,16
,2011,80100405,,,,4,7,11
,2011,80100409,,,,18,16,34
HND-007648,2011,80100414,,,,0,1,1
HND-007649,2011,80100415,,,,2,1,3
HND-007651,2011,80100417,,,,7,12,19
,2011,80100418,,,,33,24,57
HND-007654,2011,80100422,,,,28,42,70
HND-007655,2011,80100423,,,,4,7,11
HND-007656,2011,80100424,,,,27,26,53
,2011,80100426,,,,25,19,44
,2011,80100432,,,,7,2,9
HND-007661,2011,80100434,,,,15,18,33
,2011,80100436,,,,18,10,28
,2011,80100446,,,,11,8,19
,2011,80100453,,,,1,2,3
HND-007676,2011,80100459,,,,11,14,25
,2011,80100465,,,,2,3,5
,2011,80100560,,,,16,17,33
,2011,80100586,,,,17,8,25
,2011,80100595,,,,3,4,7
,2011,80100599,,,,10,7,17
HND-007745,2011,80100603,,,,70,44,114
,2011,80100615,,,,6,4,10
HND-007752,2011,80100619,,,,12,12,24
,2011,80100622,,,,27,13,40
,2011,80100637,,,,14,26,40
,2011,80100660,,,,11,8,19
,2011,80100663,,,,19,19,38
,2011,80100675,,,,46,43,89
,2011,80100722,,,,5,5,10
HND-007796,2011,80100728,,,,0,1,1
HND-007797,2011,80100730,,,,1,3,4
HND-007803,2011,80100760,,,,9,9,18
HND-007804,2011,80100762,,,,13,23,36
HND-007823,2011,80100804,,,,10,10,20
HND-007824,2011,80100816,,,,21,18,39
HND-007827,2011,80100825,,,,13,15,28
,2011,80100829,,,,7,12,19
,2011,80100831,,,,5,3,8
,2011,80100846,,,,4,4,8
HND-007848,2011,80100865,,,,59,66,125
HND-007849,2011,80100866,,,,18,20,38
HND-007850,2011,80100867,,,,21,20,41
,2011,80100882,,,,59,49,108
HND-007856,2011,80100890,,,,18,32,50
,2011,80100892,,,,10,4,14
HND-007858,2011,80100893,,,,13,16,29
HND-007862,2011,80100897,,,,19,21,40
HND-007867,2011,80100910,,,,30,27,57
,2011,80100915,,,,13,7,20
HND-007872,2011,80100929,,,,15,21,36
,2011,80100933,,,,2,1,3
,2011,80100944,,,,15,8,23
,2011,80100948,,,,33,27,60
,2011,80100954,,,,1,8,9
,2011,80100966,,,,17,19,36
,2011,80100980,,,,6,1,7
HND-007885,2011,80100999,,,,2,2,4
,2011,80101004,,,,8,15,23
,2011,80101007,,,,27,31,58
HND-007888,2011,80101009,,,,13,16,29
HND-007890,2011,80101020,,,,3,2,5
HND-007891,2011,80101022,,,,31,23,54
HND-007892,2011,80101023,,,,19,15,34
,2011,80101025,,,,6,7,13
,2011,80101030,,,,15,14,29
,2011,80101033,,,,21,14,35
,2011,80101039,,,,0,5,5
,2011,80101087,,,,1,2,3
HND-007902,2011,80101106,,,,25,37,62
HND-007903,2011,80101111,,,,27,33,60
HND-007905,2011,80101117,,,,2,0,2
HND-007908,2011,80101123,,,,13,8,21
,2011,80101130,,,,10,8,18
,2011,80101161,,,,18,18,36
,2011,80101164,,,,8,9,17
,2011,80101186,,,,2,2,4
,2011,80101187,,,,4,0,4
,2011,80101195,,,,2,5,7
,2011,80101200,,,,7,4,11
,2011,80101203,,,,4,0,4
,2011,80101209,,,,5,2,7
,2011,80101215,,,,6,6,12
,2011,80101222,,,,7,9,16
,2011,80101262,,,,7,2,9
HND-007925,2011,80101282,,,,20,15,35
,2011,80101297,,,,4,3,7
,2011,80101310,,,,2,0,2
,2011,80101317,,,,1,7,8
,2011,80101361,,,,1,5,6
HND-007931,2011,80101448,,,,21,15,36
,2011,80101464,,,,16,16,32
,2011,80101476,,,,6,3,9
,2011,80101488,,,,4,2,6
,2011,80101495,,,,2,2,4
,2011,80101496,,,,10,2,12
,2011,80101546,,,,3,0,3
,2011,80101556,,,,1,0,1
HND-007944,2011,80101560,,,,14,16,30
HND-007947,2011,80101572,,,,2,1,3
,2011,80101586,,,,1,1,2
HND-007952,2011,80101587,,,,0,2,2
,2011,80101588,,,,0,1,1
,2011,80101593,,,,0,6,6
,2011,80101605,,,,4,2,6
,2011,80101607,,,,3,15,18
,2011,80101617,,,,11,7,18
,2011,80101622,,,,4,2,6
,2011,80101634,,,,7,4,11
,2011,80101651,,,,1,1,2
,2011,80101665,,,,3,5,8
,2011,80101685,,,,1,5,6
,2011,80101705,,,,2,0,2
HND-007388,2011,80100001,,,,11,13,24
HND-007389,2011,80100002,,,,9,2,11
HND-007391,2011,80100004,,,,1,3,4
HND-007394,2011,80100007,,,,0,4,4
HND-007398,2011,80100014,,,,9,9,18
HND-007400,2011,80100016,,,,15,14,29
HND-007402,2011,80100018,,,,76,64,140
HND-007405,2011,80100020,,,,8,8,16
HND-007406,2011,80100021,,,,2,3,5
HND-007407,2011,80100022,,,,48,39,87
HND-007411,2011,80100026,,,,5,15,20
,2011,80100028,,,,2,1,3
HND-007416,2011,80100032,,,,5,2,7
HND-007418,2011,80100034,,,,4,0,4
HND-007419,2011,80100035,,,,83,84,167
HND-007423,2011,80100041,,,,9,14,23
,2011,80100045,,,,18,19,37
HND-007429,2011,80100050,,,,47,63,110
HND-007431,2011,80100052,,,,23,28,51
,2011,80100053,,,,50,44,94
HND-007432,2011,80100054,,,,52,53,105
HND-007436,2011,80100058,,,,3,2,5
,2011,80100059,,,,70,64,134
HND-007438,2011,80100060,,,,29,23,52
HND-007439,2011,80100061,,,,51,50,101
,2011,80100067,,,,5,4,9
,2011,80100069,,,,44,33,77
HND-007445,2011,80100071,,,,63,46,109
HND-007451,2011,80100077,,,,11,14,25
HND-007454,2011,80100080,,,,49,69,118
HND-007456,2011,80100082,,,,18,21,39
HND-007459,2011,80100085,,,,2,2,4
HND-007460,2011,80100086,,,,3,4,7
HND-007462,2011,80100088,,,,4,4,8
HND-007464,2011,80100090,,,,27,31,58
HND-007465,2011,80100091,,,,52,56,108
HND-007469,2011,80100095,,,,3,5,8
HND-007471,2011,80100097,,,,18,21,39
HND-007472,2011,80100098,,,,1,4,5
,2011,80100099,,,,40,26,66
HND-007473,2011,80100102,,,,13,10,23
HND-007476,2011,80100105,,,,8,5,13
HND-007477,2011,80100106,,,,13,7,20
HND-007478,2011,80100108,,,,17,17,34
HND-007479,2011,80100109,,,,35,45,80
HND-007481,2011,80100111,,,,16,18,34
HND-007485,2011,80100118,,,,7,6,13
HND-007486,2011,80100119,,,,5,5,10
HND-007487,2011,80100120,,,,0,1,1
HND-007488,2011,80100121,,,,13,15,28
HND-007489,2011,80100122,,,,5,7,12
HND-007492,2011,80100125,,,,10,4,14
,2011,80100126,,,,1,1,2
HND-007494,2011,80100127,,,,14,20,34
HND-007495,2011,80100128,,,,8,9,17
HND-007498,2011,80100131,,,,29,15,44
HND-007501,2011,80100134,,,,9,15,24
HND-007502,2011,80100135,,,,11,12,23
HND-007503,2011,80100137,,,,12,17,29
HND-007505,2011,80100140,,,,12,13,25
HND-007506,2011,80100141,,,,6,4,10
,2011,80100143,,,,43,29,72
HND-007511,2011,80100148,,,,73,0,73
HND-007512,2011,80100149,,,,61,51,112
HND-007514,2011,80100151,,,,12,7,19
,2011,80100154,,,,10,5,15
HND-007516,2011,80100157,,,,32,42,74
HND-007517,2011,80100158,,,,5,9,14
HND-007518,2011,80100159,,,,8,12,20
HND-007521,2011,80100163,,,,4,1,5
,2011,80100164,,,,18,17,35
HND-007524,2011,80100167,,,,39,32,71
HND-007525,2011,80100168,,,,41,41,82
HND-007527,2011,80100170,,,,49,52,101
HND-007528,2011,80100172,,,,0,135,135
HND-007530,2011,80100175,,,,17,16,33
HND-007531,2011,80100176,,,,2,0,2
HND-007532,2011,80100177,,,,1,2,3
HND-007533,2011,80100178,,,,17,25,42
HND-007535,2011,80100180,,,,3,4,7
HND-007537,2011,80100182,,,,7,13,20
HND-007538,2011,80100183,,,,0,22,22
HND-007540,2011,80100185,,,,118,105,223
HND-007541,2011,80100186,,,,33,36,69
HND-007544,2011,80100188,,,,57,61,118
,2011,80100193,,,,111,80,191
HND-007549,2011,80100194,,,,42,28,70
HND-007553,2011,80100199,,,,64,62,126
,2011,80100202,,,,16,18,34
,2011,80100204,,,,6,12,18
,2011,80100205,,,,16,10,26
,2011,80100207,,,,31,30,61
HND-007555,2011,80100210,,,,17,12,29
,2011,80100211,,,,0,60,60
,2011,80100212,,,,83,0,83
,2011,80100213,,,,9,5,14
,2011,80100219,,,,15,19,34
HND-007558,2011,80100220,,,,83,72,155
HND-007559,2011,80100221,,,,16,22,38
,2011,80100225,,,,11,6,17
HND-007562,2011,80100226,,,,36,44,80
HND-007563,2011,80100227,,,,6,6,12
,2011,80100230,,,,0,28,28
HND-007566,2011,80100231,,,,16,17,33
,2011,80100239,,,,35,25,60
HND-007572,2011,80100241,,,,86,94,180
,2011,80100244,,,,38,31,69
,2011,80100245,,,,40,47,87
HND-007575,2011,80100246,,,,13,11,24
HND-007576,2011,80100247,,,,13,11,24
,2011,80100250,,,,37,31,68
HND-007579,2011,80100251,,,,18,13,31
HND-007580,2011,80100252,,,,25,22,47
,2011,80100253,,,,12,12,24
HND-007582,2011,80100255,,,,3,0,3
HND-007584,2011,80100258,,,,25,32,57
HND-007585,2011,80100259,,,,33,35,68
HND-007586,2011,80100260,,,,37,42,79
,2011,80100265,,,,22,17,39
HND-007589,2011,80100266,,,,25,30,55
HND-007591,2011,80100268,,,,37,55,92
HND-007592,2011,80100275,,,,32,27,59
HND-007593,2011,80100276,,,,11,16,27
,2011,80100282,,,,15,10,25
,2011,80100283,,,,3,3,6
HND-007594,2011,80100286,,,,4,7,11
,2011,80100288,,,,3,1,4
,2011,80100291,,,,8,13,21
HND-007597,2011,80100292,,,,25,17,42
HND-007599,2011,80100294,,,,39,46,85
,2011,80100300,,,,2,3,5
,2011,80100301,,,,14,11,25
HND-007604,2011,80100302,,,,10,5,15
,2011,80100304,,,,6,0,6
,2011,80100308,,,,9,7,16
,2011,80100312,,,,14,10,24
HND-007606,2011,80100315,,,,26,35,61
HND-007608,2011,80100318,,,,7,9,16
,2011,80100319,,,,14,19,33
,2011,80100320,,,,2,1,3
HND-007609,2011,80100322,,,,10,25,35
,2011,80100324,,,,12,4,16
HND-007611,2011,80100328,,,,20,17,37
,2011,80100329,,,,19,6,25
,2011,80100332,,,,14,18,32
,2011,80100335,,,,25,18,43
,2011,80100336,,,,12,16,28
HND-007615,2011,80100341,,,,31,31,62
HND-007616,2011,80100342,,,,53,62,115
,2011,80100344,,,,6,5,11
HND-007622,2011,80100354,,,,2,1,3
,2011,80100355,,,,23,23,46
,2011,80100356,,,,6,8,14
HND-007623,2011,80100357,,,,69,54,123
,2011,80100361,,,,10,13,23
HND-007625,2011,80100363,,,,3,10,13
HND-007626,2011,80100364,,,,26,26,52
HND-007629,2011,80100368,,,,27,21,48
HND-007630,2011,80100369,,,,32,38,70
,2011,80100375,,,,22,25,47
HND-007633,2011,80100376,,,,6,6,12
HND-007634,2011,80100377,,,,3,0,3
HND-007636,2011,80100385,,,,50,56,106
HND-007637,2011,80100387,,,,37,33,70
HND-007641,2011,80100398,,,,6,5,11
HND-007643,2011,80100400,,,,51,66,117
,2011,80100404,,,,2,2,4
,2011,80100406,,,,28,30,58
,2011,80100407,,,,151,165,316
HND-007645,2011,80100408,,,,13,24,37
,2011,80100410,,,,9,8,17
HND-007646,2011,80100411,,,,36,49,85
HND-007647,2011,80100413,,,,10,8,18
,2011,80100420,,,,15,7,22
HND-007653,2011,80100421,,,,6,5,11
HND-007657,2011,80100425,,,,45,50,95
,2011,80100427,,,,12,8,20
,2011,80100428,,,,27,36,63
HND-007659,2011,80100429,,,,7,2,9
HND-007660,2011,80100433,,,,49,27,76
,2011,80100435,,,,16,11,27
,2011,80100438,,,,11,17,28
,2011,80100494,,,,3,2,5
,2011,80100499,,,,12,11,23
HND-007700,2011,80100502,,,,36,25,61
HND-007710,2011,80100521,,,,67,67,134
,2011,80100541,,,,9,10,19
HND-007722,2011,80100543,,,,41,28,69
,2011,80100547,,,,15,18,33
,2011,80100557,,,,8,3,11
,2011,80100565,,,,12,20,32
HND-007729,2011,80100568,,,,4,7,11
,2011,80100581,,,,9,10,19
,2011,80100582,,,,10,9,19
,2011,80100583,,,,2,5,7
HND-007743,2011,80100598,,,,27,24,51
,2011,80100635,,,,4,0,4
,2011,80100658,,,,5,5,10
HND-007768,2011,80100677,,,,35,31,66
HND-007798,2011,80100734,,,,59,56,115
,2011,80100736,,,,6,3,9
,2011,80100742,,,,7,12,19
,2011,80100749,,,,6,2,8
HND-007802,2011,80100753,,,,26,22,48
,2011,80100757,,,,10,6,16
,2011,80100767,,,,20,16,36
,2011,80100791,,,,6,3,9
,2011,80100792,,,,1,3,4
HND-007820,2011,80100800,,,,11,22,33
,2011,80100802,,,,9,7,16
,2011,80100811,,,,2,2,4
HND-007825,2011,80100822,,,,38,38,76
HND-007826,2011,80100823,,,,81,71,152
HND-007828,2011,80100826,,,,6,2,8
HND-007846,2011,80100860,,,,2,2,4
HND-007851,2011,80100868,,,,41,38,79
,2011,80100877,,,,3,6,9
HND-007855,2011,80100885,,,,15,15,30
HND-007861,2011,80100896,,,,38,44,82
HND-007865,2011,80100905,,,,29,29,58
HND-007868,2011,80100911,,,,28,23,51
HND-007873,2011,80100932,,,,4,3,7
,2011,80100934,,,,1,0,1
,2011,80100935,,,,13,15,28
,2011,80100968,,,,4,7,11
,2011,80100969,,,,5,7,12
,2011,80100970,,,,10,1,11
,2011,80100971,,,,6,3,9
,2011,80100985,,,,1,0,1
,2011,80100990,,,,43,38,81
,2011,80100997,,,,1,0,1
HND-007886,2011,80101002,,,,12,3,15
,2011,80101005,,,,1,0,1
,2011,80101006,,,,7,6,13
,2011,80101010,,,,2,0,2
,2011,80101014,,,,19,22,41
,2011,80101021,,,,5,2,7
,2011,80101028,,,,10,2,12
HND-007893,2011,80101032,,,,0,1,1
HND-007894,2011,80101035,,,,10,9,19
,2011,80101071,,,,24,31,55
,2011,80101083,,,,1,1,2
HND-007900,2011,80101100,,,,20,27,47
HND-007901,2011,80101103,,,,32,25,57
,2011,80101134,,,,25,30,55
,2011,80101139,,,,14,15,29
HND-007911,2011,80101153,,,,25,29,54
,2011,80101157,,,,14,13,27
,2011,80101158,,,,5,5,10
,2011,80101184,,,,6,6,12
,2011,80101197,,,,2,0,2
,2011,80101204,,,,15,15,30
,2011,80101205,,,,15,17,32
,2011,80101206,,,,9,10,19
,2011,80101210,,,,2,1,3
,2011,80101212,,,,1,0,1
,2011,80101213,,,,4,8,12
,2011,80101259,,,,21,33,54
,2011,80101260,,,,3,3,6
,2011,80101268,,,,12,5,17
HND-007923,2011,80101274,,,,10,9,19
,2011,80101293,,,,11,8,19
,2011,80101309,,,,2,10,12
,2011,80101312,,,,1,2,3
,2011,80101318,,,,4,1,5
,2011,80101357,,,,2,4,6
,2011,80101365,,,,9,8,17
,2011,80101370,,,,9,7,16
,2011,80101480,,,,7,11,18
,2011,80101481,,,,8,8,16
,2011,80101483,,,,6,10,16
HND-007933,2011,80101486,,,,2,3,5
,2011,80101543,,,,4,7,11
,2011,80101551,,,,1,0,1
,2011,80101553,,,,7,6,13
,2011,80101571,,,,4,4,8
,2011,80101615,,,,1,2,3
HND-007973,2011,80101649,,,,2,4,6
,2011,80101650,,,,6,7,13
,2011,80101652,,,,0,1,1
,2011,80101683,,,,1,3,4
,2011,80101690,,,,4,4,8
,2011,80101692,,,,10,8,18
HND-007390,2011,80100003,,,,16,12,28
,2011,80100013,,,,13,12,25
HND-007402,2011,80100018,,,,85,92,177
HND-007411,2011,80100026,,,,14,7,21
,2011,80100045,,,,37,45,82
HND-007428,2011,80100049,,,,36,36,72
HND-007433,2011,80100055,,,,23,26,49
HND-007445,2011,80100071,,,,33,33,66
,2011,80100099,,,,34,30,64
,2011,80100113,,,,29,21,50
HND-007483,2011,80100116,,,,22,23,45
HND-007504,2011,80100138,,,,6,10,16
HND-007510,2011,80100147,,,,41,34,75
HND-007517,2011,80100158,,,,12,15,27
HND-007524,2011,80100167,,,,93,98,191
HND-007527,2011,80100170,,,,31,17,48
,2011,80100173,,,,12,15,27
HND-007530,2011,80100175,,,,25,23,48
HND-007543,2011,80100187,,,,33,40,73
HND-007542,2011,80100187,,,,33,40,73
HND-007554,2011,80100200,,,,5,12,17
,2011,80100205,,,,18,25,43
,2011,80100207,,,,26,38,64
,2011,80100211,,,,0,185,185
,2011,80100212,,,,134,0,134
,2011,80100219,,,,15,19,34
,2011,80100224,,,,28,30,58
,2011,80100225,,,,56,61,117
,2011,80100230,,,,0,62,62
HND-007570,2011,80100235,,,,19,18,37
,2011,80100239,,,,69,68,137
,2011,80100245,,,,14,17,31
HND-007575,2011,80100246,,,,42,37,79
,2011,80100250,,,,39,41,80
,2011,80100261,,,,13,17,30
,2011,80100282,,,,29,20,49
,2011,80100284,,,,14,26,40
,2011,80100300,,,,19,14,33
,2011,80100303,,,,38,37,75
,2011,80100308,,,,5,3,8
,2011,80100312,,,,15,14,29
,2011,80100317,,,,19,28,47
,2011,80100319,,,,25,45,70
HND-007610,2011,80100325,,,,111,99,210
,2011,80100329,,,,15,10,25
,2011,80100332,,,,23,14,37
,2011,80100336,,,,16,15,31
,2011,80100337,,,,15,14,29
,2011,80100344,,,,10,8,18
,2011,80100350,,,,71,33,104
,2011,80100355,,,,46,29,75
,2011,80100378,,,,4,3,7
,2011,80100380,,,,11,12,23
HND-007643,2011,80100400,,,,47,41,88
,2011,80100404,,,,9,10,19
,2011,80100406,,,,14,30,44
,2011,80100407,,,,141,155,296
,2011,80100409,,,,11,12,23
,2011,80100418,,,,44,74,118
,2011,80100428,,,,30,44,74
HND-007692,2011,80100488,,,,369,195,564
HND-007699,2011,80100498,,,,234,202,436
,2011,80100499,,,,8,10,18
,2011,80100581,,,,18,17,35
,2011,80100582,,,,14,14,28
,2011,80100595,,,,1,5,6
,2011,80100614,,,,50,31,81
,2011,80100615,,,,8,19,27
,2011,80100616,,,,14,11,25
,2011,80100620,,,,357,417,774
,2011,80100622,,,,158,171,329
,2011,80100629,,,,21,18,39
HND-007756,2011,80100630,,,,323,255,578
HND-007757,2011,80100631,,,,358,112,470
HND-007758,2011,80100632,,,,479,69,548
,2011,80100633,,,,47,40,87
HND-007759,2011,80100634,,,,100,1,101
,2011,80100635,,,,63,96,159
,2011,80100639,,,,22,26,48
,2011,80100644,,,,76,90,166
HND-007762,2011,80100648,,,,372,362,734
HND-007764,2011,80100653,,,,44,34,78
,2011,80100654,,,,24,18,42
,2011,80100656,,,,3,8,11
,2011,80100672,,,,18,16,34
,2011,80100674,,,,14,13,27
,2011,80100676,,,,8,23,31
HND-007771,2011,80100681,,,,170,156,326
HND-007772,2011,80100682,,,,108,116,224
HND-007775,2011,80100685,,,,134,103,237
HND-007780,2011,80100693,,,,59,0,59
HND-007781,2011,80100694,,,,79,67,146
,2011,80100696,,,,37,29,66
HND-007784,2011,80100698,,,,113,96,209
,2011,80100701,,,,28,30,58
,2011,80100702,,,,32,30,62
,2011,80100736,,,,6,10,16
HND-007799,2011,80100739,,,,86,83,169
,2011,80100742,,,,18,18,36
,2011,80100767,,,,10,12,22
,2011,80100791,,,,11,9,20
,2011,80100792,,,,2,4,6
,2011,80100829,,,,4,6,10
,2011,80100831,,,,3,2,5
,2011,80100874,,,,45,66,111
,2011,80100877,,,,4,7,11
,2011,80100912,,,,5,8,13
,2011,80100916,,,,26,16,42
,2011,80100927,,,,33,0,33
HND-007876,2011,80100945,,,,21,16,37
,2011,80100948,,,,24,25,49
,2011,80100951,,,,5,17,22
,2011,80100997,,,,1,1,2
,2011,80101014,,,,28,37,65
,2011,80101015,,,,9,5,14
,2011,80101082,,,,17,27,44
,2011,80101084,,,,13,13,26
HND-007908,2011,80101123,,,,20,20,40
,2011,80101134,,,,83,115,198
,2011,80101149,,,,70,64,134
,2011,80101161,,,,58,52,110
,2011,80101167,,,,16,16,32
,2011,80101200,,,,5,6,11
,2011,80101204,,,,27,42,69
,2011,80101209,,,,3,4,7
,2011,80101259,,,,43,73,116
,2011,80101308,,,,29,33,62
HND-007928,2011,80101353,,,,41,24,65
,2011,80101361,,,,1,3,4
,2011,80101368,,,,8,13,21
,2011,80101373,,,,39,47,86
,2011,80101464,,,,65,70,135
,2011,80101467,,,,17,22,39
,2011,80101471,,,,64,78,142
,2011,80101473,,,,6,7,13
HND-007943,2011,80101528,,,,1115,1426,2541
,2011,80101553,,,,10,6,16
,2011,80101557,,,,24,20,44
,2011,80101559,,,,8,8,16
,2011,80101561,,,,26,18,44
,2011,80101562,,,,1,1,2
,2011,80101592,,,,23,28,51
HND-007955,2011,80101597,,,,38,17,55
,2011,80101615,,,,4,5,9
,2011,80101625,,,,5,5,10
,2011,80101634,,,,16,16,32
,2011,80101635,,,,44,35,79
,2011,80101657,,,,10,17,27
,2011,80101668,,,,1,5,6
,2011,80101704,,,,13,19,32
,2011,80100009,,,,49,46,95
HND-007455,2011,80100081,,,,42,48,90
HND-007458,2011,80100084,,,,17,24,41
HND-007464,2011,80100090,,,,26,19,45
HND-007474,2011,80100103,,,,17,17,34
,2011,80100107,,,,9,16,25
HND-007496,2011,80100129,,,,10,15,25
HND-007498,2011,80100131,,,,15,15,30
HND-007507,2011,80100142,,,,5,1,6
,2011,80100156,,,,19,19,38
HND-007519,2011,80100161,,,,9,12,21
,2011,80100164,,,,24,38,62
HND-007545,2011,80100189,,,,23,24,47
,2011,80100202,,,,29,25,54
,2011,80100208,,,,52,45,97
,2011,80100209,,,,16,8,24
HND-007556,2011,80100214,,,,9,6,15
,2011,80100217,,,,45,42,87
HND-007558,2011,80100220,,,,46,47,93
,2011,80100237,,,,35,39,74
,2011,80100240,,,,30,18,48
HND-007572,2011,80100241,,,,22,24,46
HND-007586,2011,80100260,,,,19,20,39
,2011,80100273,,,,3,2,5
,2011,80100278,,,,6,11,17
,2011,80100279,,,,47,54,101
HND-007597,2011,80100292,,,,51,68,119
HND-007601,2011,80100296,,,,17,16,33
HND-007608,2011,80100318,,,,41,22,63
,2011,80100345,,,,12,10,22
,2011,80100346,,,,42,47,89
,2011,80100374,,,,15,10,25
,2011,80100375,,,,15,14,29
,2011,80100383,,,,9,9,18
,2011,80100384,,,,6,10,16
,2011,80100388,,,,11,23,34
HND-007638,2011,80100391,,,,22,39,61
,2011,80100395,,,,7,6,13
HND-007642,2011,80100399,,,,12,13,25
,2011,80100403,,,,8,7,15
HND-007654,2011,80100422,,,,20,21,41
,2011,80100427,,,,13,8,21
,2011,80100435,,,,64,50,114
,2011,80100436,,,,13,28,41
,2011,80100508,,,,15,19,34
,2011,80100560,,,,48,65,113
,2011,80100565,,,,40,48,88
HND-007737,2011,80100585,,,,84,77,161
,2011,80100586,,,,18,25,43
HND-007742,2011,80100597,,,,176,162,338
,2011,80100599,,,,15,18,33
HND-007749,2011,80100609,,,,10,9,19
HND-007753,2011,80100621,,,,353,424,777
HND-007755,2011,80100628,,,,24,32,56
,2011,80100636,,,,66,54,120
,2011,80100637,,,,27,47,74
,2011,80100638,,,,21,16,37
,2011,80100640,,,,12,9,21
HND-007760,2011,80100642,,,,519,685,1204
HND-007761,2011,80100643,,,,629,685,1314
,2011,80100650,,,,8,10,18
HND-007763,2011,80100652,,,,184,160,344
,2011,80100655,,,,15,31,46
,2011,80100659,,,,0,17,17
HND-007765,2011,80100661,,,,61,61,122
,2011,80100663,,,,12,17,29
HND-007766,2011,80100664,,,,157,196,353
,2011,80100666,,,,5,2,7
HND-007767,2011,80100673,,,,100,99,199
,2011,80100675,,,,44,45,89
HND-007769,2011,80100679,,,,226,235,461
HND-007770,2011,80100680,,,,66,46,112
HND-007773,2011,80100683,,,,164,182,346
HND-007774,2011,80100684,,,,146,80,226
HND-007776,2011,80100686,,,,49,62,111
,2011,80100687,,,,107,104,211
HND-007778,2011,80100688,,,,115,108,223
HND-007779,2011,80100691,,,,140,160,300
HND-007782,2011,80100695,,,,43,32,75
HND-007783,2011,80100697,,,,77,65,142
HND-007785,2011,80100699,,,,150,146,296
,2011,80100700,,,,29,15,44
HND-007786,2011,80100705,,,,76,71,147
,2011,80100722,,,,6,7,13
,2011,80100723,,,,11,29,40
,2011,80100738,,,,15,12,27
HND-007800,2011,80100741,,,,131,69,200
HND-007804,2011,80100762,,,,22,24,46
,2011,80100802,,,,14,11,25
,2011,80100803,,,,86,80,166
HND-007826,2011,80100823,,,,77,72,149
,2011,80100846,,,,6,6,12
HND-007848,2011,80100865,,,,17,28,45
HND-007850,2011,80100867,,,,11,33,44
HND-007851,2011,80100868,,,,31,25,56
,2011,80100876,,,,2,2,4
HND-007853,2011,80100879,,,,144,110,254
HND-007854,2011,80100881,,,,62,63,125
,2011,80100882,,,,150,114,264
HND-007859,2011,80100894,,,,101,93,194
HND-007860,2011,80100895,,,,25,22,47
,2011,80100900,,,,11,18,29
HND-007863,2011,80100901,,,,108,82,190
HND-007866,2011,80100908,,,,43,33,76
HND-007867,2011,80100910,,,,31,29,60
,2011,80100938,,,,8,10,18
HND-007875,2011,80100941,,,,40,4,44
,2011,80100947,,,,45,30,75
,2011,80100954,,,,5,5,10
,2011,80100968,,,,2,4,6
,2011,80100971,,,,12,18,30
,2011,80100990,,,,39,42,81
HND-007891,2011,80101022,,,,9,13,22
,2011,80101027,,,,22,8,30
,2011,80101028,,,,56,58,114
,2011,80101037,,,,26,29,55
,2011,80101073,,,,24,29,53
,2011,80101074,,,,12,7,19
HND-007898,2011,80101079,,,,36,13,49
,2011,80101083,,,,4,1,5
,2011,80101085,,,,1,4,5
HND-007902,2011,80101106,,,,21,19,40
,2011,80101122,,,,3,1,4
,2011,80101145,,,,64,92,156
,2011,80101157,,,,41,58,99
,2011,80101162,,,,12,10,22
,2011,80101164,,,,18,15,33
,2011,80101168,,,,8,3,11
,2011,80101187,,,,1,6,7
,2011,80101201,,,,50,67,117
,2011,80101205,,,,5,9,14
,2011,80101206,,,,4,9,13
,2011,80101221,,,,9,5,14
,2011,80101260,,,,3,2,5
HND-007925,2011,80101282,,,,12,28,40
,2011,80101300,,,,14,25,39
,2011,80101310,,,,0,2,2
,2011,80101355,,,,13,21,34
,2011,80101356,,,,15,19,34
,2011,80101357,,,,8,4,12
,2011,80101363,,,,15,13,28
,2011,80101365,,,,8,10,18
,2011,80101370,,,,6,8,14
,2011,80101371,,,,38,42,80
HND-007932,2011,80101463,,,,43,60,103
,2011,80101466,,,,8,9,17
,2011,80101470,,,,34,17,51
,2011,80101476,,,,7,8,15
,2011,80101477,,,,77,0,77
,2011,80101478,,,,6,3,9
,2011,80101483,,,,14,30,44
,2011,80101496,,,,14,11,25
,2011,80101558,,,,16,16,32
,2011,80101661,,,,10,13,23
,2011,80101669,,,,4,3,7
,2011,80101685,,,,1,3,4
,2011,80101706,,,,0,3,3
,2011,80101710,,,,6,3,9
,2011,80100009,,,,35,44,79
HND-007402,2011,80100018,,,,69,68,137
HND-007411,2011,80100026,,,,4,5,9
HND-007445,2011,80100071,,,,19,23,42
HND-007464,2011,80100090,,,,9,17,26
,2011,80100099,,,,25,37,62
,2011,80100107,,,,10,14,24
HND-007498,2011,80100131,,,,9,15,24
HND-007517,2011,80100158,,,,20,13,33
,2011,80100164,,,,14,16,30
HND-007524,2011,80100167,,,,74,108,182
HND-007527,2011,80100170,,,,19,13,32
,2011,80100202,,,,16,17,33
,2011,80100209,,,,8,10,18
,2011,80100211,,,,0,159,159
,2011,80100217,,,,46,39,85
HND-007558,2011,80100220,,,,57,57,114
,2011,80100225,,,,68,56,124
,2011,80100237,,,,38,49,87
HND-007572,2011,80100241,,,,18,24,42
,2011,80100245,,,,2,18,20
HND-007575,2011,80100246,,,,24,23,47
HND-007586,2011,80100260,,,,12,14,26
,2011,80100273,,,,4,0,4
,2011,80100279,,,,46,49,95
HND-007597,2011,80100292,,,,49,47,96
,2011,80100300,,,,20,16,36
,2011,80100312,,,,12,14,26
HND-007608,2011,80100318,,,,25,33,58
,2011,80100319,,,,27,36,63
,2011,80100332,,,,16,26,42
,2011,80100355,,,,35,41,76
,2011,80100374,,,,7,5,12
,2011,80100375,,,,16,17,33
,2011,80100383,,,,9,6,15
,2011,80100384,,,,3,7,10
,2011,80100395,,,,5,6,11
HND-007643,2011,80100400,,,,40,41,81
,2011,80100403,,,,8,3,11
,2011,80100406,,,,18,22,40
,2011,80100407,,,,73,99,172
,2011,80100409,,,,11,11,22
,2011,80100428,,,,31,27,58
,2011,80100435,,,,39,54,93
,2011,80100436,,,,16,18,34
HND-007699,2011,80100498,,,,115,159,274
,2011,80100508,,,,19,16,35
,2011,80100560,,,,45,47,92
,2011,80100565,,,,36,36,72
,2011,80100581,,,,7,11,18
HND-007737,2011,80100585,,,,70,72,142
,2011,80100586,,,,18,29,47
HND-007742,2011,80100597,,,,153,140,293
,2011,80100616,,,,11,11,22
HND-007753,2011,80100621,,,,228,304,532
,2011,80100629,,,,12,18,30
HND-007756,2011,80100630,,,,220,208,428
HND-007757,2011,80100631,,,,359,82,441
HND-007758,2011,80100632,,,,339,58,397
,2011,80100633,,,,37,32,69
HND-007759,2011,80100634,,,,45,1,46
,2011,80100637,,,,21,58,79
,2011,80100639,,,,25,20,45
,2011,80100644,,,,88,81,169
HND-007762,2011,80100648,,,,300,383,683
HND-007764,2011,80100653,,,,43,33,76
,2011,80100654,,,,24,15,39
,2011,80100656,,,,2,10,12
HND-007765,2011,80100661,,,,37,43,80
HND-007766,2011,80100664,,,,125,163,288
,2011,80100666,,,,1,5,6
,2011,80100674,,,,17,5,22
,2011,80100675,,,,47,49,96
,2011,80100676,,,,15,15,30
HND-007769,2011,80100679,,,,186,183,369
HND-007771,2011,80100681,,,,110,132,242
HND-007773,2011,80100683,,,,146,175,321
HND-007775,2011,80100685,,,,108,62,170
HND-007779,2011,80100691,,,,92,124,216
HND-007780,2011,80100693,,,,26,0,26
HND-007784,2011,80100698,,,,78,70,148
HND-007785,2011,80100699,,,,75,134,209
HND-007786,2011,80100705,,,,51,59,110
,2011,80100722,,,,6,8,14
HND-007800,2011,80100741,,,,93,54,147
,2011,80100742,,,,23,17,40
,2011,80100791,,,,2,7,9
,2011,80100792,,,,2,6,8
,2011,80100802,,,,8,11,19
,2011,80100803,,,,72,76,148
HND-007826,2011,80100823,,,,56,63,119
,2011,80100846,,,,3,6,9
HND-007851,2011,80100868,,,,22,20,42
,2011,80100872,,,,1,1,2
,2011,80100877,,,,8,6,14
HND-007859,2011,80100894,,,,81,82,163
HND-007860,2011,80100895,,,,15,13,28
,2011,80100900,,,,14,13,27
HND-007863,2011,80100901,,,,80,77,157
HND-007866,2011,80100908,,,,25,20,45
HND-007869,2011,80100922,,,,18,104,122
HND-007875,2011,80100941,,,,22,2,24
,2011,80100947,,,,40,27,67
,2011,80100954,,,,2,4,6
,2011,80100968,,,,2,5,7
,2011,80100971,,,,10,20,30
,2011,80101014,,,,25,28,53
,2011,80101027,,,,17,18,35
,2011,80101028,,,,61,58,119
,2011,80101074,,,,17,12,29
HND-007898,2011,80101079,,,,15,11,26
,2011,80101082,,,,26,10,36
,2011,80101083,,,,6,0,6
HND-007908,2011,80101123,,,,15,21,36
,2011,80101145,,,,61,77,138
,2011,80101157,,,,37,49,86
,2011,80101161,,,,48,66,114
,2011,80101164,,,,14,17,31
,2011,80101167,,,,16,13,29
,2011,80101201,,,,55,75,130
,2011,80101205,,,,4,12,16
,2011,80101206,,,,6,9,15
,2011,80101221,,,,13,11,24
,2011,80101260,,,,1,0,1
,2011,80101300,,,,24,22,46
,2011,80101308,,,,30,31,61
,2011,80101310,,,,1,2,3
,2011,80101357,,,,6,18,24
,2011,80101363,,,,14,7,21
,2011,80101365,,,,11,18,29
,2011,80101370,,,,2,6,8
,2011,80101371,,,,23,31,54
HND-007932,2011,80101463,,,,49,57,106
,2011,80101476,,,,2,1,3
,2011,80101478,,,,9,6,15
,2011,80101483,,,,8,22,30
HND-007943,2011,80101528,,,,870,1215,2085
,2011,80101557,,,,27,45,72
,2011,80101558,,,,15,11,26
,2011,80101559,,,,8,20,28
,2011,80101561,,,,19,24,43
,2011,80101592,,,,16,14,30
HND-007955,2011,80101597,,,,10,2,12
,2011,80101661,,,,10,16,26
,2011,80101685,,,,2,3,5
HND-007390,2011,80100003,,,,23,29,52
,2011,80100013,,,,9,8,17
,2011,80100045,,,,37,38,75
HND-007428,2011,80100049,,,,15,13,28
HND-007433,2011,80100055,,,,20,24,44
HND-007455,2011,80100081,,,,26,47,73
HND-007458,2011,80100084,,,,13,7,20
HND-007474,2011,80100103,,,,22,20,42
,2011,80100113,,,,25,37,62
HND-007483,2011,80100116,,,,25,14,39
HND-007496,2011,80100129,,,,6,7,13
HND-007504,2011,80100138,,,,6,6,12
HND-007507,2011,80100142,,,,6,3,9
HND-007510,2011,80100147,,,,15,23,38
,2011,80100156,,,,21,23,44
HND-007519,2011,80100161,,,,3,8,11
,2011,80100173,,,,11,6,17
HND-007530,2011,80100175,,,,15,19,34
HND-007543,2011,80100187,,,,18,24,42
HND-007542,2011,80100187,,,,18,24,42
HND-007545,2011,80100189,,,,25,23,48
HND-007554,2011,80100200,,,,7,4,11
,2011,80100205,,,,26,31,57
,2011,80100207,,,,24,24,48
,2011,80100208,,,,39,56,95
,2011,80100212,,,,146,0,146
HND-007556,2011,80100214,,,,16,12,28
,2011,80100219,,,,26,21,47
,2011,80100230,,,,0,74,74
,2011,80100239,,,,63,76,139
,2011,80100240,,,,26,31,57
,2011,80100250,,,,39,43,82
,2011,80100261,,,,16,18,34
,2011,80100278,,,,12,12,24
,2011,80100282,,,,27,23,50
,2011,80100284,,,,8,15,23
HND-007601,2011,80100296,,,,14,12,26
,2011,80100303,,,,38,46,84
,2011,80100308,,,,3,2,5
,2011,80100317,,,,14,24,38
HND-007610,2011,80100325,,,,72,80,152
,2011,80100329,,,,13,7,20
,2011,80100336,,,,6,8,14
,2011,80100337,,,,7,10,17
,2011,80100344,,,,5,6,11
,2011,80100345,,,,8,6,14
,2011,80100346,,,,22,28,50
,2011,80100350,,,,34,24,58
,2011,80100378,,,,3,0,3
,2011,80100380,,,,12,9,21
,2011,80100388,,,,7,8,15
HND-007638,2011,80100391,,,,23,39,62
HND-007642,2011,80100399,,,,4,4,8
,2011,80100404,,,,11,10,21
,2011,80100418,,,,37,52,89
HND-007654,2011,80100422,,,,12,17,29
,2011,80100427,,,,11,12,23
HND-007692,2011,80100488,,,,246,144,390
,2011,80100499,,,,17,11,28
,2011,80100582,,,,16,16,32
,2011,80100595,,,,7,6,13
,2011,80100599,,,,9,16,25
HND-007749,2011,80100609,,,,12,6,18
,2011,80100614,,,,26,27,53
,2011,80100615,,,,15,18,33
,2011,80100620,,,,341,450,791
,2011,80100622,,,,104,122,226
HND-007755,2011,80100628,,,,10,14,24
,2011,80100635,,,,86,100,186
,2011,80100636,,,,61,71,132
,2011,80100638,,,,21,10,31
,2011,80100640,,,,13,7,20
HND-007760,2011,80100642,,,,411,512,923
HND-007761,2011,80100643,,,,534,607,1141
,2011,80100650,,,,13,10,23
HND-007763,2011,80100652,,,,122,131,253
,2011,80100655,,,,23,24,47
,2011,80100659,,,,0,21,21
,2011,80100663,,,,12,13,25
,2011,80100672,,,,12,25,37
HND-007767,2011,80100673,,,,69,87,156
HND-007770,2011,80100680,,,,32,39,71
HND-007772,2011,80100682,,,,68,71,139
HND-007774,2011,80100684,,,,93,62,155
HND-007776,2011,80100686,,,,26,43,69
,2011,80100687,,,,80,78,158
HND-007778,2011,80100688,,,,82,89,171
HND-007781,2011,80100694,,,,70,89,159
HND-007782,2011,80100695,,,,34,44,78
,2011,80100696,,,,20,30,50
HND-007783,2011,80100697,,,,63,46,109
,2011,80100700,,,,14,12,26
,2011,80100701,,,,13,22,35
,2011,80100702,,,,12,18,30
,2011,80100723,,,,2,13,15
,2011,80100736,,,,8,2,10
,2011,80100738,,,,24,15,39
HND-007799,2011,80100739,,,,67,65,132
HND-007804,2011,80100762,,,,36,35,71
,2011,80100767,,,,5,7,12
,2011,80100829,,,,1,5,6
,2011,80100831,,,,1,3,4
HND-007848,2011,80100865,,,,10,7,17
HND-007850,2011,80100867,,,,20,14,34
,2011,80100874,,,,20,41,61
,2011,80100876,,,,2,0,2
HND-007853,2011,80100879,,,,108,101,209
HND-007854,2011,80100881,,,,48,57,105
,2011,80100882,,,,129,126,255
HND-007867,2011,80100910,,,,35,27,62
,2011,80100912,,,,11,21,32
,2011,80100916,,,,32,24,56
,2011,80100927,,,,37,0,37
,2011,80100938,,,,5,9,14
HND-007876,2011,80100945,,,,15,6,21
,2011,80100948,,,,22,25,47
,2011,80100951,,,,10,12,22
,2011,80100990,,,,30,44,74
,2011,80100997,,,,1,1,2
,2011,80101015,,,,6,6,12
HND-007891,2011,80101022,,,,10,18,28
,2011,80101037,,,,12,22,34
,2011,80101073,,,,11,11,22
,2011,80101084,,,,20,26,46
,2011,80101085,,,,1,5,6
HND-007902,2011,80101106,,,,10,13,23
,2011,80101122,,,,1,2,3
,2011,80101134,,,,64,85,149
,2011,80101149,,,,46,48,94
,2011,80101168,,,,7,9,16
,2011,80101187,,,,3,5,8
,2011,80101200,,,,2,8,10
,2011,80101204,,,,19,22,41
,2011,80101209,,,,4,8,12
,2011,80101259,,,,22,31,53
HND-007925,2011,80101282,,,,11,14,25
HND-007928,2011,80101353,,,,40,32,72
,2011,80101355,,,,10,16,26
,2011,80101356,,,,8,17,25
,2011,80101361,,,,2,3,5
,2011,80101368,,,,10,6,16
,2011,80101373,,,,28,64,92
,2011,80101464,,,,38,60,98
,2011,80101466,,,,11,9,20
,2011,80101467,,,,19,13,32
,2011,80101470,,,,20,12,32
,2011,80101471,,,,54,76,130
,2011,80101473,,,,14,10,24
,2011,80101477,,,,58,0,58
,2011,80101496,,,,10,9,19
,2011,80101553,,,,4,3,7
,2011,80101562,,,,6,0,6
,2011,80101615,,,,6,6,12
,2011,80101625,,,,14,9,23
,2011,80101634,,,,7,16,23
,2011,80101635,,,,36,39,75
,2011,80101657,,,,18,22,40
,2011,80101668,,,,0,2,2
,2011,80101669,,,,7,5,12
,2011,80101704,,,,11,7,18
,2011,80101706,,,,3,2,5
,2011,80101710,,,,4,1,5
HND-007390,2011,80100003,,,,8,10,18
,2011,80100009,,,,36,44,80
HND-007402,2011,80100018,,,,25,45,70
HND-007411,2011,80100026,,,,5,8,13
,2011,80100045,,,,30,41,71
HND-007428,2011,80100049,,,,17,18,35
HND-007433,2011,80100055,,,,17,9,26
HND-007458,2011,80100084,,,,6,13,19
,2011,80100099,,,,30,37,67
,2011,80100113,,,,19,26,45
,2011,80100156,,,,19,30,49
HND-007517,2011,80100158,,,,9,12,21
,2011,80100164,,,,16,13,29
HND-007524,2011,80100167,,,,67,88,155
HND-007527,2011,80100170,,,,12,14,26
,2011,80100173,,,,11,10,21
HND-007543,2011,80100187,,,,19,22,41
HND-007542,2011,80100187,,,,19,22,41
,2011,80100205,,,,35,32,67
,2011,80100207,,,,34,40,74
,2011,80100211,,,,0,157,157
,2011,80100212,,,,130,0,130
,2011,80100219,,,,14,20,34
,2011,80100225,,,,60,59,119
,2011,80100237,,,,44,34,78
,2011,80100240,,,,23,27,50
HND-007572,2011,80100241,,,,23,18,41
,2011,80100245,,,,7,10,17
HND-007575,2011,80100246,,,,26,30,56
,2011,80100261,,,,22,20,42
,2011,80100273,,,,3,3,6
,2011,80100278,,,,12,6,18
,2011,80100279,,,,45,52,97
,2011,80100284,,,,16,10,26
,2011,80100300,,,,11,15,26
,2011,80100308,,,,1,2,3
,2011,80100312,,,,13,19,32
HND-007608,2011,80100318,,,,24,23,47
,2011,80100319,,,,20,27,47
,2011,80100329,,,,13,9,22
,2011,80100337,,,,7,3,10
,2011,80100345,,,,12,7,19
,2011,80100346,,,,20,28,48
,2011,80100350,,,,34,24,58
,2011,80100374,,,,9,6,15
,2011,80100378,,,,4,4,8
,2011,80100380,,,,8,12,20
,2011,80100383,,,,10,6,16
,2011,80100384,,,,2,2,4
,2011,80100395,,,,10,7,17
HND-007643,2011,80100400,,,,17,22,39
,2011,80100404,,,,8,7,15
,2011,80100406,,,,16,15,31
,2011,80100407,,,,56,67,123
,2011,80100428,,,,29,38,67
,2011,80100436,,,,12,8,20
,2011,80100508,,,,19,19,38
,2011,80100560,,,,33,32,65
,2011,80100581,,,,16,13,29
,2011,80100582,,,,13,13,26
HND-007749,2011,80100609,,,,16,7,23
,2011,80100615,,,,9,11,20
HND-007755,2011,80100628,,,,10,26,36
HND-007756,2011,80100630,,,,188,209,397
HND-007757,2011,80100631,,,,268,121,389
,2011,80100633,,,,38,35,73
HND-007759,2011,80100634,,,,29,5,34
,2011,80100635,,,,74,109,183
,2011,80100639,,,,22,21,43
,2011,80100640,,,,11,9,20
HND-007760,2011,80100642,,,,333,526,859
,2011,80100644,,,,78,75,153
HND-007762,2011,80100648,,,,210,273,483
,2011,80100650,,,,13,11,24
HND-007764,2011,80100653,,,,33,29,62
,2011,80100654,,,,12,27,39
,2011,80100656,,,,13,7,20
HND-007765,2011,80100661,,,,31,29,60
,2011,80100663,,,,10,23,33
HND-007766,2011,80100664,,,,136,139,275
,2011,80100672,,,,7,11,18
,2011,80100674,,,,11,6,17
,2011,80100676,,,,14,8,22
HND-007771,2011,80100681,,,,81,103,184
HND-007772,2011,80100682,,,,74,65,139
HND-007775,2011,80100685,,,,50,70,120
HND-007778,2011,80100688,,,,64,82,146
HND-007780,2011,80100693,,,,19,0,19
HND-007781,2011,80100694,,,,66,60,126
,2011,80100696,,,,18,18,36
HND-007783,2011,80100697,,,,37,49,86
HND-007784,2011,80100698,,,,58,49,107
,2011,80100700,,,,20,17,37
HND-007786,2011,80100705,,,,40,56,96
,2011,80100722,,,,2,2,4
,2011,80100723,,,,5,13,18
,2011,80100736,,,,6,10,16
HND-007799,2011,80100739,,,,48,55,103
HND-007800,2011,80100741,,,,63,41,104
,2011,80100742,,,,20,13,33
,2011,80100791,,,,2,4,6
,2011,80100792,,,,1,2,3
,2011,80100803,,,,57,49,106
HND-007826,2011,80100823,,,,26,42,68
HND-007851,2011,80100868,,,,13,24,37
,2011,80100874,,,,29,41,70
,2011,80100877,,,,3,3,6
HND-007860,2011,80100895,,,,6,15,21
,2011,80100900,,,,11,17,28
HND-007863,2011,80100901,,,,64,50,114
,2011,80100938,,,,4,6,10
HND-007875,2011,80100941,,,,10,3,13
,2011,80100947,,,,49,48,97
,2011,80100951,,,,10,11,21
,2011,80100968,,,,8,7,15
,2011,80100971,,,,12,17,29
,2011,80100990,,,,51,49,100
,2011,80100997,,,,2,1,3
,2011,80101027,,,,14,17,31
,2011,80101082,,,,27,27,54
,2011,80101083,,,,11,2,13
,2011,80101084,,,,38,32,70
HND-007902,2011,80101106,,,,8,7,15
,2011,80101187,,,,4,6,10
,2011,80101204,,,,22,25,47
,2011,80101205,,,,6,3,9
,2011,80101206,,,,8,6,14
,2011,80101221,,,,7,6,13
,2011,80101260,,,,1,3,4
,2011,80101308,,,,20,27,47
,2011,80101355,,,,3,12,15
,2011,80101356,,,,14,21,35
,2011,80101357,,,,13,11,24
,2011,80101365,,,,8,11,19
,2011,80101370,,,,3,4,7
,2011,80101466,,,,10,13,23
,2011,80101470,,,,18,7,25
,2011,80101471,,,,63,82,145
,2011,80101553,,,,3,3,6
,2011,80101557,,,,34,24,58
,2011,80101559,,,,6,4,10
,2011,80101635,,,,42,40,82
,2011,80101657,,,,10,18,28
,2011,80101661,,,,8,11,19
,2011,80101669,,,,7,3,10
,2011,80101704,,,,6,8,14
,2011,80101710,,,,2,5,7
,2011,80100013,,,,7,8,15
HND-007445,2011,80100071,,,,21,19,40
HND-007455,2011,80100081,,,,21,30,51
HND-007464,2011,80100090,,,,11,15,26
HND-007474,2011,80100103,,,,9,6,15
,2011,80100107,,,,14,16,30
HND-007483,2011,80100116,,,,15,15,30
HND-007496,2011,80100129,,,,3,10,13
HND-007498,2011,80100131,,,,16,10,26
HND-007504,2011,80100138,,,,7,7,14
HND-007507,2011,80100142,,,,5,4,9
HND-007510,2011,80100147,,,,12,17,29
HND-007519,2011,80100161,,,,7,4,11
HND-007530,2011,80100175,,,,16,23,39
HND-007545,2011,80100189,,,,23,14,37
HND-007554,2011,80100200,,,,5,11,16
,2011,80100202,,,,23,20,43
,2011,80100208,,,,50,47,97
,2011,80100209,,,,13,10,23
HND-007556,2011,80100214,,,,11,14,25
,2011,80100217,,,,32,36,68
HND-007558,2011,80100220,,,,38,47,85
,2011,80100230,,,,0,90,90
,2011,80100239,,,,63,69,132
,2011,80100250,,,,29,21,50
HND-007586,2011,80100260,,,,6,11,17
,2011,80100282,,,,38,21,59
HND-007597,2011,80100292,,,,55,55,110
HND-007601,2011,80100296,,,,7,15,22
,2011,80100303,,,,22,25,47
,2011,80100317,,,,13,26,39
HND-007610,2011,80100325,,,,97,73,170
,2011,80100332,,,,14,21,35
,2011,80100336,,,,8,11,19
,2011,80100344,,,,6,9,15
,2011,80100355,,,,24,27,51
,2011,80100375,,,,10,17,27
HND-007638,2011,80100391,,,,12,25,37
HND-007642,2011,80100399,,,,3,7,10
,2011,80100403,,,,8,2,10
,2011,80100409,,,,9,8,17
,2011,80100418,,,,21,30,51
HND-007654,2011,80100422,,,,15,19,34
,2011,80100427,,,,5,14,19
,2011,80100435,,,,37,51,88
HND-007692,2011,80100488,,,,195,149,344
HND-007699,2011,80100498,,,,101,144,245
,2011,80100499,,,,13,12,25
,2011,80100565,,,,38,34,72
HND-007737,2011,80100585,,,,63,60,123
,2011,80100586,,,,11,10,21
,2011,80100595,,,,6,2,8
HND-007742,2011,80100597,,,,119,163,282
,2011,80100599,,,,10,10,20
,2011,80100614,,,,31,11,42
,2011,80100616,,,,11,11,22
,2011,80100620,,,,314,458,772
HND-007753,2011,80100621,,,,212,310,522
,2011,80100622,,,,105,118,223
,2011,80100629,,,,10,12,22
HND-007758,2011,80100632,,,,283,23,306
,2011,80100636,,,,76,84,160
,2011,80100637,,,,30,53,83
,2011,80100638,,,,25,17,42
HND-007761,2011,80100643,,,,373,558,931
HND-007763,2011,80100652,,,,102,131,233
,2011,80100655,,,,18,13,31
,2011,80100659,,,,0,23,23
HND-007767,2011,80100673,,,,69,87,156
,2011,80100675,,,,52,47,99
HND-007769,2011,80100679,,,,147,168,315
HND-007770,2011,80100680,,,,29,45,74
HND-007773,2011,80100683,,,,114,168,282
HND-007774,2011,80100684,,,,61,24,85
HND-007776,2011,80100686,,,,30,36,66
,2011,80100687,,,,64,85,149
HND-007779,2011,80100691,,,,85,123,208
HND-007782,2011,80100695,,,,31,33,64
HND-007785,2011,80100699,,,,78,112,190
,2011,80100701,,,,22,18,40
,2011,80100702,,,,11,15,26
,2011,80100738,,,,11,22,33
HND-007804,2011,80100762,,,,16,21,37
,2011,80100767,,,,9,4,13
,2011,80100802,,,,13,8,21
,2011,80100831,,,,3,2,5
,2011,80100846,,,,0,1,1
HND-007848,2011,80100865,,,,9,13,22
HND-007850,2011,80100867,,,,20,36,56
,2011,80100872,,,,2,2,4
,2011,80100876,,,,7,2,9
HND-007853,2011,80100879,,,,82,95,177
HND-007854,2011,80100881,,,,30,54,84
,2011,80100882,,,,136,158,294
HND-007859,2011,80100894,,,,61,69,130
HND-007866,2011,80100908,,,,11,15,26
HND-007867,2011,80100910,,,,34,24,58
,2011,80100912,,,,15,20,35
,2011,80100916,,,,40,25,65
HND-007869,2011,80100922,,,,44,97,141
,2011,80100927,,,,20,0,20
HND-007876,2011,80100945,,,,10,3,13
,2011,80100948,,,,15,26,41
,2011,80100954,,,,8,1,9
,2011,80101014,,,,11,24,35
,2011,80101015,,,,4,8,12
HND-007891,2011,80101022,,,,8,14,22
,2011,80101028,,,,27,46,73
,2011,80101037,,,,15,12,27
,2011,80101073,,,,16,10,26
,2011,80101074,,,,12,14,26
HND-007898,2011,80101079,,,,6,1,7
,2011,80101085,,,,5,3,8
,2011,80101122,,,,6,7,13
HND-007908,2011,80101123,,,,12,6,18
,2011,80101134,,,,41,49,90
,2011,80101145,,,,52,81,133
,2011,80101149,,,,52,53,105
,2011,80101157,,,,25,49,74
,2011,80101161,,,,44,81,125
,2011,80101164,,,,10,12,22
,2011,80101167,,,,11,16,27
,2011,80101168,,,,2,4,6
,2011,80101200,,,,3,5,8
,2011,80101201,,,,64,94,158
,2011,80101209,,,,7,1,8
,2011,80101259,,,,26,29,55
HND-007925,2011,80101282,,,,16,8,24
,2011,80101300,,,,17,12,29
,2011,80101310,,,,2,1,3
HND-007928,2011,80101353,,,,31,22,53
,2011,80101361,,,,3,2,5
,2011,80101363,,,,18,11,29
,2011,80101368,,,,11,10,21
,2011,80101371,,,,34,59,93
,2011,80101373,,,,37,48,85
HND-007932,2011,80101463,,,,51,44,95
,2011,80101464,,,,33,64,97
,2011,80101467,,,,12,20,32
,2011,80101473,,,,16,17,33
,2011,80101476,,,,4,8,12
,2011,80101477,,,,49,0,49
,2011,80101478,,,,11,6,17
,2011,80101483,,,,11,16,27
,2011,80101496,,,,10,9,19
HND-007943,2011,80101528,,,,695,1225,1920
,2011,80101558,,,,32,21,53
,2011,80101561,,,,32,32,64
,2011,80101562,,,,3,2,5
,2011,80101592,,,,14,12,26
,2011,80101615,,,,6,12,18
,2011,80101625,,,,14,10,24
,2011,80101634,,,,9,8,17
,2011,80101685,,,,3,2,5
,2011,80100009,,,,26,50,76
,2011,80100013,,,,5,4,9
,2011,80100099,,,,31,28,59
,2011,80100107,,,,19,23,42
,2011,80100205,,,,43,28,71
,2011,80100207,,,,19,28,47
,2011,80100208,,,,43,50,93
,2011,80100212,,,,135,0,135
,2011,80100217,,,,42,38,80
,2011,80100219,,,,27,12,39
,2011,80100237,,,,41,44,85
,2011,80100261,,,,11,7,18
,2011,80100279,,,,34,49,83
HND-007597,2011,80100292,,,,66,73,139
,2011,80100303,,,,21,21,42
HND-007610,2011,80100325,,,,33,63,96
,2011,80100329,,,,9,15,24
,2011,80100332,,,,17,14,31
,2011,80100336,,,,8,0,8
,2011,80100355,,,,31,36,67
,2011,80100375,,,,13,13,26
,2011,80100383,,,,8,4,12
,2011,80100406,,,,7,4,11
,2011,80100409,,,,5,5,10
HND-007654,2011,80100422,,,,3,20,23
,2011,80100435,,,,81,104,185
HND-007692,2011,80100488,,,,293,207,500
HND-007699,2011,80100498,,,,79,111,190
,2011,80100499,,,,19,16,35
,2011,80100508,,,,14,10,24
,2011,80100565,,,,33,56,89
,2011,80100582,,,,6,9,15
,2011,80100595,,,,5,4,9
HND-007749,2011,80100609,,,,6,18,24
,2011,80100620,,,,283,459,742
HND-007753,2011,80100621,,,,288,434,722
HND-007754,2011,80100627,,,,59,19,78
HND-007755,2011,80100628,,,,20,25,45
HND-007756,2011,80100630,,,,153,150,303
HND-007758,2011,80100632,,,,603,114,717
,2011,80100633,,,,48,56,104
HND-007759,2011,80100634,,,,72,11,83
,2011,80100636,,,,120,71,191
,2011,80100637,,,,42,68,110
,2011,80100644,,,,118,128,246
HND-007762,2011,80100648,,,,245,413,658
,2011,80100659,,,,0,27,27
HND-007766,2011,80100664,,,,106,172,278
,2011,80100675,,,,44,51,95
HND-007769,2011,80100679,,,,96,123,219
HND-007771,2011,80100681,,,,57,89,146
HND-007773,2011,80100683,,,,83,142,225
,2011,80100687,,,,55,69,124
HND-007779,2011,80100691,,,,100,137,237
HND-007785,2011,80100699,,,,61,104,165
HND-007786,2011,80100705,,,,32,41,73
,2011,80100736,,,,4,6,10
,2011,80100738,,,,14,7,21
HND-007799,2011,80100739,,,,35,67,102
,2011,80100767,,,,6,2,8
,2011,80100802,,,,8,8,16
,2011,80100831,,,,2,5,7
,2011,80100874,,,,42,38,80
,2011,80100876,,,,1,4,5
HND-007853,2011,80100879,,,,72,97,169
HND-007854,2011,80100881,,,,34,45,79
,2011,80100882,,,,153,133,286
HND-007859,2011,80100894,,,,43,43,86
HND-007863,2011,80100901,,,,21,7,28
HND-007867,2011,80100910,,,,29,52,81
,2011,80100916,,,,20,16,36
HND-007875,2011,80100941,,,,22,8,30
HND-007876,2011,80100945,,,,3,3,6
,2011,80100947,,,,59,62,121
,2011,80100948,,,,17,28,45
,2011,80101014,,,,6,18,24
,2011,80101028,,,,94,130,224
,2011,80101037,,,,35,36,71
,2011,80101073,,,,41,32,73
,2011,80101084,,,,51,69,120
,2011,80101085,,,,2,2,4
,2011,80101134,,,,15,29,44
,2011,80101145,,,,31,77,108
,2011,80101157,,,,35,36,71
,2011,80101161,,,,29,48,77
,2011,80101162,,,,3,5,8
,2011,80101164,,,,4,4,8
,2011,80101167,,,,11,10,21
,2011,80101168,,,,6,5,11
,2011,80101201,,,,97,175,272
,2011,80101205,,,,2,3,5
,2011,80101206,,,,9,4,13
,2011,80101209,,,,12,5,17
,2011,80101221,,,,10,12,22
,2011,80101329,,,,29,52,81
HND-007928,2011,80101353,,,,15,26,41
,2011,80101357,,,,18,26,44
,2011,80101361,,,,1,0,1
,2011,80101363,,,,4,9,13
,2011,80101368,,,,4,6,10
,2011,80101370,,,,4,6,10
,2011,80101371,,,,72,97,169
,2011,80101373,,,,62,85,147
HND-007932,2011,80101463,,,,35,49,84
,2011,80101470,,,,26,24,50
,2011,80101471,,,,110,190,300
,2011,80101473,,,,9,12,21
,2011,80101476,,,,6,1,7
,2011,80101477,,,,42,0,42
,2011,80101496,,,,1,3,4
HND-007943,2011,80101528,,,,590,1065,1655
,2011,80101557,,,,48,79,127
,2011,80101558,,,,43,44,87
,2011,80101561,,,,12,26,38
,2011,80101592,,,,16,15,31
HND-007955,2011,80101597,,,,16,9,25
,2011,80101615,,,,10,7,17
,2011,80101634,,,,11,11,22
,2011,80101635,,,,44,84,128
,2011,80101702,,,,11,16,27
,2011,80100045,,,,34,64,98
,2011,80100156,,,,23,31,54
HND-007524,2011,80100167,,,,80,108,188
HND-007530,2011,80100175,,,,6,8,14
,2011,80100202,,,,27,24,51
,2011,80100209,,,,9,10,19
,2011,80100211,,,,0,139,139
,2011,80100225,,,,79,63,142
,2011,80100230,,,,0,91,91
,2011,80100239,,,,71,87,158
,2011,80100240,,,,31,33,64
,2011,80100250,,,,37,36,73
,2011,80100278,,,,8,17,25
,2011,80100282,,,,48,40,88
,2011,80100300,,,,23,18,41
,2011,80100312,,,,4,10,14
HND-007608,2011,80100318,,,,7,20,27
,2011,80100319,,,,25,37,62
,2011,80100337,,,,9,11,20
,2011,80100344,,,,7,4,11
,2011,80100345,,,,8,0,8
,2011,80100346,,,,22,36,58
,2011,80100350,,,,59,29,88
,2011,80100374,,,,8,19,27
,2011,80100378,,,,6,3,9
,2011,80100380,,,,9,13,22
,2011,80100403,,,,6,4,10
,2011,80100404,,,,9,11,20
,2011,80100427,,,,12,2,14
,2011,80100428,,,,10,21,31
,2011,80100560,,,,55,47,102
,2011,80100581,,,,9,16,25
HND-007737,2011,80100585,,,,30,49,79
,2011,80100586,,,,10,7,17
HND-007742,2011,80100597,,,,191,205,396
,2011,80100614,,,,20,21,41
,2011,80100615,,,,20,37,57
,2011,80100616,,,,20,23,43
,2011,80100622,,,,120,129,249
,2011,80100629,,,,14,17,31
HND-007757,2011,80100631,,,,307,42,349
,2011,80100635,,,,86,109,195
,2011,80100638,,,,17,31,48
,2011,80100639,,,,26,40,66
,2011,80100640,,,,69,68,137
HND-007760,2011,80100642,,,,251,452,703
HND-007761,2011,80100643,,,,583,914,1497
HND-007763,2011,80100652,,,,119,214,333
HND-007764,2011,80100653,,,,14,25,39
,2011,80100654,,,,20,36,56
,2011,80100655,,,,7,13,20
,2011,80100656,,,,37,32,69
HND-007765,2011,80100661,,,,13,30,43
,2011,80100663,,,,15,19,34
,2011,80100672,,,,17,7,24
HND-007767,2011,80100673,,,,114,159,273
,2011,80100674,,,,18,10,28
,2011,80100676,,,,14,22,36
HND-007770,2011,80100680,,,,24,28,52
HND-007772,2011,80100682,,,,42,54,96
HND-007774,2011,80100684,,,,40,7,47
HND-007775,2011,80100685,,,,33,13,46
HND-007776,2011,80100686,,,,15,19,34
HND-007778,2011,80100688,,,,38,87,125
HND-007780,2011,80100693,,,,24,0,24
HND-007781,2011,80100694,,,,60,73,133
,2011,80100696,,,,13,18,31
HND-007783,2011,80100697,,,,55,61,116
HND-007784,2011,80100698,,,,45,80,125
,2011,80100700,,,,25,25,50
,2011,80100701,,,,21,28,49
,2011,80100702,,,,10,3,13
,2011,80100723,,,,10,71,81
HND-007800,2011,80100741,,,,64,59,123
,2011,80100742,,,,14,15,29
,2011,80100791,,,,8,0,8
,2011,80100792,,,,1,3,4
,2011,80100803,,,,48,65,113
,2011,80100872,,,,16,21,37
HND-007860,2011,80100895,,,,124,228,352
,2011,80100900,,,,13,17,30
HND-007866,2011,80100908,,,,4,8,12
,2011,80100912,,,,19,26,45
HND-007869,2011,80100922,,,,271,649,920
,2011,80100938,,,,6,12,18
,2011,80100951,,,,4,8,12
,2011,80100968,,,,4,6,10
,2011,80100971,,,,15,11,26
,2011,80100990,,,,42,36,78
,2011,80100997,,,,1,1,2
,2011,80101015,,,,19,19,38
,2011,80101027,,,,19,10,29
,2011,80101074,,,,8,9,17
HND-007898,2011,80101079,,,,29,5,34
,2011,80101082,,,,37,21,58
,2011,80101083,,,,15,19,34
,2011,80101122,,,,16,8,24
,2011,80101149,,,,42,50,92
,2011,80101187,,,,13,5,18
,2011,80101204,,,,17,24,41
,2011,80101259,,,,20,24,44
,2011,80101300,,,,26,26,52
,2011,80101308,,,,26,42,68
,2011,80101356,,,,3,11,14
,2011,80101359,,,,0,8,8
,2011,80101365,,,,12,7,19
,2011,80101464,,,,29,50,79
,2011,80101466,,,,10,16,26
,2011,80101467,,,,14,29,43
,2011,80101478,,,,5,8,13
,2011,80101559,,,,3,9,12
,2011,80101562,,,,6,4,10
,2011,80101625,,,,41,38,79
,2011,80101657,,,,6,7,13
,2011,80101661,,,,15,22,37
,2011,80101669,,,,2,2,4
,2011,80101685,,,,1,0,1
,2011,80101704,,,,6,2,8
HND-007524,2011,80100167,,,,58,76,134
HND-007530,2011,80100175,,,,5,5,10
,2011,80100205,,,,51,51,102
,2011,80100208,,,,43,41,84
,2011,80100212,,,,117,0,117
,2011,80100217,,,,51,40,91
,2011,80100230,,,,0,107,107
,2011,80100250,,,,37,37,74
,2011,80100261,,,,4,9,13
,2011,80100279,,,,33,38,71
,2011,80100282,,,,43,29,72
HND-007597,2011,80100292,,,,34,67,101
,2011,80100303,,,,11,22,33
HND-007610,2011,80100325,,,,26,38,64
,2011,80100329,,,,13,12,25
,2011,80100332,,,,15,21,36
,2011,80100344,,,,5,5,10
,2011,80100355,,,,25,42,67
,2011,80100375,,,,7,11,18
HND-007654,2011,80100422,,,,7,14,21
,2011,80100435,,,,68,80,148
HND-007692,2011,80100488,,,,179,115,294
HND-007699,2011,80100498,,,,66,76,142
,2011,80100499,,,,16,8,24
,2011,80100508,,,,12,14,26
,2011,80100565,,,,41,56,97
,2011,80100581,,,,12,10,22
,2011,80100586,,,,7,5,12
HND-007742,2011,80100597,,,,93,195,288
,2011,80100616,,,,30,19,49
,2011,80100620,,,,184,387,571
HND-007753,2011,80100621,,,,211,307,518
HND-007754,2011,80100627,,,,45,20,65
,2011,80100629,,,,12,31,43
HND-007758,2011,80100632,,,,494,68,562
HND-007759,2011,80100634,,,,39,5,44
,2011,80100636,,,,118,88,206
,2011,80100637,,,,28,66,94
,2011,80100638,,,,28,25,53
,2011,80100655,,,,10,12,22
,2011,80100659,,,,0,31,31
HND-007767,2011,80100673,,,,74,125,199
,2011,80100675,,,,34,34,68
HND-007769,2011,80100679,,,,53,105,158
HND-007771,2011,80100681,,,,46,71,117
HND-007773,2011,80100683,,,,63,122,185
HND-007776,2011,80100686,,,,11,11,22
,2011,80100687,,,,58,68,126
HND-007779,2011,80100691,,,,87,129,216
HND-007785,2011,80100699,,,,32,81,113
HND-007786,2011,80100705,,,,24,31,55
,2011,80100736,,,,2,3,5
,2011,80100738,,,,13,11,24
HND-007799,2011,80100739,,,,25,50,75
,2011,80100802,,,,7,2,9
,2011,80100874,,,,39,65,104
HND-007860,2011,80100895,,,,130,295,425
HND-007866,2011,80100908,,,,1,4,5
,2011,80100912,,,,21,30,51
,2011,80100916,,,,33,30,63
HND-007869,2011,80100922,,,,214,521,735
HND-007875,2011,80100941,,,,10,2,12
HND-007876,2011,80100945,,,,3,1,4
,2011,80100947,,,,48,62,110
,2011,80100948,,,,16,21,37
,2011,80100968,,,,5,3,8
,2011,80101014,,,,9,19,28
,2011,80101028,,,,53,79,132
,2011,80101074,,,,12,5,17
HND-007898,2011,80101079,,,,4,3,7
,2011,80101082,,,,43,17,60
,2011,80101083,,,,8,4,12
,2011,80101084,,,,51,57,108
,2011,80101134,,,,17,26,43
,2011,80101145,,,,25,66,91
,2011,80101149,,,,28,34,62
,2011,80101157,,,,20,35,55
,2011,80101161,,,,46,69,115
,2011,80101162,,,,38,37,75
,2011,80101167,,,,6,2,8
,2011,80101201,,,,44,123,167
,2011,80101209,,,,6,5,11
,2011,80101221,,,,7,3,10
,2011,80101300,,,,44,26,70
,2011,80101308,,,,19,29,48
HND-007928,2011,80101353,,,,7,10,17
,2011,80101365,,,,5,8,13
,2011,80101371,,,,53,79,132
,2011,80101373,,,,31,58,89
HND-007932,2011,80101463,,,,26,40,66
,2011,80101467,,,,12,12,24
,2011,80101473,,,,12,16,28
,2011,80101478,,,,46,37,83
HND-007943,2011,80101528,,,,484,933,1417
,2011,80101558,,,,25,36,61
,2011,80101561,,,,14,20,34
,2011,80101562,,,,1,1,2
,2011,80101592,,,,6,10,16
HND-007955,2011,80101597,,,,10,8,18
,2011,80101615,,,,5,3,8
,2011,80101625,,,,5,15,20
,2011,80101657,,,,8,4,12
,2011,80101702,,,,12,14,26
,2011,80100009,,,,43,38,81
,2011,80100013,,,,4,3,7
,2011,80100045,,,,39,65,104
,2011,80100099,,,,24,31,55
,2011,80100107,,,,79,127,206
,2011,80100156,,,,23,30,53
,2011,80100202,,,,27,22,49
,2011,80100207,,,,29,37,66
,2011,80100209,,,,6,9,15
,2011,80100211,,,,0,136,136
,2011,80100219,,,,19,17,36
,2011,80100225,,,,65,73,138
,2011,80100237,,,,31,26,57
,2011,80100239,,,,74,64,138
,2011,80100240,,,,18,28,46
,2011,80100278,,,,11,9,20
,2011,80100300,,,,16,35,51
,2011,80100312,,,,7,8,15
HND-007608,2011,80100318,,,,11,4,15
,2011,80100319,,,,23,33,56
,2011,80100337,,,,5,9,14
,2011,80100345,,,,10,6,16
,2011,80100346,,,,15,14,29
,2011,80100350,,,,58,35,93
,2011,80100374,,,,10,10,20
,2011,80100378,,,,9,2,11
,2011,80100380,,,,6,13,19
,2011,80100383,,,,3,9,12
,2011,80100403,,,,9,5,14
,2011,80100406,,,,2,7,9
,2011,80100427,,,,2,8,10
,2011,80100428,,,,12,17,29
,2011,80100560,,,,26,26,52
,2011,80100582,,,,4,5,9
HND-007737,2011,80100585,,,,32,43,75
,2011,80100595,,,,7,1,8
HND-007749,2011,80100609,,,,14,8,22
,2011,80100614,,,,4,11,15
,2011,80100615,,,,14,29,43
,2011,80100622,,,,89,116,205
HND-007755,2011,80100628,,,,27,30,57
HND-007756,2011,80100630,,,,123,143,266
HND-007757,2011,80100631,,,,293,42,335
,2011,80100633,,,,34,33,67
,2011,80100635,,,,68,119,187
,2011,80100639,,,,19,25,44
,2011,80100640,,,,18,21,39
HND-007760,2011,80100642,,,,165,286,451
HND-007761,2011,80100643,,,,482,829,1311
,2011,80100644,,,,115,145,260
HND-007762,2011,80100648,,,,157,295,452
HND-007763,2011,80100652,,,,107,158,265
HND-007764,2011,80100653,,,,11,16,27
,2011,80100654,,,,44,23,67
,2011,80100656,,,,14,5,19
HND-007765,2011,80100661,,,,18,11,29
,2011,80100663,,,,14,11,25
HND-007766,2011,80100664,,,,89,145,234
,2011,80100672,,,,11,14,25
,2011,80100674,,,,28,14,42
,2011,80100676,,,,13,14,27
HND-007770,2011,80100680,,,,14,26,40
HND-007772,2011,80100682,,,,26,57,83
HND-007774,2011,80100684,,,,28,4,32
HND-007775,2011,80100685,,,,33,3,36
HND-007778,2011,80100688,,,,41,62,103
HND-007780,2011,80100693,,,,10,0,10
HND-007781,2011,80100694,,,,46,81,127
,2011,80100696,,,,14,16,30
HND-007783,2011,80100697,,,,27,39,66
HND-007784,2011,80100698,,,,30,60,90
,2011,80100700,,,,10,26,36
,2011,80100701,,,,10,17,27
,2011,80100702,,,,11,3,14
,2011,80100723,,,,3,38,41
HND-007800,2011,80100741,,,,47,43,90
,2011,80100742,,,,20,23,43
,2011,80100791,,,,5,3,8
,2011,80100803,,,,39,40,79
,2011,80100831,,,,5,4,9
,2011,80100872,,,,10,13,23
,2011,80100876,,,,21,4,25
HND-007853,2011,80100879,,,,48,70,118
HND-007854,2011,80100881,,,,4,18,22
,2011,80100882,,,,133,145,278
HND-007859,2011,80100894,,,,44,43,87
,2011,80100900,,,,12,14,26
HND-007863,2011,80100901,,,,13,0,13
HND-007867,2011,80100910,,,,20,37,57
,2011,80100938,,,,19,27,46
,2011,80100951,,,,6,5,11
,2011,80100971,,,,6,6,12
,2011,80100990,,,,33,40,73
,2011,80100997,,,,1,0,1
,2011,80101015,,,,17,15,32
,2011,80101027,,,,7,5,12
,2011,80101037,,,,37,24,61
,2011,80101073,,,,8,16,24
,2011,80101085,,,,6,2,8
,2011,80101122,,,,2,1,3
,2011,80101187,,,,9,13,22
,2011,80101204,,,,12,9,21
,2011,80101206,,,,6,5,11
,2011,80101329,,,,20,37,57
,2011,80101356,,,,5,2,7
,2011,80101357,,,,18,17,35
,2011,80101359,,,,0,7,7
,2011,80101361,,,,1,4,5
,2011,80101363,,,,5,6,11
,2011,80101370,,,,7,4,11
,2011,80101464,,,,17,33,50
,2011,80101466,,,,12,12,24
,2011,80101470,,,,36,30,66
,2011,80101471,,,,84,150,234
,2011,80101476,,,,4,1,5
,2011,80101477,,,,33,0,33
,2011,80101496,,,,9,1,10
,2011,80101557,,,,40,75,115
,2011,80101559,,,,2,10,12
,2011,80101635,,,,47,78,125
,2011,80101661,,,,71,42,113
,2011,80101669,,,,13,9,22
,2011,80101685,,,,1,4,5
,2011,80100009,,,,53,39,92
,2011,80100013,,,,1,1,2
,2011,80100045,,,,15,13,28
HND-007524,2011,80100167,,,,30,71,101
HND-007530,2011,80100175,,,,5,6,11
,2011,80100202,,,,9,17,26
,2011,80100211,,,,0,36,36
,2011,80100225,,,,18,19,37
,2011,80100230,,,,0,9,9
,2011,80100239,,,,34,33,67
,2011,80100250,,,,41,30,71
,2011,80100300,,,,12,11,23
HND-007608,2011,80100318,,,,6,7,13
,2011,80100319,,,,8,6,14
,2011,80100346,,,,8,6,14
,2011,80100350,,,,16,8,24
,2011,80100374,,,,8,8,16
,2011,80100581,,,,6,8,14
,2011,80100586,,,,8,2,10
HND-007742,2011,80100597,,,,96,172,268
HND-007749,2011,80100609,,,,12,16,28
,2011,80100614,,,,10,5,15
,2011,80100615,,,,6,6,12
,2011,80100622,,,,48,90,138
HND-007754,2011,80100627,,,,41,20,61
HND-007755,2011,80100628,,,,23,20,43
HND-007757,2011,80100631,,,,246,46,292
,2011,80100635,,,,7,10,17
,2011,80100639,,,,12,7,19
,2011,80100640,,,,8,11,19
HND-007760,2011,80100642,,,,111,230,341
HND-007761,2011,80100643,,,,335,702,1037
,2011,80100644,,,,83,109,192
HND-007762,2011,80100648,,,,121,254,375
HND-007763,2011,80100652,,,,61,116,177
HND-007764,2011,80100653,,,,15,21,36
,2011,80100654,,,,17,14,31
,2011,80100656,,,,1,2,3
HND-007765,2011,80100661,,,,6,15,21
,2011,80100663,,,,12,9,21
HND-007766,2011,80100664,,,,84,114,198
,2011,80100672,,,,5,6,11
HND-007767,2011,80100673,,,,36,68,104
,2011,80100676,,,,5,6,11
HND-007770,2011,80100680,,,,13,32,45
HND-007772,2011,80100682,,,,35,38,73
HND-007774,2011,80100684,,,,20,6,26
HND-007775,2011,80100685,,,,29,9,38
HND-007776,2011,80100686,,,,18,14,32
HND-007778,2011,80100688,,,,23,55,78
HND-007780,2011,80100693,,,,5,0,5
HND-007781,2011,80100694,,,,50,64,114
,2011,80100696,,,,6,16,22
HND-007783,2011,80100697,,,,29,54,83
HND-007784,2011,80100698,,,,28,47,75
,2011,80100700,,,,7,19,26
,2011,80100701,,,,7,22,29
,2011,80100702,,,,4,2,6
,2011,80100723,,,,6,46,52
HND-007800,2011,80100741,,,,42,29,71
,2011,80100791,,,,3,4,7
,2011,80100803,,,,30,41,71
,2011,80100874,,,,14,35,49
HND-007860,2011,80100895,,,,132,259,391
HND-007863,2011,80100901,,,,17,7,24
HND-007867,2011,80100910,,,,13,24,37
,2011,80100916,,,,40,62,102
,2011,80100938,,,,5,7,12
,2011,80100990,,,,29,42,71
,2011,80101015,,,,7,9,16
,2011,80101027,,,,4,4,8
,2011,80101074,,,,4,3,7
HND-007898,2011,80101079,,,,6,8,14
,2011,80101082,,,,30,19,49
,2011,80101083,,,,4,3,7
,2011,80101084,,,,42,45,87
,2011,80101122,,,,1,1,2
,2011,80101149,,,,6,6,12
,2011,80101329,,,,13,24,37
,2011,80101464,,,,17,19,36
,2011,80101466,,,,6,9,15
,2011,80101467,,,,2,8,10
,2011,80101471,,,,70,128,198
,2011,80101473,,,,24,32,56
,2011,80101478,,,,3,6,9
,2011,80101557,,,,12,39,51
,2011,80101559,,,,0,4,4
,2011,80101562,,,,3,1,4
,2011,80101625,,,,7,12,19
,2011,80101657,,,,2,3,5
,2011,80101661,,,,1,6,7
,2011,80101668,,,,6,6,12
,2011,80101669,,,,9,7,16
,2011,80100099,,,,21,19,40
,2011,80100107,,,,19,34,53
,2011,80100205,,,,28,35,63
,2011,80100217,,,,15,10,25
,2011,80100219,,,,4,1,5
,2011,80100237,,,,32,46,78
HND-007597,2011,80100292,,,,52,69,121
,2011,80100303,,,,2,8,10
HND-007610,2011,80100325,,,,12,31,43
,2011,80100344,,,,5,6,11
,2011,80100355,,,,28,28,56
HND-007654,2011,80100422,,,,15,15,30
,2011,80100435,,,,27,28,55
HND-007692,2011,80100488,,,,194,123,317
HND-007699,2011,80100498,,,,53,80,133
,2011,80100565,,,,26,36,62
HND-007737,2011,80100585,,,,21,38,59
,2011,80100616,,,,12,5,17
,2011,80100620,,,,194,390,584
HND-007753,2011,80100621,,,,166,266,432
,2011,80100629,,,,18,27,45
HND-007756,2011,80100630,,,,103,110,213
HND-007758,2011,80100632,,,,423,38,461
,2011,80100633,,,,22,38,60
HND-007759,2011,80100634,,,,10,2,12
,2011,80100636,,,,45,51,96
,2011,80100637,,,,14,39,53
,2011,80100638,,,,15,22,37
,2011,80100655,,,,9,11,20
,2011,80100659,,,,0,28,28
HND-007769,2011,80100679,,,,46,88,134
HND-007771,2011,80100681,,,,25,55,80
HND-007773,2011,80100683,,,,48,105,153
,2011,80100687,,,,38,59,97
HND-007779,2011,80100691,,,,65,102,167
HND-007785,2011,80100699,,,,40,61,101
HND-007786,2011,80100705,,,,11,23,34
HND-007799,2011,80100739,,,,20,42,62
,2011,80100872,,,,5,5,10
HND-007853,2011,80100879,,,,51,65,116
HND-007854,2011,80100881,,,,17,25,42
,2011,80100882,,,,47,66,113
HND-007859,2011,80100894,,,,24,34,58
,2011,80100900,,,,7,2,9
HND-007866,2011,80100908,,,,4,1,5
,2011,80100912,,,,9,10,19
HND-007869,2011,80100922,,,,131,370,501
HND-007875,2011,80100941,,,,5,4,9
HND-007876,2011,80100945,,,,6,7,13
,2011,80100947,,,,25,49,74
,2011,80101028,,,,26,57,83
,2011,80101073,,,,11,11,22
,2011,80101145,,,,5,34,39
,2011,80101157,,,,17,21,38
,2011,80101161,,,,24,40,64
,2011,80101162,,,,5,6,11
,2011,80101201,,,,23,53,76
,2011,80101300,,,,17,25,42
,2011,80101308,,,,2,16,18
,2011,80101357,,,,5,0,5
,2011,80101371,,,,36,48,84
,2011,80101373,,,,18,27,45
HND-007932,2011,80101463,,,,11,34,45
,2011,80101558,,,,13,20,33
,2011,80101561,,,,8,4,12
,2011,80101592,,,,6,3,9
HND-007955,2011,80101597,,,,10,4,14
,2011,80101615,,,,4,2,6
,2011,80101635,,,,17,44,61
,2011,80100916,,,,30,41,71
,2011,80200013,,,,3,2,5
,2011,80200014,,,,2,3,5
HND-008008,2011,80200019,,,,1,8,9
HND-008010,2011,80200021,,,,6,7,13
,2011,80200025,,,,2,3,5
HND-008012,2011,80200027,,,,1,4,5
HND-008013,2011,80200028,,,,5,2,7
HND-008017,2011,80200032,,,,3,2,5
,2011,80200048,,,,1,4,5
,2011,80200070,,,,4,2,6
,2011,80200071,,,,3,2,5
,2011,80200072,,,,3,2,5
,2011,80200073,,,,1,4,5
HND-008004,2011,80200011,,,,1,4,5
HND-008005,2011,80200012,,,,2,3,5
HND-008006,2011,80200015,,,,3,2,5
HND-008007,2011,80200016,,,,3,2,5
HND-008009,2011,80200020,,,,3,2,5
,2011,80200063,,,,2,3,5
,2011,80200068,,,,2,3,5
HND-008020,2011,80200069,,,,8,5,13
HND-008021,2011,80200074,,,,5,4,9
,2011,80200075,,,,2,3,5
,2011,80200024,,,,3,5,8
HND-008018,2011,80200040,,,,5,4,9
,2011,80200024,,,,5,3,8
HND-008018,2011,80200040,,,,4,6,10
HND-008014,2011,80200029,,,,9,13,22
HND-007994,2011,80200001,,,,2,3,5
HND-007998,2011,80200005,,,,9,16,25
HND-007999,2011,80200006,,,,16,12,28
HND-008000,2011,80200007,,,,7,5,12
HND-008001,2011,80200008,,,,20,16,36
HND-008003,2011,80200010,,,,4,6,10
HND-008016,2011,80200031,,,,1,1,2
HND-007995,2011,80200002,,,,3,5,8
HND-007996,2011,80200003,,,,10,5,15
HND-007997,2011,80200004,,,,12,11,23
HND-008002,2011,80200009,,,,8,4,12
HND-008015,2011,80200030,,,,16,8,24
HND-008019,2011,80200067,,,,6,6,12
HND-007997,2011,80200004,,,,14,17,31
HND-007998,2011,80200005,,,,13,8,21
HND-007999,2011,80200006,,,,6,10,16
HND-008000,2011,80200007,,,,6,5,11
HND-008001,2011,80200008,,,,21,11,32
HND-008015,2011,80200030,,,,10,9,19
HND-008016,2011,80200031,,,,5,2,7
HND-007994,2011,80200001,,,,1,3,4
HND-007995,2011,80200002,,,,5,2,7
HND-007996,2011,80200003,,,,4,7,11
HND-008002,2011,80200009,,,,6,9,15
HND-008003,2011,80200010,,,,6,6,12
HND-008019,2011,80200067,,,,4,7,11
HND-007997,2011,80200004,,,,17,13,30
HND-007998,2011,80200005,,,,12,9,21
HND-007999,2011,80200006,,,,19,10,29
HND-008000,2011,80200007,,,,6,6,12
HND-008001,2011,80200008,,,,18,15,33
HND-008003,2011,80200010,,,,5,5,10
HND-008015,2011,80200030,,,,13,7,20
HND-007994,2011,80200001,,,,4,4,8
HND-007995,2011,80200002,,,,4,1,5
HND-007996,2011,80200003,,,,4,9,13
HND-008002,2011,80200009,,,,8,6,14
HND-008016,2011,80200031,,,,5,4,9
HND-008019,2011,80200067,,,,6,3,9
HND-007996,2011,80200003,,,,10,5,15
HND-007997,2011,80200004,,,,14,14,28
HND-008000,2011,80200007,,,,8,8,16
HND-008001,2011,80200008,,,,13,17,30
HND-008002,2011,80200009,,,,5,5,10
HND-008015,2011,80200030,,,,16,11,27
HND-008016,2011,80200031,,,,5,3,8
HND-007994,2011,80200001,,,,6,3,9
HND-007998,2011,80200005,,,,13,6,19
HND-007999,2011,80200006,,,,8,9,17
HND-008003,2011,80200010,,,,3,9,12
HND-008019,2011,80200067,,,,13,6,19
HND-007995,2011,80200002,,,,4,2,6
HND-007996,2011,80200003,,,,9,6,15
HND-007997,2011,80200004,,,,14,11,25
HND-008001,2011,80200008,,,,21,21,42
HND-008002,2011,80200009,,,,7,6,13
HND-008015,2011,80200030,,,,12,13,25
HND-008016,2011,80200031,,,,6,4,10
HND-007994,2011,80200001,,,,3,5,8
HND-007998,2011,80200005,,,,18,13,31
HND-007999,2011,80200006,,,,15,10,25
HND-008000,2011,80200007,,,,5,8,13
HND-008003,2011,80200010,,,,5,3,8
HND-008019,2011,80200067,,,,6,2,8
HND-007994,2011,80200001,,,,3,4,7
HND-007995,2011,80200002,,,,0,3,3
HND-007996,2011,80200003,,,,7,10,17
HND-008002,2011,80200009,,,,1,5,6
HND-008003,2011,80200010,,,,6,2,8
HND-008019,2011,80200067,,,,3,3,6
HND-007997,2011,80200004,,,,8,10,18
HND-007998,2011,80200005,,,,10,13,23
HND-007999,2011,80200006,,,,6,6,12
HND-008000,2011,80200007,,,,5,1,6
HND-008001,2011,80200008,,,,20,13,33
HND-008015,2011,80200030,,,,19,17,36
HND-008016,2011,80200031,,,,3,3,6
HND-007997,2011,80200004,,,,24,22,46
HND-008011,2011,80200023,,,,37,36,73
HND-007997,2011,80200004,,,,17,13,30
HND-008011,2011,80200023,,,,37,31,68
HND-008011,2011,80200023,,,,24,21,45
HND-007997,2011,80200004,,,,9,12,21
HND-008011,2011,80200023,,,,19,15,34
HND-008011,2011,80200023,,,,17,13,30
HND-008011,2011,80200023,,,,15,6,21
HND-008051,2011,80300031,,,,3,3,6
,2011,80300077,,,,3,2,5
,2011,80300080,,,,4,4,8
,2011,80300081,,,,4,3,7
HND-008087,2011,80300082,,,,4,6,10
,2011,80300085,,,,4,4,8
HND-008089,2011,80300086,,,,3,2,5
,2011,80300088,,,,4,4,8
,2011,80300092,,,,3,2,5
HND-008052,2011,80300032,,,,3,2,5
,2011,80300078,,,,5,5,10
,2011,80300079,,,,3,2,5
,2011,80300083,,,,6,3,9
,2011,80300087,,,,4,3,7
HND-008090,2011,80300089,,,,4,6,10
HND-008091,2011,80300090,,,,4,5,9
HND-008073,2011,80300053,,,,1,0,1
HND-008078,2011,80300059,,,,2,4,6
HND-008081,2011,80300063,,,,1,0,1
HND-008088,2011,80300084,,,,1,3,4
HND-008064,2011,80300044,,,,1,5,6
HND-008073,2011,80300053,,,,5,1,6
HND-008074,2011,80300054,,,,1,0,1
HND-008078,2011,80300059,,,,2,4,6
HND-008080,2011,80300062,,,,5,2,7
HND-008081,2011,80300063,,,,2,0,2
HND-008066,2011,80300046,,,,2,0,2
HND-008071,2011,80300051,,,,2,3,5
HND-008075,2011,80300055,,,,1,1,2
HND-008076,2011,80300056,,,,4,2,6
,2011,80300057,,,,4,5,9
HND-008077,2011,80300058,,,,1,1,2
HND-008088,2011,80300084,,,,4,3,7
HND-008071,2011,80300051,,,,20,11,31
HND-008075,2011,80300055,,,,2,9,11
HND-008076,2011,80300056,,,,9,4,13
,2011,80300057,,,,3,7,10
HND-008077,2011,80300058,,,,14,13,27
HND-008088,2011,80300084,,,,2,4,6
HND-008064,2011,80300044,,,,5,3,8
HND-008065,2011,80300045,,,,12,17,29
HND-008066,2011,80300046,,,,10,17,27
HND-008072,2011,80300052,,,,13,7,20
HND-008073,2011,80300053,,,,5,2,7
HND-008074,2011,80300054,,,,3,14,17
HND-008078,2011,80300059,,,,4,4,8
HND-008079,2011,80300060,,,,26,16,42
HND-008080,2011,80300062,,,,13,3,16
HND-008081,2011,80300063,,,,2,0,2
HND-008024,2011,80300004,,,,2,4,6
HND-008031,2011,80300011,,,,4,7,11
HND-008035,2011,80300015,,,,28,20,48
HND-008036,2011,80300016,,,,4,4,8
HND-008037,2011,80300017,,,,26,21,47
HND-008038,2011,80300018,,,,7,11,18
HND-008040,2011,80300020,,,,3,2,5
HND-008042,2011,80300022,,,,5,2,7
HND-008043,2011,80300023,,,,0,2,2
HND-008044,2011,80300024,,,,5,5,10
HND-008049,2011,80300029,,,,0,2,2
HND-008050,2011,80300030,,,,4,1,5
HND-008051,2011,80300031,,,,0,1,1
HND-008055,2011,80300035,,,,7,11,18
HND-008056,2011,80300036,,,,7,2,9
HND-008058,2011,80300038,,,,10,12,22
HND-008060,2011,80300040,,,,5,9,14
HND-008061,2011,80300041,,,,2,2,4
HND-008062,2011,80300042,,,,2,0,2
HND-008063,2011,80300043,,,,2,7,9
,2011,80300064,,,,5,3,8
HND-008086,2011,80300076,,,,5,1,6
HND-008023,2011,80300003,,,,14,10,24
HND-008025,2011,80300005,,,,1,1,2
HND-008026,2011,80300006,,,,4,2,6
HND-008027,2011,80300007,,,,3,0,3
HND-008028,2011,80300008,,,,10,6,16
HND-008030,2011,80300010,,,,0,2,2
HND-008032,2011,80300012,,,,21,18,39
HND-008033,2011,80300013,,,,6,5,11
HND-008034,2011,80300014,,,,30,27,57
HND-008039,2011,80300019,,,,20,18,38
HND-008041,2011,80300021,,,,1,1,2
HND-008045,2011,80300025,,,,4,4,8
HND-008046,2011,80300026,,,,1,2,3
HND-008047,2011,80300027,,,,2,5,7
HND-008048,2011,80300028,,,,27,11,38
HND-008052,2011,80300032,,,,6,3,9
HND-008054,2011,80300034,,,,8,8,16
HND-008057,2011,80300037,,,,2,2,4
HND-008059,2011,80300039,,,,2,8,10
HND-008082,2011,80300066,,,,2,2,4
HND-008085,2011,80300073,,,,10,6,16
HND-008024,2011,80300004,,,,2,1,3
HND-008025,2011,80300005,,,,5,1,6
HND-008026,2011,80300006,,,,1,3,4
HND-008027,2011,80300007,,,,1,3,4
HND-008030,2011,80300010,,,,2,4,6
HND-008031,2011,80300011,,,,4,2,6
HND-008032,2011,80300012,,,,16,18,34
HND-008033,2011,80300013,,,,3,4,7
HND-008038,2011,80300018,,,,12,4,16
HND-008039,2011,80300019,,,,13,23,36
HND-008044,2011,80300024,,,,3,2,5
HND-008045,2011,80300025,,,,4,1,5
HND-008046,2011,80300026,,,,3,0,3
HND-008047,2011,80300027,,,,6,6,12
HND-008050,2011,80300030,,,,4,4,8
HND-008051,2011,80300031,,,,1,1,2
HND-008052,2011,80300032,,,,3,4,7
HND-008053,2011,80300033,,,,1,1,2
HND-008054,2011,80300034,,,,13,7,20
HND-008059,2011,80300039,,,,5,7,12
HND-008062,2011,80300042,,,,0,6,6
,2011,80300064,,,,2,1,3
HND-008082,2011,80300066,,,,3,3,6
HND-008085,2011,80300073,,,,10,7,17
HND-008023,2011,80300003,,,,16,8,24
HND-008028,2011,80300008,,,,3,4,7
HND-008034,2011,80300014,,,,29,27,56
HND-008035,2011,80300015,,,,31,20,51
HND-008036,2011,80300016,,,,5,2,7
HND-008037,2011,80300017,,,,19,15,34
HND-008040,2011,80300020,,,,2,2,4
HND-008041,2011,80300021,,,,3,1,4
HND-008042,2011,80300022,,,,3,2,5
HND-008043,2011,80300023,,,,5,0,5
HND-008048,2011,80300028,,,,24,14,38
HND-008049,2011,80300029,,,,1,0,1
HND-008055,2011,80300035,,,,6,6,12
HND-008056,2011,80300036,,,,2,0,2
HND-008057,2011,80300037,,,,1,4,5
HND-008058,2011,80300038,,,,10,9,19
HND-008060,2011,80300040,,,,9,9,18
HND-008061,2011,80300041,,,,3,2,5
HND-008063,2011,80300043,,,,7,2,9
HND-008086,2011,80300076,,,,2,0,2
HND-008023,2011,80300003,,,,13,9,22
HND-008024,2011,80300004,,,,7,1,8
HND-008025,2011,80300005,,,,1,3,4
HND-008026,2011,80300006,,,,2,1,3
HND-008027,2011,80300007,,,,1,1,2
HND-008028,2011,80300008,,,,9,4,13
HND-008030,2011,80300010,,,,4,6,10
HND-008031,2011,80300011,,,,4,3,7
HND-008032,2011,80300012,,,,24,26,50
HND-008033,2011,80300013,,,,4,3,7
HND-008039,2011,80300019,,,,25,18,43
HND-008041,2011,80300021,,,,2,0,2
HND-008045,2011,80300025,,,,2,5,7
HND-008046,2011,80300026,,,,4,2,6
HND-008047,2011,80300027,,,,5,3,8
HND-008048,2011,80300028,,,,21,18,39
HND-008050,2011,80300030,,,,2,4,6
HND-008052,2011,80300032,,,,3,1,4
HND-008053,2011,80300033,,,,1,0,1
HND-008054,2011,80300034,,,,15,11,26
HND-008059,2011,80300039,,,,5,3,8
HND-008082,2011,80300066,,,,3,5,8
HND-008085,2011,80300073,,,,2,4,6
HND-008034,2011,80300014,,,,14,25,39
HND-008035,2011,80300015,,,,26,18,44
HND-008036,2011,80300016,,,,3,2,5
HND-008037,2011,80300017,,,,21,7,28
HND-008038,2011,80300018,,,,6,10,16
HND-008040,2011,80300020,,,,2,2,4
HND-008042,2011,80300022,,,,5,3,8
HND-008043,2011,80300023,,,,3,1,4
HND-008044,2011,80300024,,,,6,3,9
HND-008049,2011,80300029,,,,1,0,1
HND-008051,2011,80300031,,,,4,1,5
HND-008055,2011,80300035,,,,6,2,8
HND-008056,2011,80300036,,,,1,3,4
HND-008057,2011,80300037,,,,5,2,7
HND-008058,2011,80300038,,,,7,5,12
HND-008060,2011,80300040,,,,15,11,26
HND-008061,2011,80300041,,,,6,6,12
HND-008062,2011,80300042,,,,2,1,3
HND-008063,2011,80300043,,,,5,6,11
,2011,80300064,,,,0,2,2
HND-008086,2011,80300076,,,,0,2,2
HND-008024,2011,80300004,,,,4,4,8
HND-008027,2011,80300007,,,,1,1,2
HND-008030,2011,80300010,,,,2,1,3
HND-008031,2011,80300011,,,,6,5,11
HND-008035,2011,80300015,,,,19,14,33
HND-008036,2011,80300016,,,,6,2,8
HND-008038,2011,80300018,,,,7,9,16
HND-008042,2011,80300022,,,,8,12,20
HND-008044,2011,80300024,,,,4,9,13
HND-008047,2011,80300027,,,,5,5,10
HND-008049,2011,80300029,,,,4,0,4
HND-008050,2011,80300030,,,,7,5,12
HND-008051,2011,80300031,,,,2,3,5
HND-008052,2011,80300032,,,,4,1,5
HND-008053,2011,80300033,,,,0,2,2
HND-008058,2011,80300038,,,,5,3,8
HND-008059,2011,80300039,,,,5,3,8
HND-008060,2011,80300040,,,,9,10,19
HND-008062,2011,80300042,,,,3,3,6
HND-008063,2011,80300043,,,,8,2,10
HND-008082,2011,80300066,,,,2,1,3
HND-008086,2011,80300076,,,,1,3,4
HND-008023,2011,80300003,,,,10,17,27
HND-008025,2011,80300005,,,,3,0,3
HND-008026,2011,80300006,,,,0,4,4
HND-008028,2011,80300008,,,,4,5,9
HND-008032,2011,80300012,,,,26,15,41
HND-008033,2011,80300013,,,,0,7,7
HND-008034,2011,80300014,,,,30,26,56
HND-008037,2011,80300017,,,,20,19,39
HND-008039,2011,80300019,,,,20,14,34
HND-008040,2011,80300020,,,,2,2,4
HND-008041,2011,80300021,,,,3,2,5
HND-008043,2011,80300023,,,,5,1,6
HND-008045,2011,80300025,,,,7,4,11
HND-008046,2011,80300026,,,,4,3,7
HND-008048,2011,80300028,,,,24,21,45
HND-008054,2011,80300034,,,,10,9,19
HND-008055,2011,80300035,,,,9,9,18
HND-008056,2011,80300036,,,,2,4,6
HND-008057,2011,80300037,,,,4,1,5
HND-008061,2011,80300041,,,,5,5,10
HND-008085,2011,80300073,,,,6,3,9
HND-008024,2011,80300004,,,,6,0,6
HND-008031,2011,80300011,,,,4,1,5
HND-008035,2011,80300015,,,,23,17,40
HND-008036,2011,80300016,,,,5,1,6
HND-008037,2011,80300017,,,,22,20,42
HND-008038,2011,80300018,,,,10,7,17
HND-008042,2011,80300022,,,,4,6,10
HND-008043,2011,80300023,,,,7,1,8
HND-008044,2011,80300024,,,,4,3,7
HND-008049,2011,80300029,,,,0,2,2
HND-008050,2011,80300030,,,,4,5,9
HND-008051,2011,80300031,,,,3,5,8
HND-008053,2011,80300033,,,,1,0,1
HND-008055,2011,80300035,,,,16,9,25
HND-008058,2011,80300038,,,,4,10,14
HND-008059,2011,80300039,,,,2,3,5
HND-008060,2011,80300040,,,,12,9,21
HND-008062,2011,80300042,,,,2,4,6
HND-008063,2011,80300043,,,,7,5,12
,2011,80300064,,,,4,0,4
HND-008086,2011,80300076,,,,0,2,2
HND-008023,2011,80300003,,,,20,19,39
HND-008025,2011,80300005,,,,2,0,2
HND-008026,2011,80300006,,,,0,1,1
HND-008027,2011,80300007,,,,3,2,5
HND-008028,2011,80300008,,,,7,7,14
HND-008030,2011,80300010,,,,1,1,2
HND-008032,2011,80300012,,,,22,20,42
HND-008033,2011,80300013,,,,6,5,11
HND-008034,2011,80300014,,,,22,21,43
HND-008039,2011,80300019,,,,20,25,45
HND-008041,2011,80300021,,,,2,1,3
HND-008045,2011,80300025,,,,4,3,7
HND-008046,2011,80300026,,,,5,4,9
HND-008047,2011,80300027,,,,6,3,9
HND-008048,2011,80300028,,,,22,27,49
HND-008052,2011,80300032,,,,4,3,7
HND-008054,2011,80300034,,,,6,9,15
HND-008056,2011,80300036,,,,3,3,6
HND-008057,2011,80300037,,,,2,1,3
HND-008061,2011,80300041,,,,2,2,4
HND-008082,2011,80300066,,,,0,3,3
HND-008085,2011,80300073,,,,2,1,3
HND-008024,2011,80300004,,,,1,5,6
HND-008025,2011,80300005,,,,1,1,2
HND-008026,2011,80300006,,,,1,5,6
HND-008027,2011,80300007,,,,1,2,3
HND-008030,2011,80300010,,,,2,0,2
HND-008031,2011,80300011,,,,1,1,2
HND-008032,2011,80300012,,,,29,24,53
HND-008033,2011,80300013,,,,2,6,8
HND-008038,2011,80300018,,,,13,9,22
HND-008039,2011,80300019,,,,17,13,30
HND-008044,2011,80300024,,,,2,4,6
HND-008045,2011,80300025,,,,2,9,11
HND-008046,2011,80300026,,,,2,3,5
HND-008047,2011,80300027,,,,4,1,5
HND-008055,2011,80300035,,,,12,14,26
HND-008056,2011,80300036,,,,1,0,1
HND-008057,2011,80300037,,,,2,0,2
HND-008058,2011,80300038,,,,8,9,17
HND-008060,2011,80300040,,,,10,10,20
HND-008061,2011,80300041,,,,1,2,3
HND-008063,2011,80300043,,,,3,4,7
,2011,80300064,,,,0,3,3
HND-008082,2011,80300066,,,,4,3,7
HND-008086,2011,80300076,,,,2,2,4
HND-008023,2011,80300003,,,,19,18,37
HND-008028,2011,80300008,,,,2,7,9
HND-008034,2011,80300014,,,,37,32,69
HND-008035,2011,80300015,,,,12,14,26
HND-008036,2011,80300016,,,,1,2,3
HND-008037,2011,80300017,,,,25,16,41
HND-008040,2011,80300020,,,,1,3,4
HND-008042,2011,80300022,,,,7,6,13
HND-008043,2011,80300023,,,,2,5,7
HND-008048,2011,80300028,,,,24,14,38
HND-008049,2011,80300029,,,,1,0,1
HND-008050,2011,80300030,,,,6,4,10
HND-008051,2011,80300031,,,,0,1,1
HND-008052,2011,80300032,,,,3,5,8
HND-008053,2011,80300033,,,,2,0,2
HND-008054,2011,80300034,,,,8,10,18
HND-008059,2011,80300039,,,,0,2,2
HND-008062,2011,80300042,,,,2,6,8
HND-008085,2011,80300073,,,,1,0,1
HND-008035,2011,80300015,,,,16,15,31
HND-008070,2011,80300050,,,,17,22,39
HND-008083,2011,80300071,,,,22,32,54
HND-008032,2011,80300012,,,,21,20,41
HND-008039,2011,80300019,,,,26,29,55
HND-008067,2011,80300047,,,,44,53,97
HND-008068,2011,80300048,,,,20,15,35
HND-008069,2011,80300049,,,,21,20,41
HND-008032,2011,80300012,,,,14,20,34
HND-008039,2011,80300019,,,,14,31,45
HND-008067,2011,80300047,,,,36,53,89
HND-008069,2011,80300049,,,,17,12,29
HND-008083,2011,80300071,,,,19,28,47
HND-008035,2011,80300015,,,,12,18,30
HND-008068,2011,80300048,,,,17,17,34
HND-008070,2011,80300050,,,,10,9,19
HND-008035,2011,80300015,,,,5,9,14
HND-008067,2011,80300047,,,,21,32,53
HND-008083,2011,80300071,,,,12,18,30
HND-008032,2011,80300012,,,,15,20,35
HND-008039,2011,80300019,,,,13,13,26
HND-008068,2011,80300048,,,,14,21,35
HND-008069,2011,80300049,,,,21,25,46
HND-008070,2011,80300050,,,,16,13,29
HND-008068,2011,80300048,,,,15,12,27
HND-008070,2011,80300050,,,,17,22,39
HND-008067,2011,80300047,,,,33,45,78
HND-008069,2011,80300049,,,,8,10,18
HND-008083,2011,80300071,,,,11,39,50
HND-008067,2011,80300047,,,,18,25,43
HND-008069,2011,80300049,,,,5,16,21
HND-008083,2011,80300071,,,,18,21,39
HND-008068,2011,80300048,,,,8,18,26
HND-008070,2011,80300050,,,,12,12,24
HND-008067,2011,80300047,,,,19,51,70
HND-008069,2011,80300049,,,,5,16,21
HND-008070,2011,80300050,,,,9,10,19
HND-008068,2011,80300048,,,,4,17,21
,2011,80400050,,,,5,5,10
HND-008143,2011,80400059,,,,10,4,14
,2011,80400062,,,,5,4,9
HND-008144,2011,80400063,,,,4,3,7
HND-008148,2011,80400078,,,,5,9,14
HND-008149,2011,80400085,,,,10,9,19
HND-008155,2011,80400098,,,,5,9,14
HND-008156,2011,80400099,,,,8,13,21
HND-008158,2011,80400101,,,,6,7,13
,2011,80400112,,,,10,11,21
HND-008162,2011,80400124,,,,8,4,12
HND-008163,2011,80400125,,,,9,6,15
HND-008164,2011,80400126,,,,1,8,9
,2011,80400132,,,,9,10,19
,2011,80400133,,,,4,7,11
HND-008169,2011,80400149,,,,6,5,11
,2011,80400152,,,,5,7,12
HND-008170,2011,80400153,,,,5,3,8
,2011,80400158,,,,5,5,10
,2011,80400159,,,,2,4,6
,2011,80400161,,,,9,4,13
,2011,80400162,,,,5,6,11
HND-008172,2011,80400165,,,,5,2,7
,2011,80400166,,,,12,8,20
HND-008173,2011,80400167,,,,8,5,13
,2011,80400168,,,,5,5,10
HND-008127,2011,80400036,,,,12,17,29
HND-008140,2011,80400055,,,,7,7,14
HND-008141,2011,80400056,,,,8,5,13
,2011,80400061,,,,14,7,21
HND-008147,2011,80400068,,,,6,5,11
HND-008150,2011,80400088,,,,16,17,33
HND-008154,2011,80400096,,,,8,5,13
,2011,80400097,,,,11,10,21
HND-008157,2011,80400100,,,,10,5,15
,2011,80400103,,,,6,6,12
HND-008159,2011,80400111,,,,8,7,15
,2011,80400123,,,,5,5,10
HND-008165,2011,80400128,,,,2,4,6
,2011,80400129,,,,4,8,12
,2011,80400130,,,,9,4,13
,2011,80400131,,,,6,7,13
,2011,80400134,,,,11,8,19
,2011,80400136,,,,10,7,17
HND-008166,2011,80400137,,,,7,13,20
,2011,80400145,,,,3,6,9
,2011,80400146,,,,3,6,9
,2011,80400147,,,,14,14,28
,2011,80400148,,,,6,6,12
,2011,80400150,,,,3,6,9
,2011,80400151,,,,5,4,9
,2011,80400154,,,,3,5,8
,2011,80400156,,,,6,4,10
,2011,80400157,,,,6,4,10
HND-008171,2011,80400163,,,,11,6,17
,2011,80400164,,,,3,4,7
HND-008174,2011,80400169,,,,5,4,9
,2011,80400170,,,,9,0,9
HND-008167,2011,80400142,,,,2,2,4
,2011,80400143,,,,2,2,4
HND-008160,2011,80400120,,,,3,4,7
,2011,80400139,,,,0,3,3
,2011,80400140,,,,4,5,9
,2011,80400053,,,,2,5,7
HND-008151,2011,80400090,,,,7,6,13
HND-008160,2011,80400120,,,,0,1,1
,2011,80400139,,,,0,2,2
,2011,80400143,,,,5,2,7
HND-008137,2011,80400051,,,,2,5,7
HND-008139,2011,80400054,,,,3,2,5
,2011,80400058,,,,2,1,3
,2011,80400140,,,,3,3,6
HND-008167,2011,80400142,,,,1,0,1
HND-008114,2011,80400023,,,,13,15,28
HND-008137,2011,80400051,,,,9,9,18
,2011,80400058,,,,3,4,7
,2011,80400140,,,,2,3,5
HND-008167,2011,80400142,,,,5,5,10
,2011,80400053,,,,13,15,28
HND-008139,2011,80400054,,,,10,8,18
HND-008151,2011,80400090,,,,14,12,26
HND-008160,2011,80400120,,,,4,3,7
,2011,80400139,,,,6,5,11
,2011,80400143,,,,1,2,3
HND-008093,2011,80400002,,,,6,6,12
HND-008094,2011,80400003,,,,8,5,13
HND-008095,2011,80400004,,,,30,28,58
HND-008100,2011,80400009,,,,4,5,9
HND-008101,2011,80400010,,,,7,11,18
HND-008102,2011,80400011,,,,7,2,9
HND-008103,2011,80400012,,,,3,1,4
HND-008104,2011,80400013,,,,7,4,11
HND-008109,2011,80400018,,,,5,9,14
HND-008110,2011,80400019,,,,12,11,23
HND-008113,2011,80400022,,,,9,8,17
HND-008115,2011,80400024,,,,5,5,10
HND-008118,2011,80400027,,,,12,9,21
HND-008120,2011,80400029,,,,2,6,8
HND-008125,2011,80400034,,,,3,8,11
HND-008126,2011,80400035,,,,4,4,8
HND-008127,2011,80400036,,,,6,14,20
HND-008130,2011,80400040,,,,2,3,5
HND-008132,2011,80400042,,,,2,1,3
HND-008134,2011,80400044,,,,8,14,22
HND-008136,2011,80400049,,,,3,1,4
HND-008138,2011,80400052,,,,5,2,7
HND-008142,2011,80400057,,,,13,12,25
HND-008146,2011,80400065,,,,6,8,14
HND-008152,2011,80400093,,,,1,1,2
HND-008153,2011,80400094,,,,4,3,7
HND-008161,2011,80400121,,,,4,5,9
HND-008168,2011,80400144,,,,2,3,5
HND-008096,2011,80400005,,,,24,13,37
HND-008097,2011,80400006,,,,7,5,12
HND-008098,2011,80400007,,,,7,2,9
HND-008099,2011,80400008,,,,17,14,31
HND-008105,2011,80400014,,,,0,1,1
HND-008106,2011,80400015,,,,17,12,29
HND-008107,2011,80400016,,,,7,10,17
HND-008108,2011,80400017,,,,7,9,16
HND-008111,2011,80400020,,,,14,11,25
HND-008112,2011,80400021,,,,20,10,30
HND-008114,2011,80400023,,,,14,13,27
HND-008116,2011,80400025,,,,1,0,1
HND-008117,2011,80400026,,,,20,16,36
HND-008119,2011,80400028,,,,3,4,7
HND-008121,2011,80400030,,,,19,12,31
HND-008122,2011,80400031,,,,7,11,18
HND-008123,2011,80400032,,,,37,18,55
HND-008124,2011,80400033,,,,18,16,34
HND-008128,2011,80400038,,,,1,3,4
HND-008129,2011,80400039,,,,0,3,3
HND-008131,2011,80400041,,,,7,7,14
HND-008135,2011,80400045,,,,8,6,14
HND-008145,2011,80400064,,,,8,5,13
HND-008093,2011,80400002,,,,3,0,3
HND-008094,2011,80400003,,,,6,4,10
HND-008095,2011,80400004,,,,20,19,39
HND-008099,2011,80400008,,,,8,7,15
HND-008100,2011,80400009,,,,7,6,13
HND-008102,2011,80400011,,,,1,3,4
HND-008106,2011,80400015,,,,15,19,34
HND-008107,2011,80400016,,,,2,3,5
HND-008108,2011,80400017,,,,12,12,24
HND-008109,2011,80400018,,,,3,4,7
HND-008111,2011,80400020,,,,7,12,19
HND-008113,2011,80400022,,,,6,3,9
HND-008114,2011,80400023,,,,17,17,34
HND-008115,2011,80400024,,,,13,10,23
HND-008120,2011,80400029,,,,7,2,9
HND-008122,2011,80400031,,,,10,3,13
HND-008126,2011,80400035,,,,4,5,9
HND-008127,2011,80400036,,,,8,6,14
HND-008128,2011,80400038,,,,0,3,3
HND-008134,2011,80400044,,,,8,8,16
HND-008135,2011,80400045,,,,19,7,26
HND-008142,2011,80400057,,,,11,6,17
HND-008146,2011,80400065,,,,7,3,10
HND-008153,2011,80400094,,,,1,3,4
HND-008096,2011,80400005,,,,15,8,23
HND-008097,2011,80400006,,,,11,10,21
HND-008098,2011,80400007,,,,4,2,6
HND-008101,2011,80400010,,,,19,8,27
HND-008103,2011,80400012,,,,2,3,5
HND-008104,2011,80400013,,,,2,8,10
HND-008105,2011,80400014,,,,1,1,2
HND-008110,2011,80400019,,,,11,10,21
HND-008112,2011,80400021,,,,12,7,19
HND-008117,2011,80400026,,,,16,12,28
HND-008118,2011,80400027,,,,8,11,19
HND-008119,2011,80400028,,,,7,7,14
HND-008121,2011,80400030,,,,9,8,17
HND-008123,2011,80400032,,,,14,6,20
HND-008124,2011,80400033,,,,18,19,37
HND-008125,2011,80400034,,,,7,3,10
HND-008129,2011,80400039,,,,2,1,3
HND-008130,2011,80400040,,,,4,7,11
HND-008131,2011,80400041,,,,2,4,6
HND-008132,2011,80400042,,,,7,5,12
HND-008133,2011,80400043,,,,3,2,5
HND-008136,2011,80400049,,,,3,2,5
HND-008138,2011,80400052,,,,6,1,7
HND-008145,2011,80400064,,,,5,9,14
HND-008152,2011,80400093,,,,3,6,9
HND-008161,2011,80400121,,,,5,5,10
HND-008168,2011,80400144,,,,1,2,3
HND-008093,2011,80400002,,,,3,8,11
HND-008094,2011,80400003,,,,3,7,10
HND-008095,2011,80400004,,,,26,21,47
HND-008100,2011,80400009,,,,3,3,6
HND-008101,2011,80400010,,,,10,18,28
HND-008102,2011,80400011,,,,2,2,4
HND-008104,2011,80400013,,,,4,3,7
HND-008109,2011,80400018,,,,3,4,7
HND-008110,2011,80400019,,,,6,6,12
HND-008113,2011,80400022,,,,5,2,7
HND-008114,2011,80400023,,,,21,16,37
HND-008115,2011,80400024,,,,2,10,12
HND-008118,2011,80400027,,,,6,5,11
HND-008120,2011,80400029,,,,7,2,9
HND-008121,2011,80400030,,,,12,10,22
HND-008122,2011,80400031,,,,9,5,14
HND-008124,2011,80400033,,,,19,16,35
HND-008128,2011,80400038,,,,1,4,5
HND-008129,2011,80400039,,,,1,1,2
HND-008131,2011,80400041,,,,2,5,7
HND-008135,2011,80400045,,,,5,3,8
HND-008146,2011,80400065,,,,6,10,16
HND-008153,2011,80400094,,,,3,2,5
HND-008096,2011,80400005,,,,10,12,22
HND-008097,2011,80400006,,,,3,4,7
HND-008098,2011,80400007,,,,4,4,8
HND-008099,2011,80400008,,,,16,14,30
HND-008105,2011,80400014,,,,0,2,2
HND-008106,2011,80400015,,,,24,19,43
HND-008107,2011,80400016,,,,10,9,19
HND-008108,2011,80400017,,,,9,15,24
HND-008111,2011,80400020,,,,7,15,22
HND-008112,2011,80400021,,,,11,12,23
HND-008116,2011,80400025,,,,2,0,2
HND-008117,2011,80400026,,,,14,11,25
HND-008119,2011,80400028,,,,5,6,11
HND-008123,2011,80400032,,,,7,4,11
HND-008125,2011,80400034,,,,7,5,12
HND-008126,2011,80400035,,,,3,3,6
HND-008127,2011,80400036,,,,12,8,20
HND-008130,2011,80400040,,,,2,6,8
HND-008132,2011,80400042,,,,3,0,3
HND-008133,2011,80400043,,,,3,7,10
HND-008134,2011,80400044,,,,21,10,31
HND-008136,2011,80400049,,,,3,0,3
HND-008138,2011,80400052,,,,4,1,5
HND-008142,2011,80400057,,,,3,10,13
HND-008145,2011,80400064,,,,7,2,9
HND-008152,2011,80400093,,,,0,1,1
HND-008161,2011,80400121,,,,3,4,7
HND-008168,2011,80400144,,,,2,0,2
HND-008094,2011,80400003,,,,13,9,22
HND-008095,2011,80400004,,,,20,21,41
HND-008096,2011,80400005,,,,15,15,30
HND-008097,2011,80400006,,,,9,4,13
HND-008099,2011,80400008,,,,8,9,17
HND-008100,2011,80400009,,,,1,0,1
HND-008106,2011,80400015,,,,17,14,31
HND-008107,2011,80400016,,,,12,2,14
HND-008108,2011,80400017,,,,3,4,7
HND-008109,2011,80400018,,,,3,2,5
HND-008111,2011,80400020,,,,11,23,34
HND-008112,2011,80400021,,,,24,11,35
HND-008113,2011,80400022,,,,5,2,7
HND-008114,2011,80400023,,,,14,22,36
HND-008119,2011,80400028,,,,4,2,6
HND-008120,2011,80400029,,,,5,3,8
HND-008125,2011,80400034,,,,5,5,10
HND-008126,2011,80400035,,,,4,8,12
HND-008127,2011,80400036,,,,13,9,22
HND-008128,2011,80400038,,,,0,3,3
HND-008132,2011,80400042,,,,7,1,8
HND-008134,2011,80400044,,,,16,15,31
HND-008142,2011,80400057,,,,6,4,10
HND-008145,2011,80400064,,,,9,10,19
HND-008146,2011,80400065,,,,4,4,8
HND-008153,2011,80400094,,,,3,3,6
HND-008168,2011,80400144,,,,3,1,4
HND-008093,2011,80400002,,,,5,4,9
HND-008098,2011,80400007,,,,2,3,5
HND-008101,2011,80400010,,,,5,9,14
HND-008102,2011,80400011,,,,0,6,6
HND-008103,2011,80400012,,,,3,2,5
HND-008104,2011,80400013,,,,5,12,17
HND-008105,2011,80400014,,,,1,1,2
HND-008110,2011,80400019,,,,11,9,20
HND-008115,2011,80400024,,,,5,5,10
HND-008116,2011,80400025,,,,1,2,3
HND-008117,2011,80400026,,,,15,12,27
HND-008118,2011,80400027,,,,11,12,23
HND-008121,2011,80400030,,,,4,11,15
HND-008122,2011,80400031,,,,7,5,12
HND-008123,2011,80400032,,,,8,10,18
HND-008124,2011,80400033,,,,14,18,32
HND-008129,2011,80400039,,,,0,2,2
HND-008130,2011,80400040,,,,4,4,8
HND-008131,2011,80400041,,,,3,4,7
HND-008133,2011,80400043,,,,6,4,10
HND-008135,2011,80400045,,,,5,3,8
HND-008138,2011,80400052,,,,6,1,7
HND-008161,2011,80400121,,,,4,3,7
HND-008095,2011,80400004,,,,26,18,44
HND-008096,2011,80400005,,,,20,17,37
HND-008097,2011,80400006,,,,7,11,18
HND-008098,2011,80400007,,,,5,3,8
HND-008099,2011,80400008,,,,9,4,13
HND-008105,2011,80400014,,,,0,5,5
HND-008106,2011,80400015,,,,12,13,25
HND-008107,2011,80400016,,,,14,11,25
HND-008108,2011,80400017,,,,3,5,8
HND-008111,2011,80400020,,,,18,12,30
HND-008112,2011,80400021,,,,14,15,29
HND-008113,2011,80400022,,,,9,2,11
HND-008114,2011,80400023,,,,10,15,25
HND-008119,2011,80400028,,,,5,3,8
HND-008120,2011,80400029,,,,3,1,4
HND-008125,2011,80400034,,,,5,4,9
HND-008126,2011,80400035,,,,3,4,7
HND-008127,2011,80400036,,,,10,7,17
HND-008130,2011,80400040,,,,2,4,6
HND-008132,2011,80400042,,,,3,4,7
HND-008133,2011,80400043,,,,2,1,3
HND-008134,2011,80400044,,,,18,10,28
HND-008136,2011,80400049,,,,3,1,4
HND-008142,2011,80400057,,,,7,4,11
HND-008145,2011,80400064,,,,9,6,15
HND-008146,2011,80400065,,,,4,0,4
HND-008152,2011,80400093,,,,2,0,2
HND-008153,2011,80400094,,,,5,1,6
HND-008161,2011,80400121,,,,2,3,5
HND-008093,2011,80400002,,,,1,4,5
HND-008094,2011,80400003,,,,1,0,1
HND-008100,2011,80400009,,,,3,1,4
HND-008101,2011,80400010,,,,1,6,7
HND-008102,2011,80400011,,,,1,3,4
HND-008103,2011,80400012,,,,2,2,4
HND-008104,2011,80400013,,,,2,7,9
HND-008109,2011,80400018,,,,1,1,2
HND-008110,2011,80400019,,,,12,7,19
HND-008115,2011,80400024,,,,4,8,12
HND-008116,2011,80400025,,,,1,2,3
HND-008117,2011,80400026,,,,7,7,14
HND-008118,2011,80400027,,,,6,8,14
HND-008121,2011,80400030,,,,7,4,11
HND-008122,2011,80400031,,,,9,9,18
HND-008123,2011,80400032,,,,3,4,7
HND-008124,2011,80400033,,,,8,6,14
HND-008128,2011,80400038,,,,1,3,4
HND-008129,2011,80400039,,,,1,1,2
HND-008131,2011,80400041,,,,4,4,8
HND-008135,2011,80400045,,,,5,3,8
HND-008138,2011,80400052,,,,6,2,8
HND-008168,2011,80400144,,,,1,2,3
HND-008096,2011,80400005,,,,14,15,29
HND-008097,2011,80400006,,,,12,7,19
HND-008098,2011,80400007,,,,5,1,6
HND-008101,2011,80400010,,,,3,3,6
HND-008103,2011,80400012,,,,0,2,2
HND-008104,2011,80400013,,,,2,3,5
HND-008105,2011,80400014,,,,1,1,2
HND-008110,2011,80400019,,,,5,7,12
HND-008112,2011,80400021,,,,12,15,27
HND-008117,2011,80400026,,,,7,8,15
HND-008118,2011,80400027,,,,6,6,12
HND-008119,2011,80400028,,,,3,2,5
HND-008121,2011,80400030,,,,2,4,6
HND-008123,2011,80400032,,,,6,6,12
HND-008124,2011,80400033,,,,4,11,15
HND-008125,2011,80400034,,,,3,6,9
HND-008129,2011,80400039,,,,1,2,3
HND-008130,2011,80400040,,,,4,8,12
HND-008131,2011,80400041,,,,3,6,9
HND-008132,2011,80400042,,,,1,1,2
HND-008133,2011,80400043,,,,2,2,4
HND-008136,2011,80400049,,,,2,1,3
HND-008138,2011,80400052,,,,4,3,7
HND-008145,2011,80400064,,,,7,4,11
HND-008152,2011,80400093,,,,3,3,6
HND-008161,2011,80400121,,,,1,2,3
HND-008093,2011,80400002,,,,3,2,5
HND-008094,2011,80400003,,,,5,1,6
HND-008095,2011,80400004,,,,29,16,45
HND-008099,2011,80400008,,,,9,12,21
HND-008100,2011,80400009,,,,0,5,5
HND-008102,2011,80400011,,,,1,3,4
HND-008106,2011,80400015,,,,18,14,32
HND-008107,2011,80400016,,,,6,5,11
HND-008108,2011,80400017,,,,1,7,8
HND-008109,2011,80400018,,,,1,2,3
HND-008111,2011,80400020,,,,9,14,23
HND-008113,2011,80400022,,,,4,6,10
HND-008114,2011,80400023,,,,11,3,14
HND-008115,2011,80400024,,,,1,1,2
HND-008120,2011,80400029,,,,3,5,8
HND-008122,2011,80400031,,,,4,10,14
HND-008126,2011,80400035,,,,4,3,7
HND-008127,2011,80400036,,,,7,7,14
HND-008128,2011,80400038,,,,1,2,3
HND-008134,2011,80400044,,,,15,7,22
HND-008135,2011,80400045,,,,3,6,9
HND-008142,2011,80400057,,,,5,1,6
HND-008146,2011,80400065,,,,5,3,8
HND-008153,2011,80400094,,,,4,0,4
HND-008168,2011,80400144,,,,1,5,6
HND-008096,2011,80400005,,,,14,10,24
HND-008092,2011,80400001,,,,33,33,66
HND-008092,2011,80400001,,,,38,29,67
HND-008096,2011,80400005,,,,5,15,20
HND-008092,2011,80400001,,,,37,30,67
HND-008096,2011,80400005,,,,13,13,26
HND-008092,2011,80400001,,,,19,19,38
HND-008092,2011,80400001,,,,25,17,42
HND-008092,2011,80400001,,,,12,12,24
,2011,80500048,,,,6,2,8
,2011,80500051,,,,4,3,7
,2011,80500044,,,,2,5,7
,2011,80500025,,,,5,5,10
HND-008194,2011,80500020,,,,9,6,15
,2011,80500025,,,,5,7,12
HND-008200,2011,80500028,,,,2,0,2
,2011,80500030,,,,2,2,4
HND-008193,2011,80500019,,,,0,1,1
HND-008201,2011,80500029,,,,6,5,11
,2011,80500035,,,,0,3,3
HND-008206,2011,80500042,,,,4,2,6
HND-008207,2011,80500045,,,,7,1,8
HND-008176,2011,80500002,,,,19,16,35
HND-008177,2011,80500003,,,,13,17,30
HND-008193,2011,80500019,,,,2,6,8
HND-008195,2011,80500021,,,,28,23,51
,2011,80500035,,,,2,4,6
HND-008206,2011,80500042,,,,7,2,9
HND-008207,2011,80500045,,,,8,5,13
HND-008194,2011,80500020,,,,27,23,50
HND-008198,2011,80500024,,,,10,6,16
,2011,80500025,,,,10,15,25
HND-008200,2011,80500028,,,,23,9,32
,2011,80500030,,,,5,4,9
HND-008202,2011,80500032,,,,14,14,28
HND-008179,2011,80500005,,,,32,17,49
HND-008180,2011,80500006,,,,31,38,69
HND-008182,2011,80500008,,,,10,15,25
HND-008184,2011,80500010,,,,21,20,41
HND-008187,2011,80500013,,,,5,2,7
HND-008189,2011,80500015,,,,2,0,2
HND-008192,2011,80500018,,,,0,2,2
HND-008193,2011,80500019,,,,2,4,6
HND-008199,2011,80500026,,,,4,2,6
HND-008203,2011,80500034,,,,24,21,45
,2011,80500035,,,,7,2,9
HND-008209,2011,80500049,,,,0,1,1
HND-008211,2011,80500052,,,,6,3,9
HND-008178,2011,80500004,,,,1,1,2
HND-008181,2011,80500007,,,,12,9,21
HND-008185,2011,80500011,,,,60,34,94
HND-008186,2011,80500012,,,,6,3,9
HND-008188,2011,80500014,,,,7,5,12
HND-008190,2011,80500016,,,,8,3,11
HND-008191,2011,80500017,,,,5,6,11
,2011,80500041,,,,2,1,3
HND-008208,2011,80500046,,,,1,3,4
HND-008210,2011,80500050,,,,0,1,1
HND-008178,2011,80500004,,,,8,0,8
HND-008184,2011,80500010,,,,18,19,37
HND-008186,2011,80500012,,,,4,5,9
HND-008187,2011,80500013,,,,3,10,13
HND-008188,2011,80500014,,,,5,7,12
HND-008193,2011,80500019,,,,5,2,7
HND-008203,2011,80500034,,,,16,14,30
,2011,80500035,,,,10,9,19
HND-008208,2011,80500046,,,,0,1,1
HND-008179,2011,80500005,,,,20,22,42
HND-008180,2011,80500006,,,,21,29,50
HND-008181,2011,80500007,,,,8,11,19
HND-008182,2011,80500008,,,,18,11,29
HND-008185,2011,80500011,,,,44,48,92
HND-008189,2011,80500015,,,,2,0,2
HND-008190,2011,80500016,,,,6,9,15
HND-008191,2011,80500017,,,,1,1,2
HND-008192,2011,80500018,,,,3,1,4
HND-008199,2011,80500026,,,,4,5,9
HND-008204,2011,80500040,,,,1,4,5
,2011,80500041,,,,1,1,2
HND-008209,2011,80500049,,,,2,5,7
HND-008210,2011,80500050,,,,0,1,1
HND-008178,2011,80500004,,,,4,1,5
HND-008181,2011,80500007,,,,14,10,24
HND-008185,2011,80500011,,,,48,47,95
HND-008186,2011,80500012,,,,3,4,7
HND-008188,2011,80500014,,,,8,7,15
HND-008191,2011,80500017,,,,7,4,11
HND-008193,2011,80500019,,,,6,3,9
,2011,80500041,,,,3,0,3
HND-008208,2011,80500046,,,,1,1,2
HND-008179,2011,80500005,,,,20,24,44
HND-008180,2011,80500006,,,,21,23,44
HND-008182,2011,80500008,,,,18,12,30
HND-008184,2011,80500010,,,,23,20,43
HND-008187,2011,80500013,,,,4,6,10
HND-008190,2011,80500016,,,,5,5,10
HND-008192,2011,80500018,,,,0,1,1
HND-008199,2011,80500026,,,,4,3,7
HND-008203,2011,80500034,,,,25,22,47
,2011,80500035,,,,0,8,8
HND-008204,2011,80500040,,,,0,2,2
HND-008209,2011,80500049,,,,3,3,6
HND-008210,2011,80500050,,,,0,1,1
HND-008178,2011,80500004,,,,3,4,7
HND-008179,2011,80500005,,,,15,23,38
HND-008180,2011,80500006,,,,30,40,70
HND-008181,2011,80500007,,,,5,10,15
HND-008185,2011,80500011,,,,58,46,104
HND-008188,2011,80500014,,,,4,4,8
HND-008189,2011,80500015,,,,2,2,4
HND-008190,2011,80500016,,,,9,3,12
HND-008191,2011,80500017,,,,5,1,6
HND-008199,2011,80500026,,,,3,8,11
HND-008203,2011,80500034,,,,25,22,47
,2011,80500035,,,,8,4,12
HND-008208,2011,80500046,,,,3,3,6
HND-008182,2011,80500008,,,,8,10,18
HND-008184,2011,80500010,,,,24,15,39
HND-008186,2011,80500012,,,,1,9,10
HND-008187,2011,80500013,,,,2,6,8
HND-008192,2011,80500018,,,,1,2,3
HND-008193,2011,80500019,,,,4,3,7
HND-008204,2011,80500040,,,,4,2,6
,2011,80500041,,,,6,2,8
HND-008209,2011,80500049,,,,1,7,8
HND-008210,2011,80500050,,,,3,0,3
HND-008178,2011,80500004,,,,0,3,3
HND-008179,2011,80500005,,,,22,24,46
HND-008180,2011,80500006,,,,43,28,71
HND-008181,2011,80500007,,,,8,7,15
HND-008185,2011,80500011,,,,53,46,99
HND-008188,2011,80500014,,,,7,13,20
HND-008189,2011,80500015,,,,2,0,2
HND-008190,2011,80500016,,,,3,5,8
HND-008191,2011,80500017,,,,4,5,9
HND-008203,2011,80500034,,,,30,31,61
,2011,80500035,,,,5,3,8
HND-008209,2011,80500049,,,,2,6,8
HND-008182,2011,80500008,,,,12,19,31
HND-008184,2011,80500010,,,,23,21,44
HND-008186,2011,80500012,,,,2,1,3
HND-008187,2011,80500013,,,,2,7,9
HND-008193,2011,80500019,,,,8,2,10
HND-008199,2011,80500026,,,,2,9,11
HND-008204,2011,80500040,,,,6,3,9
,2011,80500041,,,,3,5,8
HND-008178,2011,80500004,,,,2,7,9
HND-008184,2011,80500010,,,,15,20,35
HND-008186,2011,80500012,,,,4,2,6
HND-008187,2011,80500013,,,,4,2,6
HND-008188,2011,80500014,,,,8,3,11
HND-008193,2011,80500019,,,,3,3,6
HND-008204,2011,80500040,,,,2,2,4
,2011,80500041,,,,4,2,6
HND-008209,2011,80500049,,,,1,5,6
HND-008210,2011,80500050,,,,1,0,1
HND-008179,2011,80500005,,,,16,24,40
HND-008180,2011,80500006,,,,26,34,60
HND-008181,2011,80500007,,,,10,3,13
HND-008182,2011,80500008,,,,14,18,32
HND-008185,2011,80500011,,,,42,54,96
HND-008189,2011,80500015,,,,0,1,1
HND-008190,2011,80500016,,,,5,0,5
HND-008191,2011,80500017,,,,2,1,3
HND-008192,2011,80500018,,,,3,1,4
HND-008199,2011,80500026,,,,7,4,11
HND-008203,2011,80500034,,,,27,28,55
HND-008208,2011,80500046,,,,1,3,4
HND-008175,2011,80500001,,,,44,67,111
HND-008182,2011,80500008,,,,14,16,30
HND-008196,2011,80500022,,,,78,53,131
HND-008203,2011,80500034,,,,11,27,38
,2011,80500053,,,,4,6,10
HND-008197,2011,80500023,,,,19,19,38
,2011,80500047,,,,21,16,37
HND-008175,2011,80500001,,,,37,48,85
HND-008182,2011,80500008,,,,8,9,17
HND-008196,2011,80500022,,,,51,57,108
HND-008197,2011,80500023,,,,8,22,30
HND-008203,2011,80500034,,,,8,12,20
,2011,80500047,,,,14,21,35
,2011,80500053,,,,2,5,7
HND-008175,2011,80500001,,,,27,45,72
HND-008182,2011,80500008,,,,5,14,19
HND-008196,2011,80500022,,,,38,55,93
HND-008203,2011,80500034,,,,14,18,32
,2011,80500047,,,,10,28,38
HND-008197,2011,80500023,,,,15,8,23
HND-008175,2011,80500001,,,,21,26,47
HND-008196,2011,80500022,,,,41,40,81
HND-008197,2011,80500023,,,,3,16,19
,2011,80500047,,,,10,23,33
HND-008175,2011,80500001,,,,15,18,33
HND-008197,2011,80500023,,,,7,9,16
,2011,80500047,,,,11,18,29
HND-008196,2011,80500022,,,,25,33,58
HND-008175,2011,80500001,,,,14,18,32
HND-008196,2011,80500022,,,,37,28,65
HND-008197,2011,80500023,,,,3,11,14
HND-008244,2011,80600042,,,,3,2,5
HND-008271,2011,80600090,,,,3,5,8
HND-008276,2011,80600095,,,,6,3,9
,2011,80600099,,,,1,4,5
HND-008280,2011,80600100,,,,4,5,9
,2011,80600102,,,,2,3,5
,2011,80600106,,,,2,4,6
HND-008284,2011,80600107,,,,6,2,8
HND-008285,2011,80600108,,,,4,2,6
,2011,80600113,,,,9,2,11
,2011,80600114,,,,4,3,7
,2011,80600039,,,,2,6,8
,2011,80600075,,,,5,3,8
,2011,80600086,,,,3,4,7
,2011,80600087,,,,4,3,7
,2011,80600088,,,,3,7,10
,2011,80600098,,,,2,5,7
HND-008282,2011,80600103,,,,3,2,5
,2011,80600104,,,,3,2,5
,2011,80600109,,,,4,1,5
HND-008287,2011,80600110,,,,3,6,9
,2011,80600111,,,,4,3,7
,2011,80600112,,,,1,4,5
,2011,80600115,,,,3,3,6
HND-008288,2011,80600116,,,,3,3,6
HND-008221,2011,80600016,,,,2,1,3
HND-008258,2011,80600056,,,,1,5,6
,2011,80600071,,,,4,8,12
HND-008270,2011,80600081,,,,1,0,1
HND-008289,2011,80600117,,,,4,2,6
HND-008213,2011,80600004,,,,0,3,3
HND-008253,2011,80600051,,,,1,1,2
HND-008260,2011,80600060,,,,0,2,2
HND-008265,2011,80600065,,,,12,8,20
HND-008213,2011,80600004,,,,7,2,9
HND-008221,2011,80600016,,,,4,6,10
HND-008241,2011,80600038,,,,3,2,5
HND-008253,2011,80600051,,,,5,2,7
HND-008261,2011,80600061,,,,4,2,6
HND-008262,2011,80600062,,,,3,6,9
HND-008263,2011,80600063,,,,2,3,5
,2011,80600071,,,,13,7,20
HND-008283,2011,80600105,,,,6,7,13
HND-008289,2011,80600117,,,,2,7,9
HND-008212,2011,80600002,,,,3,4,7
,2011,80600003,,,,12,7,19
HND-008248,2011,80600046,,,,4,5,9
HND-008257,2011,80600055,,,,8,9,17
HND-008258,2011,80600056,,,,11,16,27
HND-008260,2011,80600060,,,,5,5,10
HND-008265,2011,80600065,,,,12,13,25
HND-008268,2011,80600069,,,,4,7,11
HND-008270,2011,80600081,,,,4,3,7
HND-008212,2011,80600002,,,,17,14,31
,2011,80600003,,,,4,4,8
HND-008248,2011,80600046,,,,5,9,14
HND-008257,2011,80600055,,,,11,4,15
HND-008258,2011,80600056,,,,47,51,98
HND-008260,2011,80600060,,,,6,6,12
HND-008268,2011,80600069,,,,2,2,4
HND-008270,2011,80600081,,,,4,4,8
HND-008213,2011,80600004,,,,8,5,13
HND-008221,2011,80600016,,,,4,6,10
HND-008241,2011,80600038,,,,10,22,32
HND-008253,2011,80600051,,,,5,3,8
HND-008261,2011,80600061,,,,6,3,9
HND-008262,2011,80600062,,,,29,30,59
HND-008263,2011,80600063,,,,6,6,12
HND-008265,2011,80600065,,,,11,9,20
,2011,80600071,,,,11,11,22
HND-008283,2011,80600105,,,,5,5,10
HND-008289,2011,80600117,,,,3,1,4
,2011,80600014,,,,4,4,8
HND-008220,2011,80600015,,,,1,1,2
HND-008221,2011,80600016,,,,7,8,15
HND-008222,2011,80600017,,,,4,4,8
HND-008223,2011,80600018,,,,6,2,8
HND-008227,2011,80600022,,,,0,2,2
HND-008228,2011,80600023,,,,3,3,6
HND-008229,2011,80600024,,,,2,1,3
HND-008232,2011,80600027,,,,3,3,6
HND-008236,2011,80600031,,,,2,1,3
HND-008237,2011,80600032,,,,46,40,86
,2011,80600033,,,,3,5,8
HND-008240,2011,80600036,,,,2,2,4
HND-008241,2011,80600038,,,,36,31,67
HND-008246,2011,80600044,,,,4,1,5
HND-008247,2011,80600045,,,,4,0,4
HND-008248,2011,80600046,,,,6,4,10
HND-008249,2011,80600047,,,,6,4,10
HND-008252,2011,80600050,,,,0,4,4
HND-008253,2011,80600051,,,,3,3,6
HND-008255,2011,80600053,,,,0,2,2
HND-008268,2011,80600069,,,,0,4,4
HND-008273,2011,80600092,,,,4,1,5
HND-008275,2011,80600094,,,,3,2,5
HND-008289,2011,80600117,,,,9,7,16
,2011,80600003,,,,5,7,12
,2011,80600007,,,,82,75,157
HND-008214,2011,80600008,,,,10,6,16
HND-008215,2011,80600009,,,,5,4,9
HND-008216,2011,80600010,,,,1,6,7
HND-008217,2011,80600011,,,,2,2,4
,2011,80600012,,,,7,8,15
HND-008218,2011,80600013,,,,2,6,8
HND-008224,2011,80600019,,,,9,5,14
HND-008225,2011,80600020,,,,6,13,19
HND-008226,2011,80600021,,,,3,4,7
HND-008230,2011,80600025,,,,8,9,17
HND-008231,2011,80600026,,,,3,4,7
HND-008233,2011,80600028,,,,4,5,9
HND-008235,2011,80600030,,,,4,4,8
HND-008238,2011,80600034,,,,10,10,20
HND-008239,2011,80600035,,,,13,10,23
,2011,80600037,,,,2,0,2
,2011,80600039,,,,12,6,18
HND-008242,2011,80600040,,,,2,3,5
HND-008243,2011,80600041,,,,3,3,6
HND-008244,2011,80600042,,,,2,3,5
HND-008245,2011,80600043,,,,6,2,8
HND-008250,2011,80600048,,,,0,1,1
HND-008251,2011,80600049,,,,4,1,5
HND-008254,2011,80600052,,,,2,1,3
HND-008256,2011,80600054,,,,6,9,15
HND-008257,2011,80600055,,,,30,18,48
HND-008264,2011,80600064,,,,3,5,8
HND-008266,2011,80600066,,,,3,2,5
HND-008267,2011,80600067,,,,17,17,34
,2011,80600071,,,,6,5,11
HND-008272,2011,80600091,,,,3,2,5
HND-008274,2011,80600093,,,,6,1,7
HND-008276,2011,80600095,,,,7,5,12
HND-008277,2011,80600096,,,,2,2,4
HND-008283,2011,80600105,,,,4,4,8
HND-008290,2011,80600118,,,,3,3,6
,2011,80600003,,,,9,3,12
HND-008214,2011,80600008,,,,9,7,16
HND-008216,2011,80600010,,,,1,2,3
HND-008217,2011,80600011,,,,1,1,2
HND-008218,2011,80600013,,,,5,1,6
HND-008220,2011,80600015,,,,2,3,5
HND-008221,2011,80600016,,,,6,2,8
HND-008223,2011,80600018,,,,4,7,11
HND-008224,2011,80600019,,,,10,10,20
HND-008229,2011,80600024,,,,4,0,4
HND-008230,2011,80600025,,,,6,4,10
HND-008231,2011,80600026,,,,8,5,13
HND-008232,2011,80600027,,,,4,1,5
HND-008233,2011,80600028,,,,1,2,3
HND-008235,2011,80600030,,,,4,6,10
HND-008236,2011,80600031,,,,2,8,10
HND-008237,2011,80600032,,,,45,42,87
,2011,80600033,,,,3,4,7
,2011,80600039,,,,5,5,10
HND-008243,2011,80600041,,,,0,3,3
HND-008247,2011,80600045,,,,5,3,8
HND-008248,2011,80600046,,,,6,4,10
HND-008249,2011,80600047,,,,3,6,9
HND-008250,2011,80600048,,,,0,3,3
HND-008252,2011,80600050,,,,2,1,3
HND-008254,2011,80600052,,,,3,1,4
HND-008255,2011,80600053,,,,2,0,2
HND-008256,2011,80600054,,,,3,3,6
HND-008257,2011,80600055,,,,23,17,40
HND-008264,2011,80600064,,,,5,8,13
HND-008267,2011,80600067,,,,30,23,53
HND-008268,2011,80600069,,,,3,4,7
HND-008276,2011,80600095,,,,5,8,13
HND-008277,2011,80600096,,,,1,2,3
HND-008290,2011,80600118,,,,3,4,7
,2011,80600007,,,,86,84,170
HND-008215,2011,80600009,,,,4,6,10
,2011,80600012,,,,5,4,9
,2011,80600014,,,,6,4,10
HND-008222,2011,80600017,,,,4,1,5
HND-008225,2011,80600020,,,,4,2,6
HND-008226,2011,80600021,,,,3,2,5
HND-008227,2011,80600022,,,,2,2,4
HND-008228,2011,80600023,,,,3,4,7
HND-008238,2011,80600034,,,,12,11,23
HND-008239,2011,80600035,,,,16,10,26
HND-008240,2011,80600036,,,,6,0,6
,2011,80600037,,,,2,2,4
HND-008241,2011,80600038,,,,30,25,55
HND-008242,2011,80600040,,,,2,2,4
HND-008244,2011,80600042,,,,2,1,3
HND-008245,2011,80600043,,,,1,2,3
HND-008246,2011,80600044,,,,3,3,6
HND-008251,2011,80600049,,,,0,2,2
HND-008253,2011,80600051,,,,4,0,4
HND-008266,2011,80600066,,,,2,5,7
,2011,80600071,,,,4,9,13
HND-008273,2011,80600092,,,,3,1,4
HND-008274,2011,80600093,,,,4,2,6
HND-008275,2011,80600094,,,,4,6,10
HND-008283,2011,80600105,,,,1,4,5
HND-008289,2011,80600117,,,,6,1,7
,2011,80600003,,,,2,3,5
HND-008214,2011,80600008,,,,10,7,17
HND-008215,2011,80600009,,,,3,2,5
HND-008216,2011,80600010,,,,2,2,4
HND-008217,2011,80600011,,,,2,3,5
,2011,80600012,,,,2,1,3
HND-008218,2011,80600013,,,,3,1,4
HND-008223,2011,80600018,,,,3,2,5
HND-008224,2011,80600019,,,,6,8,14
HND-008230,2011,80600025,,,,5,4,9
HND-008231,2011,80600026,,,,3,4,7
HND-008232,2011,80600027,,,,2,0,2
HND-008233,2011,80600028,,,,2,2,4
HND-008235,2011,80600030,,,,5,4,9
HND-008238,2011,80600034,,,,10,6,16
HND-008239,2011,80600035,,,,2,6,8
,2011,80600037,,,,1,3,4
,2011,80600039,,,,3,4,7
HND-008242,2011,80600040,,,,1,1,2
HND-008243,2011,80600041,,,,2,1,3
HND-008245,2011,80600043,,,,1,4,5
HND-008247,2011,80600045,,,,2,2,4
HND-008250,2011,80600048,,,,3,0,3
HND-008251,2011,80600049,,,,0,1,1
HND-008254,2011,80600052,,,,1,2,3
HND-008255,2011,80600053,,,,1,3,4
HND-008256,2011,80600054,,,,10,5,15
HND-008257,2011,80600055,,,,25,15,40
HND-008264,2011,80600064,,,,4,2,6
HND-008267,2011,80600067,,,,32,20,52
,2011,80600071,,,,5,6,11
HND-008272,2011,80600091,,,,2,1,3
HND-008274,2011,80600093,,,,4,3,7
HND-008276,2011,80600095,,,,3,1,4
HND-008277,2011,80600096,,,,1,0,1
HND-008283,2011,80600105,,,,2,4,6
HND-008290,2011,80600118,,,,1,0,1
,2011,80600007,,,,96,90,186
,2011,80600014,,,,6,3,9
HND-008220,2011,80600015,,,,0,2,2
HND-008221,2011,80600016,,,,4,3,7
HND-008222,2011,80600017,,,,2,2,4
HND-008225,2011,80600020,,,,6,4,10
HND-008228,2011,80600023,,,,3,3,6
HND-008229,2011,80600024,,,,1,0,1
HND-008236,2011,80600031,,,,3,1,4
HND-008237,2011,80600032,,,,45,41,86
,2011,80600033,,,,4,5,9
HND-008240,2011,80600036,,,,2,3,5
HND-008241,2011,80600038,,,,25,21,46
HND-008244,2011,80600042,,,,3,1,4
HND-008246,2011,80600044,,,,4,2,6
HND-008248,2011,80600046,,,,3,5,8
HND-008249,2011,80600047,,,,9,3,12
HND-008252,2011,80600050,,,,3,1,4
HND-008253,2011,80600051,,,,2,2,4
HND-008266,2011,80600066,,,,1,1,2
HND-008268,2011,80600069,,,,1,1,2
HND-008273,2011,80600092,,,,3,2,5
HND-008275,2011,80600094,,,,2,2,4
HND-008289,2011,80600117,,,,3,4,7
,2011,80600003,,,,1,4,5
HND-008214,2011,80600008,,,,9,9,18
HND-008217,2011,80600011,,,,2,3,5
HND-008220,2011,80600015,,,,1,1,2
HND-008221,2011,80600016,,,,4,6,10
HND-008222,2011,80600017,,,,2,3,5
HND-008223,2011,80600018,,,,5,5,10
HND-008229,2011,80600024,,,,1,2,3
HND-008230,2011,80600025,,,,4,6,10
HND-008231,2011,80600026,,,,1,3,4
HND-008232,2011,80600027,,,,3,3,6
HND-008235,2011,80600030,,,,4,6,10
HND-008236,2011,80600031,,,,5,4,9
HND-008237,2011,80600032,,,,33,31,64
,2011,80600033,,,,6,2,8
HND-008240,2011,80600036,,,,0,3,3
HND-008246,2011,80600044,,,,1,4,5
HND-008247,2011,80600045,,,,3,0,3
HND-008248,2011,80600046,,,,5,3,8
HND-008249,2011,80600047,,,,5,2,7
HND-008250,2011,80600048,,,,3,2,5
HND-008252,2011,80600050,,,,5,1,6
HND-008253,2011,80600051,,,,2,2,4
HND-008254,2011,80600052,,,,3,2,5
HND-008255,2011,80600053,,,,1,0,1
HND-008257,2011,80600055,,,,24,19,43
HND-008267,2011,80600067,,,,23,20,43
HND-008268,2011,80600069,,,,5,1,6
HND-008275,2011,80600094,,,,3,4,7
HND-008276,2011,80600095,,,,2,1,3
HND-008277,2011,80600096,,,,3,1,4
HND-008290,2011,80600118,,,,0,1,1
,2011,80600007,,,,82,74,156
HND-008215,2011,80600009,,,,5,5,10
,2011,80600012,,,,2,3,5
HND-008218,2011,80600013,,,,2,5,7
,2011,80600014,,,,6,3,9
HND-008224,2011,80600019,,,,13,5,18
HND-008225,2011,80600020,,,,4,3,7
HND-008226,2011,80600021,,,,0,3,3
HND-008227,2011,80600022,,,,4,4,8
HND-008228,2011,80600023,,,,3,0,3
HND-008233,2011,80600028,,,,4,5,9
HND-008238,2011,80600034,,,,6,4,10
HND-008239,2011,80600035,,,,8,7,15
,2011,80600037,,,,3,0,3
HND-008241,2011,80600038,,,,27,21,48
,2011,80600039,,,,3,2,5
HND-008242,2011,80600040,,,,1,3,4
HND-008243,2011,80600041,,,,3,1,4
HND-008244,2011,80600042,,,,1,0,1
HND-008245,2011,80600043,,,,6,5,11
HND-008251,2011,80600049,,,,2,0,2
HND-008256,2011,80600054,,,,9,2,11
HND-008264,2011,80600064,,,,5,3,8
HND-008266,2011,80600066,,,,3,1,4
,2011,80600071,,,,5,8,13
HND-008272,2011,80600091,,,,0,3,3
HND-008273,2011,80600092,,,,2,3,5
HND-008274,2011,80600093,,,,5,5,10
HND-008283,2011,80600105,,,,1,0,1
HND-008289,2011,80600117,,,,1,4,5
,2011,80600003,,,,0,3,3
,2011,80600007,,,,83,87,170
HND-008214,2011,80600008,,,,5,11,16
HND-008215,2011,80600009,,,,3,7,10
HND-008216,2011,80600010,,,,2,2,4
,2011,80600012,,,,2,4,6
HND-008218,2011,80600013,,,,3,2,5
,2011,80600014,,,,3,3,6
HND-008224,2011,80600019,,,,7,12,19
HND-008225,2011,80600020,,,,4,6,10
HND-008226,2011,80600021,,,,2,2,4
HND-008228,2011,80600023,,,,3,3,6
HND-008230,2011,80600025,,,,9,6,15
HND-008231,2011,80600026,,,,2,4,6
HND-008233,2011,80600028,,,,4,2,6
HND-008236,2011,80600031,,,,5,4,9
HND-008237,2011,80600032,,,,60,53,113
,2011,80600033,,,,5,5,10
HND-008240,2011,80600036,,,,1,2,3
HND-008246,2011,80600044,,,,2,3,5
HND-008247,2011,80600045,,,,4,2,6
HND-008248,2011,80600046,,,,3,2,5
HND-008249,2011,80600047,,,,7,1,8
HND-008252,2011,80600050,,,,4,0,4
HND-008253,2011,80600051,,,,3,0,3
HND-008254,2011,80600052,,,,0,1,1
HND-008255,2011,80600053,,,,3,0,3
HND-008264,2011,80600064,,,,4,6,10
HND-008266,2011,80600066,,,,4,1,5
HND-008275,2011,80600094,,,,4,2,6
HND-008276,2011,80600095,,,,4,2,6
HND-008283,2011,80600105,,,,3,0,3
HND-008289,2011,80600117,,,,0,4,4
HND-008290,2011,80600118,,,,0,3,3
HND-008217,2011,80600011,,,,3,1,4
HND-008220,2011,80600015,,,,2,2,4
HND-008221,2011,80600016,,,,3,6,9
HND-008222,2011,80600017,,,,3,1,4
HND-008223,2011,80600018,,,,4,2,6
HND-008227,2011,80600022,,,,4,0,4
HND-008229,2011,80600024,,,,2,4,6
HND-008232,2011,80600027,,,,3,4,7
HND-008235,2011,80600030,,,,5,3,8
HND-008238,2011,80600034,,,,5,4,9
HND-008239,2011,80600035,,,,6,8,14
,2011,80600037,,,,2,6,8
HND-008241,2011,80600038,,,,27,26,53
,2011,80600039,,,,0,2,2
HND-008242,2011,80600040,,,,2,0,2
HND-008243,2011,80600041,,,,5,0,5
HND-008244,2011,80600042,,,,4,1,5
HND-008245,2011,80600043,,,,3,8,11
HND-008250,2011,80600048,,,,1,1,2
HND-008251,2011,80600049,,,,2,2,4
HND-008256,2011,80600054,,,,4,6,10
HND-008257,2011,80600055,,,,13,20,33
HND-008267,2011,80600067,,,,24,29,53
HND-008268,2011,80600069,,,,9,2,11
,2011,80600071,,,,1,7,8
HND-008272,2011,80600091,,,,0,5,5
HND-008273,2011,80600092,,,,4,1,5
HND-008274,2011,80600093,,,,5,2,7
,2011,80600003,,,,3,2,5
HND-008214,2011,80600008,,,,13,13,26
HND-008216,2011,80600010,,,,3,0,3
HND-008217,2011,80600011,,,,1,0,1
HND-008218,2011,80600013,,,,1,5,6
HND-008220,2011,80600015,,,,1,1,2
HND-008221,2011,80600016,,,,3,4,7
HND-008223,2011,80600018,,,,2,3,5
HND-008224,2011,80600019,,,,6,4,10
HND-008229,2011,80600024,,,,3,5,8
HND-008230,2011,80600025,,,,4,8,12
HND-008231,2011,80600026,,,,0,5,5
HND-008232,2011,80600027,,,,5,5,10
HND-008233,2011,80600028,,,,0,3,3
HND-008238,2011,80600034,,,,7,4,11
HND-008239,2011,80600035,,,,5,3,8
HND-008240,2011,80600036,,,,3,3,6
,2011,80600037,,,,1,2,3
HND-008241,2011,80600038,,,,18,15,33
HND-008242,2011,80600040,,,,2,2,4
HND-008244,2011,80600042,,,,1,2,3
HND-008245,2011,80600043,,,,1,7,8
HND-008246,2011,80600044,,,,1,2,3
HND-008251,2011,80600049,,,,2,0,2
HND-008253,2011,80600051,,,,1,5,6
HND-008264,2011,80600064,,,,2,3,5
HND-008267,2011,80600067,,,,31,30,61
HND-008268,2011,80600069,,,,2,1,3
,2011,80600071,,,,2,3,5
HND-008273,2011,80600092,,,,4,1,5
HND-008274,2011,80600093,,,,1,5,6
HND-008275,2011,80600094,,,,2,0,2
HND-008290,2011,80600118,,,,1,1,2
,2011,80600007,,,,75,87,162
HND-008215,2011,80600009,,,,8,2,10
,2011,80600012,,,,4,1,5
,2011,80600014,,,,6,5,11
HND-008222,2011,80600017,,,,4,4,8
HND-008225,2011,80600020,,,,1,4,5
HND-008226,2011,80600021,,,,4,0,4
HND-008227,2011,80600022,,,,5,2,7
HND-008228,2011,80600023,,,,5,1,6
HND-008235,2011,80600030,,,,3,8,11
HND-008236,2011,80600031,,,,4,3,7
HND-008237,2011,80600032,,,,51,52,103
,2011,80600033,,,,4,9,13
,2011,80600039,,,,4,4,8
HND-008243,2011,80600041,,,,2,3,5
HND-008247,2011,80600045,,,,3,4,7
HND-008248,2011,80600046,,,,3,1,4
HND-008249,2011,80600047,,,,2,5,7
HND-008250,2011,80600048,,,,3,1,4
HND-008252,2011,80600050,,,,3,2,5
HND-008254,2011,80600052,,,,0,1,1
HND-008255,2011,80600053,,,,2,4,6
HND-008256,2011,80600054,,,,4,3,7
HND-008257,2011,80600055,,,,14,17,31
HND-008266,2011,80600066,,,,1,6,7
HND-008272,2011,80600091,,,,2,0,2
HND-008276,2011,80600095,,,,1,1,2
HND-008277,2011,80600096,,,,1,0,1
HND-008283,2011,80600105,,,,0,1,1
HND-008289,2011,80600117,,,,1,1,2
HND-008257,2011,80600055,,,,9,15,24
HND-008259,2011,80600057,,,,99,89,188
,2011,80600058,,,,103,95,198
,2011,80600119,,,,11,14,25
HND-008291,2011,80600120,,,,0,22,22
HND-008292,2011,80600121,,,,62,65,127
HND-008224,2011,80600019,,,,11,8,19
HND-008241,2011,80600038,,,,23,30,53
HND-008224,2011,80600019,,,,11,9,20
HND-008241,2011,80600038,,,,7,16,23
HND-008257,2011,80600055,,,,9,11,20
HND-008259,2011,80600057,,,,58,71,129
,2011,80600058,,,,87,78,165
,2011,80600119,,,,10,12,22
HND-008291,2011,80600120,,,,0,14,14
HND-008292,2011,80600121,,,,60,67,127
HND-008257,2011,80600055,,,,15,10,25
HND-008259,2011,80600057,,,,42,62,104
HND-008291,2011,80600120,,,,0,15,15
HND-008224,2011,80600019,,,,6,14,20
HND-008241,2011,80600038,,,,11,21,32
,2011,80600058,,,,68,81,149
,2011,80600119,,,,3,7,10
HND-008292,2011,80600121,,,,49,49,98
HND-008257,2011,80600055,,,,6,7,13
,2011,80600058,,,,79,84,163
HND-008259,2011,80600057,,,,55,61,116
,2011,80600119,,,,9,26,35
HND-008291,2011,80600120,,,,0,10,10
HND-008292,2011,80600121,,,,39,47,86
HND-008257,2011,80600055,,,,6,6,12
HND-008259,2011,80600057,,,,46,46,92
HND-008292,2011,80600121,,,,8,42,50
,2011,80600058,,,,45,94,139
HND-008291,2011,80600120,,,,0,7,7
,2011,80600058,,,,34,50,84
HND-008259,2011,80600057,,,,42,35,77
,2011,80700029,,,,7,5,12
HND-008307,2011,80700019,,,,2,8,10
,2011,80700028,,,,3,7,10
HND-008308,2011,80700030,,,,6,4,10
,2011,80700031,,,,3,7,10
HND-008304,2011,80700015,,,,3,1,4
HND-008302,2011,80700010,,,,4,4,8
HND-008303,2011,80700014,,,,2,4,6
HND-008304,2011,80700015,,,,3,3,6
HND-008302,2011,80700010,,,,5,5,10
HND-008303,2011,80700014,,,,8,4,12
HND-008304,2011,80700015,,,,2,3,5
HND-008294,2011,80700002,,,,6,7,13
HND-008295,2011,80700003,,,,2,0,2
HND-008300,2011,80700008,,,,10,7,17
HND-008301,2011,80700009,,,,4,0,4
HND-008305,2011,80700017,,,,5,7,12
HND-008306,2011,80700018,,,,1,3,4
HND-008296,2011,80700004,,,,5,0,5
HND-008297,2011,80700005,,,,4,2,6
HND-008298,2011,80700006,,,,5,0,5
HND-008299,2011,80700007,,,,5,9,14
HND-008295,2011,80700003,,,,1,0,1
HND-008296,2011,80700004,,,,7,2,9
HND-008301,2011,80700009,,,,1,0,1
HND-008306,2011,80700018,,,,1,3,4
HND-008294,2011,80700002,,,,3,10,13
HND-008297,2011,80700005,,,,0,7,7
HND-008298,2011,80700006,,,,5,1,6
HND-008299,2011,80700007,,,,10,4,14
HND-008300,2011,80700008,,,,7,3,10
HND-008305,2011,80700017,,,,4,5,9
HND-008296,2011,80700004,,,,4,4,8
HND-008297,2011,80700005,,,,4,3,7
HND-008298,2011,80700006,,,,6,2,8
HND-008299,2011,80700007,,,,3,9,12
HND-008294,2011,80700002,,,,7,8,15
HND-008295,2011,80700003,,,,5,2,7
HND-008300,2011,80700008,,,,8,5,13
HND-008301,2011,80700009,,,,1,1,2
HND-008305,2011,80700017,,,,10,3,13
HND-008306,2011,80700018,,,,1,8,9
HND-008295,2011,80700003,,,,0,1,1
HND-008296,2011,80700004,,,,5,2,7
HND-008301,2011,80700009,,,,2,2,4
HND-008306,2011,80700018,,,,1,3,4
HND-008294,2011,80700002,,,,9,6,15
HND-008297,2011,80700005,,,,5,2,7
HND-008298,2011,80700006,,,,3,2,5
HND-008299,2011,80700007,,,,5,5,10
HND-008300,2011,80700008,,,,4,6,10
HND-008305,2011,80700017,,,,3,6,9
HND-008295,2011,80700003,,,,0,1,1
HND-008300,2011,80700008,,,,8,6,14
HND-008301,2011,80700009,,,,2,3,5
HND-008305,2011,80700017,,,,8,1,9
HND-008294,2011,80700002,,,,9,9,18
HND-008296,2011,80700004,,,,3,4,7
HND-008297,2011,80700005,,,,4,9,13
HND-008298,2011,80700006,,,,7,1,8
HND-008299,2011,80700007,,,,8,7,15
HND-008294,2011,80700002,,,,4,8,12
HND-008297,2011,80700005,,,,6,4,10
HND-008298,2011,80700006,,,,1,6,7
HND-008299,2011,80700007,,,,10,4,14
HND-008300,2011,80700008,,,,11,8,19
HND-008305,2011,80700017,,,,2,7,9
HND-008295,2011,80700003,,,,1,3,4
HND-008296,2011,80700004,,,,2,3,5
HND-008293,2011,80700001,,,,24,27,51
HND-008293,2011,80700001,,,,25,34,59
HND-008293,2011,80700001,,,,20,12,32
HND-008293,2011,80700001,,,,15,6,21
HND-008293,2011,80700001,,,,13,4,17
HND-008293,2011,80700001,,,,10,11,21
HND-008328,2011,80800023,,,,2,4,6
,2011,80800059,,,,3,2,5
,2011,80800060,,,,4,2,6
,2011,80800062,,,,0,6,6
,2011,80800063,,,,7,2,9
,2011,80800068,,,,8,5,13
,2011,80800069,,,,4,2,6
,2011,80800025,,,,4,2,6
HND-008330,2011,80800026,,,,8,6,14
,2011,80800030,,,,3,3,6
HND-008334,2011,80800031,,,,3,9,12
,2011,80800033,,,,4,6,10
,2011,80800039,,,,6,4,10
,2011,80800064,,,,4,3,7
,2011,80800066,,,,6,3,9
,2011,80800067,,,,3,5,8
,2011,80800045,,,,1,3,4
,2011,80800045,,,,6,3,9
HND-008336,2011,80800046,,,,7,5,12
HND-008309,2011,80800002,,,,13,5,18
HND-008315,2011,80800009,,,,6,9,15
HND-008317,2011,80800011,,,,3,1,4
HND-008321,2011,80800015,,,,7,5,12
HND-008322,2011,80800016,,,,5,6,11
HND-008323,2011,80800017,,,,5,3,8
HND-008324,2011,80800018,,,,4,3,7
HND-008326,2011,80800020,,,,6,8,14
HND-008331,2011,80800027,,,,7,1,8
HND-008332,2011,80800028,,,,2,2,4
HND-008335,2011,80800044,,,,0,2,2
HND-008310,2011,80800004,,,,3,0,3
HND-008311,2011,80800005,,,,2,3,5
HND-008312,2011,80800006,,,,5,6,11
HND-008313,2011,80800007,,,,4,1,5
HND-008314,2011,80800008,,,,6,5,11
HND-008316,2011,80800010,,,,1,5,6
HND-008318,2011,80800012,,,,1,0,1
HND-008319,2011,80800013,,,,3,5,8
HND-008320,2011,80800014,,,,4,1,5
HND-008325,2011,80800019,,,,2,2,4
HND-008333,2011,80800029,,,,8,6,14
HND-008309,2011,80800002,,,,13,8,21
HND-008310,2011,80800004,,,,5,2,7
HND-008312,2011,80800006,,,,5,4,9
HND-008313,2011,80800007,,,,4,4,8
HND-008316,2011,80800010,,,,2,1,3
HND-008317,2011,80800011,,,,2,0,2
HND-008319,2011,80800013,,,,9,9,18
HND-008324,2011,80800018,,,,2,2,4
HND-008325,2011,80800019,,,,2,8,10
HND-008332,2011,80800028,,,,1,0,1
HND-008333,2011,80800029,,,,5,7,12
HND-008335,2011,80800044,,,,1,1,2
HND-008311,2011,80800005,,,,3,3,6
HND-008314,2011,80800008,,,,2,6,8
HND-008315,2011,80800009,,,,3,3,6
HND-008320,2011,80800014,,,,0,1,1
HND-008321,2011,80800015,,,,5,0,5
HND-008322,2011,80800016,,,,6,4,10
HND-008323,2011,80800017,,,,1,1,2
HND-008326,2011,80800020,,,,10,2,12
HND-008331,2011,80800027,,,,5,1,6
HND-008310,2011,80800004,,,,6,2,8
HND-008311,2011,80800005,,,,5,0,5
HND-008312,2011,80800006,,,,4,1,5
HND-008313,2011,80800007,,,,0,3,3
HND-008316,2011,80800010,,,,1,4,5
HND-008318,2011,80800012,,,,0,2,2
HND-008319,2011,80800013,,,,9,9,18
HND-008320,2011,80800014,,,,4,0,4
HND-008325,2011,80800019,,,,3,3,6
HND-008333,2011,80800029,,,,3,1,4
HND-008309,2011,80800002,,,,19,5,24
HND-008314,2011,80800008,,,,1,2,3
HND-008315,2011,80800009,,,,6,6,12
HND-008317,2011,80800011,,,,2,6,8
HND-008321,2011,80800015,,,,1,3,4
HND-008322,2011,80800016,,,,4,3,7
HND-008324,2011,80800018,,,,3,3,6
HND-008326,2011,80800020,,,,9,2,11
HND-008331,2011,80800027,,,,3,2,5
HND-008332,2011,80800028,,,,1,1,2
HND-008335,2011,80800044,,,,2,1,3
HND-008309,2011,80800002,,,,15,15,30
HND-008310,2011,80800004,,,,8,7,15
HND-008315,2011,80800009,,,,6,1,7
HND-008316,2011,80800010,,,,2,6,8
HND-008317,2011,80800011,,,,5,4,9
HND-008318,2011,80800012,,,,2,1,3
HND-008319,2011,80800013,,,,2,11,13
HND-008324,2011,80800018,,,,1,1,2
HND-008325,2011,80800019,,,,6,4,10
HND-008326,2011,80800020,,,,4,11,15
HND-008332,2011,80800028,,,,6,1,7
HND-008333,2011,80800029,,,,6,3,9
HND-008311,2011,80800005,,,,2,3,5
HND-008312,2011,80800006,,,,5,4,9
HND-008313,2011,80800007,,,,0,4,4
HND-008314,2011,80800008,,,,2,4,6
HND-008320,2011,80800014,,,,1,2,3
HND-008321,2011,80800015,,,,2,5,7
HND-008322,2011,80800016,,,,4,3,7
HND-008323,2011,80800017,,,,3,2,5
HND-008331,2011,80800027,,,,4,3,7
HND-008311,2011,80800005,,,,0,1,1
HND-008312,2011,80800006,,,,2,2,4
HND-008313,2011,80800007,,,,3,2,5
HND-008314,2011,80800008,,,,3,4,7
HND-008318,2011,80800012,,,,4,1,5
HND-008320,2011,80800014,,,,2,2,4
HND-008323,2011,80800017,,,,2,4,6
HND-008325,2011,80800019,,,,4,4,8
HND-008333,2011,80800029,,,,0,4,4
HND-008335,2011,80800044,,,,3,0,3
HND-008309,2011,80800002,,,,14,10,24
HND-008310,2011,80800004,,,,1,3,4
HND-008315,2011,80800009,,,,4,3,7
HND-008316,2011,80800010,,,,1,8,9
HND-008317,2011,80800011,,,,2,3,5
HND-008319,2011,80800013,,,,9,4,13
HND-008321,2011,80800015,,,,4,3,7
HND-008322,2011,80800016,,,,2,1,3
HND-008324,2011,80800018,,,,5,6,11
HND-008326,2011,80800020,,,,12,10,22
HND-008331,2011,80800027,,,,3,1,4
HND-008332,2011,80800028,,,,1,1,2
HND-008309,2011,80800002,,,,14,11,25
HND-008310,2011,80800004,,,,3,4,7
HND-008312,2011,80800006,,,,4,3,7
HND-008313,2011,80800007,,,,1,3,4
HND-008316,2011,80800010,,,,3,6,9
HND-008317,2011,80800011,,,,2,2,4
HND-008318,2011,80800012,,,,3,1,4
HND-008319,2011,80800013,,,,15,10,25
HND-008324,2011,80800018,,,,2,1,3
HND-008325,2011,80800019,,,,2,1,3
HND-008332,2011,80800028,,,,3,2,5
HND-008333,2011,80800029,,,,3,0,3
HND-008311,2011,80800005,,,,3,0,3
HND-008314,2011,80800008,,,,2,5,7
HND-008315,2011,80800009,,,,5,6,11
HND-008320,2011,80800014,,,,4,2,6
HND-008321,2011,80800015,,,,0,1,1
HND-008322,2011,80800016,,,,4,3,7
HND-008323,2011,80800017,,,,6,3,9
HND-008326,2011,80800020,,,,12,9,21
HND-008331,2011,80800027,,,,0,2,2
HND-008335,2011,80800044,,,,0,2,2
HND-008337,2011,80800047,,,,21,21,42
HND-008327,2011,80800021,,,,18,21,39
HND-008327,2011,80800021,,,,14,13,27
HND-008337,2011,80800047,,,,20,15,35
HND-008327,2011,80800021,,,,10,12,22
HND-008337,2011,80800047,,,,21,17,38
HND-008337,2011,80800047,,,,12,21,33
HND-008337,2011,80800047,,,,5,14,19
HND-008337,2011,80800047,,,,4,14,18
HND-008351,2011,80900018,,,,1,6,7
,2011,80900062,,,,5,3,8
,2011,80900064,,,,5,5,10
,2011,80900072,,,,2,3,5
,2011,80900092,,,,2,3,5
,2011,80900093,,,,3,4,7
,2011,80900094,,,,3,5,8
,2011,80900106,,,,3,3,6
,2011,80900107,,,,3,3,6
,2011,80900108,,,,3,2,5
,2011,80900119,,,,2,3,5
,2011,80900127,,,,3,3,6
,2011,80900131,,,,3,3,6
,2011,80900133,,,,8,3,11
,2011,80900134,,,,3,5,8
,2011,80900065,,,,2,3,5
,2011,80900066,,,,6,3,9
,2011,80900067,,,,2,3,5
,2011,80900068,,,,2,4,6
,2011,80900074,,,,3,4,7
,2011,80900076,,,,10,7,17
,2011,80900077,,,,6,2,8
,2011,80900095,,,,5,3,8
,2011,80900109,,,,3,2,5
,2011,80900115,,,,4,2,6
,2011,80900116,,,,3,2,5
HND-008395,2011,80900122,,,,3,2,5
,2011,80900123,,,,3,2,5
,2011,80900130,,,,3,2,5
,2011,80900132,,,,2,4,6
,2011,80900138,,,,2,4,6
HND-008342,2011,80900009,,,,2,3,5
HND-008383,2011,80900051,,,,1,1,2
,2011,80900070,,,,4,0,4
,2011,80900096,,,,4,1,5
,2011,80900113,,,,0,4,4
HND-008398,2011,80900139,,,,2,2,4
HND-008375,2011,80900042,,,,0,1,1
HND-008340,2011,80900007,,,,1,1,2
HND-008357,2011,80900024,,,,0,2,2
HND-008375,2011,80900042,,,,0,2,2
HND-008383,2011,80900051,,,,1,7,8
,2011,80900070,,,,7,3,10
,2011,80900113,,,,0,2,2
HND-008342,2011,80900009,,,,2,3,5
HND-008350,2011,80900017,,,,2,3,5
HND-008373,2011,80900040,,,,13,15,28
HND-008377,2011,80900044,,,,1,1,2
,2011,80900096,,,,5,2,7
HND-008398,2011,80900139,,,,7,2,9
HND-008339,2011,80900006,,,,9,3,12
HND-008340,2011,80900007,,,,8,7,15
HND-008357,2011,80900024,,,,9,4,13
HND-008359,2011,80900026,,,,4,10,14
HND-008365,2011,80900032,,,,4,10,14
HND-008373,2011,80900040,,,,39,39,78
HND-008377,2011,80900044,,,,11,7,18
,2011,80900096,,,,2,3,5
HND-008341,2011,80900008,,,,6,10,16
HND-008342,2011,80900009,,,,4,3,7
HND-008350,2011,80900017,,,,5,4,9
HND-008375,2011,80900042,,,,4,14,18
HND-008383,2011,80900051,,,,2,4,6
,2011,80900070,,,,3,6,9
,2011,80900113,,,,0,3,3
HND-008398,2011,80900139,,,,2,2,4
HND-008339,2011,80900006,,,,7,3,10
HND-008340,2011,80900007,,,,3,12,15
HND-008341,2011,80900008,,,,6,9,15
HND-008343,2011,80900010,,,,4,3,7
HND-008344,2011,80900011,,,,1,1,2
HND-008345,2011,80900012,,,,5,4,9
HND-008346,2011,80900013,,,,3,2,5
HND-008351,2011,80900018,,,,4,4,8
HND-008352,2011,80900019,,,,3,6,9
HND-008354,2011,80900021,,,,4,5,9
HND-008358,2011,80900025,,,,3,3,6
HND-008359,2011,80900026,,,,9,9,18
HND-008360,2011,80900027,,,,6,4,10
HND-008361,2011,80900028,,,,7,2,9
HND-008364,2011,80900031,,,,3,4,7
HND-008368,2011,80900035,,,,4,5,9
HND-008369,2011,80900036,,,,0,3,3
HND-008370,2011,80900037,,,,5,2,7
HND-008371,2011,80900038,,,,3,2,5
HND-008376,2011,80900043,,,,18,15,33
HND-008381,2011,80900049,,,,1,0,1
HND-008382,2011,80900050,,,,3,0,3
HND-008384,2011,80900052,,,,2,3,5
HND-008385,2011,80900053,,,,6,6,12
,2011,80900059,,,,0,2,2
HND-008393,2011,80900102,,,,3,5,8
HND-008394,2011,80900103,,,,1,4,5
HND-008396,2011,80900136,,,,7,5,12
HND-008397,2011,80900137,,,,3,2,5
HND-008338,2011,80900005,,,,44,31,75
HND-008342,2011,80900009,,,,12,7,19
HND-008347,2011,80900014,,,,9,6,15
HND-008348,2011,80900015,,,,5,3,8
HND-008349,2011,80900016,,,,14,5,19
HND-008350,2011,80900017,,,,3,10,13
HND-008353,2011,80900020,,,,14,8,22
HND-008355,2011,80900022,,,,4,6,10
HND-008356,2011,80900023,,,,3,3,6
HND-008357,2011,80900024,,,,8,6,14
HND-008362,2011,80900029,,,,2,3,5
HND-008363,2011,80900030,,,,1,2,3
HND-008365,2011,80900032,,,,6,2,8
HND-008366,2011,80900033,,,,2,2,4
HND-008367,2011,80900034,,,,2,3,5
HND-008372,2011,80900039,,,,3,2,5
,2011,80900045,,,,7,7,14
HND-008378,2011,80900046,,,,5,0,5
HND-008379,2011,80900047,,,,3,1,4
HND-008380,2011,80900048,,,,4,4,8
HND-008383,2011,80900051,,,,1,3,4
HND-008386,2011,80900055,,,,3,3,6
HND-008387,2011,80900056,,,,4,4,8
HND-008388,2011,80900058,,,,0,3,3
HND-008389,2011,80900060,,,,2,2,4
HND-008390,2011,80900090,,,,2,1,3
HND-008391,2011,80900091,,,,3,1,4
HND-008338,2011,80900005,,,,40,35,75
HND-008339,2011,80900006,,,,4,6,10
HND-008340,2011,80900007,,,,6,8,14
HND-008343,2011,80900010,,,,1,0,1
HND-008344,2011,80900011,,,,3,6,9
HND-008348,2011,80900015,,,,2,3,5
HND-008349,2011,80900016,,,,14,4,18
HND-008351,2011,80900018,,,,3,2,5
HND-008357,2011,80900024,,,,5,1,6
HND-008358,2011,80900025,,,,2,3,5
HND-008359,2011,80900026,,,,8,8,16
HND-008360,2011,80900027,,,,6,5,11
HND-008363,2011,80900030,,,,2,1,3
HND-008364,2011,80900031,,,,4,2,6
HND-008365,2011,80900032,,,,3,8,11
HND-008366,2011,80900033,,,,6,5,11
HND-008371,2011,80900038,,,,4,5,9
HND-008372,2011,80900039,,,,1,7,8
,2011,80900045,,,,3,4,7
HND-008378,2011,80900046,,,,1,3,4
HND-008379,2011,80900047,,,,5,1,6
HND-008386,2011,80900055,,,,5,2,7
HND-008387,2011,80900056,,,,2,7,9
HND-008389,2011,80900060,,,,1,3,4
HND-008391,2011,80900091,,,,4,2,6
HND-008393,2011,80900102,,,,1,1,2
HND-008396,2011,80900136,,,,2,0,2
HND-008341,2011,80900008,,,,6,3,9
HND-008342,2011,80900009,,,,1,5,6
HND-008345,2011,80900012,,,,0,1,1
HND-008346,2011,80900013,,,,4,4,8
HND-008347,2011,80900014,,,,10,2,12
HND-008350,2011,80900017,,,,6,8,14
HND-008352,2011,80900019,,,,4,3,7
HND-008353,2011,80900020,,,,6,6,12
HND-008354,2011,80900021,,,,9,3,12
HND-008355,2011,80900022,,,,3,1,4
HND-008356,2011,80900023,,,,2,2,4
HND-008361,2011,80900028,,,,2,4,6
HND-008362,2011,80900029,,,,3,1,4
HND-008367,2011,80900034,,,,3,5,8
HND-008368,2011,80900035,,,,1,1,2
HND-008369,2011,80900036,,,,1,2,3
HND-008370,2011,80900037,,,,0,3,3
HND-008376,2011,80900043,,,,16,13,29
HND-008380,2011,80900048,,,,4,1,5
HND-008381,2011,80900049,,,,1,3,4
HND-008382,2011,80900050,,,,1,2,3
HND-008383,2011,80900051,,,,2,1,3
HND-008385,2011,80900053,,,,3,6,9
HND-008388,2011,80900058,,,,3,1,4
,2011,80900059,,,,0,4,4
HND-008390,2011,80900090,,,,1,0,1
HND-008394,2011,80900103,,,,0,3,3
HND-008397,2011,80900137,,,,5,1,6
HND-008339,2011,80900006,,,,8,5,13
HND-008340,2011,80900007,,,,4,4,8
HND-008341,2011,80900008,,,,7,7,14
HND-008343,2011,80900010,,,,1,6,7
HND-008344,2011,80900011,,,,0,2,2
HND-008345,2011,80900012,,,,3,2,5
HND-008346,2011,80900013,,,,1,5,6
HND-008351,2011,80900018,,,,2,2,4
HND-008352,2011,80900019,,,,6,3,9
HND-008354,2011,80900021,,,,6,8,14
HND-008358,2011,80900025,,,,5,1,6
HND-008359,2011,80900026,,,,6,4,10
HND-008360,2011,80900027,,,,9,3,12
HND-008361,2011,80900028,,,,4,4,8
HND-008363,2011,80900030,,,,1,1,2
HND-008365,2011,80900032,,,,8,6,14
HND-008366,2011,80900033,,,,2,3,5
HND-008367,2011,80900034,,,,7,2,9
HND-008372,2011,80900039,,,,6,2,8
,2011,80900045,,,,0,6,6
HND-008378,2011,80900046,,,,10,2,12
HND-008379,2011,80900047,,,,3,0,3
HND-008380,2011,80900048,,,,5,4,9
HND-008383,2011,80900051,,,,2,0,2
HND-008386,2011,80900055,,,,3,3,6
HND-008387,2011,80900056,,,,10,1,11
HND-008388,2011,80900058,,,,4,0,4
HND-008390,2011,80900090,,,,2,1,3
HND-008391,2011,80900091,,,,4,6,10
HND-008338,2011,80900005,,,,36,44,80
HND-008342,2011,80900009,,,,2,4,6
HND-008347,2011,80900014,,,,9,4,13
HND-008348,2011,80900015,,,,4,2,6
HND-008349,2011,80900016,,,,8,8,16
HND-008350,2011,80900017,,,,4,3,7
HND-008353,2011,80900020,,,,15,5,20
HND-008355,2011,80900022,,,,0,6,6
HND-008356,2011,80900023,,,,4,3,7
HND-008357,2011,80900024,,,,6,3,9
HND-008362,2011,80900029,,,,1,2,3
HND-008364,2011,80900031,,,,6,0,6
HND-008368,2011,80900035,,,,1,1,2
HND-008369,2011,80900036,,,,1,2,3
HND-008370,2011,80900037,,,,3,1,4
HND-008371,2011,80900038,,,,5,7,12
HND-008376,2011,80900043,,,,11,4,15
HND-008381,2011,80900049,,,,1,0,1
HND-008384,2011,80900052,,,,2,2,4
HND-008385,2011,80900053,,,,4,4,8
,2011,80900059,,,,1,1,2
HND-008389,2011,80900060,,,,3,2,5
HND-008393,2011,80900102,,,,0,3,3
HND-008394,2011,80900103,,,,2,0,2
HND-008396,2011,80900136,,,,4,10,14
HND-008338,2011,80900005,,,,38,28,66
HND-008340,2011,80900007,,,,2,2,4
HND-008342,2011,80900009,,,,1,4,5
HND-008344,2011,80900011,,,,4,4,8
HND-008348,2011,80900015,,,,6,3,9
HND-008349,2011,80900016,,,,7,7,14
HND-008350,2011,80900017,,,,6,8,14
HND-008351,2011,80900018,,,,3,4,7
HND-008355,2011,80900022,,,,6,2,8
HND-008357,2011,80900024,,,,6,9,15
HND-008360,2011,80900027,,,,7,2,9
HND-008362,2011,80900029,,,,4,4,8
HND-008363,2011,80900030,,,,5,0,5
HND-008364,2011,80900031,,,,1,3,4
HND-008366,2011,80900033,,,,1,4,5
HND-008371,2011,80900038,,,,5,5,10
HND-008372,2011,80900039,,,,2,4,6
HND-008376,2011,80900043,,,,8,4,12
HND-008379,2011,80900047,,,,3,1,4
HND-008381,2011,80900049,,,,2,3,5
HND-008384,2011,80900052,,,,5,2,7
HND-008386,2011,80900055,,,,5,3,8
HND-008387,2011,80900056,,,,1,8,9
HND-008389,2011,80900060,,,,2,2,4
HND-008393,2011,80900102,,,,3,2,5
HND-008396,2011,80900136,,,,4,5,9
HND-008397,2011,80900137,,,,0,1,1
HND-008339,2011,80900006,,,,3,6,9
HND-008341,2011,80900008,,,,7,4,11
HND-008343,2011,80900010,,,,6,4,10
HND-008345,2011,80900012,,,,4,0,4
HND-008346,2011,80900013,,,,1,1,2
HND-008347,2011,80900014,,,,4,5,9
HND-008352,2011,80900019,,,,2,2,4
HND-008353,2011,80900020,,,,7,5,12
HND-008354,2011,80900021,,,,4,2,6
HND-008356,2011,80900023,,,,3,5,8
HND-008358,2011,80900025,,,,3,4,7
HND-008359,2011,80900026,,,,7,11,18
HND-008361,2011,80900028,,,,3,4,7
HND-008365,2011,80900032,,,,4,5,9
HND-008367,2011,80900034,,,,3,2,5
HND-008368,2011,80900035,,,,2,6,8
HND-008369,2011,80900036,,,,0,3,3
HND-008370,2011,80900037,,,,4,2,6
,2011,80900045,,,,6,6,12
HND-008378,2011,80900046,,,,3,2,5
HND-008380,2011,80900048,,,,6,4,10
HND-008382,2011,80900050,,,,3,1,4
HND-008383,2011,80900051,,,,2,2,4
HND-008385,2011,80900053,,,,5,1,6
HND-008388,2011,80900058,,,,0,3,3
,2011,80900059,,,,2,5,7
HND-008390,2011,80900090,,,,2,3,5
HND-008391,2011,80900091,,,,4,4,8
HND-008394,2011,80900103,,,,2,6,8
HND-008338,2011,80900005,,,,41,28,69
HND-008342,2011,80900009,,,,8,4,12
HND-008347,2011,80900014,,,,4,8,12
HND-008348,2011,80900015,,,,3,5,8
HND-008349,2011,80900016,,,,6,8,14
HND-008350,2011,80900017,,,,10,12,22
HND-008351,2011,80900018,,,,3,3,6
HND-008353,2011,80900020,,,,6,12,18
HND-008355,2011,80900022,,,,4,5,9
HND-008356,2011,80900023,,,,2,2,4
HND-008357,2011,80900024,,,,4,7,11
HND-008363,2011,80900030,,,,1,1,2
HND-008364,2011,80900031,,,,2,7,9
HND-008368,2011,80900035,,,,2,2,4
HND-008369,2011,80900036,,,,4,1,5
HND-008371,2011,80900038,,,,1,3,4
HND-008376,2011,80900043,,,,4,6,10
HND-008381,2011,80900049,,,,2,2,4
HND-008385,2011,80900053,,,,5,2,7
,2011,80900059,,,,0,1,1
HND-008389,2011,80900060,,,,2,2,4
HND-008396,2011,80900136,,,,3,4,7
HND-008397,2011,80900137,,,,1,1,2
HND-008339,2011,80900006,,,,0,2,2
HND-008340,2011,80900007,,,,0,2,2
HND-008341,2011,80900008,,,,4,5,9
HND-008343,2011,80900010,,,,3,3,6
HND-008344,2011,80900011,,,,3,3,6
HND-008345,2011,80900012,,,,2,1,3
HND-008346,2011,80900013,,,,3,1,4
HND-008352,2011,80900019,,,,1,1,2
HND-008354,2011,80900021,,,,3,3,6
HND-008358,2011,80900025,,,,5,6,11
HND-008359,2011,80900026,,,,5,7,12
HND-008360,2011,80900027,,,,1,4,5
HND-008361,2011,80900028,,,,3,3,6
HND-008365,2011,80900032,,,,7,2,9
HND-008366,2011,80900033,,,,2,2,4
HND-008367,2011,80900034,,,,2,2,4
HND-008370,2011,80900037,,,,2,3,5
HND-008372,2011,80900039,,,,4,5,9
,2011,80900045,,,,1,4,5
HND-008378,2011,80900046,,,,5,0,5
HND-008380,2011,80900048,,,,2,3,5
HND-008382,2011,80900050,,,,3,2,5
HND-008383,2011,80900051,,,,1,0,1
HND-008386,2011,80900055,,,,3,1,4
HND-008387,2011,80900056,,,,3,7,10
HND-008388,2011,80900058,,,,1,2,3
HND-008390,2011,80900090,,,,3,8,11
HND-008391,2011,80900091,,,,6,6,12
HND-008393,2011,80900102,,,,0,4,4
HND-008394,2011,80900103,,,,2,6,8
HND-008341,2011,80900008,,,,1,5,6
HND-008342,2011,80900009,,,,3,7,10
HND-008345,2011,80900012,,,,1,1,2
HND-008346,2011,80900013,,,,4,5,9
HND-008347,2011,80900014,,,,6,7,13
HND-008350,2011,80900017,,,,9,5,14
HND-008352,2011,80900019,,,,1,4,5
HND-008353,2011,80900020,,,,9,5,14
HND-008354,2011,80900021,,,,4,5,9
HND-008355,2011,80900022,,,,5,0,5
HND-008356,2011,80900023,,,,2,3,5
HND-008361,2011,80900028,,,,4,6,10
HND-008362,2011,80900029,,,,1,4,5
HND-008367,2011,80900034,,,,4,5,9
HND-008368,2011,80900035,,,,2,2,4
HND-008369,2011,80900036,,,,2,1,3
HND-008370,2011,80900037,,,,5,1,6
HND-008376,2011,80900043,,,,6,6,12
HND-008380,2011,80900048,,,,3,3,6
HND-008381,2011,80900049,,,,0,1,1
HND-008382,2011,80900050,,,,0,1,1
HND-008383,2011,80900051,,,,2,0,2
HND-008384,2011,80900052,,,,1,0,1
HND-008385,2011,80900053,,,,1,7,8
HND-008388,2011,80900058,,,,1,3,4
,2011,80900059,,,,0,1,1
HND-008390,2011,80900090,,,,1,1,2
HND-008394,2011,80900103,,,,3,0,3
HND-008338,2011,80900005,,,,23,40,63
HND-008339,2011,80900006,,,,4,5,9
HND-008340,2011,80900007,,,,2,1,3
HND-008343,2011,80900010,,,,6,3,9
HND-008344,2011,80900011,,,,1,4,5
HND-008348,2011,80900015,,,,9,6,15
HND-008349,2011,80900016,,,,9,4,13
HND-008351,2011,80900018,,,,5,2,7
HND-008357,2011,80900024,,,,3,6,9
HND-008358,2011,80900025,,,,6,5,11
HND-008359,2011,80900026,,,,5,10,15
HND-008360,2011,80900027,,,,2,5,7
HND-008363,2011,80900030,,,,1,3,4
HND-008364,2011,80900031,,,,1,0,1
HND-008365,2011,80900032,,,,2,5,7
HND-008366,2011,80900033,,,,1,4,5
HND-008371,2011,80900038,,,,3,5,8
HND-008372,2011,80900039,,,,7,3,10
,2011,80900045,,,,3,1,4
HND-008378,2011,80900046,,,,4,1,5
HND-008386,2011,80900055,,,,4,6,10
HND-008387,2011,80900056,,,,4,6,10
HND-008389,2011,80900060,,,,1,0,1
HND-008391,2011,80900091,,,,6,8,14
HND-008393,2011,80900102,,,,4,1,5
HND-008396,2011,80900136,,,,2,2,4
HND-008340,2011,80900007,,,,2,14,16
HND-008359,2011,80900026,,,,5,5,10
HND-008374,2011,80900041,,,,89,72,161
HND-008342,2011,80900009,,,,9,3,12
HND-008348,2011,80900015,,,,0,8,8
HND-008353,2011,80900020,,,,5,6,11
HND-008357,2011,80900024,,,,5,10,15
HND-008365,2011,80900032,,,,7,12,19
HND-008392,2011,80900101,,,,12,20,32
HND-008340,2011,80900007,,,,3,5,8
HND-008348,2011,80900015,,,,4,2,6
HND-008357,2011,80900024,,,,7,7,14
HND-008359,2011,80900026,,,,4,7,11
HND-008365,2011,80900032,,,,3,2,5
HND-008342,2011,80900009,,,,7,4,11
HND-008353,2011,80900020,,,,10,3,13
HND-008374,2011,80900041,,,,58,58,116
HND-008392,2011,80900101,,,,10,11,21
HND-008340,2011,80900007,,,,3,6,9
HND-008348,2011,80900015,,,,2,5,7
HND-008357,2011,80900024,,,,5,4,9
HND-008365,2011,80900032,,,,2,2,4
HND-008392,2011,80900101,,,,3,21,24
HND-008342,2011,80900009,,,,3,4,7
HND-008353,2011,80900020,,,,7,4,11
HND-008359,2011,80900026,,,,1,5,6
HND-008374,2011,80900041,,,,57,69,126
HND-008374,2011,80900041,,,,54,62,116
HND-008374,2011,80900041,,,,43,55,98
HND-008374,2011,80900041,,,,26,23,49
,2011,81000029,,,,6,7,13
,2011,81000032,,,,3,2,5
,2011,81000033,,,,6,8,14
,2011,81000035,,,,5,4,9
,2011,81000037,,,,3,5,8
HND-008427,2011,81000038,,,,5,6,11
HND-008428,2011,81000041,,,,2,4,6
,2011,81000043,,,,10,1,11
,2011,81000040,,,,6,3,9
,2011,81000042,,,,4,1,5
HND-008429,2011,81000044,,,,7,5,12
,2011,81000045,,,,4,1,5
HND-008421,2011,81000024,,,,5,6,11
HND-008423,2011,81000026,,,,1,1,2
HND-008422,2011,81000025,,,,6,3,9
HND-008421,2011,81000024,,,,6,8,14
HND-008423,2011,81000026,,,,6,2,8
HND-008422,2011,81000025,,,,3,3,6
HND-008401,2011,81000003,,,,5,3,8
HND-008402,2011,81000004,,,,3,1,4
HND-008403,2011,81000005,,,,5,8,13
HND-008404,2011,81000006,,,,6,9,15
HND-008405,2011,81000007,,,,2,2,4
HND-008406,2011,81000008,,,,1,2,3
HND-008408,2011,81000010,,,,13,10,23
HND-008413,2011,81000015,,,,5,1,6
HND-008414,2011,81000016,,,,8,9,17
HND-008416,2011,81000018,,,,3,0,3
HND-008417,2011,81000019,,,,0,2,2
HND-008418,2011,81000020,,,,4,2,6
HND-008400,2011,81000002,,,,7,4,11
HND-008407,2011,81000009,,,,4,4,8
HND-008409,2011,81000011,,,,2,1,3
HND-008410,2011,81000012,,,,2,2,4
HND-008411,2011,81000013,,,,0,3,3
HND-008412,2011,81000014,,,,4,5,9
HND-008415,2011,81000017,,,,4,1,5
HND-008419,2011,81000021,,,,5,3,8
HND-008424,2011,81000027,,,,4,3,7
HND-008425,2011,81000028,,,,2,1,3
HND-008400,2011,81000002,,,,6,0,6
HND-008401,2011,81000003,,,,3,2,5
HND-008405,2011,81000007,,,,2,0,2
HND-008408,2011,81000010,,,,9,11,20
HND-008410,2011,81000012,,,,3,4,7
HND-008412,2011,81000014,,,,3,1,4
HND-008413,2011,81000015,,,,3,1,4
HND-008414,2011,81000016,,,,7,8,15
HND-008416,2011,81000018,,,,1,2,3
HND-008418,2011,81000020,,,,2,3,5
HND-008425,2011,81000028,,,,1,3,4
HND-008402,2011,81000004,,,,1,5,6
HND-008403,2011,81000005,,,,4,8,12
HND-008404,2011,81000006,,,,10,3,13
HND-008406,2011,81000008,,,,1,2,3
HND-008407,2011,81000009,,,,3,1,4
HND-008409,2011,81000011,,,,1,0,1
HND-008415,2011,81000017,,,,4,1,5
HND-008419,2011,81000021,,,,1,1,2
HND-008424,2011,81000027,,,,5,1,6
HND-008401,2011,81000003,,,,6,3,9
HND-008402,2011,81000004,,,,2,2,4
HND-008404,2011,81000006,,,,6,4,10
HND-008405,2011,81000007,,,,2,3,5
HND-008408,2011,81000010,,,,11,9,20
HND-008412,2011,81000014,,,,2,1,3
HND-008413,2011,81000015,,,,2,0,2
HND-008414,2011,81000016,,,,11,3,14
HND-008416,2011,81000018,,,,1,3,4
HND-008417,2011,81000019,,,,1,2,3
HND-008418,2011,81000020,,,,1,0,1
HND-008425,2011,81000028,,,,1,1,2
HND-008400,2011,81000002,,,,6,6,12
HND-008403,2011,81000005,,,,5,5,10
HND-008406,2011,81000008,,,,0,2,2
HND-008407,2011,81000009,,,,0,7,7
HND-008409,2011,81000011,,,,1,2,3
HND-008410,2011,81000012,,,,6,1,7
HND-008411,2011,81000013,,,,2,0,2
HND-008415,2011,81000017,,,,0,2,2
HND-008419,2011,81000021,,,,3,3,6
HND-008424,2011,81000027,,,,2,4,6
HND-008400,2011,81000002,,,,5,5,10
HND-008408,2011,81000010,,,,10,8,18
HND-008409,2011,81000011,,,,1,0,1
HND-008410,2011,81000012,,,,4,6,10
HND-008411,2011,81000013,,,,1,0,1
HND-008412,2011,81000014,,,,2,0,2
HND-008413,2011,81000015,,,,2,2,4
HND-008414,2011,81000016,,,,6,4,10
HND-008415,2011,81000017,,,,1,3,4
HND-008416,2011,81000018,,,,2,2,4
HND-008418,2011,81000020,,,,2,3,5
HND-008419,2011,81000021,,,,3,0,3
HND-008424,2011,81000027,,,,6,3,9
HND-008425,2011,81000028,,,,1,1,2
HND-008401,2011,81000003,,,,5,3,8
HND-008402,2011,81000004,,,,1,3,4
HND-008403,2011,81000005,,,,5,7,12
HND-008404,2011,81000006,,,,11,6,17
HND-008405,2011,81000007,,,,1,2,3
HND-008406,2011,81000008,,,,0,2,2
HND-008407,2011,81000009,,,,8,2,10
HND-008417,2011,81000019,,,,1,0,1
HND-008400,2011,81000002,,,,5,4,9
HND-008407,2011,81000009,,,,3,1,4
HND-008409,2011,81000011,,,,2,1,3
HND-008410,2011,81000012,,,,3,2,5
HND-008411,2011,81000013,,,,1,0,1
HND-008412,2011,81000014,,,,1,1,2
HND-008414,2011,81000016,,,,2,8,10
HND-008415,2011,81000017,,,,5,0,5
HND-008416,2011,81000018,,,,0,1,1
HND-008418,2011,81000020,,,,1,0,1
HND-008419,2011,81000021,,,,0,3,3
HND-008424,2011,81000027,,,,2,3,5
HND-008425,2011,81000028,,,,2,1,3
HND-008401,2011,81000003,,,,3,3,6
HND-008402,2011,81000004,,,,4,2,6
HND-008403,2011,81000005,,,,5,8,13
HND-008404,2011,81000006,,,,3,5,8
HND-008405,2011,81000007,,,,0,2,2
HND-008406,2011,81000008,,,,1,2,3
HND-008408,2011,81000010,,,,10,10,20
HND-008413,2011,81000015,,,,3,2,5
HND-008417,2011,81000019,,,,1,0,1
HND-008402,2011,81000004,,,,2,1,3
HND-008403,2011,81000005,,,,9,6,15
HND-008404,2011,81000006,,,,9,5,14
HND-008406,2011,81000008,,,,1,0,1
HND-008407,2011,81000009,,,,2,6,8
HND-008415,2011,81000017,,,,1,5,6
HND-008419,2011,81000021,,,,0,1,1
HND-008424,2011,81000027,,,,6,4,10
HND-008400,2011,81000002,,,,4,6,10
HND-008401,2011,81000003,,,,2,0,2
HND-008408,2011,81000010,,,,10,16,26
HND-008410,2011,81000012,,,,6,1,7
HND-008411,2011,81000013,,,,0,1,1
HND-008412,2011,81000014,,,,2,2,4
HND-008413,2011,81000015,,,,4,4,8
HND-008414,2011,81000016,,,,5,4,9
HND-008416,2011,81000018,,,,2,0,2
HND-008418,2011,81000020,,,,0,6,6
HND-008425,2011,81000028,,,,1,0,1
HND-008414,2011,81000016,,,,7,5,12
,2011,81000030,,,,30,20,50
HND-008404,2011,81000006,,,,12,10,22
HND-008416,2011,81000018,,,,10,9,19
HND-008420,2011,81000022,,,,23,9,32
HND-008414,2011,81000016,,,,8,6,14
HND-008416,2011,81000018,,,,12,4,16
HND-008404,2011,81000006,,,,12,12,24
HND-008420,2011,81000022,,,,10,14,24
,2011,81000030,,,,19,8,27
HND-008414,2011,81000016,,,,4,11,15
HND-008416,2011,81000018,,,,8,5,13
HND-008404,2011,81000006,,,,8,8,16
HND-008420,2011,81000022,,,,13,10,23
,2011,81000030,,,,10,6,16
HND-008420,2011,81000022,,,,11,27,38
,2011,81000030,,,,14,12,26
HND-008420,2011,81000022,,,,9,9,18
,2011,81000030,,,,15,8,23
,2011,81000030,,,,5,8,13
HND-008420,2011,81000022,,,,10,6,16
,2011,81100062,,,,4,4,8
HND-008477,2011,81100063,,,,4,4,8
,2011,81100064,,,,5,2,7
,2011,81100066,,,,4,4,8
HND-008478,2011,81100067,,,,7,5,12
,2011,81100068,,,,9,7,16
,2011,81100073,,,,4,6,10
,2011,81100077,,,,2,4,6
,2011,81100058,,,,3,3,6
,2011,81100059,,,,6,2,8
,2011,81100060,,,,5,3,8
,2011,81100069,,,,4,1,5
,2011,81100070,,,,2,3,5
HND-008479,2011,81100072,,,,11,12,23
HND-008480,2011,81100074,,,,10,7,17
,2011,81100075,,,,5,1,6
HND-008430,2011,81100001,,,,5,3,8
HND-008432,2011,81100003,,,,6,4,10
HND-008455,2011,81100030,,,,14,15,29
HND-008431,2011,81100002,,,,5,1,6
HND-008476,2011,81100057,,,,5,4,9
HND-008430,2011,81100001,,,,7,10,17
HND-008431,2011,81100002,,,,4,5,9
HND-008432,2011,81100003,,,,2,3,5
HND-008455,2011,81100030,,,,31,18,49
HND-008476,2011,81100057,,,,5,4,9
HND-008436,2011,81100007,,,,1,2,3
HND-008437,2011,81100008,,,,18,18,36
HND-008439,2011,81100010,,,,5,6,11
HND-008440,2011,81100011,,,,4,5,9
HND-008441,2011,81100012,,,,6,2,8
HND-008442,2011,81100013,,,,0,2,2
HND-008443,2011,81100014,,,,12,7,19
HND-008444,2011,81100015,,,,7,4,11
HND-008445,2011,81100016,,,,3,2,5
HND-008446,2011,81100018,,,,7,1,8
HND-008448,2011,81100020,,,,2,2,4
HND-008452,2011,81100024,,,,3,1,4
HND-008453,2011,81100025,,,,4,6,10
HND-008456,2011,81100031,,,,0,5,5
HND-008457,2011,81100032,,,,12,10,22
HND-008458,2011,81100033,,,,4,0,4
HND-008462,2011,81100037,,,,5,4,9
HND-008465,2011,81100040,,,,1,3,4
HND-008466,2011,81100041,,,,4,0,4
HND-008468,2011,81100043,,,,6,0,6
HND-008469,2011,81100044,,,,11,13,24
HND-008470,2011,81100046,,,,4,6,10
HND-008471,2011,81100048,,,,6,1,7
,2011,81100055,,,,6,5,11
HND-008434,2011,81100005,,,,5,1,6
HND-008435,2011,81100006,,,,5,7,12
HND-008438,2011,81100009,,,,5,5,10
HND-008447,2011,81100019,,,,0,2,2
HND-008449,2011,81100021,,,,1,0,1
HND-008450,2011,81100022,,,,3,4,7
HND-008451,2011,81100023,,,,2,3,5
HND-008454,2011,81100027,,,,5,6,11
HND-008459,2011,81100034,,,,8,9,17
HND-008460,2011,81100035,,,,7,8,15
HND-008461,2011,81100036,,,,2,2,4
HND-008463,2011,81100038,,,,4,5,9
HND-008464,2011,81100039,,,,3,4,7
HND-008472,2011,81100049,,,,6,8,14
HND-008473,2011,81100052,,,,9,6,15
HND-008475,2011,81100056,,,,8,13,21
HND-008434,2011,81100005,,,,7,2,9
HND-008435,2011,81100006,,,,10,3,13
HND-008438,2011,81100009,,,,2,6,8
HND-008439,2011,81100010,,,,4,5,9
HND-008443,2011,81100014,,,,10,8,18
HND-008444,2011,81100015,,,,3,7,10
HND-008445,2011,81100016,,,,8,2,10
HND-008446,2011,81100018,,,,5,4,9
HND-008447,2011,81100019,,,,2,2,4
HND-008466,2011,81100041,,,,1,1,2
HND-008468,2011,81100043,,,,4,2,6
HND-008473,2011,81100052,,,,1,3,4
,2011,81100055,,,,2,4,6
HND-008475,2011,81100056,,,,2,3,5
HND-008437,2011,81100008,,,,24,26,50
HND-008440,2011,81100011,,,,5,1,6
HND-008441,2011,81100012,,,,1,3,4
HND-008442,2011,81100013,,,,2,6,8
HND-008448,2011,81100020,,,,1,0,1
HND-008449,2011,81100021,,,,2,1,3
HND-008450,2011,81100022,,,,4,6,10
HND-008451,2011,81100023,,,,1,1,2
HND-008452,2011,81100024,,,,3,1,4
HND-008453,2011,81100025,,,,2,4,6
HND-008454,2011,81100027,,,,1,1,2
HND-008456,2011,81100031,,,,2,2,4
HND-008457,2011,81100032,,,,5,6,11
HND-008458,2011,81100033,,,,4,3,7
HND-008459,2011,81100034,,,,9,5,14
HND-008460,2011,81100035,,,,9,4,13
HND-008461,2011,81100036,,,,2,2,4
HND-008462,2011,81100037,,,,4,3,7
HND-008463,2011,81100038,,,,3,4,7
HND-008464,2011,81100039,,,,6,4,10
HND-008465,2011,81100040,,,,3,3,6
HND-008469,2011,81100044,,,,4,6,10
HND-008470,2011,81100046,,,,4,1,5
HND-008471,2011,81100048,,,,1,2,3
HND-008472,2011,81100049,,,,2,5,7
HND-008434,2011,81100005,,,,5,4,9
HND-008435,2011,81100006,,,,8,5,13
HND-008438,2011,81100009,,,,1,2,3
HND-008449,2011,81100021,,,,1,3,4
HND-008451,2011,81100023,,,,2,1,3
HND-008454,2011,81100027,,,,7,6,13
HND-008456,2011,81100031,,,,5,1,6
HND-008458,2011,81100033,,,,4,2,6
HND-008462,2011,81100037,,,,8,2,10
HND-008465,2011,81100040,,,,7,1,8
HND-008466,2011,81100041,,,,4,3,7
HND-008468,2011,81100043,,,,4,2,6
HND-008469,2011,81100044,,,,7,1,8
HND-008470,2011,81100046,,,,4,1,5
HND-008471,2011,81100048,,,,1,3,4
,2011,81100055,,,,2,3,5
HND-008436,2011,81100007,,,,2,3,5
HND-008437,2011,81100008,,,,20,21,41
HND-008439,2011,81100010,,,,7,4,11
HND-008440,2011,81100011,,,,7,5,12
HND-008441,2011,81100012,,,,5,1,6
HND-008442,2011,81100013,,,,2,4,6
HND-008443,2011,81100014,,,,5,9,14
HND-008444,2011,81100015,,,,5,4,9
HND-008445,2011,81100016,,,,3,5,8
HND-008446,2011,81100018,,,,0,2,2
HND-008448,2011,81100020,,,,5,0,5
HND-008450,2011,81100022,,,,2,5,7
HND-008452,2011,81100024,,,,3,1,4
HND-008453,2011,81100025,,,,7,5,12
HND-008457,2011,81100032,,,,11,7,18
HND-008459,2011,81100034,,,,3,2,5
HND-008460,2011,81100035,,,,5,5,10
HND-008461,2011,81100036,,,,1,1,2
HND-008463,2011,81100038,,,,2,2,4
HND-008464,2011,81100039,,,,3,5,8
HND-008472,2011,81100049,,,,2,3,5
HND-008473,2011,81100052,,,,2,2,4
HND-008475,2011,81100056,,,,2,11,13
HND-008434,2011,81100005,,,,3,6,9
HND-008435,2011,81100006,,,,5,7,12
HND-008436,2011,81100007,,,,1,0,1
HND-008437,2011,81100008,,,,33,16,49
HND-008439,2011,81100010,,,,11,10,21
HND-008441,2011,81100012,,,,1,3,4
HND-008443,2011,81100014,,,,8,6,14
HND-008444,2011,81100015,,,,1,6,7
HND-008445,2011,81100016,,,,1,1,2
HND-008446,2011,81100018,,,,2,3,5
HND-008447,2011,81100019,,,,2,4,6
HND-008448,2011,81100020,,,,2,1,3
HND-008464,2011,81100039,,,,3,3,6
HND-008466,2011,81100041,,,,3,1,4
HND-008468,2011,81100043,,,,2,2,4
HND-008473,2011,81100052,,,,0,2,2
,2011,81100055,,,,5,3,8
HND-008475,2011,81100056,,,,1,0,1
HND-008438,2011,81100009,,,,4,3,7
HND-008440,2011,81100011,,,,6,4,10
HND-008442,2011,81100013,,,,2,2,4
HND-008449,2011,81100021,,,,0,1,1
HND-008450,2011,81100022,,,,2,1,3
HND-008451,2011,81100023,,,,6,4,10
HND-008452,2011,81100024,,,,2,3,5
HND-008453,2011,81100025,,,,0,2,2
HND-008454,2011,81100027,,,,7,4,11
HND-008456,2011,81100031,,,,0,3,3
HND-008457,2011,81100032,,,,9,6,15
HND-008458,2011,81100033,,,,0,1,1
HND-008459,2011,81100034,,,,1,5,6
HND-008460,2011,81100035,,,,4,8,12
HND-008461,2011,81100036,,,,3,1,4
HND-008462,2011,81100037,,,,5,5,10
HND-008463,2011,81100038,,,,3,3,6
HND-008465,2011,81100040,,,,4,2,6
HND-008469,2011,81100044,,,,2,0,2
HND-008470,2011,81100046,,,,3,1,4
HND-008471,2011,81100048,,,,2,3,5
HND-008472,2011,81100049,,,,8,2,10
HND-008435,2011,81100006,,,,6,4,10
HND-008436,2011,81100007,,,,3,0,3
HND-008437,2011,81100008,,,,29,34,63
HND-008439,2011,81100010,,,,9,3,12
HND-008440,2011,81100011,,,,6,3,9
HND-008441,2011,81100012,,,,2,3,5
HND-008442,2011,81100013,,,,3,1,4
HND-008443,2011,81100014,,,,6,6,12
HND-008444,2011,81100015,,,,3,3,6
HND-008445,2011,81100016,,,,3,6,9
HND-008446,2011,81100018,,,,1,0,1
HND-008447,2011,81100019,,,,1,2,3
HND-008448,2011,81100020,,,,2,1,3
HND-008453,2011,81100025,,,,3,2,5
HND-008460,2011,81100035,,,,9,4,13
HND-008461,2011,81100036,,,,2,0,2
HND-008463,2011,81100038,,,,5,5,10
HND-008464,2011,81100039,,,,6,2,8
HND-008473,2011,81100052,,,,3,2,5
,2011,81100055,,,,7,6,13
HND-008475,2011,81100056,,,,0,5,5
HND-008434,2011,81100005,,,,8,4,12
HND-008438,2011,81100009,,,,0,3,3
HND-008449,2011,81100021,,,,1,1,2
HND-008450,2011,81100022,,,,3,1,4
HND-008451,2011,81100023,,,,1,2,3
HND-008452,2011,81100024,,,,2,4,6
HND-008454,2011,81100027,,,,4,1,5
HND-008457,2011,81100032,,,,13,17,30
HND-008458,2011,81100033,,,,3,0,3
HND-008459,2011,81100034,,,,1,5,6
HND-008462,2011,81100037,,,,3,3,6
HND-008465,2011,81100040,,,,4,2,6
HND-008468,2011,81100043,,,,0,2,2
HND-008469,2011,81100044,,,,3,0,3
HND-008472,2011,81100049,,,,2,2,4
HND-008437,2011,81100008,,,,20,23,43
HND-008440,2011,81100011,,,,4,5,9
HND-008441,2011,81100012,,,,2,3,5
HND-008442,2011,81100013,,,,3,4,7
HND-008448,2011,81100020,,,,4,1,5
HND-008449,2011,81100021,,,,2,3,5
HND-008451,2011,81100023,,,,2,3,5
HND-008452,2011,81100024,,,,1,2,3
HND-008453,2011,81100025,,,,3,4,7
HND-008454,2011,81100027,,,,2,1,3
HND-008457,2011,81100032,,,,6,7,13
HND-008458,2011,81100033,,,,4,2,6
HND-008459,2011,81100034,,,,2,2,4
HND-008460,2011,81100035,,,,4,5,9
HND-008461,2011,81100036,,,,0,1,1
HND-008462,2011,81100037,,,,1,0,1
HND-008463,2011,81100038,,,,3,3,6
HND-008464,2011,81100039,,,,1,2,3
HND-008465,2011,81100040,,,,2,1,3
HND-008469,2011,81100044,,,,2,7,9
HND-008471,2011,81100048,,,,4,1,5
HND-008472,2011,81100049,,,,0,2,2
HND-008434,2011,81100005,,,,2,3,5
HND-008435,2011,81100006,,,,4,2,6
HND-008436,2011,81100007,,,,0,2,2
HND-008438,2011,81100009,,,,0,3,3
HND-008439,2011,81100010,,,,5,3,8
HND-008443,2011,81100014,,,,2,4,6
HND-008444,2011,81100015,,,,2,1,3
HND-008445,2011,81100016,,,,2,3,5
HND-008446,2011,81100018,,,,0,1,1
HND-008447,2011,81100019,,,,0,4,4
HND-008466,2011,81100041,,,,1,1,2
HND-008468,2011,81100043,,,,0,3,3
HND-008475,2011,81100056,,,,1,0,1
HND-008457,2011,81100032,,,,7,16,23
HND-008435,2011,81100006,,,,2,0,2
HND-008467,2011,81100042,,,,44,43,87
HND-008457,2011,81100032,,,,3,10,13
HND-008467,2011,81100042,,,,28,24,52
HND-008467,2011,81100042,,,,14,25,39
HND-008457,2011,81100032,,,,6,6,12
HND-008467,2011,81100042,,,,15,21,36
HND-008467,2011,81100042,,,,11,16,27
HND-008467,2011,81100042,,,,7,10,17
HND-008484,2011,81200003,,,,2,3,5
HND-008496,2011,81200027,,,,3,3,6
HND-008485,2011,81200005,,,,5,1,6
,2011,81200022,,,,1,4,5
,2011,81200023,,,,2,4,6
,2011,81200024,,,,4,7,11
,2011,81200025,,,,3,2,5
,2011,81200028,,,,4,5,9
,2011,81200029,,,,4,1,5
HND-008494,2011,81200014,,,,4,1,5
HND-008494,2011,81200014,,,,9,6,15
HND-008482,2011,81200001,,,,1,2,3
HND-008484,2011,81200003,,,,2,2,4
,2011,81200004,,,,2,0,2
HND-008485,2011,81200005,,,,2,0,2
HND-008486,2011,81200006,,,,1,4,5
HND-008487,2011,81200007,,,,1,0,1
HND-008488,2011,81200008,,,,1,1,2
HND-008490,2011,81200010,,,,2,1,3
HND-008483,2011,81200002,,,,10,12,22
HND-008491,2011,81200011,,,,0,1,1
HND-008492,2011,81200012,,,,2,3,5
HND-008493,2011,81200013,,,,1,3,4
HND-008482,2011,81200001,,,,0,1,1
HND-008483,2011,81200002,,,,15,12,27
HND-008484,2011,81200003,,,,1,0,1
HND-008487,2011,81200007,,,,4,0,4
HND-008490,2011,81200010,,,,0,1,1
HND-008491,2011,81200011,,,,2,1,3
HND-008492,2011,81200012,,,,0,1,1
HND-008493,2011,81200013,,,,2,1,3
,2011,81200004,,,,0,2,2
HND-008485,2011,81200005,,,,2,5,7
HND-008486,2011,81200006,,,,2,3,5
HND-008488,2011,81200008,,,,7,2,9
HND-008489,2011,81200009,,,,1,0,1
HND-008483,2011,81200002,,,,11,7,18
HND-008485,2011,81200005,,,,0,2,2
HND-008489,2011,81200009,,,,4,1,5
HND-008491,2011,81200011,,,,4,3,7
HND-008493,2011,81200013,,,,2,2,4
HND-008482,2011,81200001,,,,1,1,2
HND-008484,2011,81200003,,,,0,1,1
,2011,81200004,,,,1,0,1
HND-008486,2011,81200006,,,,3,2,5
HND-008487,2011,81200007,,,,0,1,1
HND-008488,2011,81200008,,,,3,1,4
HND-008490,2011,81200010,,,,2,0,2
HND-008492,2011,81200012,,,,2,3,5
HND-008482,2011,81200001,,,,1,1,2
HND-008483,2011,81200002,,,,6,11,17
HND-008492,2011,81200012,,,,1,2,3
HND-008486,2011,81200006,,,,5,3,8
HND-008487,2011,81200007,,,,0,1,1
HND-008488,2011,81200008,,,,1,6,7
HND-008489,2011,81200009,,,,1,1,2
HND-008490,2011,81200010,,,,0,2,2
HND-008483,2011,81200002,,,,10,9,19
HND-008489,2011,81200009,,,,1,0,1
HND-008492,2011,81200012,,,,2,1,3
HND-008482,2011,81200001,,,,0,3,3
HND-008484,2011,81200003,,,,1,2,3
,2011,81200004,,,,2,3,5
HND-008485,2011,81200005,,,,5,0,5
HND-008486,2011,81200006,,,,4,4,8
HND-008487,2011,81200007,,,,3,2,5
HND-008488,2011,81200008,,,,2,4,6
HND-008490,2011,81200010,,,,2,0,2
,2011,81200004,,,,1,2,3
HND-008485,2011,81200005,,,,0,1,1
HND-008486,2011,81200006,,,,2,2,4
HND-008488,2011,81200008,,,,3,0,3
HND-008489,2011,81200009,,,,1,0,1
HND-008483,2011,81200002,,,,12,8,20
HND-008484,2011,81200003,,,,5,1,6
HND-008487,2011,81200007,,,,1,0,1
HND-008490,2011,81200010,,,,0,2,2
HND-008492,2011,81200012,,,,0,3,3
HND-008495,2011,81200015,,,,14,22,36
HND-008495,2011,81200015,,,,14,25,39
HND-008495,2011,81200015,,,,16,11,27
HND-008495,2011,81200015,,,,7,19,26
HND-008495,2011,81200015,,,,6,13,19
HND-008495,2011,81200015,,,,11,14,25
,2011,81300029,,,,11,8,19
,2011,81300042,,,,2,4,6
HND-008525,2011,81300044,,,,7,8,15
,2011,81300046,,,,5,6,11
HND-008527,2011,81300047,,,,2,5,7
,2011,81300051,,,,3,3,6
,2011,81300053,,,,8,6,14
,2011,81300057,,,,3,3,6
,2011,81300060,,,,3,2,5
HND-008528,2011,81300061,,,,6,5,11
,2011,81300062,,,,5,1,6
,2011,81300063,,,,3,6,9
,2011,81300065,,,,5,4,9
HND-008529,2011,81300066,,,,4,4,8
,2011,81300067,,,,1,4,5
,2011,81300068,,,,4,2,6
,2011,81300069,,,,4,4,8
,2011,81300071,,,,2,3,5
HND-008519,2011,81300028,,,,5,3,8
HND-008526,2011,81300045,,,,8,7,15
,2011,81300048,,,,4,2,6
,2011,81300049,,,,1,8,9
,2011,81300050,,,,5,2,7
,2011,81300052,,,,2,5,7
,2011,81300055,,,,4,5,9
,2011,81300056,,,,6,2,8
,2011,81300058,,,,3,3,6
,2011,81300059,,,,1,2,3
,2011,81300070,,,,1,4,5
,2011,81300024,,,,5,9,14
,2011,81300054,,,,1,2,3
,2011,81300064,,,,3,2,5
HND-008515,2011,81300019,,,,5,3,8
HND-008516,2011,81300020,,,,0,1,1
,2011,81300024,,,,8,4,12
,2011,81300054,,,,2,3,5
,2011,81300064,,,,2,2,4
HND-008515,2011,81300019,,,,20,25,45
HND-008516,2011,81300020,,,,16,9,25
,2011,81300024,,,,6,7,13
,2011,81300026,,,,10,10,20
,2011,81300054,,,,2,0,2
,2011,81300064,,,,1,2,3
HND-008498,2011,81300002,,,,51,56,107
HND-008505,2011,81300009,,,,2,2,4
HND-008506,2011,81300010,,,,6,2,8
HND-008507,2011,81300011,,,,5,1,6
HND-008508,2011,81300012,,,,8,5,13
HND-008509,2011,81300013,,,,5,2,7
HND-008510,2011,81300014,,,,13,11,24
HND-008511,2011,81300015,,,,2,1,3
HND-008512,2011,81300016,,,,6,6,12
HND-008513,2011,81300017,,,,4,3,7
HND-008514,2011,81300018,,,,2,1,3
HND-008518,2011,81300025,,,,3,3,6
HND-008520,2011,81300036,,,,4,4,8
HND-008522,2011,81300038,,,,2,6,8
HND-008523,2011,81300039,,,,1,3,4
HND-008499,2011,81300003,,,,11,11,22
HND-008500,2011,81300004,,,,9,2,11
HND-008501,2011,81300005,,,,6,8,14
HND-008502,2011,81300006,,,,2,1,3
HND-008504,2011,81300008,,,,4,4,8
HND-008517,2011,81300021,,,,6,3,9
HND-008521,2011,81300037,,,,3,7,10
HND-008524,2011,81300040,,,,3,3,6
HND-008498,2011,81300002,,,,49,47,96
HND-008499,2011,81300003,,,,12,10,22
HND-008503,2011,81300007,,,,3,0,3
HND-008506,2011,81300010,,,,3,0,3
HND-008511,2011,81300015,,,,1,3,4
HND-008514,2011,81300018,,,,6,5,11
HND-008500,2011,81300004,,,,3,2,5
HND-008501,2011,81300005,,,,4,3,7
HND-008502,2011,81300006,,,,6,5,11
HND-008504,2011,81300008,,,,2,4,6
HND-008505,2011,81300009,,,,0,3,3
HND-008507,2011,81300011,,,,4,1,5
HND-008508,2011,81300012,,,,5,3,8
HND-008509,2011,81300013,,,,5,5,10
HND-008510,2011,81300014,,,,12,9,21
HND-008512,2011,81300016,,,,6,8,14
HND-008513,2011,81300017,,,,4,2,6
HND-008517,2011,81300021,,,,6,5,11
HND-008518,2011,81300025,,,,3,2,5
HND-008520,2011,81300036,,,,2,3,5
HND-008521,2011,81300037,,,,7,5,12
HND-008522,2011,81300038,,,,7,5,12
HND-008523,2011,81300039,,,,1,2,3
HND-008524,2011,81300040,,,,3,4,7
HND-008499,2011,81300003,,,,4,5,9
HND-008500,2011,81300004,,,,3,5,8
HND-008501,2011,81300005,,,,2,5,7
HND-008502,2011,81300006,,,,6,7,13
HND-008503,2011,81300007,,,,0,3,3
HND-008504,2011,81300008,,,,4,6,10
HND-008517,2011,81300021,,,,4,5,9
HND-008521,2011,81300037,,,,4,3,7
HND-008524,2011,81300040,,,,3,6,9
HND-008498,2011,81300002,,,,46,52,98
HND-008505,2011,81300009,,,,4,4,8
HND-008506,2011,81300010,,,,3,1,4
HND-008507,2011,81300011,,,,1,4,5
HND-008508,2011,81300012,,,,8,7,15
HND-008509,2011,81300013,,,,2,3,5
HND-008510,2011,81300014,,,,6,13,19
HND-008512,2011,81300016,,,,6,10,16
HND-008513,2011,81300017,,,,7,2,9
HND-008514,2011,81300018,,,,1,3,4
HND-008518,2011,81300025,,,,2,0,2
HND-008520,2011,81300036,,,,6,0,6
HND-008522,2011,81300038,,,,2,4,6
HND-008523,2011,81300039,,,,1,6,7
HND-008498,2011,81300002,,,,51,53,104
HND-008503,2011,81300007,,,,1,0,1
HND-008506,2011,81300010,,,,2,3,5
HND-008510,2011,81300014,,,,8,6,14
HND-008511,2011,81300015,,,,1,1,2
HND-008512,2011,81300016,,,,9,8,17
HND-008514,2011,81300018,,,,5,2,7
HND-008518,2011,81300025,,,,0,2,2
HND-008523,2011,81300039,,,,3,5,8
HND-008499,2011,81300003,,,,7,5,12
HND-008500,2011,81300004,,,,6,3,9
HND-008501,2011,81300005,,,,3,9,12
HND-008502,2011,81300006,,,,0,4,4
HND-008504,2011,81300008,,,,1,7,8
HND-008505,2011,81300009,,,,2,2,4
HND-008507,2011,81300011,,,,2,3,5
HND-008508,2011,81300012,,,,6,5,11
HND-008509,2011,81300013,,,,2,2,4
HND-008513,2011,81300017,,,,4,2,6
HND-008517,2011,81300021,,,,1,2,3
HND-008520,2011,81300036,,,,1,1,2
HND-008521,2011,81300037,,,,5,2,7
HND-008522,2011,81300038,,,,4,3,7
HND-008524,2011,81300040,,,,2,2,4
HND-008498,2011,81300002,,,,50,44,94
HND-008506,2011,81300010,,,,2,0,2
HND-008508,2011,81300012,,,,6,0,6
HND-008510,2011,81300014,,,,6,9,15
HND-008511,2011,81300015,,,,2,1,3
HND-008512,2011,81300016,,,,3,6,9
HND-008514,2011,81300018,,,,3,6,9
HND-008518,2011,81300025,,,,1,2,3
HND-008522,2011,81300038,,,,1,4,5
HND-008499,2011,81300003,,,,7,7,14
HND-008500,2011,81300004,,,,5,4,9
HND-008501,2011,81300005,,,,2,0,2
HND-008502,2011,81300006,,,,1,2,3
HND-008503,2011,81300007,,,,5,1,6
HND-008504,2011,81300008,,,,5,6,11
HND-008505,2011,81300009,,,,2,1,3
HND-008507,2011,81300011,,,,5,1,6
HND-008509,2011,81300013,,,,3,0,3
HND-008513,2011,81300017,,,,6,2,8
HND-008517,2011,81300021,,,,2,0,2
HND-008520,2011,81300036,,,,5,0,5
HND-008521,2011,81300037,,,,4,2,6
HND-008524,2011,81300040,,,,3,4,7
HND-008500,2011,81300004,,,,3,3,6
HND-008501,2011,81300005,,,,2,2,4
HND-008502,2011,81300006,,,,5,1,6
HND-008504,2011,81300008,,,,4,8,12
HND-008505,2011,81300009,,,,2,1,3
HND-008507,2011,81300011,,,,2,3,5
HND-008508,2011,81300012,,,,2,3,5
HND-008509,2011,81300013,,,,5,3,8
HND-008510,2011,81300014,,,,12,12,24
HND-008512,2011,81300016,,,,4,9,13
HND-008513,2011,81300017,,,,0,1,1
HND-008517,2011,81300021,,,,1,1,2
HND-008518,2011,81300025,,,,0,4,4
HND-008520,2011,81300036,,,,0,2,2
HND-008521,2011,81300037,,,,4,1,5
HND-008522,2011,81300038,,,,2,1,3
HND-008523,2011,81300039,,,,1,3,4
HND-008524,2011,81300040,,,,1,1,2
HND-008498,2011,81300002,,,,45,52,97
HND-008499,2011,81300003,,,,4,7,11
HND-008503,2011,81300007,,,,2,0,2
HND-008506,2011,81300010,,,,4,1,5
HND-008511,2011,81300015,,,,2,1,3
HND-008514,2011,81300018,,,,5,1,6
HND-008510,2011,81300014,,,,3,12,15
HND-008497,2011,81300001,,,,62,52,114
,2011,81300026,,,,74,81,155
HND-008497,2011,81300001,,,,39,35,74
HND-008510,2011,81300014,,,,8,11,19
,2011,81300026,,,,59,66,125
HND-008497,2011,81300001,,,,40,42,82
,2011,81300026,,,,39,37,76
HND-008510,2011,81300014,,,,5,12,17
HND-008497,2011,81300001,,,,14,14,28
,2011,81300026,,,,38,37,75
HND-008497,2011,81300001,,,,9,24,33
HND-008497,2011,81300001,,,,5,13,18
HND-008547,2011,81400018,,,,8,4,12
HND-008575,2011,81400054,,,,3,2,5
HND-008576,2011,81400058,,,,4,4,8
HND-008582,2011,81400086,,,,11,13,24
HND-008585,2011,81400096,,,,11,6,17
,2011,81400107,,,,10,9,19
HND-008593,2011,81400113,,,,6,8,14
,2011,81400057,,,,10,8,18
,2011,81400091,,,,3,2,5
HND-008584,2011,81400093,,,,6,3,9
,2011,81400094,,,,8,7,15
,2011,81400101,,,,3,5,8
,2011,81400102,,,,4,1,5
HND-008587,2011,81400103,,,,2,3,5
HND-008588,2011,81400104,,,,6,9,15
,2011,81400105,,,,4,2,6
,2011,81400106,,,,2,4,6
HND-008558,2011,81400029,,,,0,2,2
,2011,81400039,,,,0,1,1
,2011,81400099,,,,5,2,7
,2011,81400100,,,,3,3,6
,2011,81400112,,,,4,3,7
,2011,81400032,,,,1,3,4
HND-008560,2011,81400033,,,,2,5,7
,2011,81400073,,,,4,5,9
,2011,81400109,,,,3,2,5
HND-008590,2011,81400110,,,,4,5,9
,2011,81400001,,,,9,5,14
HND-008558,2011,81400029,,,,4,6,10
HND-008560,2011,81400033,,,,1,3,4
HND-008564,2011,81400037,,,,4,5,9
,2011,81400073,,,,7,3,10
HND-008583,2011,81400088,,,,7,5,12
,2011,81400095,,,,4,5,9
,2011,81400099,,,,2,1,3
HND-008590,2011,81400110,,,,1,0,1
,2011,81400112,,,,0,4,4
HND-008555,2011,81400026,,,,3,2,5
,2011,81400032,,,,4,5,9
,2011,81400039,,,,1,0,1
HND-008566,2011,81400040,,,,1,1,2
,2011,81400100,,,,2,2,4
,2011,81400109,,,,2,1,3
HND-008558,2011,81400029,,,,5,2,7
HND-008560,2011,81400033,,,,4,3,7
HND-008564,2011,81400037,,,,10,7,17
,2011,81400039,,,,8,8,16
HND-008566,2011,81400040,,,,6,7,13
,2011,81400109,,,,4,4,8
HND-008555,2011,81400026,,,,29,35,64
,2011,81400073,,,,5,3,8
HND-008583,2011,81400088,,,,1,3,4
,2011,81400095,,,,3,7,10
,2011,81400099,,,,4,4,8
,2011,81400100,,,,5,4,9
HND-008590,2011,81400110,,,,2,2,4
HND-008591,2011,81400111,,,,14,14,28
,2011,81400112,,,,3,6,9
HND-008532,2011,81400003,,,,4,1,5
HND-008533,2011,81400004,,,,22,23,45
HND-008535,2011,81400006,,,,8,8,16
HND-008536,2011,81400007,,,,1,0,1
HND-008540,2011,81400011,,,,4,9,13
HND-008541,2011,81400012,,,,7,6,13
HND-008542,2011,81400013,,,,7,10,17
HND-008543,2011,81400014,,,,4,4,8
HND-008546,2011,81400017,,,,11,6,17
HND-008567,2011,81400041,,,,6,8,14
,2011,81400043,,,,3,1,4
HND-008569,2011,81400044,,,,2,1,3
HND-008570,2011,81400046,,,,4,2,6
HND-008572,2011,81400050,,,,7,4,11
,2011,81400069,,,,3,3,6
HND-008579,2011,81400080,,,,3,1,4
HND-008581,2011,81400084,,,,6,1,7
HND-008531,2011,81400002,,,,36,29,65
HND-008534,2011,81400005,,,,17,14,31
HND-008537,2011,81400008,,,,0,4,4
HND-008538,2011,81400009,,,,8,8,16
HND-008539,2011,81400010,,,,6,7,13
HND-008544,2011,81400015,,,,9,5,14
HND-008545,2011,81400016,,,,3,6,9
HND-008547,2011,81400018,,,,9,5,14
HND-008548,2011,81400019,,,,1,2,3
HND-008549,2011,81400020,,,,8,6,14
HND-008550,2011,81400021,,,,7,2,9
HND-008551,2011,81400022,,,,2,3,5
HND-008552,2011,81400023,,,,3,2,5
HND-008553,2011,81400024,,,,17,10,27
,2011,81400025,,,,4,2,6
,2011,81400034,,,,8,11,19
,2011,81400035,,,,6,9,15
HND-008563,2011,81400036,,,,2,2,4
,2011,81400038,,,,1,5,6
HND-008571,2011,81400049,,,,6,5,11
HND-008573,2011,81400051,,,,4,2,6
HND-008580,2011,81400083,,,,4,2,6
HND-008531,2011,81400002,,,,29,40,69
HND-008532,2011,81400003,,,,3,3,6
HND-008536,2011,81400007,,,,2,2,4
HND-008540,2011,81400011,,,,7,6,13
HND-008549,2011,81400020,,,,6,4,10
,2011,81400025,,,,3,5,8
,2011,81400034,,,,4,3,7
,2011,81400035,,,,1,4,5
HND-008563,2011,81400036,,,,0,4,4
,2011,81400038,,,,1,0,1
HND-008569,2011,81400044,,,,3,3,6
HND-008570,2011,81400046,,,,3,2,5
HND-008571,2011,81400049,,,,4,7,11
HND-008573,2011,81400051,,,,0,3,3
,2011,81400068,,,,0,1,1
,2011,81400069,,,,2,3,5
HND-008533,2011,81400004,,,,14,22,36
HND-008534,2011,81400005,,,,15,16,31
HND-008535,2011,81400006,,,,12,15,27
HND-008537,2011,81400008,,,,5,4,9
HND-008538,2011,81400009,,,,8,17,25
HND-008539,2011,81400010,,,,3,3,6
HND-008541,2011,81400012,,,,4,3,7
HND-008542,2011,81400013,,,,7,6,13
HND-008543,2011,81400014,,,,1,8,9
HND-008544,2011,81400015,,,,3,8,11
HND-008545,2011,81400016,,,,2,0,2
HND-008546,2011,81400017,,,,8,1,9
HND-008547,2011,81400018,,,,7,5,12
HND-008548,2011,81400019,,,,5,3,8
HND-008550,2011,81400021,,,,1,3,4
HND-008551,2011,81400022,,,,3,6,9
HND-008552,2011,81400023,,,,4,4,8
HND-008553,2011,81400024,,,,4,2,6
HND-008567,2011,81400041,,,,8,10,18
,2011,81400043,,,,5,0,5
HND-008572,2011,81400050,,,,5,1,6
,2011,81400053,,,,3,3,6
HND-008579,2011,81400080,,,,2,0,2
HND-008580,2011,81400083,,,,2,0,2
HND-008581,2011,81400084,,,,0,1,1
HND-008531,2011,81400002,,,,23,40,63
HND-008532,2011,81400003,,,,4,3,7
HND-008533,2011,81400004,,,,20,13,33
HND-008535,2011,81400006,,,,9,7,16
HND-008536,2011,81400007,,,,1,4,5
HND-008540,2011,81400011,,,,7,7,14
HND-008541,2011,81400012,,,,5,10,15
HND-008542,2011,81400013,,,,12,9,21
HND-008546,2011,81400017,,,,4,5,9
,2011,81400034,,,,2,4,6
,2011,81400035,,,,6,3,9
,2011,81400038,,,,3,0,3
HND-008571,2011,81400049,,,,1,4,5
HND-008573,2011,81400051,,,,4,0,4
,2011,81400053,,,,7,1,8
,2011,81400068,,,,1,2,3
,2011,81400069,,,,1,3,4
HND-008580,2011,81400083,,,,1,2,3
HND-008534,2011,81400005,,,,20,15,35
HND-008537,2011,81400008,,,,8,7,15
HND-008538,2011,81400009,,,,10,11,21
HND-008539,2011,81400010,,,,2,3,5
HND-008543,2011,81400014,,,,1,2,3
HND-008544,2011,81400015,,,,4,3,7
HND-008545,2011,81400016,,,,1,3,4
HND-008547,2011,81400018,,,,4,6,10
HND-008548,2011,81400019,,,,1,2,3
HND-008549,2011,81400020,,,,0,9,9
HND-008550,2011,81400021,,,,6,6,12
HND-008551,2011,81400022,,,,4,4,8
HND-008552,2011,81400023,,,,2,2,4
HND-008553,2011,81400024,,,,1,4,5
,2011,81400025,,,,2,2,4
HND-008567,2011,81400041,,,,4,14,18
,2011,81400043,,,,5,3,8
HND-008569,2011,81400044,,,,3,1,4
HND-008570,2011,81400046,,,,4,2,6
HND-008572,2011,81400050,,,,1,1,2
HND-008579,2011,81400080,,,,3,4,7
HND-008581,2011,81400084,,,,1,0,1
HND-008531,2011,81400002,,,,41,37,78
HND-008548,2011,81400019,,,,1,1,2
HND-008549,2011,81400020,,,,6,8,14
HND-008551,2011,81400022,,,,2,0,2
HND-008553,2011,81400024,,,,1,2,3
,2011,81400025,,,,2,0,2
,2011,81400034,,,,1,0,1
,2011,81400035,,,,0,4,4
HND-008563,2011,81400036,,,,3,2,5
,2011,81400038,,,,2,2,4
HND-008567,2011,81400041,,,,1,2,3
,2011,81400043,,,,5,3,8
HND-008570,2011,81400046,,,,5,1,6
HND-008571,2011,81400049,,,,7,3,10
,2011,81400068,,,,4,1,5
HND-008579,2011,81400080,,,,5,1,6
HND-008532,2011,81400003,,,,6,5,11
HND-008533,2011,81400004,,,,16,16,32
HND-008534,2011,81400005,,,,18,15,33
HND-008535,2011,81400006,,,,14,10,24
HND-008536,2011,81400007,,,,4,1,5
HND-008537,2011,81400008,,,,4,9,13
HND-008538,2011,81400009,,,,14,5,19
HND-008539,2011,81400010,,,,15,8,23
HND-008540,2011,81400011,,,,8,2,10
HND-008541,2011,81400012,,,,2,4,6
HND-008542,2011,81400013,,,,8,14,22
HND-008543,2011,81400014,,,,3,3,6
HND-008544,2011,81400015,,,,9,3,12
HND-008545,2011,81400016,,,,3,3,6
HND-008546,2011,81400017,,,,1,3,4
HND-008547,2011,81400018,,,,4,7,11
HND-008550,2011,81400021,,,,10,4,14
HND-008552,2011,81400023,,,,3,3,6
HND-008572,2011,81400050,,,,1,1,2
HND-008573,2011,81400051,,,,3,3,6
HND-008580,2011,81400083,,,,0,1,1
HND-008581,2011,81400084,,,,4,5,9
HND-008531,2011,81400002,,,,36,28,64
HND-008538,2011,81400009,,,,7,6,13
HND-008539,2011,81400010,,,,4,3,7
HND-008544,2011,81400015,,,,7,3,10
HND-008547,2011,81400018,,,,7,5,12
HND-008548,2011,81400019,,,,0,3,3
HND-008549,2011,81400020,,,,6,2,8
HND-008552,2011,81400023,,,,2,0,2
HND-008553,2011,81400024,,,,4,3,7
,2011,81400025,,,,4,4,8
,2011,81400034,,,,1,0,1
HND-008563,2011,81400036,,,,2,1,3
HND-008567,2011,81400041,,,,2,0,2
,2011,81400043,,,,1,6,7
HND-008569,2011,81400044,,,,3,1,4
HND-008570,2011,81400046,,,,1,0,1
HND-008572,2011,81400050,,,,3,3,6
,2011,81400068,,,,1,5,6
HND-008579,2011,81400080,,,,2,2,4
HND-008532,2011,81400003,,,,4,1,5
HND-008533,2011,81400004,,,,11,14,25
HND-008534,2011,81400005,,,,22,31,53
HND-008535,2011,81400006,,,,18,11,29
HND-008536,2011,81400007,,,,3,2,5
HND-008537,2011,81400008,,,,2,6,8
HND-008540,2011,81400011,,,,0,2,2
HND-008541,2011,81400012,,,,1,10,11
HND-008542,2011,81400013,,,,10,9,19
HND-008543,2011,81400014,,,,2,3,5
HND-008545,2011,81400016,,,,3,4,7
HND-008546,2011,81400017,,,,1,7,8
HND-008550,2011,81400021,,,,5,4,9
,2011,81400035,,,,1,3,4
,2011,81400038,,,,0,3,3
HND-008571,2011,81400049,,,,3,6,9
HND-008573,2011,81400051,,,,4,3,7
HND-008580,2011,81400083,,,,2,0,2
HND-008533,2011,81400004,,,,21,26,47
HND-008534,2011,81400005,,,,16,23,39
HND-008535,2011,81400006,,,,7,11,18
HND-008537,2011,81400008,,,,3,5,8
HND-008538,2011,81400009,,,,6,8,14
HND-008539,2011,81400010,,,,6,5,11
HND-008541,2011,81400012,,,,5,5,10
HND-008542,2011,81400013,,,,10,12,22
HND-008543,2011,81400014,,,,2,4,6
HND-008544,2011,81400015,,,,3,3,6
HND-008545,2011,81400016,,,,6,2,8
HND-008547,2011,81400018,,,,5,5,10
HND-008548,2011,81400019,,,,1,3,4
HND-008550,2011,81400021,,,,4,5,9
HND-008551,2011,81400022,,,,2,2,4
HND-008552,2011,81400023,,,,4,1,5
HND-008567,2011,81400041,,,,9,9,18
,2011,81400043,,,,0,4,4
HND-008579,2011,81400080,,,,4,3,7
HND-008580,2011,81400083,,,,1,0,1
HND-008531,2011,81400002,,,,36,39,75
HND-008532,2011,81400003,,,,1,1,2
HND-008536,2011,81400007,,,,2,1,3
HND-008540,2011,81400011,,,,4,5,9
HND-008546,2011,81400017,,,,1,0,1
HND-008549,2011,81400020,,,,4,7,11
,2011,81400025,,,,1,5,6
,2011,81400034,,,,1,1,2
,2011,81400035,,,,0,3,3
HND-008563,2011,81400036,,,,2,0,2
,2011,81400038,,,,1,1,2
HND-008569,2011,81400044,,,,1,2,3
HND-008571,2011,81400049,,,,3,1,4
HND-008573,2011,81400051,,,,5,4,9
,2011,81400069,,,,1,1,2
HND-008534,2011,81400005,,,,21,22,43
HND-008549,2011,81400020,,,,13,13,26
HND-008556,2011,81400027,,,,46,48,94
HND-008535,2011,81400006,,,,20,11,31
HND-008557,2011,81400028,,,,32,40,72
HND-008549,2011,81400020,,,,10,15,25
HND-008557,2011,81400028,,,,20,31,51
HND-008534,2011,81400005,,,,10,34,44
HND-008535,2011,81400006,,,,20,9,29
HND-008556,2011,81400027,,,,25,30,55
HND-008549,2011,81400020,,,,6,17,23
HND-008556,2011,81400027,,,,17,35,52
HND-008557,2011,81400028,,,,16,16,32
HND-008534,2011,81400005,,,,13,7,20
HND-008535,2011,81400006,,,,4,9,13
HND-008595,2011,81500002,,,,5,10,15
HND-008626,2011,81500041,,,,5,5,10
HND-008627,2011,81500042,,,,4,5,9
HND-008628,2011,81500044,,,,8,9,17
HND-008630,2011,81500046,,,,8,10,18
HND-008632,2011,81500050,,,,3,6,9
HND-008636,2011,81500054,,,,1,4,5
HND-008637,2011,81500062,,,,7,3,10
,2011,81500065,,,,5,3,8
HND-008640,2011,81500068,,,,13,6,19
,2011,81500069,,,,10,2,12
,2011,81500033,,,,5,5,10
,2011,81500034,,,,13,10,23
HND-008624,2011,81500038,,,,6,11,17
,2011,81500040,,,,5,6,11
HND-008629,2011,81500045,,,,3,2,5
HND-008631,2011,81500048,,,,6,5,11
HND-008634,2011,81500052,,,,5,6,11
HND-008638,2011,81500063,,,,6,6,12
HND-008642,2011,81500070,,,,2,2,4
,2011,81500071,,,,5,6,11
HND-008643,2011,81500072,,,,8,3,11
HND-008644,2011,81500074,,,,5,4,9
,2011,81500075,,,,10,8,18
,2011,81500076,,,,2,8,10
,2011,81500077,,,,4,1,5
HND-008622,2011,81500035,,,,6,6,12
HND-008635,2011,81500053,,,,3,6,9
HND-008622,2011,81500035,,,,15,13,28
HND-008635,2011,81500053,,,,9,4,13
HND-008598,2011,81500005,,,,8,5,13
HND-008601,2011,81500009,,,,5,2,7
HND-008603,2011,81500011,,,,13,8,21
HND-008605,2011,81500013,,,,2,4,6
HND-008607,2011,81500015,,,,34,36,70
HND-008609,2011,81500017,,,,11,7,18
HND-008613,2011,81500021,,,,4,2,6
HND-008614,2011,81500022,,,,4,2,6
HND-008615,2011,81500023,,,,4,0,4
HND-008616,2011,81500024,,,,2,2,4
HND-008618,2011,81500026,,,,10,7,17
HND-008619,2011,81500027,,,,8,5,13
HND-008625,2011,81500039,,,,1,5,6
HND-008633,2011,81500051,,,,5,5,10
HND-008634,2011,81500052,,,,12,14,26
HND-008596,2011,81500003,,,,14,8,22
HND-008597,2011,81500004,,,,16,20,36
HND-008599,2011,81500006,,,,4,4,8
HND-008600,2011,81500008,,,,4,5,9
HND-008602,2011,81500010,,,,8,5,13
HND-008604,2011,81500012,,,,0,1,1
HND-008606,2011,81500014,,,,14,10,24
HND-008608,2011,81500016,,,,7,1,8
HND-008610,2011,81500018,,,,4,5,9
HND-008611,2011,81500019,,,,4,3,7
HND-008612,2011,81500020,,,,9,7,16
HND-008617,2011,81500025,,,,11,4,15
HND-008620,2011,81500028,,,,2,5,7
HND-008621,2011,81500029,,,,3,0,3
HND-008623,2011,81500037,,,,8,0,8
HND-008596,2011,81500003,,,,5,4,9
HND-008602,2011,81500010,,,,7,7,14
HND-008603,2011,81500011,,,,12,9,21
HND-008604,2011,81500012,,,,3,4,7
HND-008605,2011,81500013,,,,4,3,7
HND-008606,2011,81500014,,,,12,8,20
HND-008607,2011,81500015,,,,26,19,45
HND-008608,2011,81500016,,,,2,4,6
HND-008609,2011,81500017,,,,9,9,18
HND-008610,2011,81500018,,,,4,2,6
HND-008612,2011,81500020,,,,9,5,14
HND-008614,2011,81500022,,,,5,2,7
HND-008616,2011,81500024,,,,1,9,10
HND-008617,2011,81500025,,,,8,7,15
HND-008618,2011,81500026,,,,9,8,17
HND-008620,2011,81500028,,,,4,2,6
HND-008621,2011,81500029,,,,2,1,3
HND-008625,2011,81500039,,,,5,8,13
HND-008597,2011,81500004,,,,20,8,28
HND-008598,2011,81500005,,,,12,6,18
HND-008599,2011,81500006,,,,5,2,7
HND-008600,2011,81500008,,,,5,6,11
HND-008601,2011,81500009,,,,3,3,6
HND-008611,2011,81500019,,,,3,2,5
HND-008613,2011,81500021,,,,2,3,5
HND-008615,2011,81500023,,,,2,3,5
HND-008619,2011,81500027,,,,5,0,5
HND-008623,2011,81500037,,,,2,5,7
HND-008633,2011,81500051,,,,2,4,6
HND-008634,2011,81500052,,,,13,6,19
HND-008596,2011,81500003,,,,4,4,8
HND-008597,2011,81500004,,,,9,13,22
HND-008599,2011,81500006,,,,1,5,6
HND-008602,2011,81500010,,,,4,5,9
HND-008604,2011,81500012,,,,1,2,3
HND-008606,2011,81500014,,,,12,12,24
HND-008608,2011,81500016,,,,4,4,8
HND-008610,2011,81500018,,,,2,3,5
HND-008611,2011,81500019,,,,6,4,10
HND-008612,2011,81500020,,,,7,12,19
HND-008617,2011,81500025,,,,17,11,28
HND-008620,2011,81500028,,,,1,4,5
HND-008621,2011,81500029,,,,1,0,1
HND-008623,2011,81500037,,,,3,3,6
HND-008598,2011,81500005,,,,7,5,12
HND-008600,2011,81500008,,,,5,11,16
HND-008601,2011,81500009,,,,2,2,4
HND-008603,2011,81500011,,,,10,13,23
HND-008605,2011,81500013,,,,3,3,6
HND-008607,2011,81500015,,,,24,28,52
HND-008609,2011,81500017,,,,4,4,8
HND-008613,2011,81500021,,,,6,5,11
HND-008614,2011,81500022,,,,6,4,10
HND-008615,2011,81500023,,,,0,2,2
HND-008616,2011,81500024,,,,2,2,4
HND-008618,2011,81500026,,,,10,7,17
HND-008619,2011,81500027,,,,7,8,15
HND-008625,2011,81500039,,,,11,8,19
HND-008633,2011,81500051,,,,5,0,5
HND-008634,2011,81500052,,,,16,9,25
HND-008597,2011,81500004,,,,7,11,18
HND-008598,2011,81500005,,,,1,10,11
HND-008599,2011,81500006,,,,1,2,3
HND-008600,2011,81500008,,,,6,6,12
HND-008601,2011,81500009,,,,6,2,8
HND-008603,2011,81500011,,,,20,8,28
HND-008604,2011,81500012,,,,3,0,3
HND-008605,2011,81500013,,,,2,3,5
HND-008610,2011,81500018,,,,5,5,10
HND-008611,2011,81500019,,,,3,4,7
HND-008612,2011,81500020,,,,10,7,17
HND-008613,2011,81500021,,,,7,6,13
HND-008614,2011,81500022,,,,2,4,6
HND-008615,2011,81500023,,,,1,2,3
HND-008625,2011,81500039,,,,5,7,12
HND-008634,2011,81500052,,,,5,6,11
HND-008596,2011,81500003,,,,11,13,24
HND-008602,2011,81500010,,,,6,5,11
HND-008606,2011,81500014,,,,6,8,14
HND-008607,2011,81500015,,,,31,25,56
HND-008608,2011,81500016,,,,3,2,5
HND-008609,2011,81500017,,,,7,7,14
HND-008616,2011,81500024,,,,4,7,11
HND-008617,2011,81500025,,,,9,6,15
HND-008618,2011,81500026,,,,10,5,15
HND-008619,2011,81500027,,,,10,7,17
HND-008620,2011,81500028,,,,3,1,4
HND-008621,2011,81500029,,,,1,2,3
HND-008623,2011,81500037,,,,3,0,3
HND-008633,2011,81500051,,,,2,1,3
HND-008596,2011,81500003,,,,7,9,16
HND-008597,2011,81500004,,,,3,6,9
HND-008598,2011,81500005,,,,1,5,6
HND-008599,2011,81500006,,,,3,2,5
HND-008600,2011,81500008,,,,7,11,18
HND-008602,2011,81500010,,,,6,4,10
HND-008606,2011,81500014,,,,4,8,12
HND-008608,2011,81500016,,,,2,1,3
HND-008610,2011,81500018,,,,5,5,10
HND-008611,2011,81500019,,,,0,3,3
HND-008621,2011,81500029,,,,1,2,3
HND-008625,2011,81500039,,,,10,10,20
HND-008633,2011,81500051,,,,3,4,7
HND-008634,2011,81500052,,,,2,5,7
HND-008601,2011,81500009,,,,3,3,6
HND-008603,2011,81500011,,,,10,4,14
HND-008604,2011,81500012,,,,1,5,6
HND-008605,2011,81500013,,,,6,7,13
HND-008607,2011,81500015,,,,27,29,56
HND-008609,2011,81500017,,,,3,2,5
HND-008612,2011,81500020,,,,3,8,11
HND-008613,2011,81500021,,,,8,3,11
HND-008614,2011,81500022,,,,3,2,5
HND-008615,2011,81500023,,,,3,6,9
HND-008616,2011,81500024,,,,2,0,2
HND-008617,2011,81500025,,,,4,6,10
HND-008618,2011,81500026,,,,8,12,20
HND-008619,2011,81500027,,,,3,4,7
HND-008620,2011,81500028,,,,2,1,3
HND-008623,2011,81500037,,,,1,2,3
HND-008596,2011,81500003,,,,6,9,15
HND-008602,2011,81500010,,,,3,5,8
HND-008603,2011,81500011,,,,4,8,12
HND-008604,2011,81500012,,,,1,0,1
HND-008605,2011,81500013,,,,4,6,10
HND-008606,2011,81500014,,,,3,4,7
HND-008607,2011,81500015,,,,26,26,52
HND-008608,2011,81500016,,,,2,4,6
HND-008609,2011,81500017,,,,2,10,12
HND-008610,2011,81500018,,,,4,2,6
HND-008612,2011,81500020,,,,4,9,13
HND-008614,2011,81500022,,,,3,2,5
HND-008616,2011,81500024,,,,0,3,3
HND-008617,2011,81500025,,,,6,4,10
HND-008618,2011,81500026,,,,17,9,26
HND-008620,2011,81500028,,,,1,2,3
HND-008621,2011,81500029,,,,1,1,2
HND-008623,2011,81500037,,,,3,6,9
HND-008633,2011,81500051,,,,0,4,4
HND-008634,2011,81500052,,,,3,2,5
HND-008597,2011,81500004,,,,4,4,8
HND-008598,2011,81500005,,,,4,2,6
HND-008599,2011,81500006,,,,1,5,6
HND-008600,2011,81500008,,,,3,4,7
HND-008601,2011,81500009,,,,4,5,9
HND-008611,2011,81500019,,,,5,5,10
HND-008613,2011,81500021,,,,3,1,4
HND-008619,2011,81500027,,,,10,7,17
HND-008625,2011,81500039,,,,6,10,16
HND-008594,2011,81500001,,,,62,37,99
HND-008594,2011,81500001,,,,36,38,74
HND-008594,2011,81500001,,,,24,44,68
HND-008594,2011,81500001,,,,31,32,63
HND-008594,2011,81500001,,,,22,37,59
HND-008594,2011,81500001,,,,7,1,8
,2011,81600085,,,,5,6,11
HND-008689,2011,81600088,,,,2,9,11
,2011,81600089,,,,2,6,8
,2011,81600101,,,,3,5,8
,2011,81600075,,,,4,4,8
,2011,81600079,,,,3,6,9
,2011,81600081,,,,5,6,11
,2011,81600082,,,,2,3,5
,2011,81600083,,,,4,3,7
,2011,81600084,,,,5,2,7
,2011,81600087,,,,9,3,12
,2011,81600090,,,,4,2,6
,2011,81600091,,,,0,6,6
,2011,81600094,,,,3,7,10
,2011,81600096,,,,2,3,5
,2011,81600100,,,,4,2,6
,2011,81600053,,,,1,1,2
,2011,81600058,,,,0,3,3
,2011,81600060,,,,2,4,6
,2011,81600078,,,,7,2,9
HND-008690,2011,81600093,,,,1,1,2
,2011,81600049,,,,1,0,1
,2011,81600052,,,,0,3,3
,2011,81600053,,,,1,3,4
,2011,81600049,,,,8,5,13
,2011,81600051,,,,9,6,15
,2011,81600052,,,,5,3,8
,2011,81600053,,,,9,6,15
HND-008686,2011,81600057,,,,7,14,21
HND-008688,2011,81600062,,,,13,11,24
,2011,81600080,,,,6,7,13
,2011,81600103,,,,4,7,11
HND-008683,2011,81600046,,,,28,36,64
,2011,81600047,,,,6,9,15
,2011,81600058,,,,6,4,10
,2011,81600060,,,,4,6,10
,2011,81600078,,,,4,3,7
,2011,81600092,,,,4,7,11
HND-008690,2011,81600093,,,,4,7,11
,2011,81600097,,,,6,7,13
HND-008646,2011,81600002,,,,0,2,2
HND-008648,2011,81600004,,,,10,9,19
HND-008649,2011,81600005,,,,15,12,27
HND-008650,2011,81600006,,,,5,2,7
HND-008652,2011,81600008,,,,4,0,4
HND-008653,2011,81600009,,,,2,3,5
HND-008655,2011,81600011,,,,6,9,15
HND-008656,2011,81600013,,,,2,4,6
HND-008657,2011,81600014,,,,6,3,9
HND-008658,2011,81600016,,,,9,4,13
,2011,81600017,,,,2,0,2
HND-008659,2011,81600018,,,,17,20,37
,2011,81600020,,,,0,1,1
HND-008661,2011,81600021,,,,12,9,21
HND-008663,2011,81600023,,,,3,3,6
,2011,81600024,,,,6,3,9
HND-008664,2011,81600025,,,,0,2,2
HND-008665,2011,81600026,,,,3,3,6
HND-008666,2011,81600027,,,,4,6,10
HND-008667,2011,81600028,,,,3,1,4
HND-008668,2011,81600029,,,,3,4,7
HND-008669,2011,81600030,,,,6,5,11
HND-008670,2011,81600031,,,,13,9,22
HND-008671,2011,81600032,,,,0,1,1
,2011,81600033,,,,1,0,1
HND-008672,2011,81600034,,,,0,2,2
HND-008673,2011,81600035,,,,5,4,9
HND-008674,2011,81600036,,,,8,7,15
HND-008675,2011,81600037,,,,1,3,4
HND-008676,2011,81600038,,,,2,3,5
HND-008677,2011,81600039,,,,3,6,9
HND-008678,2011,81600040,,,,8,6,14
HND-008680,2011,81600042,,,,1,4,5
HND-008681,2011,81600043,,,,3,2,5
HND-008682,2011,81600044,,,,4,4,8
,2011,81600078,,,,5,3,8
HND-008647,2011,81600003,,,,42,43,85
HND-008651,2011,81600007,,,,4,1,5
HND-008654,2011,81600010,,,,5,6,11
,2011,81600015,,,,3,3,6
HND-008660,2011,81600019,,,,11,11,22
HND-008679,2011,81600041,,,,8,6,14
HND-008684,2011,81600055,,,,2,2,4
HND-008685,2011,81600056,,,,10,6,16
HND-008687,2011,81600061,,,,4,2,6
HND-008647,2011,81600003,,,,37,49,86
HND-008653,2011,81600009,,,,1,2,3
HND-008654,2011,81600010,,,,1,2,3
HND-008657,2011,81600014,,,,8,11,19
,2011,81600015,,,,1,6,7
HND-008658,2011,81600016,,,,7,6,13
HND-008659,2011,81600018,,,,22,13,35
HND-008660,2011,81600019,,,,8,11,19
HND-008664,2011,81600025,,,,2,0,2
HND-008668,2011,81600029,,,,2,0,2
HND-008669,2011,81600030,,,,4,0,4
HND-008673,2011,81600035,,,,0,10,10
HND-008676,2011,81600038,,,,4,2,6
HND-008677,2011,81600039,,,,4,7,11
HND-008678,2011,81600040,,,,2,5,7
HND-008687,2011,81600061,,,,0,1,1
HND-008646,2011,81600002,,,,1,3,4
HND-008648,2011,81600004,,,,10,9,19
HND-008649,2011,81600005,,,,13,13,26
HND-008650,2011,81600006,,,,8,7,15
HND-008651,2011,81600007,,,,4,2,6
HND-008652,2011,81600008,,,,6,1,7
HND-008655,2011,81600011,,,,10,4,14
HND-008656,2011,81600013,,,,1,4,5
,2011,81600017,,,,6,2,8
HND-008661,2011,81600021,,,,6,8,14
HND-008662,2011,81600022,,,,0,2,2
HND-008663,2011,81600023,,,,3,1,4
,2011,81600024,,,,0,2,2
HND-008665,2011,81600026,,,,2,2,4
HND-008666,2011,81600027,,,,2,4,6
HND-008670,2011,81600031,,,,8,4,12
HND-008671,2011,81600032,,,,2,2,4
HND-008672,2011,81600034,,,,1,1,2
HND-008674,2011,81600036,,,,9,8,17
HND-008675,2011,81600037,,,,4,4,8
HND-008679,2011,81600041,,,,6,5,11
HND-008680,2011,81600042,,,,0,2,2
HND-008681,2011,81600043,,,,4,3,7
HND-008682,2011,81600044,,,,4,3,7
HND-008684,2011,81600055,,,,2,2,4
HND-008685,2011,81600056,,,,4,6,10
,2011,81600078,,,,12,2,14
HND-008647,2011,81600003,,,,47,46,93
HND-008651,2011,81600007,,,,3,1,4
HND-008654,2011,81600010,,,,2,3,5
,2011,81600015,,,,8,3,11
HND-008659,2011,81600018,,,,17,11,28
HND-008660,2011,81600019,,,,5,4,9
HND-008677,2011,81600039,,,,7,6,13
HND-008684,2011,81600055,,,,1,2,3
HND-008685,2011,81600056,,,,7,3,10
HND-008687,2011,81600061,,,,0,3,3
HND-008646,2011,81600002,,,,1,0,1
HND-008648,2011,81600004,,,,9,6,15
HND-008649,2011,81600005,,,,10,16,26
HND-008650,2011,81600006,,,,1,3,4
HND-008652,2011,81600008,,,,2,1,3
HND-008653,2011,81600009,,,,4,2,6
HND-008655,2011,81600011,,,,7,10,17
HND-008656,2011,81600013,,,,2,3,5
HND-008657,2011,81600014,,,,6,11,17
HND-008658,2011,81600016,,,,7,5,12
,2011,81600017,,,,2,0,2
,2011,81600020,,,,1,0,1
HND-008661,2011,81600021,,,,17,9,26
HND-008662,2011,81600022,,,,0,1,1
HND-008663,2011,81600023,,,,2,1,3
,2011,81600024,,,,1,1,2
HND-008664,2011,81600025,,,,1,1,2
HND-008665,2011,81600026,,,,1,2,3
HND-008666,2011,81600027,,,,2,8,10
HND-008667,2011,81600028,,,,0,4,4
HND-008668,2011,81600029,,,,5,3,8
HND-008669,2011,81600030,,,,9,8,17
HND-008670,2011,81600031,,,,8,10,18
HND-008671,2011,81600032,,,,2,0,2
,2011,81600033,,,,1,2,3
HND-008672,2011,81600034,,,,2,3,5
HND-008673,2011,81600035,,,,11,8,19
HND-008674,2011,81600036,,,,10,5,15
HND-008675,2011,81600037,,,,5,6,11
HND-008676,2011,81600038,,,,5,1,6
HND-008678,2011,81600040,,,,5,3,8
HND-008679,2011,81600041,,,,7,8,15
HND-008680,2011,81600042,,,,3,1,4
HND-008681,2011,81600043,,,,4,4,8
HND-008682,2011,81600044,,,,3,1,4
,2011,81600078,,,,5,3,8
HND-008647,2011,81600003,,,,47,55,102
HND-008649,2011,81600005,,,,8,14,22
HND-008652,2011,81600008,,,,2,0,2
HND-008653,2011,81600009,,,,1,1,2
HND-008654,2011,81600010,,,,5,0,5
HND-008655,2011,81600011,,,,10,7,17
HND-008656,2011,81600013,,,,1,6,7
HND-008657,2011,81600014,,,,8,8,16
,2011,81600015,,,,7,2,9
HND-008658,2011,81600016,,,,6,4,10
,2011,81600017,,,,3,1,4
HND-008659,2011,81600018,,,,15,14,29
HND-008660,2011,81600019,,,,15,3,18
,2011,81600020,,,,0,1,1
,2011,81600024,,,,3,3,6
HND-008664,2011,81600025,,,,1,4,5
HND-008665,2011,81600026,,,,3,4,7
HND-008668,2011,81600029,,,,1,7,8
HND-008669,2011,81600030,,,,5,3,8
HND-008671,2011,81600032,,,,3,4,7
HND-008672,2011,81600034,,,,1,2,3
HND-008673,2011,81600035,,,,11,6,17
HND-008674,2011,81600036,,,,5,5,10
HND-008676,2011,81600038,,,,3,2,5
HND-008677,2011,81600039,,,,4,9,13
HND-008678,2011,81600040,,,,5,3,8
HND-008687,2011,81600061,,,,3,0,3
,2011,81600078,,,,6,5,11
HND-008646,2011,81600002,,,,2,2,4
HND-008648,2011,81600004,,,,14,9,23
HND-008650,2011,81600006,,,,2,4,6
HND-008651,2011,81600007,,,,2,4,6
HND-008661,2011,81600021,,,,18,15,33
HND-008662,2011,81600022,,,,2,0,2
HND-008663,2011,81600023,,,,6,3,9
HND-008666,2011,81600027,,,,2,1,3
HND-008670,2011,81600031,,,,13,14,27
,2011,81600033,,,,2,0,2
HND-008675,2011,81600037,,,,3,7,10
HND-008679,2011,81600041,,,,4,6,10
HND-008680,2011,81600042,,,,2,1,3
HND-008681,2011,81600043,,,,3,2,5
HND-008682,2011,81600044,,,,4,1,5
HND-008684,2011,81600055,,,,1,1,2
HND-008685,2011,81600056,,,,14,6,20
HND-008647,2011,81600003,,,,58,49,107
HND-008648,2011,81600004,,,,8,13,21
HND-008649,2011,81600005,,,,20,13,33
HND-008650,2011,81600006,,,,5,2,7
HND-008652,2011,81600008,,,,1,4,5
HND-008653,2011,81600009,,,,0,2,2
HND-008654,2011,81600010,,,,6,3,9
HND-008655,2011,81600011,,,,5,13,18
HND-008656,2011,81600013,,,,4,3,7
HND-008657,2011,81600014,,,,7,6,13
,2011,81600015,,,,1,9,10
HND-008658,2011,81600016,,,,3,5,8
,2011,81600017,,,,3,2,5
HND-008659,2011,81600018,,,,22,21,43
,2011,81600020,,,,0,1,1
HND-008662,2011,81600022,,,,2,1,3
,2011,81600024,,,,6,7,13
HND-008664,2011,81600025,,,,1,0,1
HND-008665,2011,81600026,,,,4,3,7
HND-008667,2011,81600028,,,,1,0,1
HND-008668,2011,81600029,,,,1,6,7
HND-008669,2011,81600030,,,,0,9,9
,2011,81600033,,,,1,1,2
HND-008672,2011,81600034,,,,3,0,3
HND-008673,2011,81600035,,,,9,4,13
HND-008674,2011,81600036,,,,15,1,16
HND-008676,2011,81600038,,,,4,1,5
HND-008677,2011,81600039,,,,9,3,12
HND-008678,2011,81600040,,,,3,2,5
HND-008680,2011,81600042,,,,2,3,5
HND-008682,2011,81600044,,,,3,1,4
,2011,81600078,,,,3,4,7
HND-008646,2011,81600002,,,,1,1,2
HND-008651,2011,81600007,,,,1,0,1
HND-008660,2011,81600019,,,,4,4,8
HND-008661,2011,81600021,,,,12,11,23
HND-008663,2011,81600023,,,,4,5,9
HND-008666,2011,81600027,,,,4,3,7
HND-008670,2011,81600031,,,,10,8,18
HND-008675,2011,81600037,,,,9,5,14
HND-008679,2011,81600041,,,,5,6,11
HND-008681,2011,81600043,,,,2,3,5
HND-008684,2011,81600055,,,,1,1,2
HND-008685,2011,81600056,,,,1,5,6
HND-008646,2011,81600002,,,,2,0,2
HND-008648,2011,81600004,,,,10,10,20
HND-008649,2011,81600005,,,,14,21,35
HND-008650,2011,81600006,,,,7,4,11
HND-008651,2011,81600007,,,,4,1,5
HND-008652,2011,81600008,,,,2,2,4
HND-008655,2011,81600011,,,,7,6,13
HND-008656,2011,81600013,,,,2,4,6
,2011,81600017,,,,1,0,1
HND-008661,2011,81600021,,,,9,12,21
HND-008662,2011,81600022,,,,2,0,2
HND-008663,2011,81600023,,,,3,2,5
,2011,81600024,,,,2,4,6
HND-008665,2011,81600026,,,,5,4,9
HND-008666,2011,81600027,,,,2,1,3
HND-008670,2011,81600031,,,,15,6,21
HND-008671,2011,81600032,,,,1,1,2
,2011,81600033,,,,4,0,4
HND-008672,2011,81600034,,,,0,3,3
HND-008674,2011,81600036,,,,11,5,16
HND-008675,2011,81600037,,,,8,8,16
HND-008679,2011,81600041,,,,7,2,9
HND-008680,2011,81600042,,,,4,0,4
HND-008681,2011,81600043,,,,2,1,3
HND-008682,2011,81600044,,,,2,3,5
HND-008684,2011,81600055,,,,4,2,6
HND-008685,2011,81600056,,,,4,6,10
,2011,81600078,,,,0,1,1
HND-008647,2011,81600003,,,,42,26,68
HND-008653,2011,81600009,,,,1,0,1
HND-008654,2011,81600010,,,,8,5,13
HND-008657,2011,81600014,,,,10,7,17
,2011,81600015,,,,8,6,14
HND-008658,2011,81600016,,,,1,9,10
HND-008659,2011,81600018,,,,8,19,27
HND-008660,2011,81600019,,,,9,10,19
,2011,81600020,,,,2,0,2
HND-008668,2011,81600029,,,,3,5,8
HND-008669,2011,81600030,,,,6,4,10
HND-008673,2011,81600035,,,,8,13,21
HND-008676,2011,81600038,,,,1,2,3
HND-008677,2011,81600039,,,,1,5,6
HND-008678,2011,81600040,,,,2,5,7
HND-008687,2011,81600061,,,,1,2,3
HND-008645,2011,81600001,,,,126,117,243
HND-008649,2011,81600005,,,,15,10,25
HND-008655,2011,81600011,,,,16,11,27
HND-008659,2011,81600018,,,,8,13,21
HND-008675,2011,81600037,,,,5,4,9
,2011,81600064,,,,69,55,124
HND-008687,2011,81600061,,,,2,4,6
,2011,81600095,,,,5,15,20
HND-008659,2011,81600018,,,,7,5,12
HND-008687,2011,81600061,,,,4,2,6
,2011,81600064,,,,51,49,100
HND-008645,2011,81600001,,,,89,86,175
HND-008649,2011,81600005,,,,9,7,16
HND-008655,2011,81600011,,,,6,13,19
HND-008675,2011,81600037,,,,1,11,12
,2011,81600095,,,,8,5,13
HND-008649,2011,81600005,,,,3,5,8
HND-008659,2011,81600018,,,,7,6,13
HND-008687,2011,81600061,,,,4,2,6
HND-008645,2011,81600001,,,,73,70,143
HND-008655,2011,81600011,,,,16,15,31
,2011,81600064,,,,28,35,63
,2011,81600095,,,,4,4,8
HND-008645,2011,81600001,,,,43,93,136
,2011,81600064,,,,31,28,59
,2011,81600095,,,,9,8,17
,2011,81600095,,,,6,7,13
HND-008645,2011,81600001,,,,25,68,93
,2011,81600064,,,,20,29,49
HND-008645,2011,81600001,,,,30,61,91
,2011,81700047,,,,4,1,5
,2011,81700053,,,,7,3,10
,2011,81700055,,,,2,3,5
,2011,81700059,,,,4,5,9
,2011,81700066,,,,5,8,13
HND-008717,2011,81700039,,,,0,7,7
,2011,81700054,,,,5,3,8
,2011,81700056,,,,12,8,20
,2011,81700057,,,,4,5,9
,2011,81700060,,,,3,5,8
,2011,81700061,,,,4,2,6
,2011,81700062,,,,10,10,20
,2011,81700063,,,,5,2,7
,2011,81700064,,,,4,6,10
HND-008719,2011,81700065,,,,5,4,9
,2011,81700067,,,,9,7,16
,2011,81700068,,,,21,11,32
,2011,81700005,,,,0,3,3
,2011,81700029,,,,1,0,1
HND-008713,2011,81700031,,,,7,0,7
HND-008711,2011,81700027,,,,3,1,4
HND-008713,2011,81700031,,,,6,1,7
,2011,81700038,,,,5,1,6
,2011,81700005,,,,11,7,18
,2011,81700026,,,,1,0,1
,2011,81700028,,,,2,3,5
,2011,81700029,,,,3,1,4
,2011,81700026,,,,4,9,13
,2011,81700028,,,,4,7,11
,2011,81700029,,,,2,2,4
,2011,81700036,,,,3,5,8
,2011,81700038,,,,7,9,16
,2011,81700005,,,,12,7,19
,2011,81700009,,,,3,5,8
HND-008704,2011,81700017,,,,50,36,86
HND-008711,2011,81700027,,,,20,23,43
HND-008713,2011,81700031,,,,6,0,6
HND-008692,2011,81700002,,,,8,6,14
HND-008693,2011,81700003,,,,2,1,3
HND-008694,2011,81700006,,,,3,2,5
HND-008695,2011,81700007,,,,33,42,75
,2011,81700010,,,,9,2,11
HND-008699,2011,81700012,,,,10,13,23
HND-008701,2011,81700014,,,,2,2,4
HND-008702,2011,81700015,,,,6,2,8
HND-008703,2011,81700016,,,,21,13,34
HND-008705,2011,81700018,,,,3,3,6
HND-008706,2011,81700019,,,,7,6,13
HND-008707,2011,81700020,,,,5,3,8
HND-008708,2011,81700021,,,,5,3,8
HND-008709,2011,81700022,,,,11,7,18
,2011,81700026,,,,6,13,19
HND-008712,2011,81700030,,,,6,3,9
HND-008718,2011,81700050,,,,0,1,1
,2011,81700005,,,,12,6,18
HND-008696,2011,81700008,,,,2,2,4
HND-008698,2011,81700011,,,,6,6,12
HND-008700,2011,81700013,,,,7,0,7
HND-008704,2011,81700017,,,,74,44,118
HND-008713,2011,81700031,,,,7,0,7
HND-008714,2011,81700032,,,,5,2,7
HND-008715,2011,81700034,,,,5,5,10
HND-008692,2011,81700002,,,,7,4,11
HND-008693,2011,81700003,,,,2,1,3
HND-008695,2011,81700007,,,,40,49,89
HND-008696,2011,81700008,,,,5,0,5
HND-008698,2011,81700011,,,,6,4,10
HND-008706,2011,81700019,,,,3,12,15
HND-008707,2011,81700020,,,,5,5,10
,2011,81700026,,,,6,11,17
HND-008712,2011,81700030,,,,8,3,11
HND-008714,2011,81700032,,,,7,13,20
HND-008715,2011,81700034,,,,5,1,6
,2011,81700005,,,,9,10,19
HND-008694,2011,81700006,,,,4,7,11
,2011,81700010,,,,17,9,26
HND-008699,2011,81700012,,,,6,9,15
HND-008700,2011,81700013,,,,9,2,11
HND-008701,2011,81700014,,,,8,4,12
HND-008702,2011,81700015,,,,6,1,7
HND-008703,2011,81700016,,,,15,8,23
HND-008704,2011,81700017,,,,40,29,69
HND-008705,2011,81700018,,,,1,2,3
HND-008708,2011,81700021,,,,2,1,3
HND-008709,2011,81700022,,,,1,7,8
HND-008713,2011,81700031,,,,6,1,7
HND-008718,2011,81700050,,,,4,2,6
HND-008692,2011,81700002,,,,7,4,11
,2011,81700005,,,,9,9,18
HND-008696,2011,81700008,,,,5,3,8
HND-008698,2011,81700011,,,,5,5,10
HND-008700,2011,81700013,,,,5,6,11
HND-008704,2011,81700017,,,,46,56,102
,2011,81700026,,,,4,9,13
HND-008712,2011,81700030,,,,5,1,6
HND-008715,2011,81700034,,,,4,4,8
HND-008718,2011,81700050,,,,2,0,2
HND-008693,2011,81700003,,,,1,1,2
HND-008694,2011,81700006,,,,0,4,4
HND-008695,2011,81700007,,,,30,30,60
,2011,81700010,,,,15,14,29
HND-008699,2011,81700012,,,,5,12,17
HND-008701,2011,81700014,,,,8,4,12
HND-008702,2011,81700015,,,,1,2,3
HND-008703,2011,81700016,,,,10,13,23
HND-008705,2011,81700018,,,,0,7,7
HND-008706,2011,81700019,,,,2,5,7
HND-008707,2011,81700020,,,,6,6,12
HND-008708,2011,81700021,,,,2,1,3
HND-008709,2011,81700022,,,,6,7,13
HND-008713,2011,81700031,,,,2,0,2
HND-008714,2011,81700032,,,,9,5,14
HND-008692,2011,81700002,,,,10,5,15
HND-008693,2011,81700003,,,,3,0,3
HND-008694,2011,81700006,,,,3,3,6
HND-008695,2011,81700007,,,,27,30,57
HND-008696,2011,81700008,,,,10,5,15
,2011,81700010,,,,10,7,17
HND-008698,2011,81700011,,,,7,3,10
HND-008702,2011,81700015,,,,2,5,7
HND-008705,2011,81700018,,,,1,1,2
HND-008706,2011,81700019,,,,11,7,18
HND-008707,2011,81700020,,,,7,1,8
HND-008709,2011,81700022,,,,3,8,11
,2011,81700026,,,,10,3,13
HND-008712,2011,81700030,,,,5,4,9
HND-008714,2011,81700032,,,,2,7,9
HND-008715,2011,81700034,,,,8,8,16
,2011,81700005,,,,14,3,17
HND-008699,2011,81700012,,,,3,5,8
HND-008700,2011,81700013,,,,3,5,8
HND-008701,2011,81700014,,,,10,4,14
HND-008703,2011,81700016,,,,13,16,29
HND-008704,2011,81700017,,,,57,41,98
HND-008708,2011,81700021,,,,4,3,7
HND-008718,2011,81700050,,,,3,2,5
HND-008692,2011,81700002,,,,9,8,17
HND-008693,2011,81700003,,,,2,2,4
HND-008694,2011,81700006,,,,3,2,5
HND-008695,2011,81700007,,,,27,32,59
,2011,81700010,,,,10,7,17
HND-008698,2011,81700011,,,,5,5,10
HND-008701,2011,81700014,,,,9,4,13
HND-008702,2011,81700015,,,,3,2,5
HND-008703,2011,81700016,,,,15,17,32
HND-008705,2011,81700018,,,,2,1,3
HND-008706,2011,81700019,,,,4,7,11
HND-008707,2011,81700020,,,,2,6,8
HND-008708,2011,81700021,,,,6,2,8
HND-008709,2011,81700022,,,,6,3,9
,2011,81700026,,,,6,15,21
HND-008714,2011,81700032,,,,8,4,12
HND-008715,2011,81700034,,,,3,4,7
,2011,81700005,,,,6,4,10
HND-008696,2011,81700008,,,,5,5,10
HND-008699,2011,81700012,,,,5,4,9
HND-008700,2011,81700013,,,,9,6,15
HND-008704,2011,81700017,,,,71,50,121
HND-008712,2011,81700030,,,,2,4,6
HND-008718,2011,81700050,,,,3,0,3
,2011,81700005,,,,9,9,18
HND-008694,2011,81700006,,,,3,3,6
,2011,81700010,,,,7,5,12
HND-008699,2011,81700012,,,,5,5,10
HND-008700,2011,81700013,,,,4,4,8
HND-008701,2011,81700014,,,,6,4,10
HND-008702,2011,81700015,,,,2,5,7
HND-008703,2011,81700016,,,,4,6,10
HND-008704,2011,81700017,,,,53,32,85
HND-008705,2011,81700018,,,,1,3,4
HND-008708,2011,81700021,,,,2,0,2
HND-008709,2011,81700022,,,,8,6,14
HND-008718,2011,81700050,,,,0,2,2
HND-008692,2011,81700002,,,,4,8,12
HND-008693,2011,81700003,,,,3,2,5
HND-008695,2011,81700007,,,,20,18,38
HND-008696,2011,81700008,,,,9,1,10
HND-008698,2011,81700011,,,,5,5,10
HND-008706,2011,81700019,,,,2,3,5
HND-008707,2011,81700020,,,,4,9,13
,2011,81700026,,,,10,9,19
HND-008712,2011,81700030,,,,6,3,9
HND-008714,2011,81700032,,,,3,2,5
HND-008715,2011,81700034,,,,4,3,7
HND-008692,2011,81700002,,,,8,14,22
HND-008703,2011,81700016,,,,10,10,20
,2011,81700024,,,,3,8,11
HND-008710,2011,81700025,,,,38,24,62
,2011,81700051,,,,16,22,38
,2011,81700052,,,,18,18,36
HND-008691,2011,81700001,,,,43,25,68
HND-008716,2011,81700037,,,,54,47,101
HND-008691,2011,81700001,,,,17,31,48
HND-008692,2011,81700002,,,,8,7,15
,2011,81700024,,,,4,5,9
HND-008710,2011,81700025,,,,25,22,47
HND-008716,2011,81700037,,,,26,43,69
HND-008703,2011,81700016,,,,10,7,17
,2011,81700051,,,,22,21,43
,2011,81700052,,,,12,18,30
HND-008692,2011,81700002,,,,2,11,13
,2011,81700051,,,,13,14,27
,2011,81700052,,,,8,19,27
HND-008691,2011,81700001,,,,13,23,36
HND-008703,2011,81700016,,,,6,10,16
,2011,81700024,,,,2,2,4
HND-008710,2011,81700025,,,,24,13,37
HND-008716,2011,81700037,,,,21,38,59
HND-008691,2011,81700001,,,,45,42,87
,2011,81700024,,,,11,10,21
HND-008710,2011,81700025,,,,45,34,79
HND-008716,2011,81700037,,,,17,26,43
,2011,81700051,,,,9,13,22
HND-008691,2011,81700001,,,,19,26,45
,2011,81700024,,,,1,12,13
HND-008710,2011,81700025,,,,19,17,36
HND-008716,2011,81700037,,,,18,24,42
,2011,81700051,,,,6,11,17
HND-008691,2011,81700001,,,,16,27,43
HND-008710,2011,81700025,,,,14,18,32
HND-008716,2011,81700037,,,,9,13,22
,2011,81700051,,,,2,3,5
HND-008731,2011,81800015,,,,4,5,9
HND-008732,2011,81800016,,,,8,1,9
,2011,81800017,,,,2,3,5
HND-008729,2011,81800013,,,,1,1,2
HND-008727,2011,81800011,,,,1,3,4
HND-008728,2011,81800012,,,,3,0,3
HND-008729,2011,81800013,,,,6,4,10
HND-008727,2011,81800011,,,,9,3,12
HND-008728,2011,81800012,,,,8,6,14
HND-008729,2011,81800013,,,,0,3,3
HND-008726,2011,81800009,,,,1,3,4
HND-008721,2011,81800003,,,,10,9,19
HND-008722,2011,81800004,,,,3,4,7
HND-008723,2011,81800005,,,,2,1,3
HND-008724,2011,81800006,,,,6,10,16
HND-008725,2011,81800007,,,,4,3,7
HND-008730,2011,81800014,,,,4,0,4
HND-008722,2011,81800004,,,,3,4,7
HND-008723,2011,81800005,,,,3,5,8
HND-008726,2011,81800009,,,,5,1,6
HND-008721,2011,81800003,,,,13,8,21
HND-008724,2011,81800006,,,,4,5,9
HND-008725,2011,81800007,,,,5,3,8
HND-008730,2011,81800014,,,,4,2,6
HND-008723,2011,81800005,,,,3,3,6
HND-008726,2011,81800009,,,,1,1,2
HND-008721,2011,81800003,,,,11,10,21
HND-008722,2011,81800004,,,,3,4,7
HND-008724,2011,81800006,,,,5,8,13
HND-008725,2011,81800007,,,,5,5,10
HND-008730,2011,81800014,,,,7,4,11
HND-008721,2011,81800003,,,,15,7,22
HND-008722,2011,81800004,,,,0,5,5
HND-008723,2011,81800005,,,,3,2,5
HND-008726,2011,81800009,,,,3,3,6
HND-008724,2011,81800006,,,,7,9,16
HND-008725,2011,81800007,,,,0,2,2
HND-008730,2011,81800014,,,,4,4,8
HND-008721,2011,81800003,,,,8,10,18
HND-008722,2011,81800004,,,,4,6,10
HND-008723,2011,81800005,,,,2,1,3
HND-008725,2011,81800007,,,,0,1,1
HND-008730,2011,81800014,,,,8,6,14
HND-008724,2011,81800006,,,,6,6,12
HND-008726,2011,81800009,,,,4,4,8
HND-008721,2011,81800003,,,,5,7,12
HND-008724,2011,81800006,,,,4,4,8
HND-008725,2011,81800007,,,,1,0,1
HND-008730,2011,81800014,,,,4,1,5
HND-008722,2011,81800004,,,,2,3,5
HND-008723,2011,81800005,,,,1,2,3
HND-008726,2011,81800009,,,,2,2,4
HND-008727,2011,81800011,,,,32,21,53
HND-008727,2011,81800011,,,,19,23,42
HND-008727,2011,81800011,,,,16,36,52
HND-008727,2011,81800011,,,,18,23,41
HND-008727,2011,81800011,,,,11,16,27
HND-008727,2011,81800011,,,,12,12,24
,2011,81900033,,,,5,0,5
,2011,81900034,,,,3,3,6
HND-008747,2011,81900021,,,,0,2,2
,2011,81900035,,,,3,5,8
HND-008745,2011,81900019,,,,6,12,18
,2011,81900025,,,,6,3,9
HND-008749,2011,81900026,,,,7,8,15
HND-008746,2011,81900020,,,,10,8,18
HND-008747,2011,81900021,,,,3,2,5
HND-008748,2011,81900022,,,,1,1,2
HND-008750,2011,81900027,,,,1,2,3
,2011,81900035,,,,1,1,2
HND-008745,2011,81900019,,,,14,8,22
HND-008748,2011,81900022,,,,11,5,16
,2011,81900025,,,,10,6,16
HND-008749,2011,81900026,,,,8,11,19
,2011,81900035,,,,5,9,14
HND-008746,2011,81900020,,,,21,19,40
HND-008747,2011,81900021,,,,4,3,7
,2011,81900023,,,,15,13,28
HND-008750,2011,81900027,,,,4,8,12
,2011,81900003,,,,15,4,19
HND-008734,2011,81900004,,,,2,1,3
HND-008735,2011,81900005,,,,4,3,7
,2011,81900007,,,,13,15,28
,2011,81900008,,,,17,10,27
HND-008736,2011,81900009,,,,9,9,18
HND-008738,2011,81900011,,,,3,5,8
HND-008739,2011,81900012,,,,5,8,13
HND-008740,2011,81900013,,,,2,1,3
HND-008741,2011,81900014,,,,3,1,4
,2011,81900016,,,,1,4,5
HND-008743,2011,81900017,,,,2,0,2
HND-008744,2011,81900018,,,,2,1,3
,2011,81900006,,,,39,35,74
HND-008737,2011,81900010,,,,1,0,1
HND-008742,2011,81900015,,,,5,2,7
,2011,81900003,,,,7,8,15
HND-008734,2011,81900004,,,,0,4,4
,2011,81900006,,,,32,34,66
,2011,81900007,,,,17,12,29
HND-008738,2011,81900011,,,,2,6,8
HND-008740,2011,81900013,,,,2,1,3
HND-008743,2011,81900017,,,,1,2,3
HND-008735,2011,81900005,,,,2,2,4
,2011,81900008,,,,16,17,33
HND-008736,2011,81900009,,,,7,8,15
HND-008737,2011,81900010,,,,2,3,5
HND-008739,2011,81900012,,,,5,5,10
HND-008741,2011,81900014,,,,2,1,3
HND-008742,2011,81900015,,,,3,4,7
,2011,81900016,,,,3,2,5
HND-008744,2011,81900018,,,,2,2,4
,2011,81900003,,,,10,7,17
HND-008734,2011,81900004,,,,1,1,2
HND-008735,2011,81900005,,,,0,1,1
,2011,81900007,,,,19,13,32
,2011,81900008,,,,9,11,20
HND-008736,2011,81900009,,,,7,7,14
HND-008738,2011,81900011,,,,2,2,4
HND-008739,2011,81900012,,,,3,6,9
HND-008740,2011,81900013,,,,2,2,4
HND-008741,2011,81900014,,,,5,5,10
,2011,81900016,,,,1,3,4
HND-008743,2011,81900017,,,,0,2,2
,2011,81900006,,,,34,34,68
HND-008737,2011,81900010,,,,3,3,6
HND-008742,2011,81900015,,,,2,3,5
HND-008744,2011,81900018,,,,2,1,3
,2011,81900003,,,,15,13,28
,2011,81900006,,,,34,39,73
,2011,81900007,,,,7,13,20
HND-008734,2011,81900004,,,,5,1,6
HND-008735,2011,81900005,,,,4,1,5
,2011,81900008,,,,12,7,19
HND-008736,2011,81900009,,,,11,4,15
HND-008737,2011,81900010,,,,2,3,5
HND-008738,2011,81900011,,,,5,3,8
HND-008739,2011,81900012,,,,6,2,8
HND-008740,2011,81900013,,,,2,1,3
HND-008741,2011,81900014,,,,4,3,7
HND-008742,2011,81900015,,,,4,5,9
HND-008743,2011,81900017,,,,0,1,1
HND-008744,2011,81900018,,,,2,1,3
,2011,81900003,,,,15,14,29
,2011,81900006,,,,41,27,68
,2011,81900007,,,,13,12,25
HND-008734,2011,81900004,,,,3,1,4
HND-008735,2011,81900005,,,,1,2,3
,2011,81900008,,,,10,8,18
HND-008736,2011,81900009,,,,7,11,18
HND-008737,2011,81900010,,,,4,5,9
HND-008738,2011,81900011,,,,3,0,3
HND-008739,2011,81900012,,,,8,6,14
HND-008740,2011,81900013,,,,4,2,6
HND-008741,2011,81900014,,,,3,1,4
HND-008742,2011,81900015,,,,2,2,4
,2011,81900016,,,,5,3,8
HND-008743,2011,81900017,,,,2,2,4
HND-008744,2011,81900018,,,,1,1,2
HND-008735,2011,81900005,,,,1,0,1
,2011,81900008,,,,9,5,14
HND-008736,2011,81900009,,,,10,9,19
HND-008737,2011,81900010,,,,5,2,7
HND-008739,2011,81900012,,,,7,4,11
HND-008741,2011,81900014,,,,4,3,7
,2011,81900016,,,,2,3,5
HND-008744,2011,81900018,,,,1,1,2
,2011,81900003,,,,12,12,24
HND-008734,2011,81900004,,,,1,3,4
,2011,81900006,,,,34,36,70
,2011,81900007,,,,11,16,27
HND-008738,2011,81900011,,,,5,6,11
HND-008740,2011,81900013,,,,3,1,4
HND-008743,2011,81900017,,,,2,5,7
,2011,81900007,,,,28,13,41
HND-008733,2011,81900001,,,,35,63,98
,2011,81900003,,,,17,9,26
HND-008736,2011,81900009,,,,23,18,41
HND-008733,2011,81900001,,,,44,58,102
,2011,81900003,,,,8,9,17
,2011,81900007,,,,14,14,28
HND-008736,2011,81900009,,,,24,25,49
,2011,81900003,,,,8,12,20
,2011,81900007,,,,15,15,30
HND-008733,2011,81900001,,,,28,36,64
HND-008736,2011,81900009,,,,17,12,29
HND-008733,2011,81900001,,,,19,25,44
HND-008736,2011,81900009,,,,9,19,28
,2011,81900007,,,,4,14,18
,2011,81900007,,,,2,17,19
HND-008733,2011,81900001,,,,25,13,38
HND-008736,2011,81900009,,,,9,29,38
,2011,81900007,,,,5,12,17
HND-008733,2011,81900001,,,,21,27,48
HND-008736,2011,81900009,,,,14,13,27
HND-008775,2011,82000028,,,,4,6,10
HND-008792,2011,82000058,,,,1,6,7
,2011,82000063,,,,5,6,11
,2011,82000064,,,,7,1,8
,2011,82000065,,,,4,4,8
HND-008794,2011,82000066,,,,5,7,12
HND-008797,2011,82000074,,,,3,6,9
HND-008803,2011,82000095,,,,9,3,12
HND-008804,2011,82000099,,,,7,5,12
,2011,82000101,,,,9,6,15
HND-008806,2011,82000102,,,,2,5,7
,2011,82000077,,,,4,2,6
,2011,82000090,,,,4,6,10
,2011,82000091,,,,5,5,10
,2011,82000097,,,,3,5,8
,2011,82000098,,,,5,2,7
HND-008782,2011,82000036,,,,1,1,2
,2011,82000046,,,,3,0,3
,2011,82000047,,,,1,0,1
,2011,82000049,,,,1,2,3
,2011,82000051,,,,1,0,1
HND-008795,2011,82000071,,,,1,2,3
HND-008783,2011,82000039,,,,3,2,5
HND-008784,2011,82000040,,,,2,4,6
HND-008785,2011,82000043,,,,2,1,3
HND-008798,2011,82000076,,,,0,1,1
HND-008800,2011,82000088,,,,1,1,2
HND-008784,2011,82000040,,,,2,3,5
,2011,82000047,,,,1,0,1
,2011,82000051,,,,2,1,3
HND-008795,2011,82000071,,,,2,5,7
,2011,82000075,,,,0,5,5
HND-008805,2011,82000100,,,,0,5,5
HND-008782,2011,82000036,,,,2,3,5
HND-008783,2011,82000039,,,,5,2,7
HND-008785,2011,82000043,,,,2,2,4
,2011,82000044,,,,6,5,11
,2011,82000046,,,,4,3,7
HND-008786,2011,82000048,,,,3,4,7
,2011,82000049,,,,3,6,9
HND-008798,2011,82000076,,,,4,1,5
HND-008800,2011,82000088,,,,2,3,5
,2011,82000092,,,,3,2,5
HND-008782,2011,82000036,,,,4,8,12
HND-008783,2011,82000039,,,,3,6,9
HND-008785,2011,82000043,,,,4,5,9
,2011,82000044,,,,2,5,7
HND-008786,2011,82000048,,,,9,6,15
,2011,82000049,,,,1,2,3
HND-008798,2011,82000076,,,,6,6,12
HND-008800,2011,82000088,,,,6,6,12
,2011,82000092,,,,0,2,2
HND-008784,2011,82000040,,,,3,6,9
,2011,82000046,,,,6,1,7
,2011,82000047,,,,4,3,7
,2011,82000051,,,,4,7,11
HND-008795,2011,82000071,,,,3,0,3
,2011,82000072,,,,15,15,30
HND-008796,2011,82000073,,,,26,36,62
,2011,82000075,,,,8,8,16
HND-008805,2011,82000100,,,,8,8,16
HND-008751,2011,82000001,,,,4,4,8
HND-008752,2011,82000003,,,,21,20,41
HND-008753,2011,82000004,,,,37,47,84
HND-008757,2011,82000008,,,,10,10,20
HND-008758,2011,82000009,,,,4,3,7
HND-008759,2011,82000010,,,,4,4,8
HND-008764,2011,82000015,,,,8,7,15
HND-008765,2011,82000016,,,,16,10,26
HND-008766,2011,82000017,,,,6,3,9
HND-008769,2011,82000021,,,,7,3,10
HND-008770,2011,82000022,,,,2,1,3
HND-008771,2011,82000023,,,,1,2,3
HND-008772,2011,82000024,,,,6,7,13
HND-008776,2011,82000029,,,,7,2,9
HND-008777,2011,82000030,,,,6,5,11
HND-008778,2011,82000031,,,,2,2,4
HND-008780,2011,82000034,,,,7,4,11
HND-008784,2011,82000040,,,,1,8,9
HND-008789,2011,82000054,,,,8,6,14
HND-008790,2011,82000056,,,,9,8,17
,2011,82000062,,,,4,5,9
HND-008800,2011,82000088,,,,8,12,20
HND-008754,2011,82000005,,,,33,27,60
HND-008755,2011,82000006,,,,8,2,10
HND-008756,2011,82000007,,,,2,3,5
HND-008760,2011,82000011,,,,1,0,1
HND-008761,2011,82000012,,,,2,2,4
HND-008762,2011,82000013,,,,7,7,14
HND-008763,2011,82000014,,,,8,13,21
HND-008767,2011,82000018,,,,6,5,11
HND-008768,2011,82000019,,,,11,9,20
HND-008773,2011,82000025,,,,11,6,17
HND-008774,2011,82000026,,,,7,2,9
HND-008779,2011,82000032,,,,2,1,3
HND-008781,2011,82000035,,,,7,1,8
HND-008791,2011,82000057,,,,7,3,10
,2011,82000085,,,,2,1,3
HND-008799,2011,82000086,,,,4,0,4
,2011,82000092,,,,6,6,12
HND-008801,2011,82000093,,,,1,3,4
HND-008802,2011,82000094,,,,4,2,6
HND-008752,2011,82000003,,,,11,4,15
HND-008754,2011,82000005,,,,2,6,8
HND-008755,2011,82000006,,,,11,3,14
HND-008758,2011,82000009,,,,1,0,1
HND-008759,2011,82000010,,,,5,2,7
HND-008760,2011,82000011,,,,1,4,5
HND-008763,2011,82000014,,,,6,7,13
HND-008767,2011,82000018,,,,4,2,6
HND-008770,2011,82000022,,,,1,0,1
HND-008771,2011,82000023,,,,3,1,4
HND-008772,2011,82000024,,,,7,3,10
HND-008773,2011,82000025,,,,4,2,6
HND-008774,2011,82000026,,,,1,1,2
HND-008776,2011,82000029,,,,4,2,6
HND-008779,2011,82000032,,,,7,3,10
HND-008780,2011,82000034,,,,4,3,7
HND-008781,2011,82000035,,,,5,6,11
HND-008790,2011,82000056,,,,7,6,13
HND-008791,2011,82000057,,,,5,0,5
HND-008800,2011,82000088,,,,9,8,17
,2011,82000092,,,,5,2,7
HND-008751,2011,82000001,,,,7,3,10
HND-008753,2011,82000004,,,,33,41,74
HND-008756,2011,82000007,,,,1,1,2
HND-008757,2011,82000008,,,,6,7,13
HND-008761,2011,82000012,,,,5,3,8
HND-008762,2011,82000013,,,,8,3,11
HND-008764,2011,82000015,,,,11,5,16
HND-008765,2011,82000016,,,,12,9,21
HND-008766,2011,82000017,,,,1,5,6
HND-008768,2011,82000019,,,,11,13,24
HND-008769,2011,82000021,,,,5,4,9
HND-008777,2011,82000030,,,,4,5,9
HND-008778,2011,82000031,,,,4,2,6
HND-008784,2011,82000040,,,,3,8,11
HND-008789,2011,82000054,,,,5,5,10
,2011,82000062,,,,1,1,2
,2011,82000085,,,,2,0,2
HND-008799,2011,82000086,,,,2,1,3
HND-008801,2011,82000093,,,,1,1,2
HND-008802,2011,82000094,,,,7,8,15
HND-008754,2011,82000005,,,,1,6,7
HND-008755,2011,82000006,,,,3,1,4
HND-008756,2011,82000007,,,,1,3,4
HND-008758,2011,82000009,,,,3,1,4
HND-008760,2011,82000011,,,,1,3,4
HND-008761,2011,82000012,,,,6,4,10
HND-008762,2011,82000013,,,,3,8,11
HND-008763,2011,82000014,,,,5,6,11
HND-008767,2011,82000018,,,,0,4,4
HND-008768,2011,82000019,,,,9,13,22
HND-008770,2011,82000022,,,,0,6,6
HND-008773,2011,82000025,,,,0,2,2
HND-008774,2011,82000026,,,,6,2,8
HND-008779,2011,82000032,,,,5,2,7
HND-008781,2011,82000035,,,,5,9,14
HND-008791,2011,82000057,,,,2,3,5
,2011,82000085,,,,3,4,7
HND-008799,2011,82000086,,,,5,2,7
,2011,82000092,,,,1,3,4
HND-008801,2011,82000093,,,,4,2,6
HND-008802,2011,82000094,,,,5,7,12
HND-008751,2011,82000001,,,,5,5,10
HND-008752,2011,82000003,,,,8,7,15
HND-008753,2011,82000004,,,,39,49,88
HND-008757,2011,82000008,,,,3,2,5
HND-008759,2011,82000010,,,,3,5,8
HND-008764,2011,82000015,,,,11,9,20
HND-008765,2011,82000016,,,,6,15,21
HND-008766,2011,82000017,,,,0,4,4
HND-008769,2011,82000021,,,,3,1,4
HND-008771,2011,82000023,,,,1,1,2
HND-008772,2011,82000024,,,,0,2,2
HND-008776,2011,82000029,,,,2,3,5
HND-008777,2011,82000030,,,,3,5,8
HND-008778,2011,82000031,,,,7,1,8
HND-008780,2011,82000034,,,,7,3,10
HND-008784,2011,82000040,,,,5,3,8
HND-008789,2011,82000054,,,,6,6,12
HND-008790,2011,82000056,,,,5,7,12
,2011,82000062,,,,1,2,3
HND-008800,2011,82000088,,,,7,5,12
HND-008751,2011,82000001,,,,3,2,5
HND-008752,2011,82000003,,,,1,10,11
HND-008757,2011,82000008,,,,7,7,14
HND-008758,2011,82000009,,,,6,6,12
HND-008759,2011,82000010,,,,9,1,10
HND-008760,2011,82000011,,,,3,2,5
HND-008766,2011,82000017,,,,4,6,10
HND-008767,2011,82000018,,,,3,1,4
HND-008769,2011,82000021,,,,3,3,6
HND-008770,2011,82000022,,,,2,0,2
HND-008771,2011,82000023,,,,4,1,5
HND-008772,2011,82000024,,,,3,3,6
HND-008773,2011,82000025,,,,0,6,6
HND-008774,2011,82000026,,,,4,1,5
HND-008776,2011,82000029,,,,1,3,4
HND-008778,2011,82000031,,,,1,0,1
HND-008779,2011,82000032,,,,0,3,3
HND-008780,2011,82000034,,,,3,3,6
HND-008784,2011,82000040,,,,5,8,13
HND-008790,2011,82000056,,,,2,9,11
HND-008791,2011,82000057,,,,0,2,2
HND-008800,2011,82000088,,,,5,5,10
HND-008753,2011,82000004,,,,32,35,67
HND-008754,2011,82000005,,,,3,7,10
HND-008755,2011,82000006,,,,4,3,7
HND-008756,2011,82000007,,,,2,2,4
HND-008761,2011,82000012,,,,1,4,5
HND-008762,2011,82000013,,,,4,7,11
HND-008763,2011,82000014,,,,2,3,5
HND-008764,2011,82000015,,,,7,2,9
HND-008765,2011,82000016,,,,10,7,17
HND-008768,2011,82000019,,,,7,11,18
HND-008777,2011,82000030,,,,5,4,9
HND-008781,2011,82000035,,,,1,6,7
HND-008789,2011,82000054,,,,3,7,10
,2011,82000062,,,,2,0,2
,2011,82000085,,,,0,2,2
HND-008799,2011,82000086,,,,3,1,4
,2011,82000092,,,,0,4,4
HND-008801,2011,82000093,,,,1,1,2
HND-008802,2011,82000094,,,,3,3,6
HND-008751,2011,82000001,,,,4,4,8
HND-008752,2011,82000003,,,,6,3,9
HND-008757,2011,82000008,,,,7,9,16
HND-008758,2011,82000009,,,,0,2,2
HND-008759,2011,82000010,,,,3,7,10
HND-008766,2011,82000017,,,,6,3,9
HND-008767,2011,82000018,,,,3,3,6
HND-008769,2011,82000021,,,,1,3,4
HND-008770,2011,82000022,,,,1,4,5
HND-008771,2011,82000023,,,,2,1,3
HND-008772,2011,82000024,,,,1,4,5
HND-008776,2011,82000029,,,,2,2,4
HND-008781,2011,82000035,,,,5,5,10
,2011,82000062,,,,0,3,3
,2011,82000085,,,,1,0,1
HND-008799,2011,82000086,,,,2,0,2
,2011,82000092,,,,0,2,2
HND-008801,2011,82000093,,,,2,2,4
HND-008802,2011,82000094,,,,3,7,10
HND-008753,2011,82000004,,,,46,48,94
HND-008754,2011,82000005,,,,0,2,2
HND-008755,2011,82000006,,,,6,0,6
HND-008756,2011,82000007,,,,1,1,2
HND-008760,2011,82000011,,,,4,4,8
HND-008761,2011,82000012,,,,2,5,7
HND-008762,2011,82000013,,,,3,2,5
HND-008763,2011,82000014,,,,0,2,2
HND-008764,2011,82000015,,,,7,5,12
HND-008765,2011,82000016,,,,3,7,10
HND-008768,2011,82000019,,,,4,5,9
HND-008773,2011,82000025,,,,1,6,7
HND-008774,2011,82000026,,,,0,4,4
HND-008777,2011,82000030,,,,5,3,8
HND-008778,2011,82000031,,,,3,2,5
HND-008779,2011,82000032,,,,1,4,5
HND-008780,2011,82000034,,,,2,4,6
HND-008784,2011,82000040,,,,6,4,10
HND-008789,2011,82000054,,,,7,6,13
HND-008790,2011,82000056,,,,3,3,6
HND-008800,2011,82000088,,,,2,9,11
HND-008751,2011,82000001,,,,3,2,5
HND-008753,2011,82000004,,,,30,38,68
HND-008756,2011,82000007,,,,2,3,5
HND-008757,2011,82000008,,,,1,4,5
HND-008761,2011,82000012,,,,4,1,5
HND-008762,2011,82000013,,,,7,5,12
HND-008764,2011,82000015,,,,7,2,9
HND-008765,2011,82000016,,,,2,6,8
HND-008766,2011,82000017,,,,3,3,6
HND-008768,2011,82000019,,,,9,7,16
HND-008769,2011,82000021,,,,3,2,5
HND-008779,2011,82000032,,,,2,3,5
HND-008780,2011,82000034,,,,6,7,13
HND-008781,2011,82000035,,,,7,3,10
HND-008790,2011,82000056,,,,6,1,7
HND-008791,2011,82000057,,,,2,2,4
HND-008800,2011,82000088,,,,2,0,2
,2011,82000092,,,,1,3,4
HND-008752,2011,82000003,,,,3,6,9
HND-008754,2011,82000005,,,,0,3,3
HND-008755,2011,82000006,,,,0,2,2
HND-008758,2011,82000009,,,,4,1,5
HND-008759,2011,82000010,,,,4,5,9
HND-008760,2011,82000011,,,,1,2,3
HND-008763,2011,82000014,,,,1,2,3
HND-008767,2011,82000018,,,,2,0,2
HND-008770,2011,82000022,,,,2,0,2
HND-008771,2011,82000023,,,,2,2,4
HND-008772,2011,82000024,,,,4,2,6
HND-008773,2011,82000025,,,,3,2,5
HND-008774,2011,82000026,,,,0,1,1
HND-008776,2011,82000029,,,,2,2,4
HND-008777,2011,82000030,,,,3,2,5
HND-008778,2011,82000031,,,,2,0,2
HND-008784,2011,82000040,,,,3,3,6
HND-008789,2011,82000054,,,,2,3,5
,2011,82000085,,,,2,2,4
HND-008799,2011,82000086,,,,3,1,4
HND-008801,2011,82000093,,,,2,0,2
HND-008802,2011,82000094,,,,1,1,2
HND-008772,2011,82000024,,,,0,1,1
HND-008787,2011,82000052,,,,40,38,78
HND-008788,2011,82000053,,,,47,33,80
HND-008787,2011,82000052,,,,26,26,52
HND-008788,2011,82000053,,,,28,21,49
HND-008772,2011,82000024,,,,2,8,10
HND-008788,2011,82000053,,,,29,30,59
HND-008772,2011,82000024,,,,4,4,8
HND-008787,2011,82000052,,,,28,29,57
HND-008787,2011,82000052,,,,5,11,16
HND-008788,2011,82000053,,,,24,36,60
HND-008788,2011,82000053,,,,18,16,34
HND-008787,2011,82000052,,,,6,9,15
HND-008788,2011,82000053,,,,10,21,31
,2011,82100030,,,,1,5,6
HND-008818,2011,82100031,,,,4,3,7
,2011,82100015,,,,1,1,2
HND-008813,2011,82100008,,,,3,1,4
HND-008814,2011,82100009,,,,0,4,4
,2011,82100015,,,,3,4,7
HND-008814,2011,82100009,,,,2,6,8
,2011,82100015,,,,2,1,3
HND-008813,2011,82100008,,,,7,4,11
HND-008809,2011,82100003,,,,9,6,15
HND-008815,2011,82100012,,,,3,1,4
HND-008816,2011,82100013,,,,4,10,14
HND-008808,2011,82100002,,,,2,3,5
HND-008810,2011,82100004,,,,0,2,2
HND-008812,2011,82100006,,,,4,1,5
HND-008817,2011,82100029,,,,1,1,2
HND-008808,2011,82100002,,,,2,3,5
HND-008810,2011,82100004,,,,1,1,2
HND-008815,2011,82100012,,,,4,3,7
HND-008809,2011,82100003,,,,5,10,15
HND-008811,2011,82100005,,,,2,3,5
HND-008812,2011,82100006,,,,1,5,6
HND-008816,2011,82100013,,,,4,5,9
HND-008817,2011,82100029,,,,2,5,7
HND-008808,2011,82100002,,,,2,3,5
HND-008810,2011,82100004,,,,5,2,7
HND-008811,2011,82100005,,,,2,2,4
HND-008812,2011,82100006,,,,3,3,6
HND-008817,2011,82100029,,,,0,1,1
HND-008809,2011,82100003,,,,13,8,21
HND-008815,2011,82100012,,,,0,3,3
HND-008816,2011,82100013,,,,6,5,11
HND-008809,2011,82100003,,,,6,9,15
HND-008810,2011,82100004,,,,1,2,3
HND-008815,2011,82100012,,,,1,3,4
HND-008816,2011,82100013,,,,7,3,10
HND-008808,2011,82100002,,,,5,4,9
HND-008811,2011,82100005,,,,1,2,3
HND-008812,2011,82100006,,,,3,6,9
HND-008817,2011,82100029,,,,3,0,3
HND-008809,2011,82100003,,,,10,6,16
HND-008815,2011,82100012,,,,5,3,8
HND-008816,2011,82100013,,,,5,7,12
HND-008808,2011,82100002,,,,3,7,10
HND-008810,2011,82100004,,,,3,4,7
HND-008811,2011,82100005,,,,3,1,4
HND-008812,2011,82100006,,,,5,4,9
HND-008817,2011,82100029,,,,1,1,2
HND-008809,2011,82100003,,,,13,13,26
HND-008812,2011,82100006,,,,9,5,14
HND-008816,2011,82100013,,,,0,2,2
HND-008817,2011,82100029,,,,0,2,2
HND-008808,2011,82100002,,,,7,4,11
HND-008810,2011,82100004,,,,6,4,10
HND-008815,2011,82100012,,,,4,3,7
HND-008807,2011,82100001,,,,29,21,50
HND-008807,2011,82100001,,,,16,21,37
HND-008807,2011,82100001,,,,17,19,36
HND-008807,2011,82100001,,,,9,16,25
HND-008807,2011,82100001,,,,10,5,15
HND-008807,2011,82100001,,,,3,4,7
HND-008829,2011,82200012,,,,4,9,13
,2011,82200025,,,,4,4,8
,2011,82200041,,,,4,5,9
,2011,82200024,,,,3,5,8
HND-008841,2011,82200039,,,,9,5,14
HND-008842,2011,82200040,,,,1,5,6
,2011,82200037,,,,2,2,4
HND-008833,2011,82200016,,,,3,3,6
HND-008835,2011,82200018,,,,4,4,8
HND-008836,2011,82200020,,,,0,2,2
HND-008837,2011,82200021,,,,3,3,6
HND-008839,2011,82200023,,,,2,0,2
HND-008840,2011,82200036,,,,1,0,1
HND-008819,2011,82200001,,,,2,3,5
,2011,82200037,,,,3,7,10
HND-008833,2011,82200016,,,,15,18,33
HND-008835,2011,82200018,,,,5,5,10
HND-008836,2011,82200020,,,,19,16,35
HND-008837,2011,82200021,,,,12,14,26
HND-008839,2011,82200023,,,,11,8,19
,2011,82200037,,,,7,9,16
HND-008819,2011,82200001,,,,11,14,25
,2011,82200034,,,,2,9,11
HND-008840,2011,82200036,,,,9,8,17
HND-008822,2011,82200005,,,,20,10,30
HND-008823,2011,82200006,,,,12,7,19
HND-008824,2011,82200007,,,,8,7,15
HND-008825,2011,82200008,,,,24,20,44
HND-008828,2011,82200011,,,,15,23,38
HND-008829,2011,82200012,,,,12,5,17
HND-008830,2011,82200013,,,,4,8,12
HND-008831,2011,82200014,,,,20,21,41
,2011,82200034,,,,4,2,6
HND-008820,2011,82200003,,,,4,1,5
HND-008821,2011,82200004,,,,12,5,17
HND-008826,2011,82200009,,,,2,3,5
HND-008827,2011,82200010,,,,7,5,12
HND-008832,2011,82200015,,,,7,5,12
,2011,82200037,,,,4,9,13
HND-008820,2011,82200003,,,,1,1,2
HND-008821,2011,82200004,,,,8,6,14
HND-008822,2011,82200005,,,,18,12,30
HND-008823,2011,82200006,,,,12,5,17
HND-008825,2011,82200008,,,,24,23,47
HND-008826,2011,82200009,,,,6,3,9
HND-008827,2011,82200010,,,,7,2,9
HND-008828,2011,82200011,,,,17,9,26
HND-008830,2011,82200013,,,,9,10,19
HND-008831,2011,82200014,,,,23,15,38
,2011,82200037,,,,12,7,19
HND-008824,2011,82200007,,,,9,3,12
HND-008829,2011,82200012,,,,7,6,13
HND-008832,2011,82200015,,,,11,6,17
,2011,82200034,,,,3,3,6
HND-008822,2011,82200005,,,,12,18,30
HND-008823,2011,82200006,,,,7,7,14
HND-008824,2011,82200007,,,,7,6,13
HND-008825,2011,82200008,,,,24,14,38
HND-008828,2011,82200011,,,,12,14,26
HND-008829,2011,82200012,,,,6,6,12
HND-008830,2011,82200013,,,,8,6,14
HND-008831,2011,82200014,,,,18,6,24
,2011,82200037,,,,2,7,9
HND-008820,2011,82200003,,,,4,1,5
HND-008821,2011,82200004,,,,7,6,13
HND-008826,2011,82200009,,,,1,1,2
HND-008827,2011,82200010,,,,11,5,16
HND-008832,2011,82200015,,,,11,7,18
,2011,82200034,,,,4,3,7
HND-008820,2011,82200003,,,,4,3,7
HND-008821,2011,82200004,,,,6,4,10
HND-008822,2011,82200005,,,,17,12,29
HND-008823,2011,82200006,,,,12,6,18
HND-008826,2011,82200009,,,,4,5,9
HND-008827,2011,82200010,,,,5,7,12
HND-008828,2011,82200011,,,,11,13,24
,2011,82200037,,,,4,2,6
HND-008824,2011,82200007,,,,0,1,1
HND-008825,2011,82200008,,,,16,19,35
HND-008829,2011,82200012,,,,4,5,9
HND-008830,2011,82200013,,,,7,4,11
HND-008831,2011,82200014,,,,20,23,43
HND-008832,2011,82200015,,,,5,8,13
,2011,82200034,,,,4,5,9
HND-008820,2011,82200003,,,,2,6,8
HND-008821,2011,82200004,,,,5,5,10
HND-008823,2011,82200006,,,,17,9,26
HND-008826,2011,82200009,,,,2,4,6
HND-008827,2011,82200010,,,,5,7,12
,2011,82200037,,,,5,2,7
HND-008822,2011,82200005,,,,15,15,30
HND-008824,2011,82200007,,,,3,6,9
HND-008825,2011,82200008,,,,14,14,28
HND-008828,2011,82200011,,,,5,12,17
HND-008829,2011,82200012,,,,3,5,8
HND-008830,2011,82200013,,,,8,8,16
HND-008831,2011,82200014,,,,20,17,37
HND-008832,2011,82200015,,,,5,7,12
,2011,82200034,,,,8,4,12
HND-008824,2011,82200007,,,,7,6,13
HND-008829,2011,82200012,,,,6,6,12
HND-008832,2011,82200015,,,,11,11,22
,2011,82200034,,,,4,3,7
HND-008820,2011,82200003,,,,1,4,5
HND-008821,2011,82200004,,,,3,8,11
HND-008822,2011,82200005,,,,13,9,22
HND-008823,2011,82200006,,,,14,8,22
HND-008825,2011,82200008,,,,24,18,42
HND-008826,2011,82200009,,,,3,1,4
HND-008827,2011,82200010,,,,9,4,13
HND-008828,2011,82200011,,,,11,16,27
HND-008830,2011,82200013,,,,7,11,18
HND-008831,2011,82200014,,,,14,18,32
,2011,82200037,,,,1,4,5
HND-008820,2011,82200003,,,,13,10,23
,2011,82200038,,,,7,3,10
HND-008834,2011,82200017,,,,100,98,198
HND-008820,2011,82200003,,,,4,4,8
HND-008834,2011,82200017,,,,91,100,191
,2011,82200038,,,,5,5,10
HND-008820,2011,82200003,,,,5,4,9
,2011,82200038,,,,1,2,3
HND-008834,2011,82200017,,,,64,89,153
HND-008834,2011,82200017,,,,71,111,182
,2011,82200038,,,,2,2,4
HND-008834,2011,82200017,,,,82,73,155
HND-008834,2011,82200017,,,,40,57,97
HND-008857,2011,82300021,,,,5,4,9
,2011,82300022,,,,4,4,8
,2011,82300029,,,,2,2,4
HND-008859,2011,82300030,,,,2,3,5
,2011,82300020,,,,4,4,8
,2011,82300031,,,,3,3,6
HND-008843,2011,82300001,,,,1,1,2
,2011,82300016,,,,1,3,4
HND-008843,2011,82300001,,,,5,8,13
HND-008854,2011,82300013,,,,11,14,25
HND-008855,2011,82300014,,,,10,7,17
,2011,82300016,,,,4,5,9
HND-008853,2011,82300011,,,,25,18,43
HND-008847,2011,82300005,,,,23,23,46
HND-008848,2011,82300006,,,,29,21,50
HND-008849,2011,82300007,,,,5,1,6
HND-008844,2011,82300002,,,,35,27,62
HND-008845,2011,82300003,,,,1,7,8
HND-008846,2011,82300004,,,,5,1,6
HND-008850,2011,82300008,,,,1,3,4
HND-008851,2011,82300009,,,,5,7,12
HND-008856,2011,82300015,,,,3,4,7
HND-008858,2011,82300024,,,,4,2,6
HND-008844,2011,82300002,,,,27,36,63
HND-008846,2011,82300004,,,,2,5,7
HND-008849,2011,82300007,,,,8,2,10
HND-008850,2011,82300008,,,,3,1,4
HND-008858,2011,82300024,,,,1,3,4
HND-008845,2011,82300003,,,,7,5,12
HND-008847,2011,82300005,,,,15,17,32
HND-008848,2011,82300006,,,,15,19,34
HND-008851,2011,82300009,,,,5,5,10
HND-008844,2011,82300002,,,,37,30,67
HND-008845,2011,82300003,,,,4,3,7
HND-008846,2011,82300004,,,,5,4,9
HND-008850,2011,82300008,,,,2,0,2
HND-008851,2011,82300009,,,,9,4,13
HND-008856,2011,82300015,,,,0,3,3
HND-008858,2011,82300024,,,,3,0,3
HND-008847,2011,82300005,,,,22,23,45
HND-008848,2011,82300006,,,,17,8,25
HND-008849,2011,82300007,,,,0,5,5
HND-008844,2011,82300002,,,,32,24,56
HND-008849,2011,82300007,,,,3,3,6
HND-008850,2011,82300008,,,,2,3,5
HND-008858,2011,82300024,,,,1,1,2
HND-008845,2011,82300003,,,,9,7,16
HND-008846,2011,82300004,,,,4,5,9
HND-008847,2011,82300005,,,,20,22,42
HND-008848,2011,82300006,,,,24,20,44
HND-008851,2011,82300009,,,,7,3,10
HND-008856,2011,82300015,,,,2,2,4
HND-008844,2011,82300002,,,,25,30,55
HND-008849,2011,82300007,,,,6,7,13
HND-008858,2011,82300024,,,,0,2,2
HND-008845,2011,82300003,,,,1,7,8
HND-008846,2011,82300004,,,,7,4,11
HND-008847,2011,82300005,,,,19,20,39
HND-008848,2011,82300006,,,,24,11,35
HND-008850,2011,82300008,,,,1,0,1
HND-008851,2011,82300009,,,,4,4,8
HND-008856,2011,82300015,,,,6,1,7
HND-008845,2011,82300003,,,,3,6,9
HND-008847,2011,82300005,,,,19,21,40
HND-008848,2011,82300006,,,,12,20,32
HND-008851,2011,82300009,,,,2,5,7
HND-008844,2011,82300002,,,,33,30,63
HND-008846,2011,82300004,,,,8,4,12
HND-008849,2011,82300007,,,,4,4,8
HND-008850,2011,82300008,,,,1,1,2
HND-008856,2011,82300015,,,,2,3,5
HND-008858,2011,82300024,,,,2,2,4
HND-008852,2011,82300010,,,,98,71,169
HND-008852,2011,82300010,,,,75,66,141
HND-008852,2011,82300010,,,,62,64,126
HND-008852,2011,82300010,,,,54,64,118
HND-008852,2011,82300010,,,,16,45,61
HND-008852,2011,82300010,,,,14,25,39
HND-008872,2011,82400014,,,,3,5,8
HND-008883,2011,82400025,,,,3,3,6
HND-008924,2011,82400105,,,,2,11,13
,2011,82400111,,,,10,4,14
HND-008916,2011,82400067,,,,2,6,8
,2011,82400086,,,,10,9,19
HND-008923,2011,82400100,,,,8,8,16
,2011,82400103,,,,2,3,5
,2011,82400106,,,,6,8,14
,2011,82400108,,,,2,3,5
,2011,82400110,,,,2,3,5
,2011,82400114,,,,2,3,5
,2011,82400115,,,,7,8,15
,2011,82400118,,,,14,8,22
,2011,82400119,,,,5,5,10
,2011,82400121,,,,5,0,5
,2011,82400122,,,,5,4,9
,2011,82400123,,,,2,3,5
HND-008928,2011,82400124,,,,5,6,11
,2011,82400041,,,,21,5,26
HND-008900,2011,82400046,,,,0,1,1
HND-008918,2011,82400085,,,,4,2,6
,2011,82400101,,,,2,5,7
,2011,82400126,,,,1,0,1
HND-008861,2011,82400003,,,,28,10,38
,2011,82400095,,,,1,0,1
,2011,82400041,,,,7,9,16
HND-008897,2011,82400043,,,,1,4,5
HND-008898,2011,82400044,,,,2,1,3
HND-008918,2011,82400085,,,,14,18,32
,2011,82400091,,,,21,14,35
,2011,82400095,,,,2,1,3
,2011,82400099,,,,2,2,4
,2011,82400101,,,,1,3,4
,2011,82400120,,,,6,9,15
,2011,82400126,,,,1,1,2
,2011,82400127,,,,3,5,8
HND-008861,2011,82400003,,,,21,19,40
,2011,82400033,,,,3,9,12
HND-008899,2011,82400045,,,,2,2,4
HND-008900,2011,82400046,,,,4,3,7
HND-008903,2011,82400049,,,,9,15,24
HND-008912,2011,82400062,,,,2,4,6
HND-008861,2011,82400003,,,,33,7,40
,2011,82400033,,,,12,6,18
,2011,82400041,,,,13,8,21
HND-008899,2011,82400045,,,,11,8,19
HND-008900,2011,82400046,,,,4,3,7
HND-008904,2011,82400050,,,,11,10,21
HND-008905,2011,82400053,,,,37,34,71
HND-008912,2011,82400062,,,,10,18,28
HND-008918,2011,82400085,,,,22,24,46
,2011,82400101,,,,3,6,9
,2011,82400104,,,,2,3,5
,2011,82400120,,,,4,11,15
,2011,82400126,,,,2,0,2
,2011,82400127,,,,4,3,7
HND-008894,2011,82400038,,,,38,41,79
HND-008897,2011,82400043,,,,11,7,18
HND-008898,2011,82400044,,,,13,14,27
HND-008903,2011,82400049,,,,19,32,51
HND-008909,2011,82400058,,,,11,9,20
HND-008910,2011,82400059,,,,14,14,28
HND-008911,2011,82400061,,,,11,6,17
,2011,82400091,,,,20,13,33
,2011,82400095,,,,5,7,12
,2011,82400099,,,,6,4,10
HND-008861,2011,82400003,,,,42,50,92
HND-008865,2011,82400007,,,,12,14,26
HND-008866,2011,82400008,,,,5,4,9
HND-008870,2011,82400012,,,,5,7,12
HND-008871,2011,82400013,,,,4,7,11
HND-008872,2011,82400014,,,,4,8,12
HND-008873,2011,82400015,,,,4,3,7
HND-008874,2011,82400016,,,,8,10,18
HND-008877,2011,82400019,,,,0,1,1
HND-008878,2011,82400020,,,,9,10,19
HND-008883,2011,82400025,,,,3,1,4
HND-008884,2011,82400026,,,,24,20,44
HND-008888,2011,82400030,,,,1,1,2
,2011,82400033,,,,13,15,28
HND-008890,2011,82400034,,,,60,57,117
HND-008896,2011,82400042,,,,2,7,9
HND-008900,2011,82400046,,,,4,0,4
HND-008906,2011,82400054,,,,8,0,8
HND-008913,2011,82400063,,,,2,1,3
HND-008915,2011,82400065,,,,8,3,11
HND-008916,2011,82400067,,,,5,3,8
,2011,82400091,,,,18,16,34
,2011,82400095,,,,6,12,18
HND-008921,2011,82400096,,,,7,7,14
HND-008922,2011,82400098,,,,9,5,14
,2011,82400099,,,,5,5,10
,2011,82400102,,,,4,3,7
,2011,82400104,,,,5,1,6
,2011,82400125,,,,2,4,6
HND-008860,2011,82400002,,,,4,1,5
HND-008862,2011,82400004,,,,15,10,25
HND-008863,2011,82400005,,,,3,6,9
HND-008864,2011,82400006,,,,7,7,14
HND-008867,2011,82400009,,,,47,54,101
HND-008868,2011,82400010,,,,10,5,15
HND-008869,2011,82400011,,,,2,3,5
HND-008875,2011,82400017,,,,13,7,20
HND-008876,2011,82400018,,,,16,18,34
HND-008879,2011,82400021,,,,2,1,3
HND-008880,2011,82400022,,,,10,4,14
HND-008881,2011,82400023,,,,7,7,14
HND-008882,2011,82400024,,,,4,3,7
HND-008885,2011,82400027,,,,5,4,9
,2011,82400028,,,,3,6,9
HND-008887,2011,82400029,,,,2,2,4
,2011,82400031,,,,6,2,8
HND-008889,2011,82400032,,,,3,6,9
HND-008891,2011,82400035,,,,53,52,105
,2011,82400036,,,,2,4,6
HND-008893,2011,82400037,,,,58,54,112
HND-008901,2011,82400047,,,,15,16,31
HND-008902,2011,82400048,,,,7,3,10
HND-008914,2011,82400064,,,,4,3,7
HND-008917,2011,82400068,,,,4,3,7
,2011,82400103,,,,3,0,3
,2011,82400126,,,,3,3,6
HND-008861,2011,82400003,,,,46,46,92
HND-008862,2011,82400004,,,,12,14,26
HND-008866,2011,82400008,,,,5,5,10
HND-008867,2011,82400009,,,,55,45,100
HND-008868,2011,82400010,,,,9,8,17
HND-008873,2011,82400015,,,,7,6,13
HND-008874,2011,82400016,,,,2,5,7
HND-008875,2011,82400017,,,,12,11,23
HND-008878,2011,82400020,,,,13,6,19
HND-008879,2011,82400021,,,,2,0,2
HND-008882,2011,82400024,,,,6,5,11
,2011,82400028,,,,0,2,2
HND-008888,2011,82400030,,,,3,2,5
,2011,82400031,,,,1,1,2
HND-008889,2011,82400032,,,,2,1,3
,2011,82400033,,,,6,11,17
HND-008891,2011,82400035,,,,33,38,71
HND-008893,2011,82400037,,,,44,39,83
HND-008900,2011,82400046,,,,2,5,7
HND-008901,2011,82400047,,,,20,22,42
HND-008916,2011,82400067,,,,3,7,10
HND-008917,2011,82400068,,,,2,1,3
HND-008921,2011,82400096,,,,4,2,6
HND-008922,2011,82400098,,,,3,6,9
,2011,82400102,,,,1,2,3
,2011,82400103,,,,0,3,3
,2011,82400104,,,,6,2,8
,2011,82400125,,,,2,4,6
,2011,82400126,,,,1,1,2
HND-008860,2011,82400002,,,,3,6,9
HND-008863,2011,82400005,,,,4,1,5
HND-008864,2011,82400006,,,,10,5,15
HND-008865,2011,82400007,,,,11,8,19
HND-008869,2011,82400011,,,,2,2,4
HND-008870,2011,82400012,,,,4,4,8
HND-008871,2011,82400013,,,,5,2,7
HND-008872,2011,82400014,,,,4,4,8
HND-008876,2011,82400018,,,,7,5,12
HND-008880,2011,82400022,,,,2,5,7
HND-008881,2011,82400023,,,,7,1,8
HND-008883,2011,82400025,,,,4,2,6
HND-008884,2011,82400026,,,,14,18,32
HND-008885,2011,82400027,,,,0,4,4
HND-008887,2011,82400029,,,,0,1,1
HND-008890,2011,82400034,,,,41,38,79
,2011,82400036,,,,2,0,2
HND-008896,2011,82400042,,,,5,1,6
HND-008902,2011,82400048,,,,1,3,4
HND-008906,2011,82400054,,,,2,0,2
HND-008913,2011,82400063,,,,3,5,8
HND-008914,2011,82400064,,,,4,6,10
HND-008915,2011,82400065,,,,3,5,8
,2011,82400091,,,,11,16,27
,2011,82400095,,,,9,8,17
,2011,82400099,,,,4,3,7
HND-008860,2011,82400002,,,,2,0,2
HND-008862,2011,82400004,,,,19,6,25
HND-008866,2011,82400008,,,,0,3,3
HND-008867,2011,82400009,,,,41,38,79
HND-008868,2011,82400010,,,,9,9,18
HND-008869,2011,82400011,,,,2,1,3
HND-008875,2011,82400017,,,,9,15,24
HND-008876,2011,82400018,,,,7,10,17
HND-008878,2011,82400020,,,,10,6,16
HND-008879,2011,82400021,,,,0,2,2
HND-008880,2011,82400022,,,,6,3,9
HND-008881,2011,82400023,,,,2,5,7
HND-008882,2011,82400024,,,,2,2,4
HND-008885,2011,82400027,,,,3,6,9
,2011,82400028,,,,4,5,9
HND-008887,2011,82400029,,,,2,2,4
,2011,82400031,,,,2,0,2
HND-008889,2011,82400032,,,,6,2,8
HND-008891,2011,82400035,,,,37,38,75
,2011,82400036,,,,1,3,4
HND-008893,2011,82400037,,,,42,48,90
HND-008901,2011,82400047,,,,13,12,25
HND-008902,2011,82400048,,,,2,3,5
HND-008916,2011,82400067,,,,3,7,10
HND-008917,2011,82400068,,,,2,2,4
,2011,82400102,,,,2,1,3
,2011,82400104,,,,0,2,2
,2011,82400125,,,,0,1,1
HND-008861,2011,82400003,,,,44,33,77
HND-008863,2011,82400005,,,,4,5,9
HND-008864,2011,82400006,,,,3,4,7
HND-008865,2011,82400007,,,,11,14,25
HND-008870,2011,82400012,,,,5,1,6
HND-008871,2011,82400013,,,,5,11,16
HND-008872,2011,82400014,,,,4,3,7
HND-008873,2011,82400015,,,,4,2,6
HND-008874,2011,82400016,,,,4,3,7
HND-008877,2011,82400019,,,,4,2,6
HND-008883,2011,82400025,,,,3,2,5
HND-008884,2011,82400026,,,,13,16,29
HND-008888,2011,82400030,,,,1,4,5
,2011,82400033,,,,10,8,18
HND-008890,2011,82400034,,,,56,50,106
HND-008896,2011,82400042,,,,3,7,10
HND-008900,2011,82400046,,,,4,5,9
HND-008906,2011,82400054,,,,1,1,2
HND-008913,2011,82400063,,,,0,2,2
HND-008914,2011,82400064,,,,1,2,3
HND-008915,2011,82400065,,,,7,5,12
,2011,82400091,,,,15,14,29
,2011,82400095,,,,7,10,17
HND-008921,2011,82400096,,,,4,8,12
HND-008922,2011,82400098,,,,8,9,17
,2011,82400099,,,,4,1,5
,2011,82400103,,,,0,2,2
,2011,82400126,,,,2,1,3
HND-008861,2011,82400003,,,,59,50,109
HND-008865,2011,82400007,,,,12,14,26
HND-008866,2011,82400008,,,,5,3,8
HND-008870,2011,82400012,,,,0,4,4
HND-008873,2011,82400015,,,,2,3,5
HND-008874,2011,82400016,,,,4,2,6
HND-008875,2011,82400017,,,,7,9,16
HND-008878,2011,82400020,,,,7,11,18
HND-008879,2011,82400021,,,,1,0,1
,2011,82400028,,,,2,4,6
HND-008888,2011,82400030,,,,3,2,5
,2011,82400031,,,,3,1,4
,2011,82400033,,,,2,6,8
HND-008890,2011,82400034,,,,50,52,102
HND-008891,2011,82400035,,,,40,38,78
HND-008896,2011,82400042,,,,3,2,5
HND-008900,2011,82400046,,,,2,2,4
HND-008901,2011,82400047,,,,7,10,17
HND-008915,2011,82400065,,,,3,3,6
HND-008916,2011,82400067,,,,8,7,15
HND-008921,2011,82400096,,,,10,4,14
HND-008922,2011,82400098,,,,8,2,10
,2011,82400099,,,,5,5,10
,2011,82400102,,,,5,2,7
,2011,82400103,,,,1,2,3
,2011,82400126,,,,2,2,4
HND-008860,2011,82400002,,,,0,3,3
HND-008862,2011,82400004,,,,7,5,12
HND-008863,2011,82400005,,,,5,5,10
HND-008864,2011,82400006,,,,15,9,24
HND-008867,2011,82400009,,,,47,54,101
HND-008868,2011,82400010,,,,16,10,26
HND-008869,2011,82400011,,,,2,1,3
HND-008871,2011,82400013,,,,5,6,11
HND-008872,2011,82400014,,,,7,5,12
HND-008876,2011,82400018,,,,3,5,8
HND-008877,2011,82400019,,,,3,2,5
HND-008880,2011,82400022,,,,6,2,8
HND-008881,2011,82400023,,,,8,1,9
HND-008882,2011,82400024,,,,4,7,11
HND-008883,2011,82400025,,,,2,0,2
HND-008884,2011,82400026,,,,15,16,31
HND-008885,2011,82400027,,,,4,1,5
HND-008887,2011,82400029,,,,2,2,4
HND-008889,2011,82400032,,,,10,5,15
,2011,82400036,,,,0,2,2
HND-008893,2011,82400037,,,,43,57,100
HND-008902,2011,82400048,,,,3,1,4
HND-008906,2011,82400054,,,,2,2,4
HND-008913,2011,82400063,,,,3,3,6
HND-008914,2011,82400064,,,,3,3,6
HND-008917,2011,82400068,,,,3,1,4
,2011,82400091,,,,15,12,27
,2011,82400095,,,,4,3,7
,2011,82400104,,,,5,4,9
,2011,82400125,,,,3,5,8
HND-008861,2011,82400003,,,,51,54,105
HND-008865,2011,82400007,,,,13,10,23
HND-008866,2011,82400008,,,,3,5,8
HND-008870,2011,82400012,,,,4,3,7
HND-008871,2011,82400013,,,,10,10,20
HND-008873,2011,82400015,,,,2,2,4
HND-008874,2011,82400016,,,,4,7,11
HND-008877,2011,82400019,,,,3,2,5
HND-008878,2011,82400020,,,,13,14,27
HND-008888,2011,82400030,,,,1,1,2
,2011,82400033,,,,8,3,11
HND-008890,2011,82400034,,,,48,51,99
HND-008891,2011,82400035,,,,46,35,81
HND-008896,2011,82400042,,,,2,4,6
HND-008900,2011,82400046,,,,2,3,5
HND-008915,2011,82400065,,,,3,3,6
HND-008916,2011,82400067,,,,8,7,15
,2011,82400095,,,,6,7,13
HND-008921,2011,82400096,,,,3,8,11
HND-008922,2011,82400098,,,,9,3,12
,2011,82400102,,,,0,2,2
,2011,82400103,,,,3,2,5
,2011,82400126,,,,5,0,5
HND-008860,2011,82400002,,,,3,1,4
HND-008862,2011,82400004,,,,8,11,19
HND-008863,2011,82400005,,,,3,4,7
HND-008864,2011,82400006,,,,5,6,11
HND-008867,2011,82400009,,,,54,36,90
HND-008868,2011,82400010,,,,9,4,13
HND-008869,2011,82400011,,,,2,1,3
HND-008872,2011,82400014,,,,7,3,10
HND-008875,2011,82400017,,,,9,13,22
HND-008876,2011,82400018,,,,5,7,12
HND-008879,2011,82400021,,,,3,1,4
HND-008880,2011,82400022,,,,5,8,13
HND-008881,2011,82400023,,,,4,9,13
HND-008882,2011,82400024,,,,6,7,13
HND-008883,2011,82400025,,,,2,0,2
HND-008884,2011,82400026,,,,17,16,33
HND-008885,2011,82400027,,,,3,4,7
,2011,82400028,,,,2,3,5
HND-008887,2011,82400029,,,,3,4,7
,2011,82400031,,,,0,2,2
HND-008889,2011,82400032,,,,1,4,5
,2011,82400036,,,,1,1,2
HND-008893,2011,82400037,,,,50,39,89
HND-008901,2011,82400047,,,,14,8,22
HND-008902,2011,82400048,,,,2,1,3
HND-008906,2011,82400054,,,,0,2,2
HND-008913,2011,82400063,,,,8,3,11
HND-008914,2011,82400064,,,,0,2,2
,2011,82400091,,,,11,15,26
,2011,82400104,,,,0,1,1
,2011,82400125,,,,2,4,6
HND-008860,2011,82400002,,,,2,1,3
HND-008863,2011,82400005,,,,1,1,2
HND-008864,2011,82400006,,,,5,7,12
HND-008865,2011,82400007,,,,6,15,21
HND-008869,2011,82400011,,,,5,2,7
HND-008870,2011,82400012,,,,5,4,9
HND-008871,2011,82400013,,,,16,10,26
HND-008872,2011,82400014,,,,1,7,8
HND-008876,2011,82400018,,,,4,5,9
HND-008877,2011,82400019,,,,0,6,6
HND-008880,2011,82400022,,,,4,1,5
HND-008881,2011,82400023,,,,4,4,8
HND-008883,2011,82400025,,,,4,1,5
HND-008884,2011,82400026,,,,10,8,18
HND-008885,2011,82400027,,,,3,5,8
HND-008887,2011,82400029,,,,0,2,2
HND-008890,2011,82400034,,,,48,59,107
,2011,82400036,,,,2,2,4
HND-008896,2011,82400042,,,,0,2,2
HND-008902,2011,82400048,,,,1,2,3
HND-008913,2011,82400063,,,,1,2,3
HND-008914,2011,82400064,,,,6,5,11
HND-008915,2011,82400065,,,,6,5,11
,2011,82400095,,,,5,3,8
HND-008861,2011,82400003,,,,60,46,106
HND-008862,2011,82400004,,,,6,5,11
HND-008866,2011,82400008,,,,2,3,5
HND-008867,2011,82400009,,,,27,31,58
HND-008868,2011,82400010,,,,7,6,13
HND-008873,2011,82400015,,,,2,5,7
HND-008874,2011,82400016,,,,5,3,8
HND-008875,2011,82400017,,,,6,7,13
HND-008878,2011,82400020,,,,5,8,13
HND-008879,2011,82400021,,,,1,1,2
HND-008882,2011,82400024,,,,0,4,4
,2011,82400028,,,,2,2,4
HND-008888,2011,82400030,,,,1,2,3
,2011,82400031,,,,1,1,2
HND-008889,2011,82400032,,,,1,5,6
,2011,82400033,,,,3,5,8
HND-008891,2011,82400035,,,,35,34,69
HND-008893,2011,82400037,,,,40,64,104
HND-008900,2011,82400046,,,,2,2,4
HND-008901,2011,82400047,,,,6,7,13
HND-008916,2011,82400067,,,,4,3,7
HND-008921,2011,82400096,,,,10,4,14
HND-008922,2011,82400098,,,,5,3,8
,2011,82400102,,,,4,2,6
,2011,82400103,,,,0,2,2
,2011,82400104,,,,1,3,4
,2011,82400125,,,,1,3,4
,2011,82400126,,,,1,2,3
HND-008861,2011,82400003,,,,49,56,105
HND-008878,2011,82400020,,,,9,8,17
HND-008895,2011,82400040,,,,14,14,28
HND-008919,2011,82400088,,,,70,71,141
,2011,82400113,,,,75,65,140
,2011,82400125,,,,5,13,18
HND-008868,2011,82400010,,,,7,7,14
HND-008893,2011,82400037,,,,21,33,54
HND-008908,2011,82400056,,,,30,45,75
HND-008920,2011,82400089,,,,157,135,292
HND-008861,2011,82400003,,,,46,56,102
HND-008868,2011,82400010,,,,10,7,17
HND-008878,2011,82400020,,,,8,24,32
HND-008893,2011,82400037,,,,17,23,40
HND-008908,2011,82400056,,,,40,34,74
HND-008920,2011,82400089,,,,130,147,277
HND-008895,2011,82400040,,,,17,10,27
HND-008919,2011,82400088,,,,24,28,52
,2011,82400113,,,,48,59,107
,2011,82400125,,,,6,4,10
HND-008861,2011,82400003,,,,35,57,92
HND-008878,2011,82400020,,,,12,13,25
,2011,82400113,,,,45,39,84
,2011,82400125,,,,5,4,9
HND-008868,2011,82400010,,,,3,6,9
HND-008893,2011,82400037,,,,14,17,31
HND-008895,2011,82400040,,,,10,15,25
HND-008908,2011,82400056,,,,26,38,64
HND-008919,2011,82400088,,,,29,33,62
HND-008920,2011,82400089,,,,101,115,216
HND-008895,2011,82400040,,,,5,6,11
HND-008919,2011,82400088,,,,79,89,168
,2011,82400113,,,,76,119,195
,2011,82400125,,,,10,17,27
HND-008908,2011,82400056,,,,29,32,61
HND-008920,2011,82400089,,,,168,251,419
HND-008908,2011,82400056,,,,19,31,50
,2011,82400113,,,,64,89,153
,2011,82400125,,,,3,9,12
HND-008895,2011,82400040,,,,4,5,9
HND-008919,2011,82400088,,,,21,35,56
HND-008920,2011,82400089,,,,96,143,239
HND-008908,2011,82400056,,,,14,30,44
HND-008919,2011,82400088,,,,15,33,48
HND-008920,2011,82400089,,,,74,111,185
,2011,82400113,,,,1,15,16
HND-008933,2011,82500007,,,,4,5,9
,2011,82500034,,,,3,5,8
,2011,82500035,,,,5,4,9
,2011,82500036,,,,0,2,2
,2011,82500024,,,,3,7,10
,2011,82500025,,,,3,1,4
HND-008947,2011,82500037,,,,4,1,5
HND-008946,2011,82500026,,,,0,1,1
,2011,82500023,,,,5,3,8
HND-008939,2011,82500013,,,,7,11,18
,2011,82500020,,,,2,6,8
,2011,82500022,,,,4,2,6
,2011,82500023,,,,3,4,7
HND-008946,2011,82500026,,,,3,5,8
,2011,82500022,,,,2,1,3
HND-008946,2011,82500026,,,,5,3,8
HND-008940,2011,82500014,,,,8,12,20
,2011,82500020,,,,8,4,12
,2011,82500023,,,,1,2,3
HND-008930,2011,82500004,,,,20,19,39
HND-008932,2011,82500006,,,,16,25,41
HND-008934,2011,82500008,,,,4,3,7
HND-008935,2011,82500009,,,,4,4,8
HND-008937,2011,82500011,,,,15,7,22
HND-008938,2011,82500012,,,,3,4,7
HND-008943,2011,82500018,,,,4,3,7
HND-008944,2011,82500019,,,,4,4,8
HND-008931,2011,82500005,,,,8,5,13
HND-008933,2011,82500007,,,,3,2,5
HND-008936,2011,82500010,,,,2,3,5
HND-008942,2011,82500017,,,,1,3,4
HND-008935,2011,82500009,,,,6,3,9
HND-008936,2011,82500010,,,,1,3,4
HND-008938,2011,82500012,,,,3,3,6
HND-008942,2011,82500017,,,,1,0,1
HND-008944,2011,82500019,,,,0,1,1
HND-008930,2011,82500004,,,,21,9,30
HND-008931,2011,82500005,,,,4,2,6
HND-008932,2011,82500006,,,,10,16,26
HND-008933,2011,82500007,,,,6,1,7
HND-008934,2011,82500008,,,,1,3,4
HND-008937,2011,82500011,,,,10,9,19
HND-008943,2011,82500018,,,,1,2,3
HND-008931,2011,82500005,,,,6,3,9
HND-008933,2011,82500007,,,,2,4,6
HND-008935,2011,82500009,,,,7,3,10
HND-008936,2011,82500010,,,,3,2,5
HND-008942,2011,82500017,,,,2,1,3
HND-008930,2011,82500004,,,,18,15,33
HND-008932,2011,82500006,,,,9,12,21
HND-008934,2011,82500008,,,,7,2,9
HND-008937,2011,82500011,,,,3,7,10
HND-008938,2011,82500012,,,,3,1,4
HND-008943,2011,82500018,,,,3,4,7
HND-008944,2011,82500019,,,,0,2,2
HND-008933,2011,82500007,,,,1,3,4
HND-008936,2011,82500010,,,,1,2,3
HND-008937,2011,82500011,,,,4,4,8
HND-008942,2011,82500017,,,,2,1,3
HND-008943,2011,82500018,,,,4,6,10
HND-008930,2011,82500004,,,,18,13,31
HND-008931,2011,82500005,,,,4,3,7
HND-008932,2011,82500006,,,,8,13,21
HND-008934,2011,82500008,,,,7,4,11
HND-008935,2011,82500009,,,,5,2,7
HND-008938,2011,82500012,,,,3,0,3
HND-008944,2011,82500019,,,,1,2,3
HND-008931,2011,82500005,,,,5,6,11
HND-008933,2011,82500007,,,,6,3,9
HND-008936,2011,82500010,,,,3,2,5
HND-008937,2011,82500011,,,,4,7,11
HND-008942,2011,82500017,,,,1,1,2
HND-008943,2011,82500018,,,,1,4,5
HND-008930,2011,82500004,,,,19,22,41
HND-008932,2011,82500006,,,,13,8,21
HND-008934,2011,82500008,,,,3,4,7
HND-008935,2011,82500009,,,,6,5,11
HND-008938,2011,82500012,,,,2,3,5
HND-008944,2011,82500019,,,,1,5,6
HND-008930,2011,82500004,,,,17,21,38
HND-008931,2011,82500005,,,,3,2,5
HND-008935,2011,82500009,,,,6,5,11
HND-008938,2011,82500012,,,,2,4,6
HND-008942,2011,82500017,,,,2,2,4
HND-008944,2011,82500019,,,,4,2,6
HND-008932,2011,82500006,,,,13,19,32
HND-008933,2011,82500007,,,,1,2,3
HND-008934,2011,82500008,,,,6,10,16
HND-008936,2011,82500010,,,,4,1,5
HND-008937,2011,82500011,,,,9,2,11
HND-008943,2011,82500018,,,,1,4,5
HND-008941,2011,82500015,,,,37,35,72
,2011,82500033,,,,22,21,43
,2011,82500033,,,,21,19,40
HND-008941,2011,82500015,,,,25,37,62
,2011,82500033,,,,18,20,38
HND-008941,2011,82500015,,,,26,21,47
HND-008941,2011,82500015,,,,14,18,32
,2011,82500033,,,,9,19,28
HND-008941,2011,82500015,,,,4,19,23
,2011,82500033,,,,3,13,16
HND-008941,2011,82500015,,,,5,14,19
HND-008959,2011,82600015,,,,9,1,10
,2011,82600044,,,,3,6,9
,2011,82600045,,,,6,6,12
,2011,82600050,,,,2,3,5
,2011,82600051,,,,3,2,5
,2011,82600053,,,,5,1,6
,2011,82600041,,,,6,2,8
,2011,82600047,,,,10,5,15
,2011,82600048,,,,3,2,5
HND-008968,2011,82600052,,,,4,1,5
,2011,82600025,,,,2,1,3
HND-008966,2011,82600032,,,,7,3,10
HND-008964,2011,82600023,,,,4,3,7
,2011,82600054,,,,6,2,8
HND-008962,2011,82600019,,,,15,16,31
HND-008964,2011,82600023,,,,10,10,20
,2011,82600024,,,,7,12,19
HND-008966,2011,82600032,,,,3,7,10
,2011,82600034,,,,9,3,12
,2011,82600036,,,,3,3,6
,2011,82600022,,,,4,2,6
,2011,82600025,,,,7,7,14
,2011,82600026,,,,2,5,7
HND-008967,2011,82600035,,,,4,2,6
,2011,82600040,,,,13,8,21
,2011,82600054,,,,8,2,10
HND-008962,2011,82600019,,,,38,28,66
HND-008966,2011,82600032,,,,14,8,22
HND-008967,2011,82600035,,,,3,2,5
,2011,82600036,,,,9,9,18
,2011,82600040,,,,15,11,26
,2011,82600054,,,,16,16,32
,2011,82600022,,,,8,11,19
HND-008964,2011,82600023,,,,10,11,21
,2011,82600024,,,,10,7,17
,2011,82600025,,,,18,14,32
,2011,82600026,,,,13,11,24
,2011,82600034,,,,3,8,11
HND-008948,2011,82600003,,,,10,12,22
HND-008950,2011,82600005,,,,3,2,5
HND-008951,2011,82600006,,,,1,4,5
HND-008953,2011,82600008,,,,1,0,1
HND-008954,2011,82600009,,,,4,3,7
HND-008956,2011,82600011,,,,1,2,3
HND-008957,2011,82600012,,,,3,6,9
HND-008958,2011,82600013,,,,0,1,1
,2011,82600014,,,,14,14,28
HND-008959,2011,82600015,,,,6,4,10
HND-008960,2011,82600016,,,,11,14,25
HND-008965,2011,82600031,,,,15,8,23
,2011,82600036,,,,19,9,28
,2011,82600039,,,,18,25,43
,2011,82600054,,,,5,1,6
HND-008949,2011,82600004,,,,47,50,97
HND-008952,2011,82600007,,,,20,21,41
HND-008955,2011,82600010,,,,4,5,9
HND-008961,2011,82600017,,,,4,5,9
HND-008967,2011,82600035,,,,2,2,4
,2011,82600046,,,,1,4,5
HND-008948,2011,82600003,,,,10,12,22
HND-008949,2011,82600004,,,,36,61,97
HND-008953,2011,82600008,,,,1,0,1
HND-008954,2011,82600009,,,,2,3,5
HND-008955,2011,82600010,,,,5,4,9
HND-008958,2011,82600013,,,,1,0,1
HND-008967,2011,82600035,,,,7,3,10
,2011,82600036,,,,13,12,25
,2011,82600039,,,,18,19,37
HND-008950,2011,82600005,,,,6,7,13
HND-008951,2011,82600006,,,,4,3,7
HND-008952,2011,82600007,,,,13,6,19
HND-008957,2011,82600012,,,,7,2,9
,2011,82600014,,,,17,15,32
HND-008959,2011,82600015,,,,3,2,5
HND-008960,2011,82600016,,,,13,13,26
HND-008961,2011,82600017,,,,3,5,8
HND-008965,2011,82600031,,,,6,9,15
,2011,82600046,,,,3,3,6
,2011,82600054,,,,1,3,4
HND-008948,2011,82600003,,,,14,10,24
HND-008953,2011,82600008,,,,4,3,7
HND-008954,2011,82600009,,,,3,1,4
HND-008956,2011,82600011,,,,1,0,1
HND-008957,2011,82600012,,,,5,4,9
HND-008958,2011,82600013,,,,0,1,1
,2011,82600014,,,,13,9,22
HND-008967,2011,82600035,,,,6,6,12
,2011,82600039,,,,13,20,33
,2011,82600046,,,,3,10,13
HND-008949,2011,82600004,,,,37,36,73
HND-008950,2011,82600005,,,,4,7,11
HND-008951,2011,82600006,,,,2,1,3
HND-008952,2011,82600007,,,,14,13,27
HND-008955,2011,82600010,,,,5,3,8
HND-008959,2011,82600015,,,,2,4,6
HND-008960,2011,82600016,,,,9,10,19
HND-008961,2011,82600017,,,,7,4,11
HND-008965,2011,82600031,,,,12,9,21
,2011,82600036,,,,9,15,24
,2011,82600054,,,,10,11,21
HND-008949,2011,82600004,,,,55,49,104
HND-008952,2011,82600007,,,,20,10,30
HND-008953,2011,82600008,,,,1,3,4
HND-008955,2011,82600010,,,,0,6,6
HND-008956,2011,82600011,,,,2,1,3
HND-008961,2011,82600017,,,,4,7,11
HND-008967,2011,82600035,,,,6,3,9
,2011,82600036,,,,8,12,20
,2011,82600039,,,,25,20,45
HND-008948,2011,82600003,,,,12,9,21
HND-008950,2011,82600005,,,,10,5,15
HND-008951,2011,82600006,,,,1,2,3
HND-008954,2011,82600009,,,,4,1,5
HND-008957,2011,82600012,,,,1,3,4
HND-008958,2011,82600013,,,,5,3,8
,2011,82600014,,,,7,8,15
HND-008959,2011,82600015,,,,5,2,7
HND-008960,2011,82600016,,,,7,6,13
HND-008965,2011,82600031,,,,8,11,19
,2011,82600046,,,,9,5,14
,2011,82600054,,,,4,3,7
HND-008949,2011,82600004,,,,42,48,90
HND-008952,2011,82600007,,,,15,13,28
HND-008953,2011,82600008,,,,4,2,6
HND-008955,2011,82600010,,,,7,7,14
HND-008956,2011,82600011,,,,3,0,3
HND-008961,2011,82600017,,,,7,5,12
HND-008965,2011,82600031,,,,13,11,24
HND-008967,2011,82600035,,,,6,5,11
,2011,82600036,,,,17,13,30
,2011,82600039,,,,20,16,36
HND-008948,2011,82600003,,,,9,12,21
HND-008950,2011,82600005,,,,10,8,18
HND-008951,2011,82600006,,,,2,3,5
HND-008954,2011,82600009,,,,4,5,9
HND-008957,2011,82600012,,,,4,3,7
HND-008958,2011,82600013,,,,2,2,4
,2011,82600014,,,,9,11,20
HND-008959,2011,82600015,,,,2,5,7
HND-008960,2011,82600016,,,,8,11,19
,2011,82600046,,,,1,2,3
,2011,82600054,,,,4,7,11
HND-008950,2011,82600005,,,,5,5,10
HND-008951,2011,82600006,,,,4,3,7
HND-008952,2011,82600007,,,,17,14,31
HND-008957,2011,82600012,,,,1,6,7
,2011,82600014,,,,19,7,26
HND-008959,2011,82600015,,,,1,3,4
HND-008960,2011,82600016,,,,12,15,27
HND-008961,2011,82600017,,,,8,2,10
HND-008965,2011,82600031,,,,5,12,17
,2011,82600046,,,,3,3,6
HND-008948,2011,82600003,,,,12,12,24
HND-008949,2011,82600004,,,,50,37,87
HND-008953,2011,82600008,,,,5,1,6
HND-008954,2011,82600009,,,,2,5,7
HND-008955,2011,82600010,,,,5,4,9
HND-008956,2011,82600011,,,,2,1,3
HND-008958,2011,82600013,,,,1,3,4
HND-008967,2011,82600035,,,,2,3,5
,2011,82600036,,,,16,7,23
,2011,82600039,,,,19,22,41
HND-008952,2011,82600007,,,,28,27,55
HND-008963,2011,82600021,,,,116,119,235
,2011,82600036,,,,13,17,30
,2011,82600049,,,,23,28,51
,2011,82600055,,,,4,1,5
HND-008963,2011,82600021,,,,95,74,169
,2011,82600036,,,,15,18,33
,2011,82600049,,,,16,22,38
,2011,82600055,,,,8,3,11
HND-008952,2011,82600007,,,,20,22,42
HND-008952,2011,82600007,,,,21,14,35
,2011,82600036,,,,8,18,26
,2011,82600055,,,,4,2,6
HND-008963,2011,82600021,,,,78,77,155
,2011,82600036,,,,30,27,57
,2011,82600055,,,,7,8,15
HND-008952,2011,82600007,,,,7,17,24
HND-008963,2011,82600021,,,,95,72,167
HND-008952,2011,82600007,,,,8,14,22
,2011,82600036,,,,16,26,42
HND-008963,2011,82600021,,,,40,62,102
HND-008952,2011,82600007,,,,8,19,27
HND-008963,2011,82600021,,,,32,60,92
,2011,82600036,,,,15,8,23
HND-008981,2011,82700017,,,,6,6,12
,2011,82700018,,,,3,8,11
,2011,82700019,,,,9,16,25
HND-008979,2011,82700014,,,,7,7,14
HND-008982,2011,82700020,,,,5,3,8
HND-008977,2011,82700009,,,,1,2,3
,2011,82700010,,,,6,3,9
HND-008975,2011,82700007,,,,8,17,25
,2011,82700010,,,,9,9,18
HND-008977,2011,82700009,,,,4,6,10
,2011,82700012,,,,8,6,14
HND-008980,2011,82700016,,,,13,9,22
,2011,82700021,,,,1,0,1
HND-008977,2011,82700009,,,,7,8,15
,2011,82700012,,,,10,5,15
,2011,82700021,,,,2,3,5
HND-008975,2011,82700007,,,,64,57,121
,2011,82700010,,,,12,7,19
HND-008969,2011,82700001,,,,143,89,232
HND-008970,2011,82700002,,,,4,1,5
HND-008973,2011,82700005,,,,13,10,23
HND-008974,2011,82700006,,,,3,10,13
HND-008978,2011,82700011,,,,4,0,4
HND-008971,2011,82700003,,,,3,1,4
HND-008972,2011,82700004,,,,3,8,11
HND-008969,2011,82700001,,,,123,103,226
HND-008978,2011,82700011,,,,1,5,6
HND-008970,2011,82700002,,,,1,0,1
HND-008971,2011,82700003,,,,0,2,2
HND-008972,2011,82700004,,,,4,4,8
HND-008973,2011,82700005,,,,16,10,26
HND-008974,2011,82700006,,,,3,3,6
HND-008971,2011,82700003,,,,3,4,7
HND-008972,2011,82700004,,,,4,2,6
HND-008969,2011,82700001,,,,116,95,211
HND-008970,2011,82700002,,,,2,2,4
HND-008973,2011,82700005,,,,19,11,30
HND-008974,2011,82700006,,,,6,9,15
HND-008978,2011,82700011,,,,2,0,2
HND-008969,2011,82700001,,,,107,77,184
HND-008973,2011,82700005,,,,10,9,19
HND-008974,2011,82700006,,,,10,10,20
HND-008978,2011,82700011,,,,1,0,1
HND-008970,2011,82700002,,,,2,2,4
HND-008971,2011,82700003,,,,5,1,6
HND-008972,2011,82700004,,,,5,3,8
HND-008969,2011,82700001,,,,94,102,196
HND-008973,2011,82700005,,,,17,10,27
HND-008974,2011,82700006,,,,6,12,18
HND-008978,2011,82700011,,,,2,1,3
HND-008970,2011,82700002,,,,2,1,3
HND-008971,2011,82700003,,,,2,7,9
HND-008972,2011,82700004,,,,3,5,8
HND-008970,2011,82700002,,,,2,3,5
HND-008971,2011,82700003,,,,0,2,2
HND-008972,2011,82700004,,,,5,6,11
HND-008973,2011,82700005,,,,13,16,29
HND-008969,2011,82700001,,,,100,95,195
HND-008978,2011,82700011,,,,3,2,5
HND-008976,2011,82700008,,,,57,97,154
HND-008976,2011,82700008,,,,64,78,142
HND-008976,2011,82700008,,,,43,53,96
HND-008976,2011,82700008,,,,40,70,110
HND-008976,2011,82700008,,,,60,50,110
HND-008976,2011,82700008,,,,35,63,98
,2011,82800030,,,,1,4,5
HND-009004,2011,82800032,,,,2,5,7
HND-009008,2011,82800046,,,,3,6,9
,2011,82800055,,,,6,5,11
,2011,82800062,,,,3,2,5
HND-009014,2011,82800063,,,,2,5,7
,2011,82800064,,,,5,6,11
,2011,82800051,,,,4,1,5
HND-009011,2011,82800052,,,,4,7,11
,2011,82800054,,,,5,7,12
HND-009007,2011,82800045,,,,0,4,4
HND-009007,2011,82800045,,,,3,5,8
HND-008998,2011,82800016,,,,16,12,28
HND-009000,2011,82800019,,,,15,12,27
HND-009007,2011,82800045,,,,1,5,6
HND-008999,2011,82800018,,,,16,12,28
HND-008986,2011,82800003,,,,26,31,57
HND-008990,2011,82800007,,,,1,2,3
HND-008991,2011,82800008,,,,6,4,10
HND-008993,2011,82800010,,,,6,3,9
HND-008994,2011,82800011,,,,3,2,5
HND-009001,2011,82800020,,,,2,4,6
HND-009005,2011,82800034,,,,0,1,1
HND-009006,2011,82800035,,,,1,1,2
,2011,82800059,,,,2,0,2
HND-009013,2011,82800061,,,,7,8,15
HND-008985,2011,82800002,,,,10,4,14
HND-008987,2011,82800004,,,,2,2,4
HND-008988,2011,82800005,,,,21,12,33
HND-008989,2011,82800006,,,,9,3,12
HND-008992,2011,82800009,,,,18,21,39
HND-008995,2011,82800012,,,,1,4,5
HND-008996,2011,82800013,,,,8,2,10
HND-008997,2011,82800015,,,,4,1,5
HND-009002,2011,82800021,,,,2,2,4
HND-009003,2011,82800022,,,,2,1,3
HND-009009,2011,82800048,,,,6,6,12
HND-009010,2011,82800050,,,,3,5,8
HND-009015,2011,82800065,,,,15,21,36
HND-008986,2011,82800003,,,,34,27,61
HND-008988,2011,82800005,,,,12,11,23
HND-008989,2011,82800006,,,,2,2,4
HND-008990,2011,82800007,,,,2,1,3
HND-008993,2011,82800010,,,,0,1,1
HND-008997,2011,82800015,,,,5,0,5
HND-009003,2011,82800022,,,,1,4,5
HND-009006,2011,82800035,,,,1,2,3
HND-009013,2011,82800061,,,,2,1,3
HND-008985,2011,82800002,,,,8,7,15
HND-008987,2011,82800004,,,,2,2,4
HND-008991,2011,82800008,,,,4,1,5
HND-008992,2011,82800009,,,,12,14,26
HND-008995,2011,82800012,,,,3,4,7
HND-008996,2011,82800013,,,,3,4,7
HND-009001,2011,82800020,,,,2,5,7
HND-009002,2011,82800021,,,,1,2,3
HND-009005,2011,82800034,,,,1,1,2
HND-009009,2011,82800048,,,,4,6,10
,2011,82800059,,,,0,1,1
HND-009015,2011,82800065,,,,2,6,8
HND-008986,2011,82800003,,,,32,35,67
HND-008990,2011,82800007,,,,1,0,1
HND-008991,2011,82800008,,,,2,5,7
HND-008993,2011,82800010,,,,1,2,3
HND-008994,2011,82800011,,,,1,1,2
HND-009001,2011,82800020,,,,2,2,4
HND-009006,2011,82800035,,,,3,3,6
HND-009010,2011,82800050,,,,8,4,12
HND-009013,2011,82800061,,,,3,5,8
HND-008985,2011,82800002,,,,3,6,9
HND-008987,2011,82800004,,,,3,5,8
HND-008988,2011,82800005,,,,19,23,42
HND-008989,2011,82800006,,,,2,5,7
HND-008992,2011,82800009,,,,14,13,27
HND-008995,2011,82800012,,,,5,3,8
HND-008996,2011,82800013,,,,1,0,1
HND-008997,2011,82800015,,,,2,1,3
HND-009002,2011,82800021,,,,1,3,4
HND-009003,2011,82800022,,,,3,1,4
HND-009005,2011,82800034,,,,1,2,3
HND-009009,2011,82800048,,,,9,4,13
,2011,82800059,,,,3,2,5
HND-009015,2011,82800065,,,,6,2,8
HND-008985,2011,82800002,,,,9,9,18
HND-008988,2011,82800005,,,,9,15,24
HND-008989,2011,82800006,,,,2,7,9
HND-008990,2011,82800007,,,,1,1,2
HND-008992,2011,82800009,,,,26,18,44
HND-009003,2011,82800022,,,,2,1,3
HND-009005,2011,82800034,,,,2,6,8
HND-009006,2011,82800035,,,,4,2,6
,2011,82800059,,,,3,3,6
HND-009015,2011,82800065,,,,3,9,12
HND-008986,2011,82800003,,,,30,34,64
HND-008987,2011,82800004,,,,3,2,5
HND-008991,2011,82800008,,,,4,5,9
HND-008993,2011,82800010,,,,0,1,1
HND-008994,2011,82800011,,,,0,2,2
HND-008995,2011,82800012,,,,7,5,12
HND-008996,2011,82800013,,,,7,4,11
HND-009001,2011,82800020,,,,3,3,6
HND-009002,2011,82800021,,,,0,1,1
HND-009009,2011,82800048,,,,1,2,3
HND-009010,2011,82800050,,,,0,1,1
HND-009013,2011,82800061,,,,2,2,4
HND-008985,2011,82800002,,,,3,6,9
HND-008987,2011,82800004,,,,2,4,6
HND-008988,2011,82800005,,,,14,19,33
HND-008989,2011,82800006,,,,4,4,8
HND-008992,2011,82800009,,,,18,29,47
HND-008995,2011,82800012,,,,1,2,3
HND-008996,2011,82800013,,,,3,3,6
HND-008997,2011,82800015,,,,1,1,2
HND-009003,2011,82800022,,,,1,3,4
HND-009005,2011,82800034,,,,4,2,6
HND-009006,2011,82800035,,,,1,1,2
,2011,82800059,,,,3,2,5
HND-009015,2011,82800065,,,,0,4,4
HND-008986,2011,82800003,,,,26,28,54
HND-008990,2011,82800007,,,,1,3,4
HND-008991,2011,82800008,,,,1,1,2
HND-008993,2011,82800010,,,,2,3,5
HND-008994,2011,82800011,,,,4,1,5
HND-009001,2011,82800020,,,,1,1,2
HND-009009,2011,82800048,,,,1,2,3
HND-009010,2011,82800050,,,,0,1,1
HND-008985,2011,82800002,,,,8,6,14
HND-008987,2011,82800004,,,,3,5,8
HND-008991,2011,82800008,,,,1,5,6
HND-008992,2011,82800009,,,,27,30,57
HND-008994,2011,82800011,,,,2,0,2
HND-008995,2011,82800012,,,,1,6,7
HND-008996,2011,82800013,,,,3,4,7
HND-009002,2011,82800021,,,,1,3,4
HND-009005,2011,82800034,,,,0,1,1
HND-009009,2011,82800048,,,,3,1,4
,2011,82800059,,,,1,0,1
HND-009015,2011,82800065,,,,0,2,2
HND-008986,2011,82800003,,,,12,23,35
HND-008988,2011,82800005,,,,11,16,27
HND-008989,2011,82800006,,,,5,2,7
HND-008990,2011,82800007,,,,3,3,6
HND-008993,2011,82800010,,,,1,1,2
HND-008997,2011,82800015,,,,0,1,1
HND-009003,2011,82800022,,,,1,1,2
HND-009006,2011,82800035,,,,1,1,2
HND-008984,2011,82800001,,,,29,44,73
HND-009012,2011,82800060,,,,18,22,40
HND-008992,2011,82800009,,,,7,10,17
HND-008984,2011,82800001,,,,15,20,35
HND-008992,2011,82800009,,,,20,22,42
HND-009012,2011,82800060,,,,21,21,42
HND-008984,2011,82800001,,,,17,30,47
HND-009012,2011,82800060,,,,6,10,16
HND-008992,2011,82800009,,,,14,22,36
HND-009012,2011,82800060,,,,6,13,19
HND-008984,2011,82800001,,,,4,17,21
HND-008984,2011,82800001,,,,9,17,26
HND-009012,2011,82800060,,,,8,5,13
HND-008984,2011,82800001,,,,13,18,31
,2011,90100092,,,,0,8,8
,2011,90100099,,,,4,4,8
HND-017300,2011,90100106,,,,7,6,13
HND-017301,2011,90100107,,,,5,8,13
,2011,90100139,,,,13,5,18
HND-017318,2011,90100146,,,,9,8,17
,2011,90100150,,,,4,5,9
,2011,90100191,,,,13,9,22
,2011,90100196,,,,9,10,19
,2011,90100206,,,,4,11,15
HND-017325,2011,90100208,,,,4,4,8
HND-017328,2011,90100215,,,,10,8,18
,2011,90100216,,,,9,10,19
,2011,90100228,,,,3,10,13
,2011,90100266,,,,5,9,14
,2011,90100270,,,,6,6,12
,2011,90100274,,,,5,3,8
,2011,90100275,,,,9,2,11
,2011,90100276,,,,2,6,8
,2011,90100284,,,,9,7,16
,2011,90100285,,,,8,7,15
HND-017342,2011,90100286,,,,5,7,12
,2011,90100287,,,,8,5,13
,2011,90100288,,,,12,13,25
,2011,90100294,,,,3,5,8
HND-017351,2011,90100309,,,,10,10,20
,2011,90100310,,,,9,12,21
,2011,90100314,,,,6,8,14
HND-017354,2011,90100315,,,,10,10,20
,2011,90100316,,,,6,6,12
HND-017355,2011,90100317,,,,7,6,13
,2011,90100321,,,,3,5,8
,2011,90100322,,,,9,10,19
,2011,90100323,,,,12,6,18
,2011,90100324,,,,3,6,9
,2011,90100326,,,,4,5,9
HND-017360,2011,90100327,,,,9,13,22
,2011,90100330,,,,6,7,13
HND-017364,2011,90100331,,,,6,7,13
,2011,90100337,,,,8,8,16
HND-017257,2011,90100046,,,,11,2,13
HND-017302,2011,90100108,,,,6,6,12
HND-017307,2011,90100114,,,,7,6,13
,2011,90100136,,,,4,5,9
,2011,90100142,,,,5,5,10
,2011,90100143,,,,5,5,10
,2011,90100149,,,,5,8,13
HND-017321,2011,90100183,,,,4,8,12
HND-017322,2011,90100193,,,,10,8,18
,2011,90100199,,,,4,6,10
,2011,90100202,,,,10,13,23
,2011,90100203,,,,7,8,15
,2011,90100204,,,,10,4,14
HND-017326,2011,90100211,,,,13,13,26
HND-017327,2011,90100212,,,,5,9,14
HND-017331,2011,90100229,,,,12,4,16
HND-017332,2011,90100233,,,,22,16,38
,2011,90100269,,,,7,4,11
,2011,90100271,,,,4,3,7
,2011,90100272,,,,4,4,8
HND-017337,2011,90100273,,,,5,2,7
HND-017339,2011,90100279,,,,6,16,22
,2011,90100280,,,,17,17,34
HND-017340,2011,90100281,,,,10,8,18
,2011,90100282,,,,6,13,19
,2011,90100283,,,,8,11,19
,2011,90100289,,,,8,8,16
HND-017343,2011,90100290,,,,10,6,16
,2011,90100291,,,,5,5,10
,2011,90100292,,,,9,5,14
,2011,90100293,,,,6,4,10
HND-017352,2011,90100312,,,,10,14,24
HND-017353,2011,90100313,,,,7,8,15
HND-017356,2011,90100318,,,,5,6,11
HND-017357,2011,90100319,,,,10,11,21
,2011,90100320,,,,13,13,26
HND-017361,2011,90100328,,,,3,5,8
,2011,90100329,,,,12,10,22
,2011,90100332,,,,7,4,11
,2011,90100333,,,,7,6,13
HND-017365,2011,90100334,,,,10,8,18
HND-017366,2011,90100335,,,,5,12,17
,2011,90100336,,,,11,12,23
,2011,90100062,,,,20,19,39
HND-017275,2011,90100067,,,,7,8,15
HND-017276,2011,90100069,,,,4,2,6
,2011,90100070,,,,10,5,15
,2011,90100072,,,,4,4,8
HND-017280,2011,90100073,,,,6,2,8
HND-017283,2011,90100078,,,,3,2,5
HND-017284,2011,90100079,,,,5,4,9
HND-017285,2011,90100080,,,,5,6,11
,2011,90100082,,,,6,3,9
,2011,90100083,,,,14,9,23
,2011,90100089,,,,4,10,14
,2011,90100090,,,,1,4,5
,2011,90100099,,,,3,3,6
,2011,90100100,,,,5,6,11
HND-017300,2011,90100106,,,,1,5,6
HND-017301,2011,90100107,,,,8,10,18
HND-017302,2011,90100108,,,,7,4,11
HND-017304,2011,90100110,,,,10,5,15
HND-017309,2011,90100117,,,,8,10,18
,2011,90100151,,,,9,8,17
HND-017359,2011,90100325,,,,3,2,5
HND-017272,2011,90100063,,,,8,11,19
HND-017273,2011,90100064,,,,18,17,35
,2011,90100068,,,,9,16,25
HND-017282,2011,90100075,,,,3,6,9
,2011,90100076,,,,1,4,5
,2011,90100077,,,,2,3,5
HND-017286,2011,90100081,,,,7,4,11
,2011,90100084,,,,2,2,4
,2011,90100085,,,,3,1,4
,2011,90100086,,,,7,2,9
,2011,90100096,,,,9,8,17
HND-017295,2011,90100097,,,,17,10,27
HND-017296,2011,90100098,,,,4,3,7
,2011,90100104,,,,2,2,4
,2011,90100112,,,,8,7,15
,2011,90100277,,,,7,3,10
,2011,90100278,,,,5,4,9
HND-017232,2011,90100019,,,,7,10,17
HND-017274,2011,90100065,,,,2,6,8
HND-017275,2011,90100067,,,,5,6,11
,2011,90100070,,,,18,2,20
,2011,90100072,,,,8,18,26
HND-017280,2011,90100073,,,,10,16,26
HND-017281,2011,90100074,,,,17,18,35
HND-017284,2011,90100079,,,,4,4,8
,2011,90100085,,,,1,1,2
,2011,90100086,,,,3,2,5
HND-017295,2011,90100097,,,,4,8,12
,2011,90100099,,,,3,3,6
,2011,90100100,,,,1,2,3
HND-017300,2011,90100106,,,,1,5,6
,2011,90100112,,,,15,11,26
HND-017309,2011,90100117,,,,17,13,30
,2011,90100151,,,,7,5,12
HND-017319,2011,90100177,,,,11,7,18
HND-017359,2011,90100325,,,,5,2,7
,2011,90100062,,,,8,8,16
HND-017272,2011,90100063,,,,7,15,22
HND-017273,2011,90100064,,,,34,34,68
,2011,90100068,,,,5,4,9
HND-017276,2011,90100069,,,,8,12,20
HND-017278,2011,90100071,,,,20,22,42
HND-017282,2011,90100075,,,,10,10,20
,2011,90100076,,,,3,3,6
,2011,90100077,,,,6,3,9
HND-017283,2011,90100078,,,,16,2,18
HND-017285,2011,90100080,,,,8,10,18
HND-017286,2011,90100081,,,,7,10,17
,2011,90100082,,,,6,7,13
,2011,90100083,,,,7,13,20
,2011,90100084,,,,5,4,9
,2011,90100089,,,,8,10,18
,2011,90100090,,,,5,2,7
,2011,90100096,,,,7,5,12
HND-017296,2011,90100098,,,,4,4,8
,2011,90100104,,,,2,3,5
HND-017302,2011,90100108,,,,9,0,9
HND-017304,2011,90100110,,,,18,17,35
HND-017305,2011,90100111,,,,6,8,14
HND-017307,2011,90100114,,,,8,4,12
,2011,90100277,,,,15,13,28
,2011,90100278,,,,7,4,11
,2011,90100062,,,,4,8,12
HND-017272,2011,90100063,,,,21,20,41
HND-017273,2011,90100064,,,,60,42,102
,2011,90100068,,,,10,6,16
HND-017276,2011,90100069,,,,15,18,33
HND-017278,2011,90100071,,,,26,18,44
HND-017282,2011,90100075,,,,16,5,21
,2011,90100076,,,,6,8,14
,2011,90100077,,,,5,7,12
HND-017283,2011,90100078,,,,14,14,28
HND-017285,2011,90100080,,,,5,7,12
HND-017286,2011,90100081,,,,8,22,30
,2011,90100083,,,,8,8,16
,2011,90100084,,,,21,17,38
HND-017290,2011,90100088,,,,10,13,23
,2011,90100089,,,,7,7,14
,2011,90100096,,,,21,12,33
HND-017295,2011,90100097,,,,5,5,10
HND-017296,2011,90100098,,,,4,11,15
,2011,90100100,,,,3,5,8
HND-017300,2011,90100106,,,,2,5,7
HND-017302,2011,90100108,,,,14,16,30
HND-017304,2011,90100110,,,,26,19,45
HND-017305,2011,90100111,,,,13,14,27
HND-017307,2011,90100114,,,,5,4,9
HND-017309,2011,90100117,,,,18,14,32
HND-017232,2011,90100019,,,,12,14,26
HND-017274,2011,90100065,,,,6,14,20
HND-017275,2011,90100067,,,,4,10,14
,2011,90100070,,,,14,13,27
,2011,90100072,,,,11,13,24
HND-017280,2011,90100073,,,,13,17,30
HND-017281,2011,90100074,,,,16,23,39
HND-017284,2011,90100079,,,,2,5,7
,2011,90100082,,,,6,12,18
,2011,90100085,,,,3,3,6
,2011,90100086,,,,1,3,4
,2011,90100090,,,,4,10,14
,2011,90100099,,,,1,1,2
HND-017301,2011,90100107,,,,14,18,32
,2011,90100112,,,,9,7,16
,2011,90100151,,,,21,12,33
HND-017319,2011,90100177,,,,5,12,17
,2011,90100277,,,,8,16,24
,2011,90100278,,,,8,2,10
HND-017359,2011,90100325,,,,4,8,12
HND-017218,2011,90100003,,,,7,9,16
HND-017219,2011,90100004,,,,15,16,31
HND-017220,2011,90100005,,,,26,40,66
HND-017224,2011,90100009,,,,6,2,8
HND-017225,2011,90100010,,,,6,7,13
HND-017227,2011,90100013,,,,3,4,7
,2011,90100014,,,,5,0,5
HND-017232,2011,90100019,,,,9,10,19
HND-017235,2011,90100022,,,,12,4,16
,2011,90100024,,,,22,25,47
,2011,90100027,,,,8,18,26
,2011,90100029,,,,29,20,49
HND-017242,2011,90100030,,,,23,23,46
,2011,90100031,,,,17,18,35
HND-017244,2011,90100032,,,,9,10,19
HND-017245,2011,90100033,,,,9,10,19
HND-017250,2011,90100039,,,,6,7,13
,2011,90100042,,,,4,2,6
HND-017255,2011,90100044,,,,8,8,16
HND-017258,2011,90100047,,,,7,11,18
HND-017260,2011,90100049,,,,4,1,5
HND-017261,2011,90100050,,,,12,10,22
HND-017262,2011,90100051,,,,3,6,9
,2011,90100053,,,,3,5,8
HND-017265,2011,90100055,,,,7,7,14
,2011,90100059,,,,2,2,4
HND-017294,2011,90100094,,,,4,4,8
,2011,90100102,,,,6,10,16
HND-017299,2011,90100105,,,,7,3,10
HND-017302,2011,90100108,,,,37,18,55
HND-017308,2011,90100116,,,,40,25,65
,2011,90100118,,,,10,13,23
HND-017314,2011,90100123,,,,5,8,13
HND-017320,2011,90100181,,,,6,9,15
,2011,90100224,,,,6,4,10
HND-017333,2011,90100258,,,,6,4,10
HND-017334,2011,90100265,,,,6,6,12
,2011,90100267,,,,2,4,6
HND-017336,2011,90100268,,,,3,2,5
HND-017345,2011,90100302,,,,1,3,4
HND-017346,2011,90100303,,,,3,3,6
HND-017347,2011,90100304,,,,5,5,10
HND-017348,2011,90100305,,,,2,3,5
HND-017349,2011,90100306,,,,28,15,43
HND-017216,2011,90100001,,,,41,52,93
HND-017217,2011,90100002,,,,73,78,151
HND-017221,2011,90100006,,,,5,3,8
HND-017222,2011,90100007,,,,12,12,24
HND-017223,2011,90100008,,,,10,12,22
HND-017226,2011,90100011,,,,9,10,19
HND-017229,2011,90100015,,,,19,17,36
HND-017230,2011,90100016,,,,10,13,23
,2011,90100018,,,,7,6,13
,2011,90100020,,,,16,9,25
,2011,90100021,,,,7,10,17
HND-017236,2011,90100023,,,,21,23,44
HND-017238,2011,90100025,,,,6,12,18
HND-017239,2011,90100026,,,,22,16,38
,2011,90100028,,,,17,10,27
HND-017246,2011,90100034,,,,39,32,71
HND-017247,2011,90100035,,,,22,13,35
HND-017248,2011,90100036,,,,13,13,26
HND-017249,2011,90100037,,,,7,5,12
,2011,90100040,,,,2,4,6
,2011,90100041,,,,3,2,5
HND-017256,2011,90100045,,,,5,3,8
HND-017257,2011,90100046,,,,5,6,11
HND-017263,2011,90100052,,,,3,2,5
HND-017266,2011,90100056,,,,12,14,26
,2011,90100057,,,,6,2,8
HND-017268,2011,90100058,,,,12,9,21
,2011,90100060,,,,7,9,16
HND-017272,2011,90100063,,,,12,17,29
HND-017291,2011,90100091,,,,7,6,13
,2011,90100092,,,,6,3,9
HND-017293,2011,90100093,,,,4,5,9
,2011,90100104,,,,6,5,11
HND-017303,2011,90100109,,,,1,2,3
HND-017311,2011,90100120,,,,1,4,5
HND-017312,2011,90100121,,,,1,1,2
HND-017313,2011,90100122,,,,15,15,30
HND-017315,2011,90100125,,,,8,4,12
HND-017316,2011,90100127,,,,4,2,6
,2011,90100278,,,,8,7,15
,2011,90100300,,,,12,12,24
HND-017344,2011,90100301,,,,11,20,31
HND-017219,2011,90100004,,,,15,14,29
HND-017220,2011,90100005,,,,34,39,73
HND-017221,2011,90100006,,,,8,10,18
HND-017222,2011,90100007,,,,6,13,19
HND-017229,2011,90100015,,,,15,11,26
HND-017230,2011,90100016,,,,13,4,17
,2011,90100021,,,,10,7,17
HND-017238,2011,90100025,,,,5,9,14
HND-017239,2011,90100026,,,,11,19,30
,2011,90100027,,,,12,14,26
,2011,90100028,,,,12,6,18
HND-017242,2011,90100030,,,,24,16,40
HND-017244,2011,90100032,,,,15,12,27
HND-017245,2011,90100033,,,,21,15,36
HND-017246,2011,90100034,,,,31,36,67
HND-017250,2011,90100039,,,,7,9,16
,2011,90100041,,,,3,2,5
HND-017256,2011,90100045,,,,5,2,7
HND-017257,2011,90100046,,,,1,4,5
HND-017258,2011,90100047,,,,8,7,15
HND-017259,2011,90100048,,,,5,8,13
HND-017261,2011,90100050,,,,7,3,10
,2011,90100053,,,,5,5,10
,2011,90100059,,,,3,1,4
,2011,90100060,,,,11,13,24
HND-017272,2011,90100063,,,,21,18,39
HND-017291,2011,90100091,,,,5,5,10
,2011,90100102,,,,4,7,11
,2011,90100104,,,,8,5,13
HND-017299,2011,90100105,,,,3,5,8
HND-017302,2011,90100108,,,,32,34,66
HND-017303,2011,90100109,,,,1,2,3
HND-017308,2011,90100116,,,,23,25,48
HND-017312,2011,90100121,,,,1,3,4
HND-017316,2011,90100127,,,,3,3,6
HND-017333,2011,90100258,,,,10,6,16
HND-017336,2011,90100268,,,,5,4,9
HND-017348,2011,90100305,,,,2,4,6
HND-017349,2011,90100306,,,,16,21,37
HND-017216,2011,90100001,,,,28,30,58
HND-017217,2011,90100002,,,,69,61,130
HND-017218,2011,90100003,,,,3,5,8
HND-017223,2011,90100008,,,,13,9,22
HND-017224,2011,90100009,,,,4,4,8
HND-017225,2011,90100010,,,,4,2,6
HND-017226,2011,90100011,,,,18,14,32
HND-017227,2011,90100013,,,,9,3,12
,2011,90100018,,,,8,3,11
HND-017232,2011,90100019,,,,11,19,30
,2011,90100020,,,,11,18,29
HND-017235,2011,90100022,,,,7,11,18
HND-017236,2011,90100023,,,,20,20,40
,2011,90100024,,,,35,23,58
,2011,90100029,,,,23,20,43
,2011,90100031,,,,14,14,28
HND-017247,2011,90100035,,,,18,18,36
HND-017248,2011,90100036,,,,12,13,25
HND-017249,2011,90100037,,,,8,4,12
,2011,90100040,,,,3,6,9
,2011,90100042,,,,5,5,10
HND-017255,2011,90100044,,,,12,10,22
HND-017260,2011,90100049,,,,2,3,5
HND-017262,2011,90100051,,,,4,9,13
HND-017265,2011,90100055,,,,2,4,6
HND-017266,2011,90100056,,,,10,13,23
,2011,90100057,,,,2,1,3
HND-017268,2011,90100058,,,,13,12,25
,2011,90100092,,,,7,4,11
HND-017293,2011,90100093,,,,4,4,8
HND-017294,2011,90100094,,,,8,3,11
,2011,90100118,,,,5,6,11
HND-017311,2011,90100120,,,,2,2,4
HND-017313,2011,90100122,,,,12,12,24
HND-017314,2011,90100123,,,,3,6,9
HND-017315,2011,90100125,,,,2,7,9
HND-017320,2011,90100181,,,,9,12,21
,2011,90100224,,,,1,1,2
HND-017334,2011,90100265,,,,4,5,9
,2011,90100267,,,,2,3,5
,2011,90100278,,,,1,3,4
,2011,90100300,,,,6,13,19
HND-017344,2011,90100301,,,,13,17,30
HND-017345,2011,90100302,,,,5,8,13
HND-017346,2011,90100303,,,,3,2,5
HND-017347,2011,90100304,,,,7,8,15
HND-017350,2011,90100308,,,,1,4,5
HND-017216,2011,90100001,,,,26,30,56
HND-017217,2011,90100002,,,,73,68,141
HND-017221,2011,90100006,,,,8,7,15
HND-017222,2011,90100007,,,,3,8,11
HND-017223,2011,90100008,,,,12,9,21
HND-017226,2011,90100011,,,,14,6,20
HND-017229,2011,90100015,,,,17,19,36
HND-017230,2011,90100016,,,,8,10,18
,2011,90100018,,,,8,7,15
,2011,90100020,,,,7,17,24
,2011,90100021,,,,18,18,36
HND-017236,2011,90100023,,,,19,21,40
HND-017238,2011,90100025,,,,10,11,21
HND-017239,2011,90100026,,,,27,14,41
,2011,90100028,,,,16,18,34
HND-017244,2011,90100032,,,,9,11,20
HND-017246,2011,90100034,,,,18,34,52
HND-017249,2011,90100037,,,,15,6,21
,2011,90100040,,,,2,6,8
,2011,90100041,,,,4,2,6
HND-017256,2011,90100045,,,,1,3,4
HND-017257,2011,90100046,,,,1,5,6
HND-017259,2011,90100048,,,,5,6,11
,2011,90100057,,,,1,5,6
HND-017268,2011,90100058,,,,16,17,33
,2011,90100059,,,,2,1,3
,2011,90100060,,,,17,12,29
HND-017272,2011,90100063,,,,35,60,95
HND-017291,2011,90100091,,,,18,16,34
,2011,90100092,,,,3,3,6
HND-017293,2011,90100093,,,,10,14,24
,2011,90100102,,,,5,4,9
,2011,90100104,,,,7,8,15
HND-017302,2011,90100108,,,,41,32,73
HND-017303,2011,90100109,,,,5,1,6
HND-017311,2011,90100120,,,,4,3,7
HND-017312,2011,90100121,,,,2,4,6
HND-017315,2011,90100125,,,,5,8,13
HND-017316,2011,90100127,,,,2,7,9
HND-017333,2011,90100258,,,,10,7,17
,2011,90100300,,,,3,8,11
,2011,90100307,,,,2,3,5
HND-017350,2011,90100308,,,,2,3,5
HND-017218,2011,90100003,,,,3,1,4
HND-017219,2011,90100004,,,,8,12,20
HND-017220,2011,90100005,,,,34,20,54
HND-017224,2011,90100009,,,,9,6,15
HND-017225,2011,90100010,,,,2,5,7
HND-017227,2011,90100013,,,,3,5,8
HND-017232,2011,90100019,,,,13,14,27
HND-017235,2011,90100022,,,,10,11,21
,2011,90100024,,,,29,25,54
,2011,90100027,,,,19,20,39
,2011,90100029,,,,42,30,72
HND-017242,2011,90100030,,,,30,33,63
,2011,90100031,,,,18,11,29
HND-017245,2011,90100033,,,,33,27,60
HND-017247,2011,90100035,,,,26,32,58
HND-017248,2011,90100036,,,,16,17,33
HND-017250,2011,90100039,,,,5,8,13
,2011,90100042,,,,7,5,12
HND-017255,2011,90100044,,,,20,14,34
HND-017258,2011,90100047,,,,16,13,29
HND-017260,2011,90100049,,,,7,2,9
HND-017261,2011,90100050,,,,5,7,12
HND-017262,2011,90100051,,,,5,6,11
,2011,90100053,,,,13,8,21
HND-017265,2011,90100055,,,,3,0,3
HND-017266,2011,90100056,,,,9,10,19
HND-017294,2011,90100094,,,,7,5,12
HND-017299,2011,90100105,,,,4,7,11
HND-017308,2011,90100116,,,,15,20,35
,2011,90100118,,,,5,4,9
HND-017313,2011,90100122,,,,19,9,28
HND-017314,2011,90100123,,,,0,4,4
HND-017320,2011,90100181,,,,6,5,11
,2011,90100224,,,,2,1,3
HND-017334,2011,90100265,,,,6,5,11
,2011,90100267,,,,0,1,1
HND-017336,2011,90100268,,,,3,2,5
HND-017344,2011,90100301,,,,33,18,51
HND-017345,2011,90100302,,,,6,7,13
HND-017346,2011,90100303,,,,3,3,6
HND-017347,2011,90100304,,,,7,3,10
HND-017348,2011,90100305,,,,3,3,6
HND-017349,2011,90100306,,,,7,23,30
HND-017219,2011,90100004,,,,7,10,17
HND-017220,2011,90100005,,,,37,36,73
HND-017222,2011,90100007,,,,5,9,14
HND-017224,2011,90100009,,,,3,2,5
HND-017229,2011,90100015,,,,27,20,47
HND-017230,2011,90100016,,,,6,3,9
,2011,90100024,,,,20,23,43
HND-017238,2011,90100025,,,,10,7,17
HND-017239,2011,90100026,,,,10,20,30
,2011,90100027,,,,16,27,43
HND-017242,2011,90100030,,,,39,34,73
,2011,90100031,,,,15,12,27
HND-017244,2011,90100032,,,,7,8,15
HND-017245,2011,90100033,,,,15,14,29
HND-017250,2011,90100039,,,,7,6,13
HND-017255,2011,90100044,,,,17,10,27
HND-017256,2011,90100045,,,,3,4,7
HND-017257,2011,90100046,,,,6,2,8
HND-017258,2011,90100047,,,,10,12,22
HND-017261,2011,90100050,,,,5,6,11
HND-017262,2011,90100051,,,,6,4,10
,2011,90100053,,,,8,5,13
,2011,90100059,,,,5,1,6
,2011,90100060,,,,13,11,24
HND-017272,2011,90100063,,,,11,19,30
HND-017291,2011,90100091,,,,5,10,15
,2011,90100102,,,,2,4,6
HND-017299,2011,90100105,,,,4,7,11
HND-017302,2011,90100108,,,,33,44,77
HND-017308,2011,90100116,,,,35,33,68
HND-017314,2011,90100123,,,,0,1,1
HND-017320,2011,90100181,,,,3,3,6
HND-017333,2011,90100258,,,,5,4,9
HND-017336,2011,90100268,,,,6,5,11
HND-017345,2011,90100302,,,,9,13,22
HND-017348,2011,90100305,,,,3,4,7
HND-017349,2011,90100306,,,,10,9,19
,2011,90100307,,,,4,4,8
HND-017216,2011,90100001,,,,14,14,28
HND-017217,2011,90100002,,,,84,81,165
HND-017218,2011,90100003,,,,3,1,4
HND-017221,2011,90100006,,,,2,8,10
HND-017223,2011,90100008,,,,14,8,22
HND-017226,2011,90100011,,,,3,16,19
HND-017227,2011,90100013,,,,4,4,8
,2011,90100018,,,,13,16,29
HND-017232,2011,90100019,,,,15,14,29
,2011,90100020,,,,15,18,33
,2011,90100021,,,,9,11,20
HND-017235,2011,90100022,,,,11,11,22
HND-017236,2011,90100023,,,,19,20,39
,2011,90100028,,,,22,15,37
,2011,90100029,,,,27,24,51
HND-017246,2011,90100034,,,,34,30,64
HND-017247,2011,90100035,,,,18,19,37
HND-017248,2011,90100036,,,,24,12,36
HND-017249,2011,90100037,,,,13,13,26
,2011,90100040,,,,2,5,7
,2011,90100041,,,,3,1,4
,2011,90100042,,,,3,4,7
HND-017259,2011,90100048,,,,4,2,6
HND-017260,2011,90100049,,,,7,8,15
HND-017265,2011,90100055,,,,2,1,3
HND-017266,2011,90100056,,,,11,9,20
,2011,90100057,,,,1,0,1
HND-017268,2011,90100058,,,,10,16,26
,2011,90100092,,,,3,2,5
HND-017293,2011,90100093,,,,16,7,23
HND-017294,2011,90100094,,,,5,2,7
,2011,90100104,,,,7,7,14
HND-017303,2011,90100109,,,,3,4,7
,2011,90100118,,,,3,3,6
HND-017311,2011,90100120,,,,7,5,12
HND-017312,2011,90100121,,,,4,1,5
HND-017313,2011,90100122,,,,12,19,31
HND-017315,2011,90100125,,,,6,19,25
HND-017316,2011,90100127,,,,2,4,6
,2011,90100224,,,,2,3,5
HND-017334,2011,90100265,,,,4,4,8
,2011,90100267,,,,0,3,3
,2011,90100300,,,,5,9,14
HND-017344,2011,90100301,,,,19,9,28
HND-017346,2011,90100303,,,,3,7,10
HND-017347,2011,90100304,,,,5,5,10
HND-017350,2011,90100308,,,,1,1,2
HND-017218,2011,90100003,,,,1,1,2
HND-017219,2011,90100004,,,,12,14,26
HND-017220,2011,90100005,,,,30,33,63
HND-017224,2011,90100009,,,,4,3,7
,2011,90100014,,,,1,1,2
HND-017232,2011,90100019,,,,14,13,27
,2011,90100024,,,,15,22,37
HND-017238,2011,90100025,,,,13,7,20
HND-017239,2011,90100026,,,,15,18,33
,2011,90100027,,,,27,23,50
HND-017246,2011,90100034,,,,25,14,39
HND-017247,2011,90100035,,,,16,26,42
HND-017248,2011,90100036,,,,17,14,31
HND-017249,2011,90100037,,,,12,13,25
,2011,90100040,,,,1,3,4
,2011,90100041,,,,7,1,8
,2011,90100042,,,,5,4,9
HND-017259,2011,90100048,,,,3,0,3
HND-017260,2011,90100049,,,,2,2,4
HND-017265,2011,90100055,,,,1,1,2
HND-017266,2011,90100056,,,,8,11,19
,2011,90100057,,,,3,1,4
HND-017268,2011,90100058,,,,13,18,31
HND-017291,2011,90100091,,,,3,12,15
,2011,90100092,,,,1,3,4
HND-017293,2011,90100093,,,,3,4,7
,2011,90100102,,,,2,2,4
HND-017299,2011,90100105,,,,3,4,7
HND-017302,2011,90100108,,,,26,24,50
HND-017308,2011,90100116,,,,16,41,57
HND-017314,2011,90100123,,,,0,2,2
HND-017320,2011,90100181,,,,1,2,3
HND-017333,2011,90100258,,,,5,4,9
HND-017334,2011,90100265,,,,3,3,6
HND-017336,2011,90100268,,,,4,4,8
HND-017345,2011,90100302,,,,21,25,46
HND-017346,2011,90100303,,,,5,5,10
HND-017347,2011,90100304,,,,6,7,13
HND-017348,2011,90100305,,,,2,2,4
HND-017349,2011,90100306,,,,5,12,17
HND-017216,2011,90100001,,,,22,19,41
HND-017217,2011,90100002,,,,79,91,170
HND-017221,2011,90100006,,,,5,12,17
HND-017223,2011,90100008,,,,13,11,24
HND-017225,2011,90100010,,,,5,8,13
HND-017226,2011,90100011,,,,9,8,17
HND-017227,2011,90100013,,,,3,5,8
HND-017229,2011,90100015,,,,19,27,46
HND-017230,2011,90100016,,,,6,5,11
,2011,90100018,,,,5,10,15
,2011,90100020,,,,12,13,25
,2011,90100021,,,,10,6,16
HND-017235,2011,90100022,,,,3,11,14
HND-017236,2011,90100023,,,,11,26,37
,2011,90100028,,,,21,17,38
,2011,90100029,,,,20,30,50
HND-017242,2011,90100030,,,,15,15,30
,2011,90100031,,,,5,12,17
HND-017244,2011,90100032,,,,4,7,11
HND-017245,2011,90100033,,,,33,21,54
HND-017250,2011,90100039,,,,8,4,12
HND-017255,2011,90100044,,,,5,14,19
HND-017256,2011,90100045,,,,1,3,4
HND-017257,2011,90100046,,,,4,3,7
HND-017258,2011,90100047,,,,12,12,24
HND-017261,2011,90100050,,,,7,8,15
HND-017262,2011,90100051,,,,6,7,13
,2011,90100053,,,,4,9,13
,2011,90100059,,,,4,1,5
,2011,90100060,,,,1,5,6
HND-017272,2011,90100063,,,,14,13,27
HND-017294,2011,90100094,,,,2,2,4
,2011,90100104,,,,10,3,13
HND-017303,2011,90100109,,,,5,2,7
,2011,90100118,,,,3,3,6
HND-017311,2011,90100120,,,,5,4,9
HND-017313,2011,90100122,,,,14,9,23
HND-017315,2011,90100125,,,,15,10,25
HND-017316,2011,90100127,,,,2,3,5
,2011,90100267,,,,1,4,5
,2011,90100300,,,,9,7,16
HND-017344,2011,90100301,,,,16,16,32
,2011,90100307,,,,3,1,4
HND-017350,2011,90100308,,,,1,2,3
HND-017216,2011,90100001,,,,19,14,33
HND-017217,2011,90100002,,,,83,81,164
HND-017218,2011,90100003,,,,2,0,2
HND-017223,2011,90100008,,,,5,5,10
HND-017224,2011,90100009,,,,3,5,8
HND-017226,2011,90100011,,,,6,8,14
HND-017227,2011,90100013,,,,4,3,7
,2011,90100018,,,,9,14,23
HND-017232,2011,90100019,,,,12,11,23
,2011,90100020,,,,7,6,13
HND-017235,2011,90100022,,,,12,8,20
HND-017236,2011,90100023,,,,13,18,31
,2011,90100024,,,,24,14,38
,2011,90100029,,,,16,24,40
HND-017242,2011,90100030,,,,30,21,51
HND-017244,2011,90100032,,,,7,5,12
HND-017245,2011,90100033,,,,17,6,23
HND-017246,2011,90100034,,,,9,17,26
HND-017250,2011,90100039,,,,1,2,3
,2011,90100041,,,,1,5,6
HND-017256,2011,90100045,,,,3,1,4
HND-017257,2011,90100046,,,,3,2,5
HND-017258,2011,90100047,,,,5,8,13
HND-017259,2011,90100048,,,,1,0,1
HND-017261,2011,90100050,,,,5,1,6
HND-017263,2011,90100052,,,,2,0,2
,2011,90100053,,,,7,10,17
HND-017291,2011,90100091,,,,19,12,31
HND-017311,2011,90100120,,,,4,4,8
HND-017313,2011,90100122,,,,8,13,21
HND-017314,2011,90100123,,,,2,0,2
HND-017315,2011,90100125,,,,7,10,17
HND-017320,2011,90100181,,,,0,5,5
HND-017334,2011,90100265,,,,1,2,3
,2011,90100267,,,,1,0,1
HND-017349,2011,90100306,,,,3,3,6
,2011,90100307,,,,2,1,3
HND-017219,2011,90100004,,,,5,2,7
HND-017220,2011,90100005,,,,19,28,47
HND-017221,2011,90100006,,,,4,11,15
,2011,90100014,,,,0,1,1
HND-017229,2011,90100015,,,,12,21,33
HND-017230,2011,90100016,,,,6,5,11
,2011,90100021,,,,8,4,12
HND-017238,2011,90100025,,,,9,9,18
HND-017239,2011,90100026,,,,27,17,44
,2011,90100027,,,,12,19,31
,2011,90100028,,,,24,9,33
,2011,90100031,,,,10,9,19
HND-017247,2011,90100035,,,,14,22,36
HND-017248,2011,90100036,,,,16,4,20
HND-017249,2011,90100037,,,,10,10,20
,2011,90100040,,,,1,2,3
,2011,90100042,,,,7,5,12
HND-017255,2011,90100044,,,,5,4,9
HND-017260,2011,90100049,,,,2,2,4
HND-017262,2011,90100051,,,,2,3,5
HND-017265,2011,90100055,,,,2,3,5
HND-017266,2011,90100056,,,,8,11,19
HND-017268,2011,90100058,,,,15,17,32
,2011,90100060,,,,1,7,8
HND-017272,2011,90100063,,,,14,12,26
,2011,90100092,,,,2,3,5
HND-017293,2011,90100093,,,,2,0,2
HND-017294,2011,90100094,,,,3,2,5
,2011,90100102,,,,2,2,4
,2011,90100104,,,,3,13,16
HND-017299,2011,90100105,,,,7,6,13
HND-017302,2011,90100108,,,,19,25,44
HND-017303,2011,90100109,,,,1,2,3
HND-017308,2011,90100116,,,,19,21,40
HND-017312,2011,90100121,,,,1,0,1
HND-017316,2011,90100127,,,,8,0,8
HND-017333,2011,90100258,,,,2,2,4
HND-017336,2011,90100268,,,,5,5,10
,2011,90100300,,,,2,3,5
HND-017344,2011,90100301,,,,13,16,29
HND-017346,2011,90100303,,,,4,0,4
HND-017347,2011,90100304,,,,2,1,3
HND-017220,2011,90100005,,,,12,20,32
HND-017232,2011,90100019,,,,7,11,18
,2011,90100024,,,,16,8,24
HND-017238,2011,90100025,,,,5,8,13
HND-017239,2011,90100026,,,,23,18,41
,2011,90100027,,,,22,9,31
,2011,90100031,,,,9,10,19
HND-017254,2011,90100043,,,,206,249,455
HND-017258,2011,90100047,,,,5,10,15
HND-017216,2011,90100001,,,,22,21,43
HND-017217,2011,90100002,,,,22,25,47
HND-017236,2011,90100023,,,,19,16,35
,2011,90100028,,,,16,22,38
,2011,90100029,,,,14,8,22
HND-017246,2011,90100034,,,,15,16,31
HND-017247,2011,90100035,,,,25,18,43
HND-017248,2011,90100036,,,,10,10,20
HND-017272,2011,90100063,,,,22,20,42
,2011,90100124,,,,9,27,36
HND-017220,2011,90100005,,,,10,12,22
HND-017238,2011,90100025,,,,9,6,15
HND-017239,2011,90100026,,,,22,15,37
,2011,90100027,,,,14,11,25
,2011,90100028,,,,6,11,17
HND-017246,2011,90100034,,,,3,5,8
HND-017258,2011,90100047,,,,9,7,16
HND-017272,2011,90100063,,,,13,28,41
,2011,90100124,,,,12,17,29
HND-017216,2011,90100001,,,,14,10,24
HND-017217,2011,90100002,,,,19,23,42
HND-017232,2011,90100019,,,,5,7,12
,2011,90100021,,,,6,7,13
HND-017236,2011,90100023,,,,13,23,36
,2011,90100024,,,,12,20,32
,2011,90100029,,,,15,10,25
,2011,90100031,,,,9,8,17
HND-017247,2011,90100035,,,,14,22,36
HND-017248,2011,90100036,,,,7,9,16
HND-017254,2011,90100043,,,,179,214,393
HND-017220,2011,90100005,,,,4,3,7
,2011,90100024,,,,12,17,29
HND-017238,2011,90100025,,,,2,8,10
HND-017239,2011,90100026,,,,14,13,27
,2011,90100027,,,,13,8,21
,2011,90100031,,,,8,7,15
HND-017246,2011,90100034,,,,7,9,16
HND-017248,2011,90100036,,,,3,10,13
HND-017258,2011,90100047,,,,6,8,14
HND-017272,2011,90100063,,,,14,11,25
HND-017216,2011,90100001,,,,10,10,20
HND-017217,2011,90100002,,,,10,20,30
HND-017232,2011,90100019,,,,1,3,4
,2011,90100021,,,,6,11,17
HND-017236,2011,90100023,,,,14,13,27
,2011,90100028,,,,8,5,13
HND-017247,2011,90100035,,,,11,7,18
HND-017254,2011,90100043,,,,163,202,365
,2011,90100124,,,,7,16,23
HND-017236,2011,90100023,,,,8,13,21
HND-017254,2011,90100043,,,,155,205,360
,2011,90100101,,,,16,15,31
,2011,90100024,,,,3,16,19
HND-017248,2011,90100036,,,,10,8,18
,2011,90100124,,,,52,77,129
,2011,90100024,,,,0,7,7
HND-017254,2011,90100043,,,,69,104,173
,2011,90100124,,,,49,60,109
HND-017236,2011,90100023,,,,1,9,10
HND-017248,2011,90100036,,,,7,7,14
,2011,90100101,,,,14,13,27
HND-017236,2011,90100023,,,,1,7,8
,2011,90100124,,,,32,65,97
,2011,90100024,,,,3,7,10
HND-017254,2011,90100043,,,,42,57,99
,2011,90100101,,,,2,3,5
,2011,90200011,,,,18,33,51
,2011,90200012,,,,3,5,8
,2011,90200013,,,,1,1,2
,2011,90200027,,,,11,8,19
,2011,90200032,,,,1,2,3
,2011,90200001,,,,7,8,15
,2011,90200016,,,,4,3,7
,2011,90200017,,,,7,7,14
,2011,90200018,,,,5,4,9
,2011,90200020,,,,9,10,19
,2011,90200021,,,,1,2,3
,2011,90200022,,,,6,11,17
,2011,90200028,,,,2,3,5
,2011,90200035,,,,6,10,16
,2011,90200045,,,,2,2,4
,2011,90200001,,,,14,8,22
,2011,90200011,,,,16,31,47
,2011,90200015,,,,10,18,28
,2011,90200016,,,,6,7,13
,2011,90200017,,,,8,6,14
,2011,90200020,,,,9,10,19
,2011,90200021,,,,2,2,4
,2011,90200028,,,,10,3,13
,2011,90200035,,,,10,8,18
,2011,90200042,,,,7,10,17
,2011,90200012,,,,3,8,11
,2011,90200013,,,,3,5,8
,2011,90200018,,,,11,10,21
,2011,90200022,,,,9,6,15
,2011,90200032,,,,11,12,23
,2011,90200045,,,,1,5,6
,2011,90200001,,,,9,8,17
,2011,90200013,,,,4,1,5
,2011,90200018,,,,11,11,22
,2011,90200020,,,,12,10,22
,2011,90200022,,,,3,5,8
,2011,90200032,,,,24,18,42
,2011,90200045,,,,1,2,3
,2011,90200011,,,,29,36,65
,2011,90200012,,,,12,18,30
,2011,90200015,,,,10,11,21
,2011,90200016,,,,8,7,15
,2011,90200017,,,,9,8,17
,2011,90200021,,,,4,5,9
,2011,90200028,,,,9,2,11
,2011,90200035,,,,8,13,21
,2011,90200042,,,,5,8,13
,2011,90200003,,,,47,49,96
,2011,90200005,,,,6,6,12
,2011,90200008,,,,13,9,22
,2011,90200030,,,,10,10,20
,2011,90200033,,,,2,1,3
,2011,90200036,,,,5,4,9
,2011,90200040,,,,3,3,6
,2011,90200043,,,,16,13,29
,2011,90200044,,,,12,9,21
,2011,90200002,,,,16,10,26
,2011,90200004,,,,15,10,25
,2011,90200006,,,,45,36,81
,2011,90200007,,,,10,10,20
,2011,90200009,,,,6,9,15
,2011,90200010,,,,15,14,29
,2011,90200024,,,,3,2,5
,2011,90200025,,,,15,9,24
,2011,90200037,,,,3,5,8
,2011,90200041,,,,13,10,23
,2011,90200002,,,,12,12,24
,2011,90200003,,,,35,42,77
,2011,90200004,,,,8,6,14
,2011,90200006,,,,60,54,114
,2011,90200009,,,,8,12,20
,2011,90200010,,,,13,15,28
,2011,90200024,,,,2,2,4
,2011,90200030,,,,15,19,34
,2011,90200033,,,,7,2,9
,2011,90200037,,,,4,2,6
,2011,90200044,,,,11,10,21
,2011,90200005,,,,4,5,9
,2011,90200007,,,,13,16,29
,2011,90200008,,,,17,16,33
,2011,90200025,,,,10,10,20
,2011,90200036,,,,4,4,8
,2011,90200040,,,,2,3,5
,2011,90200041,,,,5,7,12
,2011,90200043,,,,4,6,10
,2011,90200002,,,,21,20,41
,2011,90200003,,,,40,47,87
,2011,90200004,,,,4,3,7
,2011,90200006,,,,54,42,96
,2011,90200007,,,,16,12,28
,2011,90200009,,,,13,7,20
,2011,90200010,,,,15,10,25
,2011,90200024,,,,1,1,2
,2011,90200033,,,,3,4,7
,2011,90200037,,,,2,0,2
,2011,90200041,,,,9,4,13
,2011,90200005,,,,8,10,18
,2011,90200008,,,,19,19,38
,2011,90200025,,,,10,7,17
,2011,90200030,,,,19,21,40
,2011,90200036,,,,6,5,11
,2011,90200040,,,,5,3,8
,2011,90200043,,,,4,6,10
,2011,90200044,,,,8,11,19
,2011,90200002,,,,19,20,39
,2011,90200003,,,,53,54,107
,2011,90200006,,,,63,70,133
,2011,90200008,,,,28,27,55
,2011,90200009,,,,12,8,20
,2011,90200030,,,,20,10,30
,2011,90200033,,,,2,0,2
,2011,90200037,,,,2,2,4
,2011,90200044,,,,17,10,27
,2011,90200004,,,,7,3,10
,2011,90200005,,,,8,7,15
,2011,90200007,,,,17,16,33
,2011,90200010,,,,12,11,23
,2011,90200024,,,,5,1,6
,2011,90200025,,,,11,12,23
,2011,90200036,,,,4,6,10
,2011,90200040,,,,3,3,6
,2011,90200041,,,,5,3,8
,2011,90200043,,,,6,6,12
,2011,90200003,,,,51,52,103
,2011,90200008,,,,19,23,42
,2011,90200009,,,,14,11,25
,2011,90200030,,,,29,21,50
,2011,90200033,,,,2,2,4
,2011,90200037,,,,1,1,2
,2011,90200043,,,,3,4,7
,2011,90200002,,,,13,17,30
,2011,90200004,,,,7,5,12
,2011,90200005,,,,8,9,17
,2011,90200006,,,,44,46,90
,2011,90200007,,,,15,10,25
,2011,90200010,,,,14,12,26
,2011,90200024,,,,0,1,1
,2011,90200025,,,,10,9,19
,2011,90200036,,,,10,9,19
,2011,90200040,,,,3,3,6
,2011,90200041,,,,4,3,7
,2011,90200005,,,,11,10,21
,2011,90200007,,,,18,17,35
,2011,90200008,,,,25,19,44
,2011,90200025,,,,12,5,17
,2011,90200036,,,,7,8,15
,2011,90200040,,,,3,3,6
,2011,90200041,,,,4,3,7
,2011,90200043,,,,8,4,12
,2011,90200002,,,,33,27,60
,2011,90200003,,,,47,42,89
,2011,90200004,,,,3,1,4
,2011,90200006,,,,63,71,134
,2011,90200009,,,,9,8,17
,2011,90200010,,,,10,13,23
,2011,90200030,,,,16,12,28
,2011,90200033,,,,2,1,3
,2011,90200037,,,,5,2,7
,2011,90200003,,,,40,51,91
,2011,90200029,,,,66,77,143
,2011,90200030,,,,26,41,67
,2011,90200002,,,,22,26,48
,2011,90200002,,,,13,27,40
,2011,90200003,,,,23,25,48
,2011,90200029,,,,56,64,120
,2011,90200030,,,,13,22,35
,2011,90200029,,,,59,68,127
,2011,90200002,,,,14,9,23
,2011,90200003,,,,17,10,27
,2011,90200030,,,,19,19,38
,2011,90200030,,,,15,25,40
,2011,90200003,,,,10,13,23
,2011,90200029,,,,46,41,87
,2011,90200038,,,,7,11,18
,2011,90200038,,,,7,7,14
,2011,90200003,,,,7,4,11
,2011,90200029,,,,7,12,19
,2011,90200030,,,,4,3,7
,2011,90200003,,,,6,6,12
,2011,90200029,,,,14,13,27
,2011,90200030,,,,4,8,12
,2011,90200029,,,,15,11,26
,2011,90300022,,,,13,12,25
,2011,90300024,,,,5,7,12
,2011,90300025,,,,18,18,36
,2011,90300026,,,,13,14,27
,2011,90300030,,,,12,11,23
,2011,90300020,,,,10,10,20
,2011,90300021,,,,9,18,27
,2011,90300027,,,,14,9,23
,2011,90300028,,,,19,30,49
,2011,90300002,,,,3,8,11
,2011,90300003,,,,5,5,10
,2011,90300011,,,,13,19,32
,2011,90300001,,,,6,5,11
,2011,90300002,,,,5,9,14
,2011,90300003,,,,16,17,33
,2011,90300010,,,,10,9,19
,2011,90300011,,,,9,15,24
,2011,90300012,,,,13,18,31
,2011,90300013,,,,17,17,34
,2011,90300031,,,,6,3,9
,2011,90300001,,,,2,5,7
,2011,90300003,,,,18,9,27
,2011,90300012,,,,10,9,19
,2011,90300002,,,,10,15,25
,2011,90300010,,,,13,18,31
,2011,90300011,,,,16,18,34
,2011,90300013,,,,31,20,51
,2011,90300031,,,,5,4,9
,2011,90300004,,,,34,37,71
,2011,90300009,,,,25,25,50
,2011,90300014,,,,13,19,32
,2011,90300017,,,,5,6,11
,2011,90300005,,,,6,8,14
,2011,90300006,,,,15,25,40
,2011,90300007,,,,23,31,54
,2011,90300015,,,,19,17,36
,2011,90300018,,,,11,13,24
,2011,90300009,,,,21,23,44
,2011,90300014,,,,15,14,29
,2011,90300015,,,,31,21,52
,2011,90300017,,,,7,14,21
,2011,90300004,,,,32,19,51
,2011,90300005,,,,6,7,13
,2011,90300006,,,,11,9,20
,2011,90300007,,,,23,17,40
,2011,90300018,,,,10,6,16
,2011,90300009,,,,40,31,71
,2011,90300014,,,,15,14,29
,2011,90300015,,,,31,36,67
,2011,90300017,,,,4,3,7
,2011,90300004,,,,27,27,54
,2011,90300005,,,,10,9,19
,2011,90300006,,,,17,13,30
,2011,90300007,,,,30,24,54
,2011,90300018,,,,5,8,13
,2011,90300005,,,,7,8,15
,2011,90300006,,,,15,7,22
,2011,90300014,,,,10,6,16
,2011,90300015,,,,37,40,77
,2011,90300004,,,,72,60,132
,2011,90300007,,,,30,25,55
,2011,90300009,,,,30,45,75
,2011,90300017,,,,3,2,5
,2011,90300018,,,,4,3,7
,2011,90300005,,,,7,5,12
,2011,90300006,,,,12,12,24
,2011,90300007,,,,45,32,77
,2011,90300014,,,,19,14,33
,2011,90300015,,,,36,48,84
,2011,90300004,,,,30,24,54
,2011,90300009,,,,32,33,65
,2011,90300017,,,,6,7,13
,2011,90300018,,,,4,4,8
,2011,90300004,,,,31,16,47
,2011,90300005,,,,3,5,8
,2011,90300006,,,,14,3,17
,2011,90300007,,,,26,25,51
,2011,90300018,,,,13,17,30
,2011,90300009,,,,35,39,74
,2011,90300014,,,,12,9,21
,2011,90300015,,,,24,29,53
,2011,90300017,,,,2,1,3
,2011,90300007,,,,18,22,40
,2011,90300016,,,,45,69,114
,2011,90300004,,,,18,23,41
,2011,90300016,,,,46,42,88
,2011,90300004,,,,17,5,22
,2011,90300007,,,,14,3,17
,2011,90300016,,,,13,45,58
,2011,90300004,,,,13,17,30
,2011,90300007,,,,8,11,19
,2011,90300016,,,,23,19,42
,2011,90300016,,,,16,11,27
,2011,90300016,,,,9,24,33
,2011,90400002,,,,2,3,5
,2011,90400007,,,,5,3,8
,2011,90400018,,,,4,8,12
,2011,90400020,,,,1,5,6
,2011,90400008,,,,3,3,6
,2011,90400013,,,,15,15,30
,2011,90400014,,,,3,3,6
,2011,90400019,,,,1,1,2
,2011,90400021,,,,3,3,6
,2011,90400027,,,,4,3,7
,2011,90400028,,,,1,3,4
,2011,90400030,,,,4,3,7
,2011,90400013,,,,15,18,33
,2011,90400018,,,,4,2,6
,2011,90400019,,,,3,4,7
,2011,90400027,,,,5,5,10
,2011,90400030,,,,7,4,11
,2011,90400002,,,,2,2,4
,2011,90400007,,,,7,3,10
,2011,90400008,,,,5,5,10
,2011,90400014,,,,8,6,14
,2011,90400020,,,,8,13,21
,2011,90400021,,,,6,10,16
,2011,90400028,,,,1,8,9
,2011,90400008,,,,5,5,10
,2011,90400014,,,,4,7,11
,2011,90400020,,,,10,12,22
,2011,90400021,,,,7,13,20
,2011,90400028,,,,2,4,6
,2011,90400002,,,,3,5,8
,2011,90400007,,,,8,6,14
,2011,90400013,,,,18,17,35
,2011,90400018,,,,4,4,8
,2011,90400019,,,,3,8,11
,2011,90400022,,,,3,3,6
,2011,90400027,,,,7,7,14
,2011,90400030,,,,2,2,4
,2011,90400005,,,,6,6,12
,2011,90400010,,,,10,8,18
,2011,90400011,,,,6,12,18
,2011,90400023,,,,2,2,4
,2011,90400024,,,,9,0,9
,2011,90400025,,,,6,4,10
,2011,90400026,,,,5,3,8
,2011,90400031,,,,9,5,14
,2011,90400001,,,,27,27,54
,2011,90400003,,,,10,5,15
,2011,90400009,,,,8,5,13
,2011,90400012,,,,7,8,15
,2011,90400015,,,,13,15,28
,2011,90400017,,,,3,6,9
,2011,90400022,,,,1,4,5
,2011,90400029,,,,2,2,4
,2011,90400001,,,,26,29,55
,2011,90400003,,,,24,10,34
,2011,90400005,,,,7,8,15
,2011,90400017,,,,2,1,3
,2011,90400023,,,,3,5,8
,2011,90400024,,,,5,8,13
,2011,90400009,,,,7,5,12
,2011,90400010,,,,8,10,18
,2011,90400011,,,,11,10,21
,2011,90400012,,,,6,7,13
,2011,90400015,,,,11,8,19
,2011,90400022,,,,0,3,3
,2011,90400026,,,,1,6,7
,2011,90400031,,,,5,5,10
,2011,90400001,,,,32,23,55
,2011,90400003,,,,10,14,24
,2011,90400009,,,,6,10,16
,2011,90400012,,,,6,7,13
,2011,90400015,,,,13,14,27
,2011,90400017,,,,3,4,7
,2011,90400022,,,,2,3,5
,2011,90400024,,,,3,3,6
,2011,90400029,,,,2,4,6
,2011,90400005,,,,7,7,14
,2011,90400010,,,,8,4,12
,2011,90400011,,,,19,9,28
,2011,90400023,,,,4,7,11
,2011,90400025,,,,3,1,4
,2011,90400026,,,,4,5,9
,2011,90400031,,,,7,3,10
,2011,90400003,,,,11,9,20
,2011,90400009,,,,6,11,17
,2011,90400011,,,,21,18,39
,2011,90400012,,,,4,2,6
,2011,90400015,,,,16,14,30
,2011,90400017,,,,3,5,8
,2011,90400029,,,,6,2,8
,2011,90400001,,,,33,40,73
,2011,90400005,,,,10,8,18
,2011,90400010,,,,15,11,26
,2011,90400023,,,,2,3,5
,2011,90400024,,,,3,2,5
,2011,90400025,,,,2,1,3
,2011,90400026,,,,6,0,6
,2011,90400031,,,,4,4,8
,2011,90400003,,,,12,15,27
,2011,90400009,,,,10,7,17
,2011,90400011,,,,7,7,14
,2011,90400012,,,,9,6,15
,2011,90400015,,,,17,18,35
,2011,90400017,,,,4,3,7
,2011,90400022,,,,0,1,1
,2011,90400029,,,,0,4,4
,2011,90400031,,,,1,4,5
,2011,90400001,,,,22,26,48
,2011,90400005,,,,7,11,18
,2011,90400010,,,,11,9,20
,2011,90400023,,,,3,6,9
,2011,90400024,,,,3,2,5
,2011,90400025,,,,2,0,2
,2011,90400026,,,,4,2,6
,2011,90400001,,,,23,36,59
,2011,90400003,,,,12,8,20
,2011,90400005,,,,6,7,13
,2011,90400017,,,,2,1,3
,2011,90400023,,,,2,2,4
,2011,90400024,,,,2,6,8
,2011,90400029,,,,6,0,6
,2011,90400031,,,,1,2,3
,2011,90400009,,,,10,12,22
,2011,90400010,,,,13,7,20
,2011,90400011,,,,4,8,12
,2011,90400012,,,,7,10,17
,2011,90400015,,,,11,11,22
,2011,90400025,,,,1,1,2
,2011,90400026,,,,5,2,7
,2011,90400010,,,,12,8,20
,2011,90400016,,,,42,44,86
,2011,90400010,,,,6,9,15
,2011,90400016,,,,29,35,64
,2011,90400010,,,,8,12,20
,2011,90400016,,,,35,36,71
,2011,90400016,,,,17,33,50
,2011,90400016,,,,24,19,43
,2011,90400016,,,,2,10,12
,2011,90500034,,,,1,14,15
HND-017511,2011,90500014,,,,6,6,12
HND-017523,2011,90500031,,,,1,5,6
,2011,90500032,,,,6,4,10
,2011,90500006,,,,2,1,3
HND-017509,2011,90500011,,,,0,2,2
HND-017512,2011,90500015,,,,17,15,32
HND-017513,2011,90500016,,,,23,17,40
HND-017514,2011,90500017,,,,2,0,2
HND-017515,2011,90500018,,,,7,8,15
,2011,90500027,,,,4,3,7
,2011,90500028,,,,3,4,7
HND-017503,2011,90500002,,,,9,10,19
HND-017507,2011,90500009,,,,15,15,30
HND-017508,2011,90500010,,,,3,2,5
HND-017510,2011,90500012,,,,4,8,12
HND-017511,2011,90500014,,,,3,2,5
,2011,90500006,,,,2,2,4
HND-017508,2011,90500010,,,,5,7,12
HND-017509,2011,90500011,,,,4,3,7
HND-017510,2011,90500012,,,,10,16,26
HND-017515,2011,90500018,,,,16,14,30
,2011,90500028,,,,2,5,7
HND-017503,2011,90500002,,,,13,9,22
HND-017507,2011,90500009,,,,15,16,31
HND-017511,2011,90500014,,,,3,1,4
HND-017512,2011,90500015,,,,16,17,33
HND-017513,2011,90500016,,,,3,3,6
HND-017514,2011,90500017,,,,5,5,10
,2011,90500027,,,,2,9,11
HND-017503,2011,90500002,,,,6,11,17
HND-017507,2011,90500009,,,,22,21,43
HND-017510,2011,90500012,,,,29,32,61
HND-017511,2011,90500014,,,,7,2,9
HND-017514,2011,90500017,,,,2,5,7
,2011,90500027,,,,5,7,12
,2011,90500006,,,,2,3,5
HND-017508,2011,90500010,,,,4,10,14
HND-017509,2011,90500011,,,,5,2,7
HND-017512,2011,90500015,,,,11,10,21
HND-017513,2011,90500016,,,,12,5,17
HND-017515,2011,90500018,,,,12,22,34
,2011,90500028,,,,6,2,8
HND-017502,2011,90500001,,,,6,7,13
HND-017506,2011,90500008,,,,11,7,18
HND-017507,2011,90500009,,,,39,28,67
HND-017508,2011,90500010,,,,16,17,33
HND-017515,2011,90500018,,,,18,8,26
HND-017516,2011,90500019,,,,22,38,60
HND-017517,2011,90500020,,,,16,4,20
HND-017518,2011,90500022,,,,9,10,19
HND-017519,2011,90500023,,,,4,3,7
HND-017524,2011,90500033,,,,3,3,6
HND-017503,2011,90500002,,,,8,14,22
HND-017504,2011,90500003,,,,3,4,7
HND-017505,2011,90500007,,,,25,15,40
HND-017513,2011,90500016,,,,21,11,32
HND-017520,2011,90500024,,,,2,2,4
HND-017522,2011,90500026,,,,6,3,9
HND-017502,2011,90500001,,,,7,7,14
HND-017503,2011,90500002,,,,13,12,25
HND-017504,2011,90500003,,,,9,4,13
HND-017518,2011,90500022,,,,12,8,20
HND-017520,2011,90500024,,,,3,2,5
HND-017505,2011,90500007,,,,30,18,48
HND-017506,2011,90500008,,,,3,10,13
HND-017507,2011,90500009,,,,37,41,78
HND-017508,2011,90500010,,,,6,15,21
HND-017513,2011,90500016,,,,8,10,18
HND-017515,2011,90500018,,,,23,20,43
HND-017516,2011,90500019,,,,26,35,61
HND-017517,2011,90500020,,,,9,7,16
HND-017519,2011,90500023,,,,6,5,11
HND-017522,2011,90500026,,,,4,4,8
HND-017503,2011,90500002,,,,15,17,32
HND-017504,2011,90500003,,,,7,11,18
HND-017513,2011,90500016,,,,16,27,43
HND-017520,2011,90500024,,,,6,0,6
HND-017522,2011,90500026,,,,9,4,13
HND-017524,2011,90500033,,,,1,1,2
HND-017502,2011,90500001,,,,4,7,11
HND-017505,2011,90500007,,,,23,14,37
HND-017506,2011,90500008,,,,10,10,20
HND-017507,2011,90500009,,,,22,30,52
HND-017508,2011,90500010,,,,20,21,41
HND-017515,2011,90500018,,,,28,23,51
HND-017516,2011,90500019,,,,25,27,52
HND-017517,2011,90500020,,,,15,12,27
HND-017518,2011,90500022,,,,5,12,17
HND-017519,2011,90500023,,,,2,5,7
HND-017502,2011,90500001,,,,8,9,17
HND-017503,2011,90500002,,,,13,10,23
HND-017504,2011,90500003,,,,1,0,1
HND-017506,2011,90500008,,,,4,15,19
HND-017507,2011,90500009,,,,41,42,83
HND-017508,2011,90500010,,,,13,14,27
HND-017516,2011,90500019,,,,37,33,70
HND-017517,2011,90500020,,,,6,10,16
HND-017518,2011,90500022,,,,12,9,21
HND-017519,2011,90500023,,,,2,3,5
HND-017520,2011,90500024,,,,3,2,5
HND-017524,2011,90500033,,,,2,3,5
HND-017505,2011,90500007,,,,23,35,58
HND-017513,2011,90500016,,,,20,19,39
HND-017515,2011,90500018,,,,29,21,50
HND-017522,2011,90500026,,,,7,3,10
HND-017502,2011,90500001,,,,3,5,8
HND-017504,2011,90500003,,,,10,5,15
HND-017506,2011,90500008,,,,12,12,24
HND-017507,2011,90500009,,,,23,32,55
HND-017508,2011,90500010,,,,9,11,20
HND-017516,2011,90500019,,,,40,26,66
HND-017517,2011,90500020,,,,2,2,4
HND-017518,2011,90500022,,,,6,7,13
HND-017519,2011,90500023,,,,3,3,6
HND-017503,2011,90500002,,,,13,11,24
HND-017505,2011,90500007,,,,33,22,55
HND-017513,2011,90500016,,,,11,16,27
HND-017515,2011,90500018,,,,18,20,38
HND-017522,2011,90500026,,,,5,3,8
HND-017505,2011,90500007,,,,19,26,45
HND-017506,2011,90500008,,,,10,5,15
HND-017507,2011,90500009,,,,41,47,88
HND-017508,2011,90500010,,,,6,3,9
HND-017513,2011,90500016,,,,5,10,15
HND-017515,2011,90500018,,,,12,12,24
HND-017516,2011,90500019,,,,14,17,31
HND-017517,2011,90500020,,,,3,0,3
HND-017519,2011,90500023,,,,5,3,8
HND-017522,2011,90500026,,,,4,2,6
HND-017502,2011,90500001,,,,1,3,4
HND-017503,2011,90500002,,,,7,13,20
HND-017504,2011,90500003,,,,5,4,9
HND-017518,2011,90500022,,,,6,7,13
HND-017524,2011,90500033,,,,3,1,4
HND-017506,2011,90500008,,,,5,8,13
HND-017507,2011,90500009,,,,33,33,66
HND-017516,2011,90500019,,,,25,30,55
HND-017503,2011,90500002,,,,7,11,18
HND-017505,2011,90500007,,,,10,11,21
HND-017515,2011,90500018,,,,18,23,41
HND-017503,2011,90500002,,,,11,13,24
HND-017516,2011,90500019,,,,16,12,28
HND-017505,2011,90500007,,,,7,10,17
HND-017506,2011,90500008,,,,6,5,11
HND-017507,2011,90500009,,,,20,23,43
HND-017515,2011,90500018,,,,6,6,12
HND-017503,2011,90500002,,,,7,6,13
HND-017506,2011,90500008,,,,7,6,13
HND-017516,2011,90500019,,,,12,8,20
HND-017505,2011,90500007,,,,7,2,9
HND-017507,2011,90500009,,,,14,20,34
HND-017515,2011,90500018,,,,9,7,16
HND-017507,2011,90500009,,,,4,10,14
HND-009048,2011,90600034,,,,9,2,11
,2011,90600035,,,,6,6,12
HND-009049,2011,90600036,,,,8,9,17
,2011,90600040,,,,3,7,10
,2011,90600041,,,,3,3,6
HND-009050,2011,90600039,,,,7,10,17
,2011,90600044,,,,6,11,17
HND-009035,2011,90600016,,,,2,2,4
,2011,90600017,,,,5,7,12
HND-009038,2011,90600020,,,,13,7,20
HND-009034,2011,90600015,,,,17,19,36
HND-009035,2011,90600016,,,,9,6,15
,2011,90600017,,,,6,8,14
HND-009036,2011,90600018,,,,8,11,19
HND-009038,2011,90600020,,,,14,8,22
,2011,90600010,,,,3,4,7
HND-009037,2011,90600019,,,,11,6,17
HND-009034,2011,90600015,,,,10,17,27
HND-009035,2011,90600016,,,,2,2,4
,2011,90600017,,,,7,11,18
HND-009036,2011,90600018,,,,5,1,6
,2011,90600010,,,,5,2,7
HND-009037,2011,90600019,,,,5,8,13
HND-009038,2011,90600020,,,,13,16,29
HND-009024,2011,90600002,,,,12,7,19
HND-009025,2011,90600003,,,,18,23,41
HND-009026,2011,90600004,,,,5,0,5
HND-009038,2011,90600020,,,,7,11,18
HND-009044,2011,90600026,,,,27,9,36
HND-009045,2011,90600027,,,,3,4,7
HND-009046,2011,90600028,,,,2,3,5
HND-009051,2011,90600042,,,,9,9,18
HND-009027,2011,90600005,,,,22,18,40
HND-009028,2011,90600006,,,,4,5,9
HND-009029,2011,90600007,,,,16,5,21
HND-009030,2011,90600008,,,,11,3,14
HND-009031,2011,90600012,,,,2,5,7
HND-009032,2011,90600013,,,,2,5,7
HND-009033,2011,90600014,,,,3,0,3
HND-009039,2011,90600021,,,,1,1,2
HND-009040,2011,90600022,,,,4,3,7
HND-009041,2011,90600023,,,,16,17,33
HND-009042,2011,90600024,,,,31,29,60
HND-009043,2011,90600025,,,,6,11,17
HND-009047,2011,90600030,,,,5,8,13
HND-009024,2011,90600002,,,,3,7,10
HND-009025,2011,90600003,,,,26,18,44
HND-009030,2011,90600008,,,,14,15,29
HND-009033,2011,90600014,,,,2,1,3
HND-009040,2011,90600022,,,,3,4,7
HND-009043,2011,90600025,,,,6,7,13
HND-009045,2011,90600027,,,,3,1,4
HND-009047,2011,90600030,,,,6,1,7
HND-009026,2011,90600004,,,,2,1,3
HND-009027,2011,90600005,,,,11,10,21
HND-009028,2011,90600006,,,,1,3,4
HND-009029,2011,90600007,,,,16,16,32
HND-009031,2011,90600012,,,,5,5,10
HND-009032,2011,90600013,,,,3,4,7
HND-009038,2011,90600020,,,,10,8,18
HND-009039,2011,90600021,,,,0,1,1
HND-009041,2011,90600023,,,,8,7,15
HND-009042,2011,90600024,,,,21,19,40
HND-009044,2011,90600026,,,,1,2,3
HND-009046,2011,90600028,,,,1,2,3
HND-009051,2011,90600042,,,,5,6,11
HND-009024,2011,90600002,,,,6,6,12
HND-009025,2011,90600003,,,,22,21,43
HND-009026,2011,90600004,,,,1,1,2
HND-009038,2011,90600020,,,,16,6,22
HND-009044,2011,90600026,,,,4,0,4
HND-009045,2011,90600027,,,,2,1,3
HND-009047,2011,90600030,,,,1,2,3
HND-009027,2011,90600005,,,,10,7,17
HND-009029,2011,90600007,,,,15,16,31
HND-009030,2011,90600008,,,,9,17,26
HND-009031,2011,90600012,,,,4,10,14
HND-009032,2011,90600013,,,,7,2,9
HND-009033,2011,90600014,,,,1,0,1
HND-009039,2011,90600021,,,,3,6,9
HND-009040,2011,90600022,,,,2,1,3
HND-009041,2011,90600023,,,,7,6,13
HND-009042,2011,90600024,,,,26,34,60
HND-009043,2011,90600025,,,,3,4,7
HND-009051,2011,90600042,,,,0,2,2
HND-009025,2011,90600003,,,,25,21,46
HND-009027,2011,90600005,,,,10,11,21
HND-009028,2011,90600006,,,,3,0,3
HND-009030,2011,90600008,,,,20,16,36
HND-009033,2011,90600014,,,,1,1,2
HND-009040,2011,90600022,,,,2,3,5
HND-009051,2011,90600042,,,,3,1,4
HND-009024,2011,90600002,,,,2,2,4
HND-009026,2011,90600004,,,,2,2,4
HND-009029,2011,90600007,,,,6,13,19
HND-009031,2011,90600012,,,,7,8,15
HND-009032,2011,90600013,,,,1,3,4
HND-009038,2011,90600020,,,,7,10,17
HND-009039,2011,90600021,,,,3,2,5
HND-009042,2011,90600024,,,,30,30,60
HND-009044,2011,90600026,,,,4,2,6
HND-009045,2011,90600027,,,,1,0,1
HND-009046,2011,90600028,,,,2,4,6
HND-009047,2011,90600030,,,,0,1,1
HND-009027,2011,90600005,,,,4,7,11
HND-009028,2011,90600006,,,,2,1,3
HND-009029,2011,90600007,,,,12,15,27
HND-009030,2011,90600008,,,,14,12,26
HND-009031,2011,90600012,,,,4,19,23
HND-009033,2011,90600014,,,,1,2,3
HND-009040,2011,90600022,,,,2,2,4
HND-009042,2011,90600024,,,,35,30,65
HND-009051,2011,90600042,,,,3,0,3
HND-009024,2011,90600002,,,,1,1,2
HND-009025,2011,90600003,,,,32,19,51
HND-009026,2011,90600004,,,,2,3,5
HND-009032,2011,90600013,,,,1,1,2
HND-009038,2011,90600020,,,,15,7,22
HND-009039,2011,90600021,,,,1,3,4
HND-009044,2011,90600026,,,,2,0,2
HND-009045,2011,90600027,,,,1,0,1
HND-009046,2011,90600028,,,,1,2,3
HND-009047,2011,90600030,,,,0,1,1
HND-009026,2011,90600004,,,,1,1,2
HND-009027,2011,90600005,,,,7,7,14
HND-009028,2011,90600006,,,,3,3,6
HND-009029,2011,90600007,,,,13,13,26
HND-009031,2011,90600012,,,,8,4,12
HND-009032,2011,90600013,,,,1,2,3
HND-009038,2011,90600020,,,,5,8,13
HND-009039,2011,90600021,,,,2,2,4
HND-009042,2011,90600024,,,,26,34,60
HND-009044,2011,90600026,,,,1,3,4
HND-009046,2011,90600028,,,,1,2,3
HND-009051,2011,90600042,,,,2,1,3
HND-009024,2011,90600002,,,,3,2,5
HND-009025,2011,90600003,,,,25,29,54
HND-009030,2011,90600008,,,,19,15,34
HND-009033,2011,90600014,,,,2,2,4
HND-009040,2011,90600022,,,,1,1,2
HND-009045,2011,90600027,,,,1,1,2
HND-009047,2011,90600030,,,,0,1,1
HND-009023,2011,90600001,,,,64,67,131
HND-009025,2011,90600003,,,,27,24,51
HND-009023,2011,90600001,,,,37,48,85
HND-009025,2011,90600003,,,,11,12,23
HND-009023,2011,90600001,,,,28,36,64
HND-009025,2011,90600003,,,,8,14,22
HND-009023,2011,90600001,,,,21,26,47
HND-009023,2011,90600001,,,,21,31,52
HND-009023,2011,90600001,,,,18,15,33
HND-009072,2011,100100030,,,,13,7,20
HND-009073,2011,100100031,,,,6,8,14
HND-009080,2011,100100056,,,,1,6,7
HND-009078,2011,100100054,,,,7,8,15
,2011,100100023,,,,18,21,39
HND-009074,2011,100100032,,,,1,0,1
,2011,100100042,,,,0,3,3
,2011,100100052,,,,1,3,4
,2011,100100016,,,,2,3,5
,2011,100100017,,,,10,11,21
HND-009067,2011,100100021,,,,9,19,28
HND-009069,2011,100100024,,,,4,2,6
,2011,100100025,,,,3,5,8
,2011,100100034,,,,4,3,7
,2011,100100042,,,,0,2,2
,2011,100100052,,,,6,9,15
HND-009063,2011,100100014,,,,32,27,59
HND-009064,2011,100100015,,,,11,7,18
HND-009065,2011,100100018,,,,5,11,16
HND-009068,2011,100100022,,,,6,8,14
,2011,100100023,,,,48,54,102
HND-009071,2011,100100029,,,,1,1,2
HND-009074,2011,100100032,,,,6,3,9
,2011,100100051,,,,2,3,5
HND-009064,2011,100100015,,,,12,11,23
,2011,100100016,,,,2,5,7
HND-009065,2011,100100018,,,,12,12,24
HND-009068,2011,100100022,,,,6,2,8
,2011,100100023,,,,73,92,165
HND-009069,2011,100100024,,,,3,4,7
HND-009071,2011,100100029,,,,6,8,14
HND-009074,2011,100100032,,,,1,2,3
,2011,100100042,,,,4,4,8
,2011,100100051,,,,2,5,7
,2011,100100052,,,,10,9,19
HND-009063,2011,100100014,,,,19,12,31
,2011,100100017,,,,15,15,30
HND-009067,2011,100100021,,,,20,15,35
,2011,100100025,,,,4,4,8
,2011,100100034,,,,8,7,15
HND-009053,2011,100100001,,,,10,3,13
HND-009054,2011,100100002,,,,7,6,13
HND-009055,2011,100100003,,,,84,66,150
HND-009059,2011,100100007,,,,47,47,94
HND-009060,2011,100100008,,,,8,4,12
HND-009062,2011,100100011,,,,1,2,3
,2011,100100016,,,,4,2,6
,2011,100100017,,,,17,10,27
HND-009075,2011,100100040,,,,4,8,12
,2011,100100052,,,,12,15,27
HND-009079,2011,100100055,,,,2,3,5
HND-009056,2011,100100004,,,,20,10,30
,2011,100100006,,,,15,15,30
HND-009061,2011,100100009,,,,3,2,5
HND-009071,2011,100100029,,,,3,9,12
HND-009077,2011,100100053,,,,15,13,28
HND-009053,2011,100100001,,,,10,10,20
,2011,100100006,,,,10,9,19
HND-009062,2011,100100011,,,,2,1,3
,2011,100100016,,,,3,4,7
HND-009075,2011,100100040,,,,5,4,9
HND-009077,2011,100100053,,,,14,6,20
HND-009079,2011,100100055,,,,4,7,11
HND-009054,2011,100100002,,,,6,5,11
HND-009055,2011,100100003,,,,70,67,137
HND-009056,2011,100100004,,,,32,13,45
HND-009057,2011,100100005,,,,4,2,6
HND-009059,2011,100100007,,,,45,54,99
HND-009060,2011,100100008,,,,7,5,12
HND-009061,2011,100100009,,,,1,3,4
,2011,100100017,,,,7,22,29
HND-009071,2011,100100029,,,,4,4,8
,2011,100100052,,,,8,12,20
HND-009053,2011,100100001,,,,4,1,5
,2011,100100006,,,,9,18,27
HND-009061,2011,100100009,,,,2,5,7
HND-009071,2011,100100029,,,,3,3,6
HND-009077,2011,100100053,,,,9,9,18
HND-009054,2011,100100002,,,,5,7,12
HND-009055,2011,100100003,,,,65,51,116
HND-009056,2011,100100004,,,,14,19,33
HND-009057,2011,100100005,,,,2,2,4
HND-009059,2011,100100007,,,,48,51,99
HND-009060,2011,100100008,,,,3,7,10
HND-009062,2011,100100011,,,,2,0,2
,2011,100100016,,,,5,4,9
,2011,100100017,,,,10,19,29
HND-009075,2011,100100040,,,,9,6,15
,2011,100100052,,,,2,7,9
HND-009079,2011,100100055,,,,6,6,12
HND-009056,2011,100100004,,,,18,18,36
HND-009057,2011,100100005,,,,4,1,5
,2011,100100006,,,,9,5,14
HND-009075,2011,100100040,,,,5,4,9
,2011,100100052,,,,8,8,16
HND-009077,2011,100100053,,,,13,15,28
HND-009079,2011,100100055,,,,3,0,3
HND-009053,2011,100100001,,,,10,5,15
HND-009054,2011,100100002,,,,3,6,9
HND-009055,2011,100100003,,,,71,56,127
HND-009059,2011,100100007,,,,51,35,86
HND-009060,2011,100100008,,,,5,1,6
HND-009061,2011,100100009,,,,2,3,5
HND-009062,2011,100100011,,,,3,1,4
,2011,100100016,,,,7,2,9
,2011,100100017,,,,21,16,37
HND-009071,2011,100100029,,,,5,1,6
HND-009056,2011,100100004,,,,12,15,27
HND-009057,2011,100100005,,,,2,1,3
,2011,100100006,,,,6,4,10
HND-009061,2011,100100009,,,,0,4,4
HND-009071,2011,100100029,,,,8,4,12
HND-009075,2011,100100040,,,,5,2,7
,2011,100100052,,,,5,5,10
HND-009079,2011,100100055,,,,4,5,9
HND-009053,2011,100100001,,,,7,5,12
HND-009054,2011,100100002,,,,8,3,11
HND-009055,2011,100100003,,,,67,78,145
HND-009059,2011,100100007,,,,48,46,94
HND-009060,2011,100100008,,,,7,1,8
HND-009062,2011,100100011,,,,1,1,2
,2011,100100016,,,,5,6,11
,2011,100100017,,,,11,18,29
HND-009077,2011,100100053,,,,4,9,13
HND-009053,2011,100100001,,,,4,1,5
,2011,100100006,,,,6,12,18
HND-009062,2011,100100011,,,,0,1,1
,2011,100100016,,,,5,6,11
,2011,100100052,,,,3,13,16
HND-009054,2011,100100002,,,,6,3,9
HND-009055,2011,100100003,,,,78,70,148
HND-009056,2011,100100004,,,,14,17,31
HND-009057,2011,100100005,,,,1,0,1
HND-009059,2011,100100007,,,,39,45,84
HND-009060,2011,100100008,,,,5,6,11
HND-009061,2011,100100009,,,,3,2,5
,2011,100100017,,,,7,8,15
HND-009071,2011,100100029,,,,4,3,7
HND-009075,2011,100100040,,,,10,1,11
HND-009077,2011,100100053,,,,9,2,11
HND-009079,2011,100100055,,,,3,5,8
,2011,100100016,,,,5,3,8
,2011,100100017,,,,9,10,19
,2011,100100027,,,,82,82,164
,2011,100100028,,,,9,15,24
,2011,100100051,,,,5,3,8
,2011,100100006,,,,14,15,29
,2011,100100019,,,,6,9,15
HND-009066,2011,100100020,,,,308,295,603
,2011,100100052,,,,1,3,4
,2011,100100016,,,,3,6,9
,2011,100100017,,,,4,9,13
,2011,100100019,,,,15,3,18
,2011,100100027,,,,49,57,106
,2011,100100052,,,,0,8,8
,2011,100100006,,,,10,7,17
HND-009066,2011,100100020,,,,234,242,476
,2011,100100028,,,,10,10,20
,2011,100100051,,,,3,6,9
,2011,100100006,,,,9,4,13
,2011,100100017,,,,10,10,20
HND-009066,2011,100100020,,,,198,265,463
,2011,100100027,,,,45,45,90
,2011,100100028,,,,6,9,15
,2011,100100016,,,,1,6,7
,2011,100100019,,,,14,11,25
,2011,100100051,,,,1,6,7
,2011,100100017,,,,8,3,11
,2011,100100019,,,,75,85,160
HND-009070,2011,100100026,,,,176,249,425
,2011,100100027,,,,19,31,50
HND-009066,2011,100100020,,,,201,204,405
,2011,100100028,,,,15,28,43
,2011,100100052,,,,0,3,3
,2011,100100019,,,,55,62,117
HND-009070,2011,100100026,,,,140,258,398
,2011,100100052,,,,2,2,4
,2011,100100017,,,,4,5,9
HND-009066,2011,100100020,,,,224,205,429
,2011,100100027,,,,6,18,24
,2011,100100028,,,,13,19,32
HND-009066,2011,100100020,,,,122,146,268
,2011,100100027,,,,14,7,21
,2011,100100028,,,,2,9,11
,2011,100100019,,,,34,53,87
HND-009070,2011,100100026,,,,143,175,318
,2011,100200024,,,,8,8,16
,2011,100200028,,,,1,4,5
HND-009107,2011,100200036,,,,5,2,7
,2011,100200026,,,,11,5,16
,2011,100200027,,,,6,7,13
,2011,100200029,,,,6,6,12
,2011,100200030,,,,5,4,9
,2011,100200034,,,,3,3,6
HND-009102,2011,100200017,,,,0,1,1
HND-009096,2011,100200010,,,,6,5,11
HND-009102,2011,100200017,,,,1,1,2
HND-009106,2011,100200023,,,,6,4,10
HND-009101,2011,100200016,,,,2,5,7
HND-009103,2011,100200018,,,,9,6,15
,2011,100200019,,,,3,4,7
HND-009104,2011,100200020,,,,3,2,5
,2011,100200022,,,,1,3,4
HND-009101,2011,100200016,,,,5,5,10
HND-009103,2011,100200018,,,,5,5,10
,2011,100200019,,,,4,5,9
HND-009104,2011,100200020,,,,13,5,18
,2011,100200022,,,,7,11,18
HND-009096,2011,100200010,,,,3,8,11
HND-009102,2011,100200017,,,,6,1,7
HND-009106,2011,100200023,,,,4,4,8
,2011,100200001,,,,13,11,24
HND-009088,2011,100200002,,,,3,6,9
HND-009090,2011,100200004,,,,11,15,26
HND-009091,2011,100200005,,,,10,18,28
HND-009094,2011,100200008,,,,8,4,12
HND-009096,2011,100200010,,,,5,6,11
HND-009097,2011,100200011,,,,9,8,17
HND-009099,2011,100200013,,,,3,7,10
,2011,100200014,,,,1,2,3
HND-009089,2011,100200003,,,,6,6,12
HND-009092,2011,100200006,,,,11,10,21
HND-009093,2011,100200007,,,,9,4,13
HND-009095,2011,100200009,,,,11,16,27
HND-009098,2011,100200012,,,,7,10,17
HND-009089,2011,100200003,,,,5,10,15
HND-009090,2011,100200004,,,,18,10,28
HND-009092,2011,100200006,,,,3,7,10
HND-009093,2011,100200007,,,,12,5,17
HND-009099,2011,100200013,,,,7,2,9
,2011,100200001,,,,11,8,19
HND-009088,2011,100200002,,,,6,3,9
HND-009091,2011,100200005,,,,12,9,21
HND-009094,2011,100200008,,,,6,4,10
HND-009095,2011,100200009,,,,13,14,27
HND-009096,2011,100200010,,,,7,7,14
HND-009097,2011,100200011,,,,7,9,16
HND-009098,2011,100200012,,,,6,4,10
,2011,100200014,,,,3,5,8
HND-009089,2011,100200003,,,,11,11,22
HND-009092,2011,100200006,,,,8,12,20
HND-009093,2011,100200007,,,,3,10,13
HND-009095,2011,100200009,,,,17,19,36
HND-009098,2011,100200012,,,,6,3,9
,2011,100200001,,,,12,11,23
HND-009088,2011,100200002,,,,5,5,10
HND-009090,2011,100200004,,,,15,17,32
HND-009091,2011,100200005,,,,10,7,17
HND-009094,2011,100200008,,,,6,4,10
HND-009096,2011,100200010,,,,4,4,8
HND-009097,2011,100200011,,,,13,7,20
HND-009099,2011,100200013,,,,5,2,7
,2011,100200014,,,,0,1,1
HND-009089,2011,100200003,,,,3,6,9
HND-009090,2011,100200004,,,,10,11,21
HND-009093,2011,100200007,,,,10,1,11
HND-009094,2011,100200008,,,,8,4,12
HND-009097,2011,100200011,,,,7,7,14
HND-009099,2011,100200013,,,,3,2,5
,2011,100200001,,,,8,6,14
HND-009088,2011,100200002,,,,2,6,8
HND-009091,2011,100200005,,,,3,7,10
HND-009092,2011,100200006,,,,7,8,15
HND-009095,2011,100200009,,,,12,16,28
HND-009096,2011,100200010,,,,5,6,11
HND-009098,2011,100200012,,,,3,5,8
,2011,100200014,,,,4,3,7
HND-009088,2011,100200002,,,,4,2,6
HND-009090,2011,100200004,,,,5,9,14
HND-009093,2011,100200007,,,,3,8,11
HND-009094,2011,100200008,,,,1,6,7
HND-009097,2011,100200011,,,,5,7,12
HND-009099,2011,100200013,,,,2,1,3
,2011,100200001,,,,6,10,16
HND-009089,2011,100200003,,,,2,0,2
HND-009091,2011,100200005,,,,4,5,9
HND-009092,2011,100200006,,,,8,4,12
HND-009095,2011,100200009,,,,14,21,35
HND-009096,2011,100200010,,,,8,5,13
HND-009098,2011,100200012,,,,4,5,9
,2011,100200014,,,,0,1,1
,2011,100200001,,,,9,8,17
HND-009088,2011,100200002,,,,3,9,12
HND-009091,2011,100200005,,,,3,3,6
HND-009094,2011,100200008,,,,1,0,1
HND-009095,2011,100200009,,,,7,13,20
HND-009096,2011,100200010,,,,10,9,19
HND-009097,2011,100200011,,,,5,7,12
HND-009098,2011,100200012,,,,7,4,11
,2011,100200014,,,,2,0,2
HND-009090,2011,100200004,,,,1,4,5
HND-009092,2011,100200006,,,,6,13,19
HND-009093,2011,100200007,,,,4,2,6
HND-009095,2011,100200009,,,,9,9,18
HND-009100,2011,100200015,,,,61,38,99
HND-009100,2011,100200015,,,,60,75,135
HND-009095,2011,100200009,,,,7,11,18
HND-009095,2011,100200009,,,,8,5,13
HND-009100,2011,100200015,,,,45,55,100
HND-009100,2011,100200015,,,,31,35,66
HND-009100,2011,100200015,,,,15,13,28
HND-009100,2011,100200015,,,,3,9,12
HND-009100,2011,100200015,,,,6,5,11
HND-009129,2011,100300022,,,,5,3,8
HND-009157,2011,100300063,,,,8,5,13
,2011,100300132,,,,10,9,19
HND-009158,2011,100300136,,,,7,6,13
HND-009159,2011,100300137,,,,17,14,31
HND-009161,2011,100300155,,,,9,5,14
HND-009163,2011,100300160,,,,3,5,8
,2011,100300164,,,,7,2,9
,2011,100300165,,,,3,6,9
HND-009164,2011,100300166,,,,2,2,4
HND-009113,2011,100300005,,,,6,7,13
,2011,100300049,,,,5,5,10
HND-009156,2011,100300062,,,,4,7,11
,2011,100300105,,,,4,5,9
HND-009160,2011,100300154,,,,6,9,15
HND-009162,2011,100300156,,,,2,6,8
,2011,100300161,,,,6,10,16
,2011,100300050,,,,1,1,2
HND-009139,2011,100300032,,,,11,10,21
HND-009140,2011,100300033,,,,5,10,15
HND-009141,2011,100300034,,,,0,3,3
HND-009142,2011,100300036,,,,4,2,6
HND-009143,2011,100300037,,,,5,1,6
HND-009146,2011,100300042,,,,3,1,4
HND-009147,2011,100300044,,,,2,8,10
,2011,100300050,,,,3,3,6
HND-009153,2011,100300053,,,,3,4,7
,2011,100300056,,,,3,2,5
,2011,100300131,,,,2,3,5
,2011,100300162,,,,5,5,10
,2011,100300035,,,,16,11,27
,2011,100300038,,,,5,3,8
,2011,100300043,,,,12,6,18
,2011,100300045,,,,5,4,9
,2011,100300046,,,,3,3,6
HND-009149,2011,100300047,,,,7,6,13
HND-009151,2011,100300051,,,,4,5,9
HND-009154,2011,100300054,,,,5,8,13
,2011,100300061,,,,7,2,9
HND-009139,2011,100300032,,,,12,5,17
,2011,100300043,,,,10,8,18
,2011,100300046,,,,11,8,19
HND-009149,2011,100300047,,,,11,8,19
HND-009151,2011,100300051,,,,5,11,16
,2011,100300061,,,,7,8,15
,2011,100300131,,,,1,2,3
,2011,100300162,,,,8,5,13
HND-009140,2011,100300033,,,,13,9,22
HND-009141,2011,100300034,,,,13,19,32
HND-009142,2011,100300036,,,,5,9,14
HND-009143,2011,100300037,,,,3,5,8
,2011,100300038,,,,2,3,5
HND-009146,2011,100300042,,,,3,5,8
HND-009147,2011,100300044,,,,13,16,29
,2011,100300045,,,,16,21,37
,2011,100300050,,,,1,1,2
HND-009153,2011,100300053,,,,3,4,7
HND-009154,2011,100300054,,,,9,10,19
,2011,100300056,,,,2,5,7
HND-009111,2011,100300003,,,,19,19,38
HND-009113,2011,100300005,,,,12,7,19
HND-009114,2011,100300006,,,,14,9,23
HND-009117,2011,100300009,,,,15,13,28
HND-009118,2011,100300010,,,,23,28,51
HND-009119,2011,100300011,,,,16,18,34
,2011,100300013,,,,21,32,53
HND-009121,2011,100300014,,,,13,18,31
HND-009124,2011,100300017,,,,10,10,20
HND-009125,2011,100300018,,,,11,8,19
HND-009127,2011,100300020,,,,1,4,5
HND-009128,2011,100300021,,,,16,9,25
HND-009129,2011,100300022,,,,3,7,10
HND-009131,2011,100300024,,,,1,5,6
HND-009132,2011,100300025,,,,9,9,18
HND-009135,2011,100300028,,,,1,2,3
HND-009138,2011,100300031,,,,11,9,20
HND-009145,2011,100300041,,,,12,6,18
HND-009150,2011,100300048,,,,5,0,5
HND-009153,2011,100300053,,,,7,13,20
HND-009109,2011,100300001,,,,15,18,33
HND-009110,2011,100300002,,,,4,2,6
HND-009112,2011,100300004,,,,7,8,15
HND-009115,2011,100300007,,,,3,10,13
HND-009116,2011,100300008,,,,10,17,27
HND-009120,2011,100300012,,,,10,8,18
HND-009122,2011,100300015,,,,11,11,22
HND-009123,2011,100300016,,,,8,3,11
HND-009126,2011,100300019,,,,9,4,13
HND-009130,2011,100300023,,,,11,5,16
HND-009133,2011,100300026,,,,5,5,10
HND-009134,2011,100300027,,,,7,6,13
HND-009136,2011,100300029,,,,19,13,32
HND-009137,2011,100300030,,,,8,5,13
HND-009152,2011,100300052,,,,1,3,4
HND-009155,2011,100300060,,,,5,7,12
HND-009109,2011,100300001,,,,23,13,36
HND-009110,2011,100300002,,,,2,4,6
HND-009112,2011,100300004,,,,9,4,13
HND-009113,2011,100300005,,,,4,12,16
HND-009116,2011,100300008,,,,8,5,13
HND-009117,2011,100300009,,,,15,11,26
,2011,100300013,,,,24,16,40
HND-009123,2011,100300016,,,,6,6,12
HND-009124,2011,100300017,,,,6,14,20
HND-009126,2011,100300019,,,,8,3,11
HND-009128,2011,100300021,,,,9,6,15
HND-009130,2011,100300023,,,,10,6,16
HND-009133,2011,100300026,,,,5,2,7
HND-009134,2011,100300027,,,,6,2,8
HND-009145,2011,100300041,,,,8,6,14
HND-009152,2011,100300052,,,,4,1,5
HND-009155,2011,100300060,,,,9,7,16
HND-009111,2011,100300003,,,,19,12,31
HND-009114,2011,100300006,,,,8,18,26
HND-009115,2011,100300007,,,,11,6,17
HND-009118,2011,100300010,,,,20,18,38
HND-009119,2011,100300011,,,,17,11,28
HND-009120,2011,100300012,,,,19,20,39
HND-009121,2011,100300014,,,,11,14,25
HND-009122,2011,100300015,,,,9,10,19
HND-009125,2011,100300018,,,,8,9,17
HND-009127,2011,100300020,,,,1,5,6
HND-009129,2011,100300022,,,,4,1,5
HND-009131,2011,100300024,,,,5,3,8
HND-009132,2011,100300025,,,,15,10,25
HND-009135,2011,100300028,,,,3,3,6
HND-009136,2011,100300029,,,,14,15,29
HND-009137,2011,100300030,,,,5,4,9
HND-009138,2011,100300031,,,,14,6,20
HND-009150,2011,100300048,,,,4,3,7
HND-009153,2011,100300053,,,,5,6,11
HND-009109,2011,100300001,,,,20,15,35
HND-009110,2011,100300002,,,,4,1,5
HND-009112,2011,100300004,,,,7,6,13
HND-009116,2011,100300008,,,,2,4,6
HND-009122,2011,100300015,,,,15,19,34
HND-009123,2011,100300016,,,,8,2,10
HND-009126,2011,100300019,,,,11,9,20
HND-009130,2011,100300023,,,,14,6,20
HND-009133,2011,100300026,,,,7,4,11
HND-009134,2011,100300027,,,,4,3,7
HND-009136,2011,100300029,,,,18,13,31
HND-009137,2011,100300030,,,,8,9,17
HND-009152,2011,100300052,,,,3,0,3
HND-009155,2011,100300060,,,,12,7,19
HND-009111,2011,100300003,,,,18,13,31
HND-009113,2011,100300005,,,,5,7,12
HND-009114,2011,100300006,,,,17,10,27
HND-009115,2011,100300007,,,,11,9,20
HND-009117,2011,100300009,,,,17,17,34
HND-009118,2011,100300010,,,,26,29,55
HND-009119,2011,100300011,,,,24,15,39
HND-009120,2011,100300012,,,,8,6,14
,2011,100300013,,,,24,17,41
HND-009121,2011,100300014,,,,14,10,24
HND-009124,2011,100300017,,,,11,9,20
HND-009125,2011,100300018,,,,4,13,17
HND-009127,2011,100300020,,,,1,6,7
HND-009128,2011,100300021,,,,7,14,21
HND-009129,2011,100300022,,,,3,2,5
HND-009131,2011,100300024,,,,2,2,4
HND-009132,2011,100300025,,,,10,8,18
HND-009135,2011,100300028,,,,2,3,5
HND-009138,2011,100300031,,,,6,9,15
HND-009145,2011,100300041,,,,10,9,19
HND-009150,2011,100300048,,,,1,1,2
HND-009153,2011,100300053,,,,9,7,16
HND-009109,2011,100300001,,,,20,18,38
HND-009113,2011,100300005,,,,6,4,10
HND-009117,2011,100300009,,,,16,9,25
HND-009119,2011,100300011,,,,15,9,24
,2011,100300013,,,,27,13,40
HND-009123,2011,100300016,,,,4,8,12
HND-009124,2011,100300017,,,,9,4,13
HND-009127,2011,100300020,,,,7,3,10
HND-009128,2011,100300021,,,,8,10,18
HND-009130,2011,100300023,,,,7,11,18
HND-009131,2011,100300024,,,,4,3,7
HND-009133,2011,100300026,,,,3,1,4
HND-009134,2011,100300027,,,,5,2,7
HND-009135,2011,100300028,,,,5,2,7
HND-009145,2011,100300041,,,,4,4,8
HND-009152,2011,100300052,,,,3,1,4
HND-009155,2011,100300060,,,,7,6,13
HND-009111,2011,100300003,,,,9,18,27
HND-009112,2011,100300004,,,,14,12,26
HND-009114,2011,100300006,,,,9,6,15
HND-009115,2011,100300007,,,,6,8,14
HND-009116,2011,100300008,,,,7,6,13
HND-009118,2011,100300010,,,,20,19,39
HND-009120,2011,100300012,,,,13,8,21
HND-009121,2011,100300014,,,,16,15,31
HND-009122,2011,100300015,,,,7,6,13
HND-009125,2011,100300018,,,,3,7,10
HND-009126,2011,100300019,,,,5,3,8
HND-009129,2011,100300022,,,,2,3,5
HND-009132,2011,100300025,,,,8,11,19
HND-009136,2011,100300029,,,,7,7,14
HND-009137,2011,100300030,,,,7,5,12
HND-009138,2011,100300031,,,,4,9,13
HND-009150,2011,100300048,,,,3,3,6
HND-009153,2011,100300053,,,,5,8,13
HND-009110,2011,100300002,,,,2,4,6
HND-009111,2011,100300003,,,,8,18,26
HND-009112,2011,100300004,,,,8,8,16
HND-009115,2011,100300007,,,,8,6,14
HND-009116,2011,100300008,,,,6,6,12
HND-009120,2011,100300012,,,,17,11,28
HND-009122,2011,100300015,,,,6,14,20
HND-009125,2011,100300018,,,,8,7,15
HND-009126,2011,100300019,,,,5,3,8
HND-009132,2011,100300025,,,,10,16,26
HND-009133,2011,100300026,,,,7,1,8
HND-009136,2011,100300029,,,,2,2,4
HND-009145,2011,100300041,,,,13,8,21
HND-009150,2011,100300048,,,,1,3,4
HND-009153,2011,100300053,,,,3,11,14
HND-009155,2011,100300060,,,,3,8,11
HND-009109,2011,100300001,,,,11,20,31
HND-009113,2011,100300005,,,,1,2,3
HND-009114,2011,100300006,,,,8,6,14
HND-009117,2011,100300009,,,,15,18,33
HND-009118,2011,100300010,,,,10,14,24
HND-009119,2011,100300011,,,,7,13,20
,2011,100300013,,,,23,16,39
HND-009121,2011,100300014,,,,13,19,32
HND-009123,2011,100300016,,,,5,5,10
HND-009124,2011,100300017,,,,12,3,15
HND-009127,2011,100300020,,,,2,4,6
HND-009128,2011,100300021,,,,6,4,10
HND-009129,2011,100300022,,,,2,3,5
HND-009130,2011,100300023,,,,10,6,16
HND-009131,2011,100300024,,,,3,6,9
HND-009134,2011,100300027,,,,7,3,10
HND-009135,2011,100300028,,,,1,2,3
HND-009137,2011,100300030,,,,4,5,9
HND-009138,2011,100300031,,,,5,7,12
HND-009152,2011,100300052,,,,1,2,3
HND-009109,2011,100300001,,,,17,15,32
HND-009112,2011,100300004,,,,8,4,12
HND-009113,2011,100300005,,,,5,2,7
HND-009116,2011,100300008,,,,7,6,13
HND-009117,2011,100300009,,,,11,20,31
,2011,100300013,,,,13,8,21
HND-009123,2011,100300016,,,,11,2,13
HND-009124,2011,100300017,,,,8,4,12
HND-009126,2011,100300019,,,,3,5,8
HND-009128,2011,100300021,,,,10,5,15
HND-009130,2011,100300023,,,,6,5,11
HND-009133,2011,100300026,,,,5,0,5
HND-009134,2011,100300027,,,,6,3,9
HND-009137,2011,100300030,,,,2,6,8
HND-009138,2011,100300031,,,,4,2,6
HND-009150,2011,100300048,,,,3,1,4
HND-009153,2011,100300053,,,,8,3,11
HND-009155,2011,100300060,,,,5,2,7
HND-009111,2011,100300003,,,,18,11,29
HND-009114,2011,100300006,,,,3,5,8
HND-009115,2011,100300007,,,,4,8,12
HND-009118,2011,100300010,,,,9,13,22
HND-009119,2011,100300011,,,,2,8,10
HND-009120,2011,100300012,,,,12,10,22
HND-009121,2011,100300014,,,,13,13,26
HND-009122,2011,100300015,,,,9,8,17
HND-009125,2011,100300018,,,,6,3,9
HND-009127,2011,100300020,,,,3,5,8
HND-009129,2011,100300022,,,,5,1,6
HND-009131,2011,100300024,,,,1,1,2
HND-009132,2011,100300025,,,,8,8,16
HND-009135,2011,100300028,,,,1,1,2
HND-009136,2011,100300029,,,,3,4,7
HND-009145,2011,100300041,,,,2,9,11
HND-009152,2011,100300052,,,,1,3,4
HND-009117,2011,100300009,,,,15,16,31
HND-009118,2011,100300010,,,,7,9,16
HND-009121,2011,100300014,,,,6,16,22
HND-009144,2011,100300040,,,,53,49,102
HND-009111,2011,100300003,,,,12,10,22
HND-009116,2011,100300008,,,,16,6,22
HND-009111,2011,100300003,,,,13,5,18
HND-009118,2011,100300010,,,,5,7,12
HND-009121,2011,100300014,,,,6,13,19
HND-009116,2011,100300008,,,,8,13,21
HND-009117,2011,100300009,,,,13,24,37
HND-009144,2011,100300040,,,,66,54,120
HND-009116,2011,100300008,,,,12,10,22
HND-009117,2011,100300009,,,,15,15,30
HND-009111,2011,100300003,,,,12,10,22
HND-009118,2011,100300010,,,,5,6,11
HND-009121,2011,100300014,,,,9,6,15
HND-009144,2011,100300040,,,,41,54,95
HND-009144,2011,100300040,,,,43,59,102
HND-009144,2011,100300040,,,,29,53,82
HND-009144,2011,100300040,,,,29,37,66
HND-009200,2011,100400036,,,,5,8,13
,2011,100400045,,,,8,3,11
,2011,100400061,,,,5,5,10
HND-009208,2011,100400063,,,,8,8,16
HND-009209,2011,100400067,,,,5,0,5
HND-009210,2011,100400068,,,,6,2,8
,2011,100400071,,,,6,3,9
HND-009212,2011,100400073,,,,3,8,11
HND-009198,2011,100400034,,,,5,2,7
HND-009202,2011,100400041,,,,2,6,8
HND-009203,2011,100400043,,,,5,4,9
HND-009204,2011,100400047,,,,1,5,6
,2011,100400069,,,,4,2,6
,2011,100400072,,,,4,3,7
HND-009213,2011,100400074,,,,1,3,4
,2011,100400075,,,,4,2,6
,2011,100400029,,,,5,4,9
,2011,100400051,,,,4,4,8
,2011,100400052,,,,4,4,8
HND-009211,2011,100400070,,,,2,3,5
HND-009191,2011,100400026,,,,8,6,14
HND-009192,2011,100400027,,,,8,8,16
HND-009193,2011,100400028,,,,2,4,6
HND-009194,2011,100400030,,,,6,4,10
HND-009199,2011,100400035,,,,1,1,2
HND-009201,2011,100400040,,,,3,5,8
HND-009207,2011,100400053,,,,5,3,8
HND-009191,2011,100400026,,,,9,8,17
HND-009193,2011,100400028,,,,3,5,8
HND-009199,2011,100400035,,,,2,5,7
HND-009207,2011,100400053,,,,4,5,9
HND-009192,2011,100400027,,,,10,4,14
,2011,100400029,,,,8,5,13
HND-009194,2011,100400030,,,,11,4,15
HND-009195,2011,100400031,,,,12,10,22
HND-009201,2011,100400040,,,,2,2,4
,2011,100400051,,,,2,10,12
,2011,100400052,,,,1,1,2
HND-009211,2011,100400070,,,,4,4,8
HND-009166,2011,100400001,,,,2,2,4
HND-009169,2011,100400004,,,,17,20,37
HND-009170,2011,100400005,,,,3,1,4
HND-009173,2011,100400008,,,,5,3,8
HND-009175,2011,100400010,,,,3,6,9
HND-009176,2011,100400011,,,,3,1,4
HND-009177,2011,100400012,,,,10,11,21
HND-009178,2011,100400013,,,,7,9,16
HND-009179,2011,100400014,,,,7,6,13
HND-009182,2011,100400017,,,,2,3,5
HND-009183,2011,100400018,,,,8,6,14
HND-009190,2011,100400025,,,,4,3,7
HND-009206,2011,100400049,,,,3,1,4
HND-009167,2011,100400002,,,,11,20,31
HND-009168,2011,100400003,,,,4,4,8
HND-009171,2011,100400006,,,,8,8,16
HND-009172,2011,100400007,,,,4,1,5
HND-009174,2011,100400009,,,,1,1,2
HND-009180,2011,100400015,,,,7,4,11
HND-009181,2011,100400016,,,,3,3,6
HND-009185,2011,100400020,,,,4,6,10
HND-009186,2011,100400021,,,,1,1,2
HND-009188,2011,100400023,,,,1,2,3
HND-009189,2011,100400024,,,,12,4,16
HND-009196,2011,100400032,,,,11,5,16
HND-009205,2011,100400048,,,,8,11,19
HND-009166,2011,100400001,,,,4,4,8
HND-009167,2011,100400002,,,,16,19,35
HND-009168,2011,100400003,,,,7,3,10
HND-009169,2011,100400004,,,,22,22,44
HND-009171,2011,100400006,,,,4,5,9
HND-009172,2011,100400007,,,,1,3,4
HND-009176,2011,100400011,,,,3,5,8
HND-009178,2011,100400013,,,,11,8,19
HND-009181,2011,100400016,,,,6,1,7
HND-009182,2011,100400017,,,,3,2,5
HND-009184,2011,100400019,,,,0,3,3
HND-009185,2011,100400020,,,,3,2,5
HND-009186,2011,100400021,,,,0,4,4
HND-009189,2011,100400024,,,,5,9,14
HND-009190,2011,100400025,,,,4,6,10
HND-009196,2011,100400032,,,,4,8,12
HND-009170,2011,100400005,,,,4,3,7
HND-009173,2011,100400008,,,,2,3,5
HND-009174,2011,100400009,,,,1,0,1
HND-009175,2011,100400010,,,,11,1,12
HND-009177,2011,100400012,,,,15,3,18
HND-009179,2011,100400014,,,,4,9,13
HND-009180,2011,100400015,,,,5,7,12
HND-009183,2011,100400018,,,,3,3,6
HND-009188,2011,100400023,,,,3,1,4
HND-009205,2011,100400048,,,,9,8,17
HND-009167,2011,100400002,,,,15,20,35
HND-009168,2011,100400003,,,,5,4,9
HND-009171,2011,100400006,,,,7,11,18
HND-009172,2011,100400007,,,,3,3,6
HND-009174,2011,100400009,,,,5,2,7
HND-009180,2011,100400015,,,,5,6,11
HND-009181,2011,100400016,,,,4,2,6
HND-009184,2011,100400019,,,,0,2,2
HND-009185,2011,100400020,,,,3,6,9
HND-009186,2011,100400021,,,,3,2,5
HND-009188,2011,100400023,,,,3,4,7
HND-009189,2011,100400024,,,,4,7,11
HND-009196,2011,100400032,,,,2,6,8
HND-009205,2011,100400048,,,,7,4,11
HND-009166,2011,100400001,,,,1,3,4
HND-009169,2011,100400004,,,,22,18,40
HND-009170,2011,100400005,,,,2,3,5
HND-009173,2011,100400008,,,,1,4,5
HND-009175,2011,100400010,,,,3,4,7
HND-009176,2011,100400011,,,,2,6,8
HND-009177,2011,100400012,,,,5,9,14
HND-009178,2011,100400013,,,,14,10,24
HND-009179,2011,100400014,,,,8,3,11
HND-009182,2011,100400017,,,,1,3,4
HND-009183,2011,100400018,,,,8,5,13
HND-009190,2011,100400025,,,,2,3,5
HND-009166,2011,100400001,,,,2,0,2
HND-009168,2011,100400003,,,,3,6,9
HND-009169,2011,100400004,,,,18,29,47
HND-009172,2011,100400007,,,,5,4,9
HND-009173,2011,100400008,,,,8,3,11
HND-009176,2011,100400011,,,,2,2,4
HND-009178,2011,100400013,,,,5,11,16
HND-009182,2011,100400017,,,,4,6,10
HND-009185,2011,100400020,,,,7,4,11
HND-009187,2011,100400022,,,,1,0,1
HND-009189,2011,100400024,,,,6,5,11
HND-009190,2011,100400025,,,,2,7,9
HND-009206,2011,100400049,,,,0,1,1
HND-009167,2011,100400002,,,,15,13,28
HND-009170,2011,100400005,,,,2,2,4
HND-009171,2011,100400006,,,,7,5,12
HND-009174,2011,100400009,,,,3,1,4
HND-009175,2011,100400010,,,,9,5,14
HND-009177,2011,100400012,,,,4,5,9
HND-009179,2011,100400014,,,,11,3,14
HND-009180,2011,100400015,,,,6,5,11
HND-009183,2011,100400018,,,,2,3,5
HND-009186,2011,100400021,,,,3,0,3
HND-009188,2011,100400023,,,,2,2,4
HND-009196,2011,100400032,,,,12,6,18
HND-009205,2011,100400048,,,,9,5,14
HND-009166,2011,100400001,,,,3,3,6
HND-009169,2011,100400004,,,,7,5,12
HND-009172,2011,100400007,,,,4,2,6
HND-009173,2011,100400008,,,,1,6,7
HND-009175,2011,100400010,,,,8,2,10
HND-009176,2011,100400011,,,,3,5,8
HND-009178,2011,100400013,,,,13,8,21
HND-009179,2011,100400014,,,,10,6,16
HND-009181,2011,100400016,,,,9,3,12
HND-009182,2011,100400017,,,,2,1,3
HND-009183,2011,100400018,,,,3,4,7
HND-009187,2011,100400022,,,,1,2,3
HND-009190,2011,100400025,,,,2,3,5
HND-009206,2011,100400049,,,,1,1,2
HND-009167,2011,100400002,,,,19,11,30
HND-009168,2011,100400003,,,,3,3,6
HND-009170,2011,100400005,,,,5,8,13
HND-009171,2011,100400006,,,,7,16,23
HND-009174,2011,100400009,,,,3,6,9
HND-009177,2011,100400012,,,,8,12,20
HND-009180,2011,100400015,,,,3,6,9
HND-009184,2011,100400019,,,,2,4,6
HND-009185,2011,100400020,,,,7,3,10
HND-009186,2011,100400021,,,,7,4,11
HND-009188,2011,100400023,,,,2,0,2
HND-009189,2011,100400024,,,,8,5,13
HND-009196,2011,100400032,,,,5,4,9
HND-009205,2011,100400048,,,,4,9,13
HND-009170,2011,100400005,,,,6,4,10
HND-009173,2011,100400008,,,,2,6,8
HND-009174,2011,100400009,,,,2,3,5
HND-009175,2011,100400010,,,,4,5,9
HND-009177,2011,100400012,,,,10,4,14
HND-009179,2011,100400014,,,,10,10,20
HND-009180,2011,100400015,,,,4,14,18
HND-009183,2011,100400018,,,,4,4,8
HND-009188,2011,100400023,,,,4,1,5
HND-009205,2011,100400048,,,,6,7,13
HND-009206,2011,100400049,,,,4,4,8
HND-009167,2011,100400002,,,,14,16,30
HND-009168,2011,100400003,,,,4,1,5
HND-009169,2011,100400004,,,,11,11,22
HND-009171,2011,100400006,,,,5,7,12
HND-009172,2011,100400007,,,,1,3,4
HND-009176,2011,100400011,,,,5,2,7
HND-009178,2011,100400013,,,,12,16,28
HND-009181,2011,100400016,,,,0,2,2
HND-009185,2011,100400020,,,,4,9,13
HND-009187,2011,100400022,,,,3,4,7
HND-009189,2011,100400024,,,,8,3,11
HND-009190,2011,100400025,,,,1,1,2
HND-009196,2011,100400032,,,,3,6,9
HND-009169,2011,100400004,,,,27,29,56
HND-009179,2011,100400014,,,,11,27,38
HND-009197,2011,100400033,,,,36,39,75
HND-009185,2011,100400020,,,,14,15,29
HND-009169,2011,100400004,,,,24,31,55
HND-009185,2011,100400020,,,,7,7,14
HND-009179,2011,100400014,,,,13,18,31
HND-009197,2011,100400033,,,,31,35,66
HND-009169,2011,100400004,,,,21,10,31
HND-009185,2011,100400020,,,,6,9,15
HND-009179,2011,100400014,,,,15,12,27
HND-009197,2011,100400033,,,,40,29,69
HND-009197,2011,100400033,,,,14,21,35
HND-009197,2011,100400033,,,,17,10,27
HND-009197,2011,100400033,,,,15,22,37
HND-009234,2011,100500031,,,,7,7,14
HND-009237,2011,100500050,,,,8,2,10
HND-009238,2011,100500051,,,,3,4,7
HND-009240,2011,100500053,,,,4,8,12
HND-009232,2011,100500023,,,,7,3,10
HND-009233,2011,100500026,,,,7,5,12
HND-009235,2011,100500048,,,,7,3,10
HND-009239,2011,100500052,,,,7,2,9
HND-009221,2011,100500010,,,,1,0,1
HND-009224,2011,100500014,,,,3,3,6
,2011,100500015,,,,2,1,3
HND-009230,2011,100500021,,,,2,2,4
HND-009225,2011,100500016,,,,2,0,2
HND-009229,2011,100500020,,,,1,1,2
HND-009231,2011,100500022,,,,1,4,5
HND-009220,2011,100500009,,,,4,1,5
HND-009221,2011,100500010,,,,1,4,5
HND-009222,2011,100500011,,,,0,2,2
HND-009224,2011,100500014,,,,4,2,6
HND-009223,2011,100500013,,,,8,2,10
,2011,100500015,,,,2,4,6
HND-009225,2011,100500016,,,,1,0,1
HND-009229,2011,100500020,,,,2,3,5
HND-009230,2011,100500021,,,,5,1,6
HND-009231,2011,100500022,,,,1,4,5
HND-009220,2011,100500009,,,,7,4,11
HND-009221,2011,100500010,,,,6,5,11
HND-009222,2011,100500011,,,,11,9,20
HND-009224,2011,100500014,,,,5,4,9
,2011,100500015,,,,8,6,14
HND-009223,2011,100500013,,,,5,5,10
HND-009225,2011,100500016,,,,8,5,13
HND-009229,2011,100500020,,,,5,2,7
HND-009230,2011,100500021,,,,7,0,7
HND-009231,2011,100500022,,,,5,7,12
,2011,100500003,,,,31,15,46
HND-009216,2011,100500005,,,,10,5,15
HND-009217,2011,100500006,,,,2,6,8
HND-009226,2011,100500017,,,,8,4,12
HND-009227,2011,100500018,,,,4,7,11
HND-009236,2011,100500049,,,,5,3,8
,2011,100500001,,,,9,10,19
HND-009215,2011,100500002,,,,9,10,19
,2011,100500004,,,,7,8,15
HND-009218,2011,100500007,,,,6,5,11
HND-009219,2011,100500008,,,,1,11,12
HND-009228,2011,100500019,,,,6,7,13
,2011,100500003,,,,18,15,33
HND-009217,2011,100500006,,,,0,5,5
HND-009218,2011,100500007,,,,4,4,8
HND-009227,2011,100500018,,,,4,3,7
,2011,100500001,,,,10,17,27
HND-009215,2011,100500002,,,,10,10,20
,2011,100500004,,,,5,9,14
HND-009216,2011,100500005,,,,6,6,12
HND-009219,2011,100500008,,,,4,8,12
HND-009226,2011,100500017,,,,4,7,11
HND-009228,2011,100500019,,,,6,6,12
HND-009236,2011,100500049,,,,2,5,7
,2011,100500003,,,,18,15,33
HND-009217,2011,100500006,,,,1,3,4
HND-009218,2011,100500007,,,,4,7,11
HND-009226,2011,100500017,,,,9,15,24
HND-009227,2011,100500018,,,,5,2,7
,2011,100500001,,,,9,10,19
HND-009215,2011,100500002,,,,10,10,20
,2011,100500004,,,,7,10,17
HND-009216,2011,100500005,,,,5,6,11
HND-009219,2011,100500008,,,,6,4,10
HND-009228,2011,100500019,,,,8,6,14
HND-009236,2011,100500049,,,,4,2,6
,2011,100500003,,,,12,18,30
,2011,100500004,,,,4,8,12
HND-009217,2011,100500006,,,,2,3,5
HND-009218,2011,100500007,,,,3,9,12
HND-009219,2011,100500008,,,,8,6,14
HND-009227,2011,100500018,,,,3,4,7
HND-009228,2011,100500019,,,,8,6,14
,2011,100500001,,,,12,14,26
HND-009215,2011,100500002,,,,7,13,20
HND-009216,2011,100500005,,,,11,3,14
HND-009226,2011,100500017,,,,12,3,15
HND-009236,2011,100500049,,,,5,1,6
HND-009215,2011,100500002,,,,11,14,25
,2011,100500003,,,,13,17,30
,2011,100500004,,,,6,10,16
HND-009218,2011,100500007,,,,5,3,8
HND-009219,2011,100500008,,,,9,9,18
HND-009228,2011,100500019,,,,10,3,13
HND-009236,2011,100500049,,,,1,2,3
,2011,100500001,,,,11,14,25
HND-009216,2011,100500005,,,,11,5,16
HND-009217,2011,100500006,,,,1,4,5
HND-009226,2011,100500017,,,,5,5,10
HND-009227,2011,100500018,,,,4,3,7
,2011,100500001,,,,10,9,19
HND-009215,2011,100500002,,,,9,8,17
,2011,100500004,,,,6,3,9
HND-009216,2011,100500005,,,,2,1,3
HND-009219,2011,100500008,,,,12,4,16
HND-009226,2011,100500017,,,,10,7,17
HND-009228,2011,100500019,,,,3,1,4
HND-009236,2011,100500049,,,,0,3,3
,2011,100500003,,,,6,13,19
HND-009217,2011,100500006,,,,3,1,4
HND-009218,2011,100500007,,,,5,3,8
HND-009227,2011,100500018,,,,5,3,8
,2011,100500001,,,,8,15,23
,2011,100500003,,,,13,6,19
,2011,100500003,,,,12,1,13
,2011,100500001,,,,12,13,25
,2011,100500003,,,,6,4,10
,2011,100500001,,,,10,10,20
,2011,100600123,,,,13,9,22
HND-009340,2011,100600125,,,,6,5,11
HND-009351,2011,100600201,,,,13,12,25
HND-009352,2011,100600204,,,,6,4,10
,2011,100600207,,,,6,9,15
,2011,100600208,,,,9,8,17
HND-009357,2011,100600215,,,,11,9,20
,2011,100600216,,,,7,8,15
HND-009359,2011,100600217,,,,11,10,21
HND-009361,2011,100600219,,,,4,8,12
HND-009365,2011,100600226,,,,9,6,15
,2011,100600240,,,,6,6,12
HND-009366,2011,100600244,,,,10,7,17
,2011,100600247,,,,9,8,17
,2011,100600261,,,,4,8,12
,2011,100600262,,,,11,10,21
HND-009296,2011,100600054,,,,8,5,13
HND-009339,2011,100600122,,,,4,5,9
,2011,100600202,,,,6,2,8
HND-009353,2011,100600205,,,,9,8,17
HND-009354,2011,100600206,,,,12,4,16
HND-009355,2011,100600211,,,,6,6,12
,2011,100600212,,,,3,7,10
,2011,100600214,,,,8,6,14
,2011,100600220,,,,7,9,16
,2011,100600251,,,,5,5,10
,2011,100600252,,,,9,12,21
,2011,100600254,,,,6,7,13
,2011,100600255,,,,5,6,11
HND-009282,2011,100600040,,,,7,5,12
HND-009309,2011,100600067,,,,1,1,2
,2011,100600115,,,,0,2,2
,2011,100600221,,,,1,4,5
,2011,100600225,,,,10,8,18
HND-009318,2011,100600076,,,,1,1,2
HND-009321,2011,100600080,,,,2,0,2
HND-009332,2011,100600109,,,,4,7,11
,2011,100600114,,,,1,2,3
,2011,100600119,,,,5,6,11
,2011,100600258,,,,1,0,1
HND-009297,2011,100600055,,,,18,18,36
HND-009301,2011,100600059,,,,15,15,30
HND-009305,2011,100600063,,,,4,1,5
HND-009306,2011,100600064,,,,6,16,22
HND-009308,2011,100600066,,,,6,2,8
HND-009309,2011,100600067,,,,10,4,14
HND-009313,2011,100600071,,,,6,20,26
HND-009315,2011,100600073,,,,3,4,7
HND-009318,2011,100600076,,,,7,1,8
HND-009319,2011,100600077,,,,6,4,10
,2011,100600082,,,,2,4,6
HND-009325,2011,100600085,,,,6,3,9
HND-009332,2011,100600109,,,,9,12,21
HND-009335,2011,100600112,,,,9,4,13
,2011,100600114,,,,1,5,6
,2011,100600115,,,,6,5,11
HND-009336,2011,100600116,,,,3,5,8
HND-009337,2011,100600117,,,,7,4,11
,2011,100600119,,,,6,6,12
,2011,100600120,,,,4,1,5
HND-009341,2011,100600126,,,,4,1,5
HND-009345,2011,100600137,,,,4,7,11
HND-009346,2011,100600139,,,,0,1,1
,2011,100600221,,,,1,3,4
HND-009363,2011,100600223,,,,7,4,11
,2011,100600253,,,,3,1,4
HND-009368,2011,100600257,,,,8,5,13
HND-009282,2011,100600040,,,,8,5,13
HND-009298,2011,100600056,,,,18,17,35
HND-009299,2011,100600057,,,,31,36,67
HND-009300,2011,100600058,,,,23,18,41
HND-009302,2011,100600060,,,,12,10,22
HND-009303,2011,100600061,,,,12,14,26
HND-009304,2011,100600062,,,,6,4,10
HND-009307,2011,100600065,,,,12,11,23
HND-009310,2011,100600068,,,,12,12,24
,2011,100600069,,,,5,11,16
HND-009312,2011,100600070,,,,9,10,19
HND-009314,2011,100600072,,,,0,2,2
,2011,100600079,,,,4,6,10
HND-009321,2011,100600080,,,,3,5,8
HND-009323,2011,100600083,,,,1,2,3
HND-009324,2011,100600084,,,,7,3,10
HND-009328,2011,100600092,,,,9,17,26
HND-009331,2011,100600108,,,,0,5,5
HND-009333,2011,100600110,,,,16,18,34
HND-009334,2011,100600111,,,,4,4,8
HND-009338,2011,100600121,,,,8,9,17
HND-009344,2011,100600130,,,,2,6,8
HND-009362,2011,100600222,,,,8,8,16
,2011,100600258,,,,1,3,4
HND-009371,2011,100600265,,,,7,5,12
HND-009282,2011,100600040,,,,6,10,16
HND-009297,2011,100600055,,,,10,17,27
HND-009301,2011,100600059,,,,33,33,66
HND-009302,2011,100600060,,,,23,15,38
HND-009303,2011,100600061,,,,19,14,33
HND-009304,2011,100600062,,,,19,13,32
HND-009307,2011,100600065,,,,15,6,21
,2011,100600069,,,,22,14,36
HND-009312,2011,100600070,,,,25,22,47
HND-009313,2011,100600071,,,,22,19,41
HND-009315,2011,100600073,,,,4,7,11
HND-009318,2011,100600076,,,,2,3,5
HND-009319,2011,100600077,,,,4,4,8
HND-009325,2011,100600085,,,,10,5,15
HND-009331,2011,100600108,,,,5,16,21
HND-009333,2011,100600110,,,,15,20,35
HND-009334,2011,100600111,,,,10,7,17
HND-009335,2011,100600112,,,,7,9,16
HND-009338,2011,100600121,,,,8,13,21
HND-009341,2011,100600126,,,,5,7,12
HND-009344,2011,100600130,,,,8,10,18
HND-009345,2011,100600137,,,,2,5,7
,2011,100600221,,,,5,6,11
HND-009362,2011,100600222,,,,4,8,12
,2011,100600258,,,,2,4,6
HND-009371,2011,100600265,,,,10,6,16
HND-009298,2011,100600056,,,,18,22,40
HND-009299,2011,100600057,,,,43,41,84
HND-009300,2011,100600058,,,,21,20,41
HND-009305,2011,100600063,,,,13,14,27
HND-009306,2011,100600064,,,,7,8,15
HND-009308,2011,100600066,,,,16,14,30
HND-009309,2011,100600067,,,,11,11,22
HND-009310,2011,100600068,,,,13,7,20
HND-009314,2011,100600072,,,,7,13,20
,2011,100600079,,,,6,6,12
HND-009321,2011,100600080,,,,3,5,8
HND-009322,2011,100600081,,,,20,18,38
,2011,100600082,,,,5,3,8
HND-009323,2011,100600083,,,,13,10,23
HND-009324,2011,100600084,,,,6,6,12
HND-009328,2011,100600092,,,,12,6,18
HND-009332,2011,100600109,,,,19,16,35
,2011,100600114,,,,4,6,10
,2011,100600115,,,,6,1,7
HND-009336,2011,100600116,,,,4,4,8
HND-009337,2011,100600117,,,,2,4,6
,2011,100600119,,,,3,2,5
,2011,100600120,,,,7,8,15
HND-009346,2011,100600139,,,,5,6,11
HND-009363,2011,100600223,,,,4,3,7
HND-009368,2011,100600257,,,,5,4,9
HND-009245,2011,100600003,,,,4,7,11
HND-009248,2011,100600006,,,,7,7,14
HND-009249,2011,100600007,,,,3,4,7
HND-009251,2011,100600009,,,,16,15,31
HND-009254,2011,100600012,,,,7,2,9
HND-009255,2011,100600013,,,,69,53,122
HND-009257,2011,100600015,,,,28,21,49
HND-009260,2011,100600018,,,,12,13,25
HND-009261,2011,100600019,,,,3,1,4
HND-009263,2011,100600021,,,,4,6,10
HND-009265,2011,100600023,,,,9,9,18
HND-009268,2011,100600026,,,,6,6,12
HND-009269,2011,100600027,,,,12,12,24
HND-009273,2011,100600031,,,,6,20,26
HND-009275,2011,100600033,,,,2,2,4
HND-009278,2011,100600036,,,,11,9,20
HND-009279,2011,100600037,,,,14,15,29
HND-009282,2011,100600040,,,,54,85,139
HND-009284,2011,100600042,,,,29,21,50
HND-009287,2011,100600045,,,,4,3,7
HND-009291,2011,100600049,,,,2,1,3
HND-009318,2011,100600076,,,,3,2,5
HND-009319,2011,100600077,,,,16,9,25
,2011,100600079,,,,8,10,18
HND-009328,2011,100600092,,,,10,11,21
HND-009330,2011,100600095,,,,23,28,51
HND-009342,2011,100600127,,,,4,3,7
HND-009343,2011,100600128,,,,5,4,9
HND-009346,2011,100600139,,,,5,7,12
HND-009347,2011,100600151,,,,7,4,11
HND-009349,2011,100600161,,,,7,8,15
HND-009364,2011,100600224,,,,5,8,13
HND-009367,2011,100600256,,,,4,5,9
HND-009370,2011,100600264,,,,6,6,12
HND-009243,2011,100600001,,,,5,5,10
HND-009244,2011,100600002,,,,3,3,6
HND-009246,2011,100600004,,,,5,3,8
HND-009247,2011,100600005,,,,3,4,7
HND-009250,2011,100600008,,,,20,20,40
HND-009252,2011,100600010,,,,8,9,17
HND-009253,2011,100600011,,,,12,6,18
HND-009256,2011,100600014,,,,4,11,15
HND-009258,2011,100600016,,,,4,3,7
HND-009259,2011,100600017,,,,11,8,19
HND-009262,2011,100600020,,,,16,19,35
HND-009264,2011,100600022,,,,18,19,37
HND-009266,2011,100600024,,,,11,7,18
HND-009267,2011,100600025,,,,6,2,8
HND-009270,2011,100600028,,,,20,21,41
HND-009271,2011,100600029,,,,3,3,6
HND-009272,2011,100600030,,,,27,23,50
HND-009274,2011,100600032,,,,8,5,13
HND-009276,2011,100600034,,,,10,3,13
HND-009277,2011,100600035,,,,6,15,21
HND-009280,2011,100600038,,,,26,13,39
HND-009281,2011,100600039,,,,11,14,25
HND-009283,2011,100600041,,,,12,6,18
HND-009285,2011,100600043,,,,12,11,23
HND-009286,2011,100600044,,,,16,14,30
HND-009288,2011,100600046,,,,3,9,12
HND-009289,2011,100600047,,,,5,10,15
HND-009290,2011,100600048,,,,8,17,25
HND-009292,2011,100600050,,,,2,3,5
HND-009293,2011,100600051,,,,8,4,12
HND-009294,2011,100600052,,,,6,8,14
HND-009295,2011,100600053,,,,7,3,10
HND-009296,2011,100600054,,,,1,7,8
HND-009316,2011,100600074,,,,17,7,24
HND-009317,2011,100600075,,,,4,1,5
HND-009320,2011,100600078,,,,8,10,18
,2011,100600086,,,,15,11,26
HND-009329,2011,100600093,,,,6,4,10
HND-009348,2011,100600160,,,,4,2,6
HND-009350,2011,100600174,,,,5,8,13
HND-009372,2011,100600266,,,,5,13,18
HND-009244,2011,100600002,,,,4,3,7
HND-009247,2011,100600005,,,,3,3,6
HND-009250,2011,100600008,,,,22,17,39
HND-009251,2011,100600009,,,,20,13,33
HND-009252,2011,100600010,,,,4,12,16
HND-009253,2011,100600011,,,,8,10,18
HND-009254,2011,100600012,,,,6,5,11
HND-009255,2011,100600013,,,,67,55,122
HND-009256,2011,100600014,,,,7,8,15
HND-009259,2011,100600017,,,,10,3,13
HND-009260,2011,100600018,,,,16,15,31
HND-009267,2011,100600025,,,,1,1,2
HND-009268,2011,100600026,,,,4,6,10
HND-009271,2011,100600029,,,,5,3,8
HND-009273,2011,100600031,,,,6,8,14
HND-009274,2011,100600032,,,,6,10,16
HND-009275,2011,100600033,,,,3,4,7
HND-009276,2011,100600034,,,,9,11,20
HND-009279,2011,100600037,,,,4,10,14
HND-009280,2011,100600038,,,,22,18,40
HND-009282,2011,100600040,,,,52,57,109
HND-009285,2011,100600043,,,,14,10,24
HND-009288,2011,100600046,,,,4,4,8
HND-009289,2011,100600047,,,,6,8,14
HND-009291,2011,100600049,,,,1,2,3
HND-009293,2011,100600051,,,,5,3,8
HND-009295,2011,100600053,,,,8,3,11
HND-009316,2011,100600074,,,,9,8,17
HND-009318,2011,100600076,,,,4,1,5
HND-009319,2011,100600077,,,,10,4,14
HND-009320,2011,100600078,,,,6,10,16
,2011,100600086,,,,11,14,25
HND-009329,2011,100600093,,,,5,3,8
HND-009330,2011,100600095,,,,29,23,52
HND-009349,2011,100600161,,,,3,6,9
HND-009364,2011,100600224,,,,4,1,5
HND-009372,2011,100600266,,,,5,9,14
HND-009243,2011,100600001,,,,8,4,12
HND-009245,2011,100600003,,,,2,6,8
HND-009246,2011,100600004,,,,6,4,10
HND-009248,2011,100600006,,,,12,4,16
HND-009249,2011,100600007,,,,4,5,9
HND-009257,2011,100600015,,,,19,16,35
HND-009258,2011,100600016,,,,4,6,10
HND-009261,2011,100600019,,,,5,2,7
HND-009262,2011,100600020,,,,13,12,25
HND-009263,2011,100600021,,,,11,3,14
HND-009264,2011,100600022,,,,15,25,40
HND-009265,2011,100600023,,,,7,15,22
HND-009266,2011,100600024,,,,14,7,21
HND-009269,2011,100600027,,,,13,9,22
HND-009270,2011,100600028,,,,18,13,31
HND-009272,2011,100600030,,,,23,20,43
HND-009277,2011,100600035,,,,6,7,13
HND-009278,2011,100600036,,,,10,5,15
HND-009281,2011,100600039,,,,5,12,17
HND-009283,2011,100600041,,,,8,7,15
HND-009284,2011,100600042,,,,25,16,41
HND-009286,2011,100600044,,,,16,23,39
HND-009287,2011,100600045,,,,2,3,5
HND-009290,2011,100600048,,,,9,6,15
HND-009292,2011,100600050,,,,6,2,8
HND-009294,2011,100600052,,,,5,5,10
HND-009296,2011,100600054,,,,9,5,14
HND-009317,2011,100600075,,,,3,4,7
,2011,100600079,,,,6,10,16
HND-009327,2011,100600091,,,,0,1,1
HND-009328,2011,100600092,,,,7,7,14
HND-009342,2011,100600127,,,,5,3,8
HND-009346,2011,100600139,,,,5,3,8
HND-009347,2011,100600151,,,,9,2,11
HND-009348,2011,100600160,,,,1,3,4
HND-009350,2011,100600174,,,,4,1,5
HND-009367,2011,100600256,,,,4,7,11
HND-009370,2011,100600264,,,,2,5,7
HND-009244,2011,100600002,,,,1,5,6
HND-009246,2011,100600004,,,,6,6,12
HND-009247,2011,100600005,,,,3,4,7
HND-009250,2011,100600008,,,,12,8,20
HND-009252,2011,100600010,,,,12,6,18
HND-009253,2011,100600011,,,,9,12,21
HND-009256,2011,100600014,,,,8,11,19
HND-009258,2011,100600016,,,,5,6,11
HND-009259,2011,100600017,,,,3,8,11
HND-009260,2011,100600018,,,,21,19,40
HND-009262,2011,100600020,,,,10,9,19
HND-009264,2011,100600022,,,,23,20,43
HND-009267,2011,100600025,,,,4,2,6
HND-009270,2011,100600028,,,,18,17,35
HND-009271,2011,100600029,,,,9,0,9
HND-009272,2011,100600030,,,,19,13,32
HND-009274,2011,100600032,,,,7,7,14
HND-009276,2011,100600034,,,,3,12,15
HND-009277,2011,100600035,,,,6,4,10
HND-009280,2011,100600038,,,,22,9,31
HND-009281,2011,100600039,,,,12,7,19
HND-009283,2011,100600041,,,,9,5,14
HND-009285,2011,100600043,,,,10,23,33
HND-009286,2011,100600044,,,,12,15,27
HND-009288,2011,100600046,,,,6,4,10
HND-009289,2011,100600047,,,,9,5,14
HND-009290,2011,100600048,,,,10,11,21
HND-009292,2011,100600050,,,,5,2,7
HND-009293,2011,100600051,,,,3,3,6
HND-009294,2011,100600052,,,,5,6,11
HND-009296,2011,100600054,,,,8,4,12
HND-009316,2011,100600074,,,,10,6,16
HND-009317,2011,100600075,,,,6,3,9
HND-009320,2011,100600078,,,,9,7,16
,2011,100600086,,,,13,11,24
HND-009327,2011,100600091,,,,0,1,1
HND-009329,2011,100600093,,,,4,7,11
HND-009348,2011,100600160,,,,0,4,4
HND-009350,2011,100600174,,,,4,5,9
HND-009364,2011,100600224,,,,4,5,9
HND-009243,2011,100600001,,,,5,2,7
HND-009245,2011,100600003,,,,6,8,14
HND-009248,2011,100600006,,,,4,13,17
HND-009249,2011,100600007,,,,5,3,8
HND-009251,2011,100600009,,,,18,13,31
HND-009254,2011,100600012,,,,1,3,4
HND-009255,2011,100600013,,,,61,56,117
HND-009257,2011,100600015,,,,29,15,44
HND-009261,2011,100600019,,,,6,4,10
HND-009263,2011,100600021,,,,10,8,18
HND-009265,2011,100600023,,,,8,11,19
HND-009266,2011,100600024,,,,4,6,10
HND-009268,2011,100600026,,,,6,8,14
HND-009269,2011,100600027,,,,13,15,28
HND-009273,2011,100600031,,,,8,10,18
HND-009275,2011,100600033,,,,2,2,4
HND-009278,2011,100600036,,,,13,7,20
HND-009279,2011,100600037,,,,8,12,20
HND-009282,2011,100600040,,,,72,77,149
HND-009284,2011,100600042,,,,29,27,56
HND-009287,2011,100600045,,,,4,3,7
HND-009291,2011,100600049,,,,3,1,4
HND-009295,2011,100600053,,,,4,6,10
HND-009318,2011,100600076,,,,4,5,9
HND-009319,2011,100600077,,,,7,5,12
,2011,100600079,,,,9,7,16
HND-009328,2011,100600092,,,,8,8,16
HND-009330,2011,100600095,,,,26,26,52
HND-009342,2011,100600127,,,,2,4,6
HND-009346,2011,100600139,,,,8,1,9
HND-009347,2011,100600151,,,,2,4,6
HND-009349,2011,100600161,,,,8,10,18
HND-009367,2011,100600256,,,,3,4,7
HND-009370,2011,100600264,,,,3,2,5
HND-009372,2011,100600266,,,,4,6,10
HND-009247,2011,100600005,,,,2,2,4
HND-009248,2011,100600006,,,,5,3,8
HND-009251,2011,100600009,,,,12,12,24
HND-009252,2011,100600010,,,,11,11,22
HND-009254,2011,100600012,,,,4,2,6
HND-009255,2011,100600013,,,,77,74,151
HND-009256,2011,100600014,,,,13,10,23
HND-009257,2011,100600015,,,,15,12,27
HND-009260,2011,100600018,,,,17,11,28
HND-009265,2011,100600023,,,,12,8,20
HND-009268,2011,100600026,,,,7,5,12
HND-009269,2011,100600027,,,,9,6,15
HND-009271,2011,100600029,,,,5,4,9
HND-009273,2011,100600031,,,,9,8,17
HND-009274,2011,100600032,,,,6,2,8
HND-009276,2011,100600034,,,,6,8,14
HND-009280,2011,100600038,,,,12,13,25
HND-009283,2011,100600041,,,,8,11,19
HND-009285,2011,100600043,,,,13,13,26
HND-009288,2011,100600046,,,,4,3,7
HND-009289,2011,100600047,,,,8,5,13
HND-009291,2011,100600049,,,,3,3,6
HND-009292,2011,100600050,,,,3,1,4
HND-009293,2011,100600051,,,,3,1,4
HND-009295,2011,100600053,,,,1,3,4
HND-009296,2011,100600054,,,,9,5,14
HND-009316,2011,100600074,,,,7,8,15
HND-009319,2011,100600077,,,,9,3,12
HND-009320,2011,100600078,,,,9,10,19
,2011,100600086,,,,11,15,26
HND-009327,2011,100600091,,,,2,0,2
HND-009329,2011,100600093,,,,3,4,7
HND-009343,2011,100600128,,,,1,4,5
HND-009349,2011,100600161,,,,4,5,9
HND-009372,2011,100600266,,,,5,1,6
HND-009243,2011,100600001,,,,2,3,5
HND-009244,2011,100600002,,,,4,1,5
HND-009245,2011,100600003,,,,4,6,10
HND-009246,2011,100600004,,,,7,9,16
HND-009249,2011,100600007,,,,1,4,5
HND-009250,2011,100600008,,,,7,16,23
HND-009253,2011,100600011,,,,6,9,15
HND-009258,2011,100600016,,,,6,4,10
HND-009259,2011,100600017,,,,6,9,15
HND-009261,2011,100600019,,,,3,4,7
HND-009262,2011,100600020,,,,10,17,27
HND-009263,2011,100600021,,,,5,10,15
HND-009264,2011,100600022,,,,20,14,34
HND-009266,2011,100600024,,,,11,10,21
HND-009267,2011,100600025,,,,4,5,9
HND-009270,2011,100600028,,,,15,17,32
HND-009272,2011,100600030,,,,17,20,37
HND-009275,2011,100600033,,,,5,1,6
HND-009277,2011,100600035,,,,4,7,11
HND-009278,2011,100600036,,,,8,13,21
HND-009279,2011,100600037,,,,8,17,25
HND-009281,2011,100600039,,,,14,3,17
HND-009282,2011,100600040,,,,61,76,137
HND-009284,2011,100600042,,,,17,29,46
HND-009286,2011,100600044,,,,8,11,19
HND-009287,2011,100600045,,,,2,7,9
HND-009290,2011,100600048,,,,7,13,20
HND-009294,2011,100600052,,,,9,4,13
HND-009317,2011,100600075,,,,3,5,8
HND-009318,2011,100600076,,,,3,1,4
,2011,100600079,,,,9,9,18
HND-009328,2011,100600092,,,,2,7,9
HND-009330,2011,100600095,,,,23,25,48
HND-009342,2011,100600127,,,,3,3,6
HND-009346,2011,100600139,,,,4,5,9
HND-009347,2011,100600151,,,,7,3,10
HND-009348,2011,100600160,,,,2,4,6
HND-009350,2011,100600174,,,,2,4,6
HND-009364,2011,100600224,,,,2,4,6
HND-009367,2011,100600256,,,,8,3,11
HND-009370,2011,100600264,,,,0,4,4
HND-009245,2011,100600003,,,,4,2,6
HND-009247,2011,100600005,,,,0,2,2
HND-009248,2011,100600006,,,,5,6,11
HND-009251,2011,100600009,,,,12,17,29
HND-009252,2011,100600010,,,,10,12,22
HND-009254,2011,100600012,,,,4,0,4
HND-009255,2011,100600013,,,,61,57,118
HND-009256,2011,100600014,,,,6,10,16
HND-009257,2011,100600015,,,,18,12,30
HND-009260,2011,100600018,,,,16,15,31
HND-009261,2011,100600019,,,,4,1,5
HND-009263,2011,100600021,,,,2,7,9
HND-009265,2011,100600023,,,,6,6,12
HND-009268,2011,100600026,,,,5,3,8
HND-009269,2011,100600027,,,,18,13,31
HND-009271,2011,100600029,,,,7,4,11
HND-009274,2011,100600032,,,,2,3,5
HND-009276,2011,100600034,,,,9,5,14
HND-009277,2011,100600035,,,,4,6,10
HND-009280,2011,100600038,,,,9,13,22
HND-009283,2011,100600041,,,,7,10,17
HND-009285,2011,100600043,,,,10,11,21
HND-009286,2011,100600044,,,,13,11,24
HND-009288,2011,100600046,,,,7,2,9
HND-009289,2011,100600047,,,,8,7,15
HND-009292,2011,100600050,,,,3,2,5
HND-009293,2011,100600051,,,,0,3,3
HND-009295,2011,100600053,,,,1,3,4
HND-009296,2011,100600054,,,,9,12,21
HND-009316,2011,100600074,,,,7,11,18
HND-009317,2011,100600075,,,,2,3,5
HND-009320,2011,100600078,,,,10,10,20
,2011,100600086,,,,20,5,25
HND-009329,2011,100600093,,,,4,6,10
HND-009347,2011,100600151,,,,6,1,7
HND-009348,2011,100600160,,,,1,4,5
HND-009372,2011,100600266,,,,7,3,10
HND-009243,2011,100600001,,,,5,7,12
HND-009244,2011,100600002,,,,9,5,14
HND-009246,2011,100600004,,,,5,7,12
HND-009249,2011,100600007,,,,2,0,2
HND-009250,2011,100600008,,,,9,11,20
HND-009253,2011,100600011,,,,4,8,12
HND-009258,2011,100600016,,,,2,3,5
HND-009259,2011,100600017,,,,11,6,17
HND-009262,2011,100600020,,,,13,16,29
HND-009264,2011,100600022,,,,12,10,22
HND-009266,2011,100600024,,,,7,7,14
HND-009267,2011,100600025,,,,2,3,5
HND-009270,2011,100600028,,,,14,13,27
HND-009272,2011,100600030,,,,25,21,46
HND-009273,2011,100600031,,,,10,11,21
HND-009275,2011,100600033,,,,3,5,8
HND-009278,2011,100600036,,,,6,9,15
HND-009279,2011,100600037,,,,7,6,13
HND-009281,2011,100600039,,,,14,12,26
HND-009282,2011,100600040,,,,63,80,143
HND-009284,2011,100600042,,,,21,18,39
HND-009287,2011,100600045,,,,3,4,7
HND-009290,2011,100600048,,,,11,7,18
HND-009291,2011,100600049,,,,4,1,5
HND-009294,2011,100600052,,,,6,6,12
HND-009318,2011,100600076,,,,3,4,7
HND-009319,2011,100600077,,,,4,7,11
,2011,100600079,,,,8,5,13
HND-009328,2011,100600092,,,,3,5,8
HND-009330,2011,100600095,,,,33,36,69
HND-009342,2011,100600127,,,,4,2,6
HND-009343,2011,100600128,,,,1,1,2
HND-009346,2011,100600139,,,,5,5,10
HND-009349,2011,100600161,,,,4,3,7
HND-009350,2011,100600174,,,,1,2,3
HND-009364,2011,100600224,,,,1,1,2
HND-009367,2011,100600256,,,,5,3,8
HND-009370,2011,100600264,,,,0,5,5
HND-009243,2011,100600001,,,,8,5,13
HND-009245,2011,100600003,,,,5,4,9
HND-009246,2011,100600004,,,,8,3,11
HND-009248,2011,100600006,,,,5,3,8
HND-009249,2011,100600007,,,,3,2,5
HND-009257,2011,100600015,,,,12,13,25
HND-009258,2011,100600016,,,,2,5,7
HND-009261,2011,100600019,,,,5,6,11
HND-009262,2011,100600020,,,,13,5,18
HND-009263,2011,100600021,,,,5,4,9
HND-009264,2011,100600022,,,,11,12,23
HND-009265,2011,100600023,,,,12,10,22
HND-009266,2011,100600024,,,,10,12,22
HND-009269,2011,100600027,,,,5,14,19
HND-009270,2011,100600028,,,,15,16,31
HND-009272,2011,100600030,,,,20,20,40
HND-009277,2011,100600035,,,,6,3,9
HND-009278,2011,100600036,,,,16,12,28
HND-009281,2011,100600039,,,,13,7,20
HND-009283,2011,100600041,,,,10,11,21
HND-009284,2011,100600042,,,,31,10,41
HND-009286,2011,100600044,,,,7,10,17
HND-009290,2011,100600048,,,,9,10,19
HND-009292,2011,100600050,,,,2,1,3
HND-009294,2011,100600052,,,,2,4,6
HND-009296,2011,100600054,,,,3,2,5
HND-009317,2011,100600075,,,,6,5,11
,2011,100600079,,,,5,5,10
HND-009328,2011,100600092,,,,4,8,12
HND-009346,2011,100600139,,,,3,5,8
HND-009347,2011,100600151,,,,4,1,5
HND-009349,2011,100600161,,,,3,3,6
HND-009350,2011,100600174,,,,2,2,4
HND-009367,2011,100600256,,,,4,1,5
HND-009244,2011,100600002,,,,3,4,7
HND-009247,2011,100600005,,,,1,0,1
HND-009250,2011,100600008,,,,2,7,9
HND-009251,2011,100600009,,,,10,7,17
HND-009252,2011,100600010,,,,5,6,11
HND-009253,2011,100600011,,,,7,5,12
HND-009254,2011,100600012,,,,2,7,9
HND-009255,2011,100600013,,,,49,69,118
HND-009256,2011,100600014,,,,10,12,22
HND-009259,2011,100600017,,,,8,10,18
HND-009260,2011,100600018,,,,11,8,19
HND-009267,2011,100600025,,,,4,2,6
HND-009268,2011,100600026,,,,5,2,7
HND-009271,2011,100600029,,,,6,5,11
HND-009273,2011,100600031,,,,14,9,23
HND-009274,2011,100600032,,,,0,1,1
HND-009275,2011,100600033,,,,2,3,5
HND-009276,2011,100600034,,,,8,4,12
HND-009279,2011,100600037,,,,3,6,9
HND-009280,2011,100600038,,,,13,12,25
HND-009282,2011,100600040,,,,74,58,132
HND-009285,2011,100600043,,,,14,10,24
HND-009287,2011,100600045,,,,4,3,7
HND-009288,2011,100600046,,,,4,0,4
HND-009289,2011,100600047,,,,3,5,8
HND-009293,2011,100600051,,,,1,1,2
HND-009295,2011,100600053,,,,5,4,9
HND-009316,2011,100600074,,,,5,9,14
HND-009318,2011,100600076,,,,2,3,5
HND-009319,2011,100600077,,,,5,5,10
HND-009320,2011,100600078,,,,10,10,20
,2011,100600086,,,,11,13,24
HND-009329,2011,100600093,,,,3,1,4
HND-009330,2011,100600095,,,,18,18,36
HND-009342,2011,100600127,,,,1,2,3
HND-009343,2011,100600128,,,,3,1,4
HND-009348,2011,100600160,,,,2,0,2
HND-009372,2011,100600266,,,,5,5,10
HND-009255,2011,100600013,,,,48,44,92
HND-009257,2011,100600015,,,,20,23,43
HND-009260,2011,100600018,,,,11,9,20
HND-009330,2011,100600095,,,,24,23,47
HND-009369,2011,100600260,,,,33,13,46
HND-009250,2011,100600008,,,,4,14,18
HND-009262,2011,100600020,,,,8,9,17
HND-009264,2011,100600022,,,,28,24,52
HND-009286,2011,100600044,,,,23,10,33
,2011,100600210,,,,9,10,19
,2011,100600259,,,,30,33,63
,2011,100600263,,,,9,19,28
,2011,100600267,,,,9,15,24
HND-009250,2011,100600008,,,,13,18,31
HND-009255,2011,100600013,,,,28,37,65
HND-009260,2011,100600018,,,,11,11,22
HND-009330,2011,100600095,,,,24,19,43
,2011,100600210,,,,4,9,13
HND-009257,2011,100600015,,,,23,8,31
HND-009262,2011,100600020,,,,7,8,15
HND-009264,2011,100600022,,,,13,9,22
HND-009286,2011,100600044,,,,11,11,22
,2011,100600259,,,,18,17,35
HND-009369,2011,100600260,,,,16,5,21
,2011,100600263,,,,13,8,21
,2011,100600267,,,,10,10,20
HND-009255,2011,100600013,,,,22,37,59
HND-009257,2011,100600015,,,,19,16,35
HND-009260,2011,100600018,,,,4,16,20
,2011,100600210,,,,10,10,20
,2011,100600259,,,,19,17,36
HND-009369,2011,100600260,,,,19,17,36
HND-009250,2011,100600008,,,,14,11,25
HND-009262,2011,100600020,,,,10,17,27
HND-009264,2011,100600022,,,,21,19,40
HND-009286,2011,100600044,,,,10,9,19
HND-009330,2011,100600095,,,,14,15,29
,2011,100600263,,,,11,12,23
,2011,100600267,,,,6,9,15
,2011,100600263,,,,42,61,103
,2011,100600267,,,,15,28,43
,2011,100600210,,,,8,3,11
,2011,100600259,,,,37,23,60
,2011,100600210,,,,4,5,9
,2011,100600259,,,,13,6,19
,2011,100600263,,,,33,33,66
,2011,100600267,,,,13,19,32
,2011,100600259,,,,27,10,37
,2011,100600263,,,,20,20,40
,2011,100600267,,,,3,9,12
HND-009379,2011,100700004,,,,4,8,12
HND-009439,2011,100700073,,,,8,8,16
,2011,100700075,,,,8,2,10
,2011,100700079,,,,22,7,29
HND-009444,2011,100700082,,,,4,4,8
,2011,100700085,,,,4,1,5
,2011,100700099,,,,7,4,11
,2011,100700100,,,,5,3,8
HND-009449,2011,100700102,,,,6,5,11
HND-009450,2011,100700104,,,,6,10,16
HND-009452,2011,100700106,,,,11,4,15
,2011,100700134,,,,14,4,18
,2011,100700136,,,,4,9,13
,2011,100700148,,,,3,1,4
,2011,100700071,,,,2,5,7
,2011,100700072,,,,7,1,8
,2011,100700074,,,,1,7,8
HND-009440,2011,100700076,,,,7,1,8
,2011,100700077,,,,5,4,9
HND-009441,2011,100700078,,,,2,5,7
,2011,100700084,,,,14,6,20
HND-009448,2011,100700101,,,,7,4,11
HND-009451,2011,100700105,,,,7,6,13
,2011,100700108,,,,3,10,13
,2011,100700118,,,,5,6,11
,2011,100700135,,,,7,1,8
HND-009456,2011,100700138,,,,6,8,14
HND-009457,2011,100700139,,,,2,4,6
HND-009458,2011,100700141,,,,8,10,18
,2011,100700149,,,,4,2,6
,2011,100700150,,,,9,11,20
HND-009462,2011,100700151,,,,15,28,43
,2011,100700152,,,,7,3,10
HND-009376,2011,100700001,,,,11,7,18
HND-009413,2011,100700038,,,,1,2,3
HND-009417,2011,100700042,,,,6,1,7
HND-009419,2011,100700044,,,,3,1,4
HND-009420,2011,100700045,,,,2,2,4
HND-009423,2011,100700048,,,,1,4,5
HND-009425,2011,100700050,,,,2,0,2
,2011,100700051,,,,1,3,4
HND-009427,2011,100700054,,,,2,1,3
HND-009428,2011,100700055,,,,0,2,2
HND-009434,2011,100700062,,,,1,1,2
HND-009459,2011,100700142,,,,1,1,2
HND-009429,2011,100700056,,,,2,1,3
HND-009432,2011,100700059,,,,1,0,1
HND-009442,2011,100700080,,,,1,0,1
HND-009445,2011,100700083,,,,1,4,5
HND-009455,2011,100700123,,,,0,2,2
,2011,100700140,,,,2,2,4
HND-009413,2011,100700038,,,,4,6,10
HND-009417,2011,100700042,,,,2,4,6
HND-009419,2011,100700044,,,,4,3,7
HND-009424,2011,100700049,,,,9,3,12
HND-009425,2011,100700050,,,,4,2,6
HND-009426,2011,100700053,,,,5,4,9
HND-009427,2011,100700054,,,,3,3,6
HND-009431,2011,100700058,,,,5,6,11
HND-009434,2011,100700062,,,,2,2,4
HND-009437,2011,100700067,,,,8,5,13
HND-009438,2011,100700068,,,,4,4,8
HND-009442,2011,100700080,,,,3,1,4
HND-009459,2011,100700142,,,,2,0,2
,2011,100700146,,,,8,2,10
HND-009376,2011,100700001,,,,5,11,16
HND-009420,2011,100700045,,,,3,3,6
HND-009423,2011,100700048,,,,10,8,18
,2011,100700051,,,,9,11,20
,2011,100700052,,,,2,1,3
HND-009428,2011,100700055,,,,0,2,2
HND-009429,2011,100700056,,,,3,2,5
HND-009432,2011,100700059,,,,3,1,4
HND-009433,2011,100700061,,,,2,1,3
HND-009435,2011,100700063,,,,2,4,6
HND-009436,2011,100700064,,,,4,2,6
HND-009443,2011,100700081,,,,7,4,11
HND-009445,2011,100700083,,,,1,5,6
HND-009453,2011,100700117,,,,8,2,10
HND-009455,2011,100700123,,,,1,3,4
,2011,100700140,,,,2,3,5
,2011,100700143,,,,7,5,12
HND-009423,2011,100700048,,,,17,11,28
HND-009424,2011,100700049,,,,13,15,28
,2011,100700051,,,,13,12,25
,2011,100700052,,,,1,4,5
HND-009426,2011,100700053,,,,11,12,23
HND-009428,2011,100700055,,,,11,4,15
HND-009429,2011,100700056,,,,0,7,7
HND-009432,2011,100700059,,,,10,14,24
HND-009433,2011,100700061,,,,9,5,14
HND-009435,2011,100700063,,,,8,6,14
HND-009436,2011,100700064,,,,8,4,12
HND-009438,2011,100700068,,,,8,4,12
HND-009442,2011,100700080,,,,10,14,24
HND-009443,2011,100700081,,,,5,9,14
HND-009445,2011,100700083,,,,2,2,4
HND-009453,2011,100700117,,,,6,4,10
HND-009455,2011,100700123,,,,2,3,5
,2011,100700143,,,,8,6,14
HND-009413,2011,100700038,,,,12,7,19
HND-009417,2011,100700042,,,,1,7,8
HND-009419,2011,100700044,,,,1,2,3
HND-009420,2011,100700045,,,,4,3,7
HND-009425,2011,100700050,,,,11,8,19
HND-009427,2011,100700054,,,,3,6,9
HND-009431,2011,100700058,,,,6,4,10
HND-009434,2011,100700062,,,,3,8,11
HND-009437,2011,100700067,,,,15,11,26
,2011,100700140,,,,6,7,13
HND-009459,2011,100700142,,,,7,4,11
,2011,100700146,,,,6,4,10
HND-009378,2011,100700003,,,,0,2,2
HND-009379,2011,100700004,,,,7,6,13
HND-009381,2011,100700006,,,,2,5,7
HND-009382,2011,100700007,,,,4,5,9
HND-009387,2011,100700012,,,,40,51,91
HND-009390,2011,100700015,,,,2,1,3
HND-009391,2011,100700016,,,,6,9,15
HND-009394,2011,100700019,,,,6,7,13
HND-009395,2011,100700020,,,,6,7,13
HND-009396,2011,100700021,,,,5,7,12
HND-009398,2011,100700023,,,,7,11,18
HND-009399,2011,100700024,,,,7,3,10
HND-009401,2011,100700026,,,,10,12,22
HND-009402,2011,100700027,,,,5,3,8
HND-009405,2011,100700030,,,,6,2,8
HND-009407,2011,100700032,,,,5,2,7
HND-009409,2011,100700034,,,,7,5,12
HND-009410,2011,100700035,,,,8,11,19
HND-009415,2011,100700040,,,,6,4,10
HND-009416,2011,100700041,,,,1,2,3
HND-009418,2011,100700043,,,,3,4,7
HND-009419,2011,100700044,,,,5,4,9
HND-009422,2011,100700047,,,,2,4,6
HND-009436,2011,100700064,,,,7,4,11
HND-009442,2011,100700080,,,,5,3,8
HND-009446,2011,100700096,,,,4,3,7
HND-009457,2011,100700139,,,,3,2,5
HND-009376,2011,100700001,,,,44,37,81
HND-009377,2011,100700002,,,,7,4,11
HND-009380,2011,100700005,,,,5,11,16
HND-009383,2011,100700008,,,,10,6,16
HND-009384,2011,100700009,,,,12,14,26
HND-009385,2011,100700010,,,,7,4,11
HND-009386,2011,100700011,,,,17,7,24
HND-009388,2011,100700013,,,,7,4,11
HND-009389,2011,100700014,,,,5,9,14
HND-009392,2011,100700017,,,,10,5,15
HND-009393,2011,100700018,,,,4,3,7
HND-009397,2011,100700022,,,,6,2,8
HND-009400,2011,100700025,,,,6,6,12
HND-009403,2011,100700028,,,,18,19,37
HND-009404,2011,100700029,,,,15,10,25
HND-009406,2011,100700031,,,,11,8,19
HND-009408,2011,100700033,,,,5,6,11
HND-009411,2011,100700036,,,,10,2,12
HND-009412,2011,100700037,,,,7,2,9
HND-009413,2011,100700038,,,,4,3,7
HND-009414,2011,100700039,,,,3,4,7
HND-009417,2011,100700042,,,,5,5,10
HND-009420,2011,100700045,,,,5,4,9
HND-009421,2011,100700046,,,,2,2,4
,2011,100700052,,,,7,11,18
HND-009432,2011,100700059,,,,11,8,19
HND-009447,2011,100700098,,,,2,2,4
HND-009454,2011,100700122,,,,2,4,6
HND-009455,2011,100700123,,,,3,1,4
,2011,100700143,,,,5,4,9
HND-009460,2011,100700144,,,,5,1,6
HND-009376,2011,100700001,,,,39,33,72
HND-009378,2011,100700003,,,,4,3,7
HND-009380,2011,100700005,,,,7,6,13
HND-009381,2011,100700006,,,,4,3,7
HND-009384,2011,100700009,,,,7,9,16
HND-009385,2011,100700010,,,,4,4,8
HND-009389,2011,100700014,,,,6,6,12
HND-009390,2011,100700015,,,,3,5,8
HND-009393,2011,100700018,,,,6,5,11
HND-009398,2011,100700023,,,,6,5,11
HND-009400,2011,100700025,,,,5,5,10
HND-009401,2011,100700026,,,,11,5,16
HND-009404,2011,100700029,,,,10,11,21
HND-009405,2011,100700030,,,,3,8,11
HND-009406,2011,100700031,,,,7,6,13
HND-009408,2011,100700033,,,,8,6,14
HND-009409,2011,100700034,,,,4,10,14
HND-009412,2011,100700037,,,,9,2,11
HND-009418,2011,100700043,,,,2,2,4
HND-009421,2011,100700046,,,,2,3,5
HND-009422,2011,100700047,,,,8,5,13
,2011,100700052,,,,3,7,10
HND-009432,2011,100700059,,,,4,4,8
HND-009436,2011,100700064,,,,4,3,7
HND-009442,2011,100700080,,,,4,5,9
HND-009447,2011,100700098,,,,1,1,2
HND-009455,2011,100700123,,,,7,4,11
HND-009457,2011,100700139,,,,2,0,2
,2011,100700143,,,,6,6,12
HND-009377,2011,100700002,,,,9,3,12
HND-009379,2011,100700004,,,,4,3,7
HND-009382,2011,100700007,,,,8,7,15
HND-009383,2011,100700008,,,,6,3,9
HND-009386,2011,100700011,,,,13,9,22
HND-009387,2011,100700012,,,,46,42,88
HND-009388,2011,100700013,,,,5,4,9
HND-009391,2011,100700016,,,,7,5,12
HND-009392,2011,100700017,,,,10,12,22
HND-009394,2011,100700019,,,,12,6,18
HND-009395,2011,100700020,,,,8,5,13
HND-009396,2011,100700021,,,,5,7,12
HND-009397,2011,100700022,,,,8,5,13
HND-009399,2011,100700024,,,,6,3,9
HND-009402,2011,100700027,,,,10,8,18
HND-009403,2011,100700028,,,,19,10,29
HND-009407,2011,100700032,,,,4,1,5
HND-009410,2011,100700035,,,,7,5,12
HND-009411,2011,100700036,,,,6,6,12
HND-009413,2011,100700038,,,,2,1,3
HND-009414,2011,100700039,,,,3,2,5
HND-009415,2011,100700040,,,,5,3,8
HND-009416,2011,100700041,,,,1,1,2
HND-009417,2011,100700042,,,,5,5,10
HND-009419,2011,100700044,,,,4,6,10
HND-009420,2011,100700045,,,,4,5,9
HND-009446,2011,100700096,,,,3,5,8
HND-009454,2011,100700122,,,,0,4,4
HND-009460,2011,100700144,,,,1,1,2
HND-009376,2011,100700001,,,,46,54,100
HND-009377,2011,100700002,,,,3,3,6
HND-009380,2011,100700005,,,,9,6,15
HND-009384,2011,100700009,,,,16,10,26
HND-009385,2011,100700010,,,,8,4,12
HND-009386,2011,100700011,,,,9,11,20
HND-009389,2011,100700014,,,,11,6,17
HND-009392,2011,100700017,,,,8,7,15
HND-009393,2011,100700018,,,,4,4,8
HND-009397,2011,100700022,,,,2,3,5
HND-009400,2011,100700025,,,,5,4,9
HND-009404,2011,100700029,,,,11,11,22
HND-009406,2011,100700031,,,,8,7,15
HND-009408,2011,100700033,,,,6,1,7
HND-009411,2011,100700036,,,,2,10,12
HND-009412,2011,100700037,,,,4,3,7
HND-009420,2011,100700045,,,,1,4,5
HND-009421,2011,100700046,,,,4,6,10
,2011,100700052,,,,7,6,13
HND-009432,2011,100700059,,,,6,5,11
HND-009447,2011,100700098,,,,1,1,2
HND-009454,2011,100700122,,,,3,1,4
HND-009455,2011,100700123,,,,5,5,10
,2011,100700143,,,,4,8,12
HND-009460,2011,100700144,,,,0,2,2
HND-009378,2011,100700003,,,,1,2,3
HND-009379,2011,100700004,,,,7,9,16
HND-009381,2011,100700006,,,,0,2,2
HND-009382,2011,100700007,,,,6,4,10
HND-009383,2011,100700008,,,,2,3,5
HND-009387,2011,100700012,,,,53,41,94
HND-009388,2011,100700013,,,,3,8,11
HND-009390,2011,100700015,,,,3,2,5
HND-009391,2011,100700016,,,,14,8,22
HND-009394,2011,100700019,,,,4,4,8
HND-009395,2011,100700020,,,,5,7,12
HND-009396,2011,100700021,,,,3,5,8
HND-009398,2011,100700023,,,,14,9,23
HND-009399,2011,100700024,,,,5,3,8
HND-009401,2011,100700026,,,,12,6,18
HND-009402,2011,100700027,,,,7,9,16
HND-009403,2011,100700028,,,,22,10,32
HND-009405,2011,100700030,,,,5,6,11
HND-009407,2011,100700032,,,,3,1,4
HND-009409,2011,100700034,,,,9,7,16
HND-009410,2011,100700035,,,,6,9,15
HND-009413,2011,100700038,,,,5,3,8
HND-009414,2011,100700039,,,,4,5,9
HND-009415,2011,100700040,,,,6,5,11
HND-009416,2011,100700041,,,,0,2,2
HND-009417,2011,100700042,,,,4,4,8
HND-009418,2011,100700043,,,,2,2,4
HND-009419,2011,100700044,,,,1,4,5
HND-009422,2011,100700047,,,,5,5,10
HND-009436,2011,100700064,,,,1,0,1
HND-009442,2011,100700080,,,,2,7,9
HND-009446,2011,100700096,,,,5,3,8
HND-009457,2011,100700139,,,,2,0,2
HND-009378,2011,100700003,,,,1,2,3
HND-009381,2011,100700006,,,,5,3,8
HND-009382,2011,100700007,,,,6,4,10
HND-009384,2011,100700009,,,,8,7,15
HND-009387,2011,100700012,,,,45,46,91
HND-009390,2011,100700015,,,,3,2,5
HND-009393,2011,100700018,,,,4,4,8
HND-009394,2011,100700019,,,,5,11,16
HND-009398,2011,100700023,,,,5,1,6
HND-009401,2011,100700026,,,,8,5,13
HND-009402,2011,100700027,,,,6,6,12
HND-009404,2011,100700029,,,,13,7,20
HND-009405,2011,100700030,,,,6,7,13
HND-009406,2011,100700031,,,,8,6,14
HND-009407,2011,100700032,,,,9,1,10
HND-009409,2011,100700034,,,,5,5,10
HND-009412,2011,100700037,,,,6,3,9
HND-009416,2011,100700041,,,,2,3,5
HND-009418,2011,100700043,,,,2,2,4
HND-009421,2011,100700046,,,,1,2,3
HND-009422,2011,100700047,,,,6,3,9
,2011,100700052,,,,1,7,8
HND-009432,2011,100700059,,,,7,6,13
HND-009442,2011,100700080,,,,7,5,12
HND-009447,2011,100700098,,,,1,0,1
HND-009455,2011,100700123,,,,8,2,10
HND-009457,2011,100700139,,,,4,4,8
,2011,100700143,,,,5,3,8
HND-009376,2011,100700001,,,,43,48,91
HND-009377,2011,100700002,,,,5,2,7
HND-009379,2011,100700004,,,,5,1,6
HND-009380,2011,100700005,,,,4,5,9
HND-009383,2011,100700008,,,,4,5,9
HND-009385,2011,100700010,,,,1,6,7
HND-009386,2011,100700011,,,,14,6,20
HND-009388,2011,100700013,,,,1,1,2
HND-009389,2011,100700014,,,,5,10,15
HND-009391,2011,100700016,,,,12,11,23
HND-009392,2011,100700017,,,,3,7,10
HND-009395,2011,100700020,,,,4,6,10
HND-009396,2011,100700021,,,,5,5,10
HND-009397,2011,100700022,,,,8,2,10
HND-009399,2011,100700024,,,,9,6,15
HND-009400,2011,100700025,,,,6,1,7
HND-009403,2011,100700028,,,,18,10,28
HND-009408,2011,100700033,,,,4,3,7
HND-009410,2011,100700035,,,,4,9,13
HND-009411,2011,100700036,,,,6,5,11
HND-009413,2011,100700038,,,,6,5,11
HND-009414,2011,100700039,,,,5,2,7
HND-009415,2011,100700040,,,,2,0,2
HND-009417,2011,100700042,,,,3,3,6
HND-009419,2011,100700044,,,,4,4,8
HND-009420,2011,100700045,,,,3,6,9
HND-009446,2011,100700096,,,,2,4,6
HND-009454,2011,100700122,,,,2,4,6
HND-009460,2011,100700144,,,,2,3,5
HND-009378,2011,100700003,,,,3,2,5
HND-009381,2011,100700006,,,,9,4,13
HND-009382,2011,100700007,,,,4,9,13
HND-009387,2011,100700012,,,,53,48,101
HND-009390,2011,100700015,,,,2,1,3
HND-009391,2011,100700016,,,,6,12,18
HND-009394,2011,100700019,,,,4,3,7
HND-009396,2011,100700021,,,,5,4,9
HND-009398,2011,100700023,,,,5,13,18
HND-009401,2011,100700026,,,,11,8,19
HND-009402,2011,100700027,,,,12,2,14
HND-009405,2011,100700030,,,,5,4,9
HND-009406,2011,100700031,,,,3,3,6
HND-009407,2011,100700032,,,,4,6,10
HND-009409,2011,100700034,,,,7,7,14
HND-009410,2011,100700035,,,,5,3,8
HND-009415,2011,100700040,,,,1,4,5
HND-009416,2011,100700041,,,,4,2,6
HND-009418,2011,100700043,,,,4,2,6
HND-009419,2011,100700044,,,,3,2,5
HND-009421,2011,100700046,,,,7,1,8
HND-009422,2011,100700047,,,,5,2,7
HND-009432,2011,100700059,,,,6,6,12
HND-009436,2011,100700064,,,,2,0,2
HND-009442,2011,100700080,,,,6,8,14
HND-009446,2011,100700096,,,,3,3,6
HND-009457,2011,100700139,,,,0,1,1
HND-009376,2011,100700001,,,,41,45,86
HND-009377,2011,100700002,,,,10,4,14
HND-009379,2011,100700004,,,,2,4,6
HND-009380,2011,100700005,,,,3,2,5
HND-009383,2011,100700008,,,,7,8,15
HND-009384,2011,100700009,,,,3,10,13
HND-009385,2011,100700010,,,,3,7,10
HND-009386,2011,100700011,,,,11,15,26
HND-009388,2011,100700013,,,,3,7,10
HND-009389,2011,100700014,,,,3,7,10
HND-009392,2011,100700017,,,,3,7,10
HND-009393,2011,100700018,,,,4,4,8
HND-009395,2011,100700020,,,,11,4,15
HND-009397,2011,100700022,,,,3,2,5
HND-009399,2011,100700024,,,,4,3,7
HND-009400,2011,100700025,,,,2,6,8
HND-009403,2011,100700028,,,,17,14,31
HND-009404,2011,100700029,,,,13,7,20
HND-009408,2011,100700033,,,,1,3,4
HND-009411,2011,100700036,,,,2,5,7
HND-009412,2011,100700037,,,,1,2,3
HND-009413,2011,100700038,,,,7,9,16
HND-009414,2011,100700039,,,,3,5,8
HND-009417,2011,100700042,,,,1,2,3
HND-009420,2011,100700045,,,,0,1,1
,2011,100700052,,,,4,4,8
HND-009447,2011,100700098,,,,1,0,1
HND-009454,2011,100700122,,,,1,5,6
HND-009455,2011,100700123,,,,7,4,11
,2011,100700143,,,,0,4,4
HND-009460,2011,100700144,,,,1,2,3
HND-009377,2011,100700002,,,,4,2,6
HND-009379,2011,100700004,,,,5,3,8
HND-009382,2011,100700007,,,,7,5,12
HND-009383,2011,100700008,,,,12,6,18
HND-009386,2011,100700011,,,,9,13,22
HND-009387,2011,100700012,,,,46,42,88
HND-009388,2011,100700013,,,,4,5,9
HND-009391,2011,100700016,,,,6,7,13
HND-009392,2011,100700017,,,,7,8,15
HND-009394,2011,100700019,,,,9,4,13
HND-009395,2011,100700020,,,,12,4,16
HND-009396,2011,100700021,,,,6,8,14
HND-009399,2011,100700024,,,,4,1,5
HND-009402,2011,100700027,,,,6,8,14
HND-009403,2011,100700028,,,,14,13,27
HND-009407,2011,100700032,,,,4,6,10
HND-009410,2011,100700035,,,,5,5,10
HND-009413,2011,100700038,,,,6,4,10
HND-009414,2011,100700039,,,,4,4,8
HND-009415,2011,100700040,,,,0,4,4
HND-009416,2011,100700041,,,,1,4,5
HND-009417,2011,100700042,,,,5,1,6
HND-009419,2011,100700044,,,,2,2,4
HND-009420,2011,100700045,,,,2,3,5
HND-009454,2011,100700122,,,,3,1,4
HND-009376,2011,100700001,,,,45,49,94
HND-009378,2011,100700003,,,,2,2,4
HND-009380,2011,100700005,,,,8,14,22
HND-009381,2011,100700006,,,,4,5,9
HND-009384,2011,100700009,,,,7,5,12
HND-009385,2011,100700010,,,,1,3,4
HND-009389,2011,100700014,,,,5,7,12
HND-009390,2011,100700015,,,,2,2,4
HND-009393,2011,100700018,,,,4,4,8
HND-009398,2011,100700023,,,,4,11,15
HND-009400,2011,100700025,,,,2,5,7
HND-009401,2011,100700026,,,,10,10,20
HND-009404,2011,100700029,,,,14,15,29
HND-009405,2011,100700030,,,,1,5,6
HND-009406,2011,100700031,,,,5,4,9
HND-009408,2011,100700033,,,,2,0,2
HND-009409,2011,100700034,,,,1,4,5
HND-009411,2011,100700036,,,,2,2,4
HND-009412,2011,100700037,,,,3,5,8
HND-009418,2011,100700043,,,,2,0,2
HND-009421,2011,100700046,,,,2,2,4
HND-009422,2011,100700047,,,,6,3,9
,2011,100700052,,,,1,3,4
HND-009432,2011,100700059,,,,2,6,8
HND-009436,2011,100700064,,,,0,1,1
HND-009442,2011,100700080,,,,3,7,10
HND-009447,2011,100700098,,,,3,0,3
HND-009455,2011,100700123,,,,2,1,3
HND-009460,2011,100700144,,,,1,3,4
HND-009401,2011,100700026,,,,10,9,19
HND-009430,2011,100700057,,,,144,161,305
,2011,100700065,,,,16,20,36
HND-009392,2011,100700017,,,,3,8,11
HND-009395,2011,100700020,,,,5,15,20
HND-009403,2011,100700028,,,,23,28,51
HND-009404,2011,100700029,,,,11,15,26
HND-009406,2011,100700031,,,,9,6,15
,2011,100700052,,,,1,1,2
HND-009401,2011,100700026,,,,3,14,17
HND-009404,2011,100700029,,,,9,12,21
HND-009406,2011,100700031,,,,4,4,8
HND-009392,2011,100700017,,,,8,3,11
HND-009395,2011,100700020,,,,5,5,10
HND-009403,2011,100700028,,,,2,12,14
HND-009430,2011,100700057,,,,104,88,192
,2011,100700065,,,,10,16,26
HND-009401,2011,100700026,,,,9,8,17
HND-009404,2011,100700029,,,,8,11,19
HND-009406,2011,100700031,,,,5,5,10
HND-009430,2011,100700057,,,,107,103,210
HND-009392,2011,100700017,,,,5,11,16
HND-009395,2011,100700020,,,,4,7,11
HND-009403,2011,100700028,,,,1,10,11
,2011,100700065,,,,14,23,37
,2011,100700065,,,,24,44,68
HND-009430,2011,100700057,,,,125,84,209
,2011,100700097,,,,3,12,15
,2011,100700097,,,,3,7,10
HND-009430,2011,100700057,,,,63,59,122
,2011,100700065,,,,14,26,40
HND-009430,2011,100700057,,,,47,40,87
,2011,100700065,,,,2,18,20
,2011,100800018,,,,4,2,6
,2011,100800021,,,,1,6,7
HND-009474,2011,100800010,,,,15,12,27
HND-009475,2011,100800011,,,,12,11,23
,2011,100800016,,,,9,3,12
,2011,100800017,,,,6,4,10
HND-009474,2011,100800010,,,,8,5,13
HND-009476,2011,100800012,,,,7,8,15
HND-009478,2011,100800014,,,,6,4,10
,2011,100800015,,,,2,2,4
HND-009474,2011,100800010,,,,14,9,23
HND-009476,2011,100800012,,,,7,10,17
,2011,100800015,,,,4,4,8
HND-009479,2011,100800019,,,,1,2,3
HND-009475,2011,100800011,,,,9,11,20
HND-009478,2011,100800014,,,,2,4,6
,2011,100800016,,,,1,2,3
,2011,100800017,,,,4,0,4
HND-009467,2011,100800003,,,,11,11,22
HND-009470,2011,100800006,,,,12,11,23
HND-009471,2011,100800007,,,,2,3,5
HND-009473,2011,100800009,,,,3,4,7
HND-009479,2011,100800019,,,,1,3,4
HND-009480,2011,100800020,,,,5,6,11
,2011,100800001,,,,12,6,18
HND-009466,2011,100800002,,,,5,4,9
HND-009468,2011,100800004,,,,6,5,11
HND-009469,2011,100800005,,,,3,4,7
HND-009472,2011,100800008,,,,2,7,9
,2011,100800001,,,,13,9,22
HND-009466,2011,100800002,,,,3,6,9
HND-009469,2011,100800005,,,,3,6,9
HND-009479,2011,100800019,,,,1,3,4
HND-009467,2011,100800003,,,,12,8,20
HND-009468,2011,100800004,,,,10,2,12
HND-009470,2011,100800006,,,,14,14,28
HND-009471,2011,100800007,,,,1,0,1
HND-009472,2011,100800008,,,,1,1,2
HND-009480,2011,100800020,,,,6,1,7
,2011,100800001,,,,12,11,23
HND-009466,2011,100800002,,,,5,3,8
HND-009468,2011,100800004,,,,10,7,17
HND-009469,2011,100800005,,,,3,3,6
HND-009472,2011,100800008,,,,6,4,10
HND-009467,2011,100800003,,,,11,7,18
HND-009470,2011,100800006,,,,16,10,26
HND-009471,2011,100800007,,,,2,0,2
HND-009473,2011,100800009,,,,1,1,2
HND-009479,2011,100800019,,,,5,3,8
HND-009480,2011,100800020,,,,8,5,13
,2011,100800001,,,,11,11,22
HND-009469,2011,100800005,,,,8,4,12
HND-009470,2011,100800006,,,,18,11,29
HND-009473,2011,100800009,,,,0,2,2
HND-009479,2011,100800019,,,,6,4,10
HND-009480,2011,100800020,,,,4,13,17
HND-009466,2011,100800002,,,,3,3,6
HND-009467,2011,100800003,,,,9,10,19
HND-009468,2011,100800004,,,,4,5,9
HND-009471,2011,100800007,,,,1,2,3
HND-009472,2011,100800008,,,,4,2,6
HND-009467,2011,100800003,,,,10,4,14
HND-009470,2011,100800006,,,,12,16,28
HND-009471,2011,100800007,,,,3,4,7
HND-009473,2011,100800009,,,,0,3,3
HND-009479,2011,100800019,,,,1,2,3
HND-009480,2011,100800020,,,,1,3,4
,2011,100800001,,,,8,13,21
HND-009466,2011,100800002,,,,4,5,9
HND-009468,2011,100800004,,,,4,3,7
HND-009469,2011,100800005,,,,4,2,6
HND-009472,2011,100800008,,,,8,2,10
HND-009467,2011,100800003,,,,2,8,10
HND-009468,2011,100800004,,,,2,1,3
HND-009470,2011,100800006,,,,15,10,25
HND-009471,2011,100800007,,,,3,1,4
HND-009472,2011,100800008,,,,4,4,8
HND-009480,2011,100800020,,,,5,3,8
,2011,100800001,,,,8,16,24
HND-009466,2011,100800002,,,,1,2,3
HND-009469,2011,100800005,,,,2,4,6
HND-009479,2011,100800019,,,,1,2,3
HND-009477,2011,100800013,,,,38,37,75
HND-009477,2011,100800013,,,,41,44,85
HND-009477,2011,100800013,,,,35,24,59
HND-009477,2011,100800013,,,,21,13,34
HND-009477,2011,100800013,,,,20,8,28
HND-009477,2011,100800013,,,,4,6,10
HND-009523,2011,100900055,,,,6,9,15
HND-009524,2011,100900058,,,,6,4,10
,2011,100900060,,,,5,6,11
,2011,100900061,,,,12,7,19
,2011,100900062,,,,6,2,8
,2011,100900079,,,,6,7,13
,2011,100900129,,,,5,4,9
HND-009536,2011,100900131,,,,8,2,10
HND-009522,2011,100900053,,,,4,4,8
,2011,100900056,,,,7,6,13
,2011,100900059,,,,5,5,10
HND-009529,2011,100900070,,,,8,2,10
,2011,100900077,,,,3,4,7
,2011,100900078,,,,2,4,6
,2011,100900081,,,,5,6,11
,2011,100900130,,,,13,5,18
HND-009539,2011,100900152,,,,4,9,13
,2011,100900153,,,,2,5,7
,2011,100900043,,,,0,3,3
HND-009518,2011,100900046,,,,1,3,4
HND-009520,2011,100900049,,,,0,1,1
,2011,100900050,,,,2,2,4
,2011,100900052,,,,4,5,9
,2011,100900054,,,,1,0,1
HND-009526,2011,100900064,,,,4,5,9
,2011,100900077,,,,4,5,9
HND-009508,2011,100900030,,,,3,1,4
HND-009511,2011,100900033,,,,0,2,2
HND-009517,2011,100900044,,,,2,2,4
HND-009521,2011,100900051,,,,1,0,1
HND-009525,2011,100900063,,,,0,2,2
,2011,100900133,,,,3,3,6
HND-009506,2011,100900028,,,,3,4,7
HND-009508,2011,100900030,,,,3,1,4
HND-009514,2011,100900038,,,,2,0,2
,2011,100900039,,,,3,5,8
,2011,100900045,,,,3,1,4
HND-009518,2011,100900046,,,,1,2,3
HND-009520,2011,100900049,,,,0,3,3
,2011,100900050,,,,1,2,3
HND-009521,2011,100900051,,,,3,2,5
,2011,100900052,,,,1,2,3
,2011,100900054,,,,7,2,9
HND-009525,2011,100900063,,,,3,4,7
HND-009526,2011,100900064,,,,1,2,3
HND-009527,2011,100900067,,,,0,2,2
,2011,100900133,,,,2,2,4
HND-009502,2011,100900024,,,,1,3,4
HND-009504,2011,100900026,,,,5,5,10
HND-009505,2011,100900027,,,,2,2,4
HND-009509,2011,100900031,,,,3,1,4
HND-009511,2011,100900033,,,,6,0,6
HND-009513,2011,100900036,,,,2,5,7
,2011,100900037,,,,0,2,2
HND-009516,2011,100900041,,,,5,2,7
,2011,100900043,,,,3,4,7
HND-009517,2011,100900044,,,,1,2,3
,2011,100900047,,,,0,3,3
HND-009519,2011,100900048,,,,1,0,1
HND-009502,2011,100900024,,,,4,8,12
HND-009504,2011,100900026,,,,2,3,5
HND-009505,2011,100900027,,,,1,2,3
HND-009506,2011,100900028,,,,3,6,9
,2011,100900039,,,,5,5,10
,2011,100900043,,,,4,2,6
,2011,100900045,,,,2,9,11
HND-009518,2011,100900046,,,,6,1,7
HND-009520,2011,100900049,,,,12,9,21
,2011,100900050,,,,1,3,4
HND-009521,2011,100900051,,,,5,3,8
,2011,100900052,,,,3,1,4
,2011,100900054,,,,3,4,7
,2011,100900133,,,,1,1,2
HND-009508,2011,100900030,,,,1,3,4
HND-009509,2011,100900031,,,,2,9,11
HND-009511,2011,100900033,,,,3,4,7
HND-009513,2011,100900036,,,,3,10,13
,2011,100900037,,,,10,2,12
HND-009514,2011,100900038,,,,5,10,15
HND-009516,2011,100900041,,,,7,2,9
HND-009517,2011,100900044,,,,1,3,4
,2011,100900047,,,,5,1,6
HND-009519,2011,100900048,,,,18,12,30
HND-009525,2011,100900063,,,,4,2,6
HND-009526,2011,100900064,,,,3,1,4
HND-009527,2011,100900067,,,,4,2,6
HND-009482,2011,100900003,,,,4,11,15
HND-009483,2011,100900004,,,,5,5,10
HND-009485,2011,100900006,,,,16,16,32
HND-009486,2011,100900007,,,,9,9,18
HND-009489,2011,100900010,,,,2,8,10
HND-009491,2011,100900012,,,,7,9,16
HND-009494,2011,100900015,,,,7,8,15
HND-009497,2011,100900018,,,,2,2,4
,2011,100900019,,,,1,6,7
HND-009498,2011,100900020,,,,8,3,11
HND-009500,2011,100900022,,,,15,13,28
HND-009502,2011,100900024,,,,5,4,9
HND-009503,2011,100900025,,,,4,4,8
HND-009506,2011,100900028,,,,5,3,8
HND-009508,2011,100900030,,,,1,5,6
HND-009509,2011,100900031,,,,7,6,13
HND-009510,2011,100900032,,,,3,2,5
HND-009512,2011,100900034,,,,7,8,15
HND-009521,2011,100900051,,,,9,3,12
HND-009525,2011,100900063,,,,8,2,10
HND-009526,2011,100900064,,,,2,1,3
HND-009527,2011,100900067,,,,4,0,4
HND-009530,2011,100900072,,,,2,1,3
HND-009532,2011,100900074,,,,1,3,4
HND-009533,2011,100900075,,,,6,3,9
HND-009481,2011,100900002,,,,6,13,19
HND-009484,2011,100900005,,,,6,11,17
HND-009487,2011,100900008,,,,6,5,11
HND-009488,2011,100900009,,,,6,6,12
HND-009490,2011,100900011,,,,8,9,17
HND-009492,2011,100900013,,,,2,7,9
HND-009493,2011,100900014,,,,6,7,13
HND-009495,2011,100900016,,,,3,3,6
HND-009496,2011,100900017,,,,3,2,5
HND-009499,2011,100900021,,,,4,2,6
HND-009501,2011,100900023,,,,2,5,7
HND-009504,2011,100900026,,,,4,8,12
HND-009505,2011,100900027,,,,1,0,1
HND-009507,2011,100900029,,,,6,4,10
HND-009511,2011,100900033,,,,5,4,9
HND-009517,2011,100900044,,,,3,2,5
HND-009528,2011,100900068,,,,4,4,8
HND-009531,2011,100900073,,,,1,3,4
HND-009534,2011,100900076,,,,3,3,6
HND-009537,2011,100900132,,,,1,1,2
HND-009538,2011,100900149,,,,4,5,9
HND-009481,2011,100900002,,,,9,8,17
HND-009482,2011,100900003,,,,2,9,11
HND-009484,2011,100900005,,,,10,13,23
HND-009485,2011,100900006,,,,13,22,35
HND-009488,2011,100900009,,,,7,3,10
HND-009489,2011,100900010,,,,6,9,15
HND-009490,2011,100900011,,,,9,4,13
HND-009491,2011,100900012,,,,6,9,15
HND-009493,2011,100900014,,,,8,5,13
HND-009496,2011,100900017,,,,3,1,4
HND-009497,2011,100900018,,,,3,8,11
HND-009498,2011,100900020,,,,7,3,10
HND-009499,2011,100900021,,,,1,4,5
HND-009501,2011,100900023,,,,5,5,10
HND-009502,2011,100900024,,,,6,6,12
HND-009504,2011,100900026,,,,5,9,14
HND-009505,2011,100900027,,,,7,3,10
HND-009506,2011,100900028,,,,6,1,7
HND-009507,2011,100900029,,,,2,2,4
HND-009510,2011,100900032,,,,3,3,6
HND-009521,2011,100900051,,,,5,4,9
HND-009530,2011,100900072,,,,1,4,5
HND-009532,2011,100900074,,,,1,3,4
HND-009533,2011,100900075,,,,2,5,7
HND-009534,2011,100900076,,,,3,1,4
HND-009537,2011,100900132,,,,3,3,6
HND-009483,2011,100900004,,,,6,2,8
HND-009486,2011,100900007,,,,12,10,22
HND-009487,2011,100900008,,,,8,6,14
HND-009492,2011,100900013,,,,5,0,5
HND-009494,2011,100900015,,,,8,4,12
HND-009495,2011,100900016,,,,5,5,10
,2011,100900019,,,,3,3,6
HND-009500,2011,100900022,,,,8,17,25
HND-009503,2011,100900025,,,,7,7,14
HND-009508,2011,100900030,,,,1,5,6
HND-009509,2011,100900031,,,,5,6,11
HND-009511,2011,100900033,,,,4,7,11
HND-009512,2011,100900034,,,,9,6,15
HND-009517,2011,100900044,,,,4,0,4
HND-009525,2011,100900063,,,,3,2,5
HND-009526,2011,100900064,,,,4,4,8
HND-009527,2011,100900067,,,,3,3,6
HND-009528,2011,100900068,,,,3,2,5
HND-009531,2011,100900073,,,,3,1,4
HND-009538,2011,100900149,,,,2,3,5
HND-009481,2011,100900002,,,,11,8,19
HND-009484,2011,100900005,,,,11,12,23
HND-009488,2011,100900009,,,,2,7,9
HND-009489,2011,100900010,,,,5,8,13
HND-009490,2011,100900011,,,,2,6,8
HND-009492,2011,100900013,,,,4,3,7
HND-009493,2011,100900014,,,,4,4,8
HND-009495,2011,100900016,,,,7,5,12
HND-009496,2011,100900017,,,,6,10,16
HND-009499,2011,100900021,,,,3,2,5
HND-009501,2011,100900023,,,,4,2,6
HND-009504,2011,100900026,,,,6,4,10
HND-009505,2011,100900027,,,,6,7,13
HND-009507,2011,100900029,,,,4,4,8
HND-009508,2011,100900030,,,,6,3,9
HND-009510,2011,100900032,,,,7,6,13
HND-009512,2011,100900034,,,,11,12,23
HND-009521,2011,100900051,,,,6,3,9
HND-009528,2011,100900068,,,,2,2,4
HND-009530,2011,100900072,,,,2,3,5
HND-009532,2011,100900074,,,,3,2,5
HND-009533,2011,100900075,,,,3,4,7
HND-009537,2011,100900132,,,,2,4,6
HND-009538,2011,100900149,,,,2,2,4
HND-009482,2011,100900003,,,,8,5,13
HND-009483,2011,100900004,,,,2,3,5
HND-009485,2011,100900006,,,,15,26,41
HND-009486,2011,100900007,,,,22,23,45
HND-009487,2011,100900008,,,,2,4,6
HND-009491,2011,100900012,,,,6,2,8
HND-009494,2011,100900015,,,,12,11,23
HND-009497,2011,100900018,,,,2,2,4
,2011,100900019,,,,3,0,3
HND-009498,2011,100900020,,,,5,3,8
HND-009500,2011,100900022,,,,13,7,20
HND-009502,2011,100900024,,,,10,7,17
HND-009503,2011,100900025,,,,5,2,7
HND-009506,2011,100900028,,,,10,7,17
HND-009509,2011,100900031,,,,6,4,10
HND-009511,2011,100900033,,,,0,5,5
HND-009517,2011,100900044,,,,3,2,5
HND-009525,2011,100900063,,,,3,1,4
HND-009526,2011,100900064,,,,3,3,6
HND-009527,2011,100900067,,,,3,0,3
HND-009531,2011,100900073,,,,1,3,4
HND-009534,2011,100900076,,,,5,0,5
HND-009481,2011,100900002,,,,7,4,11
HND-009482,2011,100900003,,,,5,10,15
HND-009485,2011,100900006,,,,11,12,23
HND-009486,2011,100900007,,,,7,9,16
HND-009488,2011,100900009,,,,11,6,17
HND-009489,2011,100900010,,,,8,3,11
HND-009490,2011,100900011,,,,12,3,15
HND-009491,2011,100900012,,,,8,5,13
HND-009493,2011,100900014,,,,9,2,11
HND-009494,2011,100900015,,,,13,8,21
HND-009497,2011,100900018,,,,6,8,14
HND-009498,2011,100900020,,,,7,8,15
HND-009499,2011,100900021,,,,8,6,14
HND-009500,2011,100900022,,,,12,10,22
HND-009501,2011,100900023,,,,8,6,14
HND-009502,2011,100900024,,,,9,3,12
HND-009505,2011,100900027,,,,6,3,9
HND-009506,2011,100900028,,,,9,4,13
HND-009525,2011,100900063,,,,3,2,5
HND-009527,2011,100900067,,,,2,1,3
HND-009531,2011,100900073,,,,2,3,5
HND-009533,2011,100900075,,,,4,7,11
HND-009534,2011,100900076,,,,2,2,4
HND-009537,2011,100900132,,,,2,4,6
HND-009483,2011,100900004,,,,2,2,4
HND-009484,2011,100900005,,,,15,11,26
HND-009487,2011,100900008,,,,7,6,13
HND-009492,2011,100900013,,,,3,3,6
HND-009495,2011,100900016,,,,6,3,9
HND-009496,2011,100900017,,,,7,9,16
,2011,100900019,,,,5,2,7
HND-009503,2011,100900025,,,,7,0,7
HND-009504,2011,100900026,,,,7,9,16
HND-009507,2011,100900029,,,,1,4,5
HND-009508,2011,100900030,,,,4,1,5
HND-009509,2011,100900031,,,,2,8,10
HND-009510,2011,100900032,,,,5,2,7
HND-009511,2011,100900033,,,,3,3,6
HND-009512,2011,100900034,,,,8,8,16
HND-009521,2011,100900051,,,,6,7,13
HND-009526,2011,100900064,,,,4,2,6
HND-009528,2011,100900068,,,,3,1,4
HND-009530,2011,100900072,,,,2,3,5
HND-009532,2011,100900074,,,,2,1,3
HND-009538,2011,100900149,,,,2,2,4
HND-009481,2011,100900002,,,,12,7,19
HND-009482,2011,100900003,,,,4,5,9
HND-009485,2011,100900006,,,,12,12,24
HND-009486,2011,100900007,,,,12,11,23
HND-009489,2011,100900010,,,,2,4,6
HND-009491,2011,100900012,,,,6,9,15
HND-009493,2011,100900014,,,,3,4,7
HND-009494,2011,100900015,,,,8,5,13
HND-009497,2011,100900018,,,,3,0,3
HND-009498,2011,100900020,,,,4,2,6
HND-009499,2011,100900021,,,,3,5,8
HND-009500,2011,100900022,,,,10,8,18
HND-009502,2011,100900024,,,,2,5,7
HND-009503,2011,100900025,,,,4,3,7
HND-009506,2011,100900028,,,,6,4,10
HND-009511,2011,100900033,,,,7,4,11
HND-009525,2011,100900063,,,,4,2,6
HND-009527,2011,100900067,,,,3,4,7
HND-009531,2011,100900073,,,,3,0,3
HND-009534,2011,100900076,,,,4,1,5
HND-009537,2011,100900132,,,,2,9,11
HND-009483,2011,100900004,,,,3,10,13
HND-009484,2011,100900005,,,,11,9,20
HND-009487,2011,100900008,,,,2,4,6
HND-009488,2011,100900009,,,,5,1,6
HND-009490,2011,100900011,,,,7,5,12
HND-009492,2011,100900013,,,,2,6,8
HND-009495,2011,100900016,,,,2,7,9
HND-009496,2011,100900017,,,,3,2,5
,2011,100900019,,,,2,3,5
HND-009501,2011,100900023,,,,3,4,7
HND-009504,2011,100900026,,,,5,7,12
HND-009505,2011,100900027,,,,6,6,12
HND-009507,2011,100900029,,,,4,2,6
HND-009508,2011,100900030,,,,9,1,10
HND-009509,2011,100900031,,,,7,3,10
HND-009510,2011,100900032,,,,0,2,2
HND-009512,2011,100900034,,,,2,9,11
HND-009517,2011,100900044,,,,2,2,4
HND-009521,2011,100900051,,,,1,2,3
HND-009526,2011,100900064,,,,2,3,5
HND-009528,2011,100900068,,,,2,0,2
HND-009530,2011,100900072,,,,1,2,3
HND-009533,2011,100900075,,,,6,4,10
HND-009538,2011,100900149,,,,2,2,4
HND-009483,2011,100900004,,,,3,10,13
HND-009486,2011,100900007,,,,9,11,20
HND-009487,2011,100900008,,,,2,3,5
HND-009492,2011,100900013,,,,4,1,5
HND-009494,2011,100900015,,,,8,12,20
HND-009495,2011,100900016,,,,2,3,5
,2011,100900019,,,,3,5,8
HND-009500,2011,100900022,,,,10,8,18
HND-009503,2011,100900025,,,,4,1,5
HND-009508,2011,100900030,,,,4,3,7
HND-009509,2011,100900031,,,,6,9,15
HND-009511,2011,100900033,,,,4,2,6
HND-009512,2011,100900034,,,,6,9,15
HND-009517,2011,100900044,,,,4,1,5
HND-009525,2011,100900063,,,,4,3,7
HND-009526,2011,100900064,,,,6,4,10
HND-009527,2011,100900067,,,,2,5,7
HND-009528,2011,100900068,,,,1,3,4
HND-009531,2011,100900073,,,,2,1,3
HND-009538,2011,100900149,,,,4,3,7
HND-009481,2011,100900002,,,,11,7,18
HND-009482,2011,100900003,,,,1,7,8
HND-009484,2011,100900005,,,,15,8,23
HND-009485,2011,100900006,,,,13,11,24
HND-009488,2011,100900009,,,,4,2,6
HND-009489,2011,100900010,,,,8,2,10
HND-009490,2011,100900011,,,,9,10,19
HND-009491,2011,100900012,,,,3,4,7
HND-009493,2011,100900014,,,,3,6,9
HND-009496,2011,100900017,,,,9,8,17
HND-009497,2011,100900018,,,,2,2,4
HND-009498,2011,100900020,,,,5,5,10
HND-009499,2011,100900021,,,,3,3,6
HND-009501,2011,100900023,,,,0,4,4
HND-009502,2011,100900024,,,,7,4,11
HND-009504,2011,100900026,,,,3,6,9
HND-009505,2011,100900027,,,,4,3,7
HND-009506,2011,100900028,,,,4,3,7
HND-009507,2011,100900029,,,,2,5,7
HND-009510,2011,100900032,,,,7,2,9
HND-009521,2011,100900051,,,,3,4,7
HND-009532,2011,100900074,,,,2,2,4
HND-009533,2011,100900075,,,,3,2,5
HND-009534,2011,100900076,,,,3,5,8
HND-009537,2011,100900132,,,,0,1,1
HND-009481,2011,100900002,,,,14,13,27
HND-009484,2011,100900005,,,,22,32,54
HND-009488,2011,100900009,,,,9,5,14
HND-009481,2011,100900002,,,,16,15,31
HND-009484,2011,100900005,,,,18,26,44
HND-009488,2011,100900009,,,,7,8,15
HND-009484,2011,100900005,,,,17,21,38
HND-009481,2011,100900002,,,,6,12,18
HND-009488,2011,100900009,,,,4,5,9
HND-009572,2011,101000030,,,,6,2,8
HND-009573,2011,101000031,,,,4,4,8
HND-009576,2011,101000036,,,,5,4,9
HND-009578,2011,101000038,,,,6,7,13
,2011,101000039,,,,3,4,7
HND-009580,2011,101000054,,,,3,5,8
HND-009571,2011,101000029,,,,4,2,6
HND-009574,2011,101000032,,,,10,4,14
HND-009575,2011,101000034,,,,5,4,9
,2011,101000035,,,,4,4,8
HND-009577,2011,101000037,,,,8,9,17
HND-009581,2011,101000055,,,,8,4,12
HND-009561,2011,101000019,,,,4,5,9
,2011,101000028,,,,7,5,12
,2011,101000053,,,,7,5,12
HND-009562,2011,101000020,,,,5,7,12
HND-009563,2011,101000021,,,,5,10,15
HND-009564,2011,101000022,,,,4,3,7
HND-009566,2011,101000024,,,,6,4,10
HND-009567,2011,101000025,,,,1,5,6
HND-009568,2011,101000026,,,,5,6,11
HND-009562,2011,101000020,,,,4,3,7
HND-009563,2011,101000021,,,,10,12,22
HND-009564,2011,101000022,,,,6,8,14
HND-009566,2011,101000024,,,,5,5,10
HND-009567,2011,101000025,,,,8,4,12
HND-009561,2011,101000019,,,,1,0,1
HND-009568,2011,101000026,,,,1,4,5
,2011,101000028,,,,3,3,6
,2011,101000053,,,,3,4,7
HND-009545,2011,101000001,,,,6,4,10
HND-009546,2011,101000002,,,,4,5,9
HND-009547,2011,101000003,,,,3,1,4
HND-009548,2011,101000004,,,,5,2,7
HND-009550,2011,101000006,,,,7,6,13
HND-009557,2011,101000013,,,,4,3,7
HND-009559,2011,101000015,,,,10,2,12
HND-009560,2011,101000017,,,,5,9,14
HND-009561,2011,101000019,,,,4,3,7
HND-009569,2011,101000027,,,,2,3,5
HND-009549,2011,101000005,,,,3,5,8
HND-009552,2011,101000008,,,,3,2,5
HND-009553,2011,101000009,,,,8,4,12
HND-009554,2011,101000010,,,,3,4,7
HND-009555,2011,101000011,,,,7,5,12
HND-009556,2011,101000012,,,,5,9,14
HND-009558,2011,101000014,,,,9,5,14
HND-009545,2011,101000001,,,,6,3,9
HND-009550,2011,101000006,,,,7,5,12
HND-009553,2011,101000009,,,,11,13,24
HND-009554,2011,101000010,,,,2,3,5
HND-009555,2011,101000011,,,,9,9,18
HND-009556,2011,101000012,,,,7,5,12
HND-009557,2011,101000013,,,,2,4,6
HND-009558,2011,101000014,,,,10,10,20
HND-009559,2011,101000015,,,,7,2,9
HND-009560,2011,101000017,,,,9,5,14
HND-009569,2011,101000027,,,,2,3,5
HND-009546,2011,101000002,,,,2,5,7
HND-009547,2011,101000003,,,,5,0,5
HND-009548,2011,101000004,,,,6,5,11
HND-009549,2011,101000005,,,,5,4,9
HND-009551,2011,101000007,,,,2,1,3
HND-009552,2011,101000008,,,,3,3,6
HND-009561,2011,101000019,,,,3,3,6
HND-009549,2011,101000005,,,,7,5,12
HND-009552,2011,101000008,,,,1,3,4
HND-009553,2011,101000009,,,,11,7,18
HND-009554,2011,101000010,,,,2,1,3
HND-009555,2011,101000011,,,,8,3,11
HND-009556,2011,101000012,,,,9,7,16
HND-009558,2011,101000014,,,,10,9,19
HND-009545,2011,101000001,,,,6,10,16
HND-009546,2011,101000002,,,,1,6,7
HND-009547,2011,101000003,,,,0,1,1
HND-009548,2011,101000004,,,,8,8,16
HND-009550,2011,101000006,,,,7,4,11
HND-009551,2011,101000007,,,,1,1,2
HND-009557,2011,101000013,,,,3,5,8
HND-009559,2011,101000015,,,,1,6,7
HND-009560,2011,101000017,,,,4,2,6
HND-009561,2011,101000019,,,,2,3,5
HND-009569,2011,101000027,,,,3,2,5
HND-009545,2011,101000001,,,,7,7,14
HND-009550,2011,101000006,,,,2,6,8
HND-009553,2011,101000009,,,,9,5,14
HND-009556,2011,101000012,,,,13,9,22
HND-009557,2011,101000013,,,,5,3,8
HND-009558,2011,101000014,,,,10,10,20
HND-009559,2011,101000015,,,,5,4,9
HND-009560,2011,101000017,,,,3,5,8
HND-009569,2011,101000027,,,,5,3,8
HND-009546,2011,101000002,,,,4,5,9
HND-009547,2011,101000003,,,,0,4,4
HND-009548,2011,101000004,,,,5,6,11
HND-009549,2011,101000005,,,,3,5,8
HND-009551,2011,101000007,,,,1,0,1
HND-009552,2011,101000008,,,,1,0,1
HND-009554,2011,101000010,,,,2,2,4
HND-009555,2011,101000011,,,,6,5,11
HND-009561,2011,101000019,,,,3,0,3
HND-009545,2011,101000001,,,,14,5,19
HND-009546,2011,101000002,,,,10,3,13
HND-009548,2011,101000004,,,,4,6,10
HND-009550,2011,101000006,,,,2,6,8
HND-009556,2011,101000012,,,,7,3,10
HND-009557,2011,101000013,,,,5,5,10
HND-009558,2011,101000014,,,,8,12,20
HND-009560,2011,101000017,,,,3,1,4
HND-009569,2011,101000027,,,,6,2,8
HND-009547,2011,101000003,,,,4,0,4
HND-009549,2011,101000005,,,,3,0,3
HND-009551,2011,101000007,,,,4,5,9
HND-009552,2011,101000008,,,,1,0,1
HND-009553,2011,101000009,,,,10,7,17
HND-009554,2011,101000010,,,,0,2,2
HND-009555,2011,101000011,,,,5,5,10
HND-009546,2011,101000002,,,,5,0,5
HND-009547,2011,101000003,,,,1,2,3
HND-009548,2011,101000004,,,,2,7,9
HND-009549,2011,101000005,,,,2,2,4
HND-009551,2011,101000007,,,,1,1,2
HND-009552,2011,101000008,,,,4,2,6
HND-009545,2011,101000001,,,,9,10,19
HND-009550,2011,101000006,,,,1,0,1
HND-009553,2011,101000009,,,,6,6,12
HND-009554,2011,101000010,,,,0,6,6
HND-009555,2011,101000011,,,,7,7,14
HND-009556,2011,101000012,,,,4,0,4
HND-009557,2011,101000013,,,,2,2,4
HND-009558,2011,101000014,,,,12,8,20
HND-009559,2011,101000015,,,,1,2,3
HND-009560,2011,101000017,,,,2,6,8
HND-009569,2011,101000027,,,,1,2,3
HND-009553,2011,101000009,,,,12,8,20
HND-009558,2011,101000014,,,,11,12,23
HND-009565,2011,101000023,,,,25,28,53
HND-009553,2011,101000009,,,,5,9,14
HND-009558,2011,101000014,,,,4,7,11
HND-009565,2011,101000023,,,,27,16,43
HND-009565,2011,101000023,,,,29,33,62
HND-009553,2011,101000009,,,,8,7,15
HND-009558,2011,101000014,,,,4,3,7
HND-009565,2011,101000023,,,,9,13,22
HND-009565,2011,101000023,,,,6,3,9
HND-009565,2011,101000023,,,,7,4,11
HND-009589,2011,101100009,,,,13,9,22
HND-009587,2011,101100006,,,,1,2,3
HND-009588,2011,101100007,,,,1,0,1
,2011,101100015,,,,2,0,2
HND-009591,2011,101100011,,,,3,2,5
HND-009592,2011,101100012,,,,4,2,6
,2011,101100014,,,,3,4,7
,2011,101100015,,,,5,1,6
HND-009587,2011,101100006,,,,14,13,27
HND-009588,2011,101100007,,,,4,9,13
HND-009587,2011,101100006,,,,14,17,31
HND-009588,2011,101100007,,,,7,13,20
HND-009591,2011,101100011,,,,10,5,15
HND-009592,2011,101100012,,,,11,9,20
,2011,101100014,,,,2,2,4
,2011,101100015,,,,2,1,3
HND-009590,2011,101100010,,,,7,16,23
HND-009593,2011,101100013,,,,3,8,11
,2011,101100014,,,,3,8,11
HND-009582,2011,101100001,,,,20,12,32
HND-009583,2011,101100002,,,,11,13,24
HND-009584,2011,101100003,,,,5,4,9
HND-009585,2011,101100004,,,,14,3,17
HND-009586,2011,101100005,,,,15,11,26
HND-009582,2011,101100001,,,,20,8,28
HND-009584,2011,101100003,,,,2,5,7
HND-009586,2011,101100005,,,,7,17,24
HND-009590,2011,101100010,,,,9,3,12
HND-009583,2011,101100002,,,,9,18,27
HND-009585,2011,101100004,,,,13,13,26
HND-009593,2011,101100013,,,,4,0,4
,2011,101100014,,,,4,0,4
HND-009582,2011,101100001,,,,26,24,50
HND-009583,2011,101100002,,,,13,10,23
HND-009584,2011,101100003,,,,7,3,10
HND-009585,2011,101100004,,,,7,13,20
HND-009586,2011,101100005,,,,11,10,21
HND-009590,2011,101100010,,,,8,8,16
HND-009593,2011,101100013,,,,7,3,10
,2011,101100014,,,,7,3,10
HND-009582,2011,101100001,,,,27,24,51
HND-009586,2011,101100005,,,,14,8,22
HND-009590,2011,101100010,,,,8,7,15
HND-009583,2011,101100002,,,,12,7,19
HND-009584,2011,101100003,,,,1,3,4
HND-009585,2011,101100004,,,,15,12,27
HND-009590,2011,101100010,,,,9,13,22
HND-009582,2011,101100001,,,,20,13,33
HND-009583,2011,101100002,,,,9,5,14
HND-009584,2011,101100003,,,,2,5,7
HND-009585,2011,101100004,,,,9,13,22
HND-009586,2011,101100005,,,,4,6,10
HND-009583,2011,101100002,,,,6,7,13
HND-009585,2011,101100004,,,,4,15,19
HND-009582,2011,101100001,,,,22,13,35
HND-009584,2011,101100003,,,,2,2,4
HND-009586,2011,101100005,,,,9,10,19
HND-009590,2011,101100010,,,,5,1,6
HND-009582,2011,101100001,,,,26,29,55
HND-009582,2011,101100001,,,,12,26,38
HND-009582,2011,101100001,,,,19,26,45
HND-009602,2011,101200008,,,,9,7,16
HND-009613,2011,101200019,,,,4,6,10
,2011,101200079,,,,6,5,11
,2011,101200080,,,,3,9,12
,2011,101200081,,,,7,3,10
,2011,101200084,,,,5,8,13
,2011,101200087,,,,9,9,18
HND-009639,2011,101200092,,,,2,5,7
,2011,101200097,,,,6,5,11
,2011,101200099,,,,1,9,10
,2011,101200100,,,,2,4,6
,2011,101200102,,,,4,3,7
HND-009642,2011,101200103,,,,5,5,10
HND-009637,2011,101200085,,,,6,11,17
HND-009641,2011,101200098,,,,3,7,10
,2011,101200101,,,,4,2,6
,2011,101200001,,,,1,1,2
,2011,101200002,,,,3,1,4
,2011,101200003,,,,0,1,1
,2011,101200004,,,,0,1,1
HND-009632,2011,101200042,,,,4,2,6
HND-009633,2011,101200043,,,,1,2,3
HND-009635,2011,101200050,,,,0,1,1
HND-009636,2011,101200052,,,,3,1,4
HND-009640,2011,101200093,,,,2,4,6
HND-009619,2011,101200025,,,,7,10,17
,2011,101200046,,,,2,1,3
,2011,101200001,,,,4,5,9
,2011,101200002,,,,3,1,4
,2011,101200004,,,,5,1,6
HND-009612,2011,101200018,,,,2,2,4
HND-009619,2011,101200025,,,,8,2,10
HND-009625,2011,101200034,,,,3,7,10
HND-009631,2011,101200041,,,,7,3,10
HND-009632,2011,101200042,,,,3,1,4
HND-009633,2011,101200043,,,,2,1,3
,2011,101200046,,,,2,2,4
HND-009634,2011,101200047,,,,4,1,5
HND-009635,2011,101200050,,,,2,1,3
HND-009636,2011,101200052,,,,3,1,4
HND-009638,2011,101200091,,,,4,3,7
HND-009640,2011,101200093,,,,1,1,2
,2011,101200096,,,,4,3,7
,2011,101200003,,,,1,3,4
HND-009624,2011,101200033,,,,6,5,11
HND-009626,2011,101200035,,,,2,5,7
HND-009627,2011,101200036,,,,3,12,15
HND-009628,2011,101200037,,,,6,1,7
,2011,101200001,,,,9,6,15
,2011,101200002,,,,1,5,6
,2011,101200003,,,,4,5,9
,2011,101200004,,,,4,8,12
HND-009612,2011,101200018,,,,1,2,3
HND-009614,2011,101200020,,,,6,2,8
HND-009620,2011,101200026,,,,10,11,21
HND-009624,2011,101200033,,,,11,8,19
HND-009626,2011,101200035,,,,11,9,20
HND-009631,2011,101200041,,,,9,11,20
,2011,101200046,,,,9,6,15
HND-009638,2011,101200091,,,,5,3,8
,2011,101200096,,,,5,3,8
HND-009619,2011,101200025,,,,15,20,35
HND-009625,2011,101200034,,,,13,10,23
HND-009627,2011,101200036,,,,3,7,10
HND-009632,2011,101200042,,,,4,6,10
HND-009633,2011,101200043,,,,2,3,5
HND-009634,2011,101200047,,,,5,1,6
HND-009635,2011,101200050,,,,4,8,12
HND-009636,2011,101200052,,,,4,5,9
HND-009640,2011,101200093,,,,2,0,2
HND-009599,2011,101200005,,,,34,25,59
HND-009600,2011,101200006,,,,12,7,19
HND-009603,2011,101200009,,,,19,9,28
HND-009605,2011,101200011,,,,14,8,22
HND-009606,2011,101200012,,,,7,5,12
HND-009607,2011,101200013,,,,14,4,18
HND-009608,2011,101200014,,,,8,10,18
HND-009609,2011,101200015,,,,12,9,21
HND-009611,2011,101200017,,,,7,5,12
HND-009614,2011,101200020,,,,6,10,16
HND-009615,2011,101200021,,,,4,2,6
HND-009621,2011,101200029,,,,4,5,9
HND-009628,2011,101200037,,,,6,4,10
HND-009629,2011,101200038,,,,5,9,14
HND-009630,2011,101200039,,,,12,14,26
HND-009635,2011,101200050,,,,8,5,13
HND-009638,2011,101200091,,,,6,5,11
HND-009639,2011,101200092,,,,0,2,2
HND-009640,2011,101200093,,,,1,1,2
HND-009601,2011,101200007,,,,8,5,13
HND-009602,2011,101200008,,,,7,5,12
HND-009604,2011,101200010,,,,30,20,50
HND-009610,2011,101200016,,,,9,7,16
HND-009613,2011,101200019,,,,6,5,11
HND-009616,2011,101200022,,,,5,1,6
HND-009617,2011,101200023,,,,14,7,21
HND-009618,2011,101200024,,,,7,6,13
HND-009622,2011,101200030,,,,4,9,13
HND-009633,2011,101200043,,,,5,7,12
HND-009634,2011,101200047,,,,8,5,13
HND-009636,2011,101200052,,,,5,1,6
HND-009600,2011,101200006,,,,10,12,22
HND-009601,2011,101200007,,,,4,8,12
HND-009605,2011,101200011,,,,10,6,16
HND-009607,2011,101200013,,,,12,10,22
HND-009609,2011,101200015,,,,15,12,27
HND-009611,2011,101200017,,,,5,2,7
HND-009613,2011,101200019,,,,7,12,19
HND-009614,2011,101200020,,,,6,7,13
HND-009615,2011,101200021,,,,5,2,7
HND-009616,2011,101200022,,,,6,3,9
HND-009617,2011,101200023,,,,7,8,15
HND-009618,2011,101200024,,,,5,9,14
HND-009628,2011,101200037,,,,5,5,10
HND-009638,2011,101200091,,,,6,4,10
HND-009599,2011,101200005,,,,34,25,59
HND-009602,2011,101200008,,,,11,2,13
HND-009603,2011,101200009,,,,6,6,12
HND-009604,2011,101200010,,,,22,11,33
HND-009606,2011,101200012,,,,6,6,12
HND-009608,2011,101200014,,,,6,1,7
HND-009610,2011,101200016,,,,7,8,15
HND-009621,2011,101200029,,,,8,5,13
HND-009622,2011,101200030,,,,8,3,11
HND-009629,2011,101200038,,,,4,8,12
HND-009630,2011,101200039,,,,12,7,19
HND-009633,2011,101200043,,,,4,2,6
HND-009634,2011,101200047,,,,4,4,8
HND-009635,2011,101200050,,,,8,4,12
HND-009636,2011,101200052,,,,6,3,9
HND-009639,2011,101200092,,,,3,1,4
HND-009640,2011,101200093,,,,2,1,3
HND-009599,2011,101200005,,,,27,22,49
HND-009600,2011,101200006,,,,12,8,20
HND-009603,2011,101200009,,,,3,9,12
HND-009605,2011,101200011,,,,6,7,13
HND-009606,2011,101200012,,,,4,3,7
HND-009607,2011,101200013,,,,13,6,19
HND-009608,2011,101200014,,,,3,2,5
HND-009609,2011,101200015,,,,14,11,25
HND-009611,2011,101200017,,,,2,4,6
HND-009614,2011,101200020,,,,4,4,8
HND-009615,2011,101200021,,,,4,1,5
HND-009621,2011,101200029,,,,5,1,6
HND-009622,2011,101200030,,,,1,3,4
HND-009628,2011,101200037,,,,6,3,9
HND-009634,2011,101200047,,,,2,6,8
HND-009636,2011,101200052,,,,8,10,18
HND-009601,2011,101200007,,,,5,4,9
HND-009602,2011,101200008,,,,6,6,12
HND-009604,2011,101200010,,,,24,19,43
HND-009610,2011,101200016,,,,8,8,16
HND-009613,2011,101200019,,,,10,6,16
HND-009616,2011,101200022,,,,8,10,18
HND-009617,2011,101200023,,,,5,6,11
HND-009618,2011,101200024,,,,5,9,14
HND-009629,2011,101200038,,,,4,4,8
HND-009630,2011,101200039,,,,9,12,21
HND-009633,2011,101200043,,,,1,2,3
HND-009635,2011,101200050,,,,6,3,9
HND-009638,2011,101200091,,,,6,5,11
HND-009639,2011,101200092,,,,3,1,4
HND-009640,2011,101200093,,,,2,1,3
HND-009600,2011,101200006,,,,8,3,11
HND-009601,2011,101200007,,,,1,3,4
HND-009609,2011,101200015,,,,10,9,19
HND-009613,2011,101200019,,,,7,2,9
HND-009614,2011,101200020,,,,6,3,9
HND-009615,2011,101200021,,,,1,2,3
HND-009616,2011,101200022,,,,9,3,12
HND-009617,2011,101200023,,,,2,6,8
HND-009618,2011,101200024,,,,4,11,15
HND-009628,2011,101200037,,,,7,7,14
HND-009629,2011,101200038,,,,8,4,12
HND-009638,2011,101200091,,,,2,3,5
HND-009599,2011,101200005,,,,16,24,40
HND-009602,2011,101200008,,,,9,2,11
HND-009603,2011,101200009,,,,5,8,13
HND-009604,2011,101200010,,,,19,10,29
HND-009605,2011,101200011,,,,8,11,19
HND-009606,2011,101200012,,,,3,2,5
HND-009607,2011,101200013,,,,6,9,15
HND-009608,2011,101200014,,,,3,2,5
HND-009610,2011,101200016,,,,14,8,22
HND-009611,2011,101200017,,,,4,3,7
HND-009621,2011,101200029,,,,1,7,8
HND-009622,2011,101200030,,,,3,3,6
HND-009630,2011,101200039,,,,17,12,29
HND-009633,2011,101200043,,,,4,10,14
HND-009634,2011,101200047,,,,5,4,9
HND-009635,2011,101200050,,,,11,5,16
HND-009636,2011,101200052,,,,9,3,12
HND-009639,2011,101200092,,,,0,2,2
HND-009640,2011,101200093,,,,3,1,4
HND-009601,2011,101200007,,,,1,3,4
HND-009602,2011,101200008,,,,5,5,10
HND-009610,2011,101200016,,,,13,12,25
HND-009613,2011,101200019,,,,4,3,7
HND-009616,2011,101200022,,,,5,5,10
HND-009617,2011,101200023,,,,5,2,7
HND-009618,2011,101200024,,,,9,11,20
HND-009628,2011,101200037,,,,3,5,8
HND-009629,2011,101200038,,,,2,4,6
HND-009635,2011,101200050,,,,4,11,15
HND-009638,2011,101200091,,,,2,4,6
HND-009639,2011,101200092,,,,0,2,2
HND-009599,2011,101200005,,,,28,35,63
HND-009600,2011,101200006,,,,3,9,12
HND-009603,2011,101200009,,,,8,2,10
HND-009604,2011,101200010,,,,17,22,39
HND-009605,2011,101200011,,,,5,3,8
HND-009606,2011,101200012,,,,5,3,8
HND-009607,2011,101200013,,,,9,10,19
HND-009608,2011,101200014,,,,5,2,7
HND-009609,2011,101200015,,,,10,14,24
HND-009611,2011,101200017,,,,5,2,7
HND-009614,2011,101200020,,,,8,5,13
HND-009615,2011,101200021,,,,1,2,3
HND-009621,2011,101200029,,,,3,3,6
HND-009622,2011,101200030,,,,1,1,2
HND-009630,2011,101200039,,,,16,8,24
HND-009633,2011,101200043,,,,5,4,9
HND-009634,2011,101200047,,,,3,5,8
HND-009636,2011,101200052,,,,5,5,10
HND-009640,2011,101200093,,,,3,2,5
HND-009599,2011,101200005,,,,31,33,64
HND-009602,2011,101200008,,,,6,5,11
HND-009603,2011,101200009,,,,3,7,10
HND-009604,2011,101200010,,,,15,10,25
HND-009606,2011,101200012,,,,1,4,5
HND-009608,2011,101200014,,,,4,2,6
HND-009610,2011,101200016,,,,12,3,15
HND-009621,2011,101200029,,,,7,3,10
HND-009622,2011,101200030,,,,1,2,3
HND-009629,2011,101200038,,,,7,4,11
HND-009630,2011,101200039,,,,9,3,12
HND-009633,2011,101200043,,,,0,5,5
HND-009634,2011,101200047,,,,2,1,3
HND-009635,2011,101200050,,,,4,2,6
HND-009636,2011,101200052,,,,5,3,8
HND-009639,2011,101200092,,,,1,3,4
HND-009640,2011,101200093,,,,1,3,4
HND-009600,2011,101200006,,,,5,5,10
HND-009601,2011,101200007,,,,1,1,2
HND-009605,2011,101200011,,,,6,4,10
HND-009607,2011,101200013,,,,4,6,10
HND-009609,2011,101200015,,,,5,7,12
HND-009611,2011,101200017,,,,2,1,3
HND-009613,2011,101200019,,,,3,4,7
HND-009614,2011,101200020,,,,3,6,9
HND-009615,2011,101200021,,,,2,0,2
HND-009616,2011,101200022,,,,5,3,8
HND-009617,2011,101200023,,,,2,4,6
HND-009618,2011,101200024,,,,1,3,4
HND-009628,2011,101200037,,,,1,3,4
HND-009638,2011,101200091,,,,0,2,2
HND-009604,2011,101200010,,,,15,14,29
,2011,101200104,,,,1,1,2
HND-009605,2011,101200011,,,,9,9,18
HND-009623,2011,101200032,,,,60,65,125
HND-009605,2011,101200011,,,,6,13,19
HND-009623,2011,101200032,,,,47,52,99
HND-009604,2011,101200010,,,,8,9,17
HND-009623,2011,101200032,,,,29,60,89
HND-009604,2011,101200010,,,,8,8,16
HND-009623,2011,101200032,,,,16,13,29
,2011,101200104,,,,22,27,49
HND-009623,2011,101200032,,,,10,19,29
,2011,101200104,,,,1,0,1
HND-009623,2011,101200032,,,,5,11,16
HND-009682,2011,101300045,,,,7,3,10
HND-009683,2011,101300047,,,,9,4,13
,2011,101300052,,,,2,4,6
,2011,101300054,,,,16,6,22
,2011,101300055,,,,9,8,17
,2011,101300061,,,,6,7,13
HND-009691,2011,101300062,,,,9,6,15
,2011,101300063,,,,4,7,11
HND-009692,2011,101300064,,,,12,6,18
HND-009684,2011,101300048,,,,4,7,11
,2011,101300049,,,,8,13,21
HND-009685,2011,101300050,,,,7,9,16
,2011,101300051,,,,15,5,20
HND-009690,2011,101300056,,,,8,4,12
,2011,101300057,,,,12,9,21
HND-009673,2011,101300027,,,,4,3,7
HND-009674,2011,101300028,,,,3,1,4
,2011,101300032,,,,3,0,3
,2011,101300037,,,,1,1,2
,2011,101300043,,,,1,3,4
HND-009668,2011,101300019,,,,0,1,1
,2011,101300038,,,,2,1,3
,2011,101300041,,,,0,1,1
HND-009681,2011,101300042,,,,1,2,3
HND-009665,2011,101300016,,,,3,2,5
HND-009672,2011,101300024,,,,2,3,5
,2011,101300025,,,,2,5,7
HND-009673,2011,101300027,,,,10,5,15
HND-009674,2011,101300028,,,,0,4,4
,2011,101300031,,,,5,5,10
,2011,101300032,,,,4,3,7
HND-009677,2011,101300034,,,,8,6,14
HND-009681,2011,101300042,,,,3,3,6
,2011,101300043,,,,3,3,6
,2011,101300044,,,,3,6,9
HND-009668,2011,101300019,,,,5,5,10
,2011,101300033,,,,5,4,9
,2011,101300037,,,,3,3,6
,2011,101300038,,,,3,6,9
,2011,101300040,,,,10,7,17
,2011,101300041,,,,2,1,3
HND-009668,2011,101300019,,,,2,8,10
,2011,101300031,,,,5,5,10
,2011,101300032,,,,2,2,4
,2011,101300033,,,,1,4,5
HND-009677,2011,101300034,,,,2,9,11
HND-009681,2011,101300042,,,,3,3,6
,2011,101300043,,,,1,2,3
,2011,101300044,,,,4,4,8
HND-009665,2011,101300016,,,,3,8,11
HND-009672,2011,101300024,,,,8,7,15
,2011,101300025,,,,4,4,8
HND-009673,2011,101300027,,,,2,2,4
HND-009674,2011,101300028,,,,1,4,5
,2011,101300037,,,,3,3,6
,2011,101300038,,,,6,4,10
,2011,101300040,,,,3,4,7
,2011,101300041,,,,6,5,11
HND-009650,2011,101300001,,,,21,9,30
HND-009651,2011,101300002,,,,4,6,10
HND-009652,2011,101300003,,,,3,1,4
HND-009653,2011,101300004,,,,8,8,16
HND-009654,2011,101300005,,,,7,10,17
HND-009655,2011,101300006,,,,11,9,20
HND-009656,2011,101300007,,,,5,5,10
HND-009659,2011,101300010,,,,6,5,11
HND-009660,2011,101300011,,,,7,7,14
HND-009663,2011,101300014,,,,8,3,11
HND-009665,2011,101300016,,,,2,3,5
HND-009668,2011,101300019,,,,8,16,24
HND-009669,2011,101300020,,,,3,4,7
HND-009670,2011,101300021,,,,1,0,1
HND-009671,2011,101300022,,,,9,5,14
HND-009676,2011,101300030,,,,4,0,4
HND-009679,2011,101300036,,,,2,5,7
HND-009680,2011,101300039,,,,7,4,11
HND-009681,2011,101300042,,,,5,3,8
HND-009657,2011,101300008,,,,8,5,13
HND-009658,2011,101300009,,,,6,7,13
HND-009661,2011,101300012,,,,5,4,9
HND-009662,2011,101300013,,,,10,7,17
HND-009664,2011,101300015,,,,3,8,11
HND-009666,2011,101300017,,,,6,5,11
HND-009667,2011,101300018,,,,7,3,10
HND-009674,2011,101300028,,,,3,1,4
HND-009678,2011,101300035,,,,2,0,2
HND-009650,2011,101300001,,,,21,10,31
HND-009655,2011,101300006,,,,9,10,19
HND-009657,2011,101300008,,,,12,5,17
HND-009658,2011,101300009,,,,5,2,7
HND-009667,2011,101300018,,,,1,7,8
HND-009668,2011,101300019,,,,6,9,15
HND-009669,2011,101300020,,,,3,7,10
HND-009670,2011,101300021,,,,1,2,3
HND-009676,2011,101300030,,,,7,8,15
HND-009679,2011,101300036,,,,7,11,18
HND-009681,2011,101300042,,,,2,3,5
HND-009651,2011,101300002,,,,6,15,21
HND-009652,2011,101300003,,,,1,2,3
HND-009653,2011,101300004,,,,3,8,11
HND-009654,2011,101300005,,,,12,8,20
HND-009656,2011,101300007,,,,4,5,9
HND-009659,2011,101300010,,,,9,7,16
HND-009660,2011,101300011,,,,8,8,16
HND-009661,2011,101300012,,,,4,5,9
HND-009662,2011,101300013,,,,8,5,13
HND-009663,2011,101300014,,,,7,4,11
HND-009664,2011,101300015,,,,2,9,11
HND-009665,2011,101300016,,,,4,5,9
HND-009666,2011,101300017,,,,10,7,17
HND-009671,2011,101300022,,,,8,6,14
HND-009674,2011,101300028,,,,3,2,5
HND-009678,2011,101300035,,,,3,1,4
HND-009680,2011,101300039,,,,5,8,13
HND-009655,2011,101300006,,,,9,8,17
HND-009657,2011,101300008,,,,16,3,19
HND-009658,2011,101300009,,,,3,7,10
HND-009662,2011,101300013,,,,11,5,16
HND-009664,2011,101300015,,,,6,7,13
HND-009666,2011,101300017,,,,9,3,12
HND-009667,2011,101300018,,,,4,5,9
HND-009674,2011,101300028,,,,3,2,5
HND-009676,2011,101300030,,,,4,2,6
HND-009679,2011,101300036,,,,8,9,17
HND-009680,2011,101300039,,,,5,10,15
HND-009681,2011,101300042,,,,6,4,10
HND-009650,2011,101300001,,,,16,12,28
HND-009651,2011,101300002,,,,6,11,17
HND-009652,2011,101300003,,,,0,1,1
HND-009653,2011,101300004,,,,10,6,16
HND-009654,2011,101300005,,,,13,11,24
HND-009656,2011,101300007,,,,2,3,5
HND-009659,2011,101300010,,,,1,7,8
HND-009660,2011,101300011,,,,3,7,10
HND-009661,2011,101300012,,,,9,6,15
HND-009663,2011,101300014,,,,5,2,7
HND-009665,2011,101300016,,,,4,3,7
HND-009668,2011,101300019,,,,10,2,12
HND-009669,2011,101300020,,,,5,4,9
HND-009670,2011,101300021,,,,4,3,7
HND-009671,2011,101300022,,,,6,3,9
HND-009678,2011,101300035,,,,2,2,4
HND-009650,2011,101300001,,,,26,13,39
HND-009651,2011,101300002,,,,8,10,18
HND-009653,2011,101300004,,,,10,8,18
HND-009655,2011,101300006,,,,13,11,24
HND-009657,2011,101300008,,,,15,18,33
HND-009659,2011,101300010,,,,6,8,14
HND-009660,2011,101300011,,,,4,5,9
HND-009665,2011,101300016,,,,5,5,10
HND-009667,2011,101300018,,,,4,2,6
HND-009668,2011,101300019,,,,6,7,13
HND-009669,2011,101300020,,,,6,5,11
HND-009670,2011,101300021,,,,1,4,5
HND-009671,2011,101300022,,,,8,1,9
HND-009676,2011,101300030,,,,2,2,4
HND-009678,2011,101300035,,,,1,0,1
HND-009679,2011,101300036,,,,12,6,18
HND-009652,2011,101300003,,,,3,1,4
HND-009654,2011,101300005,,,,10,6,16
HND-009656,2011,101300007,,,,3,1,4
HND-009658,2011,101300009,,,,6,4,10
HND-009661,2011,101300012,,,,10,5,15
HND-009662,2011,101300013,,,,4,2,6
HND-009663,2011,101300014,,,,6,3,9
HND-009664,2011,101300015,,,,6,11,17
HND-009666,2011,101300017,,,,6,3,9
HND-009674,2011,101300028,,,,3,5,8
HND-009680,2011,101300039,,,,6,2,8
HND-009681,2011,101300042,,,,3,5,8
HND-009650,2011,101300001,,,,18,14,32
HND-009651,2011,101300002,,,,4,9,13
HND-009652,2011,101300003,,,,1,3,4
HND-009653,2011,101300004,,,,9,10,19
HND-009655,2011,101300006,,,,8,3,11
HND-009656,2011,101300007,,,,6,5,11
HND-009657,2011,101300008,,,,9,9,18
HND-009659,2011,101300010,,,,8,5,13
HND-009660,2011,101300011,,,,4,3,7
HND-009665,2011,101300016,,,,5,4,9
HND-009668,2011,101300019,,,,5,2,7
HND-009669,2011,101300020,,,,6,5,11
HND-009670,2011,101300021,,,,6,1,7
HND-009671,2011,101300022,,,,4,4,8
HND-009678,2011,101300035,,,,7,2,9
HND-009654,2011,101300005,,,,11,3,14
HND-009658,2011,101300009,,,,5,6,11
HND-009661,2011,101300012,,,,8,3,11
HND-009662,2011,101300013,,,,7,7,14
HND-009663,2011,101300014,,,,3,2,5
HND-009664,2011,101300015,,,,7,6,13
HND-009666,2011,101300017,,,,1,7,8
HND-009667,2011,101300018,,,,4,2,6
HND-009674,2011,101300028,,,,2,3,5
HND-009676,2011,101300030,,,,2,1,3
HND-009679,2011,101300036,,,,3,8,11
HND-009680,2011,101300039,,,,13,6,19
HND-009681,2011,101300042,,,,3,6,9
HND-009651,2011,101300002,,,,1,10,11
HND-009652,2011,101300003,,,,1,4,5
HND-009653,2011,101300004,,,,11,11,22
HND-009654,2011,101300005,,,,9,4,13
HND-009656,2011,101300007,,,,4,6,10
HND-009659,2011,101300010,,,,6,8,14
HND-009660,2011,101300011,,,,2,5,7
HND-009661,2011,101300012,,,,8,7,15
HND-009662,2011,101300013,,,,6,6,12
HND-009663,2011,101300014,,,,1,3,4
HND-009664,2011,101300015,,,,4,6,10
HND-009665,2011,101300016,,,,4,4,8
HND-009666,2011,101300017,,,,3,2,5
HND-009671,2011,101300022,,,,4,6,10
HND-009674,2011,101300028,,,,2,2,4
HND-009678,2011,101300035,,,,5,1,6
HND-009680,2011,101300039,,,,5,5,10
HND-009650,2011,101300001,,,,13,11,24
HND-009655,2011,101300006,,,,3,6,9
HND-009657,2011,101300008,,,,20,10,30
HND-009658,2011,101300009,,,,4,2,6
HND-009667,2011,101300018,,,,4,9,13
HND-009668,2011,101300019,,,,4,3,7
HND-009669,2011,101300020,,,,4,7,11
HND-009670,2011,101300021,,,,3,2,5
HND-009676,2011,101300030,,,,1,3,4
HND-009679,2011,101300036,,,,8,2,10
HND-009681,2011,101300042,,,,4,5,9
HND-009655,2011,101300006,,,,7,6,13
HND-009675,2011,101300029,,,,46,43,89
HND-009655,2011,101300006,,,,8,2,10
HND-009675,2011,101300029,,,,31,25,56
HND-009675,2011,101300029,,,,17,29,46
HND-009655,2011,101300006,,,,10,3,13
HND-009675,2011,101300029,,,,17,7,24
HND-009675,2011,101300029,,,,5,2,7
HND-009675,2011,101300029,,,,4,1,5
HND-009731,2011,101400072,,,,6,8,14
,2011,101400173,,,,4,5,9
,2011,101400174,,,,6,6,12
,2011,101400176,,,,7,8,15
HND-009735,2011,101400177,,,,8,4,12
,2011,101400179,,,,7,4,11
HND-009736,2011,101400181,,,,5,6,11
HND-009737,2011,101400182,,,,5,5,10
,2011,101400183,,,,9,5,14
HND-009709,2011,101400014,,,,7,3,10
,2011,101400065,,,,8,4,12
HND-009730,2011,101400068,,,,5,6,11
,2011,101400070,,,,14,16,30
,2011,101400071,,,,5,7,12
,2011,101400175,,,,7,5,12
,2011,101400178,,,,5,6,11
,2011,101400180,,,,4,4,8
HND-009738,2011,101400184,,,,4,5,9
HND-009739,2011,101400185,,,,7,6,13
HND-009740,2011,101400186,,,,5,4,9
HND-009710,2011,101400015,,,,3,2,5
HND-009713,2011,101400019,,,,2,2,4
HND-009722,2011,101400028,,,,7,2,9
HND-009727,2011,101400046,,,,0,1,1
HND-009729,2011,101400064,,,,2,1,3
HND-009709,2011,101400014,,,,3,2,5
HND-009716,2011,101400022,,,,3,1,4
HND-009718,2011,101400024,,,,3,2,5
HND-009719,2011,101400025,,,,3,1,4
HND-009721,2011,101400027,,,,4,1,5
HND-009723,2011,101400042,,,,2,2,4
HND-009725,2011,101400044,,,,3,3,6
HND-009726,2011,101400045,,,,2,3,5
HND-009728,2011,101400063,,,,7,4,11
HND-009734,2011,101400170,,,,3,3,6
,2011,101400017,,,,0,5,5
HND-009712,2011,101400018,,,,3,2,5
HND-009719,2011,101400025,,,,5,6,11
HND-009721,2011,101400027,,,,3,1,4
HND-009722,2011,101400028,,,,5,2,7
HND-009723,2011,101400042,,,,2,3,5
HND-009725,2011,101400044,,,,1,0,1
HND-009727,2011,101400046,,,,0,3,3
HND-009734,2011,101400170,,,,5,4,9
HND-009709,2011,101400014,,,,2,2,4
HND-009710,2011,101400015,,,,5,6,11
HND-009711,2011,101400016,,,,4,6,10
HND-009713,2011,101400019,,,,4,4,8
HND-009715,2011,101400021,,,,2,5,7
HND-009716,2011,101400022,,,,0,3,3
HND-009718,2011,101400024,,,,3,4,7
HND-009726,2011,101400045,,,,3,4,7
HND-009728,2011,101400063,,,,7,4,11
HND-009729,2011,101400064,,,,2,1,3
HND-009709,2011,101400014,,,,1,2,3
HND-009711,2011,101400016,,,,9,5,14
HND-009715,2011,101400021,,,,2,10,12
HND-009716,2011,101400022,,,,6,7,13
HND-009718,2011,101400024,,,,1,1,2
HND-009726,2011,101400045,,,,1,2,3
HND-009728,2011,101400063,,,,1,1,2
HND-009710,2011,101400015,,,,5,1,6
,2011,101400017,,,,8,5,13
HND-009712,2011,101400018,,,,4,3,7
HND-009713,2011,101400019,,,,1,1,2
HND-009721,2011,101400027,,,,4,2,6
HND-009722,2011,101400028,,,,4,3,7
HND-009723,2011,101400042,,,,8,5,13
HND-009725,2011,101400044,,,,3,0,3
HND-009727,2011,101400046,,,,3,5,8
HND-009696,2011,101400001,,,,10,12,22
HND-009698,2011,101400003,,,,2,2,4
HND-009699,2011,101400004,,,,13,10,23
HND-009700,2011,101400005,,,,10,1,11
HND-009701,2011,101400006,,,,18,11,29
HND-009702,2011,101400007,,,,2,5,7
HND-009707,2011,101400012,,,,1,2,3
HND-009708,2011,101400013,,,,6,6,12
HND-009709,2011,101400014,,,,8,10,18
HND-009718,2011,101400024,,,,4,2,6
HND-009719,2011,101400025,,,,5,3,8
HND-009721,2011,101400027,,,,3,2,5
HND-009723,2011,101400042,,,,5,0,5
HND-009724,2011,101400043,,,,7,3,10
HND-009725,2011,101400044,,,,3,2,5
HND-009726,2011,101400045,,,,3,5,8
HND-009733,2011,101400169,,,,3,8,11
HND-009734,2011,101400170,,,,0,1,1
HND-009697,2011,101400002,,,,14,7,21
HND-009703,2011,101400008,,,,8,16,24
HND-009704,2011,101400009,,,,4,1,5
HND-009705,2011,101400010,,,,8,3,11
HND-009706,2011,101400011,,,,11,16,27
HND-009713,2011,101400019,,,,8,8,16
HND-009714,2011,101400020,,,,8,7,15
HND-009720,2011,101400026,,,,2,3,5
,2011,101400029,,,,3,1,4
HND-009727,2011,101400046,,,,9,4,13
HND-009729,2011,101400064,,,,1,1,2
HND-009696,2011,101400001,,,,7,7,14
HND-009701,2011,101400006,,,,19,4,23
HND-009704,2011,101400009,,,,1,3,4
HND-009705,2011,101400010,,,,7,7,14
HND-009706,2011,101400011,,,,13,16,29
HND-009707,2011,101400012,,,,6,1,7
HND-009709,2011,101400014,,,,7,6,13
HND-009714,2011,101400020,,,,7,6,13
HND-009718,2011,101400024,,,,3,3,6
HND-009720,2011,101400026,,,,1,0,1
HND-009726,2011,101400045,,,,2,2,4
HND-009697,2011,101400002,,,,19,12,31
HND-009698,2011,101400003,,,,1,1,2
HND-009699,2011,101400004,,,,10,6,16
HND-009700,2011,101400005,,,,3,2,5
HND-009702,2011,101400007,,,,4,6,10
HND-009703,2011,101400008,,,,15,5,20
HND-009708,2011,101400013,,,,3,4,7
HND-009713,2011,101400019,,,,2,4,6
HND-009719,2011,101400025,,,,10,13,23
HND-009721,2011,101400027,,,,3,7,10
,2011,101400029,,,,5,3,8
HND-009723,2011,101400042,,,,4,5,9
HND-009724,2011,101400043,,,,4,1,5
HND-009725,2011,101400044,,,,0,1,1
HND-009727,2011,101400046,,,,3,8,11
HND-009733,2011,101400169,,,,3,1,4
HND-009734,2011,101400170,,,,1,1,2
HND-009697,2011,101400002,,,,12,15,27
HND-009701,2011,101400006,,,,11,11,22
HND-009703,2011,101400008,,,,8,10,18
HND-009704,2011,101400009,,,,2,2,4
HND-009705,2011,101400010,,,,11,5,16
HND-009706,2011,101400011,,,,8,6,14
HND-009713,2011,101400019,,,,2,5,7
HND-009714,2011,101400020,,,,8,2,10
HND-009720,2011,101400026,,,,1,2,3
,2011,101400029,,,,3,2,5
HND-009723,2011,101400042,,,,6,12,18
HND-009724,2011,101400043,,,,0,2,2
HND-009725,2011,101400044,,,,2,2,4
HND-009726,2011,101400045,,,,3,2,5
HND-009729,2011,101400064,,,,3,3,6
HND-009696,2011,101400001,,,,5,6,11
HND-009698,2011,101400003,,,,1,2,3
HND-009699,2011,101400004,,,,9,16,25
HND-009700,2011,101400005,,,,2,1,3
HND-009702,2011,101400007,,,,3,4,7
HND-009707,2011,101400012,,,,3,2,5
HND-009708,2011,101400013,,,,2,5,7
HND-009709,2011,101400014,,,,8,6,14
HND-009718,2011,101400024,,,,0,1,1
HND-009719,2011,101400025,,,,6,6,12
HND-009721,2011,101400027,,,,5,7,12
HND-009727,2011,101400046,,,,6,9,15
HND-009733,2011,101400169,,,,3,3,6
HND-009734,2011,101400170,,,,0,1,1
HND-009696,2011,101400001,,,,4,7,11
HND-009699,2011,101400004,,,,8,8,16
HND-009701,2011,101400006,,,,8,2,10
HND-009705,2011,101400010,,,,9,11,20
HND-009706,2011,101400011,,,,9,7,16
HND-009707,2011,101400012,,,,4,4,8
HND-009708,2011,101400013,,,,6,3,9
HND-009709,2011,101400014,,,,8,7,15
HND-009714,2011,101400020,,,,3,3,6
HND-009718,2011,101400024,,,,1,2,3
HND-009719,2011,101400025,,,,6,4,10
HND-009720,2011,101400026,,,,5,4,9
HND-009721,2011,101400027,,,,2,2,4
HND-009697,2011,101400002,,,,14,19,33
HND-009698,2011,101400003,,,,1,2,3
HND-009700,2011,101400005,,,,2,3,5
HND-009702,2011,101400007,,,,4,4,8
HND-009703,2011,101400008,,,,5,7,12
HND-009704,2011,101400009,,,,2,6,8
HND-009713,2011,101400019,,,,0,2,2
,2011,101400029,,,,8,7,15
HND-009723,2011,101400042,,,,7,7,14
HND-009724,2011,101400043,,,,0,1,1
HND-009725,2011,101400044,,,,1,7,8
HND-009726,2011,101400045,,,,2,1,3
HND-009727,2011,101400046,,,,8,6,14
HND-009729,2011,101400064,,,,4,4,8
HND-009733,2011,101400169,,,,2,5,7
HND-009734,2011,101400170,,,,1,3,4
HND-009696,2011,101400001,,,,1,6,7
HND-009698,2011,101400003,,,,0,3,3
HND-009699,2011,101400004,,,,3,5,8
HND-009701,2011,101400006,,,,12,5,17
HND-009702,2011,101400007,,,,6,1,7
HND-009707,2011,101400012,,,,3,1,4
HND-009708,2011,101400013,,,,4,7,11
HND-009709,2011,101400014,,,,0,1,1
HND-009718,2011,101400024,,,,1,2,3
HND-009719,2011,101400025,,,,2,2,4
HND-009721,2011,101400027,,,,1,1,2
HND-009727,2011,101400046,,,,4,3,7
HND-009734,2011,101400170,,,,1,2,3
HND-009697,2011,101400002,,,,14,15,29
HND-009700,2011,101400005,,,,4,5,9
HND-009703,2011,101400008,,,,7,6,13
HND-009704,2011,101400009,,,,3,1,4
HND-009705,2011,101400010,,,,4,4,8
HND-009706,2011,101400011,,,,4,14,18
HND-009713,2011,101400019,,,,5,2,7
HND-009714,2011,101400020,,,,0,2,2
HND-009720,2011,101400026,,,,1,1,2
,2011,101400029,,,,0,2,2
HND-009723,2011,101400042,,,,5,5,10
HND-009724,2011,101400043,,,,2,0,2
HND-009725,2011,101400044,,,,5,2,7
HND-009726,2011,101400045,,,,1,1,2
HND-009729,2011,101400064,,,,5,4,9
HND-009733,2011,101400169,,,,3,2,5
HND-009697,2011,101400002,,,,17,23,40
HND-009698,2011,101400003,,,,2,1,3
HND-009699,2011,101400004,,,,6,14,20
HND-009700,2011,101400005,,,,5,6,11
HND-009703,2011,101400008,,,,1,5,6
HND-009708,2011,101400013,,,,7,2,9
HND-009713,2011,101400019,,,,3,1,4
HND-009719,2011,101400025,,,,8,3,11
HND-009723,2011,101400042,,,,5,3,8
HND-009725,2011,101400044,,,,2,3,5
HND-009727,2011,101400046,,,,0,2,2
HND-009734,2011,101400170,,,,4,0,4
HND-009696,2011,101400001,,,,0,2,2
HND-009701,2011,101400006,,,,4,2,6
HND-009704,2011,101400009,,,,1,3,4
HND-009705,2011,101400010,,,,4,4,8
HND-009706,2011,101400011,,,,5,8,13
HND-009707,2011,101400012,,,,3,7,10
HND-009709,2011,101400014,,,,5,6,11
HND-009720,2011,101400026,,,,5,2,7
HND-009726,2011,101400045,,,,2,2,4
HND-009729,2011,101400064,,,,1,1,2
HND-009701,2011,101400006,,,,7,8,15
HND-009705,2011,101400010,,,,6,6,12
HND-009717,2011,101400023,,,,25,21,46
HND-009701,2011,101400006,,,,7,7,14
HND-009705,2011,101400010,,,,3,5,8
HND-009717,2011,101400023,,,,22,13,35
HND-009701,2011,101400006,,,,4,3,7
HND-009705,2011,101400010,,,,6,2,8
HND-009717,2011,101400023,,,,13,19,32
HND-009717,2011,101400023,,,,22,16,38
HND-009717,2011,101400023,,,,21,20,41
HND-009717,2011,101400023,,,,15,18,33
,2011,101500030,,,,5,5,10
,2011,101500031,,,,3,5,8
HND-009766,2011,101500032,,,,10,3,13
,2011,101500056,,,,5,5,10
HND-009767,2011,101500057,,,,16,8,24
,2011,101500028,,,,8,8,16
HND-009765,2011,101500029,,,,3,8,11
HND-009768,2011,101500058,,,,3,4,7
HND-009756,2011,101500015,,,,8,6,14
HND-009756,2011,101500015,,,,14,14,28
HND-009757,2011,101500016,,,,6,6,12
HND-009760,2011,101500019,,,,7,5,12
HND-009758,2011,101500017,,,,1,4,5
,2011,101500020,,,,6,3,9
HND-009761,2011,101500021,,,,7,5,12
HND-009762,2011,101500022,,,,8,9,17
,2011,101500023,,,,8,3,11
HND-009756,2011,101500015,,,,14,10,24
HND-009758,2011,101500017,,,,0,4,4
HND-009760,2011,101500019,,,,9,4,13
HND-009762,2011,101500022,,,,6,7,13
,2011,101500023,,,,5,5,10
HND-009757,2011,101500016,,,,7,8,15
,2011,101500020,,,,3,3,6
HND-009761,2011,101500021,,,,5,2,7
HND-009743,2011,101500001,,,,6,6,12
HND-009747,2011,101500006,,,,3,3,6
HND-009750,2011,101500009,,,,6,0,6
HND-009751,2011,101500010,,,,2,0,2
HND-009752,2011,101500011,,,,6,3,9
HND-009758,2011,101500017,,,,1,2,3
HND-009744,2011,101500002,,,,14,16,30
,2011,101500003,,,,5,6,11
HND-009745,2011,101500004,,,,7,4,11
HND-009746,2011,101500005,,,,23,7,30
HND-009748,2011,101500007,,,,5,7,12
HND-009749,2011,101500008,,,,2,1,3
HND-009753,2011,101500012,,,,2,3,5
HND-009754,2011,101500013,,,,2,2,4
HND-009755,2011,101500014,,,,4,5,9
HND-009759,2011,101500018,,,,0,6,6
HND-009744,2011,101500002,,,,12,15,27
HND-009749,2011,101500008,,,,5,3,8
HND-009750,2011,101500009,,,,9,8,17
HND-009759,2011,101500018,,,,1,1,2
HND-009743,2011,101500001,,,,10,5,15
,2011,101500003,,,,6,5,11
HND-009745,2011,101500004,,,,9,8,17
HND-009746,2011,101500005,,,,8,13,21
HND-009747,2011,101500006,,,,3,5,8
HND-009748,2011,101500007,,,,6,8,14
HND-009751,2011,101500010,,,,2,1,3
HND-009752,2011,101500011,,,,5,4,9
HND-009753,2011,101500012,,,,3,7,10
HND-009754,2011,101500013,,,,1,1,2
HND-009755,2011,101500014,,,,3,2,5
HND-009758,2011,101500017,,,,1,2,3
HND-009764,2011,101500026,,,,1,0,1
HND-009744,2011,101500002,,,,25,18,43
,2011,101500003,,,,8,1,9
HND-009746,2011,101500005,,,,14,12,26
HND-009748,2011,101500007,,,,5,4,9
HND-009749,2011,101500008,,,,3,4,7
HND-009753,2011,101500012,,,,2,3,5
HND-009755,2011,101500014,,,,7,5,12
HND-009759,2011,101500018,,,,5,9,14
HND-009764,2011,101500026,,,,4,1,5
HND-009743,2011,101500001,,,,6,7,13
HND-009745,2011,101500004,,,,5,7,12
HND-009747,2011,101500006,,,,1,3,4
HND-009750,2011,101500009,,,,5,5,10
HND-009751,2011,101500010,,,,0,1,1
HND-009752,2011,101500011,,,,5,7,12
HND-009758,2011,101500017,,,,3,1,4
HND-009743,2011,101500001,,,,6,14,20
HND-009744,2011,101500002,,,,15,16,31
HND-009747,2011,101500006,,,,2,1,3
HND-009749,2011,101500008,,,,5,2,7
HND-009750,2011,101500009,,,,4,5,9
HND-009758,2011,101500017,,,,3,4,7
,2011,101500003,,,,3,9,12
HND-009745,2011,101500004,,,,5,3,8
HND-009746,2011,101500005,,,,12,8,20
HND-009748,2011,101500007,,,,4,6,10
HND-009751,2011,101500010,,,,4,3,7
HND-009752,2011,101500011,,,,2,11,13
HND-009753,2011,101500012,,,,3,0,3
HND-009754,2011,101500013,,,,4,2,6
HND-009755,2011,101500014,,,,2,2,4
HND-009764,2011,101500026,,,,1,0,1
HND-009744,2011,101500002,,,,13,19,32
,2011,101500003,,,,1,7,8
HND-009745,2011,101500004,,,,2,8,10
HND-009746,2011,101500005,,,,7,15,22
HND-009748,2011,101500007,,,,8,2,10
HND-009749,2011,101500008,,,,4,5,9
HND-009753,2011,101500012,,,,2,4,6
HND-009754,2011,101500013,,,,2,2,4
HND-009755,2011,101500014,,,,4,2,6
HND-009759,2011,101500018,,,,1,9,10
HND-009764,2011,101500026,,,,3,1,4
HND-009743,2011,101500001,,,,7,7,14
HND-009747,2011,101500006,,,,4,0,4
HND-009750,2011,101500009,,,,6,5,11
HND-009751,2011,101500010,,,,1,0,1
HND-009752,2011,101500011,,,,7,4,11
HND-009758,2011,101500017,,,,4,4,8
HND-009744,2011,101500002,,,,16,12,28
HND-009749,2011,101500008,,,,5,3,8
HND-009750,2011,101500009,,,,4,5,9
HND-009743,2011,101500001,,,,8,5,13
,2011,101500003,,,,4,5,9
HND-009745,2011,101500004,,,,3,2,5
HND-009746,2011,101500005,,,,7,6,13
HND-009747,2011,101500006,,,,1,1,2
HND-009748,2011,101500007,,,,6,3,9
HND-009752,2011,101500011,,,,6,4,10
HND-009753,2011,101500012,,,,5,2,7
HND-009754,2011,101500013,,,,0,3,3
HND-009758,2011,101500017,,,,2,2,4
HND-009764,2011,101500026,,,,1,0,1
HND-009763,2011,101500025,,,,50,45,95
HND-009763,2011,101500025,,,,22,24,46
HND-009763,2011,101500025,,,,20,36,56
HND-009763,2011,101500025,,,,10,17,27
HND-009763,2011,101500025,,,,8,7,15
HND-009763,2011,101500025,,,,8,20,28
,2011,101600079,,,,6,7,13
HND-009844,2011,101600087,,,,14,15,29
,2011,101600195,,,,3,4,7
,2011,101600200,,,,7,2,9
HND-009850,2011,101600186,,,,15,11,26
,2011,101600189,,,,2,8,10
,2011,101600194,,,,2,9,11
,2011,101600196,,,,12,6,18
HND-009851,2011,101600199,,,,11,9,20
HND-009818,2011,101600051,,,,2,0,2
HND-009829,2011,101600063,,,,0,2,2
HND-009836,2011,101600070,,,,1,2,3
HND-009837,2011,101600073,,,,4,1,5
,2011,101600124,,,,1,1,2
HND-009846,2011,101600125,,,,4,2,6
,2011,101600184,,,,0,3,3
HND-009804,2011,101600035,,,,4,6,10
HND-009805,2011,101600038,,,,5,7,12
HND-009808,2011,101600041,,,,15,10,25
HND-009809,2011,101600042,,,,1,1,2
HND-009810,2011,101600043,,,,3,3,6
HND-009811,2011,101600044,,,,3,3,6
HND-009812,2011,101600045,,,,7,7,14
HND-009818,2011,101600051,,,,1,0,1
HND-009819,2011,101600052,,,,3,7,10
HND-009820,2011,101600053,,,,5,7,12
HND-009826,2011,101600060,,,,5,0,5
HND-009827,2011,101600061,,,,10,9,19
HND-009832,2011,101600066,,,,4,7,11
HND-009836,2011,101600070,,,,4,4,8
HND-009846,2011,101600125,,,,4,6,10
,2011,101600185,,,,5,1,6
,2011,101600197,,,,6,4,10
HND-009803,2011,101600034,,,,5,4,9
HND-009807,2011,101600040,,,,7,1,8
HND-009813,2011,101600046,,,,1,6,7
HND-009815,2011,101600048,,,,0,5,5
HND-009817,2011,101600050,,,,7,3,10
HND-009822,2011,101600056,,,,3,1,4
HND-009825,2011,101600059,,,,6,2,8
HND-009828,2011,101600062,,,,5,2,7
HND-009829,2011,101600063,,,,8,4,12
HND-009830,2011,101600064,,,,4,4,8
HND-009831,2011,101600065,,,,12,15,27
HND-009833,2011,101600067,,,,1,0,1
HND-009834,2011,101600068,,,,4,4,8
HND-009837,2011,101600073,,,,2,3,5
HND-009841,2011,101600082,,,,6,5,11
HND-009845,2011,101600123,,,,4,1,5
,2011,101600124,,,,3,7,10
HND-009847,2011,101600160,,,,5,9,14
,2011,101600163,,,,3,2,5
,2011,101600184,,,,3,6,9
HND-009803,2011,101600034,,,,3,1,4
HND-009804,2011,101600035,,,,2,3,5
HND-009807,2011,101600040,,,,6,5,11
HND-009813,2011,101600046,,,,5,14,19
HND-009817,2011,101600050,,,,6,6,12
HND-009818,2011,101600051,,,,2,4,6
HND-009819,2011,101600052,,,,5,2,7
HND-009822,2011,101600056,,,,5,2,7
HND-009828,2011,101600062,,,,4,6,10
HND-009829,2011,101600063,,,,7,6,13
HND-009830,2011,101600064,,,,3,4,7
HND-009831,2011,101600065,,,,25,10,35
HND-009833,2011,101600067,,,,3,5,8
HND-009834,2011,101600068,,,,3,6,9
HND-009837,2011,101600073,,,,3,4,7
HND-009841,2011,101600082,,,,2,2,4
HND-009845,2011,101600123,,,,4,1,5
,2011,101600124,,,,1,3,4
HND-009847,2011,101600160,,,,4,6,10
,2011,101600163,,,,4,0,4
,2011,101600184,,,,6,5,11
,2011,101600185,,,,10,9,19
,2011,101600197,,,,2,3,5
HND-009805,2011,101600038,,,,2,6,8
HND-009808,2011,101600041,,,,14,12,26
HND-009809,2011,101600042,,,,12,3,15
HND-009810,2011,101600043,,,,4,2,6
HND-009811,2011,101600044,,,,9,12,21
HND-009812,2011,101600045,,,,7,5,12
HND-009815,2011,101600048,,,,9,7,16
HND-009820,2011,101600053,,,,8,4,12
HND-009825,2011,101600059,,,,4,4,8
HND-009826,2011,101600060,,,,4,2,6
HND-009827,2011,101600061,,,,6,8,14
HND-009832,2011,101600066,,,,4,10,14
HND-009836,2011,101600070,,,,1,2,3
HND-009846,2011,101600125,,,,7,1,8
HND-009773,2011,101600001,,,,9,9,18
HND-009778,2011,101600006,,,,4,6,10
HND-009781,2011,101600009,,,,13,9,22
HND-009787,2011,101600015,,,,3,1,4
,2011,101600018,,,,8,7,15
HND-009790,2011,101600019,,,,2,4,6
HND-009793,2011,101600022,,,,2,6,8
,2011,101600024,,,,3,3,6
HND-009797,2011,101600027,,,,11,7,18
HND-009802,2011,101600033,,,,1,4,5
HND-009804,2011,101600035,,,,6,6,12
HND-009805,2011,101600038,,,,1,7,8
HND-009806,2011,101600039,,,,11,14,25
HND-009810,2011,101600043,,,,6,3,9
HND-009817,2011,101600050,,,,3,6,9
HND-009821,2011,101600055,,,,5,3,8
HND-009823,2011,101600057,,,,9,8,17
HND-009824,2011,101600058,,,,2,1,3
HND-009835,2011,101600069,,,,8,14,22
HND-009841,2011,101600082,,,,4,2,6
HND-009842,2011,101600083,,,,5,6,11
HND-009843,2011,101600084,,,,3,4,7
HND-009848,2011,101600165,,,,6,0,6
HND-009849,2011,101600166,,,,5,5,10
HND-009774,2011,101600002,,,,20,20,40
HND-009775,2011,101600003,,,,3,5,8
HND-009776,2011,101600004,,,,5,8,13
HND-009777,2011,101600005,,,,15,5,20
HND-009779,2011,101600007,,,,10,8,18
HND-009780,2011,101600008,,,,7,8,15
HND-009782,2011,101600010,,,,15,9,24
HND-009783,2011,101600011,,,,20,19,39
HND-009784,2011,101600012,,,,7,6,13
HND-009785,2011,101600013,,,,10,26,36
HND-009786,2011,101600014,,,,6,4,10
HND-009788,2011,101600016,,,,4,6,10
HND-009791,2011,101600020,,,,3,1,4
HND-009792,2011,101600021,,,,9,2,11
HND-009798,2011,101600028,,,,3,5,8
HND-009799,2011,101600029,,,,5,8,13
HND-009800,2011,101600030,,,,16,8,24
HND-009801,2011,101600032,,,,4,6,10
HND-009803,2011,101600034,,,,1,2,3
HND-009816,2011,101600049,,,,5,6,11
HND-009818,2011,101600051,,,,2,2,4
HND-009822,2011,101600056,,,,9,0,9
HND-009825,2011,101600059,,,,3,2,5
HND-009826,2011,101600060,,,,5,2,7
HND-009827,2011,101600061,,,,10,5,15
HND-009839,2011,101600080,,,,2,2,4
HND-009840,2011,101600081,,,,3,6,9
HND-009845,2011,101600123,,,,2,6,8
HND-009774,2011,101600002,,,,34,24,58
HND-009777,2011,101600005,,,,7,9,16
HND-009780,2011,101600008,,,,19,10,29
HND-009781,2011,101600009,,,,4,7,11
HND-009784,2011,101600012,,,,12,4,16
HND-009785,2011,101600013,,,,16,21,37
HND-009786,2011,101600014,,,,7,6,13
HND-009787,2011,101600015,,,,5,6,11
,2011,101600018,,,,4,5,9
HND-009791,2011,101600020,,,,5,3,8
HND-009792,2011,101600021,,,,3,3,6
HND-009793,2011,101600022,,,,5,1,6
,2011,101600024,,,,4,6,10
HND-009799,2011,101600029,,,,7,5,12
HND-009800,2011,101600030,,,,5,3,8
HND-009801,2011,101600032,,,,4,8,12
HND-009802,2011,101600033,,,,0,3,3
HND-009803,2011,101600034,,,,1,4,5
HND-009804,2011,101600035,,,,4,5,9
HND-009816,2011,101600049,,,,11,7,18
HND-009817,2011,101600050,,,,7,5,12
HND-009818,2011,101600051,,,,7,3,10
HND-009822,2011,101600056,,,,3,6,9
HND-009839,2011,101600080,,,,1,1,2
HND-009840,2011,101600081,,,,7,5,12
HND-009841,2011,101600082,,,,0,2,2
HND-009842,2011,101600083,,,,4,0,4
HND-009843,2011,101600084,,,,1,8,9
HND-009845,2011,101600123,,,,4,3,7
HND-009773,2011,101600001,,,,13,6,19
HND-009775,2011,101600003,,,,7,4,11
HND-009776,2011,101600004,,,,7,1,8
HND-009778,2011,101600006,,,,5,6,11
HND-009779,2011,101600007,,,,12,5,17
HND-009782,2011,101600010,,,,16,13,29
HND-009783,2011,101600011,,,,12,18,30
HND-009788,2011,101600016,,,,5,6,11
HND-009790,2011,101600019,,,,6,6,12
HND-009797,2011,101600027,,,,9,6,15
HND-009798,2011,101600028,,,,9,2,11
HND-009805,2011,101600038,,,,7,7,14
HND-009806,2011,101600039,,,,7,5,12
HND-009810,2011,101600043,,,,5,1,6
HND-009821,2011,101600055,,,,6,7,13
HND-009823,2011,101600057,,,,0,3,3
HND-009824,2011,101600058,,,,2,1,3
HND-009825,2011,101600059,,,,5,6,11
HND-009826,2011,101600060,,,,3,4,7
HND-009827,2011,101600061,,,,6,1,7
HND-009835,2011,101600069,,,,10,15,25
HND-009848,2011,101600165,,,,4,2,6
HND-009849,2011,101600166,,,,6,1,7
HND-009774,2011,101600002,,,,31,30,61
HND-009775,2011,101600003,,,,5,12,17
HND-009776,2011,101600004,,,,14,8,22
HND-009777,2011,101600005,,,,10,10,20
HND-009779,2011,101600007,,,,9,3,12
HND-009780,2011,101600008,,,,15,13,28
HND-009782,2011,101600010,,,,22,16,38
HND-009783,2011,101600011,,,,17,16,33
HND-009784,2011,101600012,,,,9,7,16
HND-009785,2011,101600013,,,,19,17,36
HND-009786,2011,101600014,,,,8,5,13
HND-009787,2011,101600015,,,,9,13,22
HND-009788,2011,101600016,,,,13,4,17
HND-009791,2011,101600020,,,,3,2,5
HND-009792,2011,101600021,,,,6,5,11
HND-009798,2011,101600028,,,,1,2,3
HND-009799,2011,101600029,,,,13,11,24
HND-009800,2011,101600030,,,,13,7,20
HND-009801,2011,101600032,,,,9,8,17
HND-009803,2011,101600034,,,,2,5,7
HND-009816,2011,101600049,,,,3,4,7
HND-009818,2011,101600051,,,,3,2,5
HND-009822,2011,101600056,,,,2,9,11
HND-009825,2011,101600059,,,,3,4,7
HND-009826,2011,101600060,,,,1,9,10
HND-009839,2011,101600080,,,,1,0,1
HND-009840,2011,101600081,,,,7,2,9
HND-009845,2011,101600123,,,,6,5,11
HND-009773,2011,101600001,,,,5,8,13
HND-009778,2011,101600006,,,,21,20,41
HND-009781,2011,101600009,,,,7,3,10
,2011,101600018,,,,11,13,24
HND-009790,2011,101600019,,,,3,6,9
HND-009793,2011,101600022,,,,4,2,6
,2011,101600024,,,,2,1,3
HND-009797,2011,101600027,,,,14,15,29
HND-009802,2011,101600033,,,,3,1,4
HND-009804,2011,101600035,,,,8,5,13
HND-009805,2011,101600038,,,,1,4,5
HND-009806,2011,101600039,,,,10,6,16
HND-009810,2011,101600043,,,,6,2,8
HND-009817,2011,101600050,,,,2,3,5
HND-009821,2011,101600055,,,,3,3,6
HND-009823,2011,101600057,,,,5,2,7
HND-009824,2011,101600058,,,,4,1,5
HND-009835,2011,101600069,,,,13,8,21
HND-009841,2011,101600082,,,,2,5,7
HND-009842,2011,101600083,,,,8,9,17
HND-009843,2011,101600084,,,,4,7,11
HND-009848,2011,101600165,,,,4,1,5
HND-009849,2011,101600166,,,,5,5,10
HND-009774,2011,101600002,,,,19,32,51
HND-009780,2011,101600008,,,,6,7,13
HND-009781,2011,101600009,,,,10,6,16
HND-009785,2011,101600013,,,,11,14,25
HND-009787,2011,101600015,,,,6,9,15
,2011,101600018,,,,12,5,17
HND-009791,2011,101600020,,,,8,7,15
HND-009792,2011,101600021,,,,3,5,8
HND-009793,2011,101600022,,,,8,10,18
,2011,101600024,,,,1,5,6
HND-009801,2011,101600032,,,,1,6,7
HND-009802,2011,101600033,,,,1,2,3
HND-009803,2011,101600034,,,,1,1,2
HND-009804,2011,101600035,,,,6,7,13
HND-009805,2011,101600038,,,,7,3,10
HND-009816,2011,101600049,,,,4,5,9
HND-009817,2011,101600050,,,,4,6,10
HND-009818,2011,101600051,,,,2,3,5
HND-009822,2011,101600056,,,,11,10,21
HND-009823,2011,101600057,,,,6,5,11
HND-009835,2011,101600069,,,,11,8,19
HND-009839,2011,101600080,,,,1,0,1
HND-009840,2011,101600081,,,,1,2,3
HND-009841,2011,101600082,,,,4,3,7
HND-009842,2011,101600083,,,,1,3,4
HND-009843,2011,101600084,,,,6,1,7
HND-009845,2011,101600123,,,,2,6,8
HND-009849,2011,101600166,,,,9,0,9
HND-009773,2011,101600001,,,,5,6,11
HND-009775,2011,101600003,,,,4,7,11
HND-009776,2011,101600004,,,,9,7,16
HND-009777,2011,101600005,,,,8,9,17
HND-009778,2011,101600006,,,,21,18,39
HND-009779,2011,101600007,,,,6,6,12
HND-009782,2011,101600010,,,,13,13,26
HND-009783,2011,101600011,,,,13,19,32
HND-009784,2011,101600012,,,,2,8,10
HND-009786,2011,101600014,,,,2,1,3
HND-009788,2011,101600016,,,,6,5,11
HND-009790,2011,101600019,,,,5,7,12
HND-009797,2011,101600027,,,,6,9,15
HND-009798,2011,101600028,,,,5,6,11
HND-009799,2011,101600029,,,,6,3,9
HND-009800,2011,101600030,,,,4,4,8
HND-009806,2011,101600039,,,,12,8,20
HND-009810,2011,101600043,,,,5,2,7
HND-009821,2011,101600055,,,,7,6,13
HND-009824,2011,101600058,,,,1,3,4
HND-009825,2011,101600059,,,,7,2,9
HND-009826,2011,101600060,,,,2,3,5
HND-009848,2011,101600165,,,,2,4,6
HND-009773,2011,101600001,,,,8,9,17
HND-009774,2011,101600002,,,,28,21,49
HND-009778,2011,101600006,,,,18,18,36
HND-009781,2011,101600009,,,,7,12,19
HND-009785,2011,101600013,,,,16,23,39
HND-009787,2011,101600015,,,,3,4,7
,2011,101600018,,,,15,5,20
HND-009790,2011,101600019,,,,3,2,5
HND-009791,2011,101600020,,,,0,2,2
HND-009792,2011,101600021,,,,2,7,9
HND-009793,2011,101600022,,,,3,7,10
,2011,101600024,,,,0,2,2
HND-009797,2011,101600027,,,,10,4,14
HND-009801,2011,101600032,,,,8,3,11
HND-009802,2011,101600033,,,,1,2,3
HND-009803,2011,101600034,,,,3,4,7
HND-009804,2011,101600035,,,,7,5,12
HND-009805,2011,101600038,,,,2,1,3
HND-009810,2011,101600043,,,,5,5,10
HND-009817,2011,101600050,,,,5,7,12
HND-009818,2011,101600051,,,,2,4,6
HND-009821,2011,101600055,,,,2,1,3
HND-009823,2011,101600057,,,,5,5,10
HND-009835,2011,101600069,,,,9,5,14
HND-009841,2011,101600082,,,,4,8,12
HND-009842,2011,101600083,,,,5,6,11
HND-009843,2011,101600084,,,,5,6,11
HND-009848,2011,101600165,,,,2,4,6
HND-009849,2011,101600166,,,,3,5,8
HND-009775,2011,101600003,,,,9,7,16
HND-009776,2011,101600004,,,,5,9,14
HND-009777,2011,101600005,,,,21,9,30
HND-009779,2011,101600007,,,,6,9,15
HND-009780,2011,101600008,,,,8,11,19
HND-009782,2011,101600010,,,,18,12,30
HND-009783,2011,101600011,,,,14,15,29
HND-009784,2011,101600012,,,,5,5,10
HND-009786,2011,101600014,,,,3,1,4
HND-009788,2011,101600016,,,,7,10,17
HND-009798,2011,101600028,,,,2,4,6
HND-009799,2011,101600029,,,,16,9,25
HND-009800,2011,101600030,,,,4,8,12
HND-009806,2011,101600039,,,,7,5,12
HND-009816,2011,101600049,,,,9,4,13
HND-009822,2011,101600056,,,,2,3,5
HND-009824,2011,101600058,,,,2,2,4
HND-009825,2011,101600059,,,,6,1,7
HND-009826,2011,101600060,,,,4,4,8
HND-009839,2011,101600080,,,,1,0,1
HND-009840,2011,101600081,,,,7,5,12
HND-009845,2011,101600123,,,,4,4,8
HND-009773,2011,101600001,,,,6,10,16
HND-009775,2011,101600003,,,,4,6,10
HND-009776,2011,101600004,,,,5,4,9
HND-009778,2011,101600006,,,,16,17,33
HND-009779,2011,101600007,,,,7,6,13
HND-009782,2011,101600010,,,,12,12,24
HND-009783,2011,101600011,,,,12,13,25
HND-009788,2011,101600016,,,,5,0,5
HND-009790,2011,101600019,,,,3,2,5
HND-009797,2011,101600027,,,,7,9,16
HND-009798,2011,101600028,,,,1,4,5
HND-009805,2011,101600038,,,,2,3,5
HND-009806,2011,101600039,,,,5,9,14
HND-009810,2011,101600043,,,,2,5,7
HND-009821,2011,101600055,,,,4,2,6
HND-009823,2011,101600057,,,,1,3,4
HND-009824,2011,101600058,,,,2,0,2
HND-009825,2011,101600059,,,,1,5,6
HND-009826,2011,101600060,,,,4,3,7
HND-009835,2011,101600069,,,,7,9,16
HND-009848,2011,101600165,,,,2,2,4
HND-009849,2011,101600166,,,,1,3,4
HND-009774,2011,101600002,,,,27,27,54
HND-009777,2011,101600005,,,,7,7,14
HND-009780,2011,101600008,,,,8,7,15
HND-009781,2011,101600009,,,,9,10,19
HND-009784,2011,101600012,,,,5,2,7
HND-009785,2011,101600013,,,,10,9,19
HND-009787,2011,101600015,,,,5,3,8
,2011,101600018,,,,8,8,16
HND-009792,2011,101600021,,,,6,2,8
HND-009793,2011,101600022,,,,7,4,11
HND-009799,2011,101600029,,,,3,7,10
HND-009800,2011,101600030,,,,2,7,9
HND-009801,2011,101600032,,,,7,2,9
HND-009802,2011,101600033,,,,1,1,2
HND-009803,2011,101600034,,,,3,3,6
HND-009804,2011,101600035,,,,6,6,12
HND-009816,2011,101600049,,,,7,1,8
HND-009817,2011,101600050,,,,6,5,11
HND-009818,2011,101600051,,,,0,2,2
HND-009822,2011,101600056,,,,5,8,13
HND-009839,2011,101600080,,,,1,0,1
HND-009840,2011,101600081,,,,4,1,5
HND-009841,2011,101600082,,,,2,4,6
HND-009842,2011,101600083,,,,2,2,4
HND-009843,2011,101600084,,,,5,3,8
HND-009845,2011,101600123,,,,3,3,6
HND-009773,2011,101600001,,,,8,6,14
HND-009778,2011,101600006,,,,9,7,16
HND-009814,2011,101600047,,,,82,74,156
HND-009776,2011,101600004,,,,8,9,17
HND-009783,2011,101600011,,,,8,6,14
HND-009773,2011,101600001,,,,3,5,8
HND-009776,2011,101600004,,,,5,5,10
HND-009778,2011,101600006,,,,6,0,6
HND-009783,2011,101600011,,,,11,3,14
HND-009814,2011,101600047,,,,55,62,117
HND-009814,2011,101600047,,,,58,46,104
HND-009773,2011,101600001,,,,9,5,14
HND-009776,2011,101600004,,,,6,12,18
HND-009778,2011,101600006,,,,3,5,8
HND-009783,2011,101600011,,,,9,5,14
HND-009814,2011,101600047,,,,35,36,71
HND-009814,2011,101600047,,,,9,3,12
HND-009814,2011,101600047,,,,8,8,16
HND-009887,2011,101700039,,,,5,7,12
,2011,101700053,,,,7,16,23
,2011,101700062,,,,4,6,10
,2011,101700067,,,,11,8,19
HND-009900,2011,101700068,,,,8,5,13
,2011,101700072,,,,2,1,3
,2011,101700073,,,,14,6,20
,2011,101700074,,,,6,7,13
HND-009904,2011,101700077,,,,3,9,12
,2011,101700092,,,,4,6,10
,2011,101700093,,,,2,3,5
,2011,101700096,,,,5,6,11
HND-009906,2011,101700097,,,,4,4,8
HND-009879,2011,101700030,,,,5,3,8
HND-009888,2011,101700040,,,,6,8,14
HND-009889,2011,101700041,,,,9,8,17
HND-009890,2011,101700042,,,,2,6,8
,2011,101700058,,,,7,4,11
,2011,101700059,,,,7,9,16
HND-009899,2011,101700060,,,,6,4,10
HND-009901,2011,101700069,,,,9,5,14
,2011,101700082,,,,10,10,20
HND-009905,2011,101700095,,,,5,10,15
HND-009907,2011,101700098,,,,3,4,7
HND-009896,2011,101700052,,,,2,1,3
,2011,101700065,,,,1,2,3
HND-009891,2011,101700047,,,,3,4,7
,2011,101700064,,,,1,2,3
,2011,101700020,,,,6,4,10
,2011,101700029,,,,6,12,18
HND-009884,2011,101700035,,,,8,5,13
HND-009896,2011,101700052,,,,2,5,7
,2011,101700064,,,,10,4,14
,2011,101700065,,,,3,5,8
HND-009875,2011,101700026,,,,4,3,7
HND-009876,2011,101700027,,,,5,7,12
,2011,101700028,,,,4,4,8
HND-009882,2011,101700033,,,,2,0,2
HND-009891,2011,101700047,,,,2,4,6
HND-009875,2011,101700026,,,,14,13,27
HND-009876,2011,101700027,,,,5,4,9
,2011,101700028,,,,5,6,11
HND-009882,2011,101700033,,,,7,4,11
HND-009884,2011,101700035,,,,3,4,7
HND-009891,2011,101700047,,,,5,4,9
,2011,101700020,,,,14,5,19
,2011,101700029,,,,15,7,22
HND-009896,2011,101700052,,,,4,3,7
,2011,101700064,,,,1,1,2
,2011,101700065,,,,1,5,6
HND-009858,2011,101700005,,,,0,4,4
HND-009860,2011,101700007,,,,8,11,19
HND-009861,2011,101700008,,,,4,1,5
HND-009862,2011,101700009,,,,3,8,11
HND-009865,2011,101700012,,,,7,15,22
HND-009866,2011,101700013,,,,5,3,8
HND-009867,2011,101700014,,,,6,3,9
HND-009868,2011,101700015,,,,3,0,3
HND-009869,2011,101700017,,,,5,6,11
HND-009872,2011,101700023,,,,8,12,20
HND-009886,2011,101700038,,,,3,3,6
HND-009892,2011,101700048,,,,7,5,12
,2011,101700049,,,,13,14,27
HND-009894,2011,101700050,,,,9,5,14
HND-009895,2011,101700051,,,,2,1,3
HND-009896,2011,101700052,,,,3,7,10
HND-009898,2011,101700054,,,,2,1,3
HND-009903,2011,101700076,,,,2,0,2
HND-009855,2011,101700002,,,,10,14,24
HND-009856,2011,101700003,,,,6,3,9
HND-009857,2011,101700004,,,,6,5,11
,2011,101700006,,,,10,10,20
HND-009863,2011,101700010,,,,8,7,15
HND-009864,2011,101700011,,,,3,6,9
,2011,101700018,,,,6,4,10
,2011,101700020,,,,18,14,32
HND-009870,2011,101700021,,,,8,4,12
HND-009871,2011,101700022,,,,5,1,6
HND-009873,2011,101700024,,,,5,8,13
HND-009874,2011,101700025,,,,7,7,14
HND-009879,2011,101700030,,,,11,8,19
HND-009880,2011,101700031,,,,6,3,9
HND-009881,2011,101700032,,,,5,1,6
HND-009885,2011,101700036,,,,4,6,10
HND-009855,2011,101700002,,,,19,11,30
HND-009856,2011,101700003,,,,5,1,6
HND-009857,2011,101700004,,,,2,5,7
HND-009858,2011,101700005,,,,2,3,5
HND-009860,2011,101700007,,,,4,7,11
HND-009863,2011,101700010,,,,13,11,24
HND-009864,2011,101700011,,,,2,2,4
HND-009865,2011,101700012,,,,6,15,21
HND-009867,2011,101700014,,,,9,6,15
HND-009871,2011,101700022,,,,1,7,8
HND-009873,2011,101700024,,,,11,4,15
HND-009874,2011,101700025,,,,8,1,9
HND-009879,2011,101700030,,,,3,7,10
HND-009880,2011,101700031,,,,1,2,3
HND-009881,2011,101700032,,,,2,4,6
HND-009885,2011,101700036,,,,8,4,12
,2011,101700006,,,,7,5,12
HND-009861,2011,101700008,,,,2,5,7
HND-009862,2011,101700009,,,,4,6,10
HND-009866,2011,101700013,,,,4,8,12
HND-009868,2011,101700015,,,,2,2,4
HND-009869,2011,101700017,,,,14,10,24
,2011,101700018,,,,6,1,7
,2011,101700020,,,,12,14,26
HND-009870,2011,101700021,,,,5,5,10
HND-009872,2011,101700023,,,,18,14,32
HND-009886,2011,101700038,,,,0,2,2
HND-009892,2011,101700048,,,,8,7,15
,2011,101700049,,,,15,18,33
HND-009894,2011,101700050,,,,5,5,10
HND-009895,2011,101700051,,,,3,4,7
HND-009896,2011,101700052,,,,1,6,7
HND-009903,2011,101700076,,,,2,2,4
HND-009855,2011,101700002,,,,18,24,42
HND-009856,2011,101700003,,,,7,19,26
HND-009857,2011,101700004,,,,4,4,8
,2011,101700006,,,,15,6,21
HND-009860,2011,101700007,,,,5,6,11
HND-009863,2011,101700010,,,,7,8,15
HND-009864,2011,101700011,,,,5,3,8
,2011,101700018,,,,12,9,21
,2011,101700020,,,,17,6,23
HND-009870,2011,101700021,,,,4,10,14
HND-009871,2011,101700022,,,,5,4,9
HND-009873,2011,101700024,,,,2,8,10
HND-009874,2011,101700025,,,,3,1,4
HND-009879,2011,101700030,,,,4,4,8
HND-009880,2011,101700031,,,,2,1,3
HND-009881,2011,101700032,,,,4,2,6
HND-009885,2011,101700036,,,,2,3,5
HND-009858,2011,101700005,,,,4,3,7
HND-009861,2011,101700008,,,,3,5,8
HND-009862,2011,101700009,,,,7,7,14
HND-009865,2011,101700012,,,,9,6,15
HND-009866,2011,101700013,,,,7,3,10
HND-009867,2011,101700014,,,,7,6,13
HND-009868,2011,101700015,,,,3,0,3
HND-009869,2011,101700017,,,,10,10,20
HND-009872,2011,101700023,,,,15,19,34
HND-009886,2011,101700038,,,,2,2,4
HND-009892,2011,101700048,,,,21,10,31
,2011,101700049,,,,9,7,16
HND-009894,2011,101700050,,,,4,3,7
HND-009895,2011,101700051,,,,1,2,3
HND-009896,2011,101700052,,,,2,3,5
HND-009898,2011,101700054,,,,2,1,3
HND-009903,2011,101700076,,,,2,1,3
HND-009855,2011,101700002,,,,11,12,23
HND-009856,2011,101700003,,,,8,5,13
HND-009857,2011,101700004,,,,3,5,8
HND-009858,2011,101700005,,,,4,2,6
HND-009860,2011,101700007,,,,6,5,11
HND-009861,2011,101700008,,,,3,3,6
HND-009863,2011,101700010,,,,7,12,19
HND-009864,2011,101700011,,,,2,1,3
HND-009865,2011,101700012,,,,3,4,7
HND-009866,2011,101700013,,,,4,3,7
HND-009867,2011,101700014,,,,4,5,9
HND-009872,2011,101700023,,,,15,11,26
HND-009874,2011,101700025,,,,0,2,2
HND-009881,2011,101700032,,,,2,2,4
HND-009886,2011,101700038,,,,3,2,5
HND-009892,2011,101700048,,,,10,3,13
HND-009894,2011,101700050,,,,3,4,7
HND-009895,2011,101700051,,,,2,4,6
HND-009903,2011,101700076,,,,4,1,5
,2011,101700006,,,,6,4,10
HND-009862,2011,101700009,,,,7,4,11
HND-009868,2011,101700015,,,,1,2,3
HND-009869,2011,101700017,,,,8,12,20
,2011,101700018,,,,5,4,9
,2011,101700020,,,,9,16,25
HND-009870,2011,101700021,,,,8,10,18
HND-009871,2011,101700022,,,,5,2,7
HND-009873,2011,101700024,,,,2,1,3
HND-009879,2011,101700030,,,,3,3,6
HND-009880,2011,101700031,,,,4,2,6
HND-009885,2011,101700036,,,,2,5,7
,2011,101700049,,,,12,6,18
HND-009896,2011,101700052,,,,4,4,8
HND-009898,2011,101700054,,,,2,2,4
HND-009856,2011,101700003,,,,5,9,14
HND-009858,2011,101700005,,,,1,2,3
HND-009860,2011,101700007,,,,4,2,6
HND-009861,2011,101700008,,,,2,5,7
HND-009862,2011,101700009,,,,3,4,7
HND-009863,2011,101700010,,,,4,5,9
HND-009864,2011,101700011,,,,3,4,7
HND-009865,2011,101700012,,,,4,6,10
HND-009866,2011,101700013,,,,4,2,6
HND-009867,2011,101700014,,,,5,6,11
HND-009868,2011,101700015,,,,1,1,2
HND-009869,2011,101700017,,,,2,4,6
HND-009872,2011,101700023,,,,4,22,26
HND-009874,2011,101700025,,,,3,0,3
HND-009879,2011,101700030,,,,0,2,2
HND-009885,2011,101700036,,,,2,3,5
,2011,101700049,,,,18,14,32
HND-009896,2011,101700052,,,,2,2,4
HND-009855,2011,101700002,,,,3,4,7
HND-009857,2011,101700004,,,,6,3,9
,2011,101700006,,,,7,6,13
,2011,101700018,,,,6,5,11
,2011,101700020,,,,10,3,13
HND-009870,2011,101700021,,,,5,8,13
HND-009871,2011,101700022,,,,6,4,10
HND-009873,2011,101700024,,,,2,1,3
HND-009881,2011,101700032,,,,3,5,8
HND-009886,2011,101700038,,,,1,3,4
HND-009892,2011,101700048,,,,4,9,13
HND-009894,2011,101700050,,,,8,6,14
HND-009895,2011,101700051,,,,2,3,5
HND-009903,2011,101700076,,,,1,4,5
,2011,101700006,,,,4,1,5
HND-009861,2011,101700008,,,,0,6,6
HND-009862,2011,101700009,,,,4,4,8
HND-009866,2011,101700013,,,,1,2,3
HND-009868,2011,101700015,,,,1,1,2
HND-009869,2011,101700017,,,,5,2,7
,2011,101700018,,,,6,5,11
HND-009870,2011,101700021,,,,7,2,9
HND-009872,2011,101700023,,,,13,8,21
HND-009879,2011,101700030,,,,2,1,3
HND-009880,2011,101700031,,,,1,1,2
HND-009881,2011,101700032,,,,0,3,3
HND-009885,2011,101700036,,,,0,1,1
HND-009855,2011,101700002,,,,5,3,8
HND-009856,2011,101700003,,,,2,7,9
HND-009857,2011,101700004,,,,4,4,8
HND-009860,2011,101700007,,,,1,3,4
HND-009863,2011,101700010,,,,7,5,12
HND-009864,2011,101700011,,,,2,5,7
HND-009865,2011,101700012,,,,2,7,9
HND-009867,2011,101700014,,,,6,3,9
HND-009871,2011,101700022,,,,4,4,8
HND-009873,2011,101700024,,,,3,1,4
HND-009874,2011,101700025,,,,2,1,3
HND-009886,2011,101700038,,,,1,2,3
HND-009892,2011,101700048,,,,2,1,3
,2011,101700049,,,,7,7,14
HND-009894,2011,101700050,,,,3,4,7
HND-009895,2011,101700051,,,,1,0,1
HND-009896,2011,101700052,,,,0,1,1
HND-009898,2011,101700054,,,,1,0,1
HND-009903,2011,101700076,,,,1,2,3
HND-009863,2011,101700010,,,,7,10,17
HND-009872,2011,101700023,,,,20,15,35
HND-009892,2011,101700048,,,,9,3,12
HND-009855,2011,101700002,,,,5,10,15
HND-009855,2011,101700002,,,,2,2,4
HND-009863,2011,101700010,,,,7,4,11
HND-009892,2011,101700048,,,,5,7,12
HND-009872,2011,101700023,,,,7,15,22
HND-009855,2011,101700002,,,,5,3,8
HND-009863,2011,101700010,,,,8,3,11
HND-009872,2011,101700023,,,,1,8,9
HND-009892,2011,101700048,,,,5,4,9
HND-009933,2011,110100059,,,,9,8,17
,2011,110100066,,,,5,4,9
HND-009936,2011,110100070,,,,7,6,13
HND-009937,2011,110100071,,,,7,5,12
HND-009938,2011,110100074,,,,5,7,12
,2011,110100076,,,,2,3,5
HND-009939,2011,110100077,,,,6,8,14
,2011,110100087,,,,8,5,13
HND-009941,2011,110100088,,,,6,7,13
,2011,110100096,,,,5,5,10
,2011,110100097,,,,6,4,10
,2011,110100060,,,,5,3,8
,2011,110100061,,,,4,3,7
,2011,110100062,,,,9,4,13
,2011,110100064,,,,7,4,11
,2011,110100067,,,,5,1,6
,2011,110100080,,,,6,6,12
,2011,110100089,,,,3,3,6
,2011,110100094,,,,4,4,8
,2011,110100049,,,,5,2,7
,2011,110100051,,,,9,10,19
,2011,110100003,,,,0,2,2
,2011,110100021,,,,9,2,11
HND-009931,2011,110100056,,,,0,1,1
HND-009908,2011,110100001,,,,2,6,8
,2011,110100003,,,,8,7,15
HND-009921,2011,110100027,,,,10,10,20
,2011,110100029,,,,1,2,3
HND-009923,2011,110100030,,,,10,15,25
HND-009924,2011,110100031,,,,5,3,8
,2011,110100036,,,,4,4,8
,2011,110100037,,,,12,2,14
HND-009928,2011,110100043,,,,15,7,22
HND-009929,2011,110100046,,,,6,2,8
,2011,110100049,,,,7,5,12
,2011,110100051,,,,20,10,30
,2011,110100052,,,,3,4,7
HND-009931,2011,110100056,,,,2,0,2
,2011,110100079,,,,6,4,10
,2011,110100091,,,,1,3,4
,2011,110100011,,,,1,5,6
,2011,110100018,,,,8,6,14
,2011,110100021,,,,9,8,17
HND-009920,2011,110100023,,,,18,20,38
HND-009922,2011,110100028,,,,15,10,25
HND-009927,2011,110100042,,,,5,9,14
HND-009930,2011,110100050,,,,4,7,11
,2011,110100075,,,,5,9,14
,2011,110100095,,,,1,3,4
,2011,110100003,,,,11,12,23
HND-009909,2011,110100004,,,,15,12,27
,2011,110100011,,,,19,15,34
,2011,110100018,,,,11,3,14
,2011,110100021,,,,13,19,32
HND-009920,2011,110100023,,,,27,27,54
HND-009922,2011,110100028,,,,22,28,50
,2011,110100029,,,,8,7,15
HND-009923,2011,110100030,,,,64,48,112
HND-009927,2011,110100042,,,,21,9,30
HND-009929,2011,110100046,,,,19,10,29
,2011,110100049,,,,13,11,24
HND-009930,2011,110100050,,,,11,10,21
,2011,110100075,,,,6,9,15
,2011,110100095,,,,6,7,13
HND-009908,2011,110100001,,,,2,8,10
,2011,110100006,,,,16,11,27
HND-009921,2011,110100027,,,,60,48,108
HND-009924,2011,110100031,,,,13,13,26
,2011,110100033,,,,3,1,4
,2011,110100036,,,,12,5,17
,2011,110100037,,,,29,34,63
HND-009928,2011,110100043,,,,15,14,29
,2011,110100051,,,,22,20,42
,2011,110100052,,,,7,7,14
HND-009931,2011,110100056,,,,5,0,5
,2011,110100079,,,,7,14,21
,2011,110100090,,,,2,2,4
,2011,110100091,,,,1,4,5
HND-009908,2011,110100001,,,,17,8,25
,2011,110100006,,,,35,33,68
HND-009911,2011,110100007,,,,25,38,63
HND-009913,2011,110100009,,,,11,10,21
HND-009914,2011,110100010,,,,10,13,23
,2011,110100011,,,,20,32,52
HND-009917,2011,110100015,,,,5,3,8
,2011,110100033,,,,7,5,12
,2011,110100052,,,,14,6,20
HND-009931,2011,110100056,,,,1,1,2
HND-009932,2011,110100057,,,,19,19,38
,2011,110100091,,,,4,1,5
HND-009942,2011,110100093,,,,2,18,20
HND-009909,2011,110100004,,,,84,69,153
HND-009910,2011,110100005,,,,6,8,14
HND-009912,2011,110100008,,,,5,5,10
HND-009915,2011,110100013,,,,26,18,44
HND-009916,2011,110100014,,,,92,84,176
HND-009918,2011,110100016,,,,8,4,12
,2011,110100018,,,,9,7,16
HND-009919,2011,110100020,,,,6,1,7
,2011,110100021,,,,17,23,40
,2011,110100025,,,,13,14,27
HND-009925,2011,110100034,,,,42,43,85
,2011,110100036,,,,18,12,30
HND-009935,2011,110100068,,,,51,50,101
HND-009940,2011,110100085,,,,4,4,8
,2011,110100090,,,,2,4,6
,2011,110100098,,,,11,12,23
HND-009909,2011,110100004,,,,71,66,137
HND-009910,2011,110100005,,,,10,3,13
HND-009913,2011,110100009,,,,3,7,10
HND-009914,2011,110100010,,,,12,13,25
,2011,110100011,,,,13,23,36
HND-009916,2011,110100014,,,,84,78,162
,2011,110100018,,,,10,9,19
HND-009919,2011,110100020,,,,4,4,8
,2011,110100021,,,,16,14,30
,2011,110100025,,,,13,16,29
HND-009925,2011,110100034,,,,56,39,95
HND-009932,2011,110100057,,,,17,22,39
HND-009935,2011,110100068,,,,49,29,78
HND-009940,2011,110100085,,,,4,3,7
HND-009908,2011,110100001,,,,6,1,7
,2011,110100006,,,,33,24,57
HND-009911,2011,110100007,,,,28,24,52
HND-009912,2011,110100008,,,,6,3,9
HND-009915,2011,110100013,,,,13,15,28
HND-009917,2011,110100015,,,,10,10,20
HND-009918,2011,110100016,,,,2,1,3
,2011,110100033,,,,0,6,6
,2011,110100036,,,,10,14,24
,2011,110100052,,,,9,9,18
HND-009931,2011,110100056,,,,1,2,3
,2011,110100091,,,,3,10,13
HND-009942,2011,110100093,,,,4,7,11
,2011,110100098,,,,3,7,10
HND-009909,2011,110100004,,,,83,67,150
HND-009910,2011,110100005,,,,10,9,19
HND-009912,2011,110100008,,,,6,3,9
HND-009914,2011,110100010,,,,9,17,26
HND-009915,2011,110100013,,,,21,27,48
HND-009916,2011,110100014,,,,69,106,175
HND-009918,2011,110100016,,,,4,3,7
,2011,110100018,,,,4,7,11
HND-009919,2011,110100020,,,,4,3,7
,2011,110100021,,,,12,17,29
,2011,110100025,,,,12,15,27
HND-009925,2011,110100034,,,,48,53,101
,2011,110100036,,,,12,15,27
HND-009935,2011,110100068,,,,40,37,77
HND-009940,2011,110100085,,,,3,3,6
,2011,110100098,,,,12,7,19
HND-009908,2011,110100001,,,,10,5,15
,2011,110100006,,,,34,33,67
HND-009911,2011,110100007,,,,26,21,47
HND-009913,2011,110100009,,,,13,9,22
,2011,110100011,,,,19,17,36
HND-009917,2011,110100015,,,,8,1,9
,2011,110100033,,,,3,4,7
,2011,110100052,,,,7,11,18
HND-009931,2011,110100056,,,,2,1,3
HND-009932,2011,110100057,,,,28,14,42
,2011,110100091,,,,6,8,14
HND-009942,2011,110100093,,,,3,9,12
HND-009909,2011,110100004,,,,80,81,161
HND-009910,2011,110100005,,,,10,6,16
,2011,110100006,,,,32,29,61
HND-009913,2011,110100009,,,,3,6,9
HND-009914,2011,110100010,,,,9,20,29
,2011,110100011,,,,17,14,31
HND-009916,2011,110100014,,,,89,107,196
HND-009917,2011,110100015,,,,3,5,8
,2011,110100018,,,,9,3,12
,2011,110100021,,,,16,17,33
,2011,110100025,,,,15,15,30
,2011,110100033,,,,4,1,5
,2011,110100052,,,,11,14,25
HND-009932,2011,110100057,,,,29,18,47
HND-009935,2011,110100068,,,,33,30,63
HND-009908,2011,110100001,,,,2,4,6
HND-009911,2011,110100007,,,,38,42,80
HND-009912,2011,110100008,,,,4,6,10
HND-009915,2011,110100013,,,,17,18,35
HND-009918,2011,110100016,,,,3,3,6
HND-009919,2011,110100020,,,,4,3,7
HND-009925,2011,110100034,,,,54,45,99
,2011,110100036,,,,20,21,41
HND-009931,2011,110100056,,,,2,2,4
HND-009940,2011,110100085,,,,8,3,11
,2011,110100091,,,,3,3,6
HND-009942,2011,110100093,,,,2,6,8
,2011,110100098,,,,8,7,15
HND-009909,2011,110100004,,,,78,68,146
,2011,110100006,,,,28,34,62
HND-009911,2011,110100007,,,,21,30,51
HND-009913,2011,110100009,,,,8,8,16
HND-009914,2011,110100010,,,,12,21,33
,2011,110100011,,,,14,20,34
HND-009916,2011,110100014,,,,64,69,133
HND-009917,2011,110100015,,,,3,5,8
,2011,110100033,,,,3,5,8
,2011,110100052,,,,11,9,20
HND-009932,2011,110100057,,,,19,17,36
HND-009935,2011,110100068,,,,24,36,60
HND-009908,2011,110100001,,,,5,5,10
HND-009910,2011,110100005,,,,7,6,13
HND-009912,2011,110100008,,,,6,4,10
HND-009915,2011,110100013,,,,14,23,37
HND-009918,2011,110100016,,,,2,3,5
,2011,110100018,,,,5,4,9
HND-009919,2011,110100020,,,,3,5,8
,2011,110100021,,,,11,17,28
,2011,110100025,,,,13,14,27
HND-009925,2011,110100034,,,,50,41,91
,2011,110100036,,,,13,14,27
HND-009931,2011,110100056,,,,0,1,1
HND-009940,2011,110100085,,,,4,1,5
,2011,110100091,,,,4,2,6
,2011,110100098,,,,7,7,14
HND-009908,2011,110100001,,,,2,4,6
,2011,110100006,,,,36,28,64
HND-009911,2011,110100007,,,,33,30,63
HND-009912,2011,110100008,,,,0,2,2
HND-009915,2011,110100013,,,,12,11,23
HND-009917,2011,110100015,,,,3,2,5
HND-009918,2011,110100016,,,,1,0,1
,2011,110100033,,,,4,2,6
,2011,110100036,,,,10,22,32
,2011,110100052,,,,6,5,11
HND-009931,2011,110100056,,,,2,1,3
,2011,110100091,,,,5,6,11
,2011,110100098,,,,3,2,5
HND-009909,2011,110100004,,,,54,87,141
HND-009910,2011,110100005,,,,5,2,7
HND-009913,2011,110100009,,,,13,11,24
HND-009914,2011,110100010,,,,7,13,20
,2011,110100011,,,,13,17,30
HND-009916,2011,110100014,,,,69,81,150
,2011,110100018,,,,5,10,15
HND-009919,2011,110100020,,,,4,4,8
,2011,110100021,,,,11,14,25
,2011,110100025,,,,15,17,32
HND-009925,2011,110100034,,,,40,52,92
HND-009932,2011,110100057,,,,15,14,29
HND-009935,2011,110100068,,,,21,14,35
HND-009940,2011,110100085,,,,6,3,9
HND-009911,2011,110100007,,,,63,56,119
HND-009916,2011,110100014,,,,65,75,140
,2011,110100018,,,,7,6,13
,2011,110100021,,,,11,14,25
,2011,110100025,,,,29,20,49
,2011,110100036,,,,12,21,33
,2011,110100039,,,,21,8,29
,2011,110100054,,,,18,17,35
,2011,110100058,,,,4,5,9
HND-009925,2011,110100034,,,,52,53,105
HND-009926,2011,110100038,,,,177,165,342
,2011,110100052,,,,26,31,57
,2011,110100084,,,,27,44,71
,2011,110100091,,,,4,3,7
HND-009916,2011,110100014,,,,24,46,70
HND-009925,2011,110100034,,,,43,42,85
HND-009926,2011,110100038,,,,145,125,270
,2011,110100039,,,,10,12,22
,2011,110100052,,,,10,24,34
,2011,110100054,,,,7,16,23
,2011,110100084,,,,14,27,41
,2011,110100091,,,,0,1,1
HND-009911,2011,110100007,,,,25,37,62
,2011,110100018,,,,4,8,12
,2011,110100021,,,,10,10,20
,2011,110100025,,,,21,34,55
,2011,110100036,,,,17,15,32
,2011,110100058,,,,8,3,11
HND-009916,2011,110100014,,,,25,46,71
,2011,110100039,,,,7,10,17
,2011,110100054,,,,10,16,26
,2011,110100058,,,,3,4,7
HND-009911,2011,110100007,,,,17,28,45
,2011,110100018,,,,7,5,12
,2011,110100021,,,,6,8,14
,2011,110100025,,,,22,19,41
HND-009925,2011,110100034,,,,27,26,53
,2011,110100036,,,,18,17,35
HND-009926,2011,110100038,,,,96,120,216
,2011,110100052,,,,19,23,42
,2011,110100084,,,,20,30,50
,2011,110100091,,,,4,1,5
,2011,110100018,,,,4,5,9
,2011,110100021,,,,4,15,19
,2011,110100025,,,,29,32,61
,2011,110100036,,,,10,14,24
,2011,110100058,,,,6,5,11
,2011,110100084,,,,26,77,103
HND-009926,2011,110100038,,,,108,156,264
,2011,110100039,,,,27,40,67
,2011,110100052,,,,34,43,77
,2011,110100092,,,,26,25,51
,2011,110100018,,,,5,7,12
,2011,110100021,,,,6,8,14
,2011,110100025,,,,26,22,48
HND-009926,2011,110100038,,,,57,113,170
,2011,110100039,,,,14,27,41
,2011,110100052,,,,34,79,113
,2011,110100036,,,,6,14,20
,2011,110100058,,,,2,7,9
,2011,110100084,,,,16,24,40
HND-009926,2011,110100038,,,,40,86,126
,2011,110100039,,,,6,20,26
,2011,110100052,,,,12,29,41
,2011,110100025,,,,14,11,25
,2011,110100036,,,,12,10,22
,2011,110100058,,,,6,12,18
HND-009954,2011,110200025,,,,9,8,17
,2011,110200026,,,,10,6,16
,2011,110200024,,,,1,2,3
,2011,110200027,,,,7,2,9
,2011,110200028,,,,1,0,1
,2011,110200012,,,,5,16,21
HND-009951,2011,110200013,,,,11,10,21
,2011,110200017,,,,2,5,7
,2011,110200006,,,,2,3,5
,2011,110200015,,,,7,5,12
,2011,110200028,,,,1,3,4
,2011,110200006,,,,4,4,8
,2011,110200012,,,,13,11,24
,2011,110200015,,,,4,2,6
,2011,110200028,,,,4,2,6
HND-009951,2011,110200013,,,,6,10,16
,2011,110200016,,,,14,13,27
,2011,110200017,,,,2,1,3
,2011,110200001,,,,13,11,24
HND-009947,2011,110200002,,,,7,5,12
HND-009949,2011,110200004,,,,10,9,19
HND-009952,2011,110200022,,,,3,3,6
HND-009953,2011,110200023,,,,0,1,1
HND-009948,2011,110200003,,,,7,13,20
,2011,110200008,,,,1,4,5
,2011,110200014,,,,3,8,11
HND-009947,2011,110200002,,,,6,12,18
HND-009948,2011,110200003,,,,9,6,15
HND-009949,2011,110200004,,,,4,8,12
,2011,110200005,,,,1,1,2
,2011,110200008,,,,7,3,10
,2011,110200014,,,,3,7,10
HND-009952,2011,110200022,,,,3,3,6
,2011,110200001,,,,12,11,23
HND-009953,2011,110200023,,,,1,1,2
HND-009948,2011,110200003,,,,22,17,39
HND-009949,2011,110200004,,,,11,15,26
,2011,110200005,,,,1,1,2
,2011,110200008,,,,1,6,7
,2011,110200014,,,,8,6,14
,2011,110200001,,,,19,12,31
HND-009947,2011,110200002,,,,8,8,16
HND-009952,2011,110200022,,,,3,5,8
HND-009953,2011,110200023,,,,2,1,3
,2011,110200001,,,,17,24,41
HND-009947,2011,110200002,,,,9,7,16
HND-009949,2011,110200004,,,,15,10,25
,2011,110200005,,,,1,0,1
,2011,110200008,,,,5,5,10
,2011,110200014,,,,10,9,19
HND-009952,2011,110200022,,,,3,4,7
HND-009948,2011,110200003,,,,13,10,23
HND-009953,2011,110200023,,,,2,2,4
,2011,110200001,,,,22,16,38
HND-009947,2011,110200002,,,,6,6,12
HND-009949,2011,110200004,,,,14,8,22
,2011,110200008,,,,3,4,7
HND-009952,2011,110200022,,,,3,3,6
HND-009953,2011,110200023,,,,2,0,2
HND-009948,2011,110200003,,,,14,12,26
,2011,110200014,,,,11,6,17
,2011,110200001,,,,26,15,41
HND-009953,2011,110200023,,,,2,3,5
HND-009947,2011,110200002,,,,4,4,8
HND-009948,2011,110200003,,,,11,13,24
HND-009949,2011,110200004,,,,14,14,28
,2011,110200008,,,,4,4,8
,2011,110200014,,,,11,6,17
HND-009952,2011,110200022,,,,4,4,8
,2011,110200008,,,,10,14,24
,2011,110200014,,,,5,8,13
HND-009948,2011,110200003,,,,11,19,30
,2011,110200020,,,,19,25,44
HND-009948,2011,110200003,,,,17,10,27
,2011,110200020,,,,17,18,35
,2011,110200008,,,,6,13,19
,2011,110200014,,,,4,5,9
,2011,110200020,,,,5,18,23
HND-009948,2011,110200003,,,,8,10,18
,2011,110200008,,,,10,9,19
,2011,110200014,,,,7,3,10
,2011,110200008,,,,6,4,10
,2011,110200014,,,,6,3,9
,2011,110200020,,,,8,11,19
,2011,110200014,,,,6,6,12
,2011,110200020,,,,4,6,10
,2011,110200020,,,,3,5,8
,2011,110200014,,,,4,5,9
HND-009978,2011,110300040,,,,7,3,10
HND-009980,2011,110300042,,,,6,4,10
HND-009983,2011,110300045,,,,5,4,9
HND-009981,2011,110300043,,,,3,4,7
HND-009982,2011,110300044,,,,10,2,12
,2011,110300048,,,,4,2,6
HND-009962,2011,110300011,,,,2,1,3
,2011,110300032,,,,6,0,6
HND-009977,2011,110300036,,,,4,2,6
,2011,110300001,,,,1,2,3
HND-009968,2011,110300019,,,,5,4,9
HND-009969,2011,110300020,,,,11,12,23
HND-009972,2011,110300024,,,,3,4,7
,2011,110300029,,,,5,2,7
HND-009974,2011,110300030,,,,9,2,11
,2011,110300031,,,,0,1,1
,2011,110300032,,,,1,0,1
HND-009984,2011,110300047,,,,1,8,9
HND-009962,2011,110300011,,,,1,6,7
HND-009967,2011,110300017,,,,7,4,11
,2011,110300018,,,,2,1,3
HND-009970,2011,110300021,,,,14,12,26
HND-009976,2011,110300033,,,,9,13,22
HND-009977,2011,110300036,,,,2,0,2
,2011,110300037,,,,5,5,10
,2011,110300009,,,,0,4,4
HND-009962,2011,110300011,,,,2,8,10
HND-009967,2011,110300017,,,,6,5,11
,2011,110300018,,,,2,1,3
HND-009970,2011,110300021,,,,25,15,40
HND-009972,2011,110300024,,,,6,6,12
,2011,110300031,,,,9,5,14
HND-009976,2011,110300033,,,,29,25,54
HND-009977,2011,110300036,,,,4,3,7
,2011,110300037,,,,3,2,5
,2011,110300001,,,,4,10,14
HND-009968,2011,110300019,,,,6,5,11
HND-009969,2011,110300020,,,,13,11,24
HND-009974,2011,110300030,,,,4,6,10
,2011,110300032,,,,2,6,8
HND-009984,2011,110300047,,,,4,2,6
HND-009956,2011,110300003,,,,20,16,36
HND-009959,2011,110300006,,,,1,2,3
HND-009960,2011,110300007,,,,45,48,93
HND-009961,2011,110300010,,,,7,6,13
HND-009963,2011,110300012,,,,2,5,7
HND-009965,2011,110300014,,,,10,10,20
HND-009966,2011,110300015,,,,6,8,14
,2011,110300016,,,,3,0,3
HND-009977,2011,110300036,,,,3,1,4
HND-009979,2011,110300041,,,,18,9,27
HND-009955,2011,110300002,,,,6,10,16
HND-009957,2011,110300004,,,,4,2,6
HND-009958,2011,110300005,,,,9,10,19
,2011,110300008,,,,1,4,5
,2011,110300009,,,,9,2,11
HND-009962,2011,110300011,,,,9,16,25
HND-009964,2011,110300013,,,,10,2,12
HND-009955,2011,110300002,,,,6,13,19
HND-009958,2011,110300005,,,,10,10,20
,2011,110300008,,,,2,6,8
,2011,110300009,,,,7,6,13
HND-009961,2011,110300010,,,,13,3,16
HND-009962,2011,110300011,,,,13,8,21
HND-009963,2011,110300012,,,,6,4,10
HND-009964,2011,110300013,,,,3,1,4
HND-009956,2011,110300003,,,,20,20,40
HND-009957,2011,110300004,,,,2,4,6
HND-009959,2011,110300006,,,,2,0,2
HND-009960,2011,110300007,,,,25,34,59
HND-009965,2011,110300014,,,,13,10,23
HND-009966,2011,110300015,,,,9,5,14
,2011,110300016,,,,2,2,4
HND-009977,2011,110300036,,,,5,2,7
HND-009979,2011,110300041,,,,5,9,14
HND-009955,2011,110300002,,,,13,10,23
HND-009957,2011,110300004,,,,6,4,10
HND-009958,2011,110300005,,,,10,9,19
,2011,110300008,,,,6,4,10
,2011,110300009,,,,2,4,6
HND-009961,2011,110300010,,,,5,6,11
HND-009962,2011,110300011,,,,16,12,28
HND-009964,2011,110300013,,,,7,4,11
HND-009956,2011,110300003,,,,19,26,45
HND-009959,2011,110300006,,,,0,4,4
HND-009960,2011,110300007,,,,29,26,55
HND-009963,2011,110300012,,,,2,5,7
HND-009965,2011,110300014,,,,14,14,28
HND-009966,2011,110300015,,,,3,6,9
,2011,110300016,,,,0,1,1
HND-009977,2011,110300036,,,,3,4,7
HND-009979,2011,110300041,,,,16,18,34
HND-009958,2011,110300005,,,,11,10,21
HND-009959,2011,110300006,,,,1,0,1
,2011,110300008,,,,2,7,9
,2011,110300009,,,,6,5,11
HND-009961,2011,110300010,,,,9,5,14
HND-009962,2011,110300011,,,,12,6,18
HND-009963,2011,110300012,,,,9,9,18
HND-009966,2011,110300015,,,,7,9,16
HND-009955,2011,110300002,,,,9,6,15
HND-009956,2011,110300003,,,,27,18,45
HND-009957,2011,110300004,,,,5,1,6
HND-009960,2011,110300007,,,,38,28,66
HND-009964,2011,110300013,,,,2,6,8
HND-009965,2011,110300014,,,,16,12,28
,2011,110300016,,,,4,3,7
HND-009977,2011,110300036,,,,6,4,10
HND-009979,2011,110300041,,,,8,11,19
HND-009955,2011,110300002,,,,6,4,10
HND-009957,2011,110300004,,,,5,3,8
HND-009960,2011,110300007,,,,42,24,66
,2011,110300009,,,,4,9,13
HND-009962,2011,110300011,,,,11,5,16
HND-009964,2011,110300013,,,,3,3,6
,2011,110300016,,,,2,2,4
HND-009977,2011,110300036,,,,5,1,6
HND-009956,2011,110300003,,,,18,26,44
HND-009958,2011,110300005,,,,5,6,11
HND-009959,2011,110300006,,,,3,2,5
,2011,110300008,,,,5,3,8
HND-009961,2011,110300010,,,,8,3,11
HND-009963,2011,110300012,,,,4,7,11
HND-009965,2011,110300014,,,,12,14,26
HND-009966,2011,110300015,,,,4,7,11
HND-009979,2011,110300041,,,,11,7,18
HND-009955,2011,110300002,,,,4,11,15
HND-009958,2011,110300005,,,,12,5,17
,2011,110300008,,,,7,7,14
,2011,110300009,,,,5,9,14
HND-009961,2011,110300010,,,,8,6,14
HND-009962,2011,110300011,,,,6,7,13
HND-009963,2011,110300012,,,,8,4,12
HND-009964,2011,110300013,,,,3,2,5
HND-009977,2011,110300036,,,,2,2,4
HND-009979,2011,110300041,,,,7,10,17
HND-009956,2011,110300003,,,,36,19,55
HND-009957,2011,110300004,,,,6,1,7
HND-009959,2011,110300006,,,,3,0,3
HND-009960,2011,110300007,,,,29,27,56
HND-009965,2011,110300014,,,,18,18,36
HND-009966,2011,110300015,,,,9,9,18
,2011,110300016,,,,1,0,1
HND-009956,2011,110300003,,,,34,26,60
HND-009960,2011,110300007,,,,25,37,62
,2011,110300008,,,,5,7,12
HND-009965,2011,110300014,,,,16,28,44
HND-009966,2011,110300015,,,,16,7,23
,2011,110300016,,,,3,4,7
HND-009973,2011,110300027,,,,20,15,35
HND-009955,2011,110300002,,,,14,6,20
,2011,110300029,,,,5,0,5
HND-009955,2011,110300002,,,,5,7,12
,2011,110300008,,,,4,6,10
HND-009973,2011,110300027,,,,30,20,50
HND-009956,2011,110300003,,,,30,41,71
HND-009960,2011,110300007,,,,18,32,50
HND-009965,2011,110300014,,,,21,23,44
,2011,110300016,,,,1,2,3
HND-009955,2011,110300002,,,,4,8,12
HND-009956,2011,110300003,,,,24,27,51
HND-009960,2011,110300007,,,,11,16,27
HND-009965,2011,110300014,,,,8,17,25
,2011,110300016,,,,1,1,2
HND-009973,2011,110300027,,,,16,14,30
,2011,110300016,,,,0,4,4
HND-009973,2011,110300027,,,,57,73,130
,2011,110300029,,,,3,9,12
,2011,110300016,,,,3,0,3
HND-009973,2011,110300027,,,,30,42,72
,2011,110300029,,,,1,7,8
,2011,110300029,,,,1,8,9
,2011,110300016,,,,0,2,2
HND-009973,2011,110300027,,,,23,32,55
,2011,110400004,,,,0,1,1
HND-009987,2011,110400005,,,,1,1,2
,2011,110400007,,,,3,0,3
,2011,110400008,,,,1,0,1
HND-009988,2011,110400011,,,,1,3,4
,2011,110400004,,,,1,0,1
,2011,110400007,,,,4,2,6
,2011,110400008,,,,3,3,6
HND-009988,2011,110400011,,,,3,1,4
HND-009987,2011,110400005,,,,3,8,11
,2011,110400015,,,,2,0,2
HND-009987,2011,110400005,,,,7,12,19
,2011,110400007,,,,1,5,6
,2011,110400015,,,,3,1,4
HND-009985,2011,110400001,,,,14,8,22
,2011,110400004,,,,0,4,4
,2011,110400008,,,,1,3,4
HND-009988,2011,110400011,,,,4,4,8
HND-009985,2011,110400001,,,,26,17,43
,2011,110400002,,,,3,3,6
,2011,110400003,,,,2,10,12
,2011,110400004,,,,6,3,9
HND-009988,2011,110400011,,,,10,16,26
,2011,110400003,,,,4,8,12
HND-009988,2011,110400011,,,,13,12,25
HND-009985,2011,110400001,,,,22,19,41
,2011,110400002,,,,2,9,11
,2011,110400004,,,,4,3,7
HND-009988,2011,110400011,,,,6,7,13
HND-009985,2011,110400001,,,,21,21,42
,2011,110400002,,,,5,2,7
,2011,110400003,,,,4,9,13
,2011,110400004,,,,3,3,6
,2011,110400002,,,,4,1,5
,2011,110400003,,,,8,3,11
HND-009985,2011,110400001,,,,15,21,36
,2011,110400004,,,,1,1,2
HND-009988,2011,110400011,,,,16,9,25
HND-009985,2011,110400001,,,,15,14,29
,2011,110400002,,,,3,6,9
,2011,110400003,,,,3,5,8
,2011,110400004,,,,1,2,3
HND-009988,2011,110400011,,,,14,11,25
HND-009985,2011,110400001,,,,13,20,33
,2011,110400002,,,,6,5,11
,2011,110400004,,,,1,3,4
,2011,110400003,,,,4,2,6
HND-009988,2011,110400011,,,,8,14,22
HND-009985,2011,110400001,,,,17,12,29
,2011,110400006,,,,3,2,5
HND-009988,2011,110400011,,,,15,16,31
HND-009985,2011,110400001,,,,12,13,25
HND-009988,2011,110400011,,,,9,14,23
,2011,110400006,,,,1,7,8
HND-009985,2011,110400001,,,,10,8,18
,2011,110400006,,,,3,6,9
HND-009988,2011,110400011,,,,10,10,20
,2011,110400006,,,,8,6,14
HND-009985,2011,110400001,,,,7,10,17
HND-009988,2011,110400011,,,,17,23,40
,2011,110400006,,,,3,6,9
HND-009985,2011,110400001,,,,6,12,18
HND-009985,2011,110400001,,,,5,14,19
,2011,110400006,,,,3,4,7
HND-009998,2011,120100009,,,,5,3,8
HND-009999,2011,120100010,,,,10,9,19
HND-010021,2011,120100034,,,,4,2,6
HND-010060,2011,120100086,,,,3,3,6
HND-010067,2011,120100114,,,,6,5,11
,2011,120100123,,,,6,7,13
,2011,120100124,,,,4,2,6
HND-010013,2011,120100024,,,,4,5,9
HND-010019,2011,120100032,,,,6,4,10
HND-010025,2011,120100039,,,,6,9,15
HND-010072,2011,120100125,,,,7,4,11
HND-010037,2011,120100053,,,,2,8,10
HND-010050,2011,120100075,,,,4,7,11
,2011,120100117,,,,2,0,2
,2011,120100118,,,,5,2,7
HND-010069,2011,120100120,,,,6,0,6
HND-010073,2011,120100126,,,,20,0,20
,2011,120100028,,,,1,1,2
HND-010027,2011,120100041,,,,1,1,2
HND-010033,2011,120100049,,,,11,13,24
HND-010036,2011,120100052,,,,14,5,19
,2011,120100028,,,,0,2,2
HND-010018,2011,120100031,,,,1,0,1
HND-010024,2011,120100037,,,,4,9,13
HND-010026,2011,120100040,,,,2,2,4
HND-010028,2011,120100042,,,,0,3,3
HND-010032,2011,120100048,,,,8,5,13
HND-010036,2011,120100052,,,,9,28,37
HND-010038,2011,120100054,,,,0,4,4
HND-010039,2011,120100055,,,,14,16,30
HND-010040,2011,120100056,,,,6,4,10
,2011,120100057,,,,4,5,9
,2011,120100064,,,,8,3,11
HND-010049,2011,120100074,,,,1,3,4
HND-010054,2011,120100079,,,,24,19,43
HND-010059,2011,120100085,,,,1,2,3
HND-010065,2011,120100092,,,,1,3,4
,2011,120100117,,,,7,9,16
,2011,120100118,,,,6,7,13
HND-010068,2011,120100119,,,,0,5,5
HND-010069,2011,120100120,,,,4,3,7
HND-010071,2011,120100122,,,,3,6,9
,2011,120100007,,,,1,7,8
HND-010020,2011,120100033,,,,0,2,2
HND-010027,2011,120100041,,,,5,3,8
HND-010030,2011,120100046,,,,10,6,16
HND-010031,2011,120100047,,,,3,7,10
HND-010033,2011,120100049,,,,26,43,69
HND-010034,2011,120100050,,,,20,20,40
HND-010035,2011,120100051,,,,31,26,57
HND-010037,2011,120100053,,,,17,17,34
HND-010050,2011,120100075,,,,3,4,7
HND-010053,2011,120100078,,,,5,9,14
HND-010055,2011,120100080,,,,1,1,2
HND-010056,2011,120100081,,,,0,7,7
,2011,120100084,,,,3,3,6
HND-010064,2011,120100091,,,,1,2,3
HND-010073,2011,120100126,,,,7,0,7
,2011,120100007,,,,3,13,16
,2011,120100028,,,,3,3,6
HND-010020,2011,120100033,,,,8,2,10
HND-010027,2011,120100041,,,,4,4,8
HND-010030,2011,120100046,,,,10,15,25
HND-010031,2011,120100047,,,,16,19,35
HND-010033,2011,120100049,,,,30,29,59
HND-010035,2011,120100051,,,,24,26,50
HND-010036,2011,120100052,,,,24,24,48
HND-010050,2011,120100075,,,,6,10,16
HND-010055,2011,120100080,,,,3,3,6
HND-010056,2011,120100081,,,,3,5,8
,2011,120100084,,,,9,8,17
HND-010059,2011,120100085,,,,5,5,10
HND-010064,2011,120100091,,,,5,6,11
HND-010073,2011,120100126,,,,9,0,9
HND-010018,2011,120100031,,,,2,4,6
HND-010022,2011,120100035,,,,4,0,4
HND-010024,2011,120100037,,,,5,8,13
HND-010026,2011,120100040,,,,9,5,14
HND-010028,2011,120100042,,,,2,3,5
HND-010032,2011,120100048,,,,6,10,16
HND-010034,2011,120100050,,,,30,33,63
HND-010037,2011,120100053,,,,20,16,36
HND-010038,2011,120100054,,,,14,5,19
HND-010039,2011,120100055,,,,33,26,59
HND-010040,2011,120100056,,,,11,10,21
,2011,120100057,,,,6,4,10
,2011,120100064,,,,12,12,24
HND-010049,2011,120100074,,,,6,8,14
HND-010053,2011,120100078,,,,13,16,29
HND-010054,2011,120100079,,,,14,19,33
HND-010065,2011,120100092,,,,1,3,4
,2011,120100117,,,,4,7,11
,2011,120100118,,,,9,11,20
HND-010068,2011,120100119,,,,0,1,1
HND-010069,2011,120100120,,,,1,1,2
HND-010071,2011,120100122,,,,1,1,2
HND-009991,2011,120100001,,,,36,34,70
HND-009994,2011,120100004,,,,30,44,74
,2011,120100007,,,,18,16,34
HND-009997,2011,120100008,,,,5,1,6
HND-009998,2011,120100009,,,,2,0,2
HND-010000,2011,120100011,,,,43,40,83
HND-010002,2011,120100013,,,,7,10,17
HND-010005,2011,120100016,,,,5,2,7
HND-010006,2011,120100017,,,,12,11,23
HND-010014,2011,120100025,,,,1,2,3
HND-010015,2011,120100026,,,,12,7,19
,2011,120100028,,,,1,5,6
HND-010016,2011,120100029,,,,9,6,15
HND-010017,2011,120100030,,,,4,7,11
HND-010018,2011,120100031,,,,4,1,5
HND-010020,2011,120100033,,,,5,5,10
HND-010029,2011,120100043,,,,36,34,70
,2011,120100064,,,,9,7,16
HND-010045,2011,120100065,,,,9,6,15
HND-010047,2011,120100071,,,,3,1,4
HND-010048,2011,120100072,,,,42,25,67
HND-010051,2011,120100076,,,,5,0,5
HND-010052,2011,120100077,,,,6,8,14
HND-010063,2011,120100090,,,,3,5,8
HND-010067,2011,120100114,,,,3,2,5
,2011,120100118,,,,10,6,16
HND-010070,2011,120100121,,,,4,10,14
HND-009992,2011,120100002,,,,22,7,29
HND-009993,2011,120100003,,,,1,1,2
HND-009995,2011,120100005,,,,47,42,89
HND-009996,2011,120100006,,,,38,46,84
HND-009999,2011,120100010,,,,5,8,13
HND-010001,2011,120100012,,,,4,4,8
HND-010003,2011,120100014,,,,12,6,18
HND-010004,2011,120100015,,,,18,17,35
HND-010007,2011,120100018,,,,17,16,33
HND-010008,2011,120100019,,,,29,11,40
HND-010009,2011,120100020,,,,1,0,1
HND-010010,2011,120100021,,,,11,4,15
HND-010011,2011,120100022,,,,6,8,14
HND-010012,2011,120100023,,,,6,9,15
HND-010013,2011,120100024,,,,3,3,6
HND-010019,2011,120100032,,,,2,2,4
HND-010021,2011,120100034,,,,5,2,7
HND-010022,2011,120100035,,,,6,6,12
HND-010044,2011,120100063,,,,6,6,12
HND-010046,2011,120100070,,,,4,4,8
HND-010061,2011,120100087,,,,4,3,7
HND-010062,2011,120100088,,,,16,10,26
HND-010066,2011,120100093,,,,4,2,6
,2011,120100117,,,,8,9,17
HND-009996,2011,120100006,,,,52,44,96
,2011,120100007,,,,11,18,29
HND-009997,2011,120100008,,,,5,4,9
HND-010004,2011,120100015,,,,13,8,21
HND-010005,2011,120100016,,,,4,4,8
HND-010008,2011,120100019,,,,21,17,38
HND-010009,2011,120100020,,,,2,1,3
HND-010011,2011,120100022,,,,6,8,14
HND-010013,2011,120100024,,,,1,2,3
HND-010014,2011,120100025,,,,2,1,3
,2011,120100028,,,,2,2,4
HND-010020,2011,120100033,,,,3,4,7
HND-010021,2011,120100034,,,,4,0,4
HND-010044,2011,120100063,,,,7,5,12
HND-010048,2011,120100072,,,,41,23,64
HND-010051,2011,120100076,,,,7,5,12
HND-010062,2011,120100088,,,,8,5,13
HND-010066,2011,120100093,,,,2,3,5
HND-010067,2011,120100114,,,,2,1,3
HND-010070,2011,120100121,,,,2,4,6
HND-009991,2011,120100001,,,,28,25,53
HND-009992,2011,120100002,,,,23,7,30
HND-009993,2011,120100003,,,,3,1,4
HND-009994,2011,120100004,,,,40,25,65
HND-009995,2011,120100005,,,,38,43,81
HND-009998,2011,120100009,,,,1,2,3
HND-009999,2011,120100010,,,,6,6,12
HND-010000,2011,120100011,,,,36,44,80
HND-010001,2011,120100012,,,,6,3,9
HND-010002,2011,120100013,,,,8,2,10
HND-010003,2011,120100014,,,,6,7,13
HND-010006,2011,120100017,,,,5,6,11
HND-010007,2011,120100018,,,,13,8,21
HND-010010,2011,120100021,,,,7,7,14
HND-010012,2011,120100023,,,,2,3,5
HND-010015,2011,120100026,,,,6,7,13
HND-010016,2011,120100029,,,,6,7,13
HND-010017,2011,120100030,,,,4,3,7
HND-010018,2011,120100031,,,,4,7,11
HND-010019,2011,120100032,,,,6,3,9
HND-010022,2011,120100035,,,,3,4,7
HND-010029,2011,120100043,,,,30,28,58
,2011,120100064,,,,9,7,16
HND-010045,2011,120100065,,,,4,8,12
HND-010046,2011,120100070,,,,7,1,8
HND-010047,2011,120100071,,,,2,3,5
HND-010052,2011,120100077,,,,3,1,4
HND-010060,2011,120100086,,,,0,1,1
HND-010061,2011,120100087,,,,0,2,2
HND-010063,2011,120100090,,,,4,3,7
,2011,120100117,,,,5,7,12
,2011,120100118,,,,4,7,11
HND-009993,2011,120100003,,,,3,1,4
HND-009995,2011,120100005,,,,37,25,62
HND-009996,2011,120100006,,,,39,38,77
,2011,120100007,,,,26,15,41
HND-009999,2011,120100010,,,,4,8,12
HND-010001,2011,120100012,,,,10,2,12
HND-010004,2011,120100015,,,,9,15,24
HND-010007,2011,120100018,,,,19,6,25
HND-010008,2011,120100019,,,,16,15,31
HND-010009,2011,120100020,,,,2,0,2
HND-010010,2011,120100021,,,,5,9,14
HND-010011,2011,120100022,,,,9,8,17
HND-010012,2011,120100023,,,,7,7,14
HND-010013,2011,120100024,,,,2,5,7
HND-010021,2011,120100034,,,,7,0,7
HND-010022,2011,120100035,,,,4,3,7
HND-010044,2011,120100063,,,,3,4,7
HND-010046,2011,120100070,,,,4,9,13
HND-010061,2011,120100087,,,,2,3,5
HND-010062,2011,120100088,,,,9,7,16
HND-010066,2011,120100093,,,,2,2,4
HND-009991,2011,120100001,,,,42,36,78
HND-009992,2011,120100002,,,,8,11,19
HND-009994,2011,120100004,,,,55,41,96
HND-009997,2011,120100008,,,,12,3,15
HND-009998,2011,120100009,,,,4,3,7
HND-010000,2011,120100011,,,,38,35,73
HND-010002,2011,120100013,,,,5,13,18
HND-010003,2011,120100014,,,,4,6,10
HND-010005,2011,120100016,,,,3,4,7
HND-010006,2011,120100017,,,,3,8,11
HND-010014,2011,120100025,,,,1,3,4
HND-010015,2011,120100026,,,,6,5,11
,2011,120100028,,,,2,2,4
HND-010016,2011,120100029,,,,4,7,11
HND-010017,2011,120100030,,,,6,4,10
HND-010018,2011,120100031,,,,0,4,4
HND-010019,2011,120100032,,,,1,2,3
HND-010020,2011,120100033,,,,11,4,15
HND-010029,2011,120100043,,,,17,29,46
,2011,120100064,,,,13,9,22
HND-010045,2011,120100065,,,,5,4,9
HND-010047,2011,120100071,,,,1,1,2
HND-010048,2011,120100072,,,,28,28,56
HND-010051,2011,120100076,,,,5,8,13
HND-010052,2011,120100077,,,,7,6,13
HND-010060,2011,120100086,,,,3,2,5
HND-010063,2011,120100090,,,,1,3,4
HND-010067,2011,120100114,,,,1,2,3
,2011,120100117,,,,6,4,10
HND-010070,2011,120100121,,,,3,5,8
HND-009991,2011,120100001,,,,27,26,53
HND-009996,2011,120100006,,,,47,41,88
,2011,120100007,,,,16,21,37
HND-009997,2011,120100008,,,,3,6,9
HND-010002,2011,120100013,,,,5,6,11
HND-010005,2011,120100016,,,,1,3,4
HND-010006,2011,120100017,,,,7,6,13
HND-010008,2011,120100019,,,,21,22,43
HND-010009,2011,120100020,,,,1,1,2
HND-010011,2011,120100022,,,,16,4,20
HND-010013,2011,120100024,,,,2,5,7
HND-010014,2011,120100025,,,,3,2,5
,2011,120100028,,,,1,2,3
HND-010016,2011,120100029,,,,7,5,12
HND-010018,2011,120100031,,,,2,9,11
HND-010020,2011,120100033,,,,2,3,5
HND-010021,2011,120100034,,,,0,1,1
,2011,120100064,,,,9,4,13
HND-010045,2011,120100065,,,,1,7,8
HND-010048,2011,120100072,,,,25,31,56
HND-010051,2011,120100076,,,,10,7,17
HND-010062,2011,120100088,,,,8,7,15
HND-010063,2011,120100090,,,,1,4,5
HND-010066,2011,120100093,,,,3,2,5
HND-010067,2011,120100114,,,,3,3,6
HND-010070,2011,120100121,,,,3,0,3
HND-009992,2011,120100002,,,,9,12,21
HND-009993,2011,120100003,,,,1,2,3
HND-009994,2011,120100004,,,,31,46,77
HND-009995,2011,120100005,,,,48,36,84
HND-009998,2011,120100009,,,,5,2,7
HND-009999,2011,120100010,,,,2,3,5
HND-010000,2011,120100011,,,,43,38,81
HND-010001,2011,120100012,,,,12,7,19
HND-010003,2011,120100014,,,,13,7,20
HND-010004,2011,120100015,,,,12,9,21
HND-010007,2011,120100018,,,,15,12,27
HND-010010,2011,120100021,,,,5,5,10
HND-010012,2011,120100023,,,,5,6,11
HND-010015,2011,120100026,,,,5,6,11
HND-010017,2011,120100030,,,,5,6,11
HND-010019,2011,120100032,,,,6,3,9
HND-010022,2011,120100035,,,,3,3,6
HND-010029,2011,120100043,,,,33,24,57
HND-010044,2011,120100063,,,,2,7,9
HND-010046,2011,120100070,,,,1,5,6
HND-010047,2011,120100071,,,,2,4,6
HND-010052,2011,120100077,,,,7,1,8
HND-010060,2011,120100086,,,,0,1,1
HND-010061,2011,120100087,,,,2,0,2
,2011,120100118,,,,2,2,4
HND-009991,2011,120100001,,,,35,19,54
HND-009994,2011,120100004,,,,36,34,70
HND-009996,2011,120100006,,,,46,41,87
,2011,120100007,,,,15,25,40
HND-009997,2011,120100008,,,,5,3,8
HND-010000,2011,120100011,,,,35,34,69
HND-010002,2011,120100013,,,,5,4,9
HND-010005,2011,120100016,,,,3,5,8
HND-010006,2011,120100017,,,,7,7,14
HND-010008,2011,120100019,,,,27,19,46
HND-010011,2011,120100022,,,,13,6,19
HND-010014,2011,120100025,,,,8,1,9
,2011,120100028,,,,3,1,4
HND-010016,2011,120100029,,,,4,6,10
HND-010019,2011,120100032,,,,1,3,4
HND-010021,2011,120100034,,,,2,0,2
HND-010022,2011,120100035,,,,2,1,3
,2011,120100064,,,,8,16,24
HND-010045,2011,120100065,,,,5,5,10
HND-010046,2011,120100070,,,,6,5,11
HND-010047,2011,120100071,,,,2,2,4
HND-010060,2011,120100086,,,,0,1,1
HND-010061,2011,120100087,,,,1,0,1
HND-010066,2011,120100093,,,,7,4,11
HND-010067,2011,120100114,,,,2,2,4
HND-010070,2011,120100121,,,,2,5,7
HND-009992,2011,120100002,,,,15,20,35
HND-009993,2011,120100003,,,,2,2,4
HND-009995,2011,120100005,,,,35,60,95
HND-009998,2011,120100009,,,,1,2,3
HND-009999,2011,120100010,,,,1,3,4
HND-010001,2011,120100012,,,,7,9,16
HND-010003,2011,120100014,,,,4,11,15
HND-010004,2011,120100015,,,,15,9,24
HND-010007,2011,120100018,,,,14,16,30
HND-010009,2011,120100020,,,,2,1,3
HND-010010,2011,120100021,,,,11,9,20
HND-010012,2011,120100023,,,,7,4,11
HND-010013,2011,120100024,,,,0,3,3
HND-010015,2011,120100026,,,,4,4,8
HND-010017,2011,120100030,,,,5,0,5
HND-010018,2011,120100031,,,,1,2,3
HND-010020,2011,120100033,,,,11,5,16
HND-010029,2011,120100043,,,,21,24,45
HND-010044,2011,120100063,,,,6,7,13
HND-010048,2011,120100072,,,,18,32,50
HND-010051,2011,120100076,,,,9,5,14
HND-010052,2011,120100077,,,,3,10,13
HND-010062,2011,120100088,,,,5,6,11
HND-010063,2011,120100090,,,,2,1,3
HND-009991,2011,120100001,,,,27,22,49
HND-009992,2011,120100002,,,,10,11,21
HND-009993,2011,120100003,,,,1,4,5
HND-009994,2011,120100004,,,,53,51,104
HND-009995,2011,120100005,,,,48,44,92
HND-009998,2011,120100009,,,,2,4,6
HND-009999,2011,120100010,,,,3,5,8
HND-010000,2011,120100011,,,,34,40,74
HND-010001,2011,120100012,,,,7,4,11
HND-010002,2011,120100013,,,,7,4,11
HND-010003,2011,120100014,,,,10,4,14
HND-010006,2011,120100017,,,,6,5,11
HND-010007,2011,120100018,,,,19,17,36
HND-010010,2011,120100021,,,,0,3,3
HND-010012,2011,120100023,,,,5,6,11
HND-010015,2011,120100026,,,,5,3,8
HND-010016,2011,120100029,,,,0,1,1
HND-010020,2011,120100033,,,,3,3,6
HND-010021,2011,120100034,,,,1,0,1
,2011,120100064,,,,19,11,30
HND-010045,2011,120100065,,,,6,5,11
HND-010048,2011,120100072,,,,25,20,45
HND-010051,2011,120100076,,,,8,9,17
HND-010062,2011,120100088,,,,7,1,8
HND-010066,2011,120100093,,,,5,4,9
HND-009996,2011,120100006,,,,49,46,95
,2011,120100007,,,,21,18,39
HND-009997,2011,120100008,,,,4,5,9
HND-010004,2011,120100015,,,,9,10,19
HND-010005,2011,120100016,,,,6,13,19
HND-010008,2011,120100019,,,,16,22,38
HND-010009,2011,120100020,,,,0,1,1
HND-010011,2011,120100022,,,,10,9,19
HND-010014,2011,120100025,,,,1,4,5
,2011,120100028,,,,2,3,5
HND-010017,2011,120100030,,,,1,2,3
HND-010018,2011,120100031,,,,1,1,2
HND-010019,2011,120100032,,,,3,0,3
HND-010022,2011,120100035,,,,2,2,4
HND-010029,2011,120100043,,,,22,27,49
HND-010044,2011,120100063,,,,2,4,6
HND-010046,2011,120100070,,,,9,2,11
HND-010047,2011,120100071,,,,2,2,4
HND-010052,2011,120100077,,,,1,6,7
HND-010060,2011,120100086,,,,1,1,2
HND-010061,2011,120100087,,,,2,1,3
HND-010063,2011,120100090,,,,2,2,4
HND-010067,2011,120100114,,,,1,2,3
HND-010070,2011,120100121,,,,11,5,16
HND-009997,2011,120100008,,,,3,2,5
HND-010016,2011,120100029,,,,6,9,15
HND-010041,2011,120100058,,,,141,89,230
HND-010057,2011,120100082,,,,22,25,47
HND-010004,2011,120100015,,,,14,16,30
HND-010007,2011,120100018,,,,22,30,52
,2011,120100059,,,,25,45,70
HND-010042,2011,120100060,,,,245,262,507
HND-010043,2011,120100061,,,,8,14,22
HND-010044,2011,120100063,,,,15,17,32
HND-009997,2011,120100008,,,,3,7,10
HND-010004,2011,120100015,,,,9,5,14
,2011,120100059,,,,12,18,30
HND-010042,2011,120100060,,,,156,214,370
HND-010043,2011,120100061,,,,5,2,7
HND-010044,2011,120100063,,,,14,18,32
HND-010057,2011,120100082,,,,8,4,12
HND-010007,2011,120100018,,,,17,17,34
HND-010016,2011,120100029,,,,8,9,17
HND-010041,2011,120100058,,,,105,69,174
HND-009997,2011,120100008,,,,3,4,7
HND-010004,2011,120100015,,,,6,9,15
HND-010016,2011,120100029,,,,3,4,7
HND-010041,2011,120100058,,,,62,51,113
,2011,120100059,,,,9,21,30
HND-010042,2011,120100060,,,,152,201,353
HND-010007,2011,120100018,,,,10,19,29
HND-010043,2011,120100061,,,,7,10,17
HND-010044,2011,120100063,,,,5,14,19
HND-010057,2011,120100082,,,,9,12,21
,2011,120100059,,,,12,11,23
HND-010042,2011,120100060,,,,140,257,397
HND-010057,2011,120100082,,,,3,9,12
HND-010023,2011,120100036,,,,269,501,770
HND-010041,2011,120100058,,,,184,8,192
HND-010043,2011,120100061,,,,11,23,34
HND-010043,2011,120100061,,,,13,17,30
HND-010057,2011,120100082,,,,5,3,8
HND-010023,2011,120100036,,,,297,556,853
HND-010041,2011,120100058,,,,137,5,142
,2011,120100059,,,,8,19,27
HND-010042,2011,120100060,,,,78,152,230
HND-010023,2011,120100036,,,,249,452,701
HND-010041,2011,120100058,,,,119,8,127
HND-010042,2011,120100060,,,,43,81,124
,2011,120100059,,,,1,8,9
HND-010057,2011,120100082,,,,3,3,6
HND-010102,2011,120200028,,,,5,2,7
,2011,120200032,,,,7,3,10
,2011,120200035,,,,5,5,10
,2011,120200054,,,,4,3,7
,2011,120200055,,,,5,4,9
HND-010104,2011,120200058,,,,3,3,6
,2011,120200060,,,,3,2,5
HND-010105,2011,120200062,,,,10,3,13
,2011,120200033,,,,2,9,11
,2011,120200034,,,,9,5,14
,2011,120200059,,,,2,4,6
HND-010099,2011,120200024,,,,0,4,4
,2011,120200031,,,,2,1,3
HND-010077,2011,120200001,,,,3,5,8
HND-010099,2011,120200024,,,,4,10,14
,2011,120200031,,,,4,2,6
HND-010077,2011,120200001,,,,1,0,1
HND-010099,2011,120200024,,,,5,9,14
,2011,120200031,,,,5,1,6
HND-010078,2011,120200002,,,,9,9,18
HND-010081,2011,120200005,,,,7,2,9
HND-010082,2011,120200006,,,,4,10,14
HND-010085,2011,120200009,,,,6,6,12
HND-010086,2011,120200010,,,,5,6,11
HND-010087,2011,120200011,,,,8,2,10
HND-010088,2011,120200012,,,,1,0,1
HND-010090,2011,120200014,,,,9,5,14
HND-010093,2011,120200017,,,,3,3,6
HND-010094,2011,120200018,,,,2,10,12
HND-010101,2011,120200026,,,,2,4,6
,2011,120200063,,,,1,1,2
HND-010079,2011,120200003,,,,3,1,4
HND-010080,2011,120200004,,,,2,2,4
HND-010083,2011,120200007,,,,1,3,4
HND-010084,2011,120200008,,,,3,5,8
HND-010089,2011,120200013,,,,2,0,2
HND-010091,2011,120200015,,,,3,2,5
HND-010095,2011,120200019,,,,2,1,3
HND-010096,2011,120200020,,,,0,2,2
HND-010097,2011,120200021,,,,0,2,2
HND-010102,2011,120200028,,,,1,0,1
HND-010103,2011,120200030,,,,3,2,5
HND-010080,2011,120200004,,,,0,2,2
HND-010081,2011,120200005,,,,4,6,10
HND-010084,2011,120200008,,,,4,3,7
HND-010087,2011,120200011,,,,6,1,7
HND-010089,2011,120200013,,,,1,1,2
HND-010092,2011,120200016,,,,1,0,1
HND-010093,2011,120200017,,,,5,0,5
HND-010096,2011,120200020,,,,2,1,3
HND-010102,2011,120200028,,,,2,1,3
HND-010078,2011,120200002,,,,8,3,11
HND-010079,2011,120200003,,,,3,4,7
HND-010082,2011,120200006,,,,7,3,10
HND-010085,2011,120200009,,,,2,2,4
HND-010086,2011,120200010,,,,2,3,5
HND-010090,2011,120200014,,,,3,1,4
HND-010091,2011,120200015,,,,5,1,6
HND-010094,2011,120200018,,,,11,4,15
HND-010095,2011,120200019,,,,1,0,1
HND-010097,2011,120200021,,,,4,6,10
HND-010101,2011,120200026,,,,2,1,3
HND-010103,2011,120200030,,,,1,0,1
,2011,120200063,,,,1,0,1
HND-010079,2011,120200003,,,,2,1,3
HND-010080,2011,120200004,,,,4,0,4
HND-010083,2011,120200007,,,,1,1,2
HND-010084,2011,120200008,,,,3,3,6
HND-010089,2011,120200013,,,,1,3,4
HND-010092,2011,120200016,,,,3,1,4
HND-010093,2011,120200017,,,,2,2,4
HND-010095,2011,120200019,,,,3,3,6
HND-010096,2011,120200020,,,,1,3,4
HND-010097,2011,120200021,,,,1,1,2
HND-010102,2011,120200028,,,,1,0,1
HND-010103,2011,120200030,,,,0,1,1
HND-010078,2011,120200002,,,,9,10,19
HND-010081,2011,120200005,,,,3,2,5
HND-010082,2011,120200006,,,,5,4,9
HND-010085,2011,120200009,,,,5,6,11
HND-010086,2011,120200010,,,,5,1,6
HND-010087,2011,120200011,,,,4,1,5
HND-010088,2011,120200012,,,,0,1,1
HND-010090,2011,120200014,,,,4,3,7
HND-010091,2011,120200015,,,,4,2,6
HND-010094,2011,120200018,,,,2,2,4
HND-010101,2011,120200026,,,,3,2,5
,2011,120200063,,,,1,4,5
HND-010080,2011,120200004,,,,1,0,1
HND-010081,2011,120200005,,,,2,2,4
HND-010084,2011,120200008,,,,2,1,3
HND-010085,2011,120200009,,,,7,5,12
HND-010086,2011,120200010,,,,3,7,10
HND-010087,2011,120200011,,,,0,3,3
HND-010089,2011,120200013,,,,1,0,1
HND-010090,2011,120200014,,,,2,2,4
HND-010092,2011,120200016,,,,2,1,3
HND-010093,2011,120200017,,,,0,4,4
HND-010094,2011,120200018,,,,4,6,10
HND-010096,2011,120200020,,,,3,1,4
HND-010102,2011,120200028,,,,0,1,1
HND-010078,2011,120200002,,,,9,6,15
HND-010079,2011,120200003,,,,2,1,3
HND-010082,2011,120200006,,,,3,2,5
HND-010083,2011,120200007,,,,0,4,4
HND-010088,2011,120200012,,,,2,1,3
HND-010091,2011,120200015,,,,0,1,1
HND-010095,2011,120200019,,,,2,5,7
HND-010097,2011,120200021,,,,7,5,12
HND-010101,2011,120200026,,,,3,2,5
HND-010103,2011,120200030,,,,1,1,2
,2011,120200063,,,,1,0,1
HND-010078,2011,120200002,,,,10,12,22
HND-010081,2011,120200005,,,,1,6,7
HND-010085,2011,120200009,,,,6,6,12
HND-010086,2011,120200010,,,,4,5,9
HND-010087,2011,120200011,,,,5,7,12
HND-010088,2011,120200012,,,,2,0,2
HND-010089,2011,120200013,,,,0,2,2
HND-010090,2011,120200014,,,,3,4,7
HND-010093,2011,120200017,,,,0,1,1
HND-010094,2011,120200018,,,,2,9,11
HND-010079,2011,120200003,,,,1,1,2
HND-010080,2011,120200004,,,,3,3,6
HND-010082,2011,120200006,,,,3,5,8
HND-010084,2011,120200008,,,,5,2,7
HND-010091,2011,120200015,,,,0,1,1
HND-010092,2011,120200016,,,,3,1,4
HND-010096,2011,120200020,,,,5,1,6
HND-010097,2011,120200021,,,,3,3,6
HND-010101,2011,120200026,,,,6,2,8
HND-010102,2011,120200028,,,,1,2,3
HND-010103,2011,120200030,,,,0,1,1
,2011,120200063,,,,4,0,4
HND-010078,2011,120200002,,,,9,14,23
HND-010082,2011,120200006,,,,2,2,4
HND-010083,2011,120200007,,,,1,0,1
HND-010085,2011,120200009,,,,10,2,12
HND-010086,2011,120200010,,,,3,3,6
HND-010088,2011,120200012,,,,2,3,5
HND-010091,2011,120200015,,,,3,2,5
HND-010094,2011,120200018,,,,1,4,5
HND-010095,2011,120200019,,,,3,0,3
HND-010101,2011,120200026,,,,2,2,4
,2011,120200063,,,,2,2,4
HND-010080,2011,120200004,,,,4,3,7
HND-010081,2011,120200005,,,,0,2,2
HND-010084,2011,120200008,,,,7,6,13
HND-010087,2011,120200011,,,,2,3,5
HND-010092,2011,120200016,,,,1,1,2
HND-010093,2011,120200017,,,,1,0,1
HND-010096,2011,120200020,,,,1,1,2
HND-010097,2011,120200021,,,,0,3,3
HND-010102,2011,120200028,,,,0,1,1
HND-010103,2011,120200030,,,,1,1,2
HND-010100,2011,120200025,,,,29,37,66
HND-010100,2011,120200025,,,,17,13,30
HND-010100,2011,120200025,,,,15,20,35
HND-010121,2011,120300018,,,,9,5,14
,2011,120300023,,,,6,6,12
,2011,120300035,,,,2,4,6
HND-010125,2011,120300036,,,,8,6,14
,2011,120300022,,,,4,3,7
,2011,120300037,,,,3,4,7
,2011,120300038,,,,2,5,7
,2011,120300016,,,,1,3,4
HND-010117,2011,120300012,,,,0,2,2
HND-010118,2011,120300014,,,,6,1,7
HND-010108,2011,120300002,,,,1,1,2
HND-010117,2011,120300012,,,,6,8,14
HND-010118,2011,120300014,,,,8,1,9
,2011,120300013,,,,7,9,16
,2011,120300016,,,,5,5,10
HND-010107,2011,120300001,,,,0,2,2
HND-010109,2011,120300003,,,,4,1,5
HND-010110,2011,120300004,,,,3,5,8
HND-010113,2011,120300007,,,,4,2,6
HND-010114,2011,120300008,,,,1,3,4
HND-010119,2011,120300015,,,,2,3,5
HND-010120,2011,120300017,,,,8,6,14
HND-010122,2011,120300019,,,,2,1,3
HND-010123,2011,120300020,,,,2,2,4
HND-010124,2011,120300025,,,,2,1,3
HND-010111,2011,120300005,,,,5,6,11
HND-010112,2011,120300006,,,,6,6,12
HND-010115,2011,120300010,,,,2,3,5
HND-010116,2011,120300011,,,,8,6,14
HND-010109,2011,120300003,,,,5,5,10
HND-010112,2011,120300006,,,,4,5,9
HND-010113,2011,120300007,,,,2,4,6
HND-010115,2011,120300010,,,,2,2,4
HND-010116,2011,120300011,,,,6,8,14
HND-010119,2011,120300015,,,,3,5,8
HND-010123,2011,120300020,,,,1,2,3
HND-010107,2011,120300001,,,,1,0,1
HND-010110,2011,120300004,,,,3,1,4
HND-010111,2011,120300005,,,,6,3,9
HND-010114,2011,120300008,,,,6,1,7
HND-010120,2011,120300017,,,,5,3,8
HND-010124,2011,120300025,,,,2,3,5
HND-010111,2011,120300005,,,,4,4,8
HND-010112,2011,120300006,,,,8,4,12
HND-010115,2011,120300010,,,,4,4,8
HND-010116,2011,120300011,,,,7,7,14
HND-010119,2011,120300015,,,,5,3,8
HND-010107,2011,120300001,,,,2,0,2
HND-010109,2011,120300003,,,,3,5,8
HND-010110,2011,120300004,,,,4,6,10
HND-010113,2011,120300007,,,,5,6,11
HND-010114,2011,120300008,,,,2,2,4
HND-010120,2011,120300017,,,,2,4,6
HND-010123,2011,120300020,,,,6,2,8
HND-010124,2011,120300025,,,,3,1,4
HND-010107,2011,120300001,,,,4,0,4
HND-010109,2011,120300003,,,,3,7,10
HND-010112,2011,120300006,,,,8,2,10
HND-010113,2011,120300007,,,,2,5,7
HND-010116,2011,120300011,,,,2,4,6
HND-010119,2011,120300015,,,,4,4,8
HND-010122,2011,120300019,,,,2,0,2
HND-010123,2011,120300020,,,,1,4,5
HND-010110,2011,120300004,,,,4,5,9
HND-010111,2011,120300005,,,,13,6,19
HND-010114,2011,120300008,,,,2,0,2
HND-010115,2011,120300010,,,,0,6,6
HND-010120,2011,120300017,,,,2,5,7
HND-010124,2011,120300025,,,,1,2,3
HND-010107,2011,120300001,,,,1,0,1
HND-010109,2011,120300003,,,,4,3,7
HND-010110,2011,120300004,,,,3,2,5
HND-010112,2011,120300006,,,,5,4,9
HND-010113,2011,120300007,,,,6,3,9
HND-010114,2011,120300008,,,,2,3,5
HND-010116,2011,120300011,,,,7,6,13
HND-010119,2011,120300015,,,,2,4,6
HND-010122,2011,120300019,,,,0,1,1
HND-010123,2011,120300020,,,,6,4,10
HND-010124,2011,120300025,,,,3,1,4
HND-010111,2011,120300005,,,,5,6,11
HND-010115,2011,120300010,,,,3,2,5
HND-010120,2011,120300017,,,,5,1,6
HND-010107,2011,120300001,,,,1,1,2
HND-010110,2011,120300004,,,,5,4,9
HND-010111,2011,120300005,,,,3,6,9
HND-010114,2011,120300008,,,,5,1,6
HND-010120,2011,120300017,,,,2,3,5
HND-010124,2011,120300025,,,,3,2,5
HND-010109,2011,120300003,,,,7,1,8
HND-010112,2011,120300006,,,,1,4,5
HND-010113,2011,120300007,,,,5,4,9
HND-010115,2011,120300010,,,,5,0,5
HND-010116,2011,120300011,,,,7,7,14
HND-010119,2011,120300015,,,,4,2,6
HND-010122,2011,120300019,,,,3,0,3
HND-010123,2011,120300020,,,,2,4,6
HND-010116,2011,120300011,,,,23,12,35
HND-010116,2011,120300011,,,,6,13,19
HND-010116,2011,120300011,,,,13,4,17
HND-010129,2011,120400002,,,,5,5,10
HND-010130,2011,120400004,,,,10,21,31
HND-010130,2011,120400004,,,,29,24,53
HND-010128,2011,120400001,,,,27,20,47
HND-010129,2011,120400002,,,,5,4,9
,2011,120400003,,,,0,2,2
,2011,120400003,,,,2,0,2
HND-010128,2011,120400001,,,,30,23,53
HND-010129,2011,120400002,,,,4,1,5
,2011,120400003,,,,2,1,3
HND-010128,2011,120400001,,,,26,27,53
HND-010129,2011,120400002,,,,8,2,10
HND-010128,2011,120400001,,,,29,24,53
HND-010129,2011,120400002,,,,1,1,2
HND-010128,2011,120400001,,,,43,28,71
HND-010129,2011,120400002,,,,2,4,6
,2011,120400003,,,,5,1,6
,2011,120400003,,,,3,0,3
HND-010128,2011,120400001,,,,26,37,63
HND-010129,2011,120400002,,,,2,3,5
HND-010131,2011,120400005,,,,45,32,77
HND-010131,2011,120400005,,,,40,34,74
HND-010131,2011,120400005,,,,43,40,83
HND-010131,2011,120400005,,,,72,32,104
HND-010131,2011,120400005,,,,60,35,95
HND-010131,2011,120400005,,,,34,48,82
HND-010146,2011,120500018,,,,12,15,27
HND-010155,2011,120500031,,,,7,5,12
HND-010159,2011,120500036,,,,8,10,18
HND-010160,2011,120500037,,,,12,15,27
HND-010158,2011,120500035,,,,5,11,16
HND-010161,2011,120500038,,,,9,5,14
,2011,120500062,,,,6,1,7
HND-010145,2011,120500017,,,,1,3,4
HND-010148,2011,120500021,,,,5,4,9
HND-010156,2011,120500033,,,,6,3,9
,2011,120500040,,,,2,2,4
,2011,120500056,,,,5,1,6
HND-010151,2011,120500024,,,,3,2,5
HND-010164,2011,120500043,,,,4,4,8
HND-010132,2011,120500002,,,,4,3,7
HND-010150,2011,120500023,,,,5,6,11
HND-010156,2011,120500033,,,,2,3,5
HND-010162,2011,120500039,,,,1,5,6
,2011,120500040,,,,1,3,4
HND-010164,2011,120500043,,,,4,6,10
HND-010165,2011,120500044,,,,4,1,5
,2011,120500055,,,,4,5,9
,2011,120500056,,,,3,2,5
HND-010145,2011,120500017,,,,1,4,5
HND-010148,2011,120500021,,,,4,3,7
HND-010149,2011,120500022,,,,2,5,7
HND-010151,2011,120500024,,,,3,2,5
HND-010145,2011,120500017,,,,5,4,9
HND-010148,2011,120500021,,,,7,9,16
HND-010149,2011,120500022,,,,4,6,10
HND-010151,2011,120500024,,,,8,8,16
HND-010162,2011,120500039,,,,5,7,12
HND-010164,2011,120500043,,,,1,1,2
HND-010132,2011,120500002,,,,4,10,14
HND-010150,2011,120500023,,,,6,7,13
HND-010156,2011,120500033,,,,2,2,4
,2011,120500040,,,,7,3,10
HND-010165,2011,120500044,,,,3,3,6
,2011,120500055,,,,8,7,15
,2011,120500056,,,,5,3,8
HND-010136,2011,120500007,,,,9,8,17
HND-010137,2011,120500008,,,,10,6,16
HND-010139,2011,120500010,,,,2,3,5
HND-010140,2011,120500011,,,,2,1,3
HND-010141,2011,120500012,,,,5,6,11
HND-010143,2011,120500014,,,,5,4,9
HND-010146,2011,120500018,,,,4,5,9
HND-010154,2011,120500029,,,,3,4,7
HND-010156,2011,120500033,,,,7,14,21
HND-010165,2011,120500044,,,,2,5,7
HND-010133,2011,120500004,,,,4,2,6
HND-010134,2011,120500005,,,,10,5,15
HND-010135,2011,120500006,,,,8,6,14
HND-010138,2011,120500009,,,,9,7,16
HND-010142,2011,120500013,,,,6,10,16
HND-010144,2011,120500015,,,,14,10,24
HND-010152,2011,120500027,,,,3,4,7
HND-010153,2011,120500028,,,,4,3,7
HND-010157,2011,120500034,,,,1,2,3
HND-010163,2011,120500042,,,,0,1,1
HND-010133,2011,120500004,,,,3,9,12
HND-010135,2011,120500006,,,,9,4,13
HND-010136,2011,120500007,,,,7,4,11
HND-010138,2011,120500009,,,,3,9,12
HND-010140,2011,120500011,,,,2,2,4
HND-010142,2011,120500013,,,,7,7,14
HND-010153,2011,120500028,,,,5,6,11
HND-010157,2011,120500034,,,,3,8,11
HND-010134,2011,120500005,,,,14,6,20
HND-010137,2011,120500008,,,,8,11,19
HND-010139,2011,120500010,,,,8,5,13
HND-010141,2011,120500012,,,,6,3,9
HND-010143,2011,120500014,,,,10,5,15
HND-010144,2011,120500015,,,,12,4,16
HND-010146,2011,120500018,,,,6,7,13
HND-010152,2011,120500027,,,,2,4,6
HND-010154,2011,120500029,,,,5,2,7
HND-010156,2011,120500033,,,,3,4,7
HND-010163,2011,120500042,,,,4,2,6
HND-010165,2011,120500044,,,,5,2,7
HND-010133,2011,120500004,,,,4,10,14
HND-010134,2011,120500005,,,,12,6,18
HND-010135,2011,120500006,,,,11,8,19
HND-010138,2011,120500009,,,,13,10,23
HND-010142,2011,120500013,,,,7,5,12
HND-010144,2011,120500015,,,,9,6,15
HND-010152,2011,120500027,,,,3,3,6
HND-010153,2011,120500028,,,,6,7,13
HND-010157,2011,120500034,,,,5,6,11
HND-010163,2011,120500042,,,,1,2,3
HND-010136,2011,120500007,,,,5,7,12
HND-010137,2011,120500008,,,,6,8,14
HND-010139,2011,120500010,,,,3,1,4
HND-010140,2011,120500011,,,,2,2,4
HND-010141,2011,120500012,,,,10,5,15
HND-010143,2011,120500014,,,,9,8,17
HND-010146,2011,120500018,,,,7,9,16
HND-010154,2011,120500029,,,,3,5,8
HND-010156,2011,120500033,,,,4,2,6
HND-010165,2011,120500044,,,,3,0,3
HND-010135,2011,120500006,,,,7,7,14
HND-010136,2011,120500007,,,,8,4,12
HND-010139,2011,120500010,,,,7,12,19
HND-010140,2011,120500011,,,,1,3,4
HND-010142,2011,120500013,,,,4,4,8
HND-010143,2011,120500014,,,,8,7,15
HND-010146,2011,120500018,,,,9,5,14
HND-010153,2011,120500028,,,,4,0,4
HND-010154,2011,120500029,,,,3,1,4
HND-010133,2011,120500004,,,,2,8,10
HND-010134,2011,120500005,,,,9,6,15
HND-010137,2011,120500008,,,,15,4,19
HND-010138,2011,120500009,,,,9,9,18
HND-010141,2011,120500012,,,,6,3,9
HND-010144,2011,120500015,,,,7,12,19
HND-010152,2011,120500027,,,,2,2,4
HND-010156,2011,120500033,,,,5,4,9
HND-010157,2011,120500034,,,,3,2,5
HND-010163,2011,120500042,,,,2,1,3
HND-010165,2011,120500044,,,,2,3,5
HND-010135,2011,120500006,,,,7,6,13
HND-010136,2011,120500007,,,,8,5,13
HND-010137,2011,120500008,,,,12,8,20
HND-010139,2011,120500010,,,,6,9,15
HND-010140,2011,120500011,,,,0,1,1
HND-010141,2011,120500012,,,,7,6,13
HND-010142,2011,120500013,,,,7,8,15
HND-010143,2011,120500014,,,,9,9,18
HND-010146,2011,120500018,,,,9,7,16
HND-010154,2011,120500029,,,,3,4,7
HND-010133,2011,120500004,,,,5,5,10
HND-010134,2011,120500005,,,,10,8,18
HND-010138,2011,120500009,,,,7,5,12
HND-010144,2011,120500015,,,,14,9,23
HND-010152,2011,120500027,,,,4,4,8
HND-010153,2011,120500028,,,,6,6,12
HND-010156,2011,120500033,,,,4,3,7
HND-010157,2011,120500034,,,,1,4,5
HND-010163,2011,120500042,,,,2,3,5
HND-010165,2011,120500044,,,,1,5,6
HND-010134,2011,120500005,,,,8,14,22
HND-010137,2011,120500008,,,,4,6,10
HND-010139,2011,120500010,,,,2,1,3
HND-010141,2011,120500012,,,,5,7,12
HND-010143,2011,120500014,,,,11,8,19
HND-010144,2011,120500015,,,,10,11,21
HND-010146,2011,120500018,,,,7,8,15
HND-010152,2011,120500027,,,,3,7,10
HND-010154,2011,120500029,,,,1,3,4
HND-010156,2011,120500033,,,,2,3,5
HND-010163,2011,120500042,,,,3,3,6
HND-010165,2011,120500044,,,,4,4,8
HND-010133,2011,120500004,,,,5,7,12
HND-010135,2011,120500006,,,,17,8,25
HND-010136,2011,120500007,,,,6,6,12
HND-010138,2011,120500009,,,,9,12,21
HND-010140,2011,120500011,,,,1,2,3
HND-010142,2011,120500013,,,,6,7,13
HND-010153,2011,120500028,,,,5,1,6
HND-010157,2011,120500034,,,,3,4,7
HND-010133,2011,120500004,,,,10,19,29
HND-010134,2011,120500005,,,,32,32,64
HND-010133,2011,120500004,,,,14,14,28
HND-010134,2011,120500005,,,,19,17,36
HND-010133,2011,120500004,,,,9,11,20
HND-010134,2011,120500005,,,,24,25,49
HND-010201,2011,120600038,,,,5,3,8
HND-010202,2011,120600039,,,,1,4,5
HND-010211,2011,120600054,,,,14,17,31
HND-010213,2011,120600058,,,,6,16,22
,2011,120600064,,,,4,3,7
,2011,120600068,,,,2,4,6
HND-010219,2011,120600071,,,,3,5,8
,2011,120600073,,,,7,7,14
,2011,120600074,,,,4,2,6
,2011,120600077,,,,4,4,8
,2011,120600078,,,,6,2,8
,2011,120600080,,,,2,9,11
,2011,120600081,,,,5,4,9
HND-010221,2011,120600082,,,,6,2,8
HND-010224,2011,120600087,,,,1,4,5
HND-010200,2011,120600037,,,,4,2,6
,2011,120600055,,,,7,3,10
HND-010214,2011,120600061,,,,6,4,10
,2011,120600063,,,,0,5,5
HND-010216,2011,120600067,,,,5,6,11
,2011,120600072,,,,8,3,11
HND-010220,2011,120600076,,,,5,3,8
,2011,120600079,,,,6,4,10
,2011,120600085,,,,4,1,5
,2011,120600086,,,,6,3,9
,2011,120600133,,,,4,2,6
,2011,120600135,,,,5,6,11
,2011,120600136,,,,5,4,9
,2011,120600137,,,,4,3,7
,2011,120600138,,,,2,4,6
,2011,120600088,,,,1,1,2
,2011,120600002,,,,2,1,3
HND-010207,2011,120600045,,,,1,0,1
HND-010215,2011,120600062,,,,1,4,5
,2011,120600065,,,,4,2,6
,2011,120600088,,,,4,3,7
,2011,120600002,,,,3,4,7
HND-010206,2011,120600044,,,,4,11,15
HND-010207,2011,120600045,,,,9,10,19
HND-010215,2011,120600062,,,,6,2,8
,2011,120600065,,,,4,4,8
,2011,120600088,,,,1,3,4
HND-010208,2011,120600046,,,,9,10,19
,2011,120600056,,,,12,9,21
HND-010169,2011,120600004,,,,1,1,2
HND-010170,2011,120600005,,,,13,5,18
HND-010172,2011,120600007,,,,11,5,16
HND-010173,2011,120600008,,,,2,4,6
HND-010174,2011,120600009,,,,14,9,23
,2011,120600010,,,,1,2,3
HND-010176,2011,120600011,,,,3,3,6
HND-010177,2011,120600012,,,,4,4,8
HND-010179,2011,120600014,,,,6,1,7
HND-010180,2011,120600015,,,,10,5,15
HND-010183,2011,120600018,,,,3,1,4
HND-010187,2011,120600022,,,,10,7,17
,2011,120600025,,,,1,2,3
HND-010197,2011,120600033,,,,9,9,18
HND-010201,2011,120600038,,,,5,5,10
HND-010202,2011,120600039,,,,2,4,6
HND-010217,2011,120600069,,,,10,4,14
HND-010218,2011,120600070,,,,11,14,25
HND-010225,2011,120600152,,,,1,1,2
HND-010168,2011,120600003,,,,4,3,7
HND-010171,2011,120600006,,,,3,3,6
HND-010178,2011,120600013,,,,11,8,19
HND-010181,2011,120600016,,,,3,4,7
HND-010182,2011,120600017,,,,0,3,3
HND-010184,2011,120600019,,,,6,1,7
HND-010185,2011,120600020,,,,5,4,9
HND-010186,2011,120600021,,,,5,4,9
HND-010188,2011,120600023,,,,0,1,1
HND-010189,2011,120600024,,,,11,1,12
HND-010191,2011,120600026,,,,7,3,10
HND-010190,2011,120600026,,,,7,3,10
HND-010192,2011,120600027,,,,3,1,4
HND-010193,2011,120600028,,,,1,0,1
HND-010194,2011,120600030,,,,3,3,6
HND-010195,2011,120600031,,,,2,2,4
HND-010198,2011,120600034,,,,8,10,18
HND-010199,2011,120600035,,,,8,3,11
HND-010203,2011,120600040,,,,1,5,6
HND-010204,2011,120600041,,,,3,4,7
HND-010205,2011,120600042,,,,1,1,2
HND-010210,2011,120600051,,,,2,1,3
HND-010222,2011,120600083,,,,3,0,3
HND-010223,2011,120600084,,,,2,2,4
,2011,120600088,,,,2,2,4
HND-010168,2011,120600003,,,,2,2,4
HND-010169,2011,120600004,,,,2,1,3
HND-010172,2011,120600007,,,,9,10,19
HND-010173,2011,120600008,,,,5,5,10
,2011,120600010,,,,2,1,3
HND-010176,2011,120600011,,,,3,5,8
HND-010178,2011,120600013,,,,10,4,14
HND-010179,2011,120600014,,,,4,9,13
HND-010181,2011,120600016,,,,3,4,7
HND-010182,2011,120600017,,,,1,1,2
HND-010185,2011,120600020,,,,5,6,11
HND-010186,2011,120600021,,,,4,3,7
HND-010187,2011,120600022,,,,6,8,14
HND-010189,2011,120600024,,,,7,9,16
,2011,120600025,,,,3,3,6
HND-010193,2011,120600028,,,,1,2,3
HND-010194,2011,120600030,,,,3,5,8
HND-010196,2011,120600032,,,,0,4,4
HND-010199,2011,120600035,,,,3,3,6
HND-010201,2011,120600038,,,,3,3,6
HND-010202,2011,120600039,,,,1,2,3
HND-010205,2011,120600042,,,,0,2,2
HND-010210,2011,120600051,,,,3,5,8
HND-010218,2011,120600070,,,,6,16,22
HND-010223,2011,120600084,,,,2,5,7
,2011,120600088,,,,2,5,7
HND-010170,2011,120600005,,,,16,12,28
HND-010171,2011,120600006,,,,5,6,11
HND-010174,2011,120600009,,,,15,12,27
HND-010177,2011,120600012,,,,6,2,8
HND-010180,2011,120600015,,,,7,11,18
HND-010183,2011,120600018,,,,3,2,5
HND-010184,2011,120600019,,,,1,2,3
HND-010188,2011,120600023,,,,0,1,1
HND-010191,2011,120600026,,,,6,10,16
HND-010190,2011,120600026,,,,6,10,16
HND-010192,2011,120600027,,,,1,4,5
HND-010195,2011,120600031,,,,2,1,3
HND-010197,2011,120600033,,,,12,7,19
HND-010198,2011,120600034,,,,4,5,9
HND-010203,2011,120600040,,,,7,1,8
HND-010204,2011,120600041,,,,3,3,6
HND-010217,2011,120600069,,,,8,4,12
HND-010222,2011,120600083,,,,0,1,1
HND-010225,2011,120600152,,,,2,1,3
HND-010168,2011,120600003,,,,3,7,10
HND-010171,2011,120600006,,,,8,5,13
HND-010176,2011,120600011,,,,1,1,2
HND-010178,2011,120600013,,,,11,4,15
HND-010181,2011,120600016,,,,3,3,6
HND-010182,2011,120600017,,,,3,3,6
HND-010184,2011,120600019,,,,4,4,8
HND-010185,2011,120600020,,,,7,6,13
HND-010186,2011,120600021,,,,2,5,7
HND-010188,2011,120600023,,,,2,1,3
HND-010189,2011,120600024,,,,14,8,22
HND-010192,2011,120600027,,,,3,4,7
HND-010193,2011,120600028,,,,0,1,1
HND-010194,2011,120600030,,,,7,1,8
HND-010195,2011,120600031,,,,2,3,5
HND-010196,2011,120600032,,,,1,0,1
HND-010198,2011,120600034,,,,6,3,9
HND-010199,2011,120600035,,,,7,9,16
HND-010203,2011,120600040,,,,4,1,5
HND-010210,2011,120600051,,,,1,4,5
HND-010222,2011,120600083,,,,2,2,4
HND-010223,2011,120600084,,,,0,2,2
,2011,120600088,,,,0,2,2
HND-010169,2011,120600004,,,,0,1,1
HND-010170,2011,120600005,,,,12,10,22
HND-010172,2011,120600007,,,,5,4,9
HND-010173,2011,120600008,,,,7,2,9
HND-010174,2011,120600009,,,,13,11,24
,2011,120600010,,,,2,2,4
HND-010177,2011,120600012,,,,1,2,3
HND-010179,2011,120600014,,,,8,4,12
HND-010180,2011,120600015,,,,12,9,21
HND-010183,2011,120600018,,,,4,1,5
HND-010187,2011,120600022,,,,5,5,10
,2011,120600025,,,,3,5,8
HND-010191,2011,120600026,,,,3,5,8
HND-010190,2011,120600026,,,,3,5,8
HND-010197,2011,120600033,,,,3,6,9
HND-010201,2011,120600038,,,,6,4,10
HND-010202,2011,120600039,,,,1,0,1
HND-010204,2011,120600041,,,,4,1,5
HND-010217,2011,120600069,,,,7,6,13
HND-010218,2011,120600070,,,,14,5,19
HND-010225,2011,120600152,,,,1,2,3
HND-010169,2011,120600004,,,,5,2,7
HND-010172,2011,120600007,,,,9,10,19
HND-010173,2011,120600008,,,,6,3,9
HND-010176,2011,120600011,,,,6,9,15
HND-010177,2011,120600012,,,,4,5,9
HND-010178,2011,120600013,,,,5,5,10
HND-010179,2011,120600014,,,,7,3,10
HND-010182,2011,120600017,,,,1,1,2
HND-010183,2011,120600018,,,,2,2,4
HND-010185,2011,120600020,,,,8,9,17
HND-010187,2011,120600022,,,,2,5,7
HND-010189,2011,120600024,,,,9,13,22
,2011,120600025,,,,3,4,7
HND-010193,2011,120600028,,,,3,0,3
HND-010196,2011,120600032,,,,2,2,4
HND-010199,2011,120600035,,,,3,2,5
HND-010201,2011,120600038,,,,2,5,7
HND-010202,2011,120600039,,,,0,3,3
HND-010217,2011,120600069,,,,4,7,11
HND-010218,2011,120600070,,,,10,11,21
HND-010223,2011,120600084,,,,4,1,5
,2011,120600088,,,,4,1,5
HND-010168,2011,120600003,,,,4,4,8
HND-010170,2011,120600005,,,,11,19,30
HND-010171,2011,120600006,,,,6,6,12
HND-010174,2011,120600009,,,,10,10,20
HND-010180,2011,120600015,,,,10,10,20
HND-010181,2011,120600016,,,,0,2,2
HND-010184,2011,120600019,,,,1,4,5
HND-010186,2011,120600021,,,,2,2,4
HND-010188,2011,120600023,,,,0,2,2
HND-010191,2011,120600026,,,,6,2,8
HND-010190,2011,120600026,,,,6,2,8
HND-010192,2011,120600027,,,,3,4,7
HND-010194,2011,120600030,,,,5,2,7
HND-010195,2011,120600031,,,,2,2,4
HND-010197,2011,120600033,,,,7,6,13
HND-010198,2011,120600034,,,,4,6,10
HND-010203,2011,120600040,,,,6,2,8
HND-010204,2011,120600041,,,,2,3,5
HND-010205,2011,120600042,,,,1,2,3
HND-010210,2011,120600051,,,,4,1,5
HND-010222,2011,120600083,,,,2,3,5
HND-010225,2011,120600152,,,,1,4,5
HND-010168,2011,120600003,,,,2,3,5
HND-010171,2011,120600006,,,,3,6,9
HND-010174,2011,120600009,,,,5,11,16
HND-010178,2011,120600013,,,,1,9,10
HND-010180,2011,120600015,,,,6,7,13
HND-010181,2011,120600016,,,,0,3,3
HND-010184,2011,120600019,,,,2,3,5
HND-010185,2011,120600020,,,,6,6,12
HND-010186,2011,120600021,,,,4,5,9
HND-010188,2011,120600023,,,,1,2,3
HND-010189,2011,120600024,,,,12,8,20
HND-010191,2011,120600026,,,,6,3,9
HND-010190,2011,120600026,,,,6,3,9
HND-010192,2011,120600027,,,,1,0,1
HND-010197,2011,120600033,,,,6,4,10
HND-010199,2011,120600035,,,,4,3,7
HND-010201,2011,120600038,,,,3,5,8
HND-010202,2011,120600039,,,,3,1,4
HND-010218,2011,120600070,,,,14,8,22
,2011,120600088,,,,2,5,7
HND-010169,2011,120600004,,,,3,1,4
HND-010170,2011,120600005,,,,23,18,41
HND-010172,2011,120600007,,,,6,7,13
HND-010173,2011,120600008,,,,6,5,11
,2011,120600010,,,,3,2,5
HND-010176,2011,120600011,,,,1,4,5
HND-010177,2011,120600012,,,,2,5,7
HND-010179,2011,120600014,,,,4,2,6
HND-010182,2011,120600017,,,,3,1,4
HND-010183,2011,120600018,,,,2,5,7
HND-010187,2011,120600022,,,,3,4,7
,2011,120600025,,,,6,2,8
HND-010193,2011,120600028,,,,2,0,2
HND-010194,2011,120600030,,,,5,5,10
HND-010195,2011,120600031,,,,1,4,5
HND-010196,2011,120600032,,,,0,3,3
HND-010198,2011,120600034,,,,5,0,5
HND-010204,2011,120600041,,,,0,5,5
HND-010205,2011,120600042,,,,2,0,2
HND-010210,2011,120600051,,,,6,5,11
HND-010217,2011,120600069,,,,5,9,14
HND-010222,2011,120600083,,,,4,1,5
HND-010223,2011,120600084,,,,2,5,7
HND-010225,2011,120600152,,,,1,1,2
HND-010168,2011,120600003,,,,5,1,6
HND-010172,2011,120600007,,,,8,9,17
HND-010173,2011,120600008,,,,2,5,7
,2011,120600010,,,,4,3,7
HND-010176,2011,120600011,,,,2,4,6
HND-010178,2011,120600013,,,,8,4,12
HND-010179,2011,120600014,,,,7,2,9
HND-010181,2011,120600016,,,,0,4,4
HND-010182,2011,120600017,,,,1,2,3
HND-010185,2011,120600020,,,,6,8,14
HND-010186,2011,120600021,,,,4,4,8
HND-010187,2011,120600022,,,,1,5,6
HND-010189,2011,120600024,,,,8,9,17
,2011,120600025,,,,4,7,11
HND-010193,2011,120600028,,,,0,3,3
HND-010195,2011,120600031,,,,3,2,5
HND-010197,2011,120600033,,,,1,2,3
HND-010198,2011,120600034,,,,3,3,6
HND-010203,2011,120600040,,,,1,4,5
HND-010204,2011,120600041,,,,5,1,6
HND-010222,2011,120600083,,,,1,1,2
HND-010225,2011,120600152,,,,1,2,3
HND-010170,2011,120600005,,,,19,12,31
HND-010171,2011,120600006,,,,7,6,13
HND-010174,2011,120600009,,,,7,12,19
HND-010177,2011,120600012,,,,3,4,7
HND-010180,2011,120600015,,,,5,7,12
HND-010183,2011,120600018,,,,1,1,2
HND-010184,2011,120600019,,,,1,6,7
HND-010191,2011,120600026,,,,3,3,6
HND-010190,2011,120600026,,,,3,3,6
HND-010192,2011,120600027,,,,7,0,7
HND-010194,2011,120600030,,,,5,2,7
HND-010196,2011,120600032,,,,0,3,3
HND-010199,2011,120600035,,,,3,4,7
HND-010201,2011,120600038,,,,3,1,4
HND-010202,2011,120600039,,,,1,4,5
HND-010205,2011,120600042,,,,3,1,4
HND-010210,2011,120600051,,,,2,2,4
HND-010217,2011,120600069,,,,9,14,23
HND-010218,2011,120600070,,,,7,6,13
HND-010223,2011,120600084,,,,2,4,6
,2011,120600088,,,,2,4,6
HND-010170,2011,120600005,,,,26,32,58
HND-010180,2011,120600015,,,,32,18,50
HND-010209,2011,120600047,,,,27,23,50
HND-010217,2011,120600069,,,,16,13,29
HND-010171,2011,120600006,,,,8,14,22
HND-010174,2011,120600009,,,,6,6,12
HND-010186,2011,120600021,,,,12,10,22
HND-010170,2011,120600005,,,,23,25,48
HND-010171,2011,120600006,,,,9,6,15
HND-010174,2011,120600009,,,,2,4,6
HND-010180,2011,120600015,,,,16,12,28
HND-010217,2011,120600069,,,,18,9,27
HND-010186,2011,120600021,,,,7,6,13
HND-010209,2011,120600047,,,,17,20,37
HND-010217,2011,120600069,,,,14,13,27
HND-010170,2011,120600005,,,,18,23,41
HND-010171,2011,120600006,,,,9,11,20
HND-010174,2011,120600009,,,,8,8,16
HND-010180,2011,120600015,,,,16,5,21
HND-010186,2011,120600021,,,,9,3,12
HND-010209,2011,120600047,,,,17,12,29
HND-010209,2011,120600047,,,,23,10,33
HND-010209,2011,120600047,,,,11,10,21
HND-010209,2011,120600047,,,,1,4,5
HND-010239,2011,120700027,,,,7,3,10
,2011,120700028,,,,5,2,7
,2011,120700030,,,,2,2,4
,2011,120700031,,,,4,8,12
,2011,120700029,,,,1,3,4
HND-010236,2011,120700011,,,,3,1,4
HND-010237,2011,120700012,,,,1,1,2
HND-010236,2011,120700011,,,,4,3,7
HND-010237,2011,120700012,,,,6,8,14
HND-010227,2011,120700001,,,,12,3,15
HND-010228,2011,120700002,,,,0,4,4
HND-010230,2011,120700004,,,,2,1,3
HND-010231,2011,120700005,,,,8,7,15
HND-010234,2011,120700008,,,,3,3,6
HND-010235,2011,120700009,,,,3,1,4
,2011,120700010,,,,2,2,4
HND-010238,2011,120700013,,,,0,1,1
HND-010229,2011,120700003,,,,3,5,8
HND-010232,2011,120700006,,,,1,2,3
HND-010233,2011,120700007,,,,0,1,1
HND-010228,2011,120700002,,,,2,2,4
HND-010229,2011,120700003,,,,6,4,10
HND-010230,2011,120700004,,,,3,2,5
HND-010233,2011,120700007,,,,3,1,4
HND-010234,2011,120700008,,,,3,4,7
HND-010238,2011,120700013,,,,1,1,2
HND-010227,2011,120700001,,,,6,4,10
HND-010231,2011,120700005,,,,9,6,15
HND-010232,2011,120700006,,,,5,1,6
HND-010235,2011,120700009,,,,0,1,1
HND-010229,2011,120700003,,,,1,5,6
HND-010232,2011,120700006,,,,4,0,4
HND-010233,2011,120700007,,,,2,0,2
HND-010227,2011,120700001,,,,4,4,8
HND-010228,2011,120700002,,,,5,1,6
HND-010230,2011,120700004,,,,3,2,5
HND-010231,2011,120700005,,,,9,8,17
HND-010234,2011,120700008,,,,3,3,6
HND-010235,2011,120700009,,,,1,1,2
,2011,120700010,,,,1,0,1
HND-010238,2011,120700013,,,,2,1,3
HND-010227,2011,120700001,,,,8,9,17
HND-010228,2011,120700002,,,,3,1,4
HND-010230,2011,120700004,,,,3,5,8
HND-010234,2011,120700008,,,,2,4,6
HND-010229,2011,120700003,,,,7,0,7
HND-010231,2011,120700005,,,,9,9,18
HND-010232,2011,120700006,,,,2,6,8
HND-010233,2011,120700007,,,,2,1,3
,2011,120700010,,,,1,1,2
HND-010227,2011,120700001,,,,6,7,13
HND-010228,2011,120700002,,,,2,4,6
HND-010230,2011,120700004,,,,6,4,10
HND-010231,2011,120700005,,,,5,5,10
HND-010234,2011,120700008,,,,2,2,4
HND-010238,2011,120700013,,,,2,0,2
HND-010229,2011,120700003,,,,4,3,7
HND-010232,2011,120700006,,,,2,4,6
,2011,120700010,,,,0,1,1
HND-010227,2011,120700001,,,,4,7,11
HND-010231,2011,120700005,,,,8,13,21
HND-010232,2011,120700006,,,,3,4,7
HND-010235,2011,120700009,,,,1,2,3
,2011,120700010,,,,2,1,3
HND-010228,2011,120700002,,,,0,1,1
HND-010229,2011,120700003,,,,3,4,7
HND-010230,2011,120700004,,,,5,8,13
HND-010233,2011,120700007,,,,2,0,2
HND-010234,2011,120700008,,,,3,7,10
HND-010238,2011,120700013,,,,1,0,1
HND-010227,2011,120700001,,,,14,15,29
HND-010227,2011,120700001,,,,12,8,20
HND-010227,2011,120700001,,,,19,7,26
HND-010250,2011,120800015,,,,2,11,13
HND-010251,2011,120800016,,,,14,9,23
HND-010254,2011,120800019,,,,4,6,10
HND-010275,2011,120800041,,,,3,3,6
HND-010276,2011,120800042,,,,7,6,13
HND-010293,2011,120800066,,,,10,7,17
,2011,120800069,,,,9,11,20
,2011,120800072,,,,0,6,6
,2011,120800075,,,,7,5,12
HND-010295,2011,120800076,,,,4,7,11
,2011,120800079,,,,6,5,11
,2011,120800080,,,,3,5,8
,2011,120800082,,,,4,2,6
,2011,120800084,,,,7,8,15
,2011,120800085,,,,3,5,8
HND-010298,2011,120800088,,,,2,9,11
,2011,120800089,,,,10,5,15
HND-010301,2011,120800094,,,,4,7,11
,2011,120800144,,,,6,4,10
HND-010303,2011,120800148,,,,6,8,14
HND-010305,2011,120800152,,,,5,6,11
HND-010307,2011,120800154,,,,4,9,13
HND-010246,2011,120800010,,,,6,4,10
HND-010247,2011,120800012,,,,6,4,10
HND-010249,2011,120800014,,,,3,9,12
,2011,120800078,,,,4,7,11
,2011,120800086,,,,10,7,17
,2011,120800087,,,,8,5,13
,2011,120800091,,,,7,3,10
,2011,120800096,,,,3,2,5
,2011,120800142,,,,7,11,18
HND-010304,2011,120800151,,,,3,6,9
HND-010306,2011,120800153,,,,4,1,5
HND-010278,2011,120800046,,,,7,10,17
HND-010285,2011,120800057,,,,1,3,4
HND-010287,2011,120800059,,,,1,1,2
HND-010296,2011,120800077,,,,5,2,7
,2011,120800149,,,,1,1,2
,2011,120800003,,,,0,1,1
,2011,120800039,,,,1,0,1
HND-010281,2011,120800050,,,,3,2,5
,2011,120800150,,,,1,4,5
HND-010240,2011,120800002,,,,6,4,10
,2011,120800003,,,,3,1,4
HND-010272,2011,120800037,,,,7,5,12
,2011,120800039,,,,3,4,7
HND-010278,2011,120800046,,,,7,5,12
,2011,120800052,,,,1,1,2
HND-010283,2011,120800054,,,,10,10,20
HND-010284,2011,120800055,,,,4,0,4
HND-010287,2011,120800059,,,,3,1,4
HND-010294,2011,120800067,,,,2,2,4
,2011,120800149,,,,1,1,2
,2011,120800150,,,,14,9,23
HND-010277,2011,120800043,,,,2,4,6
HND-010279,2011,120800048,,,,14,14,28
HND-010280,2011,120800049,,,,5,3,8
HND-010281,2011,120800050,,,,3,3,6
,2011,120800056,,,,4,4,8
HND-010285,2011,120800057,,,,4,5,9
HND-010286,2011,120800058,,,,6,4,10
HND-010292,2011,120800064,,,,1,1,2
HND-010296,2011,120800077,,,,2,0,2
HND-010299,2011,120800092,,,,3,3,6
HND-010300,2011,120800093,,,,2,6,8
HND-010240,2011,120800002,,,,4,6,10
,2011,120800039,,,,3,7,10
HND-010277,2011,120800043,,,,3,4,7
HND-010278,2011,120800046,,,,5,7,12
HND-010279,2011,120800048,,,,45,33,78
HND-010280,2011,120800049,,,,12,12,24
HND-010281,2011,120800050,,,,4,3,7
HND-010285,2011,120800057,,,,5,6,11
HND-010286,2011,120800058,,,,4,6,10
HND-010296,2011,120800077,,,,2,3,5
HND-010299,2011,120800092,,,,6,5,11
HND-010300,2011,120800093,,,,6,3,9
,2011,120800156,,,,3,2,5
,2011,120800003,,,,0,1,1
HND-010272,2011,120800037,,,,6,3,9
,2011,120800052,,,,5,6,11
HND-010283,2011,120800054,,,,26,39,65
HND-010284,2011,120800055,,,,9,5,14
,2011,120800056,,,,4,8,12
HND-010287,2011,120800059,,,,3,3,6
HND-010292,2011,120800064,,,,9,6,15
HND-010294,2011,120800067,,,,28,23,51
,2011,120800149,,,,2,2,4
,2011,120800150,,,,7,2,9
HND-010242,2011,120800006,,,,51,41,92
HND-010243,2011,120800007,,,,6,3,9
HND-010247,2011,120800012,,,,7,3,10
HND-010250,2011,120800015,,,,6,6,12
HND-010254,2011,120800019,,,,6,5,11
HND-010256,2011,120800021,,,,4,11,15
HND-010258,2011,120800023,,,,9,5,14
HND-010259,2011,120800024,,,,2,6,8
HND-010261,2011,120800026,,,,16,16,32
HND-010262,2011,120800027,,,,4,2,6
HND-010264,2011,120800029,,,,8,2,10
HND-010266,2011,120800031,,,,4,2,6
HND-010267,2011,120800032,,,,12,8,20
HND-010268,2011,120800033,,,,8,3,11
HND-010271,2011,120800036,,,,6,4,10
HND-010272,2011,120800037,,,,5,5,10
,2011,120800039,,,,6,4,10
HND-010274,2011,120800040,,,,4,4,8
HND-010275,2011,120800041,,,,3,1,4
HND-010277,2011,120800043,,,,7,2,9
HND-010281,2011,120800050,,,,2,6,8
,2011,120800052,,,,5,3,8
HND-010286,2011,120800058,,,,4,5,9
HND-010287,2011,120800059,,,,1,3,4
HND-010290,2011,120800062,,,,3,1,4
HND-010302,2011,120800141,,,,0,2,2
,2011,120800150,,,,4,5,9
HND-010308,2011,120800155,,,,2,1,3
,2011,120800156,,,,9,3,12
HND-010240,2011,120800002,,,,4,5,9
HND-010241,2011,120800005,,,,3,7,10
HND-010244,2011,120800008,,,,61,45,106
HND-010245,2011,120800009,,,,3,8,11
HND-010246,2011,120800010,,,,3,1,4
HND-010248,2011,120800013,,,,5,5,10
HND-010249,2011,120800014,,,,3,2,5
HND-010251,2011,120800016,,,,12,13,25
HND-010252,2011,120800017,,,,12,9,21
HND-010253,2011,120800018,,,,12,14,26
HND-010255,2011,120800020,,,,9,7,16
HND-010257,2011,120800022,,,,2,4,6
HND-010260,2011,120800025,,,,4,7,11
HND-010263,2011,120800028,,,,1,3,4
HND-010265,2011,120800030,,,,18,14,32
HND-010269,2011,120800034,,,,2,7,9
HND-010270,2011,120800035,,,,8,3,11
HND-010273,2011,120800038,,,,2,1,3
HND-010276,2011,120800042,,,,2,2,4
HND-010285,2011,120800057,,,,6,7,13
HND-010289,2011,120800061,,,,4,2,6
HND-010291,2011,120800063,,,,6,6,12
HND-010293,2011,120800066,,,,10,7,17
HND-010296,2011,120800077,,,,1,6,7
HND-010297,2011,120800083,,,,4,3,7
,2011,120800116,,,,2,2,4
HND-010240,2011,120800002,,,,3,9,12
HND-010242,2011,120800006,,,,48,50,98
HND-010248,2011,120800013,,,,3,9,12
HND-010251,2011,120800016,,,,4,7,11
HND-010252,2011,120800017,,,,13,14,27
HND-010254,2011,120800019,,,,4,4,8
HND-010255,2011,120800020,,,,6,4,10
HND-010256,2011,120800021,,,,4,7,11
HND-010257,2011,120800022,,,,2,2,4
HND-010259,2011,120800024,,,,7,5,12
HND-010261,2011,120800026,,,,15,16,31
HND-010262,2011,120800027,,,,3,3,6
HND-010263,2011,120800028,,,,4,1,5
HND-010264,2011,120800029,,,,9,6,15
HND-010265,2011,120800030,,,,15,15,30
HND-010267,2011,120800032,,,,5,13,18
HND-010270,2011,120800035,,,,6,4,10
HND-010271,2011,120800036,,,,5,9,14
,2011,120800039,,,,8,12,20
HND-010277,2011,120800043,,,,6,2,8
HND-010281,2011,120800050,,,,4,9,13
HND-010285,2011,120800057,,,,6,7,13
HND-010286,2011,120800058,,,,3,9,12
HND-010290,2011,120800062,,,,4,1,5
HND-010293,2011,120800066,,,,4,7,11
HND-010296,2011,120800077,,,,7,4,11
HND-010297,2011,120800083,,,,5,4,9
,2011,120800156,,,,3,2,5
HND-010241,2011,120800005,,,,5,6,11
HND-010243,2011,120800007,,,,6,6,12
HND-010244,2011,120800008,,,,39,49,88
HND-010245,2011,120800009,,,,12,10,22
HND-010246,2011,120800010,,,,5,3,8
HND-010247,2011,120800012,,,,3,2,5
HND-010249,2011,120800014,,,,3,3,6
HND-010250,2011,120800015,,,,4,2,6
HND-010253,2011,120800018,,,,10,10,20
HND-010258,2011,120800023,,,,9,4,13
HND-010260,2011,120800025,,,,4,5,9
HND-010266,2011,120800031,,,,7,6,13
HND-010268,2011,120800033,,,,9,3,12
HND-010269,2011,120800034,,,,3,4,7
HND-010272,2011,120800037,,,,3,1,4
HND-010273,2011,120800038,,,,3,1,4
HND-010274,2011,120800040,,,,5,4,9
HND-010275,2011,120800041,,,,2,0,2
HND-010276,2011,120800042,,,,1,0,1
,2011,120800052,,,,6,3,9
HND-010287,2011,120800059,,,,0,1,1
HND-010289,2011,120800061,,,,8,7,15
HND-010291,2011,120800063,,,,1,7,8
,2011,120800116,,,,1,0,1
HND-010302,2011,120800141,,,,2,0,2
,2011,120800150,,,,2,3,5
HND-010308,2011,120800155,,,,3,0,3
HND-010240,2011,120800002,,,,6,7,13
HND-010241,2011,120800005,,,,2,5,7
HND-010244,2011,120800008,,,,40,45,85
HND-010245,2011,120800009,,,,8,5,13
HND-010246,2011,120800010,,,,3,5,8
HND-010248,2011,120800013,,,,6,8,14
HND-010249,2011,120800014,,,,4,0,4
HND-010252,2011,120800017,,,,9,10,19
HND-010253,2011,120800018,,,,15,14,29
HND-010257,2011,120800022,,,,7,3,10
HND-010260,2011,120800025,,,,4,10,14
HND-010263,2011,120800028,,,,2,2,4
HND-010265,2011,120800030,,,,13,11,24
HND-010270,2011,120800035,,,,4,4,8
HND-010273,2011,120800038,,,,4,2,6
HND-010276,2011,120800042,,,,2,3,5
HND-010285,2011,120800057,,,,9,5,14
HND-010289,2011,120800061,,,,7,5,12
HND-010291,2011,120800063,,,,9,5,14
HND-010293,2011,120800066,,,,1,3,4
HND-010296,2011,120800077,,,,3,1,4
HND-010297,2011,120800083,,,,5,0,5
,2011,120800116,,,,2,3,5
HND-010242,2011,120800006,,,,53,54,107
HND-010243,2011,120800007,,,,7,7,14
HND-010247,2011,120800012,,,,1,5,6
HND-010250,2011,120800015,,,,2,8,10
HND-010251,2011,120800016,,,,16,15,31
HND-010254,2011,120800019,,,,5,4,9
HND-010255,2011,120800020,,,,6,4,10
HND-010256,2011,120800021,,,,13,3,16
HND-010258,2011,120800023,,,,8,8,16
HND-010259,2011,120800024,,,,4,4,8
HND-010261,2011,120800026,,,,17,18,35
HND-010262,2011,120800027,,,,0,2,2
HND-010264,2011,120800029,,,,4,6,10
HND-010266,2011,120800031,,,,8,5,13
HND-010267,2011,120800032,,,,9,3,12
HND-010268,2011,120800033,,,,2,0,2
HND-010269,2011,120800034,,,,5,8,13
HND-010271,2011,120800036,,,,2,2,4
HND-010272,2011,120800037,,,,5,3,8
,2011,120800039,,,,12,7,19
HND-010274,2011,120800040,,,,2,0,2
HND-010275,2011,120800041,,,,2,0,2
HND-010277,2011,120800043,,,,5,4,9
HND-010281,2011,120800050,,,,6,4,10
,2011,120800052,,,,6,5,11
HND-010286,2011,120800058,,,,6,7,13
HND-010287,2011,120800059,,,,2,2,4
HND-010290,2011,120800062,,,,5,2,7
HND-010302,2011,120800141,,,,3,5,8
,2011,120800150,,,,3,2,5
,2011,120800156,,,,4,3,7
HND-010240,2011,120800002,,,,3,6,9
HND-010241,2011,120800005,,,,7,4,11
HND-010242,2011,120800006,,,,41,57,98
HND-010248,2011,120800013,,,,7,9,16
HND-010251,2011,120800016,,,,9,6,15
HND-010252,2011,120800017,,,,7,12,19
HND-010254,2011,120800019,,,,4,4,8
HND-010255,2011,120800020,,,,11,10,21
HND-010256,2011,120800021,,,,7,1,8
HND-010257,2011,120800022,,,,3,6,9
HND-010259,2011,120800024,,,,2,4,6
HND-010260,2011,120800025,,,,7,7,14
HND-010261,2011,120800026,,,,17,18,35
HND-010263,2011,120800028,,,,2,6,8
HND-010265,2011,120800030,,,,26,18,44
HND-010267,2011,120800032,,,,13,16,29
HND-010268,2011,120800033,,,,7,3,10
HND-010271,2011,120800036,,,,6,5,11
HND-010272,2011,120800037,,,,7,3,10
,2011,120800039,,,,13,7,20
HND-010275,2011,120800041,,,,2,0,2
HND-010277,2011,120800043,,,,5,2,7
HND-010281,2011,120800050,,,,5,7,12
HND-010286,2011,120800058,,,,3,6,9
HND-010291,2011,120800063,,,,5,6,11
HND-010293,2011,120800066,,,,6,4,10
HND-010297,2011,120800083,,,,4,1,5
,2011,120800150,,,,0,3,3
HND-010308,2011,120800155,,,,2,2,4
,2011,120800156,,,,1,1,2
HND-010243,2011,120800007,,,,6,2,8
HND-010244,2011,120800008,,,,37,50,87
HND-010245,2011,120800009,,,,8,7,15
HND-010246,2011,120800010,,,,7,3,10
HND-010247,2011,120800012,,,,6,4,10
HND-010249,2011,120800014,,,,4,6,10
HND-010250,2011,120800015,,,,4,2,6
HND-010253,2011,120800018,,,,16,12,28
HND-010258,2011,120800023,,,,9,9,18
HND-010262,2011,120800027,,,,2,3,5
HND-010264,2011,120800029,,,,5,6,11
HND-010266,2011,120800031,,,,4,3,7
HND-010269,2011,120800034,,,,1,3,4
HND-010270,2011,120800035,,,,5,7,12
HND-010273,2011,120800038,,,,2,4,6
HND-010274,2011,120800040,,,,2,5,7
HND-010276,2011,120800042,,,,0,1,1
,2011,120800052,,,,5,5,10
HND-010285,2011,120800057,,,,11,4,15
HND-010287,2011,120800059,,,,6,3,9
HND-010289,2011,120800061,,,,5,4,9
HND-010290,2011,120800062,,,,5,0,5
HND-010296,2011,120800077,,,,1,3,4
,2011,120800116,,,,0,1,1
HND-010302,2011,120800141,,,,0,2,2
HND-010240,2011,120800002,,,,6,11,17
HND-010241,2011,120800005,,,,3,9,12
HND-010242,2011,120800006,,,,55,40,95
HND-010244,2011,120800008,,,,54,52,106
HND-010245,2011,120800009,,,,7,7,14
HND-010248,2011,120800013,,,,9,10,19
HND-010249,2011,120800014,,,,3,2,5
HND-010251,2011,120800016,,,,6,10,16
HND-010252,2011,120800017,,,,7,9,16
HND-010255,2011,120800020,,,,14,8,22
HND-010257,2011,120800022,,,,2,4,6
HND-010259,2011,120800024,,,,5,3,8
HND-010260,2011,120800025,,,,5,7,12
HND-010261,2011,120800026,,,,14,22,36
HND-010263,2011,120800028,,,,2,1,3
HND-010266,2011,120800031,,,,6,4,10
HND-010267,2011,120800032,,,,10,10,20
HND-010268,2011,120800033,,,,5,4,9
HND-010271,2011,120800036,,,,4,2,6
HND-010272,2011,120800037,,,,3,3,6
,2011,120800039,,,,15,13,28
HND-010274,2011,120800040,,,,4,5,9
HND-010277,2011,120800043,,,,10,4,14
HND-010281,2011,120800050,,,,8,6,14
,2011,120800052,,,,4,4,8
HND-010286,2011,120800058,,,,6,11,17
HND-010289,2011,120800061,,,,1,5,6
HND-010291,2011,120800063,,,,11,9,20
HND-010293,2011,120800066,,,,2,5,7
,2011,120800150,,,,1,2,3
HND-010308,2011,120800155,,,,0,2,2
,2011,120800156,,,,6,3,9
HND-010243,2011,120800007,,,,8,3,11
HND-010246,2011,120800010,,,,7,6,13
HND-010247,2011,120800012,,,,4,3,7
HND-010250,2011,120800015,,,,3,6,9
HND-010253,2011,120800018,,,,16,11,27
HND-010254,2011,120800019,,,,3,8,11
HND-010256,2011,120800021,,,,7,8,15
HND-010258,2011,120800023,,,,8,7,15
HND-010262,2011,120800027,,,,1,2,3
HND-010264,2011,120800029,,,,4,5,9
HND-010265,2011,120800030,,,,15,12,27
HND-010269,2011,120800034,,,,4,7,11
HND-010270,2011,120800035,,,,5,5,10
HND-010273,2011,120800038,,,,1,5,6
HND-010276,2011,120800042,,,,2,6,8
HND-010285,2011,120800057,,,,7,6,13
HND-010287,2011,120800059,,,,2,4,6
HND-010290,2011,120800062,,,,2,4,6
HND-010296,2011,120800077,,,,5,4,9
HND-010297,2011,120800083,,,,3,3,6
,2011,120800116,,,,2,6,8
HND-010302,2011,120800141,,,,1,2,3
HND-010241,2011,120800005,,,,4,4,8
HND-010243,2011,120800007,,,,2,6,8
HND-010244,2011,120800008,,,,26,40,66
HND-010245,2011,120800009,,,,2,9,11
HND-010246,2011,120800010,,,,3,2,5
HND-010247,2011,120800012,,,,3,3,6
HND-010249,2011,120800014,,,,1,4,5
HND-010250,2011,120800015,,,,4,1,5
HND-010253,2011,120800018,,,,19,9,28
HND-010258,2011,120800023,,,,6,10,16
HND-010260,2011,120800025,,,,4,9,13
HND-010266,2011,120800031,,,,4,2,6
HND-010268,2011,120800033,,,,5,6,11
HND-010269,2011,120800034,,,,4,4,8
HND-010272,2011,120800037,,,,7,3,10
HND-010273,2011,120800038,,,,1,1,2
,2011,120800039,,,,6,7,13
HND-010274,2011,120800040,,,,2,0,2
HND-010275,2011,120800041,,,,3,1,4
HND-010276,2011,120800042,,,,1,0,1
,2011,120800052,,,,2,9,11
HND-010287,2011,120800059,,,,1,1,2
HND-010289,2011,120800061,,,,2,2,4
HND-010291,2011,120800063,,,,2,5,7
,2011,120800116,,,,1,0,1
HND-010302,2011,120800141,,,,2,1,3
,2011,120800150,,,,4,2,6
HND-010308,2011,120800155,,,,1,1,2
HND-010240,2011,120800002,,,,7,8,15
HND-010242,2011,120800006,,,,44,58,102
HND-010248,2011,120800013,,,,9,7,16
HND-010251,2011,120800016,,,,1,7,8
HND-010252,2011,120800017,,,,8,6,14
HND-010254,2011,120800019,,,,6,4,10
HND-010255,2011,120800020,,,,11,6,17
HND-010256,2011,120800021,,,,4,9,13
HND-010257,2011,120800022,,,,2,2,4
HND-010259,2011,120800024,,,,3,5,8
HND-010261,2011,120800026,,,,15,15,30
HND-010262,2011,120800027,,,,2,2,4
HND-010263,2011,120800028,,,,2,5,7
HND-010264,2011,120800029,,,,5,2,7
HND-010265,2011,120800030,,,,17,19,36
HND-010267,2011,120800032,,,,4,7,11
HND-010270,2011,120800035,,,,7,6,13
HND-010271,2011,120800036,,,,1,2,3
HND-010277,2011,120800043,,,,5,6,11
HND-010281,2011,120800050,,,,6,7,13
HND-010285,2011,120800057,,,,9,4,13
HND-010286,2011,120800058,,,,8,8,16
HND-010290,2011,120800062,,,,2,1,3
HND-010293,2011,120800066,,,,6,6,12
HND-010296,2011,120800077,,,,1,2,3
HND-010297,2011,120800083,,,,2,0,2
,2011,120800156,,,,2,1,3
,2011,120800004,,,,72,44,116
HND-010252,2011,120800017,,,,7,7,14
HND-010253,2011,120800018,,,,15,15,30
HND-010255,2011,120800020,,,,6,15,21
HND-010257,2011,120800022,,,,2,9,11
HND-010259,2011,120800024,,,,12,11,23
,2011,120800039,,,,9,20,29
HND-010282,2011,120800051,,,,210,199,409
,2011,120800052,,,,8,1,9
HND-010291,2011,120800063,,,,11,5,16
,2011,120800156,,,,7,9,16
,2011,120800004,,,,41,39,80
HND-010252,2011,120800017,,,,3,7,10
HND-010255,2011,120800020,,,,14,5,19
HND-010257,2011,120800022,,,,3,6,9
HND-010259,2011,120800024,,,,7,5,12
,2011,120800039,,,,10,7,17
HND-010282,2011,120800051,,,,111,143,254
,2011,120800052,,,,5,8,13
,2011,120800156,,,,6,10,16
HND-010253,2011,120800018,,,,19,10,29
HND-010291,2011,120800063,,,,6,6,12
,2011,120800150,,,,1,0,1
,2011,120800004,,,,45,45,90
HND-010252,2011,120800017,,,,4,4,8
HND-010255,2011,120800020,,,,6,2,8
HND-010257,2011,120800022,,,,2,4,6
HND-010259,2011,120800024,,,,6,10,16
,2011,120800039,,,,11,17,28
HND-010282,2011,120800051,,,,124,142,266
,2011,120800052,,,,8,10,18
HND-010291,2011,120800063,,,,4,2,6
,2011,120800150,,,,1,2,3
,2011,120800156,,,,6,6,12
HND-010253,2011,120800018,,,,10,13,23
,2011,120800004,,,,11,6,17
,2011,120800039,,,,22,18,40
HND-010282,2011,120800051,,,,153,247,400
,2011,120800156,,,,18,26,44
,2011,120800052,,,,3,2,5
,2011,120800039,,,,14,16,30
HND-010282,2011,120800051,,,,99,137,236
,2011,120800156,,,,16,21,37
,2011,120800052,,,,7,3,10
,2011,120800039,,,,5,11,16
HND-010282,2011,120800051,,,,59,81,140
,2011,120800156,,,,4,3,7
HND-010322,2011,120900026,,,,4,8,12
HND-010310,2011,120900001,,,,3,1,4
,2011,120900013,,,,1,0,1
HND-010310,2011,120900001,,,,2,2,4
,2011,120900013,,,,1,2,3
,2011,120900013,,,,1,6,7
HND-010312,2011,120900003,,,,0,2,2
HND-010313,2011,120900004,,,,1,0,1
HND-010315,2011,120900007,,,,2,0,2
HND-010316,2011,120900008,,,,3,1,4
HND-010311,2011,120900002,,,,4,2,6
HND-010314,2011,120900005,,,,5,3,8
HND-010317,2011,120900009,,,,3,3,6
HND-010318,2011,120900010,,,,2,1,3
HND-010319,2011,120900011,,,,2,3,5
HND-010320,2011,120900012,,,,3,2,5
HND-010321,2011,120900014,,,,0,2,2
HND-010311,2011,120900002,,,,4,2,6
HND-010312,2011,120900003,,,,1,1,2
HND-010315,2011,120900007,,,,2,2,4
HND-010317,2011,120900009,,,,3,1,4
HND-010318,2011,120900010,,,,1,2,3
HND-010320,2011,120900012,,,,5,2,7
HND-010313,2011,120900004,,,,2,2,4
HND-010314,2011,120900005,,,,3,3,6
HND-010319,2011,120900011,,,,2,2,4
HND-010321,2011,120900014,,,,1,1,2
HND-010311,2011,120900002,,,,2,3,5
HND-010314,2011,120900005,,,,4,3,7
HND-010317,2011,120900009,,,,1,1,2
HND-010318,2011,120900010,,,,3,1,4
HND-010320,2011,120900012,,,,3,3,6
HND-010321,2011,120900014,,,,1,1,2
HND-010312,2011,120900003,,,,1,1,2
HND-010313,2011,120900004,,,,0,2,2
HND-010316,2011,120900008,,,,3,2,5
HND-010311,2011,120900002,,,,1,1,2
HND-010312,2011,120900003,,,,0,1,1
HND-010315,2011,120900007,,,,3,0,3
HND-010317,2011,120900009,,,,0,2,2
HND-010320,2011,120900012,,,,0,1,1
HND-010314,2011,120900005,,,,2,2,4
HND-010316,2011,120900008,,,,0,1,1
HND-010318,2011,120900010,,,,3,1,4
HND-010319,2011,120900011,,,,3,5,8
HND-010321,2011,120900014,,,,2,1,3
HND-010312,2011,120900003,,,,2,1,3
HND-010313,2011,120900004,,,,0,2,2
HND-010311,2011,120900002,,,,2,2,4
HND-010314,2011,120900005,,,,2,2,4
HND-010316,2011,120900008,,,,1,1,2
HND-010317,2011,120900009,,,,2,2,4
HND-010318,2011,120900010,,,,4,1,5
HND-010319,2011,120900011,,,,2,1,3
HND-010320,2011,120900012,,,,3,4,7
HND-010321,2011,120900014,,,,2,5,7
HND-010313,2011,120900004,,,,1,1,2
HND-010314,2011,120900005,,,,4,2,6
HND-010316,2011,120900008,,,,1,1,2
HND-010319,2011,120900011,,,,0,2,2
HND-010321,2011,120900014,,,,3,1,4
HND-010311,2011,120900002,,,,4,4,8
HND-010312,2011,120900003,,,,1,3,4
HND-010315,2011,120900007,,,,2,1,3
HND-010317,2011,120900009,,,,2,0,2
HND-010318,2011,120900010,,,,6,2,8
HND-010320,2011,120900012,,,,1,4,5
HND-010311,2011,120900002,,,,4,4,8
HND-010311,2011,120900002,,,,5,7,12
HND-010311,2011,120900002,,,,3,9,12
HND-010358,2011,121000039,,,,3,3,6
HND-010359,2011,121000040,,,,5,3,8
,2011,121000041,,,,8,7,15
HND-010364,2011,121000084,,,,3,1,4
,2011,121000085,,,,3,2,5
HND-010366,2011,121000087,,,,2,6,8
HND-010367,2011,121000088,,,,5,3,8
HND-010340,2011,121000018,,,,6,3,9
,2011,121000034,,,,6,6,12
,2011,121000042,,,,2,2,4
HND-010360,2011,121000043,,,,8,1,9
HND-010361,2011,121000044,,,,4,3,7
,2011,121000045,,,,4,5,9
HND-010362,2011,121000047,,,,4,4,8
HND-010363,2011,121000048,,,,5,2,7
,2011,121000068,,,,4,7,11
HND-010365,2011,121000086,,,,7,6,13
,2011,121000089,,,,3,1,4
HND-010352,2011,121000030,,,,5,3,8
,2011,121000032,,,,4,2,6
HND-010354,2011,121000033,,,,5,3,8
HND-010357,2011,121000038,,,,2,2,4
HND-010350,2011,121000028,,,,1,5,6
HND-010351,2011,121000029,,,,5,10,15
HND-010350,2011,121000028,,,,6,4,10
HND-010351,2011,121000029,,,,9,5,14
HND-010352,2011,121000030,,,,6,6,12
,2011,121000032,,,,5,6,11
HND-010354,2011,121000033,,,,1,5,6
HND-010357,2011,121000038,,,,9,4,13
HND-010329,2011,121000006,,,,4,4,8
HND-010332,2011,121000009,,,,22,24,46
HND-010333,2011,121000010,,,,5,5,10
HND-010334,2011,121000011,,,,4,3,7
HND-010337,2011,121000014,,,,2,1,3
HND-010338,2011,121000016,,,,9,0,9
HND-010341,2011,121000019,,,,3,1,4
HND-010342,2011,121000020,,,,1,3,4
HND-010343,2011,121000021,,,,3,6,9
HND-010344,2011,121000022,,,,8,4,12
HND-010346,2011,121000024,,,,1,0,1
HND-010348,2011,121000026,,,,4,1,5
HND-010355,2011,121000035,,,,1,5,6
HND-010356,2011,121000037,,,,0,1,1
HND-010324,2011,121000001,,,,5,8,13
HND-010325,2011,121000002,,,,10,2,12
HND-010326,2011,121000003,,,,1,2,3
HND-010327,2011,121000004,,,,7,9,16
HND-010328,2011,121000005,,,,9,1,10
HND-010330,2011,121000007,,,,4,2,6
HND-010331,2011,121000008,,,,8,8,16
HND-010335,2011,121000012,,,,5,4,9
HND-010336,2011,121000013,,,,4,3,7
HND-010339,2011,121000017,,,,4,1,5
HND-010340,2011,121000018,,,,6,7,13
HND-010347,2011,121000025,,,,4,2,6
HND-010357,2011,121000038,,,,11,4,15
HND-010325,2011,121000002,,,,4,11,15
HND-010327,2011,121000004,,,,13,7,20
HND-010329,2011,121000006,,,,6,4,10
HND-010333,2011,121000010,,,,5,2,7
HND-010334,2011,121000011,,,,2,2,4
HND-010335,2011,121000012,,,,2,3,5
HND-010336,2011,121000013,,,,1,3,4
HND-010337,2011,121000014,,,,0,3,3
HND-010338,2011,121000016,,,,3,3,6
HND-010339,2011,121000017,,,,0,3,3
HND-010344,2011,121000022,,,,4,7,11
HND-010345,2011,121000023,,,,2,1,3
HND-010346,2011,121000024,,,,0,1,1
HND-010347,2011,121000025,,,,4,1,5
HND-010353,2011,121000031,,,,4,2,6
HND-010324,2011,121000001,,,,11,8,19
HND-010326,2011,121000003,,,,1,1,2
HND-010328,2011,121000005,,,,3,6,9
HND-010330,2011,121000007,,,,4,6,10
HND-010331,2011,121000008,,,,5,3,8
HND-010332,2011,121000009,,,,22,15,37
HND-010340,2011,121000018,,,,3,4,7
HND-010341,2011,121000019,,,,2,3,5
HND-010342,2011,121000020,,,,2,1,3
HND-010343,2011,121000021,,,,2,1,3
HND-010348,2011,121000026,,,,2,2,4
HND-010355,2011,121000035,,,,0,2,2
HND-010356,2011,121000037,,,,0,1,1
HND-010357,2011,121000038,,,,3,10,13
HND-010329,2011,121000006,,,,3,3,6
HND-010332,2011,121000009,,,,12,5,17
HND-010333,2011,121000010,,,,4,6,10
HND-010334,2011,121000011,,,,3,0,3
HND-010335,2011,121000012,,,,6,4,10
HND-010337,2011,121000014,,,,2,2,4
HND-010338,2011,121000016,,,,1,4,5
HND-010341,2011,121000019,,,,1,3,4
HND-010342,2011,121000020,,,,1,3,4
HND-010343,2011,121000021,,,,0,2,2
HND-010344,2011,121000022,,,,8,6,14
HND-010345,2011,121000023,,,,1,0,1
HND-010346,2011,121000024,,,,2,2,4
HND-010348,2011,121000026,,,,2,3,5
HND-010357,2011,121000038,,,,5,7,12
HND-010324,2011,121000001,,,,6,5,11
HND-010325,2011,121000002,,,,3,5,8
HND-010326,2011,121000003,,,,3,2,5
HND-010327,2011,121000004,,,,13,11,24
HND-010328,2011,121000005,,,,6,6,12
HND-010330,2011,121000007,,,,4,3,7
HND-010331,2011,121000008,,,,8,10,18
HND-010336,2011,121000013,,,,2,3,5
HND-010339,2011,121000017,,,,2,2,4
HND-010340,2011,121000018,,,,2,4,6
HND-010347,2011,121000025,,,,2,0,2
HND-010353,2011,121000031,,,,1,2,3
HND-010355,2011,121000035,,,,0,4,4
HND-010356,2011,121000037,,,,1,1,2
HND-010325,2011,121000002,,,,2,2,4
HND-010326,2011,121000003,,,,1,2,3
HND-010327,2011,121000004,,,,10,8,18
HND-010329,2011,121000006,,,,3,2,5
HND-010330,2011,121000007,,,,1,1,2
HND-010335,2011,121000012,,,,2,2,4
HND-010336,2011,121000013,,,,3,6,9
HND-010337,2011,121000014,,,,1,2,3
HND-010339,2011,121000017,,,,4,0,4
HND-010344,2011,121000022,,,,5,2,7
HND-010345,2011,121000023,,,,1,0,1
HND-010346,2011,121000024,,,,0,2,2
HND-010347,2011,121000025,,,,3,2,5
HND-010353,2011,121000031,,,,2,5,7
HND-010324,2011,121000001,,,,9,5,14
HND-010328,2011,121000005,,,,5,3,8
HND-010331,2011,121000008,,,,10,7,17
HND-010332,2011,121000009,,,,14,20,34
HND-010333,2011,121000010,,,,2,3,5
HND-010338,2011,121000016,,,,2,4,6
HND-010340,2011,121000018,,,,6,3,9
HND-010341,2011,121000019,,,,4,7,11
HND-010342,2011,121000020,,,,2,2,4
HND-010343,2011,121000021,,,,0,3,3
HND-010348,2011,121000026,,,,2,3,5
HND-010355,2011,121000035,,,,0,4,4
HND-010356,2011,121000037,,,,0,1,1
HND-010357,2011,121000038,,,,3,7,10
HND-010324,2011,121000001,,,,10,6,16
HND-010325,2011,121000002,,,,11,8,19
HND-010326,2011,121000003,,,,1,2,3
HND-010327,2011,121000004,,,,11,11,22
HND-010328,2011,121000005,,,,6,1,7
HND-010329,2011,121000006,,,,3,5,8
HND-010330,2011,121000007,,,,4,1,5
HND-010335,2011,121000012,,,,8,8,16
HND-010336,2011,121000013,,,,3,3,6
HND-010337,2011,121000014,,,,2,0,2
HND-010339,2011,121000017,,,,2,2,4
HND-010340,2011,121000018,,,,3,5,8
HND-010347,2011,121000025,,,,6,3,9
HND-010356,2011,121000037,,,,3,3,6
HND-010331,2011,121000008,,,,6,9,15
HND-010332,2011,121000009,,,,19,20,39
HND-010333,2011,121000010,,,,5,4,9
HND-010338,2011,121000016,,,,4,2,6
HND-010341,2011,121000019,,,,2,2,4
HND-010342,2011,121000020,,,,0,1,1
HND-010344,2011,121000022,,,,3,4,7
HND-010346,2011,121000024,,,,2,0,2
HND-010348,2011,121000026,,,,3,1,4
HND-010355,2011,121000035,,,,2,4,6
HND-010357,2011,121000038,,,,6,12,18
HND-010324,2011,121000001,,,,7,8,15
HND-010326,2011,121000003,,,,3,6,9
HND-010328,2011,121000005,,,,5,1,6
HND-010330,2011,121000007,,,,0,5,5
HND-010331,2011,121000008,,,,8,2,10
HND-010332,2011,121000009,,,,23,18,41
HND-010340,2011,121000018,,,,4,4,8
HND-010341,2011,121000019,,,,4,2,6
HND-010342,2011,121000020,,,,3,2,5
HND-010348,2011,121000026,,,,1,3,4
HND-010355,2011,121000035,,,,2,1,3
HND-010356,2011,121000037,,,,1,1,2
HND-010357,2011,121000038,,,,9,6,15
HND-010325,2011,121000002,,,,5,5,10
HND-010327,2011,121000004,,,,13,7,20
HND-010329,2011,121000006,,,,3,3,6
HND-010333,2011,121000010,,,,1,4,5
HND-010335,2011,121000012,,,,4,2,6
HND-010336,2011,121000013,,,,3,4,7
HND-010338,2011,121000016,,,,2,4,6
HND-010339,2011,121000017,,,,2,2,4
HND-010344,2011,121000022,,,,6,2,8
HND-010345,2011,121000023,,,,0,3,3
HND-010346,2011,121000024,,,,1,2,3
HND-010347,2011,121000025,,,,1,2,3
HND-010353,2011,121000031,,,,1,2,3
HND-010324,2011,121000001,,,,25,27,52
HND-010327,2011,121000004,,,,6,6,12
HND-010340,2011,121000018,,,,4,7,11
HND-010349,2011,121000027,,,,56,32,88
HND-010324,2011,121000001,,,,10,10,20
HND-010340,2011,121000018,,,,8,5,13
HND-010327,2011,121000004,,,,11,10,21
HND-010349,2011,121000027,,,,29,28,57
HND-010324,2011,121000001,,,,12,12,24
HND-010340,2011,121000018,,,,2,3,5
HND-010327,2011,121000004,,,,6,6,12
HND-010349,2011,121000027,,,,37,29,66
HND-010349,2011,121000027,,,,31,15,46
HND-010349,2011,121000027,,,,16,10,26
HND-010349,2011,121000027,,,,15,11,26
,2011,121100028,,,,5,4,9
,2011,121100029,,,,2,3,5
,2011,121100030,,,,4,5,9
,2011,121100031,,,,3,5,8
HND-010380,2011,121100013,,,,4,4,8
HND-010380,2011,121100013,,,,6,6,12
HND-010380,2011,121100013,,,,7,12,19
HND-010368,2011,121100001,,,,13,21,34
HND-010370,2011,121100003,,,,1,0,1
HND-010372,2011,121100005,,,,1,3,4
HND-010374,2011,121100007,,,,1,5,6
HND-010375,2011,121100008,,,,2,2,4
HND-010369,2011,121100002,,,,5,1,6
HND-010373,2011,121100006,,,,3,2,5
HND-010376,2011,121100009,,,,4,5,9
HND-010377,2011,121100010,,,,0,1,1
HND-010378,2011,121100011,,,,4,1,5
HND-010379,2011,121100012,,,,2,2,4
HND-010380,2011,121100013,,,,2,1,3
HND-010381,2011,121100014,,,,3,5,8
HND-010368,2011,121100001,,,,12,15,27
HND-010369,2011,121100002,,,,1,0,1
HND-010370,2011,121100003,,,,3,0,3
HND-010371,2011,121100004,,,,0,2,2
HND-010372,2011,121100005,,,,0,1,1
HND-010374,2011,121100007,,,,1,2,3
HND-010379,2011,121100012,,,,3,0,3
HND-010380,2011,121100013,,,,3,2,5
HND-010381,2011,121100014,,,,4,4,8
HND-010375,2011,121100008,,,,2,4,6
HND-010376,2011,121100009,,,,3,2,5
HND-010378,2011,121100011,,,,1,4,5
HND-010369,2011,121100002,,,,1,0,1
HND-010371,2011,121100004,,,,2,0,2
HND-010373,2011,121100006,,,,0,1,1
HND-010377,2011,121100010,,,,1,3,4
HND-010378,2011,121100011,,,,4,3,7
HND-010379,2011,121100012,,,,2,0,2
HND-010380,2011,121100013,,,,0,2,2
HND-010381,2011,121100014,,,,7,1,8
HND-010368,2011,121100001,,,,14,10,24
HND-010370,2011,121100003,,,,1,1,2
HND-010372,2011,121100005,,,,4,1,5
HND-010374,2011,121100007,,,,6,2,8
HND-010375,2011,121100008,,,,4,0,4
HND-010376,2011,121100009,,,,0,5,5
HND-010368,2011,121100001,,,,9,9,18
HND-010370,2011,121100003,,,,1,1,2
HND-010371,2011,121100004,,,,0,1,1
HND-010374,2011,121100007,,,,1,4,5
HND-010375,2011,121100008,,,,4,2,6
HND-010379,2011,121100012,,,,1,3,4
HND-010380,2011,121100013,,,,2,0,2
HND-010381,2011,121100014,,,,4,5,9
HND-010373,2011,121100006,,,,2,1,3
HND-010376,2011,121100009,,,,4,1,5
HND-010377,2011,121100010,,,,2,0,2
HND-010378,2011,121100011,,,,1,0,1
HND-010368,2011,121100001,,,,6,14,20
HND-010370,2011,121100003,,,,1,0,1
HND-010371,2011,121100004,,,,1,2,3
HND-010372,2011,121100005,,,,4,0,4
HND-010374,2011,121100007,,,,3,7,10
HND-010375,2011,121100008,,,,2,2,4
HND-010380,2011,121100013,,,,1,1,2
HND-010373,2011,121100006,,,,4,3,7
HND-010376,2011,121100009,,,,1,2,3
HND-010377,2011,121100010,,,,1,2,3
HND-010378,2011,121100011,,,,1,0,1
HND-010379,2011,121100012,,,,1,2,3
HND-010381,2011,121100014,,,,2,4,6
HND-010375,2011,121100008,,,,6,0,6
HND-010376,2011,121100009,,,,2,2,4
HND-010377,2011,121100010,,,,1,2,3
HND-010378,2011,121100011,,,,1,2,3
HND-010368,2011,121100001,,,,20,11,31
HND-010370,2011,121100003,,,,0,1,1
HND-010371,2011,121100004,,,,1,1,2
HND-010374,2011,121100007,,,,3,4,7
HND-010379,2011,121100012,,,,1,0,1
HND-010380,2011,121100013,,,,2,0,2
HND-010381,2011,121100014,,,,4,5,9
HND-010382,2011,121100015,,,,26,16,42
HND-010382,2011,121100015,,,,9,19,28
HND-010382,2011,121100015,,,,18,18,36
HND-010382,2011,121100015,,,,9,13,22
HND-010382,2011,121100015,,,,7,3,10
HND-010408,2011,121200027,,,,6,6,12
HND-010385,2011,121200002,,,,5,3,8
HND-010403,2011,121200020,,,,15,5,20
HND-010409,2011,121200029,,,,9,3,12
,2011,121200030,,,,3,13,16
HND-010410,2011,121200031,,,,5,7,12
,2011,121200036,,,,7,4,11
HND-010414,2011,121200039,,,,7,8,15
HND-010415,2011,121200077,,,,5,9,14
HND-010384,2011,121200001,,,,16,9,25
HND-010400,2011,121200017,,,,6,1,7
HND-010401,2011,121200018,,,,4,5,9
HND-010405,2011,121200022,,,,3,3,6
HND-010406,2011,121200023,,,,4,2,6
HND-010386,2011,121200003,,,,10,9,19
HND-010402,2011,121200019,,,,7,8,15
HND-010411,2011,121200032,,,,7,4,11
HND-010413,2011,121200034,,,,3,1,4
HND-010384,2011,121200001,,,,24,16,40
HND-010400,2011,121200017,,,,6,7,13
HND-010401,2011,121200018,,,,7,6,13
HND-010402,2011,121200019,,,,6,4,10
HND-010405,2011,121200022,,,,5,11,16
HND-010406,2011,121200023,,,,13,11,24
HND-010411,2011,121200032,,,,6,7,13
HND-010413,2011,121200034,,,,5,5,10
HND-010386,2011,121200003,,,,3,4,7
HND-010388,2011,121200005,,,,29,15,44
HND-010391,2011,121200008,,,,4,4,8
HND-010392,2011,121200009,,,,5,9,14
HND-010395,2011,121200012,,,,5,7,12
HND-010396,2011,121200013,,,,3,5,8
HND-010397,2011,121200014,,,,4,1,5
HND-010398,2011,121200015,,,,2,4,6
HND-010400,2011,121200017,,,,6,6,12
HND-010401,2011,121200018,,,,11,13,24
HND-010385,2011,121200002,,,,1,1,2
HND-010386,2011,121200003,,,,8,7,15
HND-010387,2011,121200004,,,,1,1,2
HND-010389,2011,121200006,,,,20,24,44
HND-010390,2011,121200007,,,,9,17,26
HND-010393,2011,121200010,,,,13,8,21
HND-010394,2011,121200011,,,,5,12,17
HND-010399,2011,121200016,,,,13,7,20
HND-010402,2011,121200019,,,,7,3,10
HND-010412,2011,121200033,,,,6,5,11
HND-010388,2011,121200005,,,,24,21,45
HND-010389,2011,121200006,,,,10,19,29
HND-010392,2011,121200009,,,,7,2,9
HND-010396,2011,121200013,,,,2,2,4
HND-010398,2011,121200015,,,,1,5,6
HND-010400,2011,121200017,,,,7,8,15
HND-010401,2011,121200018,,,,5,5,10
HND-010402,2011,121200019,,,,10,5,15
HND-010412,2011,121200033,,,,3,3,6
HND-010385,2011,121200002,,,,2,6,8
HND-010386,2011,121200003,,,,8,5,13
HND-010387,2011,121200004,,,,3,2,5
HND-010390,2011,121200007,,,,6,13,19
HND-010391,2011,121200008,,,,6,6,12
HND-010393,2011,121200010,,,,8,12,20
HND-010394,2011,121200011,,,,10,4,14
HND-010395,2011,121200012,,,,1,3,4
HND-010397,2011,121200014,,,,5,3,8
HND-010399,2011,121200016,,,,11,7,18
HND-010388,2011,121200005,,,,18,26,44
HND-010389,2011,121200006,,,,11,17,28
HND-010391,2011,121200008,,,,2,1,3
HND-010392,2011,121200009,,,,7,3,10
HND-010395,2011,121200012,,,,4,1,5
HND-010396,2011,121200013,,,,6,1,7
HND-010397,2011,121200014,,,,2,6,8
HND-010398,2011,121200015,,,,8,6,14
HND-010400,2011,121200017,,,,6,10,16
HND-010401,2011,121200018,,,,1,2,3
HND-010412,2011,121200033,,,,3,2,5
HND-010385,2011,121200002,,,,1,4,5
HND-010386,2011,121200003,,,,9,5,14
HND-010387,2011,121200004,,,,1,4,5
HND-010390,2011,121200007,,,,5,8,13
HND-010393,2011,121200010,,,,15,8,23
HND-010394,2011,121200011,,,,1,8,9
HND-010399,2011,121200016,,,,8,7,15
HND-010402,2011,121200019,,,,9,9,18
HND-010385,2011,121200002,,,,3,2,5
HND-010387,2011,121200004,,,,2,1,3
HND-010389,2011,121200006,,,,17,17,34
HND-010401,2011,121200018,,,,7,7,14
HND-010402,2011,121200019,,,,11,7,18
HND-010412,2011,121200033,,,,3,1,4
HND-010386,2011,121200003,,,,3,11,14
HND-010388,2011,121200005,,,,31,30,61
HND-010390,2011,121200007,,,,5,5,10
HND-010391,2011,121200008,,,,8,4,12
HND-010392,2011,121200009,,,,6,5,11
HND-010393,2011,121200010,,,,7,5,12
HND-010394,2011,121200011,,,,5,6,11
HND-010395,2011,121200012,,,,5,7,12
HND-010396,2011,121200013,,,,9,6,15
HND-010397,2011,121200014,,,,1,2,3
HND-010398,2011,121200015,,,,6,3,9
HND-010399,2011,121200016,,,,9,8,17
HND-010400,2011,121200017,,,,5,6,11
HND-010385,2011,121200002,,,,3,1,4
HND-010386,2011,121200003,,,,9,7,16
HND-010387,2011,121200004,,,,3,6,9
HND-010389,2011,121200006,,,,17,19,36
HND-010390,2011,121200007,,,,9,11,20
HND-010393,2011,121200010,,,,14,8,22
HND-010394,2011,121200011,,,,10,8,18
HND-010399,2011,121200016,,,,5,6,11
HND-010401,2011,121200018,,,,9,10,19
HND-010402,2011,121200019,,,,7,10,17
HND-010388,2011,121200005,,,,31,31,62
HND-010391,2011,121200008,,,,2,4,6
HND-010392,2011,121200009,,,,5,2,7
HND-010395,2011,121200012,,,,4,3,7
HND-010396,2011,121200013,,,,8,2,10
HND-010397,2011,121200014,,,,2,6,8
HND-010398,2011,121200015,,,,2,0,2
HND-010400,2011,121200017,,,,3,9,12
HND-010412,2011,121200033,,,,2,5,7
HND-010385,2011,121200002,,,,4,2,6
HND-010386,2011,121200003,,,,4,8,12
HND-010387,2011,121200004,,,,3,2,5
HND-010390,2011,121200007,,,,18,10,28
HND-010391,2011,121200008,,,,2,7,9
HND-010393,2011,121200010,,,,9,11,20
HND-010394,2011,121200011,,,,2,3,5
HND-010395,2011,121200012,,,,5,11,16
HND-010397,2011,121200014,,,,4,2,6
HND-010399,2011,121200016,,,,5,4,9
HND-010388,2011,121200005,,,,36,23,59
HND-010389,2011,121200006,,,,17,12,29
HND-010392,2011,121200009,,,,4,2,6
HND-010396,2011,121200013,,,,0,5,5
HND-010398,2011,121200015,,,,6,3,9
HND-010400,2011,121200017,,,,2,10,12
HND-010401,2011,121200018,,,,3,7,10
HND-010402,2011,121200019,,,,8,10,18
HND-010412,2011,121200033,,,,3,6,9
HND-010393,2011,121200010,,,,17,18,35
HND-010407,2011,121200024,,,,33,24,57
,2011,121200076,,,,80,60,140
HND-010407,2011,121200024,,,,21,17,38
,2011,121200076,,,,56,50,106
HND-010393,2011,121200010,,,,7,6,13
HND-010407,2011,121200024,,,,20,19,39
,2011,121200076,,,,39,47,86
HND-010393,2011,121200010,,,,13,10,23
,2011,121200076,,,,62,85,147
HND-010407,2011,121200024,,,,18,25,43
,2011,121200076,,,,37,40,77
HND-010407,2011,121200024,,,,22,19,41
HND-010407,2011,121200024,,,,24,12,36
HND-010427,2011,121300021,,,,3,2,5
HND-010428,2011,121300022,,,,6,5,11
HND-010429,2011,121300023,,,,10,2,12
HND-010426,2011,121300019,,,,8,4,12
HND-010423,2011,121300008,,,,1,0,1
HND-010423,2011,121300008,,,,8,3,11
HND-010424,2011,121300009,,,,5,4,9
HND-010425,2011,121300010,,,,3,3,6
HND-010423,2011,121300008,,,,3,3,6
HND-010425,2011,121300010,,,,4,14,18
HND-010424,2011,121300009,,,,1,2,3
HND-010417,2011,121300002,,,,6,6,12
HND-010418,2011,121300003,,,,9,4,13
HND-010419,2011,121300004,,,,5,5,10
HND-010420,2011,121300005,,,,1,7,8
HND-010422,2011,121300007,,,,4,1,5
HND-010416,2011,121300001,,,,13,11,24
HND-010421,2011,121300006,,,,2,3,5
HND-010416,2011,121300001,,,,11,9,20
HND-010417,2011,121300002,,,,8,7,15
HND-010419,2011,121300004,,,,2,0,2
HND-010421,2011,121300006,,,,2,2,4
HND-010418,2011,121300003,,,,10,6,16
HND-010420,2011,121300005,,,,3,5,8
HND-010422,2011,121300007,,,,1,1,2
HND-010416,2011,121300001,,,,13,11,24
HND-010421,2011,121300006,,,,5,1,6
HND-010417,2011,121300002,,,,3,3,6
HND-010418,2011,121300003,,,,4,7,11
HND-010419,2011,121300004,,,,1,5,6
HND-010420,2011,121300005,,,,1,4,5
HND-010422,2011,121300007,,,,0,1,1
HND-010416,2011,121300001,,,,11,7,18
HND-010417,2011,121300002,,,,3,3,6
HND-010418,2011,121300003,,,,4,4,8
HND-010419,2011,121300004,,,,4,4,8
HND-010420,2011,121300005,,,,1,0,1
HND-010421,2011,121300006,,,,1,2,3
HND-010422,2011,121300007,,,,2,2,4
HND-010416,2011,121300001,,,,10,2,12
HND-010421,2011,121300006,,,,1,0,1
HND-010417,2011,121300002,,,,7,7,14
HND-010418,2011,121300003,,,,7,7,14
HND-010419,2011,121300004,,,,2,4,6
HND-010420,2011,121300005,,,,3,4,7
HND-010422,2011,121300007,,,,5,1,6
HND-010416,2011,121300001,,,,5,7,12
HND-010417,2011,121300002,,,,4,8,12
HND-010419,2011,121300004,,,,4,2,6
HND-010421,2011,121300006,,,,0,3,3
HND-010418,2011,121300003,,,,6,5,11
HND-010420,2011,121300005,,,,4,0,4
HND-010422,2011,121300007,,,,1,2,3
HND-010417,2011,121300002,,,,23,27,50
HND-010417,2011,121300002,,,,13,15,28
HND-010417,2011,121300002,,,,7,20,27
,2011,121400023,,,,4,0,4
HND-010448,2011,121400026,,,,3,4,7
,2011,121400047,,,,9,8,17
HND-010449,2011,121400048,,,,2,4,6
HND-010450,2011,121400051,,,,2,2,4
HND-010451,2011,121400052,,,,2,2,4
HND-010452,2011,121400053,,,,11,5,16
HND-010438,2011,121400010,,,,2,2,4
,2011,121400013,,,,2,2,4
HND-010438,2011,121400010,,,,12,7,19
,2011,121400013,,,,2,1,3
HND-010444,2011,121400018,,,,7,8,15
HND-010439,2011,121400011,,,,3,3,6
HND-010441,2011,121400014,,,,5,7,12
HND-010443,2011,121400016,,,,3,3,6
HND-010445,2011,121400021,,,,3,2,5
HND-010447,2011,121400024,,,,2,2,4
HND-010438,2011,121400010,,,,22,18,40
HND-010439,2011,121400011,,,,7,3,10
HND-010441,2011,121400014,,,,2,7,9
HND-010443,2011,121400016,,,,4,5,9
HND-010445,2011,121400021,,,,12,4,16
HND-010447,2011,121400024,,,,5,3,8
HND-010431,2011,121400003,,,,32,29,61
HND-010434,2011,121400006,,,,3,4,7
HND-010436,2011,121400008,,,,3,5,8
HND-010437,2011,121400009,,,,3,3,6
HND-010449,2011,121400048,,,,4,1,5
HND-010432,2011,121400004,,,,7,9,16
HND-010433,2011,121400005,,,,3,5,8
HND-010435,2011,121400007,,,,9,7,16
HND-010442,2011,121400015,,,,10,3,13
HND-010446,2011,121400022,,,,6,4,10
HND-010431,2011,121400003,,,,31,16,47
HND-010433,2011,121400005,,,,4,3,7
HND-010435,2011,121400007,,,,5,5,10
HND-010436,2011,121400008,,,,7,3,10
HND-010432,2011,121400004,,,,9,6,15
HND-010434,2011,121400006,,,,8,7,15
HND-010437,2011,121400009,,,,9,4,13
HND-010442,2011,121400015,,,,6,5,11
HND-010446,2011,121400022,,,,5,2,7
HND-010449,2011,121400048,,,,1,0,1
HND-010432,2011,121400004,,,,8,9,17
HND-010433,2011,121400005,,,,1,6,7
HND-010435,2011,121400007,,,,6,6,12
HND-010436,2011,121400008,,,,5,4,9
HND-010442,2011,121400015,,,,10,6,16
HND-010431,2011,121400003,,,,39,27,66
HND-010434,2011,121400006,,,,8,5,13
HND-010437,2011,121400009,,,,8,2,10
HND-010446,2011,121400022,,,,9,5,14
HND-010449,2011,121400048,,,,3,3,6
HND-010431,2011,121400003,,,,24,18,42
HND-010433,2011,121400005,,,,5,1,6
HND-010436,2011,121400008,,,,2,1,3
HND-010437,2011,121400009,,,,9,4,13
HND-010432,2011,121400004,,,,3,7,10
HND-010434,2011,121400006,,,,10,8,18
HND-010435,2011,121400007,,,,9,9,18
HND-010442,2011,121400015,,,,6,5,11
HND-010446,2011,121400022,,,,5,8,13
HND-010449,2011,121400048,,,,8,1,9
HND-010431,2011,121400003,,,,29,18,47
HND-010436,2011,121400008,,,,3,2,5
HND-010437,2011,121400009,,,,3,5,8
HND-010449,2011,121400048,,,,4,1,5
HND-010432,2011,121400004,,,,10,9,19
HND-010433,2011,121400005,,,,3,6,9
HND-010434,2011,121400006,,,,7,6,13
HND-010435,2011,121400007,,,,7,6,13
HND-010442,2011,121400015,,,,3,3,6
HND-010446,2011,121400022,,,,9,7,16
HND-010432,2011,121400004,,,,8,2,10
HND-010434,2011,121400006,,,,0,6,6
HND-010437,2011,121400009,,,,4,12,16
HND-010442,2011,121400015,,,,4,11,15
HND-010446,2011,121400022,,,,4,8,12
HND-010431,2011,121400003,,,,20,31,51
HND-010433,2011,121400005,,,,3,1,4
HND-010435,2011,121400007,,,,5,5,10
HND-010436,2011,121400008,,,,6,1,7
HND-010449,2011,121400048,,,,2,3,5
HND-010440,2011,121400012,,,,78,54,132
HND-010446,2011,121400022,,,,9,4,13
HND-010440,2011,121400012,,,,63,35,98
HND-010446,2011,121400022,,,,6,8,14
HND-010440,2011,121400012,,,,61,67,128
HND-010446,2011,121400022,,,,6,3,9
HND-010440,2011,121400012,,,,37,30,67
HND-010440,2011,121400012,,,,29,12,41
HND-010440,2011,121400012,,,,19,14,33
HND-010490,2011,121500044,,,,4,2,6
,2011,121500045,,,,4,4,8
,2011,121500047,,,,7,6,13
,2011,121500048,,,,1,7,8
,2011,121500061,,,,2,5,7
HND-010494,2011,121500066,,,,10,5,15
HND-010495,2011,121500067,,,,8,7,15
HND-010497,2011,121500073,,,,2,5,7
,2011,121500075,,,,8,1,9
,2011,121500078,,,,2,5,7
HND-010501,2011,121500079,,,,1,2,3
,2011,121500003,,,,4,6,10
HND-010473,2011,121500023,,,,3,3,6
HND-010491,2011,121500046,,,,7,3,10
HND-010492,2011,121500049,,,,5,7,12
,2011,121500068,,,,1,6,7
,2011,121500069,,,,7,4,11
HND-010496,2011,121500070,,,,2,3,5
,2011,121500071,,,,5,3,8
HND-010498,2011,121500074,,,,17,21,38
HND-010486,2011,121500040,,,,1,0,1
,2011,121500072,,,,2,4,6
HND-010453,2011,121500001,,,,4,3,7
HND-010476,2011,121500026,,,,2,0,2
HND-010479,2011,121500029,,,,4,3,7
,2011,121500072,,,,1,2,3
HND-010474,2011,121500024,,,,3,3,6
HND-010475,2011,121500025,,,,1,4,5
HND-010477,2011,121500027,,,,3,4,7
HND-010482,2011,121500032,,,,2,6,8
,2011,121500034,,,,4,7,11
HND-010486,2011,121500040,,,,3,4,7
HND-010474,2011,121500024,,,,9,6,15
HND-010475,2011,121500025,,,,14,16,30
HND-010477,2011,121500027,,,,15,11,26
HND-010482,2011,121500032,,,,5,7,12
,2011,121500034,,,,3,2,5
HND-010486,2011,121500040,,,,6,1,7
HND-010487,2011,121500041,,,,4,4,8
HND-010493,2011,121500051,,,,3,7,10
,2011,121500072,,,,3,3,6
HND-010453,2011,121500001,,,,2,3,5
HND-010476,2011,121500026,,,,23,20,43
HND-010479,2011,121500029,,,,10,4,14
HND-010454,2011,121500004,,,,15,22,37
HND-010458,2011,121500008,,,,12,16,28
HND-010459,2011,121500009,,,,11,4,15
HND-010460,2011,121500010,,,,2,2,4
HND-010461,2011,121500011,,,,3,6,9
HND-010466,2011,121500016,,,,2,2,4
HND-010468,2011,121500018,,,,14,10,24
HND-010469,2011,121500019,,,,5,3,8
HND-010478,2011,121500028,,,,5,4,9
HND-010479,2011,121500029,,,,5,3,8
HND-010485,2011,121500038,,,,3,1,4
HND-010488,2011,121500042,,,,2,1,3
HND-010489,2011,121500043,,,,3,4,7
HND-010500,2011,121500077,,,,6,4,10
HND-010455,2011,121500005,,,,10,8,18
HND-010456,2011,121500006,,,,2,1,3
HND-010457,2011,121500007,,,,10,18,28
HND-010462,2011,121500012,,,,5,2,7
HND-010463,2011,121500013,,,,5,5,10
HND-010464,2011,121500014,,,,0,2,2
HND-010465,2011,121500015,,,,16,10,26
HND-010467,2011,121500017,,,,7,7,14
HND-010471,2011,121500021,,,,3,4,7
HND-010472,2011,121500022,,,,6,8,14
HND-010473,2011,121500023,,,,3,0,3
HND-010480,2011,121500030,,,,7,5,12
HND-010483,2011,121500035,,,,1,4,5
HND-010484,2011,121500037,,,,1,1,2
HND-010499,2011,121500076,,,,2,0,2
HND-010502,2011,121500080,,,,3,1,4
HND-010454,2011,121500004,,,,14,9,23
HND-010455,2011,121500005,,,,9,9,18
HND-010457,2011,121500007,,,,20,15,35
HND-010458,2011,121500008,,,,19,13,32
HND-010463,2011,121500013,,,,7,4,11
HND-010465,2011,121500015,,,,19,16,35
HND-010467,2011,121500017,,,,10,3,13
HND-010468,2011,121500018,,,,11,10,21
HND-010472,2011,121500022,,,,8,7,15
HND-010473,2011,121500023,,,,2,5,7
HND-010478,2011,121500028,,,,3,4,7
HND-010484,2011,121500037,,,,2,3,5
HND-010485,2011,121500038,,,,4,2,6
HND-010499,2011,121500076,,,,3,2,5
HND-010456,2011,121500006,,,,3,4,7
HND-010459,2011,121500009,,,,13,11,24
HND-010460,2011,121500010,,,,4,4,8
HND-010461,2011,121500011,,,,2,6,8
HND-010462,2011,121500012,,,,4,7,11
HND-010464,2011,121500014,,,,2,1,3
HND-010466,2011,121500016,,,,1,0,1
HND-010469,2011,121500019,,,,1,2,3
HND-010471,2011,121500021,,,,5,3,8
HND-010479,2011,121500029,,,,3,3,6
HND-010480,2011,121500030,,,,4,3,7
HND-010481,2011,121500031,,,,0,2,2
HND-010483,2011,121500035,,,,4,3,7
HND-010488,2011,121500042,,,,2,2,4
HND-010489,2011,121500043,,,,2,2,4
HND-010500,2011,121500077,,,,7,1,8
HND-010502,2011,121500080,,,,2,2,4
HND-010455,2011,121500005,,,,14,13,27
HND-010456,2011,121500006,,,,3,5,8
HND-010457,2011,121500007,,,,17,13,30
HND-010462,2011,121500012,,,,6,1,7
HND-010463,2011,121500013,,,,2,13,15
HND-010464,2011,121500014,,,,2,1,3
HND-010465,2011,121500015,,,,18,16,34
HND-010467,2011,121500017,,,,9,5,14
HND-010468,2011,121500018,,,,12,15,27
HND-010470,2011,121500020,,,,1,3,4
HND-010471,2011,121500021,,,,1,2,3
HND-010472,2011,121500022,,,,7,7,14
HND-010473,2011,121500023,,,,1,2,3
HND-010480,2011,121500030,,,,3,6,9
HND-010481,2011,121500031,,,,3,2,5
HND-010483,2011,121500035,,,,4,5,9
HND-010484,2011,121500037,,,,0,2,2
HND-010499,2011,121500076,,,,0,1,1
HND-010502,2011,121500080,,,,2,3,5
HND-010454,2011,121500004,,,,15,18,33
HND-010458,2011,121500008,,,,19,16,35
HND-010459,2011,121500009,,,,18,26,44
HND-010460,2011,121500010,,,,6,4,10
HND-010461,2011,121500011,,,,1,4,5
HND-010466,2011,121500016,,,,3,2,5
HND-010469,2011,121500019,,,,2,1,3
HND-010478,2011,121500028,,,,9,4,13
HND-010479,2011,121500029,,,,5,2,7
HND-010485,2011,121500038,,,,4,3,7
HND-010488,2011,121500042,,,,1,3,4
HND-010489,2011,121500043,,,,4,2,6
HND-010500,2011,121500077,,,,4,2,6
HND-010454,2011,121500004,,,,8,6,14
HND-010455,2011,121500005,,,,13,6,19
HND-010457,2011,121500007,,,,21,17,38
HND-010458,2011,121500008,,,,16,18,34
HND-010465,2011,121500015,,,,13,3,16
HND-010467,2011,121500017,,,,10,5,15
HND-010468,2011,121500018,,,,6,10,16
HND-010469,2011,121500019,,,,3,1,4
HND-010473,2011,121500023,,,,1,4,5
HND-010478,2011,121500028,,,,4,6,10
HND-010479,2011,121500029,,,,2,5,7
HND-010484,2011,121500037,,,,1,3,4
HND-010485,2011,121500038,,,,3,0,3
HND-010499,2011,121500076,,,,5,1,6
HND-010500,2011,121500077,,,,1,4,5
HND-010456,2011,121500006,,,,2,8,10
HND-010459,2011,121500009,,,,15,19,34
HND-010460,2011,121500010,,,,6,5,11
HND-010461,2011,121500011,,,,3,6,9
HND-010462,2011,121500012,,,,8,8,16
HND-010463,2011,121500013,,,,7,7,14
HND-010464,2011,121500014,,,,5,4,9
HND-010466,2011,121500016,,,,0,1,1
HND-010470,2011,121500020,,,,6,2,8
HND-010471,2011,121500021,,,,1,2,3
HND-010472,2011,121500022,,,,9,8,17
HND-010480,2011,121500030,,,,3,4,7
HND-010481,2011,121500031,,,,1,6,7
HND-010483,2011,121500035,,,,7,1,8
HND-010488,2011,121500042,,,,0,2,2
HND-010489,2011,121500043,,,,2,4,6
HND-010502,2011,121500080,,,,1,4,5
HND-010456,2011,121500006,,,,4,3,7
HND-010457,2011,121500007,,,,26,16,42
HND-010460,2011,121500010,,,,2,4,6
HND-010461,2011,121500011,,,,5,0,5
HND-010462,2011,121500012,,,,5,5,10
HND-010463,2011,121500013,,,,4,5,9
HND-010464,2011,121500014,,,,3,1,4
HND-010465,2011,121500015,,,,12,18,30
HND-010466,2011,121500016,,,,1,3,4
HND-010467,2011,121500017,,,,6,11,17
HND-010470,2011,121500020,,,,0,2,2
HND-010471,2011,121500021,,,,5,2,7
HND-010472,2011,121500022,,,,9,12,21
HND-010473,2011,121500023,,,,3,4,7
HND-010484,2011,121500037,,,,4,0,4
HND-010485,2011,121500038,,,,2,0,2
HND-010488,2011,121500042,,,,3,2,5
HND-010500,2011,121500077,,,,1,0,1
HND-010454,2011,121500004,,,,8,15,23
HND-010455,2011,121500005,,,,10,11,21
HND-010458,2011,121500008,,,,20,15,35
HND-010459,2011,121500009,,,,13,15,28
HND-010468,2011,121500018,,,,10,9,19
HND-010469,2011,121500019,,,,4,3,7
HND-010478,2011,121500028,,,,5,3,8
HND-010479,2011,121500029,,,,2,4,6
HND-010480,2011,121500030,,,,5,0,5
HND-010481,2011,121500031,,,,2,2,4
HND-010483,2011,121500035,,,,4,3,7
HND-010489,2011,121500043,,,,6,3,9
HND-010499,2011,121500076,,,,0,2,2
HND-010502,2011,121500080,,,,4,2,6
HND-010454,2011,121500004,,,,6,13,19
HND-010455,2011,121500005,,,,8,13,21
HND-010457,2011,121500007,,,,6,9,15
HND-010458,2011,121500008,,,,21,14,35
HND-010463,2011,121500013,,,,7,9,16
HND-010465,2011,121500015,,,,15,9,24
HND-010467,2011,121500017,,,,5,5,10
HND-010468,2011,121500018,,,,11,9,20
HND-010472,2011,121500022,,,,9,5,14
HND-010473,2011,121500023,,,,3,3,6
HND-010478,2011,121500028,,,,1,4,5
HND-010480,2011,121500030,,,,2,6,8
HND-010481,2011,121500031,,,,5,2,7
HND-010483,2011,121500035,,,,5,5,10
HND-010488,2011,121500042,,,,2,1,3
HND-010489,2011,121500043,,,,3,4,7
HND-010502,2011,121500080,,,,0,1,1
HND-010456,2011,121500006,,,,5,4,9
HND-010459,2011,121500009,,,,11,5,16
HND-010460,2011,121500010,,,,2,6,8
HND-010461,2011,121500011,,,,3,3,6
HND-010462,2011,121500012,,,,10,3,13
HND-010464,2011,121500014,,,,3,0,3
HND-010466,2011,121500016,,,,2,0,2
HND-010469,2011,121500019,,,,1,4,5
HND-010470,2011,121500020,,,,1,3,4
HND-010471,2011,121500021,,,,4,2,6
HND-010479,2011,121500029,,,,4,2,6
HND-010484,2011,121500037,,,,1,3,4
HND-010485,2011,121500038,,,,1,1,2
HND-010499,2011,121500076,,,,2,1,3
HND-010455,2011,121500005,,,,14,18,32
HND-010458,2011,121500008,,,,15,15,30
HND-010454,2011,121500004,,,,14,14,28
HND-010454,2011,121500004,,,,10,9,19
HND-010455,2011,121500005,,,,14,12,26
HND-010458,2011,121500008,,,,10,14,24
HND-010455,2011,121500005,,,,13,13,26
HND-010458,2011,121500008,,,,8,11,19
HND-010454,2011,121500004,,,,7,4,11
HND-010454,2011,121500004,,,,6,2,8
HND-010454,2011,121500004,,,,4,2,6
HND-010454,2011,121500004,,,,5,3,8
HND-010552,2011,121600056,,,,6,5,11
HND-010554,2011,121600059,,,,9,6,15
,2011,121600065,,,,2,3,5
,2011,121600067,,,,2,3,5
,2011,121600068,,,,2,7,9
HND-010556,2011,121600069,,,,4,6,10
,2011,121600131,,,,3,2,5
,2011,121600162,,,,2,7,9
HND-010561,2011,121600164,,,,7,8,15
HND-010546,2011,121600044,,,,4,9,13
,2011,121600048,,,,5,6,11
,2011,121600054,,,,6,2,8
,2011,121600055,,,,4,6,10
HND-010553,2011,121600057,,,,9,9,18
,2011,121600058,,,,2,2,4
HND-010555,2011,121600060,,,,3,6,9
,2011,121600061,,,,5,7,12
,2011,121600062,,,,5,2,7
,2011,121600063,,,,5,7,12
,2011,121600070,,,,6,8,14
,2011,121600071,,,,5,5,10
,2011,121600129,,,,5,4,9
,2011,121600130,,,,6,6,12
,2011,121600132,,,,2,3,5
,2011,121600133,,,,3,2,5
HND-010560,2011,121600161,,,,4,2,6
HND-010562,2011,121600165,,,,3,4,7
,2011,121600167,,,,7,2,9
,2011,121600168,,,,2,7,9
HND-010539,2011,121600037,,,,1,3,4
,2011,121600046,,,,1,0,1
HND-010506,2011,121600001,,,,4,0,4
HND-010535,2011,121600032,,,,0,3,3
,2011,121600033,,,,3,5,8
HND-010539,2011,121600037,,,,3,1,4
HND-010540,2011,121600038,,,,2,2,4
HND-010545,2011,121600043,,,,4,5,9
HND-010547,2011,121600045,,,,2,2,4
HND-010541,2011,121600039,,,,4,2,6
,2011,121600046,,,,2,1,3
HND-010506,2011,121600001,,,,7,6,13
,2011,121600033,,,,11,3,14
,2011,121600046,,,,5,3,8
HND-010535,2011,121600032,,,,8,8,16
HND-010539,2011,121600037,,,,5,5,10
HND-010540,2011,121600038,,,,6,4,10
HND-010541,2011,121600039,,,,13,11,24
HND-010545,2011,121600043,,,,6,8,14
HND-010547,2011,121600045,,,,4,8,12
HND-010507,2011,121600004,,,,19,14,33
HND-010508,2011,121600005,,,,9,9,18
HND-010511,2011,121600008,,,,7,7,14
HND-010512,2011,121600009,,,,9,9,18
HND-010516,2011,121600013,,,,4,2,6
HND-010518,2011,121600015,,,,3,2,5
HND-010520,2011,121600017,,,,5,3,8
HND-010521,2011,121600018,,,,8,0,8
HND-010522,2011,121600019,,,,8,14,22
HND-010523,2011,121600020,,,,8,7,15
HND-010524,2011,121600021,,,,1,3,4
HND-010529,2011,121600026,,,,5,5,10
HND-010532,2011,121600029,,,,3,4,7
HND-010536,2011,121600034,,,,0,1,1
HND-010537,2011,121600035,,,,2,0,2
HND-010542,2011,121600040,,,,3,1,4
HND-010543,2011,121600041,,,,1,5,6
,2011,121600042,,,,5,1,6
HND-010549,2011,121600050,,,,1,2,3
HND-010550,2011,121600051,,,,6,10,16
HND-010551,2011,121600052,,,,3,4,7
HND-010509,2011,121600006,,,,12,15,27
HND-010510,2011,121600007,,,,3,6,9
HND-010513,2011,121600010,,,,12,1,13
HND-010514,2011,121600011,,,,10,9,19
HND-010515,2011,121600012,,,,4,5,9
HND-010517,2011,121600014,,,,9,6,15
HND-010519,2011,121600016,,,,6,4,10
HND-010525,2011,121600022,,,,4,6,10
HND-010526,2011,121600023,,,,7,4,11
HND-010527,2011,121600024,,,,2,2,4
HND-010528,2011,121600025,,,,5,6,11
HND-010530,2011,121600027,,,,17,16,33
HND-010531,2011,121600028,,,,7,3,10
HND-010533,2011,121600030,,,,3,6,9
HND-010534,2011,121600031,,,,6,4,10
HND-010538,2011,121600036,,,,10,8,18
HND-010548,2011,121600049,,,,1,1,2
HND-010557,2011,121600127,,,,6,6,12
HND-010558,2011,121600128,,,,2,1,3
HND-010559,2011,121600160,,,,2,3,5
HND-010509,2011,121600006,,,,18,13,31
HND-010512,2011,121600009,,,,4,10,14
HND-010521,2011,121600018,,,,13,2,15
HND-010522,2011,121600019,,,,12,15,27
HND-010523,2011,121600020,,,,8,7,15
HND-010524,2011,121600021,,,,2,1,3
HND-010525,2011,121600022,,,,2,3,5
HND-010527,2011,121600024,,,,7,5,12
HND-010529,2011,121600026,,,,4,4,8
HND-010533,2011,121600030,,,,2,4,6
HND-010534,2011,121600031,,,,3,8,11
HND-010536,2011,121600034,,,,1,2,3
HND-010538,2011,121600036,,,,10,6,16
HND-010542,2011,121600040,,,,4,3,7
HND-010543,2011,121600041,,,,4,2,6
HND-010549,2011,121600050,,,,6,5,11
HND-010550,2011,121600051,,,,7,4,11
HND-010558,2011,121600128,,,,0,3,3
HND-010559,2011,121600160,,,,4,0,4
HND-010507,2011,121600004,,,,11,11,22
HND-010508,2011,121600005,,,,5,6,11
HND-010510,2011,121600007,,,,5,8,13
HND-010511,2011,121600008,,,,5,6,11
HND-010513,2011,121600010,,,,3,1,4
HND-010514,2011,121600011,,,,11,10,21
HND-010515,2011,121600012,,,,0,5,5
HND-010516,2011,121600013,,,,3,1,4
HND-010517,2011,121600014,,,,5,3,8
HND-010518,2011,121600015,,,,1,2,3
HND-010519,2011,121600016,,,,3,7,10
HND-010520,2011,121600017,,,,3,2,5
HND-010526,2011,121600023,,,,4,5,9
HND-010528,2011,121600025,,,,5,4,9
HND-010530,2011,121600027,,,,8,11,19
HND-010531,2011,121600028,,,,5,3,8
HND-010532,2011,121600029,,,,3,1,4
HND-010537,2011,121600035,,,,6,5,11
,2011,121600042,,,,4,8,12
HND-010551,2011,121600052,,,,5,3,8
HND-010557,2011,121600127,,,,6,3,9
HND-010507,2011,121600004,,,,17,16,33
HND-010511,2011,121600008,,,,4,6,10
HND-010512,2011,121600009,,,,9,5,14
HND-010516,2011,121600013,,,,1,3,4
HND-010518,2011,121600015,,,,3,2,5
HND-010520,2011,121600017,,,,3,1,4
HND-010521,2011,121600018,,,,3,3,6
HND-010522,2011,121600019,,,,20,14,34
HND-010523,2011,121600020,,,,8,6,14
HND-010524,2011,121600021,,,,5,7,12
HND-010529,2011,121600026,,,,6,2,8
HND-010532,2011,121600029,,,,3,3,6
HND-010533,2011,121600030,,,,5,1,6
HND-010534,2011,121600031,,,,4,2,6
HND-010538,2011,121600036,,,,8,3,11
HND-010548,2011,121600049,,,,0,2,2
HND-010557,2011,121600127,,,,4,5,9
HND-010558,2011,121600128,,,,1,1,2
HND-010559,2011,121600160,,,,0,2,2
HND-010508,2011,121600005,,,,8,4,12
HND-010509,2011,121600006,,,,12,18,30
HND-010510,2011,121600007,,,,4,2,6
HND-010513,2011,121600010,,,,8,6,14
HND-010514,2011,121600011,,,,6,3,9
HND-010515,2011,121600012,,,,0,2,2
HND-010517,2011,121600014,,,,7,4,11
HND-010519,2011,121600016,,,,6,7,13
HND-010525,2011,121600022,,,,0,1,1
HND-010526,2011,121600023,,,,4,4,8
HND-010527,2011,121600024,,,,4,4,8
HND-010528,2011,121600025,,,,10,7,17
HND-010530,2011,121600027,,,,9,6,15
HND-010531,2011,121600028,,,,0,3,3
HND-010536,2011,121600034,,,,3,0,3
HND-010537,2011,121600035,,,,3,1,4
HND-010542,2011,121600040,,,,4,0,4
HND-010543,2011,121600041,,,,2,3,5
,2011,121600042,,,,12,8,20
HND-010549,2011,121600050,,,,6,4,10
HND-010550,2011,121600051,,,,5,1,6
HND-010551,2011,121600052,,,,2,1,3
HND-010509,2011,121600006,,,,8,8,16
HND-010512,2011,121600009,,,,15,8,23
HND-010513,2011,121600010,,,,3,1,4
HND-010514,2011,121600011,,,,4,7,11
HND-010519,2011,121600016,,,,1,4,5
HND-010522,2011,121600019,,,,14,18,32
HND-010523,2011,121600020,,,,9,6,15
HND-010524,2011,121600021,,,,2,3,5
HND-010525,2011,121600022,,,,7,3,10
HND-010526,2011,121600023,,,,5,2,7
HND-010527,2011,121600024,,,,5,5,10
HND-010529,2011,121600026,,,,6,7,13
HND-010530,2011,121600027,,,,4,7,11
HND-010533,2011,121600030,,,,1,1,2
HND-010534,2011,121600031,,,,4,0,4
HND-010536,2011,121600034,,,,3,1,4
HND-010537,2011,121600035,,,,0,5,5
HND-010538,2011,121600036,,,,5,9,14
HND-010542,2011,121600040,,,,4,1,5
HND-010543,2011,121600041,,,,2,1,3
HND-010548,2011,121600049,,,,1,0,1
HND-010549,2011,121600050,,,,4,7,11
HND-010550,2011,121600051,,,,6,5,11
HND-010551,2011,121600052,,,,1,1,2
HND-010559,2011,121600160,,,,2,2,4
HND-010507,2011,121600004,,,,14,14,28
HND-010508,2011,121600005,,,,4,2,6
HND-010510,2011,121600007,,,,4,6,10
HND-010511,2011,121600008,,,,9,4,13
HND-010516,2011,121600013,,,,3,1,4
HND-010517,2011,121600014,,,,8,4,12
HND-010518,2011,121600015,,,,3,2,5
HND-010520,2011,121600017,,,,5,2,7
HND-010521,2011,121600018,,,,2,1,3
HND-010528,2011,121600025,,,,6,10,16
HND-010531,2011,121600028,,,,0,1,1
HND-010532,2011,121600029,,,,5,5,10
,2011,121600042,,,,8,12,20
HND-010557,2011,121600127,,,,5,4,9
HND-010558,2011,121600128,,,,1,1,2
HND-010509,2011,121600006,,,,13,7,20
HND-010513,2011,121600010,,,,5,7,12
HND-010514,2011,121600011,,,,12,12,24
HND-010519,2011,121600016,,,,4,1,5
HND-010522,2011,121600019,,,,12,18,30
HND-010523,2011,121600020,,,,4,8,12
HND-010524,2011,121600021,,,,3,5,8
HND-010525,2011,121600022,,,,6,5,11
HND-010526,2011,121600023,,,,3,2,5
HND-010527,2011,121600024,,,,7,7,14
HND-010528,2011,121600025,,,,3,2,5
HND-010530,2011,121600027,,,,4,4,8
HND-010536,2011,121600034,,,,2,1,3
HND-010537,2011,121600035,,,,0,6,6
HND-010542,2011,121600040,,,,1,0,1
HND-010543,2011,121600041,,,,1,5,6
,2011,121600042,,,,7,11,18
HND-010549,2011,121600050,,,,4,3,7
HND-010550,2011,121600051,,,,5,8,13
HND-010551,2011,121600052,,,,7,3,10
HND-010557,2011,121600127,,,,6,4,10
HND-010558,2011,121600128,,,,1,2,3
HND-010559,2011,121600160,,,,1,1,2
HND-010507,2011,121600004,,,,10,6,16
HND-010508,2011,121600005,,,,7,6,13
HND-010510,2011,121600007,,,,16,5,21
HND-010511,2011,121600008,,,,1,7,8
HND-010512,2011,121600009,,,,14,23,37
HND-010515,2011,121600012,,,,1,0,1
HND-010516,2011,121600013,,,,2,2,4
HND-010517,2011,121600014,,,,4,3,7
HND-010518,2011,121600015,,,,5,2,7
HND-010520,2011,121600017,,,,3,3,6
HND-010521,2011,121600018,,,,1,0,1
HND-010529,2011,121600026,,,,3,7,10
HND-010531,2011,121600028,,,,6,8,14
HND-010532,2011,121600029,,,,4,4,8
HND-010533,2011,121600030,,,,4,1,5
HND-010534,2011,121600031,,,,9,5,14
HND-010538,2011,121600036,,,,2,3,5
HND-010548,2011,121600049,,,,1,0,1
HND-010507,2011,121600004,,,,16,12,28
HND-010508,2011,121600005,,,,7,5,12
HND-010510,2011,121600007,,,,7,2,9
HND-010511,2011,121600008,,,,8,8,16
HND-010513,2011,121600010,,,,5,5,10
HND-010514,2011,121600011,,,,11,8,19
HND-010515,2011,121600012,,,,1,0,1
HND-010516,2011,121600013,,,,1,4,5
HND-010517,2011,121600014,,,,3,6,9
HND-010518,2011,121600015,,,,2,5,7
HND-010519,2011,121600016,,,,1,2,3
HND-010520,2011,121600017,,,,3,1,4
HND-010526,2011,121600023,,,,3,5,8
HND-010528,2011,121600025,,,,5,10,15
HND-010530,2011,121600027,,,,2,2,4
HND-010531,2011,121600028,,,,3,2,5
HND-010532,2011,121600029,,,,6,3,9
HND-010537,2011,121600035,,,,6,2,8
,2011,121600042,,,,3,9,12
HND-010551,2011,121600052,,,,5,4,9
HND-010558,2011,121600128,,,,2,3,5
HND-010559,2011,121600160,,,,3,1,4
HND-010509,2011,121600006,,,,11,15,26
HND-010512,2011,121600009,,,,9,7,16
HND-010521,2011,121600018,,,,3,2,5
HND-010522,2011,121600019,,,,16,8,24
HND-010523,2011,121600020,,,,7,5,12
HND-010524,2011,121600021,,,,1,2,3
HND-010525,2011,121600022,,,,4,12,16
HND-010527,2011,121600024,,,,5,1,6
HND-010529,2011,121600026,,,,1,9,10
HND-010533,2011,121600030,,,,2,5,7
HND-010534,2011,121600031,,,,4,2,6
HND-010536,2011,121600034,,,,3,0,3
HND-010538,2011,121600036,,,,4,1,5
HND-010542,2011,121600040,,,,3,1,4
HND-010543,2011,121600041,,,,1,5,6
HND-010548,2011,121600049,,,,2,0,2
HND-010549,2011,121600050,,,,9,2,11
HND-010550,2011,121600051,,,,4,2,6
HND-010557,2011,121600127,,,,4,3,7
,2011,121600073,,,,20,19,39
,2011,121600159,,,,18,19,37
HND-010522,2011,121600019,,,,7,12,19
HND-010522,2011,121600019,,,,3,12,15
,2011,121600073,,,,16,13,29
,2011,121600159,,,,21,15,36
,2011,121600073,,,,21,20,41
,2011,121600159,,,,22,27,49
HND-010522,2011,121600019,,,,6,6,12
,2011,121600159,,,,8,6,14
,2011,121600159,,,,10,10,20
,2011,121600159,,,,9,5,14
HND-010583,2011,121700010,,,,1,6,7
HND-010598,2011,121700026,,,,5,10,15
,2011,121700049,,,,5,7,12
,2011,121700055,,,,4,7,11
HND-010614,2011,121700092,,,,12,7,19
HND-010615,2011,121700094,,,,11,2,13
,2011,121700095,,,,2,5,7
HND-010616,2011,121700097,,,,6,5,11
,2011,121700108,,,,2,4,6
HND-010620,2011,121700113,,,,5,3,8
HND-010581,2011,121700008,,,,10,5,15
HND-010603,2011,121700035,,,,10,10,20
HND-010605,2011,121700039,,,,8,4,12
HND-010606,2011,121700042,,,,3,4,7
,2011,121700044,,,,5,6,11
HND-010613,2011,121700091,,,,3,5,8
,2011,121700096,,,,5,8,13
,2011,121700106,,,,3,4,7
,2011,121700107,,,,4,3,7
HND-010617,2011,121700109,,,,3,3,6
,2011,121700110,,,,9,8,17
HND-010594,2011,121700022,,,,5,4,9
HND-010600,2011,121700028,,,,2,2,4
HND-010601,2011,121700029,,,,1,2,3
,2011,121700037,,,,6,4,10
HND-010604,2011,121700038,,,,3,9,12
,2011,121700045,,,,8,2,10
HND-010611,2011,121700085,,,,2,3,5
HND-010574,2011,121700001,,,,1,3,4
HND-010590,2011,121700018,,,,5,3,8
HND-010602,2011,121700030,,,,1,1,2
HND-010609,2011,121700054,,,,5,3,8
HND-010612,2011,121700089,,,,2,3,5
HND-010574,2011,121700001,,,,12,9,21
HND-010594,2011,121700022,,,,6,8,14
HND-010600,2011,121700028,,,,12,14,26
HND-010601,2011,121700029,,,,15,5,20
HND-010602,2011,121700030,,,,7,10,17
,2011,121700037,,,,2,7,9
HND-010609,2011,121700054,,,,4,1,5
HND-010612,2011,121700089,,,,7,11,18
HND-010590,2011,121700018,,,,7,3,10
HND-010604,2011,121700038,,,,2,5,7
,2011,121700045,,,,4,2,6
HND-010611,2011,121700085,,,,7,11,18
HND-010575,2011,121700002,,,,2,3,5
HND-010577,2011,121700004,,,,4,3,7
HND-010579,2011,121700006,,,,4,2,6
HND-010583,2011,121700010,,,,1,0,1
HND-010588,2011,121700016,,,,4,3,7
HND-010591,2011,121700019,,,,7,10,17
HND-010592,2011,121700020,,,,7,8,15
HND-010593,2011,121700021,,,,5,2,7
HND-010596,2011,121700024,,,,7,9,16
HND-010598,2011,121700026,,,,5,4,9
HND-010607,2011,121700047,,,,4,5,9
HND-010610,2011,121700084,,,,5,3,8
HND-010576,2011,121700003,,,,5,7,12
HND-010578,2011,121700005,,,,11,11,22
HND-010580,2011,121700007,,,,5,6,11
HND-010581,2011,121700008,,,,4,4,8
HND-010582,2011,121700009,,,,24,14,38
HND-010584,2011,121700011,,,,12,10,22
HND-010585,2011,121700012,,,,2,3,5
HND-010586,2011,121700014,,,,4,4,8
HND-010587,2011,121700015,,,,5,9,14
HND-010589,2011,121700017,,,,2,5,7
HND-010590,2011,121700018,,,,10,7,17
HND-010594,2011,121700022,,,,5,2,7
HND-010595,2011,121700023,,,,3,2,5
HND-010597,2011,121700025,,,,2,1,3
HND-010599,2011,121700027,,,,8,5,13
HND-010608,2011,121700052,,,,4,3,7
HND-010609,2011,121700054,,,,0,4,4
HND-010612,2011,121700089,,,,8,2,10
HND-010619,2011,121700111,,,,0,1,1
HND-010575,2011,121700002,,,,6,6,12
HND-010576,2011,121700003,,,,4,4,8
HND-010577,2011,121700004,,,,6,7,13
HND-010578,2011,121700005,,,,14,16,30
HND-010579,2011,121700006,,,,5,4,9
HND-010580,2011,121700007,,,,5,2,7
HND-010583,2011,121700010,,,,1,4,5
HND-010585,2011,121700012,,,,3,4,7
HND-010586,2011,121700014,,,,4,1,5
HND-010588,2011,121700016,,,,5,5,10
HND-010592,2011,121700020,,,,3,6,9
HND-010593,2011,121700021,,,,2,2,4
HND-010594,2011,121700022,,,,7,7,14
HND-010595,2011,121700023,,,,1,2,3
HND-010596,2011,121700024,,,,5,6,11
HND-010597,2011,121700025,,,,3,5,8
HND-010598,2011,121700026,,,,3,4,7
HND-010599,2011,121700027,,,,4,8,12
HND-010608,2011,121700052,,,,4,2,6
HND-010609,2011,121700054,,,,4,1,5
HND-010612,2011,121700089,,,,5,3,8
HND-010581,2011,121700008,,,,5,2,7
HND-010582,2011,121700009,,,,14,15,29
HND-010584,2011,121700011,,,,7,14,21
HND-010587,2011,121700015,,,,10,12,22
HND-010589,2011,121700017,,,,6,7,13
HND-010590,2011,121700018,,,,8,9,17
HND-010591,2011,121700019,,,,8,7,15
HND-010607,2011,121700047,,,,6,9,15
HND-010610,2011,121700084,,,,8,4,12
HND-010575,2011,121700002,,,,5,6,11
HND-010577,2011,121700004,,,,2,5,7
HND-010579,2011,121700006,,,,6,4,10
HND-010583,2011,121700010,,,,2,2,4
HND-010588,2011,121700016,,,,8,2,10
HND-010591,2011,121700019,,,,11,7,18
HND-010592,2011,121700020,,,,9,3,12
HND-010593,2011,121700021,,,,5,3,8
HND-010594,2011,121700022,,,,5,2,7
HND-010596,2011,121700024,,,,6,6,12
HND-010598,2011,121700026,,,,2,5,7
HND-010608,2011,121700052,,,,2,4,6
HND-010609,2011,121700054,,,,4,1,5
HND-010612,2011,121700089,,,,5,5,10
HND-010619,2011,121700111,,,,5,0,5
HND-010576,2011,121700003,,,,6,5,11
HND-010578,2011,121700005,,,,20,10,30
HND-010580,2011,121700007,,,,3,5,8
HND-010581,2011,121700008,,,,6,1,7
HND-010582,2011,121700009,,,,13,17,30
HND-010584,2011,121700011,,,,9,9,18
HND-010585,2011,121700012,,,,1,3,4
HND-010586,2011,121700014,,,,2,6,8
HND-010587,2011,121700015,,,,13,13,26
HND-010589,2011,121700017,,,,3,3,6
HND-010590,2011,121700018,,,,8,6,14
HND-010595,2011,121700023,,,,1,2,3
HND-010599,2011,121700027,,,,8,5,13
HND-010607,2011,121700047,,,,3,4,7
HND-010610,2011,121700084,,,,10,7,17
HND-010575,2011,121700002,,,,3,4,7
HND-010576,2011,121700003,,,,6,11,17
HND-010577,2011,121700004,,,,5,1,6
HND-010578,2011,121700005,,,,7,14,21
HND-010580,2011,121700007,,,,6,3,9
HND-010581,2011,121700008,,,,2,5,7
HND-010583,2011,121700010,,,,4,2,6
HND-010584,2011,121700011,,,,9,9,18
HND-010585,2011,121700012,,,,0,1,1
HND-010586,2011,121700014,,,,3,4,7
HND-010587,2011,121700015,,,,14,9,23
HND-010588,2011,121700016,,,,4,5,9
HND-010589,2011,121700017,,,,4,6,10
HND-010594,2011,121700022,,,,4,2,6
HND-010595,2011,121700023,,,,1,0,1
HND-010596,2011,121700024,,,,9,12,21
HND-010597,2011,121700025,,,,2,3,5
HND-010599,2011,121700027,,,,7,4,11
HND-010608,2011,121700052,,,,5,4,9
HND-010609,2011,121700054,,,,2,2,4
HND-010612,2011,121700089,,,,3,8,11
HND-010579,2011,121700006,,,,4,5,9
HND-010582,2011,121700009,,,,18,16,34
HND-010590,2011,121700018,,,,5,7,12
HND-010591,2011,121700019,,,,13,6,19
HND-010592,2011,121700020,,,,3,1,4
HND-010593,2011,121700021,,,,1,4,5
HND-010598,2011,121700026,,,,1,5,6
HND-010607,2011,121700047,,,,4,5,9
HND-010610,2011,121700084,,,,7,6,13
HND-010619,2011,121700111,,,,3,2,5
HND-010575,2011,121700002,,,,5,5,10
HND-010576,2011,121700003,,,,5,4,9
HND-010577,2011,121700004,,,,4,5,9
HND-010578,2011,121700005,,,,16,11,27
HND-010580,2011,121700007,,,,8,5,13
HND-010581,2011,121700008,,,,2,6,8
HND-010584,2011,121700011,,,,16,10,26
HND-010585,2011,121700012,,,,3,3,6
HND-010586,2011,121700014,,,,5,7,12
HND-010587,2011,121700015,,,,19,12,31
HND-010589,2011,121700017,,,,5,6,11
HND-010594,2011,121700022,,,,10,5,15
HND-010595,2011,121700023,,,,1,4,5
HND-010596,2011,121700024,,,,9,4,13
HND-010597,2011,121700025,,,,4,5,9
HND-010599,2011,121700027,,,,4,5,9
HND-010607,2011,121700047,,,,11,8,19
HND-010608,2011,121700052,,,,6,4,10
HND-010610,2011,121700084,,,,11,3,14
HND-010579,2011,121700006,,,,5,1,6
HND-010582,2011,121700009,,,,24,18,42
HND-010583,2011,121700010,,,,3,3,6
HND-010588,2011,121700016,,,,3,3,6
HND-010590,2011,121700018,,,,3,8,11
HND-010591,2011,121700019,,,,12,14,26
HND-010592,2011,121700020,,,,6,7,13
HND-010593,2011,121700021,,,,2,2,4
HND-010598,2011,121700026,,,,4,3,7
HND-010609,2011,121700054,,,,2,6,8
HND-010612,2011,121700089,,,,6,5,11
HND-010619,2011,121700111,,,,3,0,3
HND-010581,2011,121700008,,,,8,5,13
HND-010582,2011,121700009,,,,23,19,42
HND-010584,2011,121700011,,,,21,9,30
HND-010587,2011,121700015,,,,8,11,19
HND-010589,2011,121700017,,,,4,8,12
HND-010590,2011,121700018,,,,2,7,9
HND-010591,2011,121700019,,,,11,5,16
HND-010607,2011,121700047,,,,8,8,16
HND-010610,2011,121700084,,,,4,6,10
HND-010575,2011,121700002,,,,4,5,9
HND-010576,2011,121700003,,,,8,4,12
HND-010577,2011,121700004,,,,0,4,4
HND-010578,2011,121700005,,,,10,13,23
HND-010579,2011,121700006,,,,4,6,10
HND-010580,2011,121700007,,,,8,9,17
HND-010583,2011,121700010,,,,2,4,6
HND-010585,2011,121700012,,,,0,1,1
HND-010586,2011,121700014,,,,6,4,10
HND-010588,2011,121700016,,,,6,7,13
HND-010592,2011,121700020,,,,3,4,7
HND-010593,2011,121700021,,,,5,5,10
HND-010594,2011,121700022,,,,5,5,10
HND-010595,2011,121700023,,,,4,2,6
HND-010596,2011,121700024,,,,8,9,17
HND-010597,2011,121700025,,,,2,6,8
HND-010598,2011,121700026,,,,6,3,9
HND-010599,2011,121700027,,,,2,6,8
HND-010608,2011,121700052,,,,6,2,8
HND-010609,2011,121700054,,,,3,4,7
HND-010612,2011,121700089,,,,3,6,9
HND-010619,2011,121700111,,,,3,2,5
HND-010576,2011,121700003,,,,4,7,11
HND-010584,2011,121700011,,,,26,22,48
HND-010582,2011,121700009,,,,33,46,79
HND-010576,2011,121700003,,,,10,4,14
HND-010582,2011,121700009,,,,36,29,65
HND-010584,2011,121700011,,,,20,19,39
HND-010582,2011,121700009,,,,28,23,51
HND-010584,2011,121700011,,,,20,16,36
,2011,121800027,,,,11,7,18
HND-010663,2011,121800073,,,,7,5,12
HND-010667,2011,121800082,,,,11,18,29
HND-010668,2011,121800083,,,,21,12,33
HND-010669,2011,121800084,,,,5,7,12
HND-010670,2011,121800085,,,,11,13,24
HND-010673,2011,121800090,,,,11,4,15
,2011,121800101,,,,6,8,14
,2011,121800151,,,,5,4,9
,2011,121800175,,,,6,6,12
,2011,121800180,,,,4,6,10
,2011,121800182,,,,9,9,18
,2011,121800062,,,,8,10,18
HND-010672,2011,121800088,,,,4,5,9
,2011,121800089,,,,10,11,21
,2011,121800176,,,,12,4,16
,2011,121800177,,,,3,4,7
HND-010681,2011,121800179,,,,10,14,24
HND-010682,2011,121800181,,,,6,5,11
,2011,121800183,,,,2,3,5
HND-010658,2011,121800067,,,,2,1,3
HND-010660,2011,121800069,,,,0,2,2
HND-010674,2011,121800091,,,,1,2,3
HND-010676,2011,121800094,,,,7,9,16
HND-010671,2011,121800086,,,,4,3,7
HND-010677,2011,121800115,,,,4,2,6
HND-010678,2011,121800150,,,,0,1,1
HND-010625,2011,121800002,,,,0,1,1
HND-010627,2011,121800004,,,,3,3,6
HND-010628,2011,121800005,,,,1,6,7
HND-010659,2011,121800068,,,,6,5,11
HND-010661,2011,121800070,,,,1,1,2
HND-010671,2011,121800086,,,,2,5,7
HND-010658,2011,121800067,,,,10,7,17
HND-010660,2011,121800069,,,,3,3,6
HND-010674,2011,121800091,,,,6,5,11
HND-010676,2011,121800094,,,,3,13,16
HND-010677,2011,121800115,,,,4,2,6
HND-010678,2011,121800150,,,,7,2,9
HND-010625,2011,121800002,,,,13,3,16
HND-010626,2011,121800003,,,,9,13,22
HND-010627,2011,121800004,,,,5,5,10
HND-010628,2011,121800005,,,,3,4,7
HND-010659,2011,121800068,,,,7,8,15
HND-010671,2011,121800086,,,,3,2,5
HND-010674,2011,121800091,,,,5,2,7
HND-010677,2011,121800115,,,,5,5,10
HND-010658,2011,121800067,,,,19,21,40
HND-010660,2011,121800069,,,,8,2,10
HND-010661,2011,121800070,,,,4,4,8
HND-010676,2011,121800094,,,,6,5,11
HND-010678,2011,121800150,,,,12,3,15
HND-010629,2011,121800037,,,,18,8,26
HND-010630,2011,121800038,,,,13,8,21
HND-010631,2011,121800039,,,,4,6,10
HND-010632,2011,121800040,,,,30,23,53
HND-010635,2011,121800043,,,,4,4,8
HND-010637,2011,121800045,,,,11,13,24
HND-010639,2011,121800047,,,,9,0,9
HND-010640,2011,121800048,,,,15,14,29
HND-010641,2011,121800049,,,,8,9,17
HND-010642,2011,121800050,,,,8,12,20
HND-010643,2011,121800051,,,,11,9,20
HND-010644,2011,121800052,,,,9,8,17
HND-010645,2011,121800053,,,,5,7,12
HND-010646,2011,121800054,,,,13,4,17
HND-010647,2011,121800055,,,,5,8,13
HND-010648,2011,121800056,,,,2,0,2
HND-010649,2011,121800057,,,,3,6,9
HND-010652,2011,121800060,,,,0,1,1
HND-010653,2011,121800061,,,,7,8,15
HND-010654,2011,121800063,,,,2,4,6
HND-010655,2011,121800064,,,,7,3,10
HND-010656,2011,121800065,,,,2,3,5
HND-010657,2011,121800066,,,,12,15,27
HND-010664,2011,121800076,,,,5,4,9
HND-010665,2011,121800080,,,,10,9,19
HND-010680,2011,121800178,,,,3,2,5
HND-010683,2011,121800184,,,,9,8,17
HND-010633,2011,121800041,,,,6,3,9
HND-010634,2011,121800042,,,,17,6,23
HND-010636,2011,121800044,,,,11,7,18
HND-010638,2011,121800046,,,,30,19,49
HND-010650,2011,121800058,,,,8,7,15
HND-010651,2011,121800059,,,,17,13,30
HND-010670,2011,121800085,,,,8,8,16
HND-010675,2011,121800092,,,,1,3,4
HND-010679,2011,121800161,,,,4,2,6
HND-010684,2011,121800185,,,,1,2,3
HND-010630,2011,121800038,,,,4,4,8
HND-010632,2011,121800040,,,,30,28,58
HND-010634,2011,121800042,,,,10,6,16
HND-010635,2011,121800043,,,,8,6,14
HND-010636,2011,121800044,,,,4,11,15
HND-010637,2011,121800045,,,,5,10,15
HND-010639,2011,121800047,,,,10,8,18
HND-010642,2011,121800050,,,,8,3,11
HND-010643,2011,121800051,,,,7,4,11
HND-010648,2011,121800056,,,,3,1,4
HND-010651,2011,121800059,,,,8,10,18
HND-010654,2011,121800063,,,,3,4,7
HND-010655,2011,121800064,,,,6,6,12
HND-010629,2011,121800037,,,,12,10,22
HND-010631,2011,121800039,,,,0,4,4
HND-010633,2011,121800041,,,,2,4,6
HND-010638,2011,121800046,,,,6,24,30
HND-010640,2011,121800048,,,,13,16,29
HND-010641,2011,121800049,,,,7,11,18
HND-010644,2011,121800052,,,,10,10,20
HND-010645,2011,121800053,,,,11,12,23
HND-010646,2011,121800054,,,,8,8,16
HND-010647,2011,121800055,,,,3,5,8
HND-010649,2011,121800057,,,,5,5,10
HND-010650,2011,121800058,,,,9,13,22
HND-010652,2011,121800060,,,,2,2,4
HND-010653,2011,121800061,,,,6,2,8
HND-010657,2011,121800066,,,,12,9,21
HND-010664,2011,121800076,,,,2,2,4
HND-010665,2011,121800080,,,,9,12,21
HND-010666,2011,121800081,,,,2,1,3
HND-010670,2011,121800085,,,,3,6,9
HND-010675,2011,121800092,,,,1,0,1
HND-010679,2011,121800161,,,,2,3,5
HND-010680,2011,121800178,,,,3,0,3
HND-010683,2011,121800184,,,,3,8,11
HND-010684,2011,121800185,,,,2,3,5
HND-010634,2011,121800042,,,,16,5,21
HND-010635,2011,121800043,,,,4,5,9
HND-010636,2011,121800044,,,,5,10,15
HND-010638,2011,121800046,,,,16,12,28
HND-010639,2011,121800047,,,,14,11,25
HND-010650,2011,121800058,,,,4,8,12
HND-010651,2011,121800059,,,,7,7,14
HND-010652,2011,121800060,,,,4,1,5
HND-010653,2011,121800061,,,,1,4,5
HND-010654,2011,121800063,,,,2,5,7
HND-010655,2011,121800064,,,,3,2,5
HND-010656,2011,121800065,,,,1,2,3
HND-010670,2011,121800085,,,,4,6,10
HND-010675,2011,121800092,,,,0,5,5
HND-010629,2011,121800037,,,,16,8,24
HND-010630,2011,121800038,,,,2,4,6
HND-010631,2011,121800039,,,,7,4,11
HND-010632,2011,121800040,,,,28,38,66
HND-010637,2011,121800045,,,,3,9,12
HND-010640,2011,121800048,,,,13,12,25
HND-010641,2011,121800049,,,,11,7,18
HND-010642,2011,121800050,,,,6,10,16
HND-010643,2011,121800051,,,,5,10,15
HND-010644,2011,121800052,,,,8,6,14
HND-010645,2011,121800053,,,,9,12,21
HND-010646,2011,121800054,,,,15,8,23
HND-010647,2011,121800055,,,,6,7,13
HND-010648,2011,121800056,,,,2,0,2
HND-010649,2011,121800057,,,,3,3,6
HND-010657,2011,121800066,,,,0,7,7
HND-010664,2011,121800076,,,,7,2,9
HND-010665,2011,121800080,,,,2,3,5
HND-010666,2011,121800081,,,,3,0,3
HND-010679,2011,121800161,,,,1,1,2
HND-010680,2011,121800178,,,,3,3,6
HND-010683,2011,121800184,,,,3,6,9
HND-010684,2011,121800185,,,,0,3,3
HND-010630,2011,121800038,,,,5,3,8
HND-010632,2011,121800040,,,,20,18,38
HND-010634,2011,121800042,,,,6,6,12
HND-010635,2011,121800043,,,,3,2,5
HND-010636,2011,121800044,,,,3,4,7
HND-010637,2011,121800045,,,,10,10,20
HND-010639,2011,121800047,,,,7,6,13
HND-010640,2011,121800048,,,,11,14,25
HND-010642,2011,121800050,,,,5,6,11
HND-010643,2011,121800051,,,,4,6,10
HND-010644,2011,121800052,,,,6,4,10
HND-010646,2011,121800054,,,,8,14,22
HND-010648,2011,121800056,,,,0,3,3
HND-010654,2011,121800063,,,,7,1,8
HND-010656,2011,121800065,,,,0,2,2
HND-010664,2011,121800076,,,,2,3,5
HND-010665,2011,121800080,,,,7,5,12
HND-010666,2011,121800081,,,,0,3,3
HND-010629,2011,121800037,,,,13,17,30
HND-010631,2011,121800039,,,,1,3,4
HND-010633,2011,121800041,,,,4,1,5
HND-010638,2011,121800046,,,,17,11,28
HND-010641,2011,121800049,,,,12,4,16
HND-010645,2011,121800053,,,,14,12,26
HND-010647,2011,121800055,,,,5,4,9
HND-010649,2011,121800057,,,,2,2,4
HND-010650,2011,121800058,,,,4,8,12
HND-010651,2011,121800059,,,,9,10,19
HND-010652,2011,121800060,,,,4,1,5
HND-010653,2011,121800061,,,,2,3,5
HND-010655,2011,121800064,,,,3,2,5
HND-010657,2011,121800066,,,,8,8,16
HND-010670,2011,121800085,,,,0,2,2
HND-010675,2011,121800092,,,,1,1,2
HND-010679,2011,121800161,,,,3,1,4
HND-010680,2011,121800178,,,,2,1,3
HND-010684,2011,121800185,,,,3,1,4
HND-010629,2011,121800037,,,,20,23,43
HND-010630,2011,121800038,,,,3,5,8
HND-010631,2011,121800039,,,,5,2,7
HND-010632,2011,121800040,,,,26,25,51
HND-010635,2011,121800043,,,,5,2,7
HND-010637,2011,121800045,,,,5,2,7
HND-010639,2011,121800047,,,,10,17,27
HND-010640,2011,121800048,,,,15,7,22
HND-010642,2011,121800050,,,,3,5,8
HND-010643,2011,121800051,,,,10,7,17
HND-010644,2011,121800052,,,,5,4,9
HND-010645,2011,121800053,,,,10,7,17
HND-010646,2011,121800054,,,,12,9,21
HND-010648,2011,121800056,,,,3,5,8
HND-010649,2011,121800057,,,,8,3,11
HND-010656,2011,121800065,,,,3,0,3
HND-010664,2011,121800076,,,,2,1,3
HND-010665,2011,121800080,,,,5,7,12
HND-010666,2011,121800081,,,,3,2,5
HND-010680,2011,121800178,,,,3,2,5
HND-010633,2011,121800041,,,,3,2,5
HND-010634,2011,121800042,,,,2,4,6
HND-010636,2011,121800044,,,,3,4,7
HND-010638,2011,121800046,,,,18,13,31
HND-010641,2011,121800049,,,,9,4,13
HND-010647,2011,121800055,,,,2,5,7
HND-010650,2011,121800058,,,,2,3,5
HND-010651,2011,121800059,,,,10,12,22
HND-010652,2011,121800060,,,,0,2,2
HND-010653,2011,121800061,,,,2,8,10
HND-010654,2011,121800063,,,,2,1,3
HND-010655,2011,121800064,,,,4,5,9
HND-010657,2011,121800066,,,,18,13,31
HND-010670,2011,121800085,,,,4,3,7
HND-010675,2011,121800092,,,,1,0,1
HND-010679,2011,121800161,,,,3,2,5
HND-010684,2011,121800185,,,,1,1,2
HND-010629,2011,121800037,,,,14,11,25
HND-010631,2011,121800039,,,,4,2,6
HND-010633,2011,121800041,,,,3,3,6
HND-010638,2011,121800046,,,,15,18,33
HND-010640,2011,121800048,,,,6,9,15
HND-010641,2011,121800049,,,,7,5,12
HND-010644,2011,121800052,,,,5,7,12
HND-010645,2011,121800053,,,,7,4,11
HND-010646,2011,121800054,,,,2,14,16
HND-010647,2011,121800055,,,,1,2,3
HND-010649,2011,121800057,,,,4,2,6
HND-010650,2011,121800058,,,,0,4,4
HND-010653,2011,121800061,,,,2,3,5
HND-010657,2011,121800066,,,,10,8,18
HND-010664,2011,121800076,,,,3,0,3
HND-010665,2011,121800080,,,,3,7,10
HND-010670,2011,121800085,,,,2,5,7
HND-010675,2011,121800092,,,,1,1,2
HND-010679,2011,121800161,,,,1,1,2
HND-010680,2011,121800178,,,,1,1,2
HND-010683,2011,121800184,,,,1,1,2
HND-010684,2011,121800185,,,,0,2,2
HND-010630,2011,121800038,,,,2,2,4
HND-010632,2011,121800040,,,,27,28,55
HND-010634,2011,121800042,,,,4,7,11
HND-010635,2011,121800043,,,,4,3,7
HND-010636,2011,121800044,,,,9,3,12
HND-010637,2011,121800045,,,,8,6,14
HND-010639,2011,121800047,,,,12,8,20
HND-010642,2011,121800050,,,,5,9,14
HND-010643,2011,121800051,,,,2,5,7
HND-010648,2011,121800056,,,,4,1,5
HND-010651,2011,121800059,,,,7,12,19
HND-010654,2011,121800063,,,,4,3,7
HND-010655,2011,121800064,,,,0,2,2
HND-010656,2011,121800065,,,,0,1,1
HND-010642,2011,121800050,,,,10,8,18
HND-010643,2011,121800051,,,,5,12,17
HND-010662,2011,121800071,,,,80,78,158
HND-010638,2011,121800046,,,,8,6,14
HND-010642,2011,121800050,,,,9,15,24
HND-010643,2011,121800051,,,,5,10,15
HND-010638,2011,121800046,,,,3,2,5
HND-010662,2011,121800071,,,,79,54,133
HND-010642,2011,121800050,,,,6,8,14
HND-010643,2011,121800051,,,,7,12,19
HND-010638,2011,121800046,,,,6,3,9
HND-010662,2011,121800071,,,,53,66,119
HND-010662,2011,121800071,,,,20,40,60
HND-010662,2011,121800071,,,,16,21,37
HND-010662,2011,121800071,,,,7,26,33
HND-010706,2011,121900023,,,,4,6,10
HND-010708,2011,121900025,,,,6,4,10
HND-010710,2011,121900028,,,,5,5,10
HND-010712,2011,121900030,,,,5,4,9
,2011,121900042,,,,3,2,5
HND-010692,2011,121900008,,,,10,7,17
HND-010696,2011,121900012,,,,5,2,7
HND-010707,2011,121900024,,,,3,3,6
HND-010709,2011,121900026,,,,4,7,11
,2011,121900067,,,,7,3,10
HND-010720,2011,121900068,,,,5,2,7
HND-010711,2011,121900029,,,,3,0,3
HND-010700,2011,121900016,,,,1,3,4
HND-010701,2011,121900017,,,,1,0,1
HND-010705,2011,121900021,,,,2,2,4
HND-010711,2011,121900029,,,,4,7,11
HND-010719,2011,121900038,,,,4,3,7
HND-010695,2011,121900011,,,,14,12,26
HND-010711,2011,121900029,,,,2,3,5
HND-010719,2011,121900038,,,,7,4,11
HND-010700,2011,121900016,,,,8,10,18
HND-010701,2011,121900017,,,,15,16,31
HND-010702,2011,121900018,,,,13,14,27
HND-010704,2011,121900020,,,,12,10,22
HND-010705,2011,121900021,,,,7,6,13
HND-010688,2011,121900004,,,,6,3,9
HND-010690,2011,121900006,,,,12,15,27
HND-010693,2011,121900009,,,,2,1,3
HND-010699,2011,121900015,,,,4,6,10
HND-010703,2011,121900019,,,,17,17,34
HND-010712,2011,121900030,,,,2,2,4
HND-010713,2011,121900031,,,,10,3,13
HND-010721,2011,121900070,,,,2,3,5
HND-010686,2011,121900002,,,,7,10,17
HND-010687,2011,121900003,,,,10,8,18
HND-010689,2011,121900005,,,,13,14,27
HND-010691,2011,121900007,,,,11,7,18
HND-010692,2011,121900008,,,,13,6,19
HND-010694,2011,121900010,,,,5,3,8
HND-010696,2011,121900012,,,,3,5,8
HND-010697,2011,121900013,,,,2,2,4
HND-010698,2011,121900014,,,,2,1,3
HND-010714,2011,121900032,,,,3,3,6
HND-010715,2011,121900033,,,,2,3,5
HND-010716,2011,121900034,,,,3,3,6
HND-010717,2011,121900035,,,,7,1,8
HND-010718,2011,121900037,,,,5,1,6
HND-010687,2011,121900003,,,,13,15,28
HND-010688,2011,121900004,,,,3,5,8
HND-010689,2011,121900005,,,,18,17,35
HND-010690,2011,121900006,,,,20,8,28
HND-010691,2011,121900007,,,,4,5,9
HND-010694,2011,121900010,,,,5,3,8
HND-010703,2011,121900019,,,,13,15,28
HND-010717,2011,121900035,,,,1,4,5
HND-010686,2011,121900002,,,,10,3,13
HND-010692,2011,121900008,,,,7,5,12
HND-010693,2011,121900009,,,,1,2,3
HND-010696,2011,121900012,,,,4,3,7
HND-010697,2011,121900013,,,,4,3,7
HND-010698,2011,121900014,,,,5,4,9
HND-010699,2011,121900015,,,,3,1,4
HND-010712,2011,121900030,,,,3,1,4
HND-010713,2011,121900031,,,,11,8,19
HND-010714,2011,121900032,,,,0,4,4
HND-010715,2011,121900033,,,,3,5,8
HND-010716,2011,121900034,,,,1,5,6
HND-010718,2011,121900037,,,,3,3,6
HND-010721,2011,121900070,,,,1,0,1
HND-010686,2011,121900002,,,,8,15,23
HND-010687,2011,121900003,,,,12,11,23
HND-010689,2011,121900005,,,,13,12,25
HND-010691,2011,121900007,,,,6,8,14
HND-010692,2011,121900008,,,,9,10,19
HND-010693,2011,121900009,,,,5,1,6
HND-010694,2011,121900010,,,,4,2,6
HND-010696,2011,121900012,,,,7,6,13
HND-010697,2011,121900013,,,,2,1,3
HND-010698,2011,121900014,,,,2,0,2
HND-010715,2011,121900033,,,,2,2,4
HND-010717,2011,121900035,,,,5,8,13
HND-010718,2011,121900037,,,,2,1,3
HND-010688,2011,121900004,,,,6,8,14
HND-010690,2011,121900006,,,,19,15,34
HND-010699,2011,121900015,,,,7,3,10
HND-010703,2011,121900019,,,,22,15,37
HND-010712,2011,121900030,,,,3,2,5
HND-010713,2011,121900031,,,,7,8,15
HND-010714,2011,121900032,,,,5,3,8
HND-010716,2011,121900034,,,,9,4,13
HND-010721,2011,121900070,,,,3,4,7
HND-010687,2011,121900003,,,,20,13,33
HND-010688,2011,121900004,,,,6,5,11
HND-010689,2011,121900005,,,,10,21,31
HND-010691,2011,121900007,,,,4,3,7
HND-010692,2011,121900008,,,,8,9,17
HND-010694,2011,121900010,,,,5,2,7
HND-010703,2011,121900019,,,,17,23,40
HND-010686,2011,121900002,,,,10,3,13
HND-010690,2011,121900006,,,,15,13,28
HND-010693,2011,121900009,,,,4,3,7
HND-010696,2011,121900012,,,,7,4,11
HND-010697,2011,121900013,,,,2,1,3
HND-010698,2011,121900014,,,,2,4,6
HND-010699,2011,121900015,,,,7,3,10
HND-010712,2011,121900030,,,,5,1,6
HND-010713,2011,121900031,,,,10,5,15
HND-010714,2011,121900032,,,,6,4,10
HND-010715,2011,121900033,,,,5,5,10
HND-010716,2011,121900034,,,,0,5,5
HND-010717,2011,121900035,,,,3,3,6
HND-010718,2011,121900037,,,,3,1,4
HND-010721,2011,121900070,,,,3,1,4
HND-010686,2011,121900002,,,,4,7,11
HND-010687,2011,121900003,,,,7,11,18
HND-010688,2011,121900004,,,,4,10,14
HND-010689,2011,121900005,,,,22,19,41
HND-010691,2011,121900007,,,,4,3,7
HND-010692,2011,121900008,,,,10,0,10
HND-010694,2011,121900010,,,,2,3,5
HND-010696,2011,121900012,,,,1,6,7
HND-010698,2011,121900014,,,,1,4,5
HND-010712,2011,121900030,,,,2,2,4
HND-010713,2011,121900031,,,,11,9,20
HND-010721,2011,121900070,,,,1,1,2
HND-010690,2011,121900006,,,,14,14,28
HND-010693,2011,121900009,,,,0,2,2
HND-010697,2011,121900013,,,,3,2,5
HND-010699,2011,121900015,,,,7,3,10
HND-010703,2011,121900019,,,,16,17,33
HND-010714,2011,121900032,,,,7,4,11
HND-010715,2011,121900033,,,,7,7,14
HND-010716,2011,121900034,,,,0,6,6
HND-010717,2011,121900035,,,,0,6,6
HND-010718,2011,121900037,,,,5,3,8
HND-010686,2011,121900002,,,,7,4,11
HND-010692,2011,121900008,,,,9,9,18
HND-010693,2011,121900009,,,,4,2,6
HND-010696,2011,121900012,,,,7,7,14
HND-010697,2011,121900013,,,,3,1,4
HND-010698,2011,121900014,,,,1,4,5
HND-010699,2011,121900015,,,,6,4,10
HND-010712,2011,121900030,,,,6,1,7
HND-010713,2011,121900031,,,,3,4,7
HND-010714,2011,121900032,,,,6,7,13
HND-010715,2011,121900033,,,,3,2,5
HND-010716,2011,121900034,,,,5,8,13
HND-010718,2011,121900037,,,,1,3,4
HND-010721,2011,121900070,,,,3,2,5
HND-010687,2011,121900003,,,,11,8,19
HND-010688,2011,121900004,,,,5,10,15
HND-010689,2011,121900005,,,,14,12,26
HND-010690,2011,121900006,,,,15,16,31
HND-010691,2011,121900007,,,,3,4,7
HND-010694,2011,121900010,,,,5,4,9
HND-010703,2011,121900019,,,,19,17,36
HND-010717,2011,121900035,,,,3,4,7
HND-010685,2011,121900001,,,,18,13,31
HND-010688,2011,121900004,,,,5,10,15
HND-010703,2011,121900019,,,,14,11,25
HND-010686,2011,121900002,,,,26,17,43
,2011,121900036,,,,5,0,5
HND-010685,2011,121900001,,,,11,12,23
HND-010688,2011,121900004,,,,7,5,12
HND-010703,2011,121900019,,,,15,7,22
,2011,121900036,,,,11,6,17
HND-010686,2011,121900002,,,,16,13,29
HND-010685,2011,121900001,,,,11,7,18
HND-010688,2011,121900004,,,,4,3,7
HND-010703,2011,121900019,,,,10,9,19
HND-010686,2011,121900002,,,,9,4,13
,2011,121900036,,,,5,4,9
HND-010685,2011,121900001,,,,10,6,16
HND-010685,2011,121900001,,,,7,1,8
HND-010685,2011,121900001,,,,9,6,15
HND-010788,2011,130100076,,,,2,4,6
HND-010820,2011,130100208,,,,9,8,17
HND-010824,2011,130100215,,,,13,7,20
,2011,130100216,,,,14,8,22
,2011,130100247,,,,2,4,6
,2011,130100249,,,,6,4,10
,2011,130100094,,,,11,8,19
,2011,130100207,,,,6,10,16
,2011,130100209,,,,9,9,18
,2011,130100211,,,,7,3,10
HND-010822,2011,130100212,,,,3,5,8
,2011,130100213,,,,8,3,11
HND-010823,2011,130100214,,,,11,12,23
,2011,130100218,,,,1,5,6
,2011,130100220,,,,10,8,18
HND-010831,2011,130100248,,,,6,6,12
HND-010762,2011,130100041,,,,1,0,1
HND-010768,2011,130100049,,,,28,29,57
HND-010771,2011,130100053,,,,13,11,24
HND-010776,2011,130100063,,,,8,8,16
HND-010777,2011,130100065,,,,12,11,23
HND-010778,2011,130100066,,,,0,1,1
HND-010779,2011,130100067,,,,3,2,5
HND-010781,2011,130100069,,,,2,3,5
HND-010787,2011,130100075,,,,3,3,6
HND-010797,2011,130100090,,,,2,5,7
,2011,130100101,,,,5,1,6
HND-010804,2011,130100103,,,,4,6,10
,2011,130100107,,,,3,1,4
HND-010808,2011,130100110,,,,1,2,3
HND-010809,2011,130100112,,,,2,3,5
HND-010811,2011,130100114,,,,9,4,13
HND-010813,2011,130100116,,,,0,4,4
,2011,130100119,,,,3,1,4
HND-010819,2011,130100206,,,,11,10,21
HND-010827,2011,130100243,,,,2,4,6
HND-010828,2011,130100244,,,,1,1,2
HND-010830,2011,130100246,,,,1,1,2
HND-010770,2011,130100052,,,,21,12,33
HND-010772,2011,130100055,,,,3,1,4
HND-010780,2011,130100068,,,,1,2,3
HND-010782,2011,130100070,,,,9,7,16
HND-010783,2011,130100071,,,,3,6,9
HND-010785,2011,130100073,,,,5,11,16
HND-010789,2011,130100077,,,,2,0,2
HND-010800,2011,130100096,,,,3,3,6
HND-010801,2011,130100098,,,,3,0,3
HND-010802,2011,130100099,,,,1,0,1
,2011,130100100,,,,3,3,6
HND-010807,2011,130100108,,,,2,3,5
,2011,130100111,,,,0,3,3
HND-010810,2011,130100113,,,,5,0,5
,2011,130100117,,,,2,8,10
HND-010814,2011,130100118,,,,2,0,2
HND-010815,2011,130100120,,,,4,4,8
,2011,130100204,,,,12,8,20
HND-010829,2011,130100245,,,,3,2,5
,2011,130100250,,,,12,8,20
HND-010770,2011,130100052,,,,25,20,45
HND-010771,2011,130100053,,,,13,10,23
HND-010772,2011,130100055,,,,7,6,13
HND-010781,2011,130100069,,,,11,5,16
HND-010783,2011,130100071,,,,6,2,8
HND-010785,2011,130100073,,,,1,8,9
HND-010788,2011,130100076,,,,0,1,1
HND-010789,2011,130100077,,,,3,6,9
HND-010797,2011,130100090,,,,12,10,22
,2011,130100094,,,,1,4,5
HND-010801,2011,130100098,,,,7,2,9
HND-010802,2011,130100099,,,,3,3,6
,2011,130100100,,,,7,3,10
,2011,130100107,,,,1,3,4
HND-010807,2011,130100108,,,,10,9,19
,2011,130100111,,,,7,1,8
HND-010809,2011,130100112,,,,5,3,8
,2011,130100119,,,,7,15,22
HND-010815,2011,130100120,,,,2,1,3
HND-010817,2011,130100202,,,,2,8,10
,2011,130100204,,,,4,9,13
HND-010819,2011,130100206,,,,15,11,26
HND-010827,2011,130100243,,,,7,4,11
HND-010830,2011,130100246,,,,6,5,11
HND-010762,2011,130100041,,,,1,3,4
HND-010768,2011,130100049,,,,48,34,82
HND-010769,2011,130100051,,,,10,6,16
HND-010776,2011,130100063,,,,6,6,12
HND-010777,2011,130100065,,,,14,10,24
HND-010778,2011,130100066,,,,3,3,6
HND-010779,2011,130100067,,,,5,8,13
HND-010780,2011,130100068,,,,7,8,15
HND-010782,2011,130100070,,,,7,17,24
HND-010786,2011,130100074,,,,6,4,10
HND-010787,2011,130100075,,,,5,5,10
,2011,130100093,,,,3,1,4
HND-010800,2011,130100096,,,,4,5,9
,2011,130100101,,,,2,2,4
HND-010804,2011,130100103,,,,4,9,13
HND-010808,2011,130100110,,,,6,11,17
HND-010810,2011,130100113,,,,2,4,6
HND-010811,2011,130100114,,,,11,3,14
HND-010812,2011,130100115,,,,4,7,11
HND-010813,2011,130100116,,,,3,5,8
,2011,130100117,,,,5,4,9
HND-010814,2011,130100118,,,,5,3,8
HND-010818,2011,130100205,,,,6,3,9
HND-010828,2011,130100244,,,,3,3,6
HND-010829,2011,130100245,,,,5,1,6
,2011,130100250,,,,4,9,13
HND-010762,2011,130100041,,,,21,16,37
HND-010768,2011,130100049,,,,44,57,101
HND-010769,2011,130100051,,,,8,4,12
HND-010771,2011,130100053,,,,10,10,20
HND-010776,2011,130100063,,,,10,14,24
HND-010779,2011,130100067,,,,12,13,25
HND-010780,2011,130100068,,,,11,6,17
HND-010787,2011,130100075,,,,11,7,18
HND-010797,2011,130100090,,,,16,11,27
,2011,130100093,,,,8,12,20
,2011,130100094,,,,10,6,16
HND-010800,2011,130100096,,,,7,3,10
,2011,130100100,,,,8,4,12
HND-010804,2011,130100103,,,,8,8,16
,2011,130100107,,,,4,5,9
HND-010807,2011,130100108,,,,5,4,9
,2011,130100111,,,,1,1,2
HND-010809,2011,130100112,,,,1,3,4
HND-010811,2011,130100114,,,,18,17,35
,2011,130100119,,,,6,0,6
HND-010819,2011,130100206,,,,11,10,21
HND-010828,2011,130100244,,,,8,7,15
HND-010829,2011,130100245,,,,4,0,4
,2011,130100250,,,,11,13,24
HND-010770,2011,130100052,,,,27,22,49
HND-010772,2011,130100055,,,,13,16,29
HND-010777,2011,130100065,,,,13,13,26
HND-010778,2011,130100066,,,,9,5,14
HND-010781,2011,130100069,,,,10,11,21
HND-010782,2011,130100070,,,,15,16,31
HND-010783,2011,130100071,,,,2,3,5
HND-010785,2011,130100073,,,,3,12,15
HND-010786,2011,130100074,,,,11,16,27
HND-010788,2011,130100076,,,,7,11,18
HND-010789,2011,130100077,,,,10,4,14
HND-010801,2011,130100098,,,,9,9,18
HND-010802,2011,130100099,,,,0,4,4
,2011,130100101,,,,2,2,4
HND-010808,2011,130100110,,,,9,24,33
HND-010810,2011,130100113,,,,3,6,9
HND-010812,2011,130100115,,,,14,10,24
HND-010813,2011,130100116,,,,5,8,13
,2011,130100117,,,,1,2,3
HND-010814,2011,130100118,,,,3,6,9
HND-010815,2011,130100120,,,,1,2,3
HND-010817,2011,130100202,,,,18,18,36
,2011,130100204,,,,11,13,24
HND-010818,2011,130100205,,,,16,13,29
HND-010827,2011,130100243,,,,5,1,6
HND-010830,2011,130100246,,,,11,11,22
HND-010727,2011,130100005,,,,9,10,19
HND-010728,2011,130100006,,,,12,10,22
HND-010731,2011,130100009,,,,25,21,46
HND-010735,2011,130100013,,,,6,6,12
,2011,130100015,,,,17,6,23
HND-010738,2011,130100016,,,,8,7,15
HND-010741,2011,130100019,,,,10,7,17
HND-010743,2011,130100021,,,,7,11,18
HND-010745,2011,130100023,,,,14,11,25
HND-010746,2011,130100024,,,,15,14,29
HND-010748,2011,130100026,,,,28,22,50
HND-010749,2011,130100027,,,,10,2,12
,2011,130100030,,,,10,7,17
HND-010753,2011,130100031,,,,5,10,15
HND-010755,2011,130100033,,,,17,13,30
HND-010756,2011,130100034,,,,10,14,24
HND-010758,2011,130100036,,,,12,12,24
HND-010761,2011,130100040,,,,17,12,29
HND-010762,2011,130100041,,,,12,10,22
,2011,130100044,,,,3,0,3
HND-010765,2011,130100045,,,,8,12,20
HND-010767,2011,130100048,,,,7,2,9
HND-010775,2011,130100060,,,,8,10,18
,2011,130100079,,,,4,1,5
HND-010794,2011,130100086,,,,22,16,38
HND-010798,2011,130100092,,,,5,3,8
HND-010803,2011,130100102,,,,3,7,10
,2011,130100104,,,,12,10,22
HND-010806,2011,130100106,,,,10,13,23
,2011,130100119,,,,17,9,26
HND-010816,2011,130100201,,,,6,1,7
,2011,130100250,,,,13,12,25
HND-010723,2011,130100001,,,,12,5,17
HND-010724,2011,130100002,,,,25,20,45
HND-010725,2011,130100003,,,,33,37,70
HND-010726,2011,130100004,,,,14,10,24
HND-010729,2011,130100007,,,,9,11,20
,2011,130100008,,,,14,14,28
HND-010732,2011,130100010,,,,15,15,30
HND-010733,2011,130100011,,,,14,15,29
HND-010734,2011,130100012,,,,14,9,23
HND-010736,2011,130100014,,,,11,14,25
HND-010739,2011,130100017,,,,7,8,15
HND-010740,2011,130100018,,,,15,9,24
HND-010742,2011,130100020,,,,7,6,13
HND-010744,2011,130100022,,,,12,5,17
HND-010747,2011,130100025,,,,9,8,17
HND-010750,2011,130100028,,,,4,0,4
HND-010751,2011,130100029,,,,5,9,14
,2011,130100032,,,,9,8,17
,2011,130100035,,,,4,4,8
,2011,130100038,,,,5,1,6
HND-010760,2011,130100039,,,,6,2,8
HND-010763,2011,130100042,,,,76,79,155
HND-010766,2011,130100047,,,,31,31,62
HND-010773,2011,130100056,,,,17,9,26
HND-010774,2011,130100059,,,,5,0,5
HND-010790,2011,130100078,,,,15,15,30
HND-010792,2011,130100080,,,,9,8,17
HND-010793,2011,130100084,,,,3,3,6
HND-010796,2011,130100089,,,,19,6,25
HND-010810,2011,130100113,,,,6,4,10
HND-010826,2011,130100241,,,,2,3,5
HND-010724,2011,130100002,,,,18,18,36
HND-010725,2011,130100003,,,,21,31,52
HND-010726,2011,130100004,,,,12,7,19
HND-010727,2011,130100005,,,,8,13,21
,2011,130100008,,,,9,19,28
HND-010731,2011,130100009,,,,19,12,31
HND-010732,2011,130100010,,,,9,14,23
HND-010734,2011,130100012,,,,14,7,21
HND-010736,2011,130100014,,,,12,12,24
,2011,130100015,,,,16,6,22
HND-010740,2011,130100018,,,,17,7,24
HND-010745,2011,130100023,,,,10,7,17
HND-010747,2011,130100025,,,,8,5,13
HND-010748,2011,130100026,,,,29,16,45
HND-010751,2011,130100029,,,,9,4,13
HND-010755,2011,130100033,,,,8,5,13
,2011,130100035,,,,1,3,4
HND-010758,2011,130100036,,,,13,15,28
HND-010760,2011,130100039,,,,3,8,11
HND-010761,2011,130100040,,,,20,10,30
HND-010762,2011,130100041,,,,8,6,14
,2011,130100044,,,,0,3,3
HND-010766,2011,130100047,,,,16,14,30
HND-010767,2011,130100048,,,,5,4,9
HND-010774,2011,130100059,,,,3,3,6
HND-010775,2011,130100060,,,,8,5,13
HND-010790,2011,130100078,,,,12,14,26
,2011,130100079,,,,1,4,5
HND-010794,2011,130100086,,,,25,16,41
HND-010796,2011,130100089,,,,5,8,13
,2011,130100104,,,,5,7,12
HND-010806,2011,130100106,,,,9,9,18
,2011,130100119,,,,8,10,18
,2011,130100250,,,,10,14,24
HND-010723,2011,130100001,,,,9,5,14
HND-010728,2011,130100006,,,,9,14,23
HND-010729,2011,130100007,,,,15,10,25
HND-010733,2011,130100011,,,,14,11,25
HND-010735,2011,130100013,,,,5,5,10
HND-010738,2011,130100016,,,,5,9,14
HND-010739,2011,130100017,,,,5,6,11
HND-010741,2011,130100019,,,,10,9,19
HND-010742,2011,130100020,,,,5,6,11
HND-010743,2011,130100021,,,,7,5,12
HND-010744,2011,130100022,,,,15,5,20
HND-010746,2011,130100024,,,,7,12,19
HND-010749,2011,130100027,,,,9,5,14
HND-010750,2011,130100028,,,,8,3,11
,2011,130100030,,,,16,10,26
HND-010753,2011,130100031,,,,9,2,11
,2011,130100032,,,,8,6,14
HND-010756,2011,130100034,,,,9,11,20
,2011,130100038,,,,3,1,4
HND-010763,2011,130100042,,,,70,66,136
HND-010765,2011,130100045,,,,5,10,15
HND-010773,2011,130100056,,,,9,7,16
HND-010792,2011,130100080,,,,7,3,10
HND-010793,2011,130100084,,,,5,1,6
HND-010798,2011,130100092,,,,7,0,7
HND-010803,2011,130100102,,,,2,4,6
HND-010810,2011,130100113,,,,5,7,12
HND-010816,2011,130100201,,,,2,4,6
HND-010826,2011,130100241,,,,2,3,5
HND-010723,2011,130100001,,,,4,6,10
HND-010724,2011,130100002,,,,13,10,23
HND-010725,2011,130100003,,,,19,32,51
HND-010726,2011,130100004,,,,14,13,27
HND-010727,2011,130100005,,,,10,11,21
,2011,130100008,,,,15,11,26
HND-010732,2011,130100010,,,,16,13,29
HND-010733,2011,130100011,,,,8,10,18
HND-010734,2011,130100012,,,,16,12,28
HND-010736,2011,130100014,,,,13,13,26
HND-010739,2011,130100017,,,,6,5,11
HND-010740,2011,130100018,,,,9,6,15
HND-010744,2011,130100022,,,,7,8,15
HND-010747,2011,130100025,,,,5,10,15
HND-010750,2011,130100028,,,,6,1,7
HND-010751,2011,130100029,,,,3,4,7
,2011,130100032,,,,2,4,6
,2011,130100035,,,,5,3,8
HND-010760,2011,130100039,,,,3,5,8
HND-010762,2011,130100041,,,,7,7,14
HND-010763,2011,130100042,,,,89,57,146
HND-010766,2011,130100047,,,,2,15,17
HND-010773,2011,130100056,,,,8,10,18
HND-010774,2011,130100059,,,,5,3,8
HND-010790,2011,130100078,,,,3,1,4
HND-010792,2011,130100080,,,,4,5,9
HND-010796,2011,130100089,,,,9,6,15
HND-010803,2011,130100102,,,,4,2,6
,2011,130100104,,,,3,1,4
HND-010806,2011,130100106,,,,10,12,22
,2011,130100119,,,,7,11,18
HND-010826,2011,130100241,,,,5,1,6
HND-010728,2011,130100006,,,,10,9,19
HND-010729,2011,130100007,,,,13,12,25
HND-010731,2011,130100009,,,,16,21,37
HND-010735,2011,130100013,,,,4,5,9
,2011,130100015,,,,10,14,24
HND-010738,2011,130100016,,,,8,7,15
HND-010741,2011,130100019,,,,11,5,16
HND-010742,2011,130100020,,,,9,6,15
HND-010743,2011,130100021,,,,3,6,9
HND-010745,2011,130100023,,,,11,4,15
HND-010746,2011,130100024,,,,10,12,22
HND-010748,2011,130100026,,,,10,18,28
HND-010749,2011,130100027,,,,6,1,7
,2011,130100030,,,,12,10,22
HND-010753,2011,130100031,,,,10,8,18
HND-010755,2011,130100033,,,,5,5,10
HND-010756,2011,130100034,,,,9,6,15
HND-010758,2011,130100036,,,,11,17,28
,2011,130100038,,,,1,1,2
HND-010761,2011,130100040,,,,15,8,23
,2011,130100044,,,,0,1,1
HND-010765,2011,130100045,,,,5,10,15
HND-010767,2011,130100048,,,,6,5,11
HND-010775,2011,130100060,,,,3,7,10
,2011,130100079,,,,1,0,1
HND-010794,2011,130100086,,,,18,17,35
HND-010798,2011,130100092,,,,6,4,10
HND-010810,2011,130100113,,,,1,4,5
HND-010816,2011,130100201,,,,6,3,9
,2011,130100250,,,,12,9,21
HND-010724,2011,130100002,,,,16,17,33
HND-010725,2011,130100003,,,,36,31,67
HND-010727,2011,130100005,,,,14,14,28
HND-010731,2011,130100009,,,,14,12,26
HND-010734,2011,130100012,,,,2,4,6
,2011,130100015,,,,10,9,19
HND-010740,2011,130100018,,,,9,8,17
HND-010741,2011,130100019,,,,2,11,13
HND-010745,2011,130100023,,,,3,4,7
HND-010748,2011,130100026,,,,14,12,26
HND-010749,2011,130100027,,,,1,6,7
HND-010751,2011,130100029,,,,0,9,9
HND-010755,2011,130100033,,,,5,12,17
HND-010758,2011,130100036,,,,14,4,18
HND-010760,2011,130100039,,,,3,5,8
HND-010761,2011,130100040,,,,14,11,25
HND-010762,2011,130100041,,,,6,8,14
,2011,130100044,,,,2,0,2
HND-010766,2011,130100047,,,,9,10,19
HND-010767,2011,130100048,,,,7,0,7
HND-010774,2011,130100059,,,,5,3,8
HND-010775,2011,130100060,,,,0,1,1
,2011,130100079,,,,3,3,6
HND-010794,2011,130100086,,,,17,9,26
HND-010796,2011,130100089,,,,7,3,10
HND-010798,2011,130100092,,,,5,2,7
,2011,130100119,,,,10,11,21
HND-010816,2011,130100201,,,,0,4,4
,2011,130100250,,,,13,3,16
HND-010723,2011,130100001,,,,10,5,15
HND-010726,2011,130100004,,,,12,15,27
HND-010728,2011,130100006,,,,8,12,20
HND-010729,2011,130100007,,,,14,10,24
,2011,130100008,,,,7,11,18
HND-010732,2011,130100010,,,,12,10,22
HND-010733,2011,130100011,,,,9,8,17
HND-010735,2011,130100013,,,,8,5,13
HND-010736,2011,130100014,,,,18,16,34
HND-010738,2011,130100016,,,,5,5,10
HND-010739,2011,130100017,,,,4,8,12
HND-010742,2011,130100020,,,,4,5,9
HND-010743,2011,130100021,,,,5,6,11
HND-010744,2011,130100022,,,,7,9,16
HND-010746,2011,130100024,,,,5,8,13
HND-010747,2011,130100025,,,,6,10,16
HND-010750,2011,130100028,,,,3,4,7
,2011,130100030,,,,15,11,26
HND-010753,2011,130100031,,,,6,9,15
,2011,130100032,,,,5,1,6
HND-010756,2011,130100034,,,,4,11,15
,2011,130100035,,,,5,5,10
,2011,130100038,,,,4,2,6
HND-010763,2011,130100042,,,,59,73,132
HND-010765,2011,130100045,,,,8,10,18
HND-010773,2011,130100056,,,,2,13,15
HND-010790,2011,130100078,,,,3,6,9
HND-010792,2011,130100080,,,,1,2,3
HND-010793,2011,130100084,,,,1,0,1
HND-010803,2011,130100102,,,,5,1,6
,2011,130100104,,,,6,4,10
HND-010806,2011,130100106,,,,6,8,14
HND-010810,2011,130100113,,,,4,3,7
HND-010826,2011,130100241,,,,4,2,6
HND-010727,2011,130100005,,,,14,11,25
HND-010728,2011,130100006,,,,7,13,20
HND-010731,2011,130100009,,,,15,12,27
HND-010734,2011,130100012,,,,9,6,15
,2011,130100015,,,,8,14,22
HND-010738,2011,130100016,,,,5,11,16
HND-010741,2011,130100019,,,,5,6,11
HND-010743,2011,130100021,,,,9,7,16
HND-010745,2011,130100023,,,,7,7,14
HND-010748,2011,130100026,,,,16,19,35
HND-010749,2011,130100027,,,,1,6,7
HND-010751,2011,130100029,,,,1,6,7
HND-010753,2011,130100031,,,,10,8,18
HND-010755,2011,130100033,,,,4,9,13
HND-010758,2011,130100036,,,,12,12,24
HND-010761,2011,130100040,,,,7,8,15
HND-010762,2011,130100041,,,,9,8,17
,2011,130100044,,,,1,1,2
HND-010767,2011,130100048,,,,1,6,7
HND-010775,2011,130100060,,,,2,3,5
,2011,130100079,,,,7,3,10
HND-010794,2011,130100086,,,,15,19,34
HND-010796,2011,130100089,,,,3,4,7
HND-010798,2011,130100092,,,,3,5,8
HND-010810,2011,130100113,,,,3,3,6
,2011,130100119,,,,6,6,12
,2011,130100250,,,,14,14,28
HND-010723,2011,130100001,,,,6,5,11
HND-010724,2011,130100002,,,,15,17,32
HND-010725,2011,130100003,,,,21,29,50
HND-010726,2011,130100004,,,,10,12,22
HND-010729,2011,130100007,,,,4,10,14
,2011,130100008,,,,5,11,16
HND-010732,2011,130100010,,,,8,13,21
HND-010733,2011,130100011,,,,8,10,18
HND-010735,2011,130100013,,,,5,7,12
HND-010736,2011,130100014,,,,15,10,25
HND-010739,2011,130100017,,,,5,5,10
HND-010740,2011,130100018,,,,8,11,19
HND-010742,2011,130100020,,,,5,10,15
HND-010744,2011,130100022,,,,6,5,11
HND-010746,2011,130100024,,,,4,6,10
HND-010747,2011,130100025,,,,4,5,9
HND-010750,2011,130100028,,,,9,7,16
,2011,130100030,,,,13,16,29
,2011,130100032,,,,1,3,4
HND-010756,2011,130100034,,,,11,5,16
,2011,130100035,,,,3,2,5
,2011,130100038,,,,2,0,2
HND-010760,2011,130100039,,,,5,7,12
HND-010763,2011,130100042,,,,88,67,155
HND-010765,2011,130100045,,,,8,2,10
HND-010766,2011,130100047,,,,2,8,10
HND-010773,2011,130100056,,,,4,7,11
HND-010774,2011,130100059,,,,2,3,5
HND-010790,2011,130100078,,,,4,4,8
HND-010792,2011,130100080,,,,0,4,4
HND-010803,2011,130100102,,,,4,2,6
,2011,130100104,,,,2,5,7
HND-010806,2011,130100106,,,,6,2,8
HND-010816,2011,130100201,,,,2,3,5
HND-010826,2011,130100241,,,,3,1,4
HND-010723,2011,130100001,,,,2,6,8
HND-010728,2011,130100006,,,,7,13,20
HND-010729,2011,130100007,,,,8,10,18
HND-010733,2011,130100011,,,,8,4,12
HND-010735,2011,130100013,,,,8,4,12
HND-010738,2011,130100016,,,,5,5,10
HND-010739,2011,130100017,,,,5,5,10
HND-010741,2011,130100019,,,,4,3,7
HND-010742,2011,130100020,,,,8,6,14
HND-010743,2011,130100021,,,,6,2,8
HND-010744,2011,130100022,,,,9,5,14
HND-010746,2011,130100024,,,,5,2,7
HND-010749,2011,130100027,,,,6,4,10
HND-010750,2011,130100028,,,,7,3,10
,2011,130100030,,,,13,6,19
HND-010753,2011,130100031,,,,5,6,11
,2011,130100032,,,,4,5,9
HND-010756,2011,130100034,,,,10,5,15
,2011,130100038,,,,2,1,3
HND-010763,2011,130100042,,,,58,79,137
HND-010765,2011,130100045,,,,4,4,8
HND-010773,2011,130100056,,,,5,7,12
HND-010792,2011,130100080,,,,1,2,3
HND-010793,2011,130100084,,,,0,1,1
HND-010798,2011,130100092,,,,1,2,3
HND-010803,2011,130100102,,,,4,2,6
HND-010810,2011,130100113,,,,2,0,2
HND-010826,2011,130100241,,,,2,2,4
HND-010724,2011,130100002,,,,18,19,37
HND-010725,2011,130100003,,,,37,35,72
HND-010726,2011,130100004,,,,9,16,25
HND-010727,2011,130100005,,,,10,13,23
,2011,130100008,,,,9,3,12
HND-010731,2011,130100009,,,,10,6,16
HND-010732,2011,130100010,,,,9,14,23
HND-010734,2011,130100012,,,,2,5,7
HND-010736,2011,130100014,,,,17,12,29
,2011,130100015,,,,10,6,16
HND-010740,2011,130100018,,,,7,10,17
HND-010745,2011,130100023,,,,2,3,5
HND-010747,2011,130100025,,,,4,8,12
HND-010748,2011,130100026,,,,17,12,29
HND-010751,2011,130100029,,,,6,5,11
HND-010755,2011,130100033,,,,4,6,10
,2011,130100035,,,,3,5,8
HND-010758,2011,130100036,,,,8,8,16
HND-010760,2011,130100039,,,,5,4,9
HND-010761,2011,130100040,,,,9,4,13
HND-010762,2011,130100041,,,,5,5,10
HND-010766,2011,130100047,,,,6,11,17
HND-010767,2011,130100048,,,,1,4,5
HND-010774,2011,130100059,,,,3,3,6
HND-010775,2011,130100060,,,,4,3,7
HND-010790,2011,130100078,,,,4,2,6
,2011,130100079,,,,3,1,4
HND-010794,2011,130100086,,,,7,9,16
HND-010796,2011,130100089,,,,7,6,13
,2011,130100104,,,,1,1,2
HND-010806,2011,130100106,,,,2,5,7
,2011,130100119,,,,4,11,15
HND-010816,2011,130100201,,,,1,2,3
,2011,130100250,,,,13,11,24
HND-010731,2011,130100009,,,,6,11,17
,2011,130100015,,,,9,9,18
HND-010748,2011,130100026,,,,14,14,28
HND-010755,2011,130100033,,,,5,0,5
HND-010767,2011,130100048,,,,8,9,17
,2011,130100085,,,,6,10,16
,2011,130100119,,,,6,10,16
HND-010825,2011,130100221,,,,9,22,31
,2011,130100250,,,,13,16,29
HND-010724,2011,130100002,,,,8,12,20
HND-010725,2011,130100003,,,,29,57,86
HND-010726,2011,130100004,,,,7,3,10
HND-010732,2011,130100010,,,,5,12,17
HND-010784,2011,130100072,,,,277,287,564
,2011,130100119,,,,6,10,16
HND-010724,2011,130100002,,,,8,16,24
HND-010725,2011,130100003,,,,24,45,69
HND-010726,2011,130100004,,,,2,8,10
HND-010731,2011,130100009,,,,6,6,12
HND-010732,2011,130100010,,,,4,2,6
,2011,130100015,,,,7,4,11
HND-010748,2011,130100026,,,,7,9,16
HND-010755,2011,130100033,,,,1,5,6
HND-010784,2011,130100072,,,,252,208,460
,2011,130100085,,,,5,12,17
,2011,130100119,,,,4,4,8
,2011,130100119,,,,4,4,8
HND-010825,2011,130100221,,,,7,14,21
,2011,130100250,,,,14,19,33
HND-010726,2011,130100004,,,,7,10,17
HND-010784,2011,130100072,,,,211,222,433
HND-010825,2011,130100221,,,,6,17,23
HND-010724,2011,130100002,,,,6,10,16
HND-010725,2011,130100003,,,,28,38,66
HND-010731,2011,130100009,,,,2,3,5
HND-010732,2011,130100010,,,,2,9,11
,2011,130100015,,,,3,4,7
HND-010748,2011,130100026,,,,1,8,9
HND-010755,2011,130100033,,,,1,3,4
,2011,130100085,,,,4,6,10
,2011,130100119,,,,2,6,8
,2011,130100119,,,,2,6,8
,2011,130100250,,,,9,10,19
HND-010784,2011,130100072,,,,403,406,809
,2011,130100085,,,,13,10,23
,2011,130100119,,,,3,6,9
,2011,130100250,,,,4,6,10
HND-010795,2011,130100087,,,,262,380,642
HND-010825,2011,130100221,,,,16,20,36
HND-010795,2011,130100087,,,,345,494,839
HND-010784,2011,130100072,,,,214,293,507
,2011,130100085,,,,21,34,55
HND-010795,2011,130100087,,,,213,390,603
HND-010825,2011,130100221,,,,10,15,25
HND-010784,2011,130100072,,,,166,224,390
,2011,130100085,,,,6,18,24
,2011,130200067,,,,3,3,6
,2011,130200016,,,,2,5,7
,2011,130200027,,,,3,3,6
,2011,130200039,,,,2,3,5
,2011,130200043,,,,2,6,8
,2011,130200057,,,,8,6,14
HND-010856,2011,130200065,,,,2,4,6
,2011,130200068,,,,7,0,7
,2011,130200034,,,,1,0,1
HND-010857,2011,130200066,,,,0,2,2
,2011,130200013,,,,4,1,5
HND-010845,2011,130200026,,,,1,1,2
HND-010844,2011,130200014,,,,4,4,8
,2011,130200015,,,,0,3,3
HND-010845,2011,130200026,,,,5,0,5
,2011,130200034,,,,7,2,9
HND-010850,2011,130200037,,,,1,3,4
HND-010857,2011,130200066,,,,4,1,5
,2011,130200013,,,,3,1,4
,2011,130200033,,,,3,4,7
,2011,130200013,,,,6,8,14
HND-010844,2011,130200014,,,,4,2,6
,2011,130200034,,,,5,5,10
,2011,130200015,,,,7,5,12
HND-010845,2011,130200026,,,,8,6,14
,2011,130200033,,,,6,4,10
HND-010850,2011,130200037,,,,6,2,8
HND-010857,2011,130200066,,,,1,5,6
HND-010835,2011,130200004,,,,11,3,14
HND-010836,2011,130200005,,,,14,9,23
HND-010839,2011,130200008,,,,0,1,1
HND-010841,2011,130200010,,,,13,13,26
HND-010842,2011,130200011,,,,7,7,14
HND-010843,2011,130200012,,,,6,6,12
HND-010847,2011,130200030,,,,5,5,10
HND-010848,2011,130200031,,,,7,6,13
HND-010851,2011,130200038,,,,4,4,8
HND-010853,2011,130200059,,,,2,4,6
HND-010833,2011,130200002,,,,10,11,21
HND-010834,2011,130200003,,,,10,8,18
HND-010837,2011,130200006,,,,13,8,21
HND-010838,2011,130200007,,,,13,13,26
HND-010840,2011,130200009,,,,2,2,4
HND-010846,2011,130200029,,,,5,4,9
HND-010849,2011,130200035,,,,4,4,8
HND-010852,2011,130200058,,,,5,3,8
HND-010854,2011,130200060,,,,1,2,3
HND-010855,2011,130200061,,,,1,2,3
HND-010834,2011,130200003,,,,8,7,15
HND-010835,2011,130200004,,,,8,6,14
HND-010837,2011,130200006,,,,10,8,18
HND-010838,2011,130200007,,,,10,5,15
HND-010842,2011,130200011,,,,4,6,10
HND-010847,2011,130200030,,,,3,8,11
HND-010848,2011,130200031,,,,4,7,11
HND-010849,2011,130200035,,,,6,1,7
HND-010851,2011,130200038,,,,4,5,9
HND-010853,2011,130200059,,,,6,4,10
HND-010854,2011,130200060,,,,3,1,4
HND-010833,2011,130200002,,,,14,9,23
HND-010836,2011,130200005,,,,5,12,17
HND-010839,2011,130200008,,,,1,2,3
HND-010840,2011,130200009,,,,3,5,8
HND-010841,2011,130200010,,,,9,11,20
HND-010843,2011,130200012,,,,5,5,10
HND-010846,2011,130200029,,,,2,1,3
HND-010852,2011,130200058,,,,8,4,12
HND-010855,2011,130200061,,,,1,1,2
HND-010833,2011,130200002,,,,5,12,17
HND-010834,2011,130200003,,,,6,12,18
HND-010837,2011,130200006,,,,4,5,9
HND-010838,2011,130200007,,,,8,7,15
HND-010840,2011,130200009,,,,1,1,2
HND-010846,2011,130200029,,,,0,2,2
HND-010847,2011,130200030,,,,4,3,7
HND-010848,2011,130200031,,,,1,4,5
HND-010851,2011,130200038,,,,5,7,12
HND-010853,2011,130200059,,,,3,2,5
HND-010854,2011,130200060,,,,2,3,5
HND-010855,2011,130200061,,,,2,0,2
HND-010835,2011,130200004,,,,5,3,8
HND-010836,2011,130200005,,,,7,3,10
HND-010839,2011,130200008,,,,0,2,2
HND-010841,2011,130200010,,,,2,6,8
HND-010842,2011,130200011,,,,7,5,12
HND-010843,2011,130200012,,,,4,6,10
HND-010849,2011,130200035,,,,3,5,8
HND-010852,2011,130200058,,,,5,7,12
HND-010834,2011,130200003,,,,6,9,15
HND-010835,2011,130200004,,,,4,9,13
HND-010838,2011,130200007,,,,5,8,13
HND-010839,2011,130200008,,,,1,0,1
HND-010841,2011,130200010,,,,5,5,10
HND-010842,2011,130200011,,,,8,4,12
HND-010847,2011,130200030,,,,2,2,4
HND-010849,2011,130200035,,,,3,3,6
HND-010851,2011,130200038,,,,3,0,3
HND-010853,2011,130200059,,,,1,3,4
HND-010854,2011,130200060,,,,2,1,3
HND-010833,2011,130200002,,,,9,11,20
HND-010836,2011,130200005,,,,9,13,22
HND-010837,2011,130200006,,,,9,9,18
HND-010840,2011,130200009,,,,3,5,8
HND-010843,2011,130200012,,,,5,6,11
HND-010846,2011,130200029,,,,1,5,6
HND-010848,2011,130200031,,,,1,3,4
HND-010852,2011,130200058,,,,3,4,7
HND-010855,2011,130200061,,,,2,3,5
HND-010835,2011,130200004,,,,9,10,19
HND-010838,2011,130200007,,,,7,6,13
HND-010839,2011,130200008,,,,3,2,5
HND-010841,2011,130200010,,,,1,7,8
HND-010842,2011,130200011,,,,3,3,6
HND-010843,2011,130200012,,,,6,2,8
HND-010847,2011,130200030,,,,3,5,8
HND-010849,2011,130200035,,,,3,2,5
HND-010851,2011,130200038,,,,1,3,4
HND-010833,2011,130200002,,,,17,8,25
HND-010834,2011,130200003,,,,3,8,11
HND-010836,2011,130200005,,,,3,9,12
HND-010837,2011,130200006,,,,4,1,5
HND-010840,2011,130200009,,,,3,1,4
HND-010846,2011,130200029,,,,3,6,9
HND-010848,2011,130200031,,,,2,2,4
HND-010852,2011,130200058,,,,2,3,5
HND-010853,2011,130200059,,,,1,3,4
HND-010855,2011,130200061,,,,2,2,4
HND-010833,2011,130200002,,,,16,7,23
HND-010836,2011,130200005,,,,2,4,6
HND-010839,2011,130200008,,,,0,4,4
HND-010840,2011,130200009,,,,5,3,8
HND-010841,2011,130200010,,,,3,2,5
HND-010843,2011,130200012,,,,8,5,13
HND-010846,2011,130200029,,,,2,3,5
HND-010852,2011,130200058,,,,0,2,2
HND-010855,2011,130200061,,,,4,3,7
HND-010834,2011,130200003,,,,7,3,10
HND-010835,2011,130200004,,,,7,6,13
HND-010837,2011,130200006,,,,4,7,11
HND-010838,2011,130200007,,,,6,3,9
HND-010842,2011,130200011,,,,4,5,9
HND-010847,2011,130200030,,,,3,3,6
HND-010848,2011,130200031,,,,1,1,2
HND-010849,2011,130200035,,,,2,5,7
HND-010851,2011,130200038,,,,1,3,4
HND-010853,2011,130200059,,,,2,3,5
HND-010835,2011,130200004,,,,8,9,17
HND-010833,2011,130200002,,,,15,12,27
HND-010834,2011,130200003,,,,5,3,8
HND-010834,2011,130200003,,,,9,8,17
HND-010835,2011,130200004,,,,6,12,18
HND-010833,2011,130200002,,,,11,12,23
HND-010834,2011,130200003,,,,5,1,6
HND-010835,2011,130200004,,,,6,9,15
HND-010833,2011,130200002,,,,12,10,22
HND-010882,2011,130300029,,,,4,3,7
,2011,130300053,,,,2,4,6
,2011,130300065,,,,8,2,10
,2011,130300066,,,,4,1,5
,2011,130300069,,,,6,5,11
HND-010889,2011,130300051,,,,3,3,6
HND-010890,2011,130300068,,,,6,1,7
,2011,130300070,,,,3,3,6
HND-010895,2011,130300088,,,,3,3,6
HND-010873,2011,130300017,,,,2,4,6
HND-010876,2011,130300021,,,,2,2,4
HND-010878,2011,130300023,,,,3,2,5
HND-010881,2011,130300027,,,,4,4,8
HND-010893,2011,130300086,,,,5,3,8
HND-010894,2011,130300087,,,,2,6,8
HND-010875,2011,130300020,,,,1,1,2
HND-010877,2011,130300022,,,,1,3,4
HND-010880,2011,130300025,,,,4,4,8
HND-010883,2011,130300030,,,,1,3,4
HND-010884,2011,130300031,,,,4,3,7
,2011,130300046,,,,3,4,7
HND-010896,2011,130300089,,,,5,1,6
HND-010880,2011,130300025,,,,4,2,6
HND-010883,2011,130300030,,,,2,5,7
HND-010888,2011,130300038,,,,6,2,8
HND-010893,2011,130300086,,,,2,1,3
HND-010894,2011,130300087,,,,0,1,1
HND-010896,2011,130300089,,,,4,2,6
HND-010873,2011,130300017,,,,12,11,23
,2011,130300019,,,,4,9,13
HND-010875,2011,130300020,,,,4,0,4
HND-010876,2011,130300021,,,,4,3,7
HND-010877,2011,130300022,,,,6,5,11
HND-010878,2011,130300023,,,,2,1,3
HND-010879,2011,130300024,,,,4,4,8
HND-010881,2011,130300027,,,,0,1,1
HND-010884,2011,130300031,,,,4,2,6
,2011,130300046,,,,2,3,5
,2011,130300019,,,,5,7,12
HND-010875,2011,130300020,,,,9,9,18
HND-010876,2011,130300021,,,,3,5,8
HND-010877,2011,130300022,,,,3,5,8
HND-010879,2011,130300024,,,,9,7,16
HND-010881,2011,130300027,,,,2,3,5
HND-010883,2011,130300030,,,,5,6,11
HND-010884,2011,130300031,,,,5,1,6
HND-010888,2011,130300038,,,,7,8,15
,2011,130300046,,,,7,3,10
HND-010873,2011,130300017,,,,18,9,27
HND-010878,2011,130300023,,,,5,2,7
HND-010880,2011,130300025,,,,6,2,8
HND-010893,2011,130300086,,,,4,0,4
HND-010894,2011,130300087,,,,4,5,9
HND-010896,2011,130300089,,,,2,2,4
HND-010858,2011,130300001,,,,8,6,14
HND-010860,2011,130300003,,,,11,10,21
HND-010863,2011,130300006,,,,6,6,12
HND-010864,2011,130300007,,,,7,6,13
,2011,130300008,,,,12,13,25
HND-010867,2011,130300011,,,,10,4,14
HND-010869,2011,130300013,,,,6,9,15
HND-010872,2011,130300016,,,,11,4,15
HND-010885,2011,130300032,,,,5,3,8
HND-010891,2011,130300084,,,,8,6,14
HND-010859,2011,130300002,,,,12,13,25
HND-010861,2011,130300004,,,,17,16,33
HND-010862,2011,130300005,,,,6,2,8
HND-010865,2011,130300009,,,,12,6,18
HND-010866,2011,130300010,,,,5,4,9
HND-010868,2011,130300012,,,,1,3,4
HND-010870,2011,130300014,,,,1,2,3
HND-010871,2011,130300015,,,,2,7,9
HND-010886,2011,130300033,,,,4,1,5
HND-010887,2011,130300036,,,,2,5,7
HND-010892,2011,130300085,,,,1,2,3
HND-010860,2011,130300003,,,,5,11,16
HND-010861,2011,130300004,,,,20,21,41
HND-010862,2011,130300005,,,,3,3,6
HND-010863,2011,130300006,,,,4,5,9
HND-010864,2011,130300007,,,,4,4,8
HND-010865,2011,130300009,,,,11,9,20
HND-010871,2011,130300015,,,,1,2,3
HND-010872,2011,130300016,,,,4,5,9
HND-010886,2011,130300033,,,,3,4,7
HND-010887,2011,130300036,,,,4,2,6
HND-010891,2011,130300084,,,,4,2,6
HND-010858,2011,130300001,,,,8,8,16
HND-010859,2011,130300002,,,,6,7,13
,2011,130300008,,,,15,12,27
HND-010867,2011,130300011,,,,3,2,5
HND-010868,2011,130300012,,,,5,0,5
HND-010869,2011,130300013,,,,4,7,11
HND-010870,2011,130300014,,,,6,5,11
HND-010885,2011,130300032,,,,2,4,6
HND-010892,2011,130300085,,,,4,5,9
HND-010859,2011,130300002,,,,5,9,14
HND-010861,2011,130300004,,,,15,18,33
HND-010862,2011,130300005,,,,2,3,5
HND-010866,2011,130300010,,,,2,5,7
HND-010868,2011,130300012,,,,2,2,4
HND-010870,2011,130300014,,,,3,5,8
HND-010871,2011,130300015,,,,6,4,10
HND-010886,2011,130300033,,,,3,2,5
HND-010887,2011,130300036,,,,4,4,8
HND-010891,2011,130300084,,,,4,2,6
HND-010892,2011,130300085,,,,6,3,9
HND-010858,2011,130300001,,,,8,9,17
HND-010860,2011,130300003,,,,14,12,26
HND-010863,2011,130300006,,,,5,5,10
HND-010864,2011,130300007,,,,3,7,10
,2011,130300008,,,,15,14,29
HND-010867,2011,130300011,,,,1,4,5
HND-010869,2011,130300013,,,,2,6,8
HND-010872,2011,130300016,,,,5,3,8
HND-010885,2011,130300032,,,,1,1,2
HND-010858,2011,130300001,,,,7,5,12
HND-010860,2011,130300003,,,,10,3,13
HND-010863,2011,130300006,,,,4,5,9
HND-010864,2011,130300007,,,,3,4,7
HND-010865,2011,130300009,,,,7,5,12
HND-010869,2011,130300013,,,,5,6,11
HND-010871,2011,130300015,,,,4,2,6
HND-010872,2011,130300016,,,,3,3,6
HND-010885,2011,130300032,,,,0,2,2
HND-010886,2011,130300033,,,,3,5,8
HND-010891,2011,130300084,,,,0,4,4
HND-010859,2011,130300002,,,,5,15,20
HND-010861,2011,130300004,,,,35,36,71
HND-010862,2011,130300005,,,,2,6,8
,2011,130300008,,,,9,10,19
HND-010866,2011,130300010,,,,2,4,6
HND-010868,2011,130300012,,,,0,5,5
HND-010870,2011,130300014,,,,3,5,8
HND-010887,2011,130300036,,,,7,6,13
HND-010892,2011,130300085,,,,2,3,5
HND-010858,2011,130300001,,,,8,7,15
HND-010860,2011,130300003,,,,3,16,19
HND-010863,2011,130300006,,,,3,8,11
HND-010864,2011,130300007,,,,2,5,7
HND-010869,2011,130300013,,,,4,9,13
HND-010872,2011,130300016,,,,1,4,5
HND-010886,2011,130300033,,,,1,5,6
HND-010887,2011,130300036,,,,1,4,5
HND-010892,2011,130300085,,,,5,5,10
HND-010859,2011,130300002,,,,4,5,9
HND-010861,2011,130300004,,,,18,23,41
HND-010862,2011,130300005,,,,4,1,5
,2011,130300008,,,,9,8,17
HND-010865,2011,130300009,,,,5,5,10
HND-010866,2011,130300010,,,,4,4,8
HND-010868,2011,130300012,,,,1,5,6
HND-010870,2011,130300014,,,,2,4,6
HND-010891,2011,130300084,,,,1,1,2
HND-010858,2011,130300001,,,,13,6,19
HND-010859,2011,130300002,,,,6,4,10
,2011,130300008,,,,11,8,19
HND-010869,2011,130300013,,,,5,6,11
HND-010870,2011,130300014,,,,5,6,11
HND-010886,2011,130300033,,,,0,3,3
HND-010887,2011,130300036,,,,1,5,6
HND-010891,2011,130300084,,,,1,0,1
HND-010860,2011,130300003,,,,16,4,20
HND-010861,2011,130300004,,,,28,24,52
HND-010862,2011,130300005,,,,2,7,9
HND-010863,2011,130300006,,,,8,3,11
HND-010864,2011,130300007,,,,6,1,7
HND-010872,2011,130300016,,,,4,1,5
HND-010892,2011,130300085,,,,2,2,4
HND-010858,2011,130300001,,,,17,21,38
HND-010874,2011,130300018,,,,42,66,108
,2011,130300008,,,,11,14,25
HND-010874,2011,130300018,,,,35,64,99
HND-010858,2011,130300001,,,,14,11,25
,2011,130300008,,,,8,10,18
HND-010858,2011,130300001,,,,8,7,15
,2011,130300008,,,,4,9,13
HND-010874,2011,130300018,,,,42,43,85
HND-010874,2011,130300018,,,,20,25,45
HND-010874,2011,130300018,,,,7,15,22
HND-010874,2011,130300018,,,,12,10,22
,2011,130400031,,,,9,4,13
,2011,130400032,,,,3,4,7
HND-010909,2011,130400013,,,,2,6,8
,2011,130400033,,,,8,7,15
HND-010908,2011,130400011,,,,7,7,14
HND-010908,2011,130400011,,,,11,3,14
HND-010910,2011,130400016,,,,6,9,15
HND-010914,2011,130400022,,,,6,4,10
HND-010908,2011,130400011,,,,12,20,32
HND-010910,2011,130400016,,,,12,7,19
HND-010914,2011,130400022,,,,13,4,17
HND-010898,2011,130400001,,,,12,18,30
HND-010899,2011,130400002,,,,6,7,13
HND-010901,2011,130400004,,,,0,2,2
HND-010902,2011,130400005,,,,9,16,25
HND-010905,2011,130400008,,,,4,1,5
HND-010907,2011,130400010,,,,8,3,11
HND-010911,2011,130400018,,,,8,4,12
HND-010912,2011,130400019,,,,3,4,7
HND-010913,2011,130400021,,,,2,0,2
HND-010916,2011,130400024,,,,0,1,1
HND-010920,2011,130400028,,,,3,1,4
HND-010924,2011,130400049,,,,1,2,3
HND-010900,2011,130400003,,,,2,3,5
HND-010903,2011,130400006,,,,4,8,12
HND-010904,2011,130400007,,,,3,6,9
HND-010906,2011,130400009,,,,4,4,8
HND-010917,2011,130400025,,,,3,1,4
HND-010918,2011,130400026,,,,2,1,3
HND-010921,2011,130400029,,,,4,3,7
HND-010923,2011,130400048,,,,6,4,10
HND-010925,2011,130400050,,,,1,2,3
HND-010900,2011,130400003,,,,4,4,8
HND-010901,2011,130400004,,,,1,0,1
HND-010903,2011,130400006,,,,7,7,14
HND-010904,2011,130400007,,,,7,13,20
HND-010911,2011,130400018,,,,2,0,2
HND-010913,2011,130400021,,,,2,1,3
HND-010915,2011,130400023,,,,1,1,2
HND-010918,2011,130400026,,,,1,0,1
HND-010921,2011,130400029,,,,2,5,7
HND-010923,2011,130400048,,,,1,3,4
HND-010925,2011,130400050,,,,2,1,3
HND-010898,2011,130400001,,,,23,15,38
HND-010899,2011,130400002,,,,5,9,14
HND-010902,2011,130400005,,,,12,11,23
HND-010905,2011,130400008,,,,3,5,8
HND-010906,2011,130400009,,,,2,0,2
HND-010912,2011,130400019,,,,3,3,6
HND-010916,2011,130400024,,,,0,3,3
HND-010917,2011,130400025,,,,1,2,3
HND-010920,2011,130400028,,,,1,0,1
HND-010924,2011,130400049,,,,3,1,4
HND-010900,2011,130400003,,,,7,4,11
HND-010903,2011,130400006,,,,7,5,12
HND-010904,2011,130400007,,,,8,6,14
HND-010906,2011,130400009,,,,2,3,5
HND-010915,2011,130400023,,,,3,2,5
HND-010917,2011,130400025,,,,1,1,2
HND-010918,2011,130400026,,,,1,3,4
HND-010921,2011,130400029,,,,1,4,5
HND-010925,2011,130400050,,,,2,0,2
HND-010898,2011,130400001,,,,24,15,39
HND-010899,2011,130400002,,,,7,6,13
HND-010901,2011,130400004,,,,2,2,4
HND-010902,2011,130400005,,,,10,9,19
HND-010911,2011,130400018,,,,3,6,9
HND-010912,2011,130400019,,,,2,5,7
HND-010913,2011,130400021,,,,3,2,5
HND-010916,2011,130400024,,,,0,3,3
HND-010920,2011,130400028,,,,0,2,2
HND-010923,2011,130400048,,,,3,3,6
HND-010924,2011,130400049,,,,3,0,3
HND-010900,2011,130400003,,,,4,8,12
HND-010901,2011,130400004,,,,1,1,2
HND-010904,2011,130400007,,,,6,10,16
HND-010905,2011,130400008,,,,4,11,15
HND-010907,2011,130400010,,,,4,3,7
HND-010911,2011,130400018,,,,2,6,8
HND-010913,2011,130400021,,,,4,0,4
HND-010915,2011,130400023,,,,0,2,2
HND-010916,2011,130400024,,,,5,3,8
HND-010918,2011,130400026,,,,0,2,2
HND-010923,2011,130400048,,,,5,4,9
HND-010925,2011,130400050,,,,3,6,9
HND-010898,2011,130400001,,,,16,13,29
HND-010899,2011,130400002,,,,9,7,16
HND-010902,2011,130400005,,,,13,14,27
HND-010903,2011,130400006,,,,3,11,14
HND-010906,2011,130400009,,,,3,5,8
HND-010912,2011,130400019,,,,3,7,10
HND-010917,2011,130400025,,,,2,4,6
HND-010920,2011,130400028,,,,2,2,4
HND-010921,2011,130400029,,,,3,1,4
HND-010924,2011,130400049,,,,1,4,5
HND-010899,2011,130400002,,,,8,8,16
HND-010901,2011,130400004,,,,2,3,5
HND-010904,2011,130400007,,,,10,4,14
HND-010907,2011,130400010,,,,3,4,7
HND-010911,2011,130400018,,,,2,4,6
HND-010913,2011,130400021,,,,2,3,5
HND-010915,2011,130400023,,,,2,1,3
HND-010916,2011,130400024,,,,2,1,3
HND-010920,2011,130400028,,,,1,6,7
HND-010923,2011,130400048,,,,0,5,5
HND-010925,2011,130400050,,,,0,1,1
HND-010898,2011,130400001,,,,16,20,36
HND-010900,2011,130400003,,,,5,6,11
HND-010902,2011,130400005,,,,10,10,20
HND-010903,2011,130400006,,,,4,6,10
HND-010906,2011,130400009,,,,3,5,8
HND-010912,2011,130400019,,,,2,0,2
HND-010917,2011,130400025,,,,1,1,2
HND-010918,2011,130400026,,,,1,2,3
HND-010921,2011,130400029,,,,2,3,5
HND-010924,2011,130400049,,,,0,2,2
HND-010898,2011,130400001,,,,16,20,36
HND-010899,2011,130400002,,,,3,9,12
HND-010902,2011,130400005,,,,13,16,29
HND-010905,2011,130400008,,,,3,7,10
HND-010906,2011,130400009,,,,6,6,12
HND-010912,2011,130400019,,,,1,4,5
HND-010916,2011,130400024,,,,2,2,4
HND-010917,2011,130400025,,,,3,3,6
HND-010920,2011,130400028,,,,1,0,1
HND-010900,2011,130400003,,,,2,0,2
HND-010901,2011,130400004,,,,1,3,4
HND-010903,2011,130400006,,,,1,5,6
HND-010904,2011,130400007,,,,7,9,16
HND-010911,2011,130400018,,,,1,0,1
HND-010913,2011,130400021,,,,1,1,2
HND-010918,2011,130400026,,,,1,1,2
HND-010921,2011,130400029,,,,2,1,3
HND-010923,2011,130400048,,,,2,4,6
HND-010898,2011,130400001,,,,14,28,42
HND-010898,2011,130400001,,,,15,23,38
HND-010898,2011,130400001,,,,13,20,33
HND-010944,2011,130500019,,,,5,5,10
,2011,130500072,,,,6,5,11
,2011,130500149,,,,4,9,13
HND-010984,2011,130500174,,,,8,6,14
,2011,130500060,,,,5,5,10
,2011,130500068,,,,7,4,11
,2011,130500071,,,,5,4,9
,2011,130500144,,,,2,10,12
,2011,130500146,,,,6,4,10
,2011,130500147,,,,6,4,10
,2011,130500148,,,,5,5,10
,2011,130500171,,,,8,5,13
HND-010944,2011,130500019,,,,5,6,11
HND-010949,2011,130500024,,,,3,5,8
,2011,130500027,,,,9,8,17
,2011,130500031,,,,2,2,4
,2011,130500051,,,,0,3,3
HND-010972,2011,130500055,,,,2,6,8
HND-010974,2011,130500064,,,,3,3,6
HND-010977,2011,130500140,,,,4,5,9
,2011,130500143,,,,2,1,3
,2011,130500150,,,,2,2,4
HND-010980,2011,130500167,,,,1,1,2
,2011,130500168,,,,1,2,3
HND-010948,2011,130500023,,,,2,1,3
HND-010967,2011,130500048,,,,3,2,5
,2011,130500052,,,,1,0,1
HND-010970,2011,130500053,,,,4,2,6
,2011,130500057,,,,2,4,6
,2011,130500062,,,,3,1,4
,2011,130500065,,,,2,2,4
,2011,130500141,,,,1,2,3
HND-010978,2011,130500142,,,,8,8,16
HND-010982,2011,130500170,,,,7,5,12
HND-010944,2011,130500019,,,,4,14,18
HND-010945,2011,130500020,,,,4,3,7
HND-010949,2011,130500024,,,,3,7,10
,2011,130500027,,,,6,8,14
,2011,130500028,,,,4,0,4
HND-010953,2011,130500030,,,,2,3,5
,2011,130500031,,,,3,3,6
,2011,130500032,,,,2,2,4
HND-010958,2011,130500038,,,,3,5,8
,2011,130500052,,,,1,0,1
HND-010972,2011,130500055,,,,4,1,5
HND-010977,2011,130500140,,,,8,6,14
HND-010978,2011,130500142,,,,8,10,18
,2011,130500143,,,,3,4,7
,2011,130500150,,,,5,0,5
,2011,130500166,,,,6,3,9
HND-010948,2011,130500023,,,,4,2,6
,2011,130500025,,,,1,3,4
HND-010950,2011,130500026,,,,0,3,3
HND-010967,2011,130500048,,,,3,5,8
,2011,130500051,,,,0,4,4
HND-010970,2011,130500053,,,,1,4,5
,2011,130500057,,,,1,3,4
,2011,130500062,,,,4,1,5
HND-010974,2011,130500064,,,,5,3,8
,2011,130500065,,,,4,7,11
,2011,130500141,,,,9,12,21
HND-010980,2011,130500167,,,,1,3,4
,2011,130500168,,,,4,4,8
HND-010982,2011,130500170,,,,4,4,8
HND-010948,2011,130500023,,,,5,8,13
HND-010950,2011,130500026,,,,5,9,14
HND-010967,2011,130500048,,,,0,2,2
,2011,130500051,,,,2,7,9
HND-010970,2011,130500053,,,,3,2,5
,2011,130500057,,,,1,1,2
,2011,130500062,,,,7,3,10
,2011,130500065,,,,4,1,5
HND-010977,2011,130500140,,,,3,3,6
,2011,130500143,,,,4,5,9
,2011,130500150,,,,5,2,7
HND-010980,2011,130500167,,,,4,3,7
HND-010944,2011,130500019,,,,12,15,27
HND-010945,2011,130500020,,,,6,2,8
HND-010949,2011,130500024,,,,8,4,12
,2011,130500025,,,,7,7,14
,2011,130500027,,,,18,10,28
,2011,130500028,,,,10,8,18
HND-010953,2011,130500030,,,,5,8,13
,2011,130500031,,,,5,4,9
,2011,130500032,,,,6,2,8
HND-010958,2011,130500038,,,,4,4,8
,2011,130500052,,,,5,2,7
HND-010972,2011,130500055,,,,1,2,3
HND-010974,2011,130500064,,,,3,4,7
,2011,130500141,,,,5,7,12
HND-010978,2011,130500142,,,,5,8,13
,2011,130500166,,,,5,7,12
,2011,130500168,,,,2,5,7
HND-010982,2011,130500170,,,,5,5,10
HND-010926,2011,130500001,,,,19,16,35
,2011,130500002,,,,23,15,38
,2011,130500003,,,,13,10,23
HND-010931,2011,130500006,,,,7,9,16
HND-010932,2011,130500007,,,,7,7,14
HND-010938,2011,130500013,,,,13,7,20
HND-010941,2011,130500016,,,,7,8,15
HND-010954,2011,130500034,,,,2,11,13
HND-010956,2011,130500036,,,,3,4,7
HND-010957,2011,130500037,,,,0,6,6
HND-010962,2011,130500042,,,,14,11,25
HND-010965,2011,130500045,,,,7,6,13
HND-010968,2011,130500049,,,,7,10,17
HND-010969,2011,130500050,,,,4,3,7
HND-010971,2011,130500054,,,,9,6,15
,2011,130500057,,,,1,4,5
HND-010973,2011,130500063,,,,3,5,8
HND-010975,2011,130500138,,,,4,2,6
HND-010981,2011,130500169,,,,2,3,5
,2011,130500173,,,,2,2,4
HND-010929,2011,130500004,,,,8,5,13
HND-010930,2011,130500005,,,,11,9,20
HND-010933,2011,130500008,,,,11,8,19
HND-010934,2011,130500009,,,,25,21,46
HND-010935,2011,130500010,,,,14,4,18
HND-010936,2011,130500011,,,,7,4,11
HND-010937,2011,130500012,,,,3,4,7
,2011,130500014,,,,5,6,11
HND-010940,2011,130500015,,,,5,10,15
HND-010942,2011,130500017,,,,8,9,17
HND-010943,2011,130500018,,,,8,7,15
HND-010947,2011,130500022,,,,6,3,9
HND-010952,2011,130500029,,,,11,13,24
HND-010955,2011,130500035,,,,5,4,9
HND-010959,2011,130500039,,,,1,1,2
HND-010960,2011,130500040,,,,2,2,4
HND-010961,2011,130500041,,,,0,1,1
HND-010963,2011,130500043,,,,1,2,3
HND-010964,2011,130500044,,,,2,4,6
HND-010966,2011,130500047,,,,1,4,5
HND-010967,2011,130500048,,,,15,10,25
HND-010976,2011,130500139,,,,3,6,9
HND-010979,2011,130500165,,,,4,4,8
HND-010983,2011,130500172,,,,13,9,22
,2011,130500002,,,,21,18,39
HND-010930,2011,130500005,,,,10,7,17
HND-010931,2011,130500006,,,,8,9,17
HND-010934,2011,130500009,,,,16,11,27
HND-010937,2011,130500012,,,,3,4,7
HND-010940,2011,130500015,,,,8,4,12
HND-010942,2011,130500017,,,,9,10,19
HND-010943,2011,130500018,,,,1,4,5
HND-010952,2011,130500029,,,,12,10,22
HND-010955,2011,130500035,,,,10,2,12
HND-010956,2011,130500036,,,,1,0,1
HND-010959,2011,130500039,,,,2,2,4
HND-010960,2011,130500040,,,,2,3,5
HND-010961,2011,130500041,,,,1,1,2
HND-010962,2011,130500042,,,,11,11,22
HND-010964,2011,130500044,,,,5,3,8
HND-010965,2011,130500045,,,,5,2,7
HND-010967,2011,130500048,,,,8,3,11
,2011,130500057,,,,4,5,9
HND-010976,2011,130500139,,,,2,3,5
HND-010979,2011,130500165,,,,2,2,4
HND-010981,2011,130500169,,,,5,3,8
HND-010926,2011,130500001,,,,11,9,20
,2011,130500003,,,,12,9,21
HND-010929,2011,130500004,,,,5,4,9
HND-010932,2011,130500007,,,,9,8,17
HND-010933,2011,130500008,,,,4,6,10
HND-010935,2011,130500010,,,,10,12,22
HND-010936,2011,130500011,,,,6,6,12
HND-010938,2011,130500013,,,,5,4,9
,2011,130500014,,,,7,4,11
HND-010941,2011,130500016,,,,13,4,17
HND-010947,2011,130500022,,,,2,3,5
HND-010954,2011,130500034,,,,8,1,9
HND-010957,2011,130500037,,,,8,5,13
HND-010963,2011,130500043,,,,3,1,4
HND-010966,2011,130500047,,,,4,5,9
HND-010968,2011,130500049,,,,5,11,16
HND-010969,2011,130500050,,,,3,5,8
HND-010971,2011,130500054,,,,12,11,23
HND-010973,2011,130500063,,,,3,5,8
HND-010975,2011,130500138,,,,6,0,6
HND-010983,2011,130500172,,,,12,4,16
,2011,130500173,,,,1,1,2
HND-010929,2011,130500004,,,,6,3,9
HND-010930,2011,130500005,,,,5,5,10
HND-010933,2011,130500008,,,,7,6,13
HND-010934,2011,130500009,,,,18,15,33
HND-010935,2011,130500010,,,,2,8,10
HND-010937,2011,130500012,,,,1,4,5
,2011,130500014,,,,10,5,15
HND-010940,2011,130500015,,,,8,4,12
HND-010942,2011,130500017,,,,8,11,19
HND-010943,2011,130500018,,,,11,4,15
HND-010952,2011,130500029,,,,13,13,26
HND-010955,2011,130500035,,,,6,2,8
HND-010959,2011,130500039,,,,2,1,3
HND-010960,2011,130500040,,,,2,2,4
HND-010961,2011,130500041,,,,2,3,5
HND-010963,2011,130500043,,,,2,3,5
HND-010964,2011,130500044,,,,4,5,9
HND-010966,2011,130500047,,,,1,8,9
HND-010967,2011,130500048,,,,3,4,7
,2011,130500057,,,,1,8,9
HND-010975,2011,130500138,,,,4,2,6
HND-010976,2011,130500139,,,,0,4,4
HND-010979,2011,130500165,,,,2,3,5
HND-010926,2011,130500001,,,,6,13,19
,2011,130500002,,,,20,15,35
,2011,130500003,,,,11,15,26
HND-010931,2011,130500006,,,,8,9,17
HND-010932,2011,130500007,,,,9,9,18
HND-010936,2011,130500011,,,,7,9,16
HND-010938,2011,130500013,,,,4,4,8
HND-010941,2011,130500016,,,,9,10,19
HND-010947,2011,130500022,,,,6,5,11
HND-010954,2011,130500034,,,,5,4,9
HND-010956,2011,130500036,,,,8,4,12
HND-010957,2011,130500037,,,,5,2,7
HND-010962,2011,130500042,,,,14,1,15
HND-010965,2011,130500045,,,,7,6,13
HND-010968,2011,130500049,,,,8,4,12
HND-010969,2011,130500050,,,,4,3,7
HND-010971,2011,130500054,,,,16,7,23
HND-010973,2011,130500063,,,,5,6,11
HND-010981,2011,130500169,,,,1,3,4
,2011,130500173,,,,2,0,2
,2011,130500002,,,,19,13,32
,2011,130500003,,,,11,11,22
HND-010930,2011,130500005,,,,0,2,2
HND-010931,2011,130500006,,,,10,7,17
HND-010932,2011,130500007,,,,7,7,14
HND-010934,2011,130500009,,,,10,19,29
HND-010940,2011,130500015,,,,9,4,13
HND-010941,2011,130500016,,,,7,10,17
HND-010956,2011,130500036,,,,2,3,5
HND-010957,2011,130500037,,,,1,4,5
HND-010959,2011,130500039,,,,1,1,2
HND-010960,2011,130500040,,,,1,8,9
HND-010962,2011,130500042,,,,4,10,14
HND-010964,2011,130500044,,,,6,3,9
HND-010965,2011,130500045,,,,3,9,12
HND-010967,2011,130500048,,,,5,5,10
HND-010969,2011,130500050,,,,4,5,9
HND-010971,2011,130500054,,,,6,6,12
,2011,130500057,,,,2,5,7
HND-010976,2011,130500139,,,,6,3,9
HND-010979,2011,130500165,,,,2,4,6
HND-010981,2011,130500169,,,,2,1,3
HND-010983,2011,130500172,,,,3,3,6
HND-010926,2011,130500001,,,,13,13,26
HND-010929,2011,130500004,,,,7,5,12
HND-010933,2011,130500008,,,,5,4,9
HND-010935,2011,130500010,,,,4,2,6
HND-010936,2011,130500011,,,,0,8,8
HND-010937,2011,130500012,,,,4,1,5
HND-010938,2011,130500013,,,,6,3,9
,2011,130500014,,,,4,3,7
HND-010942,2011,130500017,,,,11,9,20
HND-010943,2011,130500018,,,,5,4,9
HND-010947,2011,130500022,,,,8,3,11
HND-010952,2011,130500029,,,,5,13,18
HND-010954,2011,130500034,,,,3,3,6
HND-010955,2011,130500035,,,,2,4,6
HND-010961,2011,130500041,,,,0,1,1
HND-010963,2011,130500043,,,,1,1,2
HND-010966,2011,130500047,,,,2,5,7
HND-010968,2011,130500049,,,,5,6,11
HND-010973,2011,130500063,,,,4,2,6
HND-010975,2011,130500138,,,,1,1,2
,2011,130500173,,,,4,1,5
HND-010926,2011,130500001,,,,10,13,23
,2011,130500002,,,,19,15,34
,2011,130500003,,,,8,9,17
HND-010931,2011,130500006,,,,11,7,18
HND-010932,2011,130500007,,,,5,6,11
HND-010934,2011,130500009,,,,12,12,24
HND-010938,2011,130500013,,,,1,6,7
HND-010940,2011,130500015,,,,4,5,9
HND-010941,2011,130500016,,,,7,6,13
HND-010956,2011,130500036,,,,7,1,8
HND-010957,2011,130500037,,,,4,3,7
HND-010960,2011,130500040,,,,3,0,3
HND-010962,2011,130500042,,,,4,9,13
HND-010965,2011,130500045,,,,3,4,7
HND-010967,2011,130500048,,,,2,2,4
HND-010968,2011,130500049,,,,3,6,9
HND-010969,2011,130500050,,,,6,9,15
HND-010971,2011,130500054,,,,5,6,11
,2011,130500057,,,,7,2,9
HND-010973,2011,130500063,,,,4,2,6
HND-010976,2011,130500139,,,,2,1,3
HND-010981,2011,130500169,,,,1,3,4
HND-010929,2011,130500004,,,,5,4,9
HND-010930,2011,130500005,,,,2,2,4
HND-010933,2011,130500008,,,,6,4,10
HND-010935,2011,130500010,,,,5,8,13
HND-010936,2011,130500011,,,,5,1,6
HND-010937,2011,130500012,,,,3,4,7
,2011,130500014,,,,3,5,8
HND-010942,2011,130500017,,,,8,19,27
HND-010943,2011,130500018,,,,6,4,10
HND-010947,2011,130500022,,,,1,4,5
HND-010952,2011,130500029,,,,8,7,15
HND-010954,2011,130500034,,,,7,3,10
HND-010955,2011,130500035,,,,2,2,4
HND-010959,2011,130500039,,,,2,2,4
HND-010961,2011,130500041,,,,4,2,6
HND-010963,2011,130500043,,,,2,2,4
HND-010964,2011,130500044,,,,3,4,7
HND-010966,2011,130500047,,,,7,2,9
HND-010975,2011,130500138,,,,0,2,2
HND-010979,2011,130500165,,,,2,0,2
,2011,130500173,,,,1,0,1
,2011,130500002,,,,18,16,34
HND-010930,2011,130500005,,,,2,2,4
HND-010931,2011,130500006,,,,7,7,14
HND-010937,2011,130500012,,,,3,2,5
HND-010940,2011,130500015,,,,3,10,13
HND-010942,2011,130500017,,,,5,12,17
HND-010943,2011,130500018,,,,8,6,14
HND-010954,2011,130500034,,,,6,1,7
HND-010957,2011,130500037,,,,4,4,8
HND-010963,2011,130500043,,,,0,2,2
HND-010966,2011,130500047,,,,2,2,4
HND-010968,2011,130500049,,,,0,7,7
HND-010969,2011,130500050,,,,2,2,4
HND-010971,2011,130500054,,,,7,4,11
HND-010975,2011,130500138,,,,1,5,6
,2011,130500173,,,,0,1,1
HND-010926,2011,130500001,,,,15,8,23
,2011,130500003,,,,2,11,13
HND-010929,2011,130500004,,,,5,9,14
HND-010932,2011,130500007,,,,5,5,10
HND-010933,2011,130500008,,,,3,5,8
HND-010934,2011,130500009,,,,12,10,22
HND-010935,2011,130500010,,,,6,6,12
HND-010936,2011,130500011,,,,2,3,5
HND-010938,2011,130500013,,,,4,3,7
,2011,130500014,,,,0,7,7
HND-010941,2011,130500016,,,,5,4,9
HND-010947,2011,130500022,,,,4,2,6
HND-010952,2011,130500029,,,,11,5,16
HND-010955,2011,130500035,,,,5,0,5
HND-010956,2011,130500036,,,,3,2,5
HND-010960,2011,130500040,,,,0,1,1
HND-010961,2011,130500041,,,,2,0,2
HND-010962,2011,130500042,,,,2,5,7
HND-010964,2011,130500044,,,,2,2,4
HND-010965,2011,130500045,,,,11,3,14
HND-010967,2011,130500048,,,,1,0,1
,2011,130500057,,,,2,2,4
HND-010973,2011,130500063,,,,1,0,1
HND-010976,2011,130500139,,,,2,4,6
HND-010979,2011,130500165,,,,0,3,3
HND-010981,2011,130500169,,,,1,0,1
HND-010926,2011,130500001,,,,6,6,12
HND-010931,2011,130500006,,,,10,9,19
HND-010932,2011,130500007,,,,15,16,31
,2011,130500021,,,,72,89,161
HND-010940,2011,130500015,,,,6,2,8
HND-010931,2011,130500006,,,,6,7,13
HND-010940,2011,130500015,,,,6,1,7
HND-010926,2011,130500001,,,,2,6,8
HND-010932,2011,130500007,,,,9,8,17
,2011,130500021,,,,54,53,107
HND-010931,2011,130500006,,,,6,13,19
HND-010940,2011,130500015,,,,6,8,14
,2011,130500021,,,,60,58,118
HND-010926,2011,130500001,,,,3,1,4
HND-010932,2011,130500007,,,,7,12,19
,2011,130500021,,,,68,71,139
,2011,130500021,,,,50,38,88
,2011,130500021,,,,27,32,59
,2011,130600032,,,,4,7,11
HND-011019,2011,130600094,,,,5,5,10
,2011,130600099,,,,2,7,9
HND-011022,2011,130600105,,,,2,6,8
,2011,130600125,,,,4,5,9
,2011,130600127,,,,4,1,5
,2011,130600090,,,,7,5,12
,2011,130600097,,,,9,2,11
,2011,130600100,,,,8,7,15
,2011,130600126,,,,4,6,10
HND-011012,2011,130600027,,,,3,2,5
HND-011013,2011,130600028,,,,5,5,10
,2011,130600044,,,,2,1,3
,2011,130600124,,,,0,2,2
,2011,130600128,,,,5,3,8
,2011,130600129,,,,1,0,1
HND-011014,2011,130600029,,,,5,1,6
HND-011017,2011,130600051,,,,2,2,4
HND-011026,2011,130600118,,,,3,1,4
,2011,130600122,,,,1,1,2
,2011,130600131,,,,1,3,4
HND-010993,2011,130600007,,,,8,8,16
HND-011013,2011,130600028,,,,3,4,7
HND-011015,2011,130600031,,,,4,3,7
,2011,130600044,,,,2,3,5
,2011,130600089,,,,4,12,16
,2011,130600122,,,,2,1,3
HND-011028,2011,130600123,,,,5,2,7
,2011,130600124,,,,3,2,5
,2011,130600125,,,,5,2,7
,2011,130600128,,,,2,3,5
,2011,130600129,,,,3,4,7
HND-011012,2011,130600027,,,,9,13,22
HND-011014,2011,130600029,,,,5,2,7
HND-011018,2011,130600092,,,,4,2,6
,2011,130600096,,,,2,3,5
HND-011026,2011,130600118,,,,2,6,8
HND-011027,2011,130600121,,,,2,0,2
,2011,130600131,,,,3,3,6
HND-010993,2011,130600007,,,,4,18,22
HND-011014,2011,130600029,,,,5,12,17
,2011,130600044,,,,3,5,8
HND-011026,2011,130600118,,,,11,12,23
HND-011027,2011,130600121,,,,5,5,10
,2011,130600122,,,,5,6,11
HND-011028,2011,130600123,,,,6,7,13
,2011,130600131,,,,4,1,5
HND-011012,2011,130600027,,,,7,7,14
HND-011013,2011,130600028,,,,7,3,10
HND-011015,2011,130600031,,,,3,4,7
HND-011017,2011,130600051,,,,4,7,11
HND-011018,2011,130600092,,,,6,10,16
,2011,130600096,,,,8,7,15
,2011,130600124,,,,4,8,12
,2011,130600125,,,,6,7,13
,2011,130600128,,,,9,7,16
,2011,130600129,,,,6,0,6
HND-010989,2011,130600003,,,,12,9,21
HND-010990,2011,130600004,,,,7,7,14
HND-010992,2011,130600006,,,,16,9,25
HND-010993,2011,130600007,,,,19,14,33
HND-010994,2011,130600008,,,,6,9,15
HND-010998,2011,130600012,,,,15,11,26
HND-011001,2011,130600015,,,,4,4,8
HND-011005,2011,130600019,,,,15,8,23
HND-011007,2011,130600021,,,,7,3,10
,2011,130600023,,,,7,6,13
HND-011011,2011,130600026,,,,5,7,12
HND-011016,2011,130600038,,,,10,7,17
HND-011029,2011,130600130,,,,1,1,2
HND-010987,2011,130600001,,,,5,13,18
HND-010988,2011,130600002,,,,7,13,20
HND-010991,2011,130600005,,,,13,12,25
HND-010995,2011,130600009,,,,3,3,6
HND-010996,2011,130600010,,,,6,6,12
HND-010997,2011,130600011,,,,14,13,27
HND-010999,2011,130600013,,,,6,6,12
HND-011000,2011,130600014,,,,15,8,23
HND-011003,2011,130600017,,,,5,4,9
HND-011004,2011,130600018,,,,5,6,11
HND-011006,2011,130600020,,,,2,2,4
HND-011008,2011,130600022,,,,6,8,14
HND-011009,2011,130600024,,,,9,7,16
HND-011010,2011,130600025,,,,6,8,14
HND-011017,2011,130600051,,,,2,3,5
,2011,130600053,,,,5,3,8
HND-011023,2011,130600114,,,,5,3,8
HND-011025,2011,130600116,,,,1,2,3
HND-010989,2011,130600003,,,,11,9,20
HND-010993,2011,130600007,,,,14,15,29
HND-010995,2011,130600009,,,,3,1,4
HND-010996,2011,130600010,,,,8,7,15
HND-010997,2011,130600011,,,,8,6,14
HND-010998,2011,130600012,,,,16,11,27
HND-011000,2011,130600014,,,,5,7,12
HND-011001,2011,130600015,,,,3,7,10
HND-011004,2011,130600018,,,,9,7,16
HND-011011,2011,130600026,,,,5,4,9
HND-011016,2011,130600038,,,,5,2,7
HND-011023,2011,130600114,,,,2,3,5
HND-011024,2011,130600115,,,,1,0,1
HND-010987,2011,130600001,,,,11,16,27
HND-010988,2011,130600002,,,,11,6,17
HND-010990,2011,130600004,,,,8,3,11
HND-010991,2011,130600005,,,,7,11,18
HND-010992,2011,130600006,,,,16,17,33
HND-010994,2011,130600008,,,,11,8,19
HND-010999,2011,130600013,,,,2,7,9
HND-011002,2011,130600016,,,,4,5,9
HND-011003,2011,130600017,,,,3,3,6
HND-011005,2011,130600019,,,,7,5,12
HND-011006,2011,130600020,,,,1,3,4
HND-011007,2011,130600021,,,,3,5,8
HND-011008,2011,130600022,,,,7,4,11
,2011,130600023,,,,9,5,14
HND-011009,2011,130600024,,,,2,3,5
HND-011017,2011,130600051,,,,4,4,8
,2011,130600053,,,,2,5,7
HND-011025,2011,130600116,,,,2,5,7
HND-011029,2011,130600130,,,,2,1,3
HND-010987,2011,130600001,,,,20,12,32
HND-010988,2011,130600002,,,,7,9,16
HND-010991,2011,130600005,,,,8,9,17
HND-010995,2011,130600009,,,,1,3,4
HND-010996,2011,130600010,,,,7,7,14
HND-010997,2011,130600011,,,,2,6,8
HND-010999,2011,130600013,,,,7,3,10
HND-011000,2011,130600014,,,,4,3,7
HND-011003,2011,130600017,,,,7,4,11
HND-011004,2011,130600018,,,,3,5,8
HND-011006,2011,130600020,,,,4,1,5
HND-011008,2011,130600022,,,,12,6,18
HND-011010,2011,130600025,,,,6,7,13
HND-011016,2011,130600038,,,,1,6,7
HND-011023,2011,130600114,,,,6,4,10
HND-011024,2011,130600115,,,,3,7,10
HND-011025,2011,130600116,,,,0,4,4
HND-010989,2011,130600003,,,,10,8,18
HND-010990,2011,130600004,,,,5,5,10
HND-010992,2011,130600006,,,,11,6,17
HND-010993,2011,130600007,,,,14,17,31
HND-010994,2011,130600008,,,,8,5,13
HND-010998,2011,130600012,,,,16,19,35
HND-011001,2011,130600015,,,,3,4,7
HND-011002,2011,130600016,,,,4,2,6
HND-011005,2011,130600019,,,,9,3,12
HND-011007,2011,130600021,,,,3,6,9
,2011,130600023,,,,5,13,18
HND-011009,2011,130600024,,,,6,3,9
HND-011011,2011,130600026,,,,2,4,6
HND-011017,2011,130600051,,,,3,3,6
,2011,130600053,,,,6,4,10
HND-011029,2011,130600130,,,,2,0,2
HND-010989,2011,130600003,,,,6,9,15
HND-010993,2011,130600007,,,,12,10,22
HND-010995,2011,130600009,,,,4,2,6
HND-010996,2011,130600010,,,,5,9,14
HND-010998,2011,130600012,,,,7,6,13
HND-011000,2011,130600014,,,,3,5,8
HND-011001,2011,130600015,,,,4,1,5
HND-011004,2011,130600018,,,,4,6,10
,2011,130600023,,,,7,9,16
HND-011011,2011,130600026,,,,5,1,6
HND-011016,2011,130600038,,,,2,6,8
,2011,130600053,,,,4,4,8
HND-011024,2011,130600115,,,,4,1,5
HND-010987,2011,130600001,,,,15,12,27
HND-010988,2011,130600002,,,,10,7,17
HND-010990,2011,130600004,,,,1,3,4
HND-010991,2011,130600005,,,,13,10,23
HND-010992,2011,130600006,,,,5,5,10
HND-010994,2011,130600008,,,,9,2,11
HND-010997,2011,130600011,,,,10,7,17
HND-011002,2011,130600016,,,,4,3,7
HND-011003,2011,130600017,,,,4,3,7
HND-011005,2011,130600019,,,,5,4,9
HND-011007,2011,130600021,,,,0,3,3
HND-011008,2011,130600022,,,,7,6,13
HND-011009,2011,130600024,,,,6,2,8
HND-011017,2011,130600051,,,,2,3,5
HND-011023,2011,130600114,,,,4,5,9
HND-011025,2011,130600116,,,,5,1,6
HND-011029,2011,130600130,,,,1,4,5
HND-010989,2011,130600003,,,,10,10,20
HND-010990,2011,130600004,,,,4,2,6
HND-010992,2011,130600006,,,,6,5,11
HND-010993,2011,130600007,,,,9,7,16
HND-010998,2011,130600012,,,,14,10,24
HND-011001,2011,130600015,,,,1,2,3
HND-011004,2011,130600018,,,,1,7,8
HND-011005,2011,130600019,,,,7,3,10
,2011,130600023,,,,6,5,11
HND-011011,2011,130600026,,,,2,7,9
HND-011017,2011,130600051,,,,2,1,3
,2011,130600053,,,,4,5,9
HND-011023,2011,130600114,,,,2,4,6
HND-011025,2011,130600116,,,,3,1,4
HND-011029,2011,130600130,,,,1,1,2
HND-010987,2011,130600001,,,,16,18,34
HND-010988,2011,130600002,,,,12,7,19
HND-010991,2011,130600005,,,,5,9,14
HND-010994,2011,130600008,,,,2,8,10
HND-010995,2011,130600009,,,,2,2,4
HND-010996,2011,130600010,,,,7,15,22
HND-010997,2011,130600011,,,,4,6,10
HND-010999,2011,130600013,,,,1,5,6
HND-011000,2011,130600014,,,,4,1,5
HND-011002,2011,130600016,,,,2,1,3
HND-011003,2011,130600017,,,,2,4,6
HND-011006,2011,130600020,,,,4,3,7
HND-011008,2011,130600022,,,,5,4,9
HND-011010,2011,130600025,,,,6,3,9
HND-011016,2011,130600038,,,,3,1,4
HND-011024,2011,130600115,,,,0,1,1
HND-010987,2011,130600001,,,,17,22,39
HND-010988,2011,130600002,,,,12,15,27
HND-010991,2011,130600005,,,,12,8,20
HND-010992,2011,130600006,,,,7,7,14
HND-010994,2011,130600008,,,,3,5,8
HND-011003,2011,130600017,,,,3,3,6
HND-011005,2011,130600019,,,,5,2,7
HND-011006,2011,130600020,,,,2,0,2
HND-011008,2011,130600022,,,,7,4,11
,2011,130600023,,,,3,1,4
HND-011009,2011,130600024,,,,7,1,8
HND-011017,2011,130600051,,,,2,2,4
,2011,130600053,,,,0,5,5
HND-011023,2011,130600114,,,,3,3,6
HND-011024,2011,130600115,,,,1,3,4
HND-011029,2011,130600130,,,,0,2,2
HND-010989,2011,130600003,,,,12,9,21
HND-010993,2011,130600007,,,,13,4,17
HND-010995,2011,130600009,,,,0,2,2
HND-010996,2011,130600010,,,,4,8,12
HND-010997,2011,130600011,,,,1,7,8
HND-010998,2011,130600012,,,,8,10,18
HND-011000,2011,130600014,,,,4,2,6
HND-011001,2011,130600015,,,,3,0,3
HND-011004,2011,130600018,,,,3,6,9
HND-011010,2011,130600025,,,,6,4,10
HND-011011,2011,130600026,,,,1,3,4
HND-011016,2011,130600038,,,,2,2,4
HND-011025,2011,130600116,,,,3,1,4
HND-010989,2011,130600003,,,,10,1,11
HND-010993,2011,130600007,,,,14,21,35
HND-010987,2011,130600001,,,,30,25,55
HND-010988,2011,130600002,,,,13,8,21
HND-010989,2011,130600003,,,,4,5,9
HND-010993,2011,130600007,,,,17,22,39
HND-010987,2011,130600001,,,,29,27,56
HND-010988,2011,130600002,,,,9,5,14
HND-010989,2011,130600003,,,,4,4,8
HND-010993,2011,130600007,,,,9,2,11
HND-010987,2011,130600001,,,,22,14,36
HND-010988,2011,130600002,,,,8,6,14
,2011,130600113,,,,7,16,23
,2011,130600113,,,,7,8,15
,2011,130600113,,,,5,8,13
HND-011069,2011,130700057,,,,3,3,6
HND-011073,2011,130700063,,,,4,2,6
HND-011075,2011,130700067,,,,7,4,11
HND-011076,2011,130700070,,,,5,4,9
,2011,130700072,,,,6,4,10
,2011,130700085,,,,1,6,7
HND-011070,2011,130700058,,,,2,3,5
HND-011072,2011,130700060,,,,5,4,9
,2011,130700062,,,,3,2,5
,2011,130700087,,,,4,4,8
,2011,130700088,,,,3,5,8
HND-011056,2011,130700026,,,,2,3,5
HND-011062,2011,130700048,,,,1,1,2
HND-011055,2011,130700025,,,,14,9,23
HND-011056,2011,130700026,,,,9,10,19
HND-011059,2011,130700045,,,,7,7,14
HND-011060,2011,130700046,,,,4,4,8
HND-011062,2011,130700048,,,,2,7,9
HND-011056,2011,130700026,,,,1,11,12
HND-011062,2011,130700048,,,,3,5,8
HND-011055,2011,130700025,,,,13,11,24
HND-011059,2011,130700045,,,,7,6,13
HND-011060,2011,130700046,,,,5,2,7
,2011,130700002,,,,9,7,16
HND-011039,2011,130700009,,,,2,1,3
HND-011040,2011,130700010,,,,7,10,17
HND-011045,2011,130700015,,,,4,5,9
HND-011048,2011,130700018,,,,7,2,9
HND-011050,2011,130700020,,,,3,2,5
HND-011051,2011,130700021,,,,7,6,13
HND-011058,2011,130700042,,,,2,6,8
HND-011063,2011,130700049,,,,1,3,4
HND-011066,2011,130700053,,,,1,5,6
HND-011068,2011,130700056,,,,3,1,4
HND-011031,2011,130700001,,,,5,7,12
HND-011033,2011,130700003,,,,8,3,11
HND-011034,2011,130700004,,,,3,1,4
HND-011036,2011,130700006,,,,5,3,8
HND-011038,2011,130700008,,,,15,11,26
HND-011043,2011,130700013,,,,2,3,5
HND-011046,2011,130700016,,,,12,14,26
HND-011047,2011,130700017,,,,1,0,1
HND-011064,2011,130700050,,,,1,0,1
HND-011031,2011,130700001,,,,9,9,18
HND-011034,2011,130700004,,,,0,2,2
HND-011038,2011,130700008,,,,12,8,20
HND-011040,2011,130700010,,,,11,10,21
HND-011041,2011,130700011,,,,3,0,3
HND-011043,2011,130700013,,,,2,7,9
HND-011044,2011,130700014,,,,7,9,16
HND-011046,2011,130700016,,,,8,7,15
HND-011048,2011,130700018,,,,7,4,11
HND-011051,2011,130700021,,,,5,1,6
HND-011053,2011,130700023,,,,5,4,9
HND-011054,2011,130700024,,,,5,3,8
HND-011058,2011,130700042,,,,5,4,9
HND-011064,2011,130700050,,,,3,2,5
HND-011065,2011,130700052,,,,2,1,3
HND-011033,2011,130700003,,,,7,7,14
HND-011035,2011,130700005,,,,7,5,12
HND-011036,2011,130700006,,,,5,3,8
HND-011037,2011,130700007,,,,2,2,4
HND-011039,2011,130700009,,,,4,3,7
HND-011042,2011,130700012,,,,3,2,5
HND-011049,2011,130700019,,,,4,1,5
HND-011050,2011,130700020,,,,7,5,12
HND-011052,2011,130700022,,,,5,2,7
HND-011066,2011,130700053,,,,2,8,10
HND-011068,2011,130700056,,,,1,1,2
HND-011031,2011,130700001,,,,5,9,14
HND-011034,2011,130700004,,,,2,2,4
HND-011036,2011,130700006,,,,5,5,10
HND-011038,2011,130700008,,,,12,7,19
HND-011041,2011,130700011,,,,2,7,9
HND-011043,2011,130700013,,,,3,4,7
HND-011046,2011,130700016,,,,10,11,21
HND-011047,2011,130700017,,,,1,2,3
HND-011049,2011,130700019,,,,8,4,12
HND-011064,2011,130700050,,,,0,1,1
HND-011065,2011,130700052,,,,2,0,2
HND-011035,2011,130700005,,,,5,6,11
HND-011039,2011,130700009,,,,4,3,7
HND-011040,2011,130700010,,,,10,6,16
HND-011045,2011,130700015,,,,1,4,5
HND-011050,2011,130700020,,,,6,5,11
HND-011051,2011,130700021,,,,8,3,11
HND-011058,2011,130700042,,,,4,5,9
HND-011063,2011,130700049,,,,2,2,4
HND-011068,2011,130700056,,,,3,3,6
,2011,130700002,,,,4,5,9
HND-011034,2011,130700004,,,,5,4,9
HND-011038,2011,130700008,,,,10,8,18
HND-011040,2011,130700010,,,,9,5,14
HND-011041,2011,130700011,,,,4,5,9
HND-011042,2011,130700012,,,,6,5,11
HND-011043,2011,130700013,,,,3,6,9
HND-011044,2011,130700014,,,,6,6,12
HND-011047,2011,130700017,,,,2,2,4
HND-011048,2011,130700018,,,,3,8,11
HND-011050,2011,130700020,,,,6,5,11
HND-011051,2011,130700021,,,,14,6,20
HND-011053,2011,130700023,,,,4,6,10
HND-011054,2011,130700024,,,,4,1,5
HND-011058,2011,130700042,,,,6,7,13
HND-011065,2011,130700052,,,,3,2,5
HND-011031,2011,130700001,,,,9,5,14
HND-011033,2011,130700003,,,,13,12,25
HND-011036,2011,130700006,,,,5,3,8
HND-011037,2011,130700007,,,,2,6,8
HND-011039,2011,130700009,,,,5,2,7
HND-011045,2011,130700015,,,,3,2,5
HND-011046,2011,130700016,,,,15,9,24
HND-011052,2011,130700022,,,,7,4,11
HND-011064,2011,130700050,,,,1,3,4
HND-011066,2011,130700053,,,,1,1,2
HND-011068,2011,130700056,,,,1,1,2
,2011,130700002,,,,6,9,15
HND-011034,2011,130700004,,,,0,2,2
HND-011035,2011,130700005,,,,3,5,8
HND-011038,2011,130700008,,,,10,15,25
HND-011039,2011,130700009,,,,4,4,8
HND-011040,2011,130700010,,,,13,9,22
HND-011041,2011,130700011,,,,2,5,7
HND-011045,2011,130700015,,,,1,2,3
HND-011048,2011,130700018,,,,3,8,11
HND-011050,2011,130700020,,,,6,7,13
HND-011051,2011,130700021,,,,12,6,18
HND-011054,2011,130700024,,,,3,1,4
HND-011063,2011,130700049,,,,0,4,4
HND-011064,2011,130700050,,,,1,1,2
HND-011065,2011,130700052,,,,2,0,2
HND-011066,2011,130700053,,,,1,0,1
HND-011031,2011,130700001,,,,6,4,10
HND-011036,2011,130700006,,,,5,4,9
HND-011043,2011,130700013,,,,10,22,32
HND-011046,2011,130700016,,,,8,10,18
HND-011049,2011,130700019,,,,0,4,4
HND-011053,2011,130700023,,,,12,9,21
HND-011058,2011,130700042,,,,1,3,4
HND-011068,2011,130700056,,,,4,4,8
HND-011033,2011,130700003,,,,3,5,8
HND-011036,2011,130700006,,,,4,4,8
HND-011037,2011,130700007,,,,7,5,12
HND-011039,2011,130700009,,,,3,5,8
HND-011042,2011,130700012,,,,2,5,7
HND-011045,2011,130700015,,,,1,4,5
HND-011049,2011,130700019,,,,4,5,9
HND-011050,2011,130700020,,,,4,2,6
HND-011052,2011,130700022,,,,2,5,7
HND-011058,2011,130700042,,,,0,1,1
HND-011064,2011,130700050,,,,1,2,3
HND-011065,2011,130700052,,,,1,2,3
HND-011031,2011,130700001,,,,6,12,18
HND-011034,2011,130700004,,,,3,2,5
HND-011038,2011,130700008,,,,6,15,21
HND-011040,2011,130700010,,,,7,6,13
HND-011041,2011,130700011,,,,1,4,5
HND-011043,2011,130700013,,,,0,3,3
HND-011044,2011,130700014,,,,5,4,9
HND-011046,2011,130700016,,,,12,12,24
HND-011047,2011,130700017,,,,1,4,5
HND-011051,2011,130700021,,,,1,0,1
HND-011054,2011,130700024,,,,1,1,2
HND-011063,2011,130700049,,,,2,2,4
HND-011066,2011,130700053,,,,2,0,2
HND-011038,2011,130700008,,,,11,10,21
HND-011036,2011,130700006,,,,12,5,17
HND-011057,2011,130700027,,,,36,62,98
HND-011038,2011,130700008,,,,7,10,17
HND-011057,2011,130700027,,,,31,42,73
HND-011036,2011,130700006,,,,14,14,28
HND-011038,2011,130700008,,,,8,11,19
HND-011057,2011,130700027,,,,29,39,68
HND-011036,2011,130700006,,,,3,10,13
HND-011057,2011,130700027,,,,50,55,105
HND-011057,2011,130700027,,,,13,6,19
HND-011057,2011,130700027,,,,10,12,22
HND-011103,2011,130800076,,,,9,4,13
HND-011104,2011,130800096,,,,5,3,8
HND-011106,2011,130800101,,,,5,11,16
,2011,130800102,,,,3,5,8
HND-011094,2011,130800024,,,,1,0,1
HND-011097,2011,130800034,,,,0,1,1
HND-011098,2011,130800038,,,,3,5,8
HND-011100,2011,130800041,,,,3,1,4
HND-011105,2011,130800099,,,,6,2,8
HND-011093,2011,130800021,,,,2,2,4
HND-011096,2011,130800033,,,,2,0,2
,2011,130800036,,,,4,4,8
HND-011099,2011,130800039,,,,1,4,5
HND-011101,2011,130800042,,,,2,1,3
,2011,130800100,,,,3,4,7
HND-011090,2011,130800012,,,,5,1,6
HND-011093,2011,130800021,,,,4,5,9
HND-011096,2011,130800033,,,,7,6,13
HND-011097,2011,130800034,,,,8,8,16
HND-011098,2011,130800038,,,,3,0,3
HND-011105,2011,130800099,,,,4,3,7
,2011,130800100,,,,1,3,4
HND-011094,2011,130800024,,,,2,4,6
,2011,130800036,,,,1,1,2
HND-011099,2011,130800039,,,,1,0,1
HND-011100,2011,130800041,,,,3,7,10
HND-011101,2011,130800042,,,,3,4,7
HND-011094,2011,130800024,,,,4,6,10
HND-011096,2011,130800033,,,,25,10,35
HND-011099,2011,130800039,,,,1,1,2
HND-011100,2011,130800041,,,,2,5,7
HND-011101,2011,130800042,,,,2,3,5
HND-011090,2011,130800012,,,,7,4,11
HND-011093,2011,130800021,,,,4,3,7
HND-011097,2011,130800034,,,,7,9,16
HND-011098,2011,130800038,,,,6,8,14
HND-011105,2011,130800099,,,,6,7,13
,2011,130800100,,,,0,4,4
HND-011081,2011,130800003,,,,5,3,8
HND-011083,2011,130800005,,,,21,13,34
HND-011084,2011,130800006,,,,14,13,27
HND-011087,2011,130800009,,,,8,6,14
HND-011088,2011,130800010,,,,2,2,4
HND-011089,2011,130800011,,,,9,4,13
HND-011092,2011,130800016,,,,3,11,14
,2011,130800026,,,,8,5,13
HND-011102,2011,130800075,,,,5,2,7
HND-011079,2011,130800001,,,,13,14,27
HND-011080,2011,130800002,,,,10,8,18
HND-011082,2011,130800004,,,,9,4,13
HND-011085,2011,130800007,,,,9,3,12
HND-011086,2011,130800008,,,,14,6,20
HND-011095,2011,130800025,,,,2,1,3
HND-011098,2011,130800038,,,,7,5,12
HND-011079,2011,130800001,,,,9,12,21
HND-011080,2011,130800002,,,,4,10,14
HND-011082,2011,130800004,,,,12,3,15
HND-011083,2011,130800005,,,,8,6,14
HND-011086,2011,130800008,,,,9,7,16
HND-011087,2011,130800009,,,,1,8,9
HND-011089,2011,130800011,,,,5,4,9
HND-011092,2011,130800016,,,,4,1,5
HND-011098,2011,130800038,,,,4,5,9
HND-011102,2011,130800075,,,,4,4,8
HND-011081,2011,130800003,,,,6,9,15
HND-011084,2011,130800006,,,,8,13,21
HND-011085,2011,130800007,,,,1,4,5
HND-011088,2011,130800010,,,,2,4,6
,2011,130800026,,,,4,3,7
HND-011079,2011,130800001,,,,12,10,22
HND-011080,2011,130800002,,,,15,18,33
HND-011082,2011,130800004,,,,7,8,15
HND-011083,2011,130800005,,,,6,14,20
HND-011086,2011,130800008,,,,8,7,15
HND-011095,2011,130800025,,,,1,2,3
HND-011098,2011,130800038,,,,5,9,14
HND-011102,2011,130800075,,,,5,2,7
HND-011081,2011,130800003,,,,5,2,7
HND-011084,2011,130800006,,,,13,13,26
HND-011085,2011,130800007,,,,5,3,8
HND-011087,2011,130800009,,,,6,6,12
HND-011088,2011,130800010,,,,1,0,1
HND-011089,2011,130800011,,,,0,1,1
HND-011092,2011,130800016,,,,5,1,6
,2011,130800026,,,,5,3,8
HND-011079,2011,130800001,,,,13,9,22
HND-011080,2011,130800002,,,,5,11,16
HND-011083,2011,130800005,,,,3,9,12
HND-011087,2011,130800009,,,,4,3,7
HND-011088,2011,130800010,,,,1,1,2
HND-011089,2011,130800011,,,,3,1,4
HND-011095,2011,130800025,,,,1,1,2
HND-011102,2011,130800075,,,,1,0,1
HND-011081,2011,130800003,,,,5,3,8
HND-011082,2011,130800004,,,,11,11,22
HND-011084,2011,130800006,,,,8,11,19
HND-011085,2011,130800007,,,,9,3,12
HND-011086,2011,130800008,,,,8,5,13
,2011,130800026,,,,2,2,4
HND-011098,2011,130800038,,,,2,5,7
HND-011079,2011,130800001,,,,6,8,14
HND-011083,2011,130800005,,,,8,12,20
HND-011084,2011,130800006,,,,11,9,20
HND-011087,2011,130800009,,,,4,4,8
HND-011088,2011,130800010,,,,2,2,4
HND-011089,2011,130800011,,,,8,2,10
HND-011092,2011,130800016,,,,3,2,5
,2011,130800026,,,,4,0,4
HND-011102,2011,130800075,,,,3,4,7
HND-011080,2011,130800002,,,,5,12,17
HND-011081,2011,130800003,,,,1,3,4
HND-011082,2011,130800004,,,,10,1,11
HND-011085,2011,130800007,,,,1,2,3
HND-011086,2011,130800008,,,,5,12,17
HND-011095,2011,130800025,,,,3,0,3
HND-011098,2011,130800038,,,,6,6,12
HND-011081,2011,130800003,,,,2,5,7
HND-011084,2011,130800006,,,,9,8,17
HND-011085,2011,130800007,,,,5,3,8
HND-011088,2011,130800010,,,,2,1,3
,2011,130800026,,,,2,3,5
HND-011079,2011,130800001,,,,9,7,16
HND-011080,2011,130800002,,,,11,9,20
HND-011082,2011,130800004,,,,4,7,11
HND-011083,2011,130800005,,,,5,6,11
HND-011086,2011,130800008,,,,9,6,15
HND-011087,2011,130800009,,,,3,1,4
HND-011089,2011,130800011,,,,2,3,5
HND-011092,2011,130800016,,,,1,0,1
HND-011095,2011,130800025,,,,1,2,3
HND-011098,2011,130800038,,,,1,2,3
HND-011102,2011,130800075,,,,2,1,3
HND-011084,2011,130800006,,,,5,6,11
HND-011091,2011,130800013,,,,41,52,93
HND-011091,2011,130800013,,,,60,63,123
HND-011084,2011,130800006,,,,5,6,11
HND-011084,2011,130800006,,,,7,5,12
HND-011091,2011,130800013,,,,46,44,90
HND-011091,2011,130800013,,,,47,33,80
HND-011091,2011,130800013,,,,30,24,54
HND-011091,2011,130800013,,,,31,19,50
HND-011140,2011,130900037,,,,12,15,27
HND-011142,2011,130900049,,,,6,7,13
HND-011143,2011,130900050,,,,6,2,8
,2011,130900122,,,,4,5,9
,2011,130900152,,,,8,1,9
HND-011167,2011,130900164,,,,7,4,11
HND-011169,2011,130900166,,,,10,5,15
,2011,130900173,,,,10,11,21
HND-011179,2011,130900217,,,,5,3,8
,2011,130900219,,,,29,19,48
,2011,130900035,,,,12,15,27
,2011,130900048,,,,5,4,9
HND-011145,2011,130900053,,,,6,2,8
HND-011159,2011,130900116,,,,7,4,11
HND-011160,2011,130900119,,,,11,5,16
HND-011161,2011,130900141,,,,8,7,15
HND-011168,2011,130900165,,,,8,5,13
HND-011170,2011,130900169,,,,14,12,26
HND-011177,2011,130900215,,,,3,7,10
HND-011178,2011,130900216,,,,5,1,6
,2011,130900245,,,,5,5,10
HND-011185,2011,130900256,,,,7,3,10
,2011,130900257,,,,2,3,5
HND-011186,2011,130900258,,,,21,15,36
HND-011147,2011,130900057,,,,4,6,10
,2011,130900064,,,,2,4,6
HND-011156,2011,130900110,,,,7,5,12
,2011,130900147,,,,3,1,4
HND-011166,2011,130900148,,,,3,1,4
HND-011173,2011,130900211,,,,3,1,4
HND-011174,2011,130900212,,,,0,3,3
HND-011180,2011,130900247,,,,3,6,9
HND-011181,2011,130900248,,,,7,4,11
HND-011184,2011,130900251,,,,2,2,4
HND-011139,2011,130900034,,,,4,4,8
HND-011146,2011,130900055,,,,9,8,17
HND-011157,2011,130900111,,,,2,2,4
,2011,130900209,,,,4,1,5
HND-011175,2011,130900213,,,,1,1,2
,2011,130900246,,,,3,3,6
HND-011182,2011,130900249,,,,7,9,16
HND-011183,2011,130900250,,,,1,4,5
,2011,130900252,,,,2,6,8
,2011,130900254,,,,2,2,4
HND-011146,2011,130900055,,,,12,4,16
HND-011156,2011,130900110,,,,6,12,18
,2011,130900147,,,,4,2,6
HND-011166,2011,130900148,,,,3,6,9
,2011,130900209,,,,4,3,7
HND-011172,2011,130900210,,,,6,6,12
HND-011173,2011,130900211,,,,3,1,4
HND-011175,2011,130900213,,,,5,5,10
HND-011176,2011,130900214,,,,5,2,7
,2011,130900246,,,,2,7,9
HND-011180,2011,130900247,,,,6,6,12
HND-011182,2011,130900249,,,,10,3,13
HND-011138,2011,130900033,,,,9,3,12
HND-011139,2011,130900034,,,,6,9,15
HND-011147,2011,130900057,,,,4,5,9
,2011,130900064,,,,1,5,6
HND-011155,2011,130900109,,,,8,4,12
HND-011157,2011,130900111,,,,7,6,13
HND-011174,2011,130900212,,,,6,5,11
HND-011181,2011,130900248,,,,1,5,6
HND-011183,2011,130900250,,,,7,5,12
HND-011184,2011,130900251,,,,6,6,12
,2011,130900252,,,,2,5,7
,2011,130900254,,,,6,6,12
HND-011138,2011,130900033,,,,5,3,8
HND-011147,2011,130900057,,,,9,7,16
,2011,130900064,,,,4,5,9
HND-011155,2011,130900109,,,,8,3,11
HND-011157,2011,130900111,,,,10,11,21
,2011,130900246,,,,15,13,28
HND-011180,2011,130900247,,,,14,15,29
HND-011181,2011,130900248,,,,7,4,11
HND-011182,2011,130900249,,,,6,2,8
HND-011139,2011,130900034,,,,10,11,21
HND-011146,2011,130900055,,,,17,11,28
HND-011156,2011,130900110,,,,8,12,20
,2011,130900147,,,,11,10,21
HND-011166,2011,130900148,,,,4,3,7
,2011,130900209,,,,7,6,13
HND-011172,2011,130900210,,,,13,5,18
HND-011173,2011,130900211,,,,2,4,6
HND-011174,2011,130900212,,,,5,7,12
HND-011175,2011,130900213,,,,1,7,8
HND-011176,2011,130900214,,,,8,12,20
HND-011183,2011,130900250,,,,16,9,25
HND-011184,2011,130900251,,,,17,19,36
,2011,130900252,,,,1,3,4
,2011,130900254,,,,17,19,36
HND-011107,2011,130900001,,,,37,25,62
HND-011109,2011,130900003,,,,14,14,28
HND-011110,2011,130900004,,,,14,20,34
HND-011112,2011,130900006,,,,21,29,50
HND-011113,2011,130900007,,,,11,17,28
HND-011114,2011,130900008,,,,5,5,10
HND-011116,2011,130900010,,,,2,5,7
HND-011117,2011,130900011,,,,9,10,19
HND-011118,2011,130900012,,,,14,11,25
HND-011119,2011,130900014,,,,10,8,18
HND-011122,2011,130900017,,,,20,14,34
HND-011123,2011,130900018,,,,11,10,21
HND-011126,2011,130900021,,,,15,17,32
HND-011128,2011,130900023,,,,20,19,39
HND-011129,2011,130900024,,,,1,1,2
HND-011131,2011,130900026,,,,5,5,10
HND-011132,2011,130900027,,,,16,11,27
HND-011135,2011,130900030,,,,10,16,26
HND-011136,2011,130900031,,,,10,7,17
HND-011137,2011,130900032,,,,6,13,19
HND-011141,2011,130900047,,,,12,10,22
HND-011149,2011,130900059,,,,10,7,17
HND-011163,2011,130900144,,,,10,6,16
HND-011165,2011,130900146,,,,12,13,25
HND-011108,2011,130900002,,,,14,8,22
HND-011111,2011,130900005,,,,9,13,22
HND-011115,2011,130900009,,,,29,24,53
HND-011120,2011,130900015,,,,21,11,32
HND-011121,2011,130900016,,,,14,6,20
HND-011124,2011,130900019,,,,18,14,32
HND-011125,2011,130900020,,,,4,3,7
HND-011127,2011,130900022,,,,9,8,17
HND-011130,2011,130900025,,,,15,11,26
HND-011133,2011,130900028,,,,2,5,7
HND-011134,2011,130900029,,,,12,2,14
HND-011148,2011,130900058,,,,13,10,23
HND-011150,2011,130900060,,,,6,7,13
HND-011151,2011,130900061,,,,15,10,25
HND-011152,2011,130900062,,,,5,7,12
HND-011153,2011,130900063,,,,6,9,15
HND-011154,2011,130900107,,,,16,10,26
HND-011162,2011,130900143,,,,5,4,9
HND-011164,2011,130900145,,,,5,9,14
HND-011171,2011,130900208,,,,10,15,25
HND-011108,2011,130900002,,,,6,5,11
HND-011109,2011,130900003,,,,11,8,19
HND-011112,2011,130900006,,,,31,37,68
HND-011113,2011,130900007,,,,16,9,25
HND-011115,2011,130900009,,,,29,17,46
HND-011117,2011,130900011,,,,4,8,12
HND-011121,2011,130900016,,,,4,5,9
HND-011122,2011,130900017,,,,15,4,19
HND-011124,2011,130900019,,,,16,17,33
HND-011130,2011,130900025,,,,12,13,25
HND-011131,2011,130900026,,,,4,2,6
HND-011134,2011,130900029,,,,7,6,13
HND-011137,2011,130900032,,,,10,5,15
HND-011150,2011,130900060,,,,3,7,10
HND-011152,2011,130900062,,,,6,7,13
HND-011164,2011,130900145,,,,9,5,14
HND-011107,2011,130900001,,,,26,24,50
HND-011110,2011,130900004,,,,17,15,32
HND-011111,2011,130900005,,,,6,9,15
HND-011114,2011,130900008,,,,6,1,7
HND-011116,2011,130900010,,,,5,1,6
HND-011118,2011,130900012,,,,4,9,13
HND-011119,2011,130900014,,,,3,9,12
HND-011120,2011,130900015,,,,21,10,31
HND-011123,2011,130900018,,,,12,8,20
HND-011125,2011,130900020,,,,4,3,7
HND-011126,2011,130900021,,,,11,14,25
HND-011127,2011,130900022,,,,4,11,15
HND-011128,2011,130900023,,,,10,15,25
HND-011129,2011,130900024,,,,1,2,3
HND-011132,2011,130900027,,,,6,12,18
HND-011133,2011,130900028,,,,1,2,3
HND-011135,2011,130900030,,,,21,12,33
HND-011136,2011,130900031,,,,4,7,11
HND-011141,2011,130900047,,,,9,9,18
HND-011148,2011,130900058,,,,5,7,12
HND-011149,2011,130900059,,,,5,6,11
HND-011151,2011,130900061,,,,11,10,21
HND-011153,2011,130900063,,,,5,9,14
HND-011154,2011,130900107,,,,19,10,29
HND-011162,2011,130900143,,,,9,6,15
HND-011163,2011,130900144,,,,9,5,14
HND-011165,2011,130900146,,,,10,7,17
HND-011171,2011,130900208,,,,6,10,16
HND-011108,2011,130900002,,,,7,9,16
HND-011111,2011,130900005,,,,9,8,17
HND-011112,2011,130900006,,,,18,18,36
HND-011115,2011,130900009,,,,38,29,67
HND-011120,2011,130900015,,,,21,15,36
HND-011121,2011,130900016,,,,13,7,20
HND-011124,2011,130900019,,,,17,14,31
HND-011127,2011,130900022,,,,5,6,11
HND-011130,2011,130900025,,,,10,3,13
HND-011133,2011,130900028,,,,1,1,2
HND-011134,2011,130900029,,,,6,7,13
HND-011135,2011,130900030,,,,21,17,38
HND-011137,2011,130900032,,,,8,9,17
HND-011141,2011,130900047,,,,9,9,18
HND-011149,2011,130900059,,,,5,9,14
HND-011150,2011,130900060,,,,8,5,13
HND-011151,2011,130900061,,,,5,8,13
HND-011152,2011,130900062,,,,4,3,7
HND-011154,2011,130900107,,,,7,15,22
HND-011164,2011,130900145,,,,6,9,15
HND-011171,2011,130900208,,,,8,13,21
HND-011107,2011,130900001,,,,24,12,36
HND-011109,2011,130900003,,,,16,15,31
HND-011110,2011,130900004,,,,21,7,28
HND-011113,2011,130900007,,,,12,19,31
HND-011114,2011,130900008,,,,2,3,5
HND-011116,2011,130900010,,,,3,4,7
HND-011117,2011,130900011,,,,12,3,15
HND-011118,2011,130900012,,,,7,6,13
HND-011119,2011,130900014,,,,4,5,9
HND-011122,2011,130900017,,,,10,4,14
HND-011123,2011,130900018,,,,9,2,11
HND-011125,2011,130900020,,,,6,4,10
HND-011126,2011,130900021,,,,13,13,26
HND-011128,2011,130900023,,,,16,9,25
HND-011129,2011,130900024,,,,3,2,5
HND-011131,2011,130900026,,,,2,5,7
HND-011132,2011,130900027,,,,14,14,28
HND-011136,2011,130900031,,,,6,10,16
HND-011148,2011,130900058,,,,1,7,8
HND-011153,2011,130900063,,,,5,4,9
HND-011162,2011,130900143,,,,6,8,14
HND-011163,2011,130900144,,,,9,12,21
HND-011165,2011,130900146,,,,14,5,19
HND-011107,2011,130900001,,,,24,22,46
HND-011108,2011,130900002,,,,11,5,16
HND-011109,2011,130900003,,,,9,13,22
HND-011112,2011,130900006,,,,20,15,35
HND-011113,2011,130900007,,,,10,10,20
HND-011115,2011,130900009,,,,24,20,44
HND-011116,2011,130900010,,,,7,1,8
HND-011117,2011,130900011,,,,5,6,11
HND-011119,2011,130900014,,,,3,7,10
HND-011121,2011,130900016,,,,9,7,16
HND-011122,2011,130900017,,,,7,12,19
HND-011128,2011,130900023,,,,7,12,19
HND-011131,2011,130900026,,,,5,3,8
HND-011132,2011,130900027,,,,8,11,19
HND-011134,2011,130900029,,,,7,6,13
HND-011148,2011,130900058,,,,11,9,20
HND-011152,2011,130900062,,,,6,8,14
HND-011162,2011,130900143,,,,8,6,14
HND-011163,2011,130900144,,,,5,7,12
HND-011164,2011,130900145,,,,5,16,21
HND-011165,2011,130900146,,,,8,12,20
HND-011110,2011,130900004,,,,21,19,40
HND-011111,2011,130900005,,,,5,10,15
HND-011114,2011,130900008,,,,5,2,7
HND-011118,2011,130900012,,,,1,6,7
HND-011120,2011,130900015,,,,9,16,25
HND-011123,2011,130900018,,,,12,5,17
HND-011124,2011,130900019,,,,8,10,18
HND-011125,2011,130900020,,,,1,2,3
HND-011126,2011,130900021,,,,10,10,20
HND-011127,2011,130900022,,,,8,9,17
HND-011129,2011,130900024,,,,2,2,4
HND-011130,2011,130900025,,,,14,11,25
HND-011133,2011,130900028,,,,2,6,8
HND-011135,2011,130900030,,,,6,5,11
HND-011136,2011,130900031,,,,7,6,13
HND-011137,2011,130900032,,,,1,5,6
HND-011141,2011,130900047,,,,9,9,18
HND-011149,2011,130900059,,,,3,4,7
HND-011150,2011,130900060,,,,4,3,7
HND-011151,2011,130900061,,,,10,3,13
HND-011153,2011,130900063,,,,7,9,16
HND-011154,2011,130900107,,,,9,9,18
HND-011171,2011,130900208,,,,8,5,13
HND-011107,2011,130900001,,,,27,12,39
HND-011108,2011,130900002,,,,13,7,20
HND-011109,2011,130900003,,,,10,10,20
HND-011110,2011,130900004,,,,21,19,40
HND-011112,2011,130900006,,,,6,9,15
HND-011113,2011,130900007,,,,10,14,24
HND-011116,2011,130900010,,,,1,3,4
HND-011117,2011,130900011,,,,2,4,6
HND-011118,2011,130900012,,,,3,0,3
HND-011119,2011,130900014,,,,3,5,8
HND-011122,2011,130900017,,,,9,7,16
HND-011123,2011,130900018,,,,3,2,5
HND-011126,2011,130900021,,,,12,14,26
HND-011128,2011,130900023,,,,9,7,16
HND-011131,2011,130900026,,,,2,3,5
HND-011132,2011,130900027,,,,16,10,26
HND-011134,2011,130900029,,,,7,6,13
HND-011148,2011,130900058,,,,12,7,19
HND-011152,2011,130900062,,,,4,5,9
HND-011162,2011,130900143,,,,1,3,4
HND-011163,2011,130900144,,,,7,11,18
HND-011164,2011,130900145,,,,6,4,10
HND-011111,2011,130900005,,,,7,6,13
HND-011114,2011,130900008,,,,1,2,3
HND-011115,2011,130900009,,,,14,18,32
HND-011120,2011,130900015,,,,5,7,12
HND-011121,2011,130900016,,,,6,2,8
HND-011124,2011,130900019,,,,3,5,8
HND-011125,2011,130900020,,,,6,2,8
HND-011127,2011,130900022,,,,5,4,9
HND-011129,2011,130900024,,,,1,1,2
HND-011130,2011,130900025,,,,9,8,17
HND-011133,2011,130900028,,,,1,5,6
HND-011135,2011,130900030,,,,8,10,18
HND-011136,2011,130900031,,,,6,6,12
HND-011137,2011,130900032,,,,7,1,8
HND-011141,2011,130900047,,,,3,5,8
HND-011149,2011,130900059,,,,4,1,5
HND-011150,2011,130900060,,,,1,0,1
HND-011151,2011,130900061,,,,6,3,9
HND-011153,2011,130900063,,,,3,5,8
HND-011154,2011,130900107,,,,6,5,11
HND-011165,2011,130900146,,,,8,7,15
HND-011171,2011,130900208,,,,3,6,9
HND-011107,2011,130900001,,,,7,11,18
HND-011110,2011,130900004,,,,13,13,26
HND-011111,2011,130900005,,,,16,4,20
HND-011114,2011,130900008,,,,2,1,3
HND-011116,2011,130900010,,,,3,6,9
HND-011118,2011,130900012,,,,0,2,2
HND-011119,2011,130900014,,,,4,1,5
HND-011120,2011,130900015,,,,6,10,16
HND-011123,2011,130900018,,,,7,4,11
HND-011125,2011,130900020,,,,1,2,3
HND-011126,2011,130900021,,,,11,7,18
HND-011127,2011,130900022,,,,2,3,5
HND-011128,2011,130900023,,,,4,9,13
HND-011129,2011,130900024,,,,1,3,4
HND-011132,2011,130900027,,,,4,6,10
HND-011133,2011,130900028,,,,5,1,6
HND-011135,2011,130900030,,,,3,5,8
HND-011136,2011,130900031,,,,6,4,10
HND-011141,2011,130900047,,,,1,1,2
HND-011148,2011,130900058,,,,3,8,11
HND-011149,2011,130900059,,,,1,4,5
HND-011151,2011,130900061,,,,3,4,7
HND-011153,2011,130900063,,,,6,8,14
HND-011154,2011,130900107,,,,8,4,12
HND-011164,2011,130900145,,,,2,7,9
HND-011108,2011,130900002,,,,5,9,14
HND-011109,2011,130900003,,,,8,10,18
HND-011112,2011,130900006,,,,5,6,11
HND-011113,2011,130900007,,,,9,12,21
HND-011115,2011,130900009,,,,17,15,32
HND-011117,2011,130900011,,,,5,4,9
HND-011121,2011,130900016,,,,3,8,11
HND-011122,2011,130900017,,,,3,1,4
HND-011124,2011,130900019,,,,6,4,10
HND-011130,2011,130900025,,,,2,6,8
HND-011131,2011,130900026,,,,2,3,5
HND-011134,2011,130900029,,,,5,6,11
HND-011137,2011,130900032,,,,4,5,9
HND-011150,2011,130900060,,,,5,5,10
HND-011152,2011,130900062,,,,3,1,4
HND-011162,2011,130900143,,,,3,2,5
HND-011163,2011,130900144,,,,2,4,6
HND-011165,2011,130900146,,,,7,4,11
HND-011171,2011,130900208,,,,5,3,8
HND-011107,2011,130900001,,,,2,7,9
HND-011110,2011,130900004,,,,2,6,8
HND-011112,2011,130900006,,,,13,20,33
HND-011113,2011,130900007,,,,5,15,20
HND-011108,2011,130900002,,,,9,17,26
HND-011120,2011,130900015,,,,7,9,16
HND-011108,2011,130900002,,,,6,7,13
HND-011112,2011,130900006,,,,9,12,21
HND-011113,2011,130900007,,,,9,9,18
HND-011107,2011,130900001,,,,4,8,12
HND-011110,2011,130900004,,,,8,6,14
HND-011120,2011,130900015,,,,19,1,20
HND-011107,2011,130900001,,,,5,8,13
HND-011108,2011,130900002,,,,8,15,23
HND-011112,2011,130900006,,,,4,7,11
HND-011113,2011,130900007,,,,6,8,14
HND-011110,2011,130900004,,,,5,4,9
HND-011120,2011,130900015,,,,10,5,15
HND-011108,2011,130900002,,,,7,5,12
HND-011108,2011,130900002,,,,0,5,5
HND-011108,2011,130900002,,,,10,3,13
HND-011218,2011,131000036,,,,4,6,10
,2011,131000035,,,,4,6,10
,2011,131000071,,,,4,2,6
HND-011227,2011,131000072,,,,10,7,17
,2011,131000074,,,,4,2,6
,2011,131000075,,,,5,2,7
,2011,131000076,,,,5,2,7
,2011,131000077,,,,3,7,10
HND-011204,2011,131000018,,,,0,1,1
HND-011206,2011,131000020,,,,9,7,16
,2011,131000021,,,,2,0,2
HND-011214,2011,131000029,,,,1,0,1
HND-011215,2011,131000031,,,,2,0,2
HND-011216,2011,131000032,,,,4,3,7
,2011,131000045,,,,0,1,1
HND-011221,2011,131000047,,,,4,1,5
HND-011222,2011,131000048,,,,4,1,5
HND-011209,2011,131000024,,,,2,5,7
,2011,131000039,,,,1,1,2
HND-011204,2011,131000018,,,,0,2,2
HND-011205,2011,131000019,,,,5,7,12
HND-011214,2011,131000029,,,,3,0,3
,2011,131000030,,,,11,8,19
HND-011215,2011,131000031,,,,2,3,5
,2011,131000039,,,,3,1,4
HND-011220,2011,131000044,,,,3,3,6
,2011,131000045,,,,2,3,5
HND-011221,2011,131000047,,,,0,1,1
HND-011222,2011,131000048,,,,0,5,5
HND-011202,2011,131000015,,,,13,8,21
HND-011206,2011,131000020,,,,7,8,15
,2011,131000021,,,,0,3,3
HND-011209,2011,131000024,,,,1,0,1
HND-011216,2011,131000032,,,,2,1,3
HND-011223,2011,131000061,,,,4,6,10
HND-011206,2011,131000020,,,,11,7,18
,2011,131000021,,,,2,3,5
HND-011209,2011,131000024,,,,2,0,2
HND-011202,2011,131000015,,,,7,11,18
HND-011204,2011,131000018,,,,7,10,17
HND-011205,2011,131000019,,,,7,11,18
HND-011214,2011,131000029,,,,1,5,6
,2011,131000030,,,,18,12,30
HND-011215,2011,131000031,,,,4,3,7
HND-011216,2011,131000032,,,,1,3,4
,2011,131000039,,,,2,2,4
HND-011220,2011,131000044,,,,4,6,10
,2011,131000045,,,,2,2,4
HND-011221,2011,131000047,,,,2,1,3
HND-011222,2011,131000048,,,,5,2,7
HND-011223,2011,131000061,,,,4,5,9
HND-011189,2011,131000002,,,,17,10,27
HND-011190,2011,131000003,,,,7,7,14
HND-011191,2011,131000004,,,,13,10,23
HND-011192,2011,131000005,,,,9,2,11
HND-011194,2011,131000007,,,,6,2,8
HND-011195,2011,131000008,,,,12,5,17
HND-011199,2011,131000012,,,,13,9,22
,2011,131000013,,,,3,2,5
HND-011201,2011,131000014,,,,5,6,11
HND-011208,2011,131000023,,,,12,5,17
HND-011210,2011,131000025,,,,3,4,7
HND-011212,2011,131000027,,,,5,5,10
HND-011213,2011,131000028,,,,3,4,7
HND-011224,2011,131000068,,,,1,1,2
HND-011225,2011,131000069,,,,2,2,4
HND-011188,2011,131000001,,,,14,13,27
HND-011193,2011,131000006,,,,5,4,9
HND-011196,2011,131000009,,,,6,2,8
HND-011197,2011,131000010,,,,5,2,7
HND-011198,2011,131000011,,,,2,4,6
HND-011207,2011,131000022,,,,3,2,5
HND-011209,2011,131000024,,,,4,3,7
HND-011211,2011,131000026,,,,4,2,6
HND-011217,2011,131000033,,,,6,2,8
HND-011226,2011,131000070,,,,7,7,14
HND-011188,2011,131000001,,,,21,14,35
HND-011191,2011,131000004,,,,8,6,14
HND-011193,2011,131000006,,,,10,5,15
HND-011197,2011,131000010,,,,4,2,6
HND-011198,2011,131000011,,,,3,6,9
HND-011199,2011,131000012,,,,7,6,13
,2011,131000013,,,,4,0,4
HND-011201,2011,131000014,,,,5,3,8
HND-011207,2011,131000022,,,,5,3,8
HND-011208,2011,131000023,,,,1,0,1
HND-011209,2011,131000024,,,,2,3,5
HND-011210,2011,131000025,,,,2,0,2
HND-011211,2011,131000026,,,,0,2,2
HND-011212,2011,131000027,,,,3,0,3
HND-011217,2011,131000033,,,,1,6,7
HND-011224,2011,131000068,,,,1,1,2
HND-011226,2011,131000070,,,,3,2,5
HND-011189,2011,131000002,,,,16,14,30
HND-011190,2011,131000003,,,,12,6,18
HND-011192,2011,131000005,,,,9,6,15
HND-011194,2011,131000007,,,,2,4,6
HND-011195,2011,131000008,,,,10,8,18
HND-011196,2011,131000009,,,,4,2,6
HND-011213,2011,131000028,,,,7,2,9
HND-011225,2011,131000069,,,,1,0,1
HND-011188,2011,131000001,,,,13,20,33
HND-011193,2011,131000006,,,,18,8,26
HND-011196,2011,131000009,,,,1,4,5
HND-011197,2011,131000010,,,,3,3,6
HND-011198,2011,131000011,,,,3,5,8
HND-011207,2011,131000022,,,,3,1,4
HND-011209,2011,131000024,,,,1,2,3
HND-011211,2011,131000026,,,,2,1,3
HND-011217,2011,131000033,,,,0,4,4
HND-011226,2011,131000070,,,,7,0,7
HND-011189,2011,131000002,,,,22,11,33
HND-011190,2011,131000003,,,,9,14,23
HND-011191,2011,131000004,,,,7,12,19
HND-011192,2011,131000005,,,,6,5,11
HND-011194,2011,131000007,,,,10,4,14
HND-011195,2011,131000008,,,,9,7,16
HND-011199,2011,131000012,,,,2,12,14
,2011,131000013,,,,5,6,11
HND-011201,2011,131000014,,,,9,10,19
HND-011208,2011,131000023,,,,3,3,6
HND-011210,2011,131000025,,,,3,2,5
HND-011212,2011,131000027,,,,2,4,6
HND-011213,2011,131000028,,,,4,4,8
HND-011224,2011,131000068,,,,1,0,1
HND-011225,2011,131000069,,,,3,0,3
HND-011188,2011,131000001,,,,15,28,43
HND-011190,2011,131000003,,,,10,5,15
HND-011191,2011,131000004,,,,7,15,22
HND-011192,2011,131000005,,,,5,5,10
HND-011193,2011,131000006,,,,12,10,22
HND-011194,2011,131000007,,,,6,1,7
HND-011197,2011,131000010,,,,2,3,5
HND-011198,2011,131000011,,,,0,3,3
HND-011199,2011,131000012,,,,7,0,7
,2011,131000013,,,,2,1,3
HND-011201,2011,131000014,,,,1,10,11
HND-011207,2011,131000022,,,,4,5,9
HND-011208,2011,131000023,,,,3,2,5
HND-011209,2011,131000024,,,,2,2,4
HND-011210,2011,131000025,,,,3,2,5
HND-011212,2011,131000027,,,,4,3,7
HND-011213,2011,131000028,,,,7,2,9
HND-011224,2011,131000068,,,,1,3,4
HND-011189,2011,131000002,,,,12,12,24
HND-011195,2011,131000008,,,,4,12,16
HND-011211,2011,131000026,,,,5,4,9
HND-011217,2011,131000033,,,,2,1,3
HND-011225,2011,131000069,,,,3,4,7
HND-011226,2011,131000070,,,,5,3,8
HND-011190,2011,131000003,,,,10,7,17
HND-011191,2011,131000004,,,,3,8,11
HND-011192,2011,131000005,,,,5,4,9
HND-011194,2011,131000007,,,,4,5,9
HND-011199,2011,131000012,,,,5,4,9
,2011,131000013,,,,0,5,5
HND-011201,2011,131000014,,,,5,7,12
HND-011207,2011,131000022,,,,0,2,2
HND-011208,2011,131000023,,,,5,7,12
HND-011209,2011,131000024,,,,2,3,5
HND-011210,2011,131000025,,,,2,2,4
HND-011212,2011,131000027,,,,5,0,5
HND-011213,2011,131000028,,,,6,1,7
HND-011224,2011,131000068,,,,0,2,2
HND-011225,2011,131000069,,,,3,1,4
HND-011188,2011,131000001,,,,20,25,45
HND-011189,2011,131000002,,,,18,15,33
HND-011193,2011,131000006,,,,7,15,22
HND-011195,2011,131000008,,,,7,7,14
HND-011196,2011,131000009,,,,1,4,5
HND-011197,2011,131000010,,,,5,6,11
HND-011198,2011,131000011,,,,4,2,6
HND-011211,2011,131000026,,,,2,2,4
HND-011217,2011,131000033,,,,1,3,4
HND-011226,2011,131000070,,,,2,3,5
HND-011189,2011,131000002,,,,11,20,31
HND-011190,2011,131000003,,,,7,6,13
HND-011192,2011,131000005,,,,5,7,12
HND-011194,2011,131000007,,,,2,3,5
HND-011195,2011,131000008,,,,9,10,19
HND-011196,2011,131000009,,,,2,1,3
HND-011213,2011,131000028,,,,3,4,7
HND-011217,2011,131000033,,,,1,1,2
HND-011225,2011,131000069,,,,1,1,2
HND-011226,2011,131000070,,,,3,4,7
HND-011188,2011,131000001,,,,16,18,34
HND-011191,2011,131000004,,,,3,12,15
HND-011193,2011,131000006,,,,6,7,13
HND-011197,2011,131000010,,,,4,1,5
HND-011198,2011,131000011,,,,3,4,7
HND-011199,2011,131000012,,,,2,5,7
,2011,131000013,,,,5,1,6
HND-011201,2011,131000014,,,,3,1,4
HND-011207,2011,131000022,,,,0,2,2
HND-011208,2011,131000023,,,,2,6,8
HND-011209,2011,131000024,,,,0,1,1
HND-011210,2011,131000025,,,,6,2,8
HND-011211,2011,131000026,,,,3,0,3
HND-011212,2011,131000027,,,,3,0,3
HND-011224,2011,131000068,,,,1,0,1
HND-011192,2011,131000005,,,,4,8,12
HND-011188,2011,131000001,,,,13,15,28
HND-011203,2011,131000016,,,,44,44,88
HND-011188,2011,131000001,,,,4,8,12
HND-011203,2011,131000016,,,,45,31,76
HND-011192,2011,131000005,,,,3,2,5
HND-011188,2011,131000001,,,,4,4,8
HND-011192,2011,131000005,,,,6,3,9
HND-011203,2011,131000016,,,,39,36,75
HND-011203,2011,131000016,,,,17,33,50
HND-011203,2011,131000016,,,,24,26,50
HND-011203,2011,131000016,,,,17,15,32
HND-011256,2011,131100053,,,,11,10,21
HND-011271,2011,131100110,,,,6,5,11
HND-011257,2011,131100058,,,,11,14,25
HND-011259,2011,131100060,,,,11,13,24
HND-011244,2011,131100016,,,,0,1,1
HND-011255,2011,131100052,,,,2,1,3
HND-011272,2011,131100111,,,,6,2,8
HND-011245,2011,131100017,,,,1,6,7
HND-011252,2011,131100036,,,,6,3,9
,2011,131100049,,,,4,3,7
HND-011254,2011,131100050,,,,1,2,3
,2011,131100051,,,,4,3,7
HND-011258,2011,131100059,,,,2,1,3
HND-011267,2011,131100071,,,,1,1,2
,2011,131100094,,,,0,3,3
HND-011246,2011,131100018,,,,6,3,9
HND-011248,2011,131100020,,,,6,9,15
HND-011254,2011,131100050,,,,4,3,7
,2011,131100051,,,,3,1,4
HND-011255,2011,131100052,,,,7,4,11
HND-011260,2011,131100063,,,,6,11,17
HND-011244,2011,131100016,,,,5,3,8
HND-011245,2011,131100017,,,,16,15,31
HND-011251,2011,131100023,,,,0,8,8
HND-011252,2011,131100036,,,,4,5,9
,2011,131100049,,,,2,2,4
HND-011258,2011,131100059,,,,6,7,13
HND-011267,2011,131100071,,,,3,3,6
,2011,131100094,,,,3,3,6
HND-011268,2011,131100096,,,,5,9,14
HND-011272,2011,131100111,,,,3,2,5
HND-011244,2011,131100016,,,,11,12,23
HND-011251,2011,131100023,,,,11,10,21
HND-011252,2011,131100036,,,,6,3,9
,2011,131100049,,,,3,3,6
HND-011254,2011,131100050,,,,6,2,8
,2011,131100051,,,,5,7,12
HND-011258,2011,131100059,,,,6,6,12
HND-011267,2011,131100071,,,,5,3,8
,2011,131100094,,,,6,0,6
HND-011268,2011,131100096,,,,7,9,16
HND-011245,2011,131100017,,,,35,27,62
HND-011246,2011,131100018,,,,13,11,24
HND-011248,2011,131100020,,,,4,8,12
HND-011255,2011,131100052,,,,9,11,20
HND-011260,2011,131100063,,,,5,5,10
HND-011272,2011,131100111,,,,1,1,2
HND-011234,2011,131100006,,,,22,17,39
HND-011237,2011,131100009,,,,3,4,7
HND-011240,2011,131100012,,,,8,2,10
HND-011241,2011,131100013,,,,6,3,9
HND-011242,2011,131100014,,,,3,3,6
HND-011243,2011,131100015,,,,8,13,21
HND-011249,2011,131100021,,,,2,0,2
HND-011250,2011,131100022,,,,11,4,15
HND-011253,2011,131100042,,,,12,8,20
HND-011261,2011,131100064,,,,9,5,14
HND-011262,2011,131100065,,,,8,4,12
HND-011263,2011,131100066,,,,6,1,7
HND-011264,2011,131100067,,,,4,4,8
,2011,131100070,,,,6,2,8
HND-011270,2011,131100109,,,,7,8,15
HND-011228,2011,131100001,,,,60,47,107
HND-011229,2011,131100002,,,,13,7,20
HND-011230,2011,131100003,,,,27,14,41
HND-011232,2011,131100004,,,,21,13,34
HND-011231,2011,131100004,,,,21,13,34
HND-011233,2011,131100005,,,,32,20,52
HND-011235,2011,131100007,,,,6,1,7
HND-011236,2011,131100008,,,,2,0,2
HND-011238,2011,131100010,,,,15,20,35
HND-011239,2011,131100011,,,,9,8,17
HND-011265,2011,131100068,,,,2,0,2
,2011,131100072,,,,8,4,12
HND-011269,2011,131100108,,,,7,5,12
HND-011273,2011,131100112,,,,2,4,6
HND-011236,2011,131100008,,,,4,5,9
HND-011237,2011,131100009,,,,14,7,21
HND-011238,2011,131100010,,,,7,13,20
HND-011239,2011,131100011,,,,4,6,10
HND-011240,2011,131100012,,,,4,3,7
HND-011242,2011,131100014,,,,4,4,8
HND-011263,2011,131100066,,,,7,6,13
,2011,131100070,,,,3,1,4
HND-011273,2011,131100112,,,,4,0,4
HND-011228,2011,131100001,,,,33,45,78
HND-011229,2011,131100002,,,,9,11,20
HND-011230,2011,131100003,,,,12,8,20
HND-011232,2011,131100004,,,,12,11,23
HND-011231,2011,131100004,,,,12,11,23
HND-011233,2011,131100005,,,,16,22,38
HND-011234,2011,131100006,,,,13,12,25
HND-011235,2011,131100007,,,,3,1,4
HND-011241,2011,131100013,,,,2,6,8
HND-011243,2011,131100015,,,,7,10,17
HND-011249,2011,131100021,,,,4,2,6
HND-011250,2011,131100022,,,,3,1,4
HND-011253,2011,131100042,,,,7,7,14
HND-011261,2011,131100064,,,,7,3,10
HND-011262,2011,131100065,,,,3,5,8
HND-011264,2011,131100067,,,,1,1,2
HND-011265,2011,131100068,,,,2,3,5
,2011,131100072,,,,8,10,18
HND-011269,2011,131100108,,,,4,8,12
HND-011270,2011,131100109,,,,2,3,5
HND-011228,2011,131100001,,,,39,25,64
HND-011230,2011,131100003,,,,7,13,20
HND-011233,2011,131100005,,,,6,9,15
HND-011235,2011,131100007,,,,4,9,13
HND-011236,2011,131100008,,,,2,4,6
HND-011238,2011,131100010,,,,0,2,2
HND-011239,2011,131100011,,,,6,5,11
HND-011263,2011,131100066,,,,5,2,7
HND-011265,2011,131100068,,,,1,1,2
,2011,131100072,,,,10,11,21
HND-011269,2011,131100108,,,,5,6,11
HND-011273,2011,131100112,,,,0,3,3
HND-011229,2011,131100002,,,,8,3,11
HND-011232,2011,131100004,,,,11,10,21
HND-011231,2011,131100004,,,,11,10,21
HND-011234,2011,131100006,,,,18,13,31
HND-011237,2011,131100009,,,,4,9,13
HND-011240,2011,131100012,,,,8,5,13
HND-011241,2011,131100013,,,,2,2,4
HND-011242,2011,131100014,,,,4,4,8
HND-011243,2011,131100015,,,,8,9,17
HND-011249,2011,131100021,,,,4,2,6
HND-011250,2011,131100022,,,,2,1,3
HND-011253,2011,131100042,,,,7,6,13
HND-011261,2011,131100064,,,,6,5,11
HND-011262,2011,131100065,,,,2,0,2
HND-011264,2011,131100067,,,,2,3,5
,2011,131100070,,,,1,1,2
HND-011270,2011,131100109,,,,0,3,3
HND-011234,2011,131100006,,,,12,10,22
HND-011236,2011,131100008,,,,5,2,7
HND-011237,2011,131100009,,,,3,5,8
HND-011238,2011,131100010,,,,0,7,7
HND-011239,2011,131100011,,,,7,3,10
HND-011240,2011,131100012,,,,5,6,11
HND-011241,2011,131100013,,,,1,0,1
HND-011242,2011,131100014,,,,3,6,9
HND-011249,2011,131100021,,,,4,6,10
HND-011261,2011,131100064,,,,3,3,6
HND-011263,2011,131100066,,,,1,3,4
,2011,131100070,,,,0,2,2
HND-011270,2011,131100109,,,,2,6,8
HND-011228,2011,131100001,,,,35,26,61
HND-011229,2011,131100002,,,,13,2,15
HND-011230,2011,131100003,,,,7,11,18
HND-011232,2011,131100004,,,,20,13,33
HND-011231,2011,131100004,,,,20,13,33
HND-011233,2011,131100005,,,,7,3,10
HND-011235,2011,131100007,,,,3,6,9
HND-011243,2011,131100015,,,,7,8,15
HND-011250,2011,131100022,,,,4,5,9
HND-011253,2011,131100042,,,,3,3,6
HND-011262,2011,131100065,,,,1,5,6
HND-011264,2011,131100067,,,,0,1,1
HND-011265,2011,131100068,,,,3,2,5
,2011,131100072,,,,15,12,27
HND-011269,2011,131100108,,,,1,0,1
HND-011273,2011,131100112,,,,1,0,1
HND-011234,2011,131100006,,,,9,14,23
HND-011237,2011,131100009,,,,8,12,20
HND-011239,2011,131100011,,,,3,5,8
HND-011240,2011,131100012,,,,5,2,7
HND-011241,2011,131100013,,,,4,0,4
HND-011242,2011,131100014,,,,2,1,3
HND-011243,2011,131100015,,,,4,7,11
HND-011249,2011,131100021,,,,3,1,4
HND-011253,2011,131100042,,,,3,4,7
HND-011261,2011,131100064,,,,2,0,2
HND-011263,2011,131100066,,,,0,4,4
HND-011264,2011,131100067,,,,1,4,5
HND-011228,2011,131100001,,,,49,46,95
HND-011229,2011,131100002,,,,5,6,11
HND-011230,2011,131100003,,,,6,10,16
HND-011232,2011,131100004,,,,7,8,15
HND-011231,2011,131100004,,,,7,8,15
HND-011233,2011,131100005,,,,3,4,7
HND-011235,2011,131100007,,,,2,2,4
HND-011236,2011,131100008,,,,3,3,6
HND-011250,2011,131100022,,,,3,2,5
HND-011262,2011,131100065,,,,3,1,4
HND-011265,2011,131100068,,,,0,4,4
,2011,131100072,,,,11,6,17
HND-011269,2011,131100108,,,,2,1,3
HND-011270,2011,131100109,,,,4,2,6
HND-011273,2011,131100112,,,,3,3,6
HND-011228,2011,131100001,,,,22,45,67
HND-011229,2011,131100002,,,,5,3,8
HND-011230,2011,131100003,,,,7,11,18
HND-011232,2011,131100004,,,,12,10,22
HND-011231,2011,131100004,,,,12,10,22
HND-011234,2011,131100006,,,,14,10,24
HND-011235,2011,131100007,,,,5,2,7
HND-011241,2011,131100013,,,,1,0,1
HND-011243,2011,131100015,,,,4,5,9
HND-011249,2011,131100021,,,,2,1,3
HND-011250,2011,131100022,,,,0,3,3
HND-011253,2011,131100042,,,,1,4,5
HND-011261,2011,131100064,,,,1,2,3
HND-011262,2011,131100065,,,,2,1,3
HND-011264,2011,131100067,,,,2,0,2
HND-011265,2011,131100068,,,,0,2,2
,2011,131100072,,,,9,8,17
HND-011273,2011,131100112,,,,1,6,7
HND-011233,2011,131100005,,,,5,2,7
HND-011236,2011,131100008,,,,3,2,5
HND-011237,2011,131100009,,,,9,0,9
HND-011239,2011,131100011,,,,3,4,7
HND-011240,2011,131100012,,,,6,5,11
HND-011242,2011,131100014,,,,3,3,6
HND-011263,2011,131100066,,,,3,2,5
HND-011269,2011,131100108,,,,2,1,3
HND-011270,2011,131100109,,,,1,1,2
HND-011234,2011,131100006,,,,14,17,31
HND-011232,2011,131100004,,,,8,6,14
HND-011231,2011,131100004,,,,8,6,14
HND-011247,2011,131100019,,,,53,37,90
,2011,131100072,,,,6,10,16
HND-011247,2011,131100019,,,,38,28,66
HND-011232,2011,131100004,,,,5,6,11
HND-011231,2011,131100004,,,,5,6,11
HND-011234,2011,131100006,,,,12,9,21
,2011,131100072,,,,3,6,9
HND-011234,2011,131100006,,,,6,10,16
HND-011247,2011,131100019,,,,43,23,66
,2011,131100072,,,,14,15,29
HND-011247,2011,131100019,,,,25,30,55
HND-011247,2011,131100019,,,,12,12,24
HND-011247,2011,131100019,,,,26,17,43
HND-011305,2011,131200042,,,,3,3,6
HND-011306,2011,131200043,,,,4,3,7
HND-011307,2011,131200044,,,,1,4,5
HND-011315,2011,131200059,,,,1,4,5
,2011,131200049,,,,2,3,5
HND-011309,2011,131200050,,,,3,2,5
HND-011310,2011,131200051,,,,3,2,5
HND-011311,2011,131200052,,,,4,1,5
,2011,131200053,,,,3,2,5
HND-011312,2011,131200056,,,,3,3,6
HND-011313,2011,131200057,,,,4,1,5
,2011,131200060,,,,3,3,6
,2011,131200016,,,,6,1,7
HND-011290,2011,131200018,,,,12,12,24
HND-011308,2011,131200047,,,,0,1,1
,2011,131200048,,,,0,2,2
HND-011291,2011,131200019,,,,0,6,6
,2011,131200028,,,,1,1,2
HND-011300,2011,131200032,,,,3,0,3
HND-011301,2011,131200035,,,,1,1,2
,2011,131200046,,,,1,1,2
,2011,131200016,,,,2,2,4
HND-011290,2011,131200018,,,,5,12,17
HND-011291,2011,131200019,,,,1,6,7
HND-011294,2011,131200022,,,,2,3,5
,2011,131200046,,,,3,2,5
HND-011308,2011,131200047,,,,2,1,3
,2011,131200023,,,,9,5,14
,2011,131200028,,,,3,4,7
HND-011300,2011,131200032,,,,6,3,9
HND-011301,2011,131200035,,,,1,1,2
,2011,131200048,,,,4,2,6
,2011,131200028,,,,0,2,2
HND-011300,2011,131200032,,,,2,12,14
HND-011301,2011,131200035,,,,2,1,3
,2011,131200048,,,,2,2,4
,2011,131200016,,,,1,4,5
HND-011290,2011,131200018,,,,10,9,19
HND-011291,2011,131200019,,,,3,6,9
HND-011294,2011,131200022,,,,5,5,10
,2011,131200023,,,,4,4,8
,2011,131200040,,,,7,2,9
,2011,131200046,,,,2,3,5
HND-011308,2011,131200047,,,,3,3,6
HND-011274,2011,131200001,,,,22,20,42
HND-011276,2011,131200003,,,,5,5,10
HND-011278,2011,131200005,,,,6,7,13
HND-011280,2011,131200007,,,,5,1,6
HND-011281,2011,131200008,,,,3,5,8
HND-011282,2011,131200009,,,,2,2,4
HND-011293,2011,131200021,,,,2,2,4
HND-011297,2011,131200026,,,,3,2,5
HND-011298,2011,131200029,,,,2,1,3
HND-011303,2011,131200038,,,,1,2,3
HND-011304,2011,131200039,,,,8,2,10
HND-011275,2011,131200002,,,,4,3,7
HND-011277,2011,131200004,,,,6,5,11
HND-011279,2011,131200006,,,,13,9,22
HND-011283,2011,131200010,,,,2,4,6
HND-011284,2011,131200011,,,,5,5,10
HND-011285,2011,131200012,,,,4,2,6
HND-011286,2011,131200013,,,,8,3,11
HND-011287,2011,131200014,,,,9,10,19
HND-011288,2011,131200015,,,,1,2,3
HND-011289,2011,131200017,,,,3,1,4
HND-011295,2011,131200024,,,,6,2,8
HND-011296,2011,131200025,,,,4,5,9
HND-011299,2011,131200030,,,,1,2,3
HND-011302,2011,131200036,,,,4,1,5
HND-011274,2011,131200001,,,,8,15,23
HND-011275,2011,131200002,,,,0,3,3
HND-011276,2011,131200003,,,,4,2,6
HND-011277,2011,131200004,,,,2,3,5
HND-011278,2011,131200005,,,,5,6,11
HND-011280,2011,131200007,,,,9,6,15
HND-011285,2011,131200012,,,,3,3,6
HND-011286,2011,131200013,,,,18,12,30
HND-011287,2011,131200014,,,,10,11,21
HND-011289,2011,131200017,,,,6,0,6
HND-011296,2011,131200025,,,,3,3,6
HND-011298,2011,131200029,,,,1,1,2
HND-011279,2011,131200006,,,,14,12,26
HND-011281,2011,131200008,,,,2,2,4
HND-011282,2011,131200009,,,,2,0,2
HND-011283,2011,131200010,,,,2,2,4
HND-011284,2011,131200011,,,,2,2,4
HND-011293,2011,131200021,,,,2,0,2
HND-011295,2011,131200024,,,,1,2,3
HND-011297,2011,131200026,,,,1,1,2
HND-011299,2011,131200030,,,,2,0,2
HND-011302,2011,131200036,,,,1,3,4
HND-011303,2011,131200038,,,,1,2,3
HND-011304,2011,131200039,,,,4,2,6
HND-011275,2011,131200002,,,,4,0,4
HND-011276,2011,131200003,,,,7,5,12
HND-011277,2011,131200004,,,,3,2,5
HND-011279,2011,131200006,,,,13,8,21
HND-011285,2011,131200012,,,,6,0,6
HND-011286,2011,131200013,,,,8,9,17
HND-011287,2011,131200014,,,,10,14,24
HND-011288,2011,131200015,,,,1,1,2
HND-011289,2011,131200017,,,,3,3,6
HND-011296,2011,131200025,,,,1,1,2
HND-011299,2011,131200030,,,,0,4,4
HND-011302,2011,131200036,,,,7,2,9
HND-011274,2011,131200001,,,,13,14,27
HND-011278,2011,131200005,,,,3,7,10
HND-011280,2011,131200007,,,,0,10,10
HND-011281,2011,131200008,,,,5,1,6
HND-011282,2011,131200009,,,,1,3,4
HND-011283,2011,131200010,,,,1,3,4
HND-011284,2011,131200011,,,,7,5,12
HND-011293,2011,131200021,,,,4,5,9
HND-011295,2011,131200024,,,,2,3,5
HND-011297,2011,131200026,,,,3,0,3
HND-011298,2011,131200029,,,,3,0,3
HND-011303,2011,131200038,,,,2,1,3
HND-011304,2011,131200039,,,,3,2,5
HND-011274,2011,131200001,,,,22,13,35
HND-011275,2011,131200002,,,,4,4,8
HND-011276,2011,131200003,,,,3,8,11
HND-011277,2011,131200004,,,,0,4,4
HND-011278,2011,131200005,,,,5,6,11
HND-011280,2011,131200007,,,,5,5,10
HND-011281,2011,131200008,,,,0,4,4
HND-011286,2011,131200013,,,,7,9,16
HND-011288,2011,131200015,,,,2,3,5
HND-011289,2011,131200017,,,,2,5,7
HND-011297,2011,131200026,,,,1,1,2
HND-011298,2011,131200029,,,,0,1,1
HND-011303,2011,131200038,,,,1,3,4
HND-011279,2011,131200006,,,,10,7,17
HND-011282,2011,131200009,,,,2,2,4
HND-011283,2011,131200010,,,,6,3,9
HND-011284,2011,131200011,,,,3,2,5
HND-011285,2011,131200012,,,,6,1,7
HND-011287,2011,131200014,,,,14,5,19
HND-011293,2011,131200021,,,,1,5,6
HND-011295,2011,131200024,,,,2,0,2
HND-011296,2011,131200025,,,,1,4,5
HND-011299,2011,131200030,,,,2,0,2
HND-011302,2011,131200036,,,,3,1,4
HND-011304,2011,131200039,,,,2,2,4
HND-011275,2011,131200002,,,,0,3,3
HND-011277,2011,131200004,,,,4,3,7
HND-011279,2011,131200006,,,,6,6,12
HND-011282,2011,131200009,,,,2,1,3
HND-011283,2011,131200010,,,,2,1,3
HND-011284,2011,131200011,,,,7,3,10
HND-011285,2011,131200012,,,,3,3,6
HND-011286,2011,131200013,,,,9,9,18
HND-011287,2011,131200014,,,,9,6,15
HND-011288,2011,131200015,,,,1,5,6
HND-011289,2011,131200017,,,,1,1,2
HND-011295,2011,131200024,,,,1,0,1
HND-011296,2011,131200025,,,,1,2,3
HND-011303,2011,131200038,,,,2,3,5
HND-011274,2011,131200001,,,,21,23,44
HND-011276,2011,131200003,,,,11,6,17
HND-011278,2011,131200005,,,,4,4,8
HND-011280,2011,131200007,,,,2,8,10
HND-011281,2011,131200008,,,,3,4,7
HND-011293,2011,131200021,,,,2,2,4
HND-011298,2011,131200029,,,,0,2,2
HND-011299,2011,131200030,,,,0,1,1
HND-011302,2011,131200036,,,,1,0,1
HND-011304,2011,131200039,,,,1,0,1
HND-011274,2011,131200001,,,,18,13,31
HND-011275,2011,131200002,,,,3,1,4
HND-011276,2011,131200003,,,,5,5,10
HND-011277,2011,131200004,,,,1,4,5
HND-011278,2011,131200005,,,,3,5,8
HND-011280,2011,131200007,,,,4,3,7
HND-011285,2011,131200012,,,,2,3,5
HND-011286,2011,131200013,,,,10,7,17
HND-011287,2011,131200014,,,,15,3,18
HND-011289,2011,131200017,,,,3,1,4
HND-011296,2011,131200025,,,,2,2,4
HND-011298,2011,131200029,,,,2,2,4
HND-011299,2011,131200030,,,,2,0,2
HND-011302,2011,131200036,,,,1,2,3
HND-011303,2011,131200038,,,,1,0,1
HND-011279,2011,131200006,,,,4,3,7
HND-011281,2011,131200008,,,,1,1,2
HND-011282,2011,131200009,,,,2,0,2
HND-011283,2011,131200010,,,,2,6,8
HND-011284,2011,131200011,,,,5,5,10
HND-011293,2011,131200021,,,,1,4,5
HND-011295,2011,131200024,,,,1,2,3
HND-011297,2011,131200026,,,,2,0,2
HND-011278,2011,131200005,,,,9,7,16
HND-011286,2011,131200013,,,,11,9,20
HND-011287,2011,131200014,,,,4,6,10
HND-011292,2011,131200020,,,,21,14,35
HND-011278,2011,131200005,,,,3,0,3
HND-011287,2011,131200014,,,,4,3,7
HND-011292,2011,131200020,,,,22,28,50
HND-011286,2011,131200013,,,,9,6,15
HND-011278,2011,131200005,,,,5,0,5
HND-011286,2011,131200013,,,,6,6,12
HND-011292,2011,131200020,,,,16,33,49
HND-011287,2011,131200014,,,,1,6,7
HND-011292,2011,131200020,,,,11,13,24
HND-011292,2011,131200020,,,,6,5,11
HND-011292,2011,131200020,,,,8,16,24
,2011,131300086,,,,3,3,6
,2011,131300146,,,,4,1,5
,2011,131300148,,,,2,3,5
,2011,131300158,,,,8,13,21
,2011,131300160,,,,3,2,5
,2011,131300166,,,,3,4,7
HND-011400,2011,131300167,,,,7,6,13
,2011,131300171,,,,2,3,5
,2011,131300173,,,,7,2,9
,2011,131300185,,,,7,4,11
,2011,131300192,,,,5,8,13
,2011,131300198,,,,2,5,7
HND-011412,2011,131300200,,,,9,6,15
HND-011413,2011,131300201,,,,3,9,12
HND-011414,2011,131300204,,,,9,10,19
HND-011417,2011,131300210,,,,4,4,8
HND-011418,2011,131300211,,,,4,14,18
HND-011419,2011,131300212,,,,2,3,5
,2011,131300256,,,,3,4,7
HND-011370,2011,131300073,,,,8,6,14
HND-011373,2011,131300078,,,,12,9,21
,2011,131300088,,,,5,0,5
,2011,131300147,,,,5,8,13
,2011,131300149,,,,4,3,7
HND-011394,2011,131300152,,,,4,8,12
HND-011395,2011,131300153,,,,10,11,21
,2011,131300159,,,,5,4,9
HND-011397,2011,131300161,,,,5,2,7
,2011,131300162,,,,2,4,6
HND-011398,2011,131300163,,,,3,4,7
HND-011402,2011,131300175,,,,8,8,16
,2011,131300193,,,,3,2,5
HND-011411,2011,131300194,,,,4,4,8
,2011,131300196,,,,4,4,8
HND-011416,2011,131300208,,,,6,2,8
,2011,131300257,,,,2,3,5
,2011,131300085,,,,1,1,2
HND-011382,2011,131300093,,,,0,3,3
HND-011407,2011,131300181,,,,1,3,4
HND-011421,2011,131300223,,,,0,2,2
HND-011422,2011,131300224,,,,11,4,15
HND-011403,2011,131300176,,,,3,5,8
HND-011405,2011,131300179,,,,0,2,2
HND-011406,2011,131300180,,,,0,2,2
,2011,131300182,,,,1,2,3
HND-011423,2011,131300255,,,,5,2,7
HND-011369,2011,131300072,,,,8,11,19
HND-011371,2011,131300074,,,,3,1,4
HND-011372,2011,131300075,,,,2,3,5
HND-011374,2011,131300080,,,,1,0,1
HND-011376,2011,131300082,,,,2,1,3
HND-011378,2011,131300084,,,,3,7,10
HND-011382,2011,131300093,,,,4,3,7
HND-011393,2011,131300145,,,,4,9,13
HND-011422,2011,131300224,,,,5,10,15
HND-011363,2011,131300053,,,,25,19,44
,2011,131300085,,,,5,4,9
HND-011379,2011,131300089,,,,2,1,3
HND-011401,2011,131300170,,,,7,4,11
HND-011403,2011,131300176,,,,5,6,11
HND-011404,2011,131300177,,,,2,3,5
HND-011405,2011,131300179,,,,5,4,9
HND-011406,2011,131300180,,,,9,7,16
HND-011407,2011,131300181,,,,2,4,6
,2011,131300182,,,,4,5,9
HND-011421,2011,131300223,,,,6,6,12
HND-011423,2011,131300255,,,,2,1,3
,2011,131300046,,,,11,10,21
HND-011363,2011,131300053,,,,23,22,45
HND-011379,2011,131300089,,,,12,8,20
HND-011401,2011,131300170,,,,5,1,6
HND-011403,2011,131300176,,,,12,12,24
HND-011404,2011,131300177,,,,7,7,14
HND-011405,2011,131300179,,,,8,7,15
HND-011406,2011,131300180,,,,16,17,33
HND-011407,2011,131300181,,,,3,4,7
,2011,131300182,,,,4,3,7
HND-011421,2011,131300223,,,,15,13,28
HND-011423,2011,131300255,,,,4,2,6
HND-011365,2011,131300055,,,,18,20,38
HND-011369,2011,131300072,,,,9,5,14
HND-011371,2011,131300074,,,,4,9,13
HND-011372,2011,131300075,,,,6,9,15
HND-011374,2011,131300080,,,,22,16,38
HND-011375,2011,131300081,,,,17,23,40
HND-011376,2011,131300082,,,,11,10,21
HND-011377,2011,131300083,,,,12,11,23
HND-011378,2011,131300084,,,,6,13,19
,2011,131300085,,,,5,2,7
HND-011382,2011,131300093,,,,3,6,9
HND-011393,2011,131300145,,,,21,16,37
HND-011422,2011,131300224,,,,7,7,14
HND-011320,2011,131300006,,,,6,5,11
HND-011323,2011,131300009,,,,5,6,11
HND-011324,2011,131300010,,,,14,8,22
HND-011329,2011,131300016,,,,3,5,8
HND-011331,2011,131300018,,,,9,4,13
HND-011332,2011,131300019,,,,9,7,16
HND-011333,2011,131300020,,,,8,5,13
HND-011334,2011,131300021,,,,15,19,34
HND-011339,2011,131300026,,,,17,12,29
HND-011342,2011,131300029,,,,29,23,52
HND-011351,2011,131300038,,,,15,10,25
HND-011352,2011,131300039,,,,7,11,18
HND-011356,2011,131300043,,,,10,10,20
HND-011358,2011,131300045,,,,10,5,15
HND-011359,2011,131300048,,,,20,10,30
HND-011360,2011,131300050,,,,3,9,12
HND-011361,2011,131300051,,,,7,1,8
HND-011362,2011,131300052,,,,18,15,33
HND-011364,2011,131300054,,,,24,35,59
HND-011367,2011,131300070,,,,6,3,9
HND-011368,2011,131300071,,,,5,3,8
HND-011380,2011,131300091,,,,4,5,9
HND-011381,2011,131300092,,,,9,9,18
HND-011383,2011,131300094,,,,6,4,10
HND-011385,2011,131300096,,,,5,7,12
HND-011389,2011,131300101,,,,5,5,10
HND-011391,2011,131300139,,,,13,14,27
HND-011392,2011,131300140,,,,9,13,22
HND-011399,2011,131300164,,,,24,15,39
HND-011410,2011,131300189,,,,3,2,5
HND-011420,2011,131300222,,,,2,2,4
HND-011316,2011,131300001,,,,34,38,72
HND-011317,2011,131300002,,,,53,39,92
HND-011318,2011,131300004,,,,25,27,52
HND-011319,2011,131300005,,,,16,4,20
HND-011321,2011,131300007,,,,17,18,35
HND-011322,2011,131300008,,,,8,16,24
HND-011325,2011,131300011,,,,11,10,21
HND-011326,2011,131300012,,,,6,12,18
HND-011327,2011,131300013,,,,16,14,30
HND-011328,2011,131300014,,,,7,14,21
HND-011330,2011,131300017,,,,7,2,9
HND-011335,2011,131300022,,,,9,9,18
HND-011336,2011,131300023,,,,6,8,14
HND-011337,2011,131300024,,,,37,27,64
HND-011338,2011,131300025,,,,12,8,20
HND-011340,2011,131300027,,,,13,10,23
HND-011341,2011,131300028,,,,22,22,44
HND-011343,2011,131300030,,,,14,7,21
HND-011344,2011,131300031,,,,6,8,14
HND-011345,2011,131300032,,,,7,4,11
HND-011346,2011,131300033,,,,17,10,27
HND-011347,2011,131300034,,,,3,1,4
HND-011348,2011,131300035,,,,10,8,18
HND-011349,2011,131300036,,,,4,2,6
HND-011350,2011,131300037,,,,5,2,7
HND-011353,2011,131300040,,,,2,3,5
HND-011354,2011,131300041,,,,11,9,20
HND-011355,2011,131300042,,,,5,5,10
HND-011357,2011,131300044,,,,5,3,8
HND-011382,2011,131300093,,,,8,4,12
HND-011384,2011,131300095,,,,22,13,35
HND-011386,2011,131300097,,,,8,8,16
HND-011387,2011,131300098,,,,4,2,6
HND-011388,2011,131300099,,,,11,4,15
HND-011390,2011,131300111,,,,7,8,15
HND-011408,2011,131300183,,,,18,13,31
HND-011409,2011,131300188,,,,14,3,17
,2011,131300190,,,,1,0,1
HND-011415,2011,131300206,,,,7,4,11
HND-011316,2011,131300001,,,,37,19,56
HND-011319,2011,131300005,,,,14,13,27
HND-011321,2011,131300007,,,,14,16,30
HND-011322,2011,131300008,,,,16,9,25
HND-011323,2011,131300009,,,,11,9,20
HND-011327,2011,131300013,,,,11,9,20
HND-011330,2011,131300017,,,,1,3,4
HND-011331,2011,131300018,,,,5,6,11
HND-011336,2011,131300023,,,,8,4,12
HND-011338,2011,131300025,,,,11,8,19
HND-011340,2011,131300027,,,,14,7,21
HND-011341,2011,131300028,,,,18,11,29
HND-011342,2011,131300029,,,,27,20,47
HND-011345,2011,131300032,,,,3,1,4
HND-011346,2011,131300033,,,,14,6,20
HND-011347,2011,131300034,,,,4,3,7
HND-011348,2011,131300035,,,,8,2,10
HND-011350,2011,131300037,,,,2,5,7
HND-011351,2011,131300038,,,,14,15,29
HND-011353,2011,131300040,,,,5,5,10
HND-011354,2011,131300041,,,,10,8,18
HND-011355,2011,131300042,,,,4,5,9
HND-011356,2011,131300043,,,,13,14,27
HND-011357,2011,131300044,,,,9,8,17
HND-011358,2011,131300045,,,,8,13,21
HND-011384,2011,131300095,,,,20,13,33
HND-011385,2011,131300096,,,,4,5,9
HND-011387,2011,131300098,,,,1,2,3
HND-011388,2011,131300099,,,,12,5,17
HND-011389,2011,131300101,,,,3,2,5
HND-011390,2011,131300111,,,,10,12,22
HND-011392,2011,131300140,,,,4,7,11
HND-011408,2011,131300183,,,,13,18,31
HND-011410,2011,131300189,,,,1,3,4
,2011,131300190,,,,0,1,1
HND-011420,2011,131300222,,,,3,2,5
HND-011317,2011,131300002,,,,31,23,54
HND-011318,2011,131300004,,,,18,22,40
HND-011320,2011,131300006,,,,6,1,7
HND-011324,2011,131300010,,,,10,16,26
HND-011325,2011,131300011,,,,15,20,35
HND-011326,2011,131300012,,,,15,8,23
HND-011328,2011,131300014,,,,8,5,13
HND-011329,2011,131300016,,,,3,6,9
HND-011332,2011,131300019,,,,10,8,18
HND-011333,2011,131300020,,,,13,6,19
HND-011334,2011,131300021,,,,5,17,22
HND-011335,2011,131300022,,,,10,18,28
HND-011337,2011,131300024,,,,31,33,64
HND-011339,2011,131300026,,,,19,14,33
HND-011343,2011,131300030,,,,15,12,27
HND-011344,2011,131300031,,,,6,5,11
HND-011349,2011,131300036,,,,4,1,5
HND-011352,2011,131300039,,,,10,7,17
HND-011359,2011,131300048,,,,13,10,23
HND-011360,2011,131300050,,,,10,7,17
HND-011361,2011,131300051,,,,5,2,7
HND-011362,2011,131300052,,,,13,15,28
HND-011364,2011,131300054,,,,15,18,33
HND-011367,2011,131300070,,,,2,3,5
HND-011368,2011,131300071,,,,2,0,2
HND-011380,2011,131300091,,,,3,0,3
HND-011381,2011,131300092,,,,12,10,22
HND-011382,2011,131300093,,,,5,2,7
HND-011383,2011,131300094,,,,5,2,7
HND-011386,2011,131300097,,,,3,11,14
HND-011391,2011,131300139,,,,12,7,19
HND-011399,2011,131300164,,,,9,4,13
HND-011409,2011,131300188,,,,5,0,5
HND-011415,2011,131300206,,,,3,2,5
HND-011316,2011,131300001,,,,37,46,83
HND-011317,2011,131300002,,,,23,26,49
HND-011318,2011,131300004,,,,28,31,59
HND-011319,2011,131300005,,,,7,10,17
HND-011321,2011,131300007,,,,10,15,25
HND-011322,2011,131300008,,,,9,13,22
HND-011326,2011,131300012,,,,5,16,21
HND-011327,2011,131300013,,,,12,3,15
HND-011328,2011,131300014,,,,7,5,12
HND-011330,2011,131300017,,,,3,1,4
HND-011335,2011,131300022,,,,8,8,16
HND-011336,2011,131300023,,,,3,2,5
HND-011337,2011,131300024,,,,25,26,51
HND-011338,2011,131300025,,,,8,8,16
HND-011340,2011,131300027,,,,21,16,37
HND-011341,2011,131300028,,,,27,23,50
HND-011344,2011,131300031,,,,8,4,12
HND-011345,2011,131300032,,,,4,3,7
HND-011346,2011,131300033,,,,9,9,18
HND-011347,2011,131300034,,,,4,6,10
HND-011348,2011,131300035,,,,6,9,15
HND-011350,2011,131300037,,,,6,3,9
HND-011353,2011,131300040,,,,1,5,6
HND-011354,2011,131300041,,,,15,6,21
HND-011355,2011,131300042,,,,2,2,4
HND-011357,2011,131300044,,,,3,8,11
HND-011382,2011,131300093,,,,1,4,5
HND-011384,2011,131300095,,,,11,9,20
HND-011386,2011,131300097,,,,3,2,5
HND-011387,2011,131300098,,,,2,1,3
HND-011388,2011,131300099,,,,8,10,18
HND-011390,2011,131300111,,,,8,9,17
HND-011408,2011,131300183,,,,18,11,29
,2011,131300190,,,,2,0,2
HND-011420,2011,131300222,,,,3,2,5
HND-011320,2011,131300006,,,,8,2,10
HND-011323,2011,131300009,,,,9,10,19
HND-011324,2011,131300010,,,,2,12,14
HND-011325,2011,131300011,,,,16,11,27
HND-011329,2011,131300016,,,,6,1,7
HND-011331,2011,131300018,,,,8,6,14
HND-011332,2011,131300019,,,,3,10,13
HND-011333,2011,131300020,,,,7,8,15
HND-011334,2011,131300021,,,,7,5,12
HND-011339,2011,131300026,,,,8,10,18
HND-011342,2011,131300029,,,,31,22,53
HND-011343,2011,131300030,,,,8,17,25
HND-011349,2011,131300036,,,,3,4,7
HND-011351,2011,131300038,,,,16,10,26
HND-011352,2011,131300039,,,,12,11,23
HND-011356,2011,131300043,,,,8,6,14
HND-011358,2011,131300045,,,,6,11,17
HND-011359,2011,131300048,,,,4,5,9
HND-011360,2011,131300050,,,,4,7,11
HND-011361,2011,131300051,,,,2,3,5
HND-011362,2011,131300052,,,,10,11,21
HND-011364,2011,131300054,,,,18,15,33
HND-011367,2011,131300070,,,,2,1,3
HND-011368,2011,131300071,,,,3,4,7
HND-011380,2011,131300091,,,,0,1,1
HND-011381,2011,131300092,,,,9,8,17
HND-011383,2011,131300094,,,,2,1,3
HND-011385,2011,131300096,,,,8,2,10
HND-011389,2011,131300101,,,,3,0,3
HND-011391,2011,131300139,,,,10,10,20
HND-011392,2011,131300140,,,,2,3,5
HND-011399,2011,131300164,,,,11,15,26
HND-011409,2011,131300188,,,,2,5,7
HND-011410,2011,131300189,,,,1,4,5
HND-011415,2011,131300206,,,,1,2,3
HND-011319,2011,131300005,,,,4,7,11
HND-011322,2011,131300008,,,,8,12,20
HND-011323,2011,131300009,,,,9,6,15
HND-011330,2011,131300017,,,,0,2,2
HND-011331,2011,131300018,,,,3,4,7
HND-011332,2011,131300019,,,,4,9,13
HND-011338,2011,131300025,,,,5,8,13
HND-011341,2011,131300028,,,,9,18,27
HND-011342,2011,131300029,,,,10,17,27
HND-011346,2011,131300033,,,,3,10,13
HND-011348,2011,131300035,,,,8,10,18
HND-011350,2011,131300037,,,,4,5,9
HND-011351,2011,131300038,,,,11,16,27
HND-011352,2011,131300039,,,,3,3,6
HND-011355,2011,131300042,,,,2,1,3
HND-011356,2011,131300043,,,,10,6,16
HND-011357,2011,131300044,,,,5,6,11
HND-011358,2011,131300045,,,,3,5,8
HND-011359,2011,131300048,,,,3,4,7
HND-011360,2011,131300050,,,,1,5,6
HND-011361,2011,131300051,,,,4,3,7
HND-011367,2011,131300070,,,,4,5,9
HND-011368,2011,131300071,,,,2,3,5
HND-011380,2011,131300091,,,,0,4,4
HND-011384,2011,131300095,,,,12,8,20
HND-011385,2011,131300096,,,,1,10,11
HND-011388,2011,131300099,,,,7,4,11
HND-011389,2011,131300101,,,,1,1,2
HND-011390,2011,131300111,,,,4,15,19
HND-011391,2011,131300139,,,,8,12,20
HND-011408,2011,131300183,,,,12,5,17
HND-011410,2011,131300189,,,,2,1,3
HND-011415,2011,131300206,,,,0,1,1
HND-011316,2011,131300001,,,,30,32,62
HND-011317,2011,131300002,,,,21,20,41
HND-011318,2011,131300004,,,,22,28,50
HND-011320,2011,131300006,,,,3,4,7
HND-011321,2011,131300007,,,,7,8,15
HND-011324,2011,131300010,,,,10,6,16
HND-011325,2011,131300011,,,,14,15,29
HND-011326,2011,131300012,,,,4,7,11
HND-011327,2011,131300013,,,,6,6,12
HND-011329,2011,131300016,,,,0,2,2
HND-011333,2011,131300020,,,,6,7,13
HND-011334,2011,131300021,,,,11,9,20
HND-011335,2011,131300022,,,,7,8,15
HND-011336,2011,131300023,,,,6,3,9
HND-011337,2011,131300024,,,,16,18,34
HND-011339,2011,131300026,,,,12,8,20
HND-011340,2011,131300027,,,,13,14,27
HND-011343,2011,131300030,,,,12,6,18
HND-011344,2011,131300031,,,,7,7,14
HND-011345,2011,131300032,,,,4,1,5
HND-011347,2011,131300034,,,,6,2,8
HND-011349,2011,131300036,,,,2,2,4
HND-011353,2011,131300040,,,,4,1,5
HND-011354,2011,131300041,,,,7,5,12
HND-011362,2011,131300052,,,,8,5,13
HND-011364,2011,131300054,,,,17,15,32
HND-011381,2011,131300092,,,,12,6,18
HND-011382,2011,131300093,,,,1,1,2
HND-011386,2011,131300097,,,,1,2,3
HND-011387,2011,131300098,,,,3,0,3
HND-011399,2011,131300164,,,,19,20,39
HND-011409,2011,131300188,,,,1,2,3
,2011,131300190,,,,1,2,3
HND-011420,2011,131300222,,,,1,1,2
HND-011316,2011,131300001,,,,36,31,67
HND-011317,2011,131300002,,,,25,36,61
HND-011318,2011,131300004,,,,17,21,38
HND-011319,2011,131300005,,,,6,13,19
HND-011321,2011,131300007,,,,3,7,10
HND-011324,2011,131300010,,,,6,9,15
HND-011325,2011,131300011,,,,12,13,25
HND-011326,2011,131300012,,,,4,15,19
HND-011327,2011,131300013,,,,6,5,11
HND-011328,2011,131300014,,,,9,5,14
HND-011329,2011,131300016,,,,1,4,5
HND-011330,2011,131300017,,,,5,3,8
HND-011333,2011,131300020,,,,5,5,10
HND-011334,2011,131300021,,,,4,5,9
HND-011335,2011,131300022,,,,7,2,9
HND-011336,2011,131300023,,,,4,6,10
HND-011337,2011,131300024,,,,10,10,20
HND-011338,2011,131300025,,,,4,4,8
HND-011340,2011,131300027,,,,10,14,24
HND-011348,2011,131300035,,,,2,6,8
HND-011351,2011,131300038,,,,8,11,19
HND-011352,2011,131300039,,,,14,9,23
HND-011355,2011,131300042,,,,3,1,4
HND-011356,2011,131300043,,,,3,4,7
HND-011357,2011,131300044,,,,12,1,13
HND-011358,2011,131300045,,,,4,0,4
HND-011359,2011,131300048,,,,12,11,23
HND-011360,2011,131300050,,,,6,6,12
HND-011361,2011,131300051,,,,0,4,4
HND-011367,2011,131300070,,,,0,3,3
HND-011380,2011,131300091,,,,2,2,4
HND-011383,2011,131300094,,,,2,2,4
HND-011384,2011,131300095,,,,13,18,31
HND-011385,2011,131300096,,,,6,3,9
HND-011388,2011,131300099,,,,0,8,8
HND-011389,2011,131300101,,,,3,3,6
HND-011399,2011,131300164,,,,14,9,23
HND-011409,2011,131300188,,,,3,1,4
,2011,131300190,,,,0,4,4
HND-011415,2011,131300206,,,,1,1,2
HND-011320,2011,131300006,,,,3,1,4
HND-011322,2011,131300008,,,,8,9,17
HND-011323,2011,131300009,,,,5,4,9
HND-011331,2011,131300018,,,,2,7,9
HND-011332,2011,131300019,,,,4,8,12
HND-011339,2011,131300026,,,,13,7,20
HND-011341,2011,131300028,,,,11,10,21
HND-011342,2011,131300029,,,,20,15,35
HND-011343,2011,131300030,,,,11,11,22
HND-011344,2011,131300031,,,,8,8,16
HND-011345,2011,131300032,,,,3,1,4
HND-011346,2011,131300033,,,,6,5,11
HND-011347,2011,131300034,,,,1,6,7
HND-011349,2011,131300036,,,,4,1,5
HND-011350,2011,131300037,,,,1,6,7
HND-011353,2011,131300040,,,,0,3,3
HND-011354,2011,131300041,,,,5,6,11
HND-011362,2011,131300052,,,,9,12,21
HND-011364,2011,131300054,,,,13,19,32
HND-011381,2011,131300092,,,,8,8,16
HND-011382,2011,131300093,,,,1,7,8
HND-011386,2011,131300097,,,,2,1,3
HND-011387,2011,131300098,,,,1,1,2
HND-011390,2011,131300111,,,,10,8,18
HND-011391,2011,131300139,,,,11,5,16
HND-011392,2011,131300140,,,,2,8,10
HND-011408,2011,131300183,,,,2,8,10
HND-011410,2011,131300189,,,,0,2,2
HND-011420,2011,131300222,,,,0,3,3
HND-011316,2011,131300001,,,,34,27,61
HND-011319,2011,131300005,,,,5,3,8
HND-011321,2011,131300007,,,,3,6,9
HND-011322,2011,131300008,,,,3,5,8
HND-011323,2011,131300009,,,,9,4,13
HND-011327,2011,131300013,,,,3,3,6
HND-011331,2011,131300018,,,,3,3,6
HND-011336,2011,131300023,,,,5,1,6
HND-011338,2011,131300025,,,,7,4,11
HND-011340,2011,131300027,,,,5,13,18
HND-011341,2011,131300028,,,,14,11,25
HND-011342,2011,131300029,,,,10,16,26
HND-011343,2011,131300030,,,,6,9,15
HND-011344,2011,131300031,,,,4,3,7
HND-011349,2011,131300036,,,,2,5,7
HND-011359,2011,131300048,,,,0,2,2
HND-011360,2011,131300050,,,,3,3,6
HND-011361,2011,131300051,,,,4,6,10
HND-011362,2011,131300052,,,,7,3,10
HND-011364,2011,131300054,,,,9,7,16
HND-011367,2011,131300070,,,,0,3,3
HND-011368,2011,131300071,,,,1,2,3
HND-011380,2011,131300091,,,,0,4,4
HND-011381,2011,131300092,,,,6,7,13
HND-011382,2011,131300093,,,,3,6,9
HND-011383,2011,131300094,,,,0,2,2
HND-011386,2011,131300097,,,,0,1,1
HND-011392,2011,131300140,,,,1,4,5
HND-011399,2011,131300164,,,,5,12,17
HND-011408,2011,131300183,,,,3,5,8
HND-011410,2011,131300189,,,,1,0,1
,2011,131300190,,,,3,2,5
HND-011415,2011,131300206,,,,1,1,2
HND-011317,2011,131300002,,,,17,20,37
HND-011318,2011,131300004,,,,21,20,41
HND-011320,2011,131300006,,,,2,5,7
HND-011324,2011,131300010,,,,5,11,16
HND-011325,2011,131300011,,,,11,13,24
HND-011326,2011,131300012,,,,7,8,15
HND-011328,2011,131300014,,,,4,8,12
HND-011329,2011,131300016,,,,4,1,5
HND-011332,2011,131300019,,,,0,5,5
HND-011333,2011,131300020,,,,4,6,10
HND-011334,2011,131300021,,,,1,4,5
HND-011335,2011,131300022,,,,1,3,4
HND-011337,2011,131300024,,,,12,17,29
HND-011339,2011,131300026,,,,5,6,11
HND-011345,2011,131300032,,,,1,5,6
HND-011346,2011,131300033,,,,3,3,6
HND-011347,2011,131300034,,,,3,3,6
HND-011348,2011,131300035,,,,2,5,7
HND-011350,2011,131300037,,,,3,1,4
HND-011351,2011,131300038,,,,10,9,19
HND-011353,2011,131300040,,,,2,0,2
HND-011354,2011,131300041,,,,8,5,13
HND-011355,2011,131300042,,,,2,1,3
HND-011356,2011,131300043,,,,2,4,6
HND-011357,2011,131300044,,,,3,2,5
HND-011358,2011,131300045,,,,1,1,2
HND-011384,2011,131300095,,,,9,5,14
HND-011385,2011,131300096,,,,0,6,6
HND-011387,2011,131300098,,,,1,1,2
HND-011388,2011,131300099,,,,7,6,13
HND-011389,2011,131300101,,,,3,4,7
HND-011390,2011,131300111,,,,6,8,14
HND-011391,2011,131300139,,,,3,8,11
HND-011409,2011,131300188,,,,0,2,2
HND-011341,2011,131300028,,,,8,18,26
HND-011342,2011,131300029,,,,14,12,26
HND-011364,2011,131300054,,,,13,22,35
HND-011366,2011,131300056,,,,107,147,254
HND-011391,2011,131300139,,,,7,16,23
HND-011318,2011,131300004,,,,13,10,23
HND-011325,2011,131300011,,,,17,16,33
HND-011337,2011,131300024,,,,7,14,21
HND-011340,2011,131300027,,,,19,10,29
,2011,131300225,,,,7,12,19
HND-011318,2011,131300004,,,,8,9,17
HND-011325,2011,131300011,,,,13,12,25
HND-011337,2011,131300024,,,,6,9,15
,2011,131300225,,,,3,5,8
HND-011340,2011,131300027,,,,12,8,20
HND-011341,2011,131300028,,,,8,4,12
HND-011342,2011,131300029,,,,2,4,6
HND-011364,2011,131300054,,,,11,7,18
HND-011366,2011,131300056,,,,70,99,169
HND-011341,2011,131300028,,,,7,6,13
HND-011342,2011,131300029,,,,7,10,17
HND-011366,2011,131300056,,,,64,75,139
,2011,131300225,,,,2,15,17
HND-011318,2011,131300004,,,,3,9,12
HND-011325,2011,131300011,,,,12,11,23
HND-011337,2011,131300024,,,,9,6,15
HND-011340,2011,131300027,,,,8,8,16
HND-011364,2011,131300054,,,,4,11,15
HND-011366,2011,131300056,,,,77,80,157
HND-011366,2011,131300056,,,,49,61,110
HND-011366,2011,131300056,,,,34,35,69
HND-011441,2011,131400044,,,,6,3,9
HND-011440,2011,131400043,,,,8,1,9
,2011,131400045,,,,3,5,8
HND-011439,2011,131400028,,,,2,1,3
,2011,131400041,,,,0,1,1
,2011,131400042,,,,3,2,5
HND-011434,2011,131400009,,,,5,1,6
HND-011435,2011,131400010,,,,0,1,1
,2011,131400013,,,,2,2,4
,2011,131400013,,,,3,4,7
HND-011439,2011,131400028,,,,1,4,5
,2011,131400041,,,,2,3,5
,2011,131400042,,,,2,1,3
HND-011434,2011,131400009,,,,4,5,9
HND-011435,2011,131400010,,,,1,2,3
HND-011437,2011,131400012,,,,1,1,2
HND-011434,2011,131400009,,,,6,5,11
HND-011435,2011,131400010,,,,7,6,13
HND-011437,2011,131400012,,,,4,5,9
,2011,131400013,,,,5,3,8
HND-011439,2011,131400028,,,,2,5,7
,2011,131400041,,,,7,3,10
,2011,131400042,,,,2,7,9
HND-011426,2011,131400001,,,,14,12,26
HND-011427,2011,131400002,,,,13,10,23
HND-011428,2011,131400003,,,,10,5,15
HND-011429,2011,131400004,,,,14,14,28
HND-011430,2011,131400005,,,,2,4,6
HND-011432,2011,131400007,,,,7,8,15
HND-011433,2011,131400008,,,,4,5,9
,2011,131400040,,,,8,1,9
HND-011431,2011,131400006,,,,5,6,11
HND-011438,2011,131400020,,,,1,3,4
HND-011427,2011,131400002,,,,12,5,17
HND-011428,2011,131400003,,,,9,7,16
HND-011429,2011,131400004,,,,19,11,30
HND-011431,2011,131400006,,,,5,1,6
HND-011432,2011,131400007,,,,7,3,10
HND-011426,2011,131400001,,,,13,14,27
HND-011430,2011,131400005,,,,3,1,4
HND-011433,2011,131400008,,,,3,7,10
HND-011438,2011,131400020,,,,1,0,1
,2011,131400040,,,,1,7,8
HND-011431,2011,131400006,,,,9,3,12
HND-011438,2011,131400020,,,,2,0,2
HND-011426,2011,131400001,,,,15,14,29
HND-011427,2011,131400002,,,,10,9,19
HND-011428,2011,131400003,,,,9,2,11
HND-011429,2011,131400004,,,,17,8,25
HND-011430,2011,131400005,,,,3,1,4
HND-011432,2011,131400007,,,,5,6,11
HND-011433,2011,131400008,,,,8,2,10
,2011,131400040,,,,4,2,6
HND-011426,2011,131400001,,,,7,14,21
HND-011427,2011,131400002,,,,10,8,18
HND-011428,2011,131400003,,,,8,8,16
HND-011429,2011,131400004,,,,9,12,21
HND-011430,2011,131400005,,,,2,1,3
HND-011432,2011,131400007,,,,2,5,7
HND-011431,2011,131400006,,,,5,4,9
HND-011433,2011,131400008,,,,3,4,7
HND-011438,2011,131400020,,,,0,2,2
,2011,131400040,,,,4,4,8
HND-011426,2011,131400001,,,,13,14,27
HND-011427,2011,131400002,,,,4,9,13
HND-011428,2011,131400003,,,,7,3,10
HND-011429,2011,131400004,,,,12,12,24
HND-011430,2011,131400005,,,,2,4,6
HND-011432,2011,131400007,,,,6,4,10
HND-011433,2011,131400008,,,,2,3,5
,2011,131400040,,,,5,9,14
HND-011431,2011,131400006,,,,4,1,5
HND-011438,2011,131400020,,,,1,0,1
HND-011427,2011,131400002,,,,7,8,15
HND-011428,2011,131400003,,,,7,5,12
HND-011429,2011,131400004,,,,10,12,22
HND-011431,2011,131400006,,,,2,5,7
HND-011432,2011,131400007,,,,5,4,9
,2011,131400040,,,,4,3,7
HND-011426,2011,131400001,,,,22,13,35
HND-011433,2011,131400008,,,,2,0,2
HND-011438,2011,131400020,,,,2,2,4
HND-011427,2011,131400002,,,,7,15,22
HND-011436,2011,131400011,,,,31,33,64
HND-011427,2011,131400002,,,,6,9,15
HND-011436,2011,131400011,,,,24,21,45
HND-011427,2011,131400002,,,,6,5,11
HND-011436,2011,131400011,,,,24,18,42
HND-011436,2011,131400011,,,,10,21,31
HND-011436,2011,131400011,,,,17,21,38
HND-011436,2011,131400011,,,,12,16,28
,2011,131500094,,,,7,8,15
HND-011491,2011,131500095,,,,10,5,15
,2011,131500096,,,,11,1,12
,2011,131500097,,,,6,6,12
HND-011495,2011,131500105,,,,7,5,12
HND-011496,2011,131500106,,,,3,8,11
HND-011497,2011,131500107,,,,2,3,5
HND-011498,2011,131500108,,,,6,5,11
HND-011502,2011,131500129,,,,5,9,14
,2011,131500131,,,,7,6,13
,2011,131500132,,,,8,8,16
HND-011504,2011,131500135,,,,7,2,9
HND-011490,2011,131500093,,,,6,6,12
HND-011492,2011,131500098,,,,15,9,24
HND-011493,2011,131500102,,,,2,8,10
,2011,131500103,,,,4,6,10
HND-011494,2011,131500104,,,,4,2,6
HND-011501,2011,131500128,,,,4,3,7
HND-011503,2011,131500130,,,,3,3,6
,2011,131500133,,,,6,2,8
,2011,131500134,,,,5,5,10
HND-011464,2011,131500026,,,,9,4,13
HND-011466,2011,131500028,,,,2,2,4
HND-011475,2011,131500050,,,,3,3,6
,2011,131500063,,,,0,5,5
HND-011484,2011,131500067,,,,2,2,4
HND-011487,2011,131500070,,,,2,1,3
HND-011472,2011,131500038,,,,3,4,7
HND-011479,2011,131500060,,,,7,5,12
,2011,131500061,,,,1,5,6
HND-011480,2011,131500062,,,,0,3,3
HND-011481,2011,131500064,,,,4,2,6
HND-011483,2011,131500066,,,,1,5,6
HND-011473,2011,131500039,,,,1,0,1
HND-011475,2011,131500050,,,,4,5,9
HND-011480,2011,131500062,,,,4,1,5
,2011,131500063,,,,3,4,7
HND-011481,2011,131500064,,,,3,1,4
HND-011484,2011,131500067,,,,5,2,7
HND-011464,2011,131500026,,,,9,10,19
HND-011466,2011,131500028,,,,5,4,9
HND-011472,2011,131500038,,,,1,2,3
HND-011479,2011,131500060,,,,6,4,10
,2011,131500061,,,,4,2,6
HND-011483,2011,131500066,,,,3,2,5
HND-011487,2011,131500070,,,,5,2,7
HND-011466,2011,131500028,,,,8,6,14
HND-011472,2011,131500038,,,,6,4,10
HND-011473,2011,131500039,,,,15,11,26
HND-011479,2011,131500060,,,,4,3,7
,2011,131500061,,,,1,4,5
HND-011483,2011,131500066,,,,8,1,9
HND-011487,2011,131500070,,,,0,1,1
HND-011464,2011,131500026,,,,15,7,22
HND-011475,2011,131500050,,,,4,3,7
HND-011480,2011,131500062,,,,8,7,15
,2011,131500063,,,,3,2,5
HND-011481,2011,131500064,,,,2,2,4
HND-011484,2011,131500067,,,,10,3,13
HND-011442,2011,131500001,,,,9,12,21
HND-011443,2011,131500003,,,,14,11,25
HND-011444,2011,131500004,,,,13,19,32
HND-011446,2011,131500006,,,,10,13,23
HND-011447,2011,131500007,,,,18,20,38
HND-011450,2011,131500010,,,,12,11,23
HND-011451,2011,131500011,,,,14,14,28
HND-011452,2011,131500012,,,,11,9,20
HND-011456,2011,131500016,,,,8,4,12
HND-011458,2011,131500019,,,,6,3,9
HND-011459,2011,131500020,,,,3,9,12
HND-011460,2011,131500021,,,,5,5,10
,2011,131500022,,,,3,7,10
HND-011462,2011,131500024,,,,3,9,12
HND-011467,2011,131500029,,,,12,5,17
HND-011471,2011,131500036,,,,13,17,30
HND-011477,2011,131500056,,,,3,0,3
HND-011486,2011,131500069,,,,3,5,8
HND-011489,2011,131500090,,,,8,7,15
HND-011445,2011,131500005,,,,13,9,22
HND-011448,2011,131500008,,,,7,9,16
HND-011449,2011,131500009,,,,4,12,16
HND-011453,2011,131500013,,,,17,9,26
HND-011455,2011,131500015,,,,6,5,11
HND-011457,2011,131500017,,,,6,5,11
HND-011463,2011,131500025,,,,6,6,12
HND-011468,2011,131500031,,,,26,23,49
HND-011469,2011,131500031,,,,26,23,49
HND-011470,2011,131500035,,,,12,6,18
HND-011474,2011,131500045,,,,15,7,22
HND-011476,2011,131500055,,,,17,11,28
HND-011478,2011,131500058,,,,3,4,7
HND-011485,2011,131500068,,,,4,3,7
HND-011488,2011,131500089,,,,4,2,6
HND-011500,2011,131500124,,,,6,4,10
HND-011442,2011,131500001,,,,8,7,15
HND-011446,2011,131500006,,,,10,3,13
HND-011449,2011,131500009,,,,6,13,19
HND-011458,2011,131500019,,,,6,7,13
HND-011468,2011,131500031,,,,23,23,46
HND-011469,2011,131500031,,,,23,23,46
HND-011470,2011,131500035,,,,6,7,13
HND-011476,2011,131500055,,,,7,9,16
HND-011486,2011,131500069,,,,3,7,10
HND-011499,2011,131500123,,,,2,0,2
HND-011443,2011,131500003,,,,6,4,10
HND-011444,2011,131500004,,,,9,15,24
HND-011445,2011,131500005,,,,6,10,16
HND-011447,2011,131500007,,,,12,20,32
HND-011448,2011,131500008,,,,6,5,11
HND-011450,2011,131500010,,,,11,11,22
HND-011451,2011,131500011,,,,18,20,38
HND-011452,2011,131500012,,,,13,8,21
HND-011453,2011,131500013,,,,17,8,25
HND-011455,2011,131500015,,,,7,4,11
HND-011456,2011,131500016,,,,2,4,6
HND-011457,2011,131500017,,,,9,10,19
HND-011459,2011,131500020,,,,11,6,17
HND-011460,2011,131500021,,,,6,6,12
,2011,131500022,,,,8,9,17
HND-011462,2011,131500024,,,,8,3,11
HND-011463,2011,131500025,,,,9,3,12
HND-011467,2011,131500029,,,,7,4,11
HND-011471,2011,131500036,,,,10,11,21
HND-011474,2011,131500045,,,,9,4,13
HND-011477,2011,131500056,,,,2,2,4
HND-011482,2011,131500065,,,,3,3,6
HND-011485,2011,131500068,,,,3,3,6
HND-011489,2011,131500090,,,,4,4,8
HND-011500,2011,131500124,,,,8,6,14
HND-011445,2011,131500005,,,,9,8,17
HND-011448,2011,131500008,,,,8,2,10
HND-011449,2011,131500009,,,,13,9,22
HND-011453,2011,131500013,,,,6,8,14
HND-011455,2011,131500015,,,,0,5,5
HND-011458,2011,131500019,,,,2,3,5
HND-011463,2011,131500025,,,,6,5,11
HND-011468,2011,131500031,,,,18,24,42
HND-011469,2011,131500031,,,,18,24,42
HND-011470,2011,131500035,,,,11,10,21
HND-011474,2011,131500045,,,,6,4,10
HND-011476,2011,131500055,,,,7,8,15
HND-011478,2011,131500058,,,,2,0,2
HND-011485,2011,131500068,,,,1,8,9
HND-011488,2011,131500089,,,,5,3,8
HND-011442,2011,131500001,,,,6,7,13
HND-011443,2011,131500003,,,,6,8,14
HND-011444,2011,131500004,,,,9,13,22
HND-011446,2011,131500006,,,,2,4,6
HND-011447,2011,131500007,,,,27,18,45
HND-011450,2011,131500010,,,,15,19,34
HND-011451,2011,131500011,,,,13,10,23
HND-011452,2011,131500012,,,,10,8,18
HND-011454,2011,131500014,,,,4,4,8
HND-011456,2011,131500016,,,,11,5,16
HND-011459,2011,131500020,,,,14,7,21
HND-011460,2011,131500021,,,,5,4,9
HND-011462,2011,131500024,,,,9,7,16
HND-011467,2011,131500029,,,,7,7,14
HND-011471,2011,131500036,,,,3,7,10
HND-011477,2011,131500056,,,,4,2,6
HND-011482,2011,131500065,,,,4,2,6
HND-011486,2011,131500069,,,,3,5,8
HND-011489,2011,131500090,,,,13,8,21
HND-011499,2011,131500123,,,,2,1,3
HND-011500,2011,131500124,,,,5,3,8
HND-011442,2011,131500001,,,,9,10,19
HND-011446,2011,131500006,,,,6,7,13
HND-011449,2011,131500009,,,,9,9,18
HND-011450,2011,131500010,,,,9,13,22
HND-011451,2011,131500011,,,,20,15,35
HND-011456,2011,131500016,,,,4,2,6
HND-011458,2011,131500019,,,,6,9,15
HND-011459,2011,131500020,,,,13,5,18
HND-011460,2011,131500021,,,,4,1,5
HND-011467,2011,131500029,,,,4,6,10
HND-011478,2011,131500058,,,,2,2,4
HND-011486,2011,131500069,,,,2,6,8
HND-011489,2011,131500090,,,,7,14,21
HND-011499,2011,131500123,,,,4,2,6
HND-011443,2011,131500003,,,,15,15,30
HND-011444,2011,131500004,,,,8,10,18
HND-011445,2011,131500005,,,,12,5,17
HND-011447,2011,131500007,,,,10,5,15
HND-011448,2011,131500008,,,,8,1,9
HND-011452,2011,131500012,,,,8,9,17
HND-011453,2011,131500013,,,,12,12,24
HND-011454,2011,131500014,,,,3,2,5
HND-011455,2011,131500015,,,,2,0,2
HND-011457,2011,131500017,,,,4,4,8
HND-011462,2011,131500024,,,,11,9,20
HND-011463,2011,131500025,,,,9,7,16
HND-011468,2011,131500031,,,,12,19,31
HND-011469,2011,131500031,,,,12,19,31
HND-011470,2011,131500035,,,,13,10,23
HND-011471,2011,131500036,,,,3,4,7
HND-011474,2011,131500045,,,,3,4,7
HND-011476,2011,131500055,,,,10,9,19
HND-011477,2011,131500056,,,,1,2,3
HND-011482,2011,131500065,,,,3,2,5
HND-011485,2011,131500068,,,,4,2,6
HND-011488,2011,131500089,,,,6,5,11
HND-011500,2011,131500124,,,,6,3,9
HND-011442,2011,131500001,,,,9,6,15
HND-011444,2011,131500004,,,,9,1,10
HND-011446,2011,131500006,,,,4,7,11
HND-011450,2011,131500010,,,,20,9,29
HND-011451,2011,131500011,,,,11,12,23
HND-011456,2011,131500016,,,,3,5,8
HND-011458,2011,131500019,,,,4,4,8
HND-011459,2011,131500020,,,,11,9,20
HND-011460,2011,131500021,,,,5,6,11
HND-011467,2011,131500029,,,,4,2,6
HND-011471,2011,131500036,,,,1,2,3
HND-011477,2011,131500056,,,,2,1,3
HND-011478,2011,131500058,,,,4,1,5
HND-011486,2011,131500069,,,,2,0,2
HND-011489,2011,131500090,,,,9,6,15
HND-011499,2011,131500123,,,,2,1,3
HND-011443,2011,131500003,,,,7,7,14
HND-011445,2011,131500005,,,,7,8,15
HND-011447,2011,131500007,,,,14,11,25
HND-011448,2011,131500008,,,,4,6,10
HND-011449,2011,131500009,,,,5,4,9
HND-011452,2011,131500012,,,,9,6,15
HND-011453,2011,131500013,,,,13,10,23
HND-011454,2011,131500014,,,,2,8,10
HND-011457,2011,131500017,,,,6,8,14
,2011,131500022,,,,3,1,4
HND-011462,2011,131500024,,,,10,5,15
HND-011463,2011,131500025,,,,7,9,16
HND-011468,2011,131500031,,,,16,24,40
HND-011469,2011,131500031,,,,16,24,40
HND-011470,2011,131500035,,,,11,8,19
HND-011474,2011,131500045,,,,4,3,7
HND-011476,2011,131500055,,,,3,6,9
HND-011482,2011,131500065,,,,1,2,3
HND-011485,2011,131500068,,,,2,1,3
HND-011500,2011,131500124,,,,2,5,7
HND-011443,2011,131500003,,,,2,10,12
HND-011444,2011,131500004,,,,2,3,5
HND-011445,2011,131500005,,,,5,9,14
HND-011447,2011,131500007,,,,9,5,14
HND-011448,2011,131500008,,,,7,3,10
HND-011450,2011,131500010,,,,14,5,19
HND-011451,2011,131500011,,,,7,7,14
HND-011452,2011,131500012,,,,5,4,9
HND-011453,2011,131500013,,,,8,9,17
HND-011454,2011,131500014,,,,4,9,13
HND-011456,2011,131500016,,,,5,4,9
HND-011459,2011,131500020,,,,0,5,5
HND-011460,2011,131500021,,,,4,3,7
,2011,131500022,,,,3,1,4
HND-011462,2011,131500024,,,,3,2,5
HND-011463,2011,131500025,,,,4,3,7
HND-011467,2011,131500029,,,,5,2,7
HND-011468,2011,131500031,,,,10,25,35
HND-011469,2011,131500031,,,,10,25,35
HND-011470,2011,131500035,,,,4,7,11
HND-011476,2011,131500055,,,,2,3,5
HND-011478,2011,131500058,,,,2,3,5
HND-011482,2011,131500065,,,,3,1,4
HND-011500,2011,131500124,,,,1,1,2
HND-011442,2011,131500001,,,,3,3,6
HND-011446,2011,131500006,,,,4,5,9
HND-011449,2011,131500009,,,,0,3,3
HND-011458,2011,131500019,,,,3,2,5
HND-011471,2011,131500036,,,,2,3,5
HND-011474,2011,131500045,,,,2,1,3
HND-011477,2011,131500056,,,,1,1,2
HND-011486,2011,131500069,,,,4,3,7
HND-011488,2011,131500089,,,,0,3,3
HND-011489,2011,131500090,,,,2,7,9
HND-011450,2011,131500010,,,,42,24,66
HND-011451,2011,131500011,,,,8,6,14
HND-011465,2011,131500027,,,,40,26,66
HND-011450,2011,131500010,,,,20,10,30
HND-011451,2011,131500011,,,,5,3,8
HND-011465,2011,131500027,,,,13,33,46
HND-011451,2011,131500011,,,,10,10,20
HND-011450,2011,131500010,,,,16,12,28
HND-011465,2011,131500027,,,,24,24,48
HND-011465,2011,131500027,,,,21,14,35
HND-011465,2011,131500027,,,,15,11,26
HND-011465,2011,131500027,,,,13,10,23
HND-011543,2011,131600089,,,,3,12,15
HND-011544,2011,131600090,,,,3,5,8
,2011,131600091,,,,2,3,5
,2011,131600094,,,,3,6,9
,2011,131600096,,,,5,4,9
,2011,131600100,,,,3,1,4
HND-011547,2011,131600105,,,,6,4,10
,2011,131600106,,,,3,4,7
,2011,131600107,,,,2,3,5
,2011,131600109,,,,1,4,5
HND-011549,2011,131600165,,,,3,4,7
HND-011551,2011,131600168,,,,2,1,3
,2011,131600171,,,,2,1,3
HND-011553,2011,131600175,,,,2,3,5
HND-011558,2011,131600204,,,,3,6,9
,2011,131600206,,,,1,5,6
HND-011561,2011,131600209,,,,0,1,1
HND-011562,2011,131600210,,,,2,3,5
HND-011525,2011,131600021,,,,3,8,11
HND-011531,2011,131600037,,,,3,3,6
HND-011532,2011,131600039,,,,1,2,3
HND-011546,2011,131600095,,,,4,5,9
,2011,131600098,,,,7,6,13
,2011,131600099,,,,2,5,7
,2011,131600102,,,,3,4,7
,2011,131600108,,,,2,5,7
,2011,131600111,,,,3,2,5
HND-011548,2011,131600137,,,,6,3,9
HND-011552,2011,131600172,,,,3,4,7
,2011,131600203,,,,1,4,5
HND-011559,2011,131600205,,,,4,1,5
,2011,131600207,,,,3,8,11
HND-011560,2011,131600208,,,,4,5,9
HND-011528,2011,131600024,,,,2,2,4
HND-011529,2011,131600025,,,,2,5,7
HND-011525,2011,131600021,,,,1,1,2
HND-011531,2011,131600037,,,,3,1,4
HND-011525,2011,131600021,,,,8,4,12
HND-011527,2011,131600023,,,,0,3,3
HND-011528,2011,131600024,,,,3,4,7
HND-011529,2011,131600025,,,,2,3,5
HND-011531,2011,131600037,,,,5,4,9
HND-011526,2011,131600022,,,,6,10,16
HND-011525,2011,131600021,,,,8,12,20
HND-011526,2011,131600022,,,,13,11,24
HND-011531,2011,131600037,,,,9,5,14
HND-011527,2011,131600023,,,,13,15,28
HND-011528,2011,131600024,,,,5,9,14
HND-011529,2011,131600025,,,,5,4,9
HND-011506,2011,131600002,,,,36,19,55
HND-011512,2011,131600008,,,,7,3,10
HND-011513,2011,131600009,,,,10,8,18
HND-011519,2011,131600015,,,,3,4,7
HND-011522,2011,131600018,,,,13,10,23
HND-011523,2011,131600019,,,,11,8,19
HND-011524,2011,131600020,,,,20,16,36
HND-011530,2011,131600026,,,,16,8,24
HND-011536,2011,131600043,,,,5,3,8
HND-011538,2011,131600045,,,,7,16,23
HND-011539,2011,131600046,,,,7,7,14
HND-011540,2011,131600047,,,,7,9,16
HND-011541,2011,131600048,,,,5,7,12
HND-011542,2011,131600049,,,,8,4,12
HND-011550,2011,131600167,,,,3,4,7
HND-011555,2011,131600199,,,,6,6,12
HND-011556,2011,131600200,,,,6,1,7
HND-011557,2011,131600201,,,,5,4,9
HND-011505,2011,131600001,,,,10,6,16
HND-011507,2011,131600003,,,,13,14,27
HND-011508,2011,131600004,,,,5,4,9
HND-011509,2011,131600005,,,,19,12,31
HND-011510,2011,131600006,,,,5,10,15
HND-011511,2011,131600007,,,,11,15,26
HND-011514,2011,131600010,,,,14,11,25
HND-011515,2011,131600011,,,,8,3,11
HND-011516,2011,131600012,,,,9,7,16
HND-011517,2011,131600013,,,,4,6,10
HND-011518,2011,131600014,,,,12,7,19
HND-011520,2011,131600016,,,,2,6,8
HND-011521,2011,131600017,,,,9,14,23
HND-011533,2011,131600040,,,,4,5,9
HND-011534,2011,131600041,,,,10,8,18
HND-011535,2011,131600042,,,,5,4,9
HND-011537,2011,131600044,,,,5,12,17
HND-011506,2011,131600002,,,,18,13,31
HND-011507,2011,131600003,,,,7,14,21
HND-011508,2011,131600004,,,,7,6,13
HND-011509,2011,131600005,,,,13,14,27
HND-011511,2011,131600007,,,,14,6,20
HND-011512,2011,131600008,,,,4,1,5
HND-011516,2011,131600012,,,,4,9,13
HND-011517,2011,131600013,,,,6,3,9
HND-011518,2011,131600014,,,,9,7,16
HND-011519,2011,131600015,,,,4,3,7
HND-011521,2011,131600017,,,,5,7,12
HND-011522,2011,131600018,,,,7,9,16
HND-011524,2011,131600020,,,,12,13,25
HND-011530,2011,131600026,,,,2,12,14
HND-011533,2011,131600040,,,,2,0,2
HND-011534,2011,131600041,,,,6,3,9
HND-011539,2011,131600046,,,,7,7,14
HND-011541,2011,131600048,,,,2,0,2
HND-011542,2011,131600049,,,,1,2,3
HND-011505,2011,131600001,,,,5,7,12
HND-011510,2011,131600006,,,,6,4,10
HND-011513,2011,131600009,,,,7,3,10
HND-011514,2011,131600010,,,,8,9,17
HND-011515,2011,131600011,,,,7,2,9
HND-011520,2011,131600016,,,,7,4,11
HND-011523,2011,131600019,,,,5,8,13
HND-011535,2011,131600042,,,,4,3,7
HND-011536,2011,131600043,,,,4,3,7
HND-011537,2011,131600044,,,,3,5,8
HND-011538,2011,131600045,,,,4,6,10
HND-011540,2011,131600047,,,,2,2,4
HND-011550,2011,131600167,,,,3,4,7
HND-011555,2011,131600199,,,,1,4,5
HND-011556,2011,131600200,,,,2,1,3
HND-011557,2011,131600201,,,,2,2,4
HND-011505,2011,131600001,,,,5,14,19
HND-011507,2011,131600003,,,,9,12,21
HND-011508,2011,131600004,,,,8,5,13
HND-011509,2011,131600005,,,,10,8,18
HND-011510,2011,131600006,,,,8,5,13
HND-011511,2011,131600007,,,,6,9,15
HND-011514,2011,131600010,,,,9,6,15
HND-011515,2011,131600011,,,,9,9,18
HND-011516,2011,131600012,,,,1,6,7
HND-011517,2011,131600013,,,,4,5,9
HND-011518,2011,131600014,,,,6,5,11
HND-011520,2011,131600016,,,,5,5,10
HND-011521,2011,131600017,,,,6,16,22
HND-011533,2011,131600040,,,,4,4,8
HND-011534,2011,131600041,,,,1,4,5
HND-011536,2011,131600043,,,,4,3,7
HND-011538,2011,131600045,,,,6,5,11
HND-011539,2011,131600046,,,,8,12,20
HND-011540,2011,131600047,,,,2,5,7
HND-011541,2011,131600048,,,,3,3,6
HND-011542,2011,131600049,,,,2,5,7
HND-011506,2011,131600002,,,,23,21,44
HND-011512,2011,131600008,,,,5,2,7
HND-011513,2011,131600009,,,,8,6,14
HND-011519,2011,131600015,,,,2,4,6
HND-011522,2011,131600018,,,,9,6,15
HND-011523,2011,131600019,,,,5,8,13
HND-011524,2011,131600020,,,,7,6,13
HND-011530,2011,131600026,,,,4,10,14
HND-011535,2011,131600042,,,,2,3,5
HND-011537,2011,131600044,,,,5,1,6
HND-011550,2011,131600167,,,,1,5,6
HND-011555,2011,131600199,,,,2,1,3
HND-011556,2011,131600200,,,,4,1,5
HND-011557,2011,131600201,,,,3,1,4
HND-011506,2011,131600002,,,,33,19,52
HND-011507,2011,131600003,,,,7,8,15
HND-011509,2011,131600005,,,,11,13,24
HND-011511,2011,131600007,,,,5,16,21
HND-011512,2011,131600008,,,,2,5,7
HND-011516,2011,131600012,,,,5,5,10
HND-011517,2011,131600013,,,,6,3,9
HND-011518,2011,131600014,,,,5,12,17
HND-011519,2011,131600015,,,,4,3,7
HND-011521,2011,131600017,,,,9,9,18
HND-011522,2011,131600018,,,,6,8,14
HND-011524,2011,131600020,,,,13,8,21
HND-011530,2011,131600026,,,,13,10,23
HND-011533,2011,131600040,,,,1,2,3
HND-011534,2011,131600041,,,,3,5,8
HND-011535,2011,131600042,,,,4,1,5
HND-011539,2011,131600046,,,,6,9,15
HND-011550,2011,131600167,,,,1,6,7
HND-011505,2011,131600001,,,,7,9,16
HND-011508,2011,131600004,,,,6,4,10
HND-011510,2011,131600006,,,,14,7,21
HND-011513,2011,131600009,,,,3,5,8
HND-011514,2011,131600010,,,,8,4,12
HND-011515,2011,131600011,,,,12,11,23
HND-011520,2011,131600016,,,,3,7,10
HND-011523,2011,131600019,,,,5,8,13
HND-011536,2011,131600043,,,,2,6,8
HND-011537,2011,131600044,,,,4,5,9
HND-011538,2011,131600045,,,,4,0,4
HND-011540,2011,131600047,,,,3,0,3
HND-011541,2011,131600048,,,,5,6,11
HND-011542,2011,131600049,,,,2,2,4
HND-011555,2011,131600199,,,,2,2,4
HND-011556,2011,131600200,,,,3,7,10
HND-011557,2011,131600201,,,,4,8,12
HND-011506,2011,131600002,,,,24,17,41
HND-011509,2011,131600005,,,,7,10,17
HND-011511,2011,131600007,,,,10,9,19
HND-011512,2011,131600008,,,,3,2,5
HND-011513,2011,131600009,,,,0,2,2
HND-011517,2011,131600013,,,,2,5,7
HND-011519,2011,131600015,,,,2,4,6
HND-011521,2011,131600017,,,,11,5,16
HND-011522,2011,131600018,,,,2,6,8
HND-011523,2011,131600019,,,,4,7,11
HND-011524,2011,131600020,,,,14,7,21
HND-011530,2011,131600026,,,,6,5,11
HND-011533,2011,131600040,,,,6,1,7
HND-011534,2011,131600041,,,,5,3,8
HND-011535,2011,131600042,,,,6,4,10
HND-011539,2011,131600046,,,,3,6,9
HND-011550,2011,131600167,,,,2,3,5
HND-011555,2011,131600199,,,,1,8,9
HND-011557,2011,131600201,,,,0,1,1
HND-011505,2011,131600001,,,,2,7,9
HND-011507,2011,131600003,,,,7,6,13
HND-011508,2011,131600004,,,,5,10,15
HND-011510,2011,131600006,,,,9,9,18
HND-011514,2011,131600010,,,,3,2,5
HND-011515,2011,131600011,,,,4,8,12
HND-011516,2011,131600012,,,,3,10,13
HND-011518,2011,131600014,,,,5,4,9
HND-011520,2011,131600016,,,,4,8,12
HND-011536,2011,131600043,,,,0,5,5
HND-011537,2011,131600044,,,,3,4,7
HND-011538,2011,131600045,,,,3,4,7
HND-011540,2011,131600047,,,,3,8,11
HND-011541,2011,131600048,,,,4,5,9
HND-011542,2011,131600049,,,,3,4,7
HND-011505,2011,131600001,,,,3,9,12
HND-011510,2011,131600006,,,,9,6,15
HND-011513,2011,131600009,,,,2,4,6
HND-011520,2011,131600016,,,,4,5,9
HND-011523,2011,131600019,,,,2,2,4
HND-011535,2011,131600042,,,,2,0,2
HND-011536,2011,131600043,,,,5,1,6
HND-011537,2011,131600044,,,,0,3,3
HND-011538,2011,131600045,,,,3,3,6
HND-011540,2011,131600047,,,,3,1,4
HND-011506,2011,131600002,,,,23,15,38
HND-011507,2011,131600003,,,,8,7,15
HND-011508,2011,131600004,,,,6,7,13
HND-011509,2011,131600005,,,,10,11,21
HND-011511,2011,131600007,,,,4,10,14
HND-011512,2011,131600008,,,,2,0,2
HND-011516,2011,131600012,,,,4,4,8
HND-011517,2011,131600013,,,,3,4,7
HND-011518,2011,131600014,,,,7,3,10
HND-011519,2011,131600015,,,,2,2,4
HND-011521,2011,131600017,,,,3,4,7
HND-011522,2011,131600018,,,,6,3,9
HND-011524,2011,131600020,,,,7,7,14
HND-011530,2011,131600026,,,,6,6,12
HND-011533,2011,131600040,,,,3,0,3
HND-011534,2011,131600041,,,,3,1,4
HND-011539,2011,131600046,,,,2,7,9
HND-011541,2011,131600048,,,,2,3,5
HND-011542,2011,131600049,,,,2,3,5
HND-011555,2011,131600199,,,,1,0,1
HND-011557,2011,131600201,,,,3,2,5
HND-011506,2011,131600002,,,,26,24,50
HND-011509,2011,131600005,,,,6,11,17
HND-011507,2011,131600003,,,,3,5,8
HND-011508,2011,131600004,,,,4,10,14
HND-011510,2011,131600006,,,,2,4,6
HND-011506,2011,131600002,,,,19,16,35
HND-011507,2011,131600003,,,,3,2,5
HND-011508,2011,131600004,,,,8,9,17
HND-011509,2011,131600005,,,,3,8,11
HND-011510,2011,131600006,,,,5,3,8
HND-011506,2011,131600002,,,,10,29,39
HND-011507,2011,131600003,,,,8,3,11
HND-011508,2011,131600004,,,,4,6,10
HND-011509,2011,131600005,,,,5,7,12
HND-011510,2011,131600006,,,,2,6,8
HND-011554,2011,131600198,,,,13,9,22
HND-011554,2011,131600198,,,,11,9,20
HND-011554,2011,131600198,,,,9,7,16
,2011,131700048,,,,4,5,9
,2011,131700095,,,,4,4,8
,2011,131700098,,,,1,4,5
,2011,131700099,,,,3,5,8
HND-011594,2011,131700046,,,,6,9,15
,2011,131700047,,,,5,2,7
,2011,131700052,,,,18,14,32
,2011,131700093,,,,2,5,7
,2011,131700094,,,,2,6,8
,2011,131700096,,,,4,8,12
,2011,131700097,,,,4,0,4
HND-011587,2011,131700025,,,,2,3,5
,2011,131700040,,,,4,0,4
,2011,131700041,,,,5,3,8
,2011,131700042,,,,1,2,3
HND-011596,2011,131700079,,,,1,1,2
,2011,131700092,,,,2,3,5
HND-011581,2011,131700017,,,,8,8,16
HND-011584,2011,131700021,,,,0,2,2
HND-011583,2011,131700020,,,,2,4,6
HND-011584,2011,131700021,,,,1,4,5
HND-011585,2011,131700022,,,,12,4,16
HND-011588,2011,131700026,,,,2,3,5
,2011,131700040,,,,2,6,8
,2011,131700041,,,,2,3,5
,2011,131700078,,,,1,0,1
HND-011596,2011,131700079,,,,1,2,3
HND-011581,2011,131700017,,,,9,9,18
HND-011586,2011,131700023,,,,4,4,8
HND-011587,2011,131700025,,,,2,4,6
,2011,131700042,,,,3,4,7
,2011,131700092,,,,2,5,7
HND-011581,2011,131700017,,,,8,12,20
HND-011587,2011,131700025,,,,6,3,9
,2011,131700040,,,,0,3,3
,2011,131700041,,,,3,2,5
,2011,131700078,,,,7,3,10
HND-011596,2011,131700079,,,,4,8,12
HND-011583,2011,131700020,,,,7,2,9
HND-011584,2011,131700021,,,,6,8,14
HND-011585,2011,131700022,,,,12,10,22
HND-011586,2011,131700023,,,,13,3,16
HND-011588,2011,131700026,,,,8,4,12
,2011,131700042,,,,5,5,10
,2011,131700092,,,,1,1,2
HND-011567,2011,131700003,,,,15,11,26
HND-011570,2011,131700006,,,,11,15,26
HND-011573,2011,131700009,,,,8,15,23
HND-011574,2011,131700010,,,,3,8,11
HND-011575,2011,131700011,,,,8,7,15
HND-011589,2011,131700028,,,,2,7,9
HND-011590,2011,131700029,,,,6,5,11
HND-011591,2011,131700030,,,,6,3,9
HND-011592,2011,131700031,,,,5,4,9
HND-011595,2011,131700077,,,,1,4,5
HND-011566,2011,131700002,,,,4,8,12
HND-011568,2011,131700004,,,,8,8,16
HND-011569,2011,131700005,,,,15,22,37
HND-011571,2011,131700007,,,,5,5,10
HND-011572,2011,131700008,,,,10,9,19
HND-011576,2011,131700012,,,,8,3,11
HND-011577,2011,131700013,,,,3,0,3
HND-011578,2011,131700014,,,,6,6,12
HND-011579,2011,131700015,,,,10,4,14
HND-011593,2011,131700043,,,,7,4,11
HND-011567,2011,131700003,,,,13,11,24
HND-011569,2011,131700005,,,,18,14,32
HND-011571,2011,131700007,,,,1,5,6
HND-011572,2011,131700008,,,,11,9,20
HND-011573,2011,131700009,,,,9,6,15
HND-011579,2011,131700015,,,,2,6,8
HND-011589,2011,131700028,,,,5,3,8
HND-011590,2011,131700029,,,,7,5,12
HND-011591,2011,131700030,,,,4,5,9
HND-011592,2011,131700031,,,,2,1,3
HND-011593,2011,131700043,,,,2,1,3
HND-011595,2011,131700077,,,,2,2,4
HND-011566,2011,131700002,,,,5,6,11
HND-011568,2011,131700004,,,,7,7,14
HND-011570,2011,131700006,,,,9,12,21
HND-011574,2011,131700010,,,,6,12,18
HND-011575,2011,131700011,,,,6,5,11
HND-011576,2011,131700012,,,,5,8,13
HND-011577,2011,131700013,,,,3,1,4
HND-011578,2011,131700014,,,,5,6,11
HND-011580,2011,131700016,,,,2,2,4
HND-011566,2011,131700002,,,,12,11,23
HND-011568,2011,131700004,,,,8,6,14
HND-011569,2011,131700005,,,,12,18,30
HND-011571,2011,131700007,,,,4,1,5
HND-011572,2011,131700008,,,,11,9,20
HND-011576,2011,131700012,,,,2,3,5
HND-011577,2011,131700013,,,,2,4,6
HND-011578,2011,131700014,,,,7,8,15
HND-011579,2011,131700015,,,,8,9,17
HND-011591,2011,131700030,,,,7,3,10
HND-011592,2011,131700031,,,,4,7,11
HND-011595,2011,131700077,,,,5,0,5
HND-011567,2011,131700003,,,,15,17,32
HND-011570,2011,131700006,,,,15,11,26
HND-011573,2011,131700009,,,,2,8,10
HND-011574,2011,131700010,,,,9,5,14
HND-011575,2011,131700011,,,,8,7,15
HND-011580,2011,131700016,,,,2,1,3
HND-011589,2011,131700028,,,,3,2,5
HND-011590,2011,131700029,,,,5,8,13
HND-011593,2011,131700043,,,,1,5,6
HND-011567,2011,131700003,,,,14,12,26
HND-011572,2011,131700008,,,,16,14,30
HND-011573,2011,131700009,,,,9,8,17
HND-011589,2011,131700028,,,,6,6,12
HND-011590,2011,131700029,,,,6,3,9
HND-011591,2011,131700030,,,,6,5,11
HND-011592,2011,131700031,,,,6,2,8
HND-011593,2011,131700043,,,,2,5,7
HND-011566,2011,131700002,,,,11,7,18
HND-011568,2011,131700004,,,,9,5,14
HND-011569,2011,131700005,,,,9,16,25
HND-011570,2011,131700006,,,,12,10,22
HND-011571,2011,131700007,,,,4,8,12
HND-011574,2011,131700010,,,,8,6,14
HND-011575,2011,131700011,,,,7,4,11
HND-011576,2011,131700012,,,,5,8,13
HND-011577,2011,131700013,,,,2,2,4
HND-011578,2011,131700014,,,,7,4,11
HND-011579,2011,131700015,,,,8,7,15
HND-011580,2011,131700016,,,,1,1,2
HND-011595,2011,131700077,,,,3,3,6
HND-011567,2011,131700003,,,,18,18,36
HND-011570,2011,131700006,,,,6,7,13
HND-011572,2011,131700008,,,,11,15,26
HND-011573,2011,131700009,,,,13,9,22
HND-011574,2011,131700010,,,,4,6,10
HND-011575,2011,131700011,,,,8,12,20
HND-011589,2011,131700028,,,,3,6,9
HND-011590,2011,131700029,,,,3,1,4
HND-011591,2011,131700030,,,,8,6,14
HND-011592,2011,131700031,,,,4,5,9
HND-011593,2011,131700043,,,,2,2,4
HND-011566,2011,131700002,,,,5,5,10
HND-011568,2011,131700004,,,,7,8,15
HND-011569,2011,131700005,,,,16,14,30
HND-011571,2011,131700007,,,,4,8,12
HND-011576,2011,131700012,,,,6,7,13
HND-011578,2011,131700014,,,,2,6,8
HND-011579,2011,131700015,,,,7,5,12
HND-011595,2011,131700077,,,,4,4,8
HND-011566,2011,131700002,,,,8,7,15
HND-011568,2011,131700004,,,,10,1,11
HND-011570,2011,131700006,,,,6,6,12
HND-011574,2011,131700010,,,,2,7,9
HND-011575,2011,131700011,,,,8,4,12
HND-011576,2011,131700012,,,,2,6,8
HND-011578,2011,131700014,,,,7,8,15
HND-011580,2011,131700016,,,,2,0,2
HND-011567,2011,131700003,,,,18,16,34
HND-011569,2011,131700005,,,,13,11,24
HND-011571,2011,131700007,,,,3,9,12
HND-011572,2011,131700008,,,,9,10,19
HND-011573,2011,131700009,,,,14,15,29
HND-011579,2011,131700015,,,,6,1,7
HND-011589,2011,131700028,,,,2,5,7
HND-011590,2011,131700029,,,,6,1,7
HND-011591,2011,131700030,,,,5,5,10
HND-011592,2011,131700031,,,,2,2,4
HND-011593,2011,131700043,,,,2,2,4
HND-011595,2011,131700077,,,,2,1,3
HND-011573,2011,131700009,,,,11,9,20
HND-011582,2011,131700019,,,,64,51,115
HND-011573,2011,131700009,,,,4,7,11
HND-011582,2011,131700019,,,,43,45,88
HND-011573,2011,131700009,,,,4,2,6
HND-011582,2011,131700019,,,,32,32,64
HND-011582,2011,131700019,,,,28,29,57
HND-011582,2011,131700019,,,,25,26,51
HND-011582,2011,131700019,,,,15,13,28
,2011,131800019,,,,8,1,9
,2011,131800017,,,,7,2,9
,2011,131800024,,,,3,2,5
,2011,131800026,,,,3,2,5
,2011,131800027,,,,3,2,5
HND-011608,2011,131800012,,,,1,2,3
HND-011609,2011,131800014,,,,0,5,5
HND-011607,2011,131800011,,,,6,0,6
HND-011610,2011,131800015,,,,2,1,3
HND-011612,2011,131800025,,,,0,2,2
HND-011612,2011,131800025,,,,4,2,6
HND-011607,2011,131800011,,,,5,1,6
HND-011608,2011,131800012,,,,4,1,5
HND-011609,2011,131800014,,,,2,3,5
HND-011610,2011,131800015,,,,9,8,17
HND-011607,2011,131800011,,,,2,2,4
HND-011608,2011,131800012,,,,5,1,6
HND-011609,2011,131800014,,,,8,1,9
HND-011610,2011,131800015,,,,6,8,14
HND-011612,2011,131800025,,,,4,3,7
HND-011597,2011,131800001,,,,8,1,9
HND-011599,2011,131800003,,,,6,4,10
HND-011601,2011,131800005,,,,12,3,15
HND-011603,2011,131800007,,,,5,6,11
HND-011606,2011,131800010,,,,1,1,2
HND-011611,2011,131800016,,,,2,1,3
HND-011600,2011,131800004,,,,1,4,5
HND-011597,2011,131800001,,,,5,5,10
HND-011598,2011,131800002,,,,2,3,5
HND-011599,2011,131800003,,,,4,1,5
HND-011600,2011,131800004,,,,6,2,8
HND-011601,2011,131800005,,,,8,7,15
HND-011602,2011,131800006,,,,6,4,10
HND-011603,2011,131800007,,,,5,2,7
HND-011611,2011,131800016,,,,2,3,5
HND-011604,2011,131800008,,,,2,2,4
HND-011605,2011,131800009,,,,3,3,6
HND-011600,2011,131800004,,,,4,6,10
HND-011602,2011,131800006,,,,3,7,10
HND-011597,2011,131800001,,,,6,2,8
HND-011599,2011,131800003,,,,5,6,11
HND-011601,2011,131800005,,,,6,10,16
HND-011603,2011,131800007,,,,6,5,11
HND-011604,2011,131800008,,,,3,0,3
HND-011605,2011,131800009,,,,7,2,9
HND-011606,2011,131800010,,,,4,7,11
HND-011597,2011,131800001,,,,4,9,13
HND-011598,2011,131800002,,,,2,5,7
HND-011599,2011,131800003,,,,8,8,16
HND-011600,2011,131800004,,,,5,7,12
HND-011601,2011,131800005,,,,9,7,16
HND-011603,2011,131800007,,,,7,2,9
HND-011611,2011,131800016,,,,2,1,3
HND-011605,2011,131800009,,,,2,0,2
HND-011597,2011,131800001,,,,6,8,14
HND-011598,2011,131800002,,,,2,1,3
HND-011599,2011,131800003,,,,2,3,5
HND-011601,2011,131800005,,,,10,15,25
HND-011603,2011,131800007,,,,4,6,10
HND-011604,2011,131800008,,,,2,3,5
HND-011606,2011,131800010,,,,0,3,3
HND-011611,2011,131800016,,,,3,2,5
HND-011602,2011,131800006,,,,5,11,16
HND-011605,2011,131800009,,,,2,6,8
HND-011604,2011,131800008,,,,1,2,3
HND-011605,2011,131800009,,,,1,0,1
HND-011597,2011,131800001,,,,7,7,14
HND-011598,2011,131800002,,,,2,4,6
HND-011599,2011,131800003,,,,5,10,15
HND-011600,2011,131800004,,,,2,1,3
HND-011601,2011,131800005,,,,5,4,9
HND-011602,2011,131800006,,,,2,4,6
HND-011603,2011,131800007,,,,7,5,12
HND-011606,2011,131800010,,,,1,2,3
HND-011601,2011,131800005,,,,0,6,6
HND-011603,2011,131800007,,,,1,3,4
HND-011601,2011,131800005,,,,0,2,2
HND-011603,2011,131800007,,,,5,7,12
HND-011601,2011,131800005,,,,1,3,4
HND-011603,2011,131800007,,,,3,4,7
HND-011652,2011,131900085,,,,3,3,6
HND-011653,2011,131900091,,,,9,19,28
,2011,131900129,,,,9,10,19
,2011,131900130,,,,2,4,6
HND-011659,2011,131900133,,,,8,3,11
HND-011661,2011,131900139,,,,11,6,17
HND-011663,2011,131900144,,,,4,3,7
HND-011666,2011,131900200,,,,4,1,5
HND-011667,2011,131900204,,,,3,5,8
HND-011668,2011,131900206,,,,3,2,5
,2011,131900226,,,,4,6,10
,2011,131900235,,,,4,3,7
,2011,131900048,,,,7,3,10
,2011,131900125,,,,9,5,14
,2011,131900127,,,,4,6,10
HND-011658,2011,131900128,,,,10,4,14
,2011,131900131,,,,9,6,15
,2011,131900134,,,,3,3,6
,2011,131900136,,,,10,3,13
,2011,131900137,,,,5,7,12
HND-011660,2011,131900138,,,,8,5,13
,2011,131900140,,,,6,3,9
,2011,131900141,,,,3,8,11
,2011,131900142,,,,2,3,5
HND-011662,2011,131900143,,,,7,6,13
,2011,131900203,,,,2,3,5
,2011,131900205,,,,3,2,5
,2011,131900207,,,,4,2,6
HND-011671,2011,131900227,,,,2,2,4
,2011,131900228,,,,6,4,10
,2011,131900229,,,,3,2,5
HND-011672,2011,131900230,,,,5,4,9
HND-011638,2011,131900030,,,,4,4,8
HND-011673,2011,131900234,,,,1,1,2
HND-011637,2011,131900028,,,,0,3,3
,2011,131900078,,,,3,0,3
HND-011651,2011,131900079,,,,3,2,5
,2011,131900233,,,,1,0,1
HND-011637,2011,131900028,,,,7,5,12
HND-011638,2011,131900030,,,,2,3,5
,2011,131900031,,,,14,21,35
HND-011651,2011,131900079,,,,6,1,7
,2011,131900233,,,,4,6,10
HND-011673,2011,131900234,,,,3,3,6
HND-011643,2011,131900043,,,,3,3,6
,2011,131900078,,,,4,3,7
HND-011637,2011,131900028,,,,6,4,10
HND-011638,2011,131900030,,,,7,3,10
,2011,131900031,,,,14,12,26
HND-011643,2011,131900043,,,,7,6,13
,2011,131900078,,,,1,0,1
HND-011651,2011,131900079,,,,4,2,6
,2011,131900233,,,,11,8,19
HND-011673,2011,131900234,,,,9,6,15
HND-011614,2011,131900003,,,,12,9,21
HND-011615,2011,131900004,,,,6,12,18
HND-011616,2011,131900005,,,,14,16,30
HND-011618,2011,131900007,,,,11,7,18
HND-011619,2011,131900008,,,,14,7,21
HND-011621,2011,131900010,,,,1,0,1
HND-011622,2011,131900011,,,,4,9,13
HND-011627,2011,131900016,,,,6,5,11
HND-011629,2011,131900018,,,,10,8,18
,2011,131900019,,,,8,7,15
HND-011630,2011,131900020,,,,6,5,11
HND-011631,2011,131900021,,,,6,3,9
HND-011632,2011,131900022,,,,7,3,10
HND-011634,2011,131900024,,,,5,6,11
HND-011635,2011,131900026,,,,4,3,7
HND-011639,2011,131900038,,,,10,9,19
HND-011646,2011,131900071,,,,7,6,13
HND-011647,2011,131900074,,,,4,4,8
HND-011649,2011,131900076,,,,11,6,17
HND-011650,2011,131900077,,,,1,2,3
HND-011655,2011,131900095,,,,9,6,15
HND-011657,2011,131900097,,,,2,2,4
HND-011664,2011,131900198,,,,1,4,5
HND-011613,2011,131900001,,,,17,8,25
HND-011617,2011,131900006,,,,8,15,23
HND-011620,2011,131900009,,,,12,9,21
HND-011623,2011,131900012,,,,4,4,8
HND-011624,2011,131900013,,,,6,7,13
HND-011625,2011,131900014,,,,4,4,8
HND-011626,2011,131900015,,,,4,4,8
HND-011628,2011,131900017,,,,12,6,18
HND-011633,2011,131900023,,,,6,4,10
HND-011636,2011,131900027,,,,9,5,14
HND-011640,2011,131900040,,,,3,5,8
HND-011641,2011,131900041,,,,4,5,9
HND-011642,2011,131900042,,,,8,1,9
HND-011644,2011,131900047,,,,4,5,9
HND-011645,2011,131900065,,,,14,11,25
HND-011648,2011,131900075,,,,2,5,7
HND-011654,2011,131900094,,,,3,1,4
HND-011656,2011,131900096,,,,6,1,7
HND-011665,2011,131900199,,,,3,8,11
HND-011669,2011,131900224,,,,5,4,9
HND-011670,2011,131900225,,,,5,3,8
HND-011613,2011,131900001,,,,13,16,29
HND-011615,2011,131900004,,,,10,3,13
HND-011617,2011,131900006,,,,3,5,8
HND-011624,2011,131900013,,,,7,10,17
HND-011626,2011,131900015,,,,4,2,6
HND-011628,2011,131900017,,,,6,7,13
HND-011629,2011,131900018,,,,3,3,6
HND-011640,2011,131900040,,,,7,5,12
HND-011641,2011,131900041,,,,2,4,6
HND-011647,2011,131900074,,,,4,2,6
HND-011648,2011,131900075,,,,2,2,4
HND-011650,2011,131900077,,,,6,1,7
HND-011664,2011,131900198,,,,4,0,4
HND-011669,2011,131900224,,,,0,1,1
HND-011614,2011,131900003,,,,8,10,18
HND-011616,2011,131900005,,,,9,10,19
HND-011618,2011,131900007,,,,9,7,16
HND-011619,2011,131900008,,,,7,4,11
HND-011620,2011,131900009,,,,10,11,21
HND-011621,2011,131900010,,,,7,6,13
HND-011622,2011,131900011,,,,5,5,10
HND-011623,2011,131900012,,,,7,9,16
HND-011625,2011,131900014,,,,8,5,13
HND-011627,2011,131900016,,,,6,5,11
,2011,131900019,,,,5,7,12
HND-011630,2011,131900020,,,,6,4,10
HND-011631,2011,131900021,,,,8,10,18
HND-011632,2011,131900022,,,,0,7,7
HND-011633,2011,131900023,,,,4,2,6
HND-011634,2011,131900024,,,,2,6,8
HND-011636,2011,131900027,,,,5,5,10
HND-011639,2011,131900038,,,,3,2,5
HND-011642,2011,131900042,,,,1,3,4
HND-011644,2011,131900047,,,,3,4,7
HND-011645,2011,131900065,,,,16,15,31
HND-011646,2011,131900071,,,,9,7,16
HND-011649,2011,131900076,,,,5,2,7
HND-011654,2011,131900094,,,,3,4,7
HND-011655,2011,131900095,,,,1,5,6
HND-011656,2011,131900096,,,,2,3,5
HND-011657,2011,131900097,,,,3,0,3
HND-011665,2011,131900199,,,,7,3,10
HND-011670,2011,131900225,,,,2,4,6
HND-011613,2011,131900001,,,,20,18,38
HND-011617,2011,131900006,,,,2,11,13
HND-011620,2011,131900009,,,,8,10,18
HND-011623,2011,131900012,,,,9,6,15
HND-011624,2011,131900013,,,,6,9,15
HND-011625,2011,131900014,,,,4,7,11
HND-011626,2011,131900015,,,,5,4,9
HND-011628,2011,131900017,,,,6,9,15
HND-011636,2011,131900027,,,,8,7,15
HND-011639,2011,131900038,,,,3,4,7
HND-011645,2011,131900065,,,,17,14,31
HND-011646,2011,131900071,,,,4,6,10
HND-011647,2011,131900074,,,,5,1,6
HND-011649,2011,131900076,,,,5,4,9
HND-011650,2011,131900077,,,,0,3,3
HND-011655,2011,131900095,,,,1,6,7
HND-011657,2011,131900097,,,,1,2,3
HND-011665,2011,131900199,,,,7,4,11
HND-011614,2011,131900003,,,,7,11,18
HND-011615,2011,131900004,,,,12,11,23
HND-011616,2011,131900005,,,,12,15,27
HND-011618,2011,131900007,,,,11,10,21
HND-011619,2011,131900008,,,,2,7,9
HND-011621,2011,131900010,,,,4,3,7
HND-011622,2011,131900011,,,,9,5,14
HND-011627,2011,131900016,,,,4,5,9
HND-011629,2011,131900018,,,,8,3,11
,2011,131900019,,,,8,4,12
HND-011630,2011,131900020,,,,9,4,13
HND-011631,2011,131900021,,,,8,7,15
HND-011632,2011,131900022,,,,4,3,7
HND-011633,2011,131900023,,,,6,5,11
HND-011634,2011,131900024,,,,8,4,12
HND-011635,2011,131900026,,,,2,3,5
HND-011640,2011,131900040,,,,5,2,7
HND-011641,2011,131900041,,,,7,6,13
HND-011642,2011,131900042,,,,2,4,6
HND-011644,2011,131900047,,,,2,6,8
HND-011648,2011,131900075,,,,2,1,3
HND-011654,2011,131900094,,,,2,2,4
HND-011656,2011,131900096,,,,1,0,1
HND-011664,2011,131900198,,,,4,5,9
HND-011669,2011,131900224,,,,2,2,4
HND-011670,2011,131900225,,,,3,2,5
HND-011613,2011,131900001,,,,10,20,30
HND-011614,2011,131900003,,,,16,14,30
HND-011615,2011,131900004,,,,10,12,22
HND-011616,2011,131900005,,,,10,11,21
HND-011617,2011,131900006,,,,12,8,20
HND-011618,2011,131900007,,,,9,6,15
HND-011626,2011,131900015,,,,2,6,8
HND-011628,2011,131900017,,,,7,8,15
HND-011629,2011,131900018,,,,5,5,10
,2011,131900019,,,,5,9,14
HND-011630,2011,131900020,,,,6,6,12
HND-011631,2011,131900021,,,,6,5,11
HND-011635,2011,131900026,,,,1,3,4
HND-011640,2011,131900040,,,,2,3,5
HND-011641,2011,131900041,,,,3,8,11
HND-011647,2011,131900074,,,,3,4,7
HND-011648,2011,131900075,,,,1,2,3
HND-011650,2011,131900077,,,,4,2,6
HND-011656,2011,131900096,,,,0,2,2
HND-011664,2011,131900198,,,,3,2,5
HND-011669,2011,131900224,,,,3,3,6
HND-011670,2011,131900225,,,,3,4,7
HND-011619,2011,131900008,,,,3,2,5
HND-011620,2011,131900009,,,,9,15,24
HND-011621,2011,131900010,,,,3,4,7
HND-011622,2011,131900011,,,,7,6,13
HND-011623,2011,131900012,,,,7,8,15
HND-011624,2011,131900013,,,,6,7,13
HND-011625,2011,131900014,,,,16,2,18
HND-011627,2011,131900016,,,,5,4,9
HND-011632,2011,131900022,,,,4,6,10
HND-011633,2011,131900023,,,,4,1,5
HND-011634,2011,131900024,,,,5,9,14
HND-011636,2011,131900027,,,,9,4,13
HND-011639,2011,131900038,,,,5,4,9
HND-011642,2011,131900042,,,,6,3,9
HND-011644,2011,131900047,,,,4,4,8
HND-011645,2011,131900065,,,,10,21,31
HND-011646,2011,131900071,,,,6,9,15
HND-011649,2011,131900076,,,,7,3,10
HND-011654,2011,131900094,,,,1,0,1
HND-011655,2011,131900095,,,,10,7,17
HND-011657,2011,131900097,,,,3,3,6
HND-011665,2011,131900199,,,,6,3,9
HND-011614,2011,131900003,,,,8,11,19
HND-011615,2011,131900004,,,,13,10,23
HND-011616,2011,131900005,,,,7,6,13
HND-011618,2011,131900007,,,,5,8,13
HND-011629,2011,131900018,,,,4,6,10
,2011,131900019,,,,6,4,10
HND-011630,2011,131900020,,,,9,7,16
HND-011631,2011,131900021,,,,8,7,15
HND-011632,2011,131900022,,,,5,3,8
HND-011634,2011,131900024,,,,4,7,11
HND-011635,2011,131900026,,,,3,4,7
HND-011640,2011,131900040,,,,8,7,15
HND-011641,2011,131900041,,,,3,9,12
HND-011642,2011,131900042,,,,2,4,6
HND-011648,2011,131900075,,,,3,2,5
HND-011650,2011,131900077,,,,3,1,4
HND-011656,2011,131900096,,,,1,3,4
HND-011664,2011,131900198,,,,6,3,9
HND-011669,2011,131900224,,,,3,4,7
HND-011670,2011,131900225,,,,3,3,6
HND-011613,2011,131900001,,,,14,4,18
HND-011617,2011,131900006,,,,9,9,18
HND-011619,2011,131900008,,,,6,4,10
HND-011620,2011,131900009,,,,7,7,14
HND-011621,2011,131900010,,,,6,0,6
HND-011622,2011,131900011,,,,4,2,6
HND-011623,2011,131900012,,,,4,5,9
HND-011624,2011,131900013,,,,5,3,8
HND-011625,2011,131900014,,,,3,8,11
HND-011626,2011,131900015,,,,5,0,5
HND-011627,2011,131900016,,,,4,3,7
HND-011628,2011,131900017,,,,8,9,17
HND-011633,2011,131900023,,,,1,1,2
HND-011636,2011,131900027,,,,6,7,13
HND-011639,2011,131900038,,,,1,5,6
HND-011644,2011,131900047,,,,3,1,4
HND-011645,2011,131900065,,,,15,10,25
HND-011646,2011,131900071,,,,0,1,1
HND-011647,2011,131900074,,,,3,1,4
HND-011649,2011,131900076,,,,7,2,9
HND-011654,2011,131900094,,,,1,1,2
HND-011655,2011,131900095,,,,3,2,5
HND-011657,2011,131900097,,,,1,2,3
HND-011665,2011,131900199,,,,3,6,9
HND-011614,2011,131900003,,,,11,10,21
HND-011616,2011,131900005,,,,12,10,22
HND-011618,2011,131900007,,,,9,3,12
HND-011619,2011,131900008,,,,0,2,2
HND-011620,2011,131900009,,,,5,4,9
HND-011621,2011,131900010,,,,3,4,7
HND-011622,2011,131900011,,,,1,3,4
HND-011623,2011,131900012,,,,5,5,10
HND-011625,2011,131900014,,,,7,6,13
HND-011627,2011,131900016,,,,2,4,6
,2011,131900019,,,,4,6,10
HND-011630,2011,131900020,,,,4,4,8
HND-011631,2011,131900021,,,,5,7,12
HND-011632,2011,131900022,,,,2,3,5
HND-011633,2011,131900023,,,,1,5,6
HND-011634,2011,131900024,,,,6,4,10
HND-011636,2011,131900027,,,,6,4,10
HND-011639,2011,131900038,,,,4,1,5
HND-011642,2011,131900042,,,,3,3,6
HND-011644,2011,131900047,,,,2,4,6
HND-011645,2011,131900065,,,,19,8,27
HND-011646,2011,131900071,,,,4,7,11
HND-011649,2011,131900076,,,,8,3,11
HND-011654,2011,131900094,,,,3,0,3
HND-011655,2011,131900095,,,,1,4,5
HND-011656,2011,131900096,,,,3,2,5
HND-011657,2011,131900097,,,,2,4,6
HND-011664,2011,131900198,,,,3,0,3
HND-011670,2011,131900225,,,,2,0,2
HND-011613,2011,131900001,,,,8,12,20
HND-011615,2011,131900004,,,,5,9,14
HND-011617,2011,131900006,,,,4,7,11
HND-011624,2011,131900013,,,,3,11,14
HND-011626,2011,131900015,,,,6,2,8
HND-011628,2011,131900017,,,,6,7,13
HND-011629,2011,131900018,,,,10,8,18
HND-011635,2011,131900026,,,,1,2,3
HND-011640,2011,131900040,,,,4,3,7
HND-011641,2011,131900041,,,,6,2,8
HND-011647,2011,131900074,,,,3,2,5
HND-011648,2011,131900075,,,,1,1,2
HND-011650,2011,131900077,,,,1,1,2
HND-011665,2011,131900199,,,,4,7,11
HND-011669,2011,131900224,,,,2,0,2
HND-011613,2011,131900001,,,,11,5,16
HND-011645,2011,131900065,,,,25,26,51
HND-011613,2011,131900001,,,,9,8,17
HND-011645,2011,131900065,,,,44,46,90
HND-011613,2011,131900001,,,,8,6,14
HND-011645,2011,131900065,,,,32,19,51
HND-011705,2011,132000055,,,,3,3,6
HND-011708,2011,132000060,,,,5,3,8
,2011,132000063,,,,4,1,5
HND-011709,2011,132000064,,,,8,10,18
HND-011715,2011,132000074,,,,7,2,9
,2011,132000075,,,,4,5,9
,2011,132000077,,,,4,1,5
HND-011717,2011,132000080,,,,9,4,13
,2011,132000081,,,,3,3,6
HND-011718,2011,132000089,,,,7,7,14
,2011,132000108,,,,6,3,9
HND-011722,2011,132000128,,,,7,4,11
HND-011703,2011,132000046,,,,4,7,11
,2011,132000047,,,,3,3,6
HND-011704,2011,132000052,,,,10,7,17
HND-011714,2011,132000073,,,,6,4,10
HND-011716,2011,132000076,,,,3,4,7
,2011,132000079,,,,4,9,13
HND-011720,2011,132000107,,,,3,4,7
,2011,132000109,,,,4,3,7
HND-011723,2011,132000129,,,,7,5,12
HND-011724,2011,132000130,,,,3,2,5
HND-011725,2011,132000131,,,,3,3,6
HND-011700,2011,132000042,,,,8,14,22
HND-011701,2011,132000043,,,,0,2,2
HND-011706,2011,132000057,,,,2,2,4
HND-011698,2011,132000026,,,,1,0,1
,2011,132000065,,,,1,1,2
,2011,132000068,,,,2,3,5
HND-011710,2011,132000069,,,,5,3,8
,2011,132000106,,,,1,2,3
HND-011697,2011,132000025,,,,3,4,7
HND-011700,2011,132000042,,,,7,9,16
HND-011706,2011,132000057,,,,4,3,7
HND-011710,2011,132000069,,,,0,2,2
HND-011694,2011,132000022,,,,6,3,9
HND-011696,2011,132000024,,,,5,5,10
HND-011698,2011,132000026,,,,1,8,9
HND-011701,2011,132000043,,,,5,4,9
HND-011702,2011,132000044,,,,0,5,5
,2011,132000065,,,,1,0,1
,2011,132000068,,,,2,3,5
,2011,132000106,,,,3,1,4
HND-011694,2011,132000022,,,,14,17,31
HND-011696,2011,132000024,,,,6,12,18
HND-011698,2011,132000026,,,,15,14,29
HND-011702,2011,132000044,,,,8,10,18
,2011,132000065,,,,4,10,14
,2011,132000068,,,,2,4,6
,2011,132000106,,,,1,4,5
HND-011697,2011,132000025,,,,12,8,20
HND-011700,2011,132000042,,,,13,10,23
HND-011701,2011,132000043,,,,10,15,25
HND-011706,2011,132000057,,,,5,6,11
HND-011710,2011,132000069,,,,3,5,8
HND-011675,2011,132000002,,,,14,7,21
HND-011676,2011,132000003,,,,9,12,21
HND-011681,2011,132000008,,,,18,17,35
HND-011682,2011,132000009,,,,3,4,7
HND-011683,2011,132000010,,,,3,3,6
HND-011684,2011,132000011,,,,2,4,6
HND-011687,2011,132000014,,,,1,1,2
HND-011688,2011,132000015,,,,10,10,20
HND-011689,2011,132000016,,,,11,7,18
HND-011690,2011,132000017,,,,5,2,7
HND-011692,2011,132000020,,,,6,5,11
HND-011711,2011,132000070,,,,0,2,2
HND-011712,2011,132000071,,,,3,3,6
HND-011719,2011,132000105,,,,2,2,4
HND-011721,2011,132000127,,,,4,2,6
HND-011674,2011,132000001,,,,17,10,27
HND-011677,2011,132000004,,,,7,8,15
HND-011678,2011,132000005,,,,14,18,32
HND-011679,2011,132000006,,,,14,14,28
HND-011680,2011,132000007,,,,4,7,11
HND-011685,2011,132000012,,,,5,5,10
HND-011686,2011,132000013,,,,4,2,6
HND-011691,2011,132000018,,,,14,11,25
HND-011693,2011,132000021,,,,3,4,7
HND-011699,2011,132000036,,,,7,6,13
HND-011707,2011,132000058,,,,12,14,26
HND-011713,2011,132000072,,,,5,2,7
HND-011675,2011,132000002,,,,16,9,25
HND-011678,2011,132000005,,,,15,16,31
HND-011680,2011,132000007,,,,4,10,14
HND-011683,2011,132000010,,,,11,8,19
HND-011684,2011,132000011,,,,1,1,2
HND-011686,2011,132000013,,,,1,0,1
HND-011687,2011,132000014,,,,6,7,13
HND-011689,2011,132000016,,,,17,11,28
HND-011692,2011,132000020,,,,7,2,9
HND-011693,2011,132000021,,,,2,4,6
HND-011699,2011,132000036,,,,5,5,10
HND-011707,2011,132000058,,,,8,6,14
HND-011712,2011,132000071,,,,7,2,9
HND-011721,2011,132000127,,,,4,3,7
HND-011674,2011,132000001,,,,10,9,19
HND-011676,2011,132000003,,,,11,11,22
HND-011677,2011,132000004,,,,14,10,24
HND-011679,2011,132000006,,,,16,20,36
HND-011681,2011,132000008,,,,16,12,28
HND-011682,2011,132000009,,,,5,6,11
HND-011685,2011,132000012,,,,5,2,7
HND-011688,2011,132000015,,,,10,15,25
HND-011690,2011,132000017,,,,2,8,10
HND-011691,2011,132000018,,,,10,10,20
HND-011711,2011,132000070,,,,1,3,4
HND-011713,2011,132000072,,,,2,0,2
HND-011719,2011,132000105,,,,3,5,8
HND-011674,2011,132000001,,,,14,12,26
HND-011677,2011,132000004,,,,12,3,15
HND-011678,2011,132000005,,,,8,6,14
HND-011679,2011,132000006,,,,18,14,32
HND-011680,2011,132000007,,,,4,8,12
HND-011684,2011,132000011,,,,0,7,7
HND-011685,2011,132000012,,,,3,2,5
HND-011686,2011,132000013,,,,3,3,6
HND-011693,2011,132000021,,,,3,2,5
HND-011699,2011,132000036,,,,6,1,7
HND-011707,2011,132000058,,,,13,8,21
HND-011713,2011,132000072,,,,3,4,7
HND-011675,2011,132000002,,,,9,14,23
HND-011676,2011,132000003,,,,12,9,21
HND-011681,2011,132000008,,,,18,22,40
HND-011682,2011,132000009,,,,3,4,7
HND-011683,2011,132000010,,,,5,6,11
HND-011687,2011,132000014,,,,4,3,7
HND-011688,2011,132000015,,,,11,9,20
HND-011689,2011,132000016,,,,13,12,25
HND-011690,2011,132000017,,,,1,1,2
HND-011691,2011,132000018,,,,9,9,18
HND-011692,2011,132000020,,,,1,3,4
HND-011711,2011,132000070,,,,2,2,4
HND-011712,2011,132000071,,,,2,1,3
HND-011719,2011,132000105,,,,2,6,8
HND-011721,2011,132000127,,,,1,2,3
HND-011675,2011,132000002,,,,7,8,15
HND-011678,2011,132000005,,,,30,26,56
HND-011683,2011,132000010,,,,7,8,15
HND-011684,2011,132000011,,,,4,0,4
HND-011686,2011,132000013,,,,0,1,1
HND-011687,2011,132000014,,,,2,0,2
HND-011689,2011,132000016,,,,14,8,22
HND-011690,2011,132000017,,,,6,5,11
HND-011692,2011,132000020,,,,2,5,7
HND-011693,2011,132000021,,,,8,2,10
HND-011699,2011,132000036,,,,6,4,10
HND-011711,2011,132000070,,,,3,3,6
HND-011712,2011,132000071,,,,6,0,6
HND-011719,2011,132000105,,,,3,5,8
HND-011721,2011,132000127,,,,5,2,7
HND-011674,2011,132000001,,,,6,7,13
HND-011676,2011,132000003,,,,8,14,22
HND-011677,2011,132000004,,,,7,13,20
HND-011679,2011,132000006,,,,9,13,22
HND-011680,2011,132000007,,,,4,3,7
HND-011681,2011,132000008,,,,18,13,31
HND-011682,2011,132000009,,,,4,5,9
HND-011685,2011,132000012,,,,5,6,11
HND-011688,2011,132000015,,,,9,3,12
HND-011691,2011,132000018,,,,9,3,12
HND-011707,2011,132000058,,,,9,8,17
HND-011713,2011,132000072,,,,2,4,6
HND-011675,2011,132000002,,,,14,4,18
HND-011676,2011,132000003,,,,10,11,21
HND-011678,2011,132000005,,,,12,16,28
HND-011683,2011,132000010,,,,9,11,20
HND-011684,2011,132000011,,,,1,1,2
HND-011687,2011,132000014,,,,3,2,5
HND-011688,2011,132000015,,,,5,8,13
HND-011689,2011,132000016,,,,22,7,29
HND-011690,2011,132000017,,,,1,3,4
HND-011692,2011,132000020,,,,0,3,3
HND-011699,2011,132000036,,,,4,5,9
HND-011707,2011,132000058,,,,5,12,17
HND-011713,2011,132000072,,,,1,1,2
HND-011674,2011,132000001,,,,3,11,14
HND-011677,2011,132000004,,,,6,8,14
HND-011679,2011,132000006,,,,8,15,23
HND-011680,2011,132000007,,,,2,8,10
HND-011681,2011,132000008,,,,18,22,40
HND-011682,2011,132000009,,,,2,2,4
HND-011685,2011,132000012,,,,5,3,8
HND-011686,2011,132000013,,,,2,0,2
HND-011691,2011,132000018,,,,12,8,20
HND-011693,2011,132000021,,,,3,2,5
HND-011711,2011,132000070,,,,1,2,3
HND-011712,2011,132000071,,,,4,3,7
HND-011719,2011,132000105,,,,2,4,6
HND-011721,2011,132000127,,,,5,2,7
HND-011674,2011,132000001,,,,6,7,13
HND-011676,2011,132000003,,,,11,16,27
HND-011677,2011,132000004,,,,5,5,10
HND-011679,2011,132000006,,,,9,9,18
HND-011681,2011,132000008,,,,23,16,39
HND-011682,2011,132000009,,,,2,3,5
HND-011685,2011,132000012,,,,2,8,10
HND-011688,2011,132000015,,,,2,4,6
HND-011690,2011,132000017,,,,2,2,4
HND-011691,2011,132000018,,,,6,8,14
HND-011699,2011,132000036,,,,1,4,5
HND-011707,2011,132000058,,,,4,7,11
HND-011712,2011,132000071,,,,0,1,1
HND-011721,2011,132000127,,,,5,3,8
HND-011675,2011,132000002,,,,7,11,18
HND-011678,2011,132000005,,,,10,7,17
HND-011680,2011,132000007,,,,1,4,5
HND-011683,2011,132000010,,,,6,8,14
HND-011684,2011,132000011,,,,2,4,6
HND-011686,2011,132000013,,,,1,3,4
HND-011687,2011,132000014,,,,3,1,4
HND-011689,2011,132000016,,,,17,11,28
HND-011692,2011,132000020,,,,3,4,7
HND-011693,2011,132000021,,,,3,2,5
HND-011711,2011,132000070,,,,0,2,2
HND-011713,2011,132000072,,,,3,6,9
HND-011719,2011,132000105,,,,2,3,5
HND-011676,2011,132000003,,,,21,16,37
HND-011678,2011,132000005,,,,9,9,18
HND-011679,2011,132000006,,,,5,11,16
HND-011695,2011,132000023,,,,44,41,85
HND-011678,2011,132000005,,,,11,7,18
HND-011695,2011,132000023,,,,28,23,51
HND-011676,2011,132000003,,,,17,11,28
HND-011679,2011,132000006,,,,7,8,15
HND-011678,2011,132000005,,,,0,10,10
HND-011676,2011,132000003,,,,12,14,26
HND-011679,2011,132000006,,,,5,16,21
HND-011695,2011,132000023,,,,25,36,61
HND-011695,2011,132000023,,,,38,41,79
HND-011695,2011,132000023,,,,32,38,70
HND-011695,2011,132000023,,,,21,26,47
,2011,132100074,,,,3,8,11
,2011,132100076,,,,4,4,8
HND-011765,2011,132100077,,,,11,4,15
HND-011767,2011,132100081,,,,2,5,7
HND-011768,2011,132100084,,,,3,5,8
,2011,132100086,,,,11,5,16
,2011,132100087,,,,5,4,9
,2011,132100159,,,,3,4,7
HND-011772,2011,132100162,,,,2,5,7
HND-011774,2011,132100185,,,,6,6,12
,2011,132100186,,,,7,5,12
HND-011762,2011,132100071,,,,11,8,19
HND-011763,2011,132100072,,,,3,3,6
HND-011764,2011,132100073,,,,7,5,12
,2011,132100082,,,,6,1,7
,2011,132100083,,,,7,4,11
,2011,132100091,,,,4,3,7
,2011,132100155,,,,4,6,10
HND-011771,2011,132100157,,,,9,3,12
,2011,132100158,,,,11,9,20
HND-011775,2011,132100190,,,,6,5,11
,2011,132100191,,,,4,2,6
HND-011776,2011,132100192,,,,4,3,7
HND-011751,2011,132100058,,,,3,4,7
HND-011755,2011,132100062,,,,1,4,5
HND-011761,2011,132100069,,,,1,3,4
,2011,132100189,,,,3,7,10
HND-011750,2011,132100029,,,,15,14,29
HND-011761,2011,132100069,,,,4,2,6
,2011,132100189,,,,7,2,9
HND-011751,2011,132100058,,,,3,4,7
HND-011755,2011,132100062,,,,6,10,16
,2011,132100090,,,,4,0,4
HND-011751,2011,132100058,,,,1,4,5
HND-011755,2011,132100062,,,,7,3,10
,2011,132100090,,,,5,6,11
HND-011750,2011,132100029,,,,15,12,27
HND-011761,2011,132100069,,,,6,4,10
,2011,132100189,,,,3,6,9
HND-011728,2011,132100004,,,,2,0,2
HND-011729,2011,132100006,,,,19,20,39
,2011,132100007,,,,5,6,11
HND-011731,2011,132100009,,,,13,6,19
HND-011734,2011,132100012,,,,2,2,4
HND-011735,2011,132100013,,,,33,23,56
HND-011736,2011,132100014,,,,11,13,24
HND-011738,2011,132100016,,,,8,10,18
HND-011739,2011,132100017,,,,7,9,16
HND-011741,2011,132100019,,,,5,5,10
HND-011747,2011,132100026,,,,3,0,3
HND-011752,2011,132100059,,,,1,5,6
HND-011753,2011,132100060,,,,11,5,16
HND-011756,2011,132100064,,,,1,1,2
HND-011759,2011,132100067,,,,4,3,7
HND-011761,2011,132100069,,,,3,4,7
HND-011726,2011,132100002,,,,9,10,19
HND-011727,2011,132100003,,,,9,6,15
,2011,132100005,,,,11,13,24
HND-011730,2011,132100008,,,,11,10,21
HND-011732,2011,132100010,,,,14,8,22
HND-011733,2011,132100011,,,,16,4,20
HND-011737,2011,132100015,,,,4,4,8
HND-011740,2011,132100018,,,,13,14,27
HND-011742,2011,132100020,,,,18,14,32
HND-011743,2011,132100021,,,,6,6,12
HND-011744,2011,132100022,,,,14,8,22
HND-011745,2011,132100023,,,,7,8,15
HND-011746,2011,132100025,,,,2,5,7
HND-011748,2011,132100027,,,,9,1,10
HND-011749,2011,132100028,,,,5,2,7
HND-011751,2011,132100058,,,,12,3,15
HND-011754,2011,132100061,,,,8,2,10
HND-011757,2011,132100065,,,,8,5,13
HND-011758,2011,132100066,,,,2,4,6
HND-011760,2011,132100068,,,,2,7,9
HND-011773,2011,132100184,,,,3,3,6
HND-011777,2011,132100193,,,,12,11,23
HND-011726,2011,132100002,,,,9,11,20
HND-011727,2011,132100003,,,,1,3,4
HND-011731,2011,132100009,,,,10,5,15
HND-011734,2011,132100012,,,,3,3,6
HND-011740,2011,132100018,,,,6,7,13
HND-011741,2011,132100019,,,,5,4,9
HND-011743,2011,132100021,,,,5,3,8
HND-011745,2011,132100023,,,,2,4,6
HND-011751,2011,132100058,,,,4,2,6
HND-011757,2011,132100065,,,,6,4,10
HND-011760,2011,132100068,,,,2,3,5
HND-011773,2011,132100184,,,,2,0,2
HND-011777,2011,132100193,,,,1,2,3
HND-011728,2011,132100004,,,,1,3,4
,2011,132100005,,,,8,5,13
HND-011729,2011,132100006,,,,12,5,17
,2011,132100007,,,,3,5,8
HND-011730,2011,132100008,,,,13,10,23
HND-011732,2011,132100010,,,,5,6,11
HND-011733,2011,132100011,,,,6,4,10
HND-011735,2011,132100013,,,,17,20,37
HND-011736,2011,132100014,,,,6,6,12
HND-011737,2011,132100015,,,,2,0,2
HND-011738,2011,132100016,,,,5,10,15
HND-011739,2011,132100017,,,,5,4,9
HND-011742,2011,132100020,,,,7,4,11
HND-011744,2011,132100022,,,,2,5,7
HND-011746,2011,132100025,,,,3,3,6
HND-011747,2011,132100026,,,,1,3,4
HND-011748,2011,132100027,,,,3,3,6
HND-011749,2011,132100028,,,,4,2,6
HND-011752,2011,132100059,,,,2,0,2
HND-011753,2011,132100060,,,,6,6,12
HND-011754,2011,132100061,,,,3,5,8
HND-011756,2011,132100064,,,,0,1,1
HND-011758,2011,132100066,,,,2,0,2
HND-011759,2011,132100067,,,,2,2,4
HND-011761,2011,132100069,,,,6,7,13
HND-011726,2011,132100002,,,,6,4,10
HND-011727,2011,132100003,,,,9,5,14
,2011,132100005,,,,5,5,10
HND-011730,2011,132100008,,,,12,6,18
HND-011731,2011,132100009,,,,8,9,17
HND-011737,2011,132100015,,,,5,3,8
HND-011740,2011,132100018,,,,9,8,17
HND-011744,2011,132100022,,,,1,0,1
HND-011745,2011,132100023,,,,7,3,10
HND-011748,2011,132100027,,,,5,5,10
HND-011749,2011,132100028,,,,3,1,4
HND-011751,2011,132100058,,,,4,8,12
HND-011753,2011,132100060,,,,3,3,6
HND-011757,2011,132100065,,,,4,1,5
HND-011758,2011,132100066,,,,4,2,6
HND-011760,2011,132100068,,,,5,3,8
HND-011773,2011,132100184,,,,4,2,6
HND-011777,2011,132100193,,,,2,1,3
HND-011728,2011,132100004,,,,2,1,3
HND-011729,2011,132100006,,,,10,6,16
,2011,132100007,,,,3,2,5
HND-011732,2011,132100010,,,,10,0,10
HND-011733,2011,132100011,,,,5,1,6
HND-011734,2011,132100012,,,,2,4,6
HND-011735,2011,132100013,,,,28,23,51
HND-011736,2011,132100014,,,,8,7,15
HND-011738,2011,132100016,,,,1,5,6
HND-011739,2011,132100017,,,,7,2,9
HND-011741,2011,132100019,,,,3,4,7
HND-011742,2011,132100020,,,,6,5,11
HND-011743,2011,132100021,,,,6,5,11
HND-011746,2011,132100025,,,,1,2,3
HND-011747,2011,132100026,,,,0,1,1
HND-011752,2011,132100059,,,,2,0,2
HND-011754,2011,132100061,,,,1,4,5
HND-011756,2011,132100064,,,,3,1,4
HND-011759,2011,132100067,,,,1,0,1
HND-011761,2011,132100069,,,,7,4,11
HND-011727,2011,132100003,,,,3,1,4
HND-011728,2011,132100004,,,,2,0,2
HND-011729,2011,132100006,,,,3,4,7
HND-011731,2011,132100009,,,,10,5,15
HND-011733,2011,132100011,,,,6,4,10
HND-011734,2011,132100012,,,,5,0,5
HND-011738,2011,132100016,,,,4,6,10
HND-011741,2011,132100019,,,,3,8,11
HND-011742,2011,132100020,,,,5,3,8
HND-011743,2011,132100021,,,,4,2,6
HND-011745,2011,132100023,,,,2,3,5
HND-011751,2011,132100058,,,,4,6,10
HND-011757,2011,132100065,,,,4,5,9
HND-011760,2011,132100068,,,,5,3,8
HND-011773,2011,132100184,,,,3,1,4
HND-011726,2011,132100002,,,,6,7,13
,2011,132100005,,,,5,8,13
,2011,132100007,,,,1,4,5
HND-011730,2011,132100008,,,,10,3,13
HND-011732,2011,132100010,,,,8,5,13
HND-011735,2011,132100013,,,,27,20,47
HND-011736,2011,132100014,,,,6,5,11
HND-011739,2011,132100017,,,,8,8,16
HND-011740,2011,132100018,,,,6,3,9
HND-011744,2011,132100022,,,,1,3,4
HND-011746,2011,132100025,,,,4,2,6
HND-011747,2011,132100026,,,,2,5,7
HND-011748,2011,132100027,,,,1,2,3
HND-011749,2011,132100028,,,,1,5,6
HND-011752,2011,132100059,,,,2,2,4
HND-011753,2011,132100060,,,,4,3,7
HND-011754,2011,132100061,,,,3,2,5
HND-011756,2011,132100064,,,,0,4,4
HND-011758,2011,132100066,,,,3,4,7
HND-011761,2011,132100069,,,,1,4,5
HND-011727,2011,132100003,,,,2,2,4
HND-011728,2011,132100004,,,,4,5,9
HND-011729,2011,132100006,,,,7,5,12
,2011,132100007,,,,5,3,8
HND-011731,2011,132100009,,,,4,4,8
HND-011732,2011,132100010,,,,5,3,8
HND-011733,2011,132100011,,,,3,0,3
HND-011734,2011,132100012,,,,0,3,3
HND-011736,2011,132100014,,,,9,8,17
HND-011738,2011,132100016,,,,5,5,10
HND-011741,2011,132100019,,,,2,0,2
HND-011742,2011,132100020,,,,3,3,6
HND-011743,2011,132100021,,,,4,3,7
HND-011745,2011,132100023,,,,1,2,3
HND-011747,2011,132100026,,,,1,2,3
HND-011756,2011,132100064,,,,3,0,3
HND-011760,2011,132100068,,,,2,4,6
HND-011761,2011,132100069,,,,1,4,5
HND-011726,2011,132100002,,,,12,2,14
,2011,132100005,,,,2,3,5
HND-011730,2011,132100008,,,,6,10,16
HND-011735,2011,132100013,,,,13,25,38
HND-011737,2011,132100015,,,,1,2,3
HND-011739,2011,132100017,,,,5,13,18
HND-011740,2011,132100018,,,,4,5,9
HND-011744,2011,132100022,,,,2,2,4
HND-011746,2011,132100025,,,,0,2,2
HND-011748,2011,132100027,,,,2,6,8
HND-011749,2011,132100028,,,,1,5,6
HND-011751,2011,132100058,,,,4,3,7
HND-011752,2011,132100059,,,,3,1,4
HND-011753,2011,132100060,,,,5,5,10
HND-011754,2011,132100061,,,,0,2,2
HND-011757,2011,132100065,,,,2,7,9
HND-011758,2011,132100066,,,,1,2,3
HND-011759,2011,132100067,,,,2,2,4
,2011,132100005,,,,1,5,6
HND-011729,2011,132100006,,,,5,4,9
,2011,132100007,,,,4,3,7
HND-011730,2011,132100008,,,,5,9,14
HND-011732,2011,132100010,,,,5,3,8
HND-011733,2011,132100011,,,,1,2,3
HND-011734,2011,132100012,,,,0,2,2
HND-011735,2011,132100013,,,,19,18,37
HND-011736,2011,132100014,,,,6,5,11
HND-011737,2011,132100015,,,,2,1,3
HND-011738,2011,132100016,,,,3,5,8
HND-011739,2011,132100017,,,,8,5,13
HND-011742,2011,132100020,,,,1,2,3
HND-011746,2011,132100025,,,,1,3,4
HND-011747,2011,132100026,,,,2,0,2
HND-011748,2011,132100027,,,,3,3,6
HND-011749,2011,132100028,,,,0,2,2
HND-011752,2011,132100059,,,,3,4,7
HND-011753,2011,132100060,,,,1,4,5
HND-011754,2011,132100061,,,,5,4,9
HND-011756,2011,132100064,,,,0,1,1
HND-011758,2011,132100066,,,,3,2,5
HND-011759,2011,132100067,,,,1,3,4
HND-011761,2011,132100069,,,,2,1,3
HND-011726,2011,132100002,,,,1,4,5
HND-011727,2011,132100003,,,,8,2,10
HND-011731,2011,132100009,,,,2,4,6
HND-011740,2011,132100018,,,,2,3,5
HND-011741,2011,132100019,,,,3,4,7
HND-011743,2011,132100021,,,,1,4,5
HND-011745,2011,132100023,,,,1,2,3
HND-011757,2011,132100065,,,,2,3,5
HND-011760,2011,132100068,,,,0,3,3
HND-011729,2011,132100006,,,,4,4,8
HND-011735,2011,132100013,,,,13,22,35
HND-011729,2011,132100006,,,,4,2,6
HND-011735,2011,132100013,,,,11,17,28
HND-011729,2011,132100006,,,,0,5,5
HND-011735,2011,132100013,,,,9,23,32
,2011,132200037,,,,3,3,6
HND-011804,2011,132200047,,,,4,3,7
HND-011809,2011,132200081,,,,8,2,10
,2011,132200039,,,,5,3,8
HND-011800,2011,132200040,,,,5,5,10
HND-011801,2011,132200041,,,,2,5,7
HND-011802,2011,132200043,,,,4,2,6
HND-011803,2011,132200046,,,,2,6,8
HND-011790,2011,132200017,,,,4,2,6
,2011,132200029,,,,0,2,2
HND-011791,2011,132200018,,,,4,2,6
HND-011794,2011,132200025,,,,3,4,7
HND-011796,2011,132200027,,,,1,2,3
,2011,132200031,,,,0,2,2
,2011,132200036,,,,1,1,2
HND-011791,2011,132200018,,,,2,3,5
HND-011792,2011,132200019,,,,1,4,5
HND-011794,2011,132200025,,,,1,2,3
HND-011796,2011,132200027,,,,2,3,5
,2011,132200031,,,,1,1,2
,2011,132200036,,,,1,0,1
HND-011805,2011,132200077,,,,1,6,7
HND-011790,2011,132200017,,,,0,3,3
HND-011795,2011,132200026,,,,2,3,5
,2011,132200029,,,,2,4,6
,2011,132200033,,,,3,0,3
HND-011790,2011,132200017,,,,4,4,8
HND-011791,2011,132200018,,,,7,5,12
HND-011795,2011,132200026,,,,19,17,36
HND-011796,2011,132200027,,,,6,6,12
,2011,132200029,,,,1,3,4
,2011,132200031,,,,0,4,4
,2011,132200033,,,,5,0,5
,2011,132200036,,,,3,3,6
HND-011789,2011,132200009,,,,9,8,17
HND-011792,2011,132200019,,,,6,2,8
HND-011794,2011,132200025,,,,2,3,5
HND-011805,2011,132200077,,,,6,9,15
HND-011781,2011,132200001,,,,19,14,33
HND-011782,2011,132200002,,,,21,20,41
HND-011783,2011,132200003,,,,14,8,22
HND-011786,2011,132200006,,,,12,12,24
HND-011791,2011,132200018,,,,5,5,10
HND-011792,2011,132200019,,,,9,7,16
HND-011793,2011,132200024,,,,9,21,30
HND-011794,2011,132200025,,,,3,4,7
HND-011797,2011,132200028,,,,6,5,11
HND-011798,2011,132200030,,,,3,6,9
,2011,132200034,,,,2,2,4
HND-011807,2011,132200079,,,,4,1,5
HND-011784,2011,132200004,,,,5,9,14
HND-011785,2011,132200005,,,,2,5,7
HND-011787,2011,132200007,,,,8,7,15
,2011,132200008,,,,5,1,6
HND-011790,2011,132200017,,,,7,1,8
HND-011799,2011,132200032,,,,2,3,5
HND-011806,2011,132200078,,,,2,2,4
HND-011808,2011,132200080,,,,6,6,12
HND-011785,2011,132200005,,,,6,5,11
,2011,132200008,,,,2,2,4
HND-011790,2011,132200017,,,,7,4,11
HND-011791,2011,132200018,,,,4,3,7
HND-011793,2011,132200024,,,,11,11,22
HND-011799,2011,132200032,,,,2,5,7
HND-011806,2011,132200078,,,,2,3,5
HND-011807,2011,132200079,,,,1,4,5
HND-011781,2011,132200001,,,,16,16,32
HND-011782,2011,132200002,,,,13,16,29
HND-011783,2011,132200003,,,,17,14,31
HND-011784,2011,132200004,,,,4,10,14
HND-011786,2011,132200006,,,,10,18,28
HND-011787,2011,132200007,,,,4,2,6
HND-011792,2011,132200019,,,,8,9,17
HND-011794,2011,132200025,,,,4,6,10
HND-011797,2011,132200028,,,,3,5,8
HND-011798,2011,132200030,,,,6,4,10
,2011,132200034,,,,3,2,5
HND-011808,2011,132200080,,,,2,5,7
HND-011785,2011,132200005,,,,4,4,8
HND-011787,2011,132200007,,,,14,6,20
,2011,132200008,,,,2,3,5
HND-011790,2011,132200017,,,,3,3,6
HND-011799,2011,132200032,,,,2,2,4
HND-011806,2011,132200078,,,,3,4,7
HND-011808,2011,132200080,,,,5,1,6
HND-011781,2011,132200001,,,,6,2,8
HND-011782,2011,132200002,,,,22,20,42
HND-011783,2011,132200003,,,,12,16,28
HND-011784,2011,132200004,,,,15,9,24
HND-011786,2011,132200006,,,,14,10,24
HND-011791,2011,132200018,,,,6,3,9
HND-011792,2011,132200019,,,,8,7,15
HND-011793,2011,132200024,,,,8,6,14
HND-011794,2011,132200025,,,,1,0,1
HND-011797,2011,132200028,,,,5,4,9
HND-011798,2011,132200030,,,,2,5,7
,2011,132200034,,,,2,2,4
HND-011807,2011,132200079,,,,5,2,7
HND-011783,2011,132200003,,,,6,11,17
,2011,132200008,,,,2,3,5
HND-011790,2011,132200017,,,,5,3,8
HND-011791,2011,132200018,,,,8,2,10
HND-011793,2011,132200024,,,,3,3,6
HND-011794,2011,132200025,,,,3,2,5
HND-011798,2011,132200030,,,,3,3,6
HND-011807,2011,132200079,,,,3,3,6
HND-011781,2011,132200001,,,,5,5,10
HND-011782,2011,132200002,,,,15,21,36
HND-011784,2011,132200004,,,,15,5,20
HND-011785,2011,132200005,,,,3,3,6
HND-011786,2011,132200006,,,,10,9,19
HND-011792,2011,132200019,,,,7,4,11
HND-011797,2011,132200028,,,,7,3,10
HND-011799,2011,132200032,,,,7,3,10
,2011,132200034,,,,3,5,8
HND-011806,2011,132200078,,,,3,0,3
HND-011808,2011,132200080,,,,5,0,5
HND-011781,2011,132200001,,,,14,14,28
HND-011782,2011,132200002,,,,14,19,33
HND-011783,2011,132200003,,,,7,7,14
HND-011791,2011,132200018,,,,1,4,5
HND-011793,2011,132200024,,,,7,4,11
HND-011794,2011,132200025,,,,5,4,9
HND-011797,2011,132200028,,,,4,1,5
HND-011799,2011,132200032,,,,2,0,2
,2011,132200034,,,,2,0,2
HND-011806,2011,132200078,,,,1,2,3
HND-011808,2011,132200080,,,,2,2,4
HND-011784,2011,132200004,,,,7,10,17
HND-011785,2011,132200005,,,,3,2,5
,2011,132200008,,,,2,2,4
HND-011790,2011,132200017,,,,5,5,10
HND-011792,2011,132200019,,,,6,7,13
HND-011798,2011,132200030,,,,2,4,6
HND-011781,2011,132200001,,,,1,0,1
HND-011782,2011,132200002,,,,12,14,26
HND-011783,2011,132200003,,,,4,5,9
HND-011784,2011,132200004,,,,7,9,16
HND-011792,2011,132200019,,,,3,3,6
HND-011794,2011,132200025,,,,3,2,5
HND-011797,2011,132200028,,,,1,1,2
HND-011799,2011,132200032,,,,4,2,6
HND-011806,2011,132200078,,,,1,2,3
,2011,132200008,,,,1,4,5
HND-011790,2011,132200017,,,,3,1,4
HND-011791,2011,132200018,,,,4,4,8
HND-011793,2011,132200024,,,,4,5,9
HND-011798,2011,132200030,,,,4,2,6
,2011,132200034,,,,1,1,2
HND-011808,2011,132200080,,,,0,2,2
HND-011782,2011,132200002,,,,18,14,32
HND-011783,2011,132200003,,,,5,2,7
HND-011784,2011,132200004,,,,6,2,8
HND-011782,2011,132200002,,,,9,4,13
HND-011783,2011,132200003,,,,7,3,10
HND-011784,2011,132200004,,,,4,6,10
HND-011783,2011,132200003,,,,1,1,2
HND-011782,2011,132200002,,,,7,1,8
HND-011784,2011,132200004,,,,1,6,7
,2011,132300040,,,,11,11,22
,2011,132300048,,,,7,8,15
HND-011838,2011,132300050,,,,5,3,8
,2011,132300031,,,,4,6,10
,2011,132300043,,,,4,5,9
,2011,132300046,,,,5,2,7
,2011,132300025,,,,2,1,3
,2011,132300045,,,,1,2,3
,2011,132300047,,,,0,4,4
,2011,132300071,,,,3,3,6
HND-011841,2011,132300102,,,,2,2,4
,2011,132300104,,,,3,3,6
HND-011834,2011,132300029,,,,4,1,5
HND-011837,2011,132300042,,,,0,2,2
,2011,132300053,,,,1,2,3
HND-011840,2011,132300085,,,,1,3,4
HND-011832,2011,132300026,,,,6,9,15
HND-011833,2011,132300027,,,,7,6,13
,2011,132300028,,,,3,3,6
,2011,132300045,,,,6,4,10
,2011,132300047,,,,7,0,7
,2011,132300053,,,,1,2,3
,2011,132300071,,,,1,1,2
HND-011841,2011,132300102,,,,1,0,1
,2011,132300104,,,,1,1,2
HND-011829,2011,132300020,,,,6,8,14
HND-011830,2011,132300021,,,,3,3,6
,2011,132300025,,,,2,0,2
HND-011834,2011,132300029,,,,5,6,11
,2011,132300032,,,,2,1,3
HND-011837,2011,132300042,,,,4,4,8
HND-011840,2011,132300085,,,,3,5,8
HND-011829,2011,132300020,,,,10,9,19
HND-011833,2011,132300027,,,,7,5,12
,2011,132300028,,,,5,6,11
,2011,132300032,,,,5,4,9
HND-011837,2011,132300042,,,,8,11,19
HND-011840,2011,132300085,,,,10,4,14
HND-011830,2011,132300021,,,,11,11,22
,2011,132300025,,,,8,7,15
HND-011832,2011,132300026,,,,9,10,19
HND-011834,2011,132300029,,,,6,2,8
,2011,132300045,,,,3,11,14
,2011,132300047,,,,3,3,6
,2011,132300053,,,,4,2,6
,2011,132300071,,,,1,2,3
HND-011841,2011,132300102,,,,7,4,11
,2011,132300104,,,,1,2,3
HND-011811,2011,132300002,,,,6,2,8
HND-011812,2011,132300003,,,,21,11,32
HND-011818,2011,132300009,,,,18,20,38
HND-011821,2011,132300012,,,,4,1,5
HND-011824,2011,132300015,,,,10,2,12
HND-011827,2011,132300018,,,,7,6,13
HND-011839,2011,132300083,,,,1,3,4
HND-011810,2011,132300001,,,,13,10,23
HND-011813,2011,132300004,,,,8,7,15
HND-011814,2011,132300005,,,,5,5,10
HND-011815,2011,132300006,,,,16,8,24
HND-011816,2011,132300007,,,,12,12,24
HND-011817,2011,132300008,,,,12,12,24
HND-011819,2011,132300010,,,,5,6,11
HND-011820,2011,132300011,,,,14,6,20
HND-011822,2011,132300013,,,,5,2,7
HND-011823,2011,132300014,,,,2,4,6
HND-011825,2011,132300016,,,,4,4,8
HND-011826,2011,132300017,,,,4,4,8
HND-011828,2011,132300019,,,,4,6,10
HND-011835,2011,132300034,,,,5,2,7
HND-011836,2011,132300035,,,,6,3,9
HND-011812,2011,132300003,,,,9,18,27
HND-011813,2011,132300004,,,,4,5,9
HND-011815,2011,132300006,,,,12,10,22
HND-011816,2011,132300007,,,,7,0,7
HND-011818,2011,132300009,,,,7,10,17
HND-011821,2011,132300012,,,,4,4,8
HND-011822,2011,132300013,,,,3,1,4
HND-011827,2011,132300018,,,,5,5,10
HND-011828,2011,132300019,,,,3,2,5
HND-011836,2011,132300035,,,,5,4,9
HND-011810,2011,132300001,,,,12,9,21
HND-011811,2011,132300002,,,,6,4,10
HND-011814,2011,132300005,,,,7,1,8
HND-011817,2011,132300008,,,,10,8,18
HND-011819,2011,132300010,,,,5,6,11
HND-011820,2011,132300011,,,,6,9,15
HND-011823,2011,132300014,,,,4,4,8
HND-011824,2011,132300015,,,,8,4,12
HND-011825,2011,132300016,,,,6,3,9
HND-011826,2011,132300017,,,,2,3,5
HND-011835,2011,132300034,,,,3,2,5
HND-011839,2011,132300083,,,,5,2,7
HND-011812,2011,132300003,,,,17,12,29
HND-011815,2011,132300006,,,,11,14,25
HND-011818,2011,132300009,,,,10,9,19
HND-011821,2011,132300012,,,,4,5,9
HND-011824,2011,132300015,,,,5,13,18
HND-011827,2011,132300018,,,,6,3,9
HND-011836,2011,132300035,,,,3,2,5
HND-011810,2011,132300001,,,,13,10,23
HND-011811,2011,132300002,,,,6,8,14
HND-011813,2011,132300004,,,,4,6,10
HND-011814,2011,132300005,,,,9,4,13
HND-011816,2011,132300007,,,,4,11,15
HND-011817,2011,132300008,,,,15,8,23
HND-011819,2011,132300010,,,,3,4,7
HND-011820,2011,132300011,,,,10,5,15
HND-011822,2011,132300013,,,,3,4,7
HND-011823,2011,132300014,,,,3,7,10
HND-011825,2011,132300016,,,,5,1,6
HND-011826,2011,132300017,,,,2,1,3
HND-011828,2011,132300019,,,,5,3,8
HND-011835,2011,132300034,,,,2,4,6
HND-011839,2011,132300083,,,,1,4,5
HND-011810,2011,132300001,,,,11,11,22
HND-011813,2011,132300004,,,,5,4,9
HND-011815,2011,132300006,,,,10,13,23
HND-011816,2011,132300007,,,,7,10,17
HND-011820,2011,132300011,,,,5,8,13
HND-011821,2011,132300012,,,,3,0,3
HND-011822,2011,132300013,,,,3,3,6
HND-011825,2011,132300016,,,,5,6,11
HND-011827,2011,132300018,,,,0,5,5
HND-011828,2011,132300019,,,,4,0,4
HND-011811,2011,132300002,,,,3,4,7
HND-011812,2011,132300003,,,,22,16,38
HND-011814,2011,132300005,,,,10,9,19
HND-011817,2011,132300008,,,,12,11,23
HND-011818,2011,132300009,,,,19,18,37
HND-011819,2011,132300010,,,,2,5,7
HND-011823,2011,132300014,,,,3,7,10
HND-011824,2011,132300015,,,,8,5,13
HND-011826,2011,132300017,,,,3,1,4
HND-011835,2011,132300034,,,,3,7,10
HND-011836,2011,132300035,,,,1,5,6
HND-011839,2011,132300083,,,,2,2,4
HND-011810,2011,132300001,,,,13,18,31
HND-011813,2011,132300004,,,,3,3,6
HND-011814,2011,132300005,,,,8,5,13
HND-011815,2011,132300006,,,,8,13,21
HND-011816,2011,132300007,,,,7,9,16
HND-011819,2011,132300010,,,,7,8,15
HND-011820,2011,132300011,,,,7,4,11
HND-011822,2011,132300013,,,,4,1,5
HND-011823,2011,132300014,,,,6,1,7
HND-011825,2011,132300016,,,,3,2,5
HND-011827,2011,132300018,,,,0,12,12
HND-011828,2011,132300019,,,,5,4,9
HND-011811,2011,132300002,,,,3,2,5
HND-011812,2011,132300003,,,,13,13,26
HND-011817,2011,132300008,,,,6,11,17
HND-011818,2011,132300009,,,,10,16,26
HND-011821,2011,132300012,,,,7,4,11
HND-011824,2011,132300015,,,,6,5,11
HND-011826,2011,132300017,,,,1,0,1
HND-011835,2011,132300034,,,,2,1,3
HND-011836,2011,132300035,,,,1,2,3
HND-011839,2011,132300083,,,,2,2,4
HND-011810,2011,132300001,,,,7,5,12
HND-011811,2011,132300002,,,,6,3,9
HND-011814,2011,132300005,,,,3,1,4
HND-011817,2011,132300008,,,,13,6,19
HND-011819,2011,132300010,,,,7,4,11
HND-011820,2011,132300011,,,,2,3,5
HND-011823,2011,132300014,,,,4,4,8
HND-011824,2011,132300015,,,,4,5,9
HND-011825,2011,132300016,,,,6,2,8
HND-011826,2011,132300017,,,,1,0,1
HND-011835,2011,132300034,,,,4,0,4
HND-011839,2011,132300083,,,,2,0,2
HND-011812,2011,132300003,,,,16,8,24
HND-011813,2011,132300004,,,,3,3,6
HND-011815,2011,132300006,,,,9,16,25
HND-011816,2011,132300007,,,,3,5,8
HND-011818,2011,132300009,,,,9,20,29
HND-011821,2011,132300012,,,,2,3,5
HND-011822,2011,132300013,,,,4,2,6
HND-011827,2011,132300018,,,,2,0,2
HND-011828,2011,132300019,,,,1,1,2
HND-011836,2011,132300035,,,,2,2,4
HND-011810,2011,132300001,,,,16,13,29
HND-011818,2011,132300009,,,,10,18,28
HND-011831,2011,132300022,,,,47,62,109
HND-011818,2011,132300009,,,,5,17,22
HND-011831,2011,132300022,,,,34,45,79
HND-011810,2011,132300001,,,,5,5,10
HND-011818,2011,132300009,,,,3,10,13
HND-011810,2011,132300001,,,,8,5,13
HND-011831,2011,132300022,,,,45,38,83
HND-011831,2011,132300022,,,,16,24,40
HND-011831,2011,132300022,,,,25,23,48
HND-011831,2011,132300022,,,,13,16,29
HND-011853,2011,132400021,,,,5,0,5
,2011,132400023,,,,2,4,6
HND-011848,2011,132400007,,,,11,3,14
HND-011849,2011,132400008,,,,2,3,5
HND-011854,2011,132400022,,,,4,2,6
HND-011852,2011,132400018,,,,1,2,3
HND-011848,2011,132400007,,,,9,7,16
HND-011849,2011,132400008,,,,10,6,16
HND-011850,2011,132400009,,,,4,3,7
HND-011852,2011,132400018,,,,8,2,10
HND-011854,2011,132400022,,,,2,3,5
HND-011848,2011,132400007,,,,10,11,21
HND-011850,2011,132400009,,,,10,8,18
HND-011854,2011,132400022,,,,1,3,4
HND-011849,2011,132400008,,,,2,5,7
HND-011844,2011,132400003,,,,5,8,13
HND-011845,2011,132400004,,,,5,8,13
HND-011847,2011,132400006,,,,3,2,5
HND-011842,2011,132400001,,,,20,23,43
HND-011843,2011,132400002,,,,6,10,16
HND-011846,2011,132400005,,,,6,0,6
HND-011851,2011,132400017,,,,4,3,7
HND-011843,2011,132400002,,,,5,4,9
HND-011844,2011,132400003,,,,8,2,10
HND-011842,2011,132400001,,,,11,22,33
HND-011845,2011,132400004,,,,8,8,16
HND-011846,2011,132400005,,,,4,4,8
HND-011847,2011,132400006,,,,2,4,6
HND-011851,2011,132400017,,,,4,2,6
HND-011842,2011,132400001,,,,28,16,44
HND-011843,2011,132400002,,,,4,7,11
HND-011844,2011,132400003,,,,4,4,8
HND-011846,2011,132400005,,,,2,0,2
HND-011851,2011,132400017,,,,4,1,5
HND-011845,2011,132400004,,,,8,5,13
HND-011847,2011,132400006,,,,2,2,4
HND-011844,2011,132400003,,,,5,3,8
HND-011845,2011,132400004,,,,6,7,13
HND-011847,2011,132400006,,,,4,4,8
HND-011842,2011,132400001,,,,18,21,39
HND-011843,2011,132400002,,,,4,4,8
HND-011846,2011,132400005,,,,2,4,6
HND-011851,2011,132400017,,,,2,4,6
HND-011844,2011,132400003,,,,1,7,8
HND-011845,2011,132400004,,,,6,12,18
HND-011847,2011,132400006,,,,2,3,5
HND-011842,2011,132400001,,,,16,18,34
HND-011843,2011,132400002,,,,1,5,6
HND-011846,2011,132400005,,,,1,5,6
HND-011851,2011,132400017,,,,4,4,8
HND-011842,2011,132400001,,,,28,17,45
HND-011845,2011,132400004,,,,4,5,9
HND-011846,2011,132400005,,,,1,3,4
HND-011847,2011,132400006,,,,3,2,5
HND-011851,2011,132400017,,,,0,1,1
HND-011843,2011,132400002,,,,1,7,8
HND-011844,2011,132400003,,,,7,3,10
HND-011842,2011,132400001,,,,13,18,31
HND-011842,2011,132400001,,,,9,10,19
HND-011842,2011,132400001,,,,13,13,26
,2011,132500057,,,,2,4,6
HND-011879,2011,132500058,,,,2,11,13
,2011,132500073,,,,2,3,5
HND-011882,2011,132500074,,,,1,5,6
HND-011884,2011,132500079,,,,4,1,5
HND-011886,2011,132500081,,,,4,3,7
,2011,132500082,,,,2,4,6
HND-011880,2011,132500059,,,,6,6,12
,2011,132500072,,,,5,4,9
HND-011883,2011,132500078,,,,3,6,9
HND-011885,2011,132500080,,,,8,7,15
,2011,132500084,,,,2,5,7
,2011,132500017,,,,2,5,7
HND-011871,2011,132500018,,,,4,2,6
HND-011873,2011,132500034,,,,7,5,12
HND-011878,2011,132500055,,,,1,2,3
,2011,132500056,,,,1,2,3
,2011,132500017,,,,11,9,20
HND-011871,2011,132500018,,,,6,6,12
HND-011873,2011,132500034,,,,4,3,7
HND-011878,2011,132500055,,,,3,6,9
,2011,132500056,,,,3,3,6
,2011,132500056,,,,4,5,9
,2011,132500017,,,,13,12,25
HND-011871,2011,132500018,,,,10,4,14
HND-011873,2011,132500034,,,,3,4,7
HND-011878,2011,132500055,,,,5,5,10
HND-011855,2011,132500001,,,,9,8,17
HND-011856,2011,132500002,,,,6,6,12
HND-011857,2011,132500003,,,,11,16,27
HND-011859,2011,132500005,,,,11,16,27
HND-011862,2011,132500008,,,,6,7,13
HND-011863,2011,132500009,,,,8,6,14
HND-011864,2011,132500010,,,,8,3,11
HND-011866,2011,132500012,,,,2,3,5
HND-011869,2011,132500015,,,,5,0,5
HND-011876,2011,132500040,,,,3,5,8
HND-011858,2011,132500004,,,,13,10,23
HND-011860,2011,132500006,,,,12,6,18
HND-011861,2011,132500007,,,,2,3,5
HND-011865,2011,132500011,,,,4,7,11
HND-011867,2011,132500013,,,,6,7,13
HND-011868,2011,132500014,,,,9,3,12
HND-011870,2011,132500016,,,,5,4,9
HND-011874,2011,132500035,,,,2,8,10
HND-011875,2011,132500036,,,,6,10,16
HND-011877,2011,132500043,,,,2,1,3
HND-011856,2011,132500002,,,,6,4,10
HND-011861,2011,132500007,,,,2,0,2
HND-011862,2011,132500008,,,,5,4,9
HND-011864,2011,132500010,,,,0,5,5
HND-011865,2011,132500011,,,,3,5,8
HND-011868,2011,132500014,,,,1,5,6
HND-011870,2011,132500016,,,,2,5,7
HND-011874,2011,132500035,,,,6,3,9
HND-011876,2011,132500040,,,,4,9,13
HND-011877,2011,132500043,,,,2,1,3
HND-011855,2011,132500001,,,,14,10,24
HND-011857,2011,132500003,,,,13,17,30
HND-011858,2011,132500004,,,,20,7,27
HND-011859,2011,132500005,,,,12,12,24
HND-011860,2011,132500006,,,,5,3,8
HND-011863,2011,132500009,,,,8,8,16
HND-011866,2011,132500012,,,,2,3,5
HND-011867,2011,132500013,,,,4,1,5
HND-011869,2011,132500015,,,,3,4,7
HND-011875,2011,132500036,,,,7,2,9
HND-011858,2011,132500004,,,,11,16,27
HND-011860,2011,132500006,,,,6,4,10
HND-011861,2011,132500007,,,,4,1,5
HND-011862,2011,132500008,,,,7,4,11
HND-011864,2011,132500010,,,,4,4,8
HND-011865,2011,132500011,,,,1,3,4
HND-011867,2011,132500013,,,,4,1,5
HND-011868,2011,132500014,,,,8,2,10
HND-011870,2011,132500016,,,,1,4,5
HND-011874,2011,132500035,,,,3,1,4
HND-011875,2011,132500036,,,,4,6,10
HND-011877,2011,132500043,,,,2,2,4
HND-011855,2011,132500001,,,,2,7,9
HND-011856,2011,132500002,,,,1,3,4
HND-011857,2011,132500003,,,,15,11,26
HND-011859,2011,132500005,,,,7,12,19
HND-011863,2011,132500009,,,,7,8,15
HND-011866,2011,132500012,,,,2,3,5
HND-011869,2011,132500015,,,,2,2,4
HND-011876,2011,132500040,,,,3,3,6
HND-011856,2011,132500002,,,,0,5,5
HND-011859,2011,132500005,,,,12,16,28
HND-011862,2011,132500008,,,,2,10,12
HND-011864,2011,132500010,,,,1,5,6
HND-011865,2011,132500011,,,,5,6,11
HND-011868,2011,132500014,,,,4,2,6
HND-011869,2011,132500015,,,,1,3,4
HND-011870,2011,132500016,,,,5,0,5
HND-011874,2011,132500035,,,,2,4,6
HND-011876,2011,132500040,,,,3,6,9
HND-011855,2011,132500001,,,,9,4,13
HND-011857,2011,132500003,,,,15,15,30
HND-011858,2011,132500004,,,,6,12,18
HND-011860,2011,132500006,,,,1,5,6
HND-011861,2011,132500007,,,,3,3,6
HND-011863,2011,132500009,,,,7,5,12
HND-011866,2011,132500012,,,,2,1,3
HND-011867,2011,132500013,,,,4,1,5
HND-011875,2011,132500036,,,,7,12,19
HND-011877,2011,132500043,,,,2,3,5
HND-011858,2011,132500004,,,,7,8,15
HND-011860,2011,132500006,,,,5,5,10
HND-011861,2011,132500007,,,,4,1,5
HND-011864,2011,132500010,,,,5,3,8
HND-011866,2011,132500012,,,,2,4,6
HND-011867,2011,132500013,,,,9,3,12
HND-011870,2011,132500016,,,,6,3,9
HND-011876,2011,132500040,,,,4,1,5
HND-011855,2011,132500001,,,,6,3,9
HND-011856,2011,132500002,,,,1,7,8
HND-011857,2011,132500003,,,,9,6,15
HND-011859,2011,132500005,,,,20,8,28
HND-011862,2011,132500008,,,,8,6,14
HND-011863,2011,132500009,,,,10,5,15
HND-011865,2011,132500011,,,,3,4,7
HND-011868,2011,132500014,,,,1,3,4
HND-011869,2011,132500015,,,,2,2,4
HND-011874,2011,132500035,,,,0,2,2
HND-011875,2011,132500036,,,,5,2,7
HND-011877,2011,132500043,,,,2,0,2
HND-011856,2011,132500002,,,,1,1,2
HND-011861,2011,132500007,,,,3,2,5
HND-011862,2011,132500008,,,,8,4,12
HND-011864,2011,132500010,,,,1,1,2
HND-011865,2011,132500011,,,,4,3,7
HND-011868,2011,132500014,,,,4,5,9
HND-011870,2011,132500016,,,,4,2,6
HND-011875,2011,132500036,,,,1,7,8
HND-011855,2011,132500001,,,,4,3,7
HND-011857,2011,132500003,,,,5,5,10
HND-011858,2011,132500004,,,,8,9,17
HND-011859,2011,132500005,,,,10,10,20
HND-011860,2011,132500006,,,,5,0,5
HND-011863,2011,132500009,,,,3,5,8
HND-011866,2011,132500012,,,,1,1,2
HND-011867,2011,132500013,,,,0,7,7
HND-011869,2011,132500015,,,,2,3,5
HND-011874,2011,132500035,,,,3,2,5
HND-011876,2011,132500040,,,,1,3,4
HND-011877,2011,132500043,,,,4,2,6
HND-011857,2011,132500003,,,,12,11,23
HND-011872,2011,132500019,,,,45,49,94
HND-011872,2011,132500019,,,,49,46,95
HND-011857,2011,132500003,,,,10,8,18
HND-011857,2011,132500003,,,,7,9,16
HND-011872,2011,132500019,,,,29,40,69
HND-011872,2011,132500019,,,,13,19,32
HND-011872,2011,132500019,,,,11,15,26
HND-011872,2011,132500019,,,,6,6,12
HND-011909,2011,132600037,,,,1,4,5
HND-011910,2011,132600038,,,,3,2,5
HND-011907,2011,132600035,,,,4,5,9
HND-011902,2011,132600016,,,,0,1,1
HND-011903,2011,132600017,,,,4,0,4
HND-011904,2011,132600027,,,,1,2,3
HND-011911,2011,132600041,,,,4,2,6
HND-011902,2011,132600016,,,,11,4,15
HND-011904,2011,132600027,,,,6,2,8
HND-011911,2011,132600041,,,,4,4,8
HND-011903,2011,132600017,,,,1,3,4
HND-011907,2011,132600035,,,,2,3,5
HND-011903,2011,132600017,,,,2,2,4
HND-011904,2011,132600027,,,,3,3,6
HND-011902,2011,132600016,,,,6,4,10
HND-011907,2011,132600035,,,,1,4,5
HND-011911,2011,132600041,,,,1,2,3
HND-011888,2011,132600001,,,,2,3,5
HND-011889,2011,132600002,,,,14,9,23
HND-011891,2011,132600004,,,,2,3,5
HND-011892,2011,132600005,,,,8,1,9
HND-011893,2011,132600006,,,,1,1,2
HND-011894,2011,132600007,,,,0,3,3
HND-011897,2011,132600010,,,,6,5,11
HND-011899,2011,132600012,,,,4,4,8
HND-011905,2011,132600028,,,,2,2,4
HND-011906,2011,132600033,,,,5,1,6
HND-011908,2011,132600036,,,,0,1,1
HND-011890,2011,132600003,,,,6,4,10
HND-011895,2011,132600008,,,,6,3,9
HND-011896,2011,132600009,,,,4,1,5
HND-011898,2011,132600011,,,,1,0,1
HND-011900,2011,132600013,,,,2,3,5
HND-011901,2011,132600014,,,,2,3,5
HND-011888,2011,132600001,,,,3,2,5
HND-011892,2011,132600005,,,,4,5,9
HND-011895,2011,132600008,,,,1,2,3
HND-011897,2011,132600010,,,,3,8,11
HND-011898,2011,132600011,,,,4,3,7
HND-011899,2011,132600012,,,,4,5,9
HND-011900,2011,132600013,,,,1,0,1
HND-011889,2011,132600002,,,,11,5,16
HND-011891,2011,132600004,,,,1,1,2
HND-011893,2011,132600006,,,,3,2,5
HND-011896,2011,132600009,,,,3,1,4
HND-011901,2011,132600014,,,,0,3,3
HND-011908,2011,132600036,,,,1,1,2
HND-011890,2011,132600003,,,,3,0,3
HND-011895,2011,132600008,,,,0,5,5
HND-011898,2011,132600011,,,,0,2,2
HND-011900,2011,132600013,,,,2,1,3
HND-011901,2011,132600014,,,,1,0,1
HND-011888,2011,132600001,,,,4,2,6
HND-011889,2011,132600002,,,,13,8,21
HND-011891,2011,132600004,,,,4,2,6
HND-011892,2011,132600005,,,,5,4,9
HND-011893,2011,132600006,,,,3,10,13
HND-011894,2011,132600007,,,,3,1,4
HND-011897,2011,132600010,,,,6,6,12
HND-011905,2011,132600028,,,,1,4,5
HND-011892,2011,132600005,,,,8,4,12
HND-011895,2011,132600008,,,,2,6,8
HND-011899,2011,132600012,,,,1,6,7
HND-011900,2011,132600013,,,,4,3,7
HND-011905,2011,132600028,,,,2,5,7
HND-011906,2011,132600033,,,,1,2,3
HND-011888,2011,132600001,,,,3,6,9
HND-011889,2011,132600002,,,,10,11,21
HND-011890,2011,132600003,,,,4,3,7
HND-011891,2011,132600004,,,,4,5,9
HND-011893,2011,132600006,,,,2,4,6
HND-011894,2011,132600007,,,,3,0,3
HND-011896,2011,132600009,,,,1,3,4
HND-011897,2011,132600010,,,,4,10,14
HND-011898,2011,132600011,,,,1,2,3
HND-011901,2011,132600014,,,,3,1,4
HND-011908,2011,132600036,,,,3,4,7
HND-011890,2011,132600003,,,,4,3,7
HND-011892,2011,132600005,,,,8,7,15
HND-011895,2011,132600008,,,,9,3,12
HND-011898,2011,132600011,,,,2,2,4
HND-011899,2011,132600012,,,,8,3,11
HND-011900,2011,132600013,,,,0,3,3
HND-011905,2011,132600028,,,,2,3,5
HND-011908,2011,132600036,,,,4,3,7
HND-011888,2011,132600001,,,,5,3,8
HND-011889,2011,132600002,,,,11,15,26
HND-011891,2011,132600004,,,,4,7,11
HND-011893,2011,132600006,,,,2,7,9
HND-011894,2011,132600007,,,,2,2,4
HND-011896,2011,132600009,,,,6,1,7
HND-011897,2011,132600010,,,,3,6,9
HND-011901,2011,132600014,,,,1,2,3
HND-011888,2011,132600001,,,,4,6,10
HND-011889,2011,132600002,,,,10,8,18
HND-011890,2011,132600003,,,,4,2,6
HND-011891,2011,132600004,,,,3,6,9
HND-011893,2011,132600006,,,,7,2,9
HND-011896,2011,132600009,,,,0,1,1
HND-011897,2011,132600010,,,,6,3,9
HND-011898,2011,132600011,,,,1,1,2
HND-011900,2011,132600013,,,,3,1,4
HND-011901,2011,132600014,,,,3,2,5
HND-011892,2011,132600005,,,,7,8,15
HND-011895,2011,132600008,,,,0,2,2
HND-011899,2011,132600012,,,,3,1,4
HND-011905,2011,132600028,,,,1,1,2
HND-011906,2011,132600033,,,,1,3,4
HND-011889,2011,132600002,,,,23,17,40
HND-011892,2011,132600005,,,,4,9,13
HND-011889,2011,132600002,,,,13,22,35
HND-011892,2011,132600005,,,,8,6,14
HND-011889,2011,132600002,,,,13,17,30
HND-011892,2011,132600005,,,,3,3,6
,2011,132700030,,,,3,4,7
HND-011924,2011,132700031,,,,4,2,6
HND-011919,2011,132700008,,,,0,1,1
HND-011920,2011,132700009,,,,0,2,2
HND-011922,2011,132700012,,,,2,5,7
HND-011923,2011,132700013,,,,1,1,2
HND-011919,2011,132700008,,,,3,3,6
HND-011920,2011,132700009,,,,1,2,3
HND-011923,2011,132700013,,,,2,1,3
HND-011922,2011,132700012,,,,4,1,5
HND-011922,2011,132700012,,,,7,2,9
HND-011919,2011,132700008,,,,4,4,8
HND-011920,2011,132700009,,,,3,2,5
HND-011923,2011,132700013,,,,1,0,1
HND-011913,2011,132700002,,,,1,4,5
HND-011914,2011,132700003,,,,6,6,12
HND-011912,2011,132700001,,,,16,11,27
HND-011915,2011,132700004,,,,2,4,6
HND-011916,2011,132700005,,,,6,9,15
HND-011917,2011,132700006,,,,9,9,18
HND-011918,2011,132700007,,,,1,0,1
HND-011912,2011,132700001,,,,17,8,25
HND-011913,2011,132700002,,,,1,1,2
HND-011916,2011,132700005,,,,4,4,8
HND-011918,2011,132700007,,,,1,0,1
HND-011914,2011,132700003,,,,9,3,12
HND-011915,2011,132700004,,,,6,4,10
HND-011917,2011,132700006,,,,9,6,15
HND-011921,2011,132700010,,,,3,4,7
HND-011912,2011,132700001,,,,7,12,19
HND-011915,2011,132700004,,,,8,3,11
HND-011916,2011,132700005,,,,5,8,13
HND-011917,2011,132700006,,,,5,9,14
HND-011918,2011,132700007,,,,1,1,2
HND-011913,2011,132700002,,,,2,1,3
HND-011914,2011,132700003,,,,7,1,8
HND-011912,2011,132700001,,,,4,11,15
HND-011913,2011,132700002,,,,1,0,1
HND-011916,2011,132700005,,,,11,2,13
HND-011914,2011,132700003,,,,4,4,8
HND-011915,2011,132700004,,,,4,6,10
HND-011917,2011,132700006,,,,4,2,6
HND-011918,2011,132700007,,,,1,2,3
HND-011921,2011,132700010,,,,1,4,5
HND-011913,2011,132700002,,,,0,2,2
HND-011914,2011,132700003,,,,4,5,9
HND-011912,2011,132700001,,,,12,14,26
HND-011915,2011,132700004,,,,3,3,6
HND-011916,2011,132700005,,,,6,10,16
HND-011917,2011,132700006,,,,3,7,10
HND-011918,2011,132700007,,,,3,3,6
HND-011921,2011,132700010,,,,1,4,5
HND-011914,2011,132700003,,,,7,6,13
HND-011915,2011,132700004,,,,2,5,7
HND-011917,2011,132700006,,,,5,7,12
HND-011921,2011,132700010,,,,1,2,3
HND-011912,2011,132700001,,,,12,10,22
HND-011913,2011,132700002,,,,1,1,2
HND-011916,2011,132700005,,,,6,7,13
HND-011918,2011,132700007,,,,0,3,3
HND-011914,2011,132700003,,,,4,9,13
HND-011912,2011,132700001,,,,13,19,32
HND-011916,2011,132700005,,,,5,2,7
HND-011912,2011,132700001,,,,11,11,22
HND-011916,2011,132700005,,,,7,3,10
HND-011914,2011,132700003,,,,2,5,7
HND-011912,2011,132700001,,,,11,8,19
HND-011916,2011,132700005,,,,2,7,9
HND-011914,2011,132700003,,,,4,1,5
HND-011937,2011,132800013,,,,2,4,6
,2011,132800048,,,,4,6,10
HND-011944,2011,132800050,,,,15,11,26
HND-011946,2011,132800060,,,,2,8,10
HND-011947,2011,132800061,,,,3,6,9
,2011,132800063,,,,5,3,8
HND-011943,2011,132800049,,,,7,4,11
HND-011945,2011,132800059,,,,4,5,9
HND-011948,2011,132800062,,,,9,7,16
HND-011928,2011,132800004,,,,1,0,1
,2011,132800022,,,,0,3,3
HND-011928,2011,132800004,,,,5,0,5
HND-011939,2011,132800019,,,,1,2,3
HND-011936,2011,132800012,,,,1,5,6
,2011,132800022,,,,6,4,10
,2011,132800022,,,,7,4,11
HND-011928,2011,132800004,,,,9,5,14
HND-011936,2011,132800012,,,,6,5,11
HND-011939,2011,132800019,,,,11,9,20
HND-011925,2011,132800001,,,,4,14,18
HND-011930,2011,132800006,,,,12,6,18
HND-011931,2011,132800007,,,,7,2,9
HND-011938,2011,132800015,,,,3,3,6
HND-011941,2011,132800021,,,,3,4,7
HND-011926,2011,132800002,,,,12,3,15
HND-011927,2011,132800003,,,,15,13,28
HND-011929,2011,132800005,,,,4,3,7
HND-011932,2011,132800008,,,,11,12,23
HND-011933,2011,132800009,,,,6,7,13
HND-011934,2011,132800010,,,,7,12,19
HND-011935,2011,132800011,,,,7,11,18
HND-011939,2011,132800019,,,,1,1,2
HND-011940,2011,132800020,,,,9,6,15
HND-011926,2011,132800002,,,,10,9,19
HND-011927,2011,132800003,,,,10,15,25
HND-011930,2011,132800006,,,,8,7,15
HND-011933,2011,132800009,,,,11,8,19
HND-011934,2011,132800010,,,,9,9,18
HND-011938,2011,132800015,,,,5,4,9
HND-011942,2011,132800046,,,,2,2,4
HND-011925,2011,132800001,,,,10,7,17
HND-011929,2011,132800005,,,,10,2,12
HND-011931,2011,132800007,,,,1,4,5
HND-011932,2011,132800008,,,,13,5,18
HND-011935,2011,132800011,,,,24,27,51
HND-011939,2011,132800019,,,,3,1,4
HND-011940,2011,132800020,,,,6,5,11
HND-011941,2011,132800021,,,,1,1,2
HND-011926,2011,132800002,,,,5,6,11
HND-011927,2011,132800003,,,,11,18,29
HND-011932,2011,132800008,,,,6,6,12
HND-011933,2011,132800009,,,,5,3,8
HND-011934,2011,132800010,,,,6,2,8
HND-011935,2011,132800011,,,,4,11,15
HND-011940,2011,132800020,,,,6,9,15
HND-011925,2011,132800001,,,,9,7,16
HND-011929,2011,132800005,,,,3,1,4
HND-011930,2011,132800006,,,,9,7,16
HND-011931,2011,132800007,,,,4,1,5
HND-011938,2011,132800015,,,,7,3,10
HND-011939,2011,132800019,,,,2,3,5
HND-011941,2011,132800021,,,,2,0,2
HND-011942,2011,132800046,,,,1,1,2
HND-011927,2011,132800003,,,,6,14,20
HND-011930,2011,132800006,,,,13,9,22
HND-011933,2011,132800009,,,,7,4,11
HND-011938,2011,132800015,,,,6,3,9
HND-011925,2011,132800001,,,,6,8,14
HND-011926,2011,132800002,,,,4,4,8
HND-011929,2011,132800005,,,,7,2,9
HND-011931,2011,132800007,,,,2,2,4
HND-011932,2011,132800008,,,,12,13,25
HND-011934,2011,132800010,,,,9,3,12
HND-011935,2011,132800011,,,,3,4,7
HND-011939,2011,132800019,,,,2,2,4
HND-011940,2011,132800020,,,,8,7,15
HND-011941,2011,132800021,,,,1,1,2
HND-011942,2011,132800046,,,,1,2,3
HND-011927,2011,132800003,,,,10,9,19
HND-011930,2011,132800006,,,,12,7,19
HND-011931,2011,132800007,,,,2,2,4
HND-011933,2011,132800009,,,,1,5,6
HND-011938,2011,132800015,,,,4,6,10
HND-011925,2011,132800001,,,,8,8,16
HND-011926,2011,132800002,,,,7,7,14
HND-011929,2011,132800005,,,,9,3,12
HND-011932,2011,132800008,,,,6,3,9
HND-011934,2011,132800010,,,,7,11,18
HND-011935,2011,132800011,,,,4,10,14
HND-011939,2011,132800019,,,,2,2,4
HND-011940,2011,132800020,,,,5,3,8
HND-011941,2011,132800021,,,,2,1,3
HND-011942,2011,132800046,,,,2,3,5
HND-011925,2011,132800001,,,,4,3,7
HND-011929,2011,132800005,,,,6,6,12
HND-011931,2011,132800007,,,,2,1,3
HND-011932,2011,132800008,,,,6,2,8
HND-011935,2011,132800011,,,,3,2,5
HND-011939,2011,132800019,,,,1,1,2
HND-011940,2011,132800020,,,,1,8,9
HND-011942,2011,132800046,,,,1,5,6
HND-011926,2011,132800002,,,,4,6,10
HND-011927,2011,132800003,,,,6,7,13
HND-011930,2011,132800006,,,,10,18,28
HND-011933,2011,132800009,,,,2,2,4
HND-011934,2011,132800010,,,,8,2,10
HND-011938,2011,132800015,,,,5,4,9
HND-011927,2011,132800003,,,,12,4,16
HND-011934,2011,132800010,,,,11,3,14
HND-011927,2011,132800003,,,,5,8,13
HND-011934,2011,132800010,,,,10,5,15
HND-011927,2011,132800003,,,,8,6,14
HND-011934,2011,132800010,,,,8,4,12
HND-011973,2011,140100025,,,,2,3,5
HND-011976,2011,140100028,,,,3,3,6
HND-012001,2011,140100086,,,,3,2,5
,2011,140100100,,,,0,5,5
HND-012005,2011,140100104,,,,5,1,6
HND-012006,2011,140100106,,,,1,4,5
HND-012008,2011,140100108,,,,5,4,9
,2011,140100115,,,,4,0,4
HND-011969,2011,140100021,,,,2,3,5
,2011,140100080,,,,5,0,5
HND-012003,2011,140100088,,,,4,2,6
,2011,140100098,,,,4,2,6
,2011,140100099,,,,4,2,6
,2011,140100105,,,,2,4,6
HND-012007,2011,140100107,,,,1,4,5
HND-012011,2011,140100113,,,,3,6,9
HND-012012,2011,140100114,,,,5,2,7
HND-011981,2011,140100034,,,,20,20,40
HND-011982,2011,140100035,,,,12,13,25
HND-011983,2011,140100037,,,,5,7,12
HND-011984,2011,140100038,,,,17,14,31
HND-011985,2011,140100039,,,,2,1,3
,2011,140100045,,,,1,1,2
HND-011993,2011,140100050,,,,6,2,8
HND-011995,2011,140100052,,,,10,6,16
,2011,140100057,,,,4,3,7
,2011,140100073,,,,2,0,2
HND-012000,2011,140100081,,,,0,2,2
,2011,140100101,,,,1,7,8
,2011,140100110,,,,2,1,3
,2011,140100040,,,,1,1,2
HND-011986,2011,140100041,,,,8,8,16
HND-011992,2011,140100048,,,,5,11,16
,2011,140100049,,,,1,3,4
HND-011994,2011,140100051,,,,1,1,2
,2011,140100055,,,,0,1,1
HND-011997,2011,140100058,,,,7,7,14
HND-012004,2011,140100089,,,,0,1,1
,2011,140100109,,,,2,1,3
HND-011981,2011,140100034,,,,29,26,55
HND-011984,2011,140100038,,,,20,18,38
HND-011985,2011,140100039,,,,4,3,7
,2011,140100045,,,,2,2,4
HND-011992,2011,140100048,,,,2,5,7
,2011,140100049,,,,2,1,3
HND-011993,2011,140100050,,,,1,2,3
HND-011994,2011,140100051,,,,2,1,3
HND-011995,2011,140100052,,,,10,11,21
,2011,140100057,,,,6,2,8
,2011,140100073,,,,0,2,2
HND-012000,2011,140100081,,,,3,2,5
HND-012004,2011,140100089,,,,3,6,9
,2011,140100101,,,,3,1,4
,2011,140100109,,,,2,2,4
,2011,140100110,,,,4,2,6
HND-011982,2011,140100035,,,,11,16,27
HND-011983,2011,140100037,,,,11,11,22
,2011,140100040,,,,4,4,8
HND-011986,2011,140100041,,,,24,19,43
HND-011987,2011,140100042,,,,2,2,4
,2011,140100055,,,,1,3,4
HND-011997,2011,140100058,,,,7,6,13
HND-011981,2011,140100034,,,,36,29,65
HND-011982,2011,140100035,,,,21,14,35
HND-011984,2011,140100038,,,,8,13,21
HND-011985,2011,140100039,,,,9,10,19
,2011,140100045,,,,8,0,8
HND-011992,2011,140100048,,,,6,11,17
,2011,140100049,,,,1,2,3
HND-011993,2011,140100050,,,,4,6,10
HND-011994,2011,140100051,,,,4,4,8
HND-011995,2011,140100052,,,,8,10,18
,2011,140100057,,,,6,3,9
,2011,140100073,,,,1,2,3
HND-012000,2011,140100081,,,,2,4,6
HND-011983,2011,140100037,,,,11,8,19
,2011,140100040,,,,3,9,12
HND-011986,2011,140100041,,,,26,25,51
HND-011987,2011,140100042,,,,9,5,14
,2011,140100055,,,,6,3,9
HND-011997,2011,140100058,,,,20,18,38
HND-012004,2011,140100089,,,,5,5,10
,2011,140100101,,,,3,4,7
,2011,140100109,,,,4,4,8
,2011,140100110,,,,1,0,1
HND-011952,2011,140100003,,,,64,50,114
HND-011953,2011,140100004,,,,2,0,2
HND-011954,2011,140100005,,,,4,1,5
HND-011957,2011,140100008,,,,6,1,7
HND-011959,2011,140100010,,,,6,3,9
HND-011966,2011,140100018,,,,3,1,4
HND-011968,2011,140100020,,,,1,0,1
HND-011969,2011,140100021,,,,2,2,4
HND-011971,2011,140100023,,,,1,2,3
HND-011972,2011,140100024,,,,1,1,2
HND-011974,2011,140100026,,,,3,2,5
HND-011975,2011,140100027,,,,4,5,9
HND-011989,2011,140100044,,,,3,5,8
HND-011996,2011,140100056,,,,6,2,8
,2011,140100057,,,,11,6,17
HND-012003,2011,140100088,,,,1,3,4
HND-012010,2011,140100112,,,,1,2,3
HND-012011,2011,140100113,,,,1,5,6
HND-011950,2011,140100001,,,,29,26,55
HND-011951,2011,140100002,,,,44,48,92
HND-011956,2011,140100007,,,,9,7,16
HND-011958,2011,140100009,,,,5,3,8
HND-011960,2011,140100011,,,,3,2,5
HND-011961,2011,140100012,,,,26,20,46
HND-011962,2011,140100013,,,,1,4,5
HND-011964,2011,140100016,,,,5,0,5
HND-011965,2011,140100017,,,,3,6,9
HND-011967,2011,140100019,,,,2,1,3
HND-011970,2011,140100022,,,,2,8,10
HND-011973,2011,140100025,,,,1,1,2
HND-011976,2011,140100028,,,,1,1,2
HND-011977,2011,140100029,,,,1,2,3
HND-011978,2011,140100031,,,,5,5,10
HND-011979,2011,140100032,,,,3,4,7
HND-011980,2011,140100033,,,,2,3,5
HND-011988,2011,140100043,,,,1,3,4
,2011,140100055,,,,8,8,16
HND-011998,2011,140100070,,,,5,6,11
HND-011999,2011,140100079,,,,5,3,8
HND-012001,2011,140100086,,,,2,1,3
HND-012002,2011,140100087,,,,1,1,2
HND-012009,2011,140100111,,,,1,0,1
HND-011950,2011,140100001,,,,32,26,58
HND-011952,2011,140100003,,,,40,34,74
HND-011953,2011,140100004,,,,0,3,3
HND-011956,2011,140100007,,,,7,12,19
HND-011957,2011,140100008,,,,2,0,2
HND-011959,2011,140100010,,,,8,3,11
HND-011962,2011,140100013,,,,4,6,10
HND-011963,2011,140100014,,,,3,2,5
HND-011965,2011,140100017,,,,4,4,8
HND-011966,2011,140100018,,,,5,2,7
HND-011971,2011,140100023,,,,2,1,3
HND-011973,2011,140100025,,,,3,0,3
HND-011977,2011,140100029,,,,1,3,4
HND-011979,2011,140100032,,,,8,7,15
,2011,140100054,,,,1,1,2
,2011,140100057,,,,4,2,6
HND-011999,2011,140100079,,,,2,2,4
HND-012001,2011,140100086,,,,1,1,2
HND-012009,2011,140100111,,,,0,2,2
HND-012010,2011,140100112,,,,0,3,3
HND-011951,2011,140100002,,,,49,40,89
HND-011954,2011,140100005,,,,2,2,4
HND-011955,2011,140100006,,,,3,4,7
HND-011958,2011,140100009,,,,2,3,5
HND-011961,2011,140100012,,,,22,16,38
HND-011964,2011,140100016,,,,5,3,8
HND-011967,2011,140100019,,,,2,2,4
HND-011968,2011,140100020,,,,0,2,2
HND-011969,2011,140100021,,,,3,3,6
HND-011970,2011,140100022,,,,4,2,6
HND-011972,2011,140100024,,,,2,0,2
HND-011975,2011,140100027,,,,2,1,3
HND-011976,2011,140100028,,,,2,2,4
HND-011978,2011,140100031,,,,6,8,14
HND-011980,2011,140100033,,,,0,4,4
HND-011988,2011,140100043,,,,0,1,1
HND-011989,2011,140100044,,,,5,4,9
,2011,140100055,,,,9,7,16
HND-011996,2011,140100056,,,,6,4,10
HND-011998,2011,140100070,,,,2,3,5
HND-012002,2011,140100087,,,,6,0,6
HND-012003,2011,140100088,,,,3,1,4
HND-012011,2011,140100113,,,,2,4,6
HND-011950,2011,140100001,,,,24,23,47
HND-011951,2011,140100002,,,,55,42,97
HND-011955,2011,140100006,,,,2,0,2
HND-011956,2011,140100007,,,,18,4,22
HND-011960,2011,140100011,,,,0,1,1
HND-011961,2011,140100012,,,,16,20,36
HND-011964,2011,140100016,,,,1,1,2
HND-011965,2011,140100017,,,,3,3,6
HND-011970,2011,140100022,,,,6,6,12
HND-011973,2011,140100025,,,,2,4,6
HND-011977,2011,140100029,,,,5,4,9
HND-011978,2011,140100031,,,,5,6,11
HND-011980,2011,140100033,,,,2,3,5
HND-011988,2011,140100043,,,,2,1,3
,2011,140100054,,,,4,2,6
,2011,140100055,,,,7,8,15
HND-011998,2011,140100070,,,,2,4,6
HND-012001,2011,140100086,,,,1,0,1
HND-012002,2011,140100087,,,,3,0,3
HND-012009,2011,140100111,,,,3,4,7
HND-011952,2011,140100003,,,,51,61,112
HND-011953,2011,140100004,,,,5,5,10
HND-011954,2011,140100005,,,,1,2,3
HND-011957,2011,140100008,,,,3,1,4
HND-011958,2011,140100009,,,,6,2,8
HND-011959,2011,140100010,,,,4,7,11
HND-011966,2011,140100018,,,,6,6,12
HND-011967,2011,140100019,,,,0,3,3
HND-011968,2011,140100020,,,,1,1,2
HND-011972,2011,140100024,,,,2,0,2
HND-011974,2011,140100026,,,,1,1,2
HND-011975,2011,140100027,,,,1,6,7
HND-011976,2011,140100028,,,,0,2,2
HND-011979,2011,140100032,,,,10,9,19
HND-011989,2011,140100044,,,,1,6,7
HND-011996,2011,140100056,,,,8,1,9
,2011,140100057,,,,1,4,5
HND-011999,2011,140100079,,,,2,2,4
HND-012003,2011,140100088,,,,1,1,2
HND-012010,2011,140100112,,,,1,0,1
HND-012011,2011,140100113,,,,1,2,3
HND-011950,2011,140100001,,,,33,35,68
HND-011952,2011,140100003,,,,61,35,96
HND-011953,2011,140100004,,,,1,2,3
HND-011956,2011,140100007,,,,9,9,18
HND-011959,2011,140100010,,,,5,4,9
HND-011960,2011,140100011,,,,2,0,2
HND-011963,2011,140100014,,,,2,4,6
HND-011965,2011,140100017,,,,3,3,6
HND-011966,2011,140100018,,,,7,6,13
HND-011971,2011,140100023,,,,6,6,12
HND-011975,2011,140100027,,,,7,6,13
HND-011977,2011,140100029,,,,3,1,4
HND-011979,2011,140100032,,,,5,6,11
HND-011980,2011,140100033,,,,1,3,4
HND-011988,2011,140100043,,,,0,2,2
,2011,140100054,,,,1,1,2
,2011,140100057,,,,7,2,9
HND-011999,2011,140100079,,,,3,0,3
HND-012002,2011,140100087,,,,1,1,2
HND-012009,2011,140100111,,,,3,3,6
HND-012010,2011,140100112,,,,2,1,3
HND-011951,2011,140100002,,,,50,53,103
HND-011954,2011,140100005,,,,2,2,4
HND-011958,2011,140100009,,,,3,2,5
HND-011961,2011,140100012,,,,25,19,44
HND-011964,2011,140100016,,,,3,5,8
HND-011967,2011,140100019,,,,5,1,6
HND-011969,2011,140100021,,,,4,0,4
HND-011970,2011,140100022,,,,5,7,12
HND-011972,2011,140100024,,,,1,2,3
HND-011973,2011,140100025,,,,2,1,3
HND-011976,2011,140100028,,,,1,1,2
HND-011978,2011,140100031,,,,7,3,10
HND-011989,2011,140100044,,,,6,5,11
,2011,140100055,,,,4,13,17
HND-011996,2011,140100056,,,,9,6,15
HND-011998,2011,140100070,,,,2,4,6
HND-012003,2011,140100088,,,,3,2,5
HND-012011,2011,140100113,,,,2,1,3
HND-011950,2011,140100001,,,,31,29,60
HND-011952,2011,140100003,,,,51,59,110
HND-011953,2011,140100004,,,,3,3,6
HND-011954,2011,140100005,,,,1,4,5
HND-011957,2011,140100008,,,,1,2,3
HND-011959,2011,140100010,,,,8,10,18
HND-011960,2011,140100011,,,,1,0,1
HND-011963,2011,140100014,,,,2,0,2
HND-011966,2011,140100018,,,,6,1,7
HND-011968,2011,140100020,,,,2,0,2
HND-011969,2011,140100021,,,,2,4,6
HND-011971,2011,140100023,,,,5,3,8
HND-011974,2011,140100026,,,,2,1,3
HND-011975,2011,140100027,,,,1,4,5
HND-011978,2011,140100031,,,,6,9,15
HND-011979,2011,140100032,,,,7,2,9
HND-011980,2011,140100033,,,,3,1,4
HND-011988,2011,140100043,,,,0,1,1
,2011,140100057,,,,3,7,10
HND-011998,2011,140100070,,,,4,1,5
HND-011999,2011,140100079,,,,2,0,2
HND-012001,2011,140100086,,,,2,1,3
HND-012002,2011,140100087,,,,0,2,2
HND-012010,2011,140100112,,,,0,2,2
HND-012011,2011,140100113,,,,2,0,2
HND-011951,2011,140100002,,,,49,43,92
HND-011955,2011,140100006,,,,1,0,1
HND-011956,2011,140100007,,,,4,9,13
HND-011958,2011,140100009,,,,2,5,7
HND-011961,2011,140100012,,,,15,28,43
HND-011964,2011,140100016,,,,6,7,13
HND-011965,2011,140100017,,,,4,7,11
HND-011967,2011,140100019,,,,3,3,6
HND-011970,2011,140100022,,,,5,6,11
HND-011972,2011,140100024,,,,2,2,4
HND-011973,2011,140100025,,,,0,1,1
HND-011976,2011,140100028,,,,2,3,5
HND-011977,2011,140100029,,,,1,1,2
HND-011989,2011,140100044,,,,7,4,11
,2011,140100055,,,,7,11,18
HND-011996,2011,140100056,,,,3,1,4
HND-012003,2011,140100088,,,,0,3,3
HND-012009,2011,140100111,,,,2,2,4
HND-011951,2011,140100002,,,,47,48,95
HND-011954,2011,140100005,,,,1,2,3
HND-011955,2011,140100006,,,,1,0,1
HND-011958,2011,140100009,,,,4,10,14
HND-011961,2011,140100012,,,,21,26,47
HND-011964,2011,140100016,,,,2,5,7
HND-011967,2011,140100019,,,,3,1,4
HND-011968,2011,140100020,,,,4,1,5
HND-011969,2011,140100021,,,,2,2,4
HND-011970,2011,140100022,,,,2,3,5
HND-011972,2011,140100024,,,,1,0,1
HND-011975,2011,140100027,,,,4,1,5
HND-011978,2011,140100031,,,,5,10,15
HND-011980,2011,140100033,,,,2,1,3
HND-011989,2011,140100044,,,,1,9,10
,2011,140100055,,,,10,8,18
HND-011996,2011,140100056,,,,4,7,11
HND-011998,2011,140100070,,,,4,1,5
HND-012002,2011,140100087,,,,2,0,2
HND-012003,2011,140100088,,,,2,2,4
HND-011950,2011,140100001,,,,29,38,67
HND-011952,2011,140100003,,,,49,62,111
HND-011953,2011,140100004,,,,2,0,2
HND-011956,2011,140100007,,,,9,5,14
HND-011959,2011,140100010,,,,6,5,11
HND-011960,2011,140100011,,,,0,1,1
HND-011962,2011,140100013,,,,1,1,2
HND-011963,2011,140100014,,,,1,1,2
HND-011965,2011,140100017,,,,1,1,2
HND-011966,2011,140100018,,,,5,2,7
HND-011973,2011,140100025,,,,1,1,2
HND-011974,2011,140100026,,,,2,0,2
HND-011977,2011,140100029,,,,0,2,2
HND-011979,2011,140100032,,,,2,8,10
,2011,140100057,,,,3,4,7
HND-011999,2011,140100079,,,,0,2,2
HND-012001,2011,140100086,,,,1,0,1
HND-012009,2011,140100111,,,,1,2,3
,2011,140100057,,,,2,3,5
HND-011950,2011,140100001,,,,30,32,62
HND-011979,2011,140100032,,,,22,11,33
HND-011990,2011,140100046,,,,77,84,161
HND-011991,2011,140100047,,,,248,183,431
,2011,140100054,,,,5,3,8
,2011,140100055,,,,7,9,16
HND-011950,2011,140100001,,,,17,29,46
HND-011979,2011,140100032,,,,10,16,26
HND-011991,2011,140100047,,,,172,182,354
,2011,140100055,,,,7,5,12
HND-011990,2011,140100046,,,,59,77,136
,2011,140100054,,,,6,1,7
,2011,140100057,,,,3,3,6
HND-011950,2011,140100001,,,,20,21,41
HND-011979,2011,140100032,,,,9,10,19
HND-011990,2011,140100046,,,,33,56,89
HND-011991,2011,140100047,,,,147,195,342
,2011,140100054,,,,5,6,11
,2011,140100055,,,,12,9,21
HND-011991,2011,140100047,,,,170,206,376
,2011,140100055,,,,9,7,16
HND-011990,2011,140100046,,,,166,327,493
,2011,140100054,,,,18,17,35
HND-011990,2011,140100046,,,,116,226,342
HND-011991,2011,140100047,,,,118,128,246
,2011,140100055,,,,2,7,9
,2011,140100054,,,,11,11,22
,2011,140100054,,,,4,5,9
HND-011990,2011,140100046,,,,99,216,315
HND-011991,2011,140100047,,,,84,112,196
,2011,140200069,,,,2,5,7
,2011,140200071,,,,2,9,11
HND-012066,2011,140200082,,,,1,5,6
HND-012067,2011,140200085,,,,6,8,14
,2011,140200115,,,,3,9,12
,2011,140200117,,,,6,12,18
HND-012071,2011,140200119,,,,5,2,7
,2011,140200122,,,,4,2,6
,2011,140200123,,,,2,4,6
HND-012072,2011,140200124,,,,7,4,11
,2011,140200126,,,,5,4,9
,2011,140200040,,,,3,6,9
HND-012049,2011,140200043,,,,1,6,7
HND-012052,2011,140200059,,,,6,2,8
,2011,140200083,,,,5,8,13
,2011,140200110,,,,4,9,13
,2011,140200112,,,,10,7,17
,2011,140200113,,,,5,7,12
,2011,140200114,,,,1,4,5
HND-012070,2011,140200116,,,,4,3,7
,2011,140200118,,,,1,6,7
,2011,140200121,,,,6,6,12
,2011,140200125,,,,3,3,6
,2011,140200127,,,,2,3,5
,2011,140200128,,,,3,3,6
HND-012040,2011,140200029,,,,2,2,4
HND-012069,2011,140200108,,,,2,3,5
HND-012041,2011,140200030,,,,1,4,5
HND-012045,2011,140200034,,,,2,0,2
HND-012056,2011,140200064,,,,1,2,3
,2011,140200129,,,,7,1,8
HND-012040,2011,140200029,,,,5,4,9
HND-012041,2011,140200030,,,,3,2,5
HND-012046,2011,140200035,,,,3,5,8
HND-012048,2011,140200042,,,,1,3,4
HND-012057,2011,140200065,,,,9,6,15
HND-012069,2011,140200108,,,,5,2,7
HND-012042,2011,140200031,,,,3,6,9
HND-012045,2011,140200034,,,,0,4,4
HND-012056,2011,140200064,,,,8,10,18
,2011,140200129,,,,3,1,4
,2011,140200130,,,,4,1,5
HND-012042,2011,140200031,,,,7,19,26
HND-012045,2011,140200034,,,,8,11,19
HND-012046,2011,140200035,,,,6,11,17
HND-012056,2011,140200064,,,,7,9,16
HND-012057,2011,140200065,,,,7,4,11
HND-012069,2011,140200108,,,,4,2,6
,2011,140200130,,,,7,1,8
HND-012040,2011,140200029,,,,14,13,27
HND-012041,2011,140200030,,,,14,15,29
HND-012048,2011,140200042,,,,5,7,12
,2011,140200129,,,,1,3,4
HND-012016,2011,140200004,,,,25,24,49
HND-012017,2011,140200005,,,,16,14,30
HND-012020,2011,140200008,,,,5,6,11
HND-012021,2011,140200009,,,,19,14,33
HND-012023,2011,140200011,,,,14,11,25
HND-012025,2011,140200013,,,,9,12,21
HND-012028,2011,140200016,,,,4,6,10
HND-012029,2011,140200017,,,,8,2,10
HND-012030,2011,140200019,,,,13,9,22
HND-012033,2011,140200022,,,,7,5,12
HND-012036,2011,140200025,,,,10,5,15
HND-012037,2011,140200026,,,,2,1,3
HND-012038,2011,140200027,,,,4,7,11
HND-012047,2011,140200041,,,,2,5,7
HND-012049,2011,140200043,,,,3,2,5
HND-012050,2011,140200044,,,,4,1,5
HND-012051,2011,140200051,,,,1,2,3
HND-012054,2011,140200062,,,,3,3,6
HND-012063,2011,140200079,,,,9,3,12
HND-012065,2011,140200081,,,,3,3,6
HND-012073,2011,140200131,,,,8,8,16
HND-012014,2011,140200002,,,,20,11,31
HND-012015,2011,140200003,,,,9,10,19
HND-012018,2011,140200006,,,,1,2,3
HND-012019,2011,140200007,,,,13,14,27
HND-012022,2011,140200010,,,,12,8,20
HND-012024,2011,140200012,,,,4,6,10
HND-012026,2011,140200014,,,,10,7,17
HND-012027,2011,140200015,,,,8,11,19
HND-012031,2011,140200020,,,,4,6,10
HND-012032,2011,140200021,,,,6,2,8
HND-012035,2011,140200024,,,,2,5,7
HND-012039,2011,140200028,,,,13,9,22
HND-012044,2011,140200033,,,,4,0,4
HND-012052,2011,140200059,,,,5,5,10
HND-012053,2011,140200061,,,,1,2,3
HND-012055,2011,140200063,,,,1,1,2
HND-012058,2011,140200066,,,,2,1,3
HND-012061,2011,140200077,,,,2,0,2
HND-012062,2011,140200078,,,,3,4,7
HND-012064,2011,140200080,,,,1,0,1
HND-012068,2011,140200107,,,,0,2,2
HND-012069,2011,140200108,,,,5,9,14
HND-012074,2011,140200132,,,,5,2,7
HND-012013,2011,140200001,,,,3,3,6
HND-012015,2011,140200003,,,,13,6,19
HND-012019,2011,140200007,,,,12,7,19
HND-012020,2011,140200008,,,,6,6,12
HND-012024,2011,140200012,,,,4,4,8
HND-012027,2011,140200015,,,,2,4,6
HND-012028,2011,140200016,,,,3,5,8
HND-012030,2011,140200019,,,,1,4,5
HND-012031,2011,140200020,,,,1,0,1
HND-012032,2011,140200021,,,,3,5,8
HND-012033,2011,140200022,,,,2,4,6
HND-012035,2011,140200024,,,,6,3,9
HND-012036,2011,140200025,,,,7,2,9
HND-012044,2011,140200033,,,,2,0,2
HND-012049,2011,140200043,,,,3,4,7
HND-012052,2011,140200059,,,,1,6,7
HND-012053,2011,140200061,,,,4,1,5
HND-012055,2011,140200063,,,,0,1,1
HND-012058,2011,140200066,,,,1,1,2
HND-012062,2011,140200078,,,,3,4,7
HND-012063,2011,140200079,,,,1,0,1
HND-012068,2011,140200107,,,,5,1,6
HND-012069,2011,140200108,,,,6,6,12
HND-012074,2011,140200132,,,,4,4,8
HND-012014,2011,140200002,,,,16,10,26
HND-012016,2011,140200004,,,,24,19,43
HND-012017,2011,140200005,,,,16,11,27
HND-012018,2011,140200006,,,,1,2,3
HND-012021,2011,140200009,,,,20,9,29
HND-012022,2011,140200010,,,,2,3,5
HND-012023,2011,140200011,,,,5,9,14
HND-012025,2011,140200013,,,,10,9,19
HND-012026,2011,140200014,,,,12,5,17
HND-012029,2011,140200017,,,,11,4,15
HND-012034,2011,140200023,,,,1,2,3
HND-012037,2011,140200026,,,,5,3,8
HND-012038,2011,140200027,,,,2,2,4
HND-012039,2011,140200028,,,,1,4,5
HND-012047,2011,140200041,,,,3,4,7
HND-012050,2011,140200044,,,,2,1,3
HND-012054,2011,140200062,,,,1,1,2
HND-012061,2011,140200077,,,,2,0,2
HND-012064,2011,140200080,,,,1,0,1
HND-012065,2011,140200081,,,,2,0,2
HND-012073,2011,140200131,,,,5,6,11
HND-012014,2011,140200002,,,,19,18,37
HND-012015,2011,140200003,,,,13,10,23
HND-012018,2011,140200006,,,,1,1,2
HND-012019,2011,140200007,,,,13,22,35
HND-012022,2011,140200010,,,,9,21,30
HND-012024,2011,140200012,,,,2,3,5
HND-012026,2011,140200014,,,,8,6,14
HND-012027,2011,140200015,,,,6,12,18
HND-012030,2011,140200019,,,,2,0,2
HND-012031,2011,140200020,,,,3,3,6
HND-012032,2011,140200021,,,,4,2,6
HND-012033,2011,140200022,,,,9,3,12
HND-012034,2011,140200023,,,,2,2,4
HND-012035,2011,140200024,,,,7,4,11
HND-012039,2011,140200028,,,,2,0,2
HND-012044,2011,140200033,,,,3,2,5
HND-012052,2011,140200059,,,,2,2,4
HND-012053,2011,140200061,,,,3,1,4
HND-012055,2011,140200063,,,,1,3,4
HND-012058,2011,140200066,,,,4,2,6
HND-012062,2011,140200078,,,,4,5,9
HND-012064,2011,140200080,,,,2,2,4
HND-012074,2011,140200132,,,,0,1,1
HND-012013,2011,140200001,,,,0,1,1
HND-012016,2011,140200004,,,,23,28,51
HND-012017,2011,140200005,,,,19,14,33
HND-012020,2011,140200008,,,,12,7,19
HND-012021,2011,140200009,,,,13,25,38
HND-012023,2011,140200011,,,,3,6,9
HND-012025,2011,140200013,,,,8,10,18
HND-012028,2011,140200016,,,,1,4,5
HND-012029,2011,140200017,,,,5,9,14
HND-012036,2011,140200025,,,,1,8,9
HND-012037,2011,140200026,,,,2,0,2
HND-012038,2011,140200027,,,,1,5,6
HND-012047,2011,140200041,,,,1,2,3
HND-012049,2011,140200043,,,,2,4,6
HND-012051,2011,140200051,,,,2,3,5
HND-012054,2011,140200062,,,,4,1,5
HND-012061,2011,140200077,,,,2,2,4
HND-012063,2011,140200079,,,,2,1,3
HND-012065,2011,140200081,,,,2,3,5
HND-012068,2011,140200107,,,,0,1,1
HND-012069,2011,140200108,,,,8,5,13
HND-012073,2011,140200131,,,,1,9,10
HND-012013,2011,140200001,,,,1,1,2
HND-012017,2011,140200005,,,,17,15,32
HND-012020,2011,140200008,,,,12,8,20
HND-012025,2011,140200013,,,,10,10,20
HND-012027,2011,140200015,,,,11,10,21
HND-012028,2011,140200016,,,,8,8,16
HND-012030,2011,140200019,,,,5,4,9
HND-012031,2011,140200020,,,,2,4,6
HND-012033,2011,140200022,,,,2,8,10
HND-012035,2011,140200024,,,,3,7,10
HND-012036,2011,140200025,,,,6,5,11
HND-012037,2011,140200026,,,,2,4,6
HND-012044,2011,140200033,,,,0,3,3
HND-012047,2011,140200041,,,,5,7,12
HND-012049,2011,140200043,,,,5,4,9
HND-012052,2011,140200059,,,,4,2,6
HND-012053,2011,140200061,,,,1,4,5
HND-012054,2011,140200062,,,,0,1,1
HND-012055,2011,140200063,,,,2,2,4
HND-012063,2011,140200079,,,,0,1,1
HND-012068,2011,140200107,,,,3,4,7
HND-012069,2011,140200108,,,,13,5,18
HND-012073,2011,140200131,,,,1,0,1
HND-012014,2011,140200002,,,,20,12,32
HND-012015,2011,140200003,,,,8,16,24
HND-012016,2011,140200004,,,,31,31,62
HND-012018,2011,140200006,,,,2,1,3
HND-012019,2011,140200007,,,,12,3,15
HND-012021,2011,140200009,,,,15,13,28
HND-012022,2011,140200010,,,,14,18,32
HND-012023,2011,140200011,,,,6,4,10
HND-012026,2011,140200014,,,,4,5,9
HND-012029,2011,140200017,,,,9,2,11
HND-012032,2011,140200021,,,,3,4,7
HND-012034,2011,140200023,,,,1,1,2
HND-012038,2011,140200027,,,,2,3,5
HND-012039,2011,140200028,,,,5,4,9
HND-012050,2011,140200044,,,,0,1,1
HND-012051,2011,140200051,,,,0,2,2
HND-012058,2011,140200066,,,,1,7,8
HND-012061,2011,140200077,,,,1,0,1
HND-012062,2011,140200078,,,,8,5,13
HND-012064,2011,140200080,,,,3,2,5
HND-012065,2011,140200081,,,,2,4,6
HND-012074,2011,140200132,,,,1,1,2
HND-012014,2011,140200002,,,,6,6,12
HND-012015,2011,140200003,,,,11,4,15
HND-012018,2011,140200006,,,,3,3,6
HND-012019,2011,140200007,,,,6,7,13
HND-012021,2011,140200009,,,,7,12,19
HND-012022,2011,140200010,,,,4,19,23
HND-012023,2011,140200011,,,,2,5,7
HND-012026,2011,140200014,,,,7,1,8
HND-012027,2011,140200015,,,,10,7,17
HND-012031,2011,140200020,,,,1,1,2
HND-012032,2011,140200021,,,,3,6,9
HND-012034,2011,140200023,,,,1,0,1
HND-012035,2011,140200024,,,,3,0,3
HND-012039,2011,140200028,,,,3,5,8
HND-012047,2011,140200041,,,,5,3,8
HND-012049,2011,140200043,,,,2,2,4
HND-012050,2011,140200044,,,,2,2,4
HND-012051,2011,140200051,,,,1,1,2
HND-012052,2011,140200059,,,,4,5,9
HND-012055,2011,140200063,,,,3,1,4
HND-012058,2011,140200066,,,,1,4,5
HND-012063,2011,140200079,,,,0,1,1
HND-012065,2011,140200081,,,,4,0,4
HND-012068,2011,140200107,,,,2,2,4
HND-012069,2011,140200108,,,,13,7,20
HND-012073,2011,140200131,,,,0,2,2
HND-012013,2011,140200001,,,,0,2,2
HND-012016,2011,140200004,,,,36,39,75
HND-012017,2011,140200005,,,,8,12,20
HND-012020,2011,140200008,,,,4,5,9
HND-012025,2011,140200013,,,,11,6,17
HND-012028,2011,140200016,,,,7,3,10
HND-012029,2011,140200017,,,,4,3,7
HND-012030,2011,140200019,,,,3,5,8
HND-012033,2011,140200022,,,,1,7,8
HND-012036,2011,140200025,,,,6,3,9
HND-012037,2011,140200026,,,,4,0,4
HND-012038,2011,140200027,,,,2,0,2
HND-012044,2011,140200033,,,,0,2,2
HND-012053,2011,140200061,,,,1,1,2
HND-012054,2011,140200062,,,,1,3,4
HND-012061,2011,140200077,,,,0,1,1
HND-012062,2011,140200078,,,,3,0,3
HND-012064,2011,140200080,,,,4,1,5
HND-012074,2011,140200132,,,,1,1,2
HND-012015,2011,140200003,,,,5,9,14
HND-012019,2011,140200007,,,,6,4,10
HND-012020,2011,140200008,,,,3,8,11
HND-012027,2011,140200015,,,,2,4,6
HND-012028,2011,140200016,,,,8,4,12
HND-012030,2011,140200019,,,,1,3,4
HND-012031,2011,140200020,,,,2,2,4
HND-012032,2011,140200021,,,,3,2,5
HND-012033,2011,140200022,,,,1,0,1
HND-012035,2011,140200024,,,,3,3,6
HND-012036,2011,140200025,,,,6,3,9
HND-012047,2011,140200041,,,,3,1,4
HND-012050,2011,140200044,,,,3,4,7
HND-012051,2011,140200051,,,,0,3,3
HND-012053,2011,140200061,,,,3,0,3
HND-012055,2011,140200063,,,,1,0,1
HND-012058,2011,140200066,,,,1,2,3
HND-012061,2011,140200077,,,,0,4,4
HND-012064,2011,140200080,,,,2,1,3
HND-012065,2011,140200081,,,,1,0,1
HND-012073,2011,140200131,,,,0,1,1
HND-012014,2011,140200002,,,,7,9,16
HND-012016,2011,140200004,,,,31,16,47
HND-012017,2011,140200005,,,,8,13,21
HND-012018,2011,140200006,,,,1,1,2
HND-012021,2011,140200009,,,,9,9,18
HND-012022,2011,140200010,,,,12,15,27
HND-012023,2011,140200011,,,,4,6,10
HND-012025,2011,140200013,,,,8,11,19
HND-012029,2011,140200017,,,,2,3,5
HND-012034,2011,140200023,,,,1,2,3
HND-012037,2011,140200026,,,,2,1,3
HND-012038,2011,140200027,,,,4,0,4
HND-012039,2011,140200028,,,,1,3,4
HND-012044,2011,140200033,,,,0,2,2
HND-012049,2011,140200043,,,,2,5,7
HND-012052,2011,140200059,,,,2,2,4
HND-012054,2011,140200062,,,,0,1,1
HND-012062,2011,140200078,,,,2,1,3
HND-012063,2011,140200079,,,,2,0,2
HND-012068,2011,140200107,,,,2,1,3
HND-012069,2011,140200108,,,,4,6,10
HND-012074,2011,140200132,,,,1,0,1
HND-012043,2011,140200032,,,,69,62,131
HND-012043,2011,140200032,,,,61,78,139
HND-012043,2011,140200032,,,,46,39,85
HND-012043,2011,140200032,,,,38,22,60
HND-012043,2011,140200032,,,,31,18,49
HND-012043,2011,140200032,,,,19,18,37
HND-012103,2011,140300061,,,,3,4,7
,2011,140300062,,,,6,4,10
,2011,140300023,,,,3,5,8
,2011,140300063,,,,3,5,8
HND-012093,2011,140300020,,,,4,8,12
HND-012094,2011,140300021,,,,2,7,9
HND-012095,2011,140300022,,,,3,1,4
HND-012097,2011,140300030,,,,2,3,5
,2011,140300031,,,,3,2,5
HND-012093,2011,140300020,,,,10,15,25
HND-012095,2011,140300022,,,,4,1,5
HND-012094,2011,140300021,,,,3,6,9
HND-012097,2011,140300030,,,,1,1,2
,2011,140300031,,,,0,1,1
HND-012094,2011,140300021,,,,12,10,22
HND-012095,2011,140300022,,,,2,4,6
HND-012093,2011,140300020,,,,12,12,24
HND-012097,2011,140300030,,,,2,4,6
,2011,140300031,,,,4,2,6
HND-012078,2011,140300003,,,,8,9,17
HND-012079,2011,140300004,,,,3,5,8
,2011,140300007,,,,2,4,6
HND-012084,2011,140300011,,,,1,1,2
HND-012088,2011,140300015,,,,2,1,3
HND-012089,2011,140300016,,,,3,4,7
HND-012092,2011,140300019,,,,6,2,8
HND-012102,2011,140300056,,,,3,0,3
HND-012076,2011,140300001,,,,10,8,18
HND-012077,2011,140300002,,,,4,2,6
HND-012080,2011,140300005,,,,1,0,1
HND-012081,2011,140300006,,,,2,3,5
HND-012083,2011,140300009,,,,4,6,10
HND-012085,2011,140300012,,,,1,0,1
HND-012087,2011,140300014,,,,11,7,18
HND-012090,2011,140300017,,,,3,2,5
HND-012091,2011,140300018,,,,5,2,7
HND-012099,2011,140300049,,,,5,4,9
HND-012101,2011,140300055,,,,2,0,2
HND-012076,2011,140300001,,,,14,7,21
HND-012078,2011,140300003,,,,10,14,24
HND-012080,2011,140300005,,,,0,1,1
HND-012083,2011,140300009,,,,7,3,10
HND-012085,2011,140300012,,,,3,2,5
HND-012087,2011,140300014,,,,2,1,3
HND-012088,2011,140300015,,,,1,1,2
HND-012099,2011,140300049,,,,4,2,6
HND-012077,2011,140300002,,,,1,7,8
HND-012079,2011,140300004,,,,4,0,4
,2011,140300007,,,,2,0,2
HND-012086,2011,140300013,,,,4,8,12
HND-012089,2011,140300016,,,,5,7,12
HND-012090,2011,140300017,,,,2,2,4
HND-012092,2011,140300019,,,,5,3,8
HND-012101,2011,140300055,,,,1,0,1
HND-012104,2011,140300064,,,,2,3,5
HND-012076,2011,140300001,,,,7,14,21
HND-012077,2011,140300002,,,,5,4,9
HND-012080,2011,140300005,,,,0,1,1
HND-012081,2011,140300006,,,,3,1,4
HND-012083,2011,140300009,,,,0,2,2
HND-012085,2011,140300012,,,,1,2,3
HND-012087,2011,140300014,,,,2,2,4
HND-012090,2011,140300017,,,,1,2,3
HND-012091,2011,140300018,,,,2,1,3
HND-012102,2011,140300056,,,,4,1,5
HND-012078,2011,140300003,,,,16,15,31
HND-012079,2011,140300004,,,,0,1,1
,2011,140300007,,,,5,5,10
HND-012084,2011,140300011,,,,2,5,7
HND-012086,2011,140300013,,,,4,2,6
HND-012088,2011,140300015,,,,0,1,1
HND-012089,2011,140300016,,,,3,0,3
HND-012092,2011,140300019,,,,3,2,5
HND-012099,2011,140300049,,,,3,1,4
HND-012104,2011,140300064,,,,2,2,4
HND-012078,2011,140300003,,,,9,12,21
,2011,140300007,,,,0,2,2
HND-012083,2011,140300009,,,,2,3,5
HND-012086,2011,140300013,,,,2,1,3
HND-012087,2011,140300014,,,,2,1,3
HND-012088,2011,140300015,,,,1,2,3
HND-012091,2011,140300018,,,,2,1,3
HND-012092,2011,140300019,,,,2,1,3
HND-012099,2011,140300049,,,,1,2,3
HND-012076,2011,140300001,,,,13,13,26
HND-012077,2011,140300002,,,,5,4,9
HND-012079,2011,140300004,,,,0,2,2
HND-012080,2011,140300005,,,,1,0,1
HND-012085,2011,140300012,,,,2,1,3
HND-012089,2011,140300016,,,,5,3,8
HND-012090,2011,140300017,,,,0,3,3
HND-012101,2011,140300055,,,,2,2,4
HND-012102,2011,140300056,,,,1,1,2
HND-012104,2011,140300064,,,,3,0,3
HND-012078,2011,140300003,,,,15,17,32
,2011,140300007,,,,3,0,3
HND-012088,2011,140300015,,,,1,1,2
HND-012092,2011,140300019,,,,1,1,2
HND-012099,2011,140300049,,,,1,0,1
HND-012101,2011,140300055,,,,0,2,2
HND-012104,2011,140300064,,,,0,1,1
HND-012076,2011,140300001,,,,8,7,15
HND-012077,2011,140300002,,,,4,2,6
HND-012079,2011,140300004,,,,2,0,2
HND-012080,2011,140300005,,,,2,2,4
HND-012083,2011,140300009,,,,1,0,1
HND-012084,2011,140300011,,,,0,1,1
HND-012085,2011,140300012,,,,2,2,4
HND-012089,2011,140300016,,,,0,1,1
HND-012090,2011,140300017,,,,1,1,2
HND-012091,2011,140300018,,,,1,0,1
HND-012102,2011,140300056,,,,0,1,1
HND-012077,2011,140300002,,,,4,3,7
HND-012079,2011,140300004,,,,0,3,3
,2011,140300007,,,,3,1,4
HND-012084,2011,140300011,,,,1,2,3
HND-012089,2011,140300016,,,,6,0,6
HND-012090,2011,140300017,,,,0,2,2
HND-012092,2011,140300019,,,,1,1,2
HND-012101,2011,140300055,,,,1,2,3
HND-012102,2011,140300056,,,,1,2,3
HND-012104,2011,140300064,,,,0,1,1
HND-012076,2011,140300001,,,,17,19,36
HND-012078,2011,140300003,,,,3,13,16
HND-012080,2011,140300005,,,,1,1,2
HND-012083,2011,140300009,,,,1,1,2
HND-012085,2011,140300012,,,,0,2,2
HND-012087,2011,140300014,,,,2,0,2
HND-012088,2011,140300015,,,,1,0,1
HND-012099,2011,140300049,,,,3,3,6
HND-012076,2011,140300001,,,,12,12,24
HND-012076,2011,140300001,,,,9,4,13
HND-012076,2011,140300001,,,,11,4,15
,2011,140400032,,,,4,6,10
HND-012121,2011,140400033,,,,3,3,6
,2011,140400034,,,,1,4,5
,2011,140400037,,,,1,3,4
,2011,140400038,,,,1,5,6
HND-012113,2011,140400016,,,,2,3,5
HND-012122,2011,140400035,,,,4,1,5
,2011,140400036,,,,1,2,3
HND-012110,2011,140400006,,,,0,1,1
HND-012109,2011,140400005,,,,0,2,2
,2011,140400036,,,,0,3,3
HND-012110,2011,140400006,,,,1,3,4
HND-012109,2011,140400005,,,,11,10,21
HND-012110,2011,140400006,,,,6,8,14
,2011,140400036,,,,2,2,4
HND-012107,2011,140400003,,,,4,1,5
HND-012113,2011,140400016,,,,3,0,3
HND-012114,2011,140400017,,,,2,3,5
HND-012116,2011,140400019,,,,4,4,8
HND-012117,2011,140400020,,,,3,6,9
HND-012118,2011,140400021,,,,3,6,9
HND-012119,2011,140400022,,,,3,1,4
HND-012105,2011,140400001,,,,13,8,21
HND-012106,2011,140400002,,,,16,18,34
HND-012108,2011,140400004,,,,5,5,10
HND-012112,2011,140400015,,,,10,3,13
,2011,140400018,,,,3,6,9
HND-012120,2011,140400031,,,,2,0,2
HND-012106,2011,140400002,,,,10,12,22
HND-012113,2011,140400016,,,,3,2,5
HND-012117,2011,140400020,,,,2,4,6
HND-012119,2011,140400022,,,,2,2,4
HND-012105,2011,140400001,,,,13,4,17
HND-012107,2011,140400003,,,,6,4,10
HND-012108,2011,140400004,,,,4,7,11
HND-012112,2011,140400015,,,,2,5,7
HND-012114,2011,140400017,,,,6,1,7
,2011,140400018,,,,2,2,4
HND-012116,2011,140400019,,,,1,0,1
HND-012118,2011,140400021,,,,1,0,1
HND-012120,2011,140400031,,,,2,1,3
HND-012107,2011,140400003,,,,2,1,3
HND-012113,2011,140400016,,,,2,0,2
HND-012114,2011,140400017,,,,2,1,3
HND-012117,2011,140400020,,,,2,2,4
HND-012118,2011,140400021,,,,5,2,7
HND-012119,2011,140400022,,,,1,1,2
HND-012105,2011,140400001,,,,10,8,18
HND-012106,2011,140400002,,,,9,21,30
HND-012108,2011,140400004,,,,4,8,12
HND-012112,2011,140400015,,,,1,5,6
,2011,140400018,,,,2,0,2
HND-012105,2011,140400001,,,,14,4,18
HND-012106,2011,140400002,,,,11,11,22
HND-012112,2011,140400015,,,,4,1,5
,2011,140400018,,,,1,1,2
HND-012119,2011,140400022,,,,3,4,7
HND-012107,2011,140400003,,,,3,4,7
HND-012108,2011,140400004,,,,6,6,12
HND-012113,2011,140400016,,,,1,3,4
HND-012114,2011,140400017,,,,0,1,1
HND-012116,2011,140400019,,,,2,1,3
HND-012117,2011,140400020,,,,0,2,2
HND-012118,2011,140400021,,,,2,1,3
HND-012105,2011,140400001,,,,4,10,14
HND-012106,2011,140400002,,,,11,12,23
HND-012108,2011,140400004,,,,6,2,8
HND-012112,2011,140400015,,,,2,2,4
,2011,140400018,,,,2,3,5
HND-012107,2011,140400003,,,,2,4,6
HND-012113,2011,140400016,,,,1,2,3
HND-012114,2011,140400017,,,,0,1,1
HND-012116,2011,140400019,,,,0,2,2
HND-012117,2011,140400020,,,,1,4,5
HND-012118,2011,140400021,,,,1,3,4
HND-012119,2011,140400022,,,,2,1,3
HND-012120,2011,140400031,,,,2,2,4
HND-012105,2011,140400001,,,,7,8,15
HND-012108,2011,140400004,,,,7,4,11
HND-012112,2011,140400015,,,,2,3,5
HND-012114,2011,140400017,,,,3,0,3
,2011,140400018,,,,1,1,2
HND-012116,2011,140400019,,,,1,2,3
HND-012118,2011,140400021,,,,0,2,2
HND-012120,2011,140400031,,,,2,0,2
HND-012106,2011,140400002,,,,11,17,28
HND-012113,2011,140400016,,,,4,1,5
HND-012117,2011,140400020,,,,1,2,3
HND-012119,2011,140400022,,,,3,0,3
HND-012106,2011,140400002,,,,12,23,35
HND-012106,2011,140400002,,,,7,10,17
HND-012106,2011,140400002,,,,4,5,9
HND-012106,2011,140400002,,,,11,3,14
HND-012140,2011,140500044,,,,3,4,7
,2011,140500050,,,,6,3,9
,2011,140500049,,,,3,5,8
HND-012133,2011,140500024,,,,3,4,7
HND-012141,2011,140500045,,,,0,2,2
HND-012142,2011,140500046,,,,0,1,1
HND-012133,2011,140500024,,,,7,7,14
HND-012141,2011,140500045,,,,0,3,3
HND-012132,2011,140500023,,,,11,10,21
HND-012142,2011,140500046,,,,1,1,2
HND-012142,2011,140500046,,,,4,4,8
HND-012132,2011,140500023,,,,9,7,16
HND-012133,2011,140500024,,,,10,5,15
HND-012141,2011,140500045,,,,4,3,7
HND-012125,2011,140500003,,,,21,15,36
HND-012128,2011,140500006,,,,5,6,11
HND-012129,2011,140500007,,,,3,2,5
HND-012131,2011,140500022,,,,4,2,6
HND-012134,2011,140500025,,,,1,3,4
HND-012137,2011,140500040,,,,3,4,7
HND-012138,2011,140500041,,,,3,8,11
HND-012143,2011,140500047,,,,4,2,6
HND-012144,2011,140500048,,,,2,4,6
HND-012123,2011,140500001,,,,13,13,26
HND-012124,2011,140500002,,,,2,5,7
HND-012126,2011,140500004,,,,3,5,8
HND-012127,2011,140500005,,,,0,1,1
HND-012135,2011,140500026,,,,9,5,14
HND-012136,2011,140500027,,,,8,5,13
HND-012139,2011,140500042,,,,1,4,5
HND-012125,2011,140500003,,,,5,4,9
HND-012127,2011,140500005,,,,2,2,4
HND-012129,2011,140500007,,,,3,2,5
HND-012135,2011,140500026,,,,5,3,8
HND-012136,2011,140500027,,,,4,2,6
HND-012143,2011,140500047,,,,2,0,2
HND-012123,2011,140500001,,,,12,13,25
HND-012124,2011,140500002,,,,3,3,6
HND-012126,2011,140500004,,,,1,4,5
HND-012128,2011,140500006,,,,5,3,8
HND-012130,2011,140500011,,,,1,1,2
HND-012131,2011,140500022,,,,1,3,4
HND-012134,2011,140500025,,,,3,2,5
HND-012137,2011,140500040,,,,6,6,12
HND-012138,2011,140500041,,,,0,3,3
HND-012139,2011,140500042,,,,6,0,6
HND-012144,2011,140500048,,,,1,1,2
HND-012123,2011,140500001,,,,15,16,31
HND-012124,2011,140500002,,,,5,1,6
HND-012126,2011,140500004,,,,2,4,6
HND-012127,2011,140500005,,,,2,0,2
HND-012130,2011,140500011,,,,1,3,4
HND-012135,2011,140500026,,,,5,2,7
HND-012136,2011,140500027,,,,3,5,8
HND-012139,2011,140500042,,,,1,0,1
HND-012125,2011,140500003,,,,7,12,19
HND-012128,2011,140500006,,,,4,5,9
HND-012129,2011,140500007,,,,3,0,3
HND-012134,2011,140500025,,,,1,1,2
HND-012138,2011,140500041,,,,2,0,2
HND-012143,2011,140500047,,,,3,2,5
HND-012144,2011,140500048,,,,3,0,3
HND-012125,2011,140500003,,,,4,9,13
HND-012127,2011,140500005,,,,2,0,2
HND-012128,2011,140500006,,,,3,4,7
HND-012129,2011,140500007,,,,2,1,3
HND-012136,2011,140500027,,,,4,3,7
HND-012138,2011,140500041,,,,3,4,7
HND-012143,2011,140500047,,,,1,1,2
HND-012123,2011,140500001,,,,11,9,20
HND-012124,2011,140500002,,,,3,4,7
HND-012126,2011,140500004,,,,2,2,4
HND-012130,2011,140500011,,,,1,1,2
HND-012134,2011,140500025,,,,0,3,3
HND-012135,2011,140500026,,,,0,2,2
HND-012137,2011,140500040,,,,1,3,4
HND-012139,2011,140500042,,,,2,2,4
HND-012144,2011,140500048,,,,3,2,5
HND-012125,2011,140500003,,,,8,5,13
HND-012127,2011,140500005,,,,2,2,4
HND-012128,2011,140500006,,,,3,1,4
HND-012129,2011,140500007,,,,3,1,4
HND-012136,2011,140500027,,,,1,1,2
HND-012137,2011,140500040,,,,5,2,7
HND-012138,2011,140500041,,,,4,1,5
HND-012143,2011,140500047,,,,0,1,1
HND-012123,2011,140500001,,,,14,11,25
HND-012124,2011,140500002,,,,3,8,11
HND-012126,2011,140500004,,,,1,4,5
HND-012130,2011,140500011,,,,2,5,7
HND-012134,2011,140500025,,,,0,4,4
HND-012135,2011,140500026,,,,0,4,4
HND-012139,2011,140500042,,,,0,5,5
HND-012123,2011,140500001,,,,4,14,18
HND-012124,2011,140500002,,,,2,0,2
HND-012126,2011,140500004,,,,0,4,4
HND-012128,2011,140500006,,,,2,1,3
HND-012130,2011,140500011,,,,1,0,1
HND-012131,2011,140500022,,,,1,2,3
HND-012134,2011,140500025,,,,0,1,1
HND-012137,2011,140500040,,,,4,3,7
HND-012138,2011,140500041,,,,0,2,2
HND-012139,2011,140500042,,,,1,1,2
HND-012144,2011,140500048,,,,2,0,2
HND-012125,2011,140500003,,,,4,5,9
HND-012127,2011,140500005,,,,2,1,3
HND-012129,2011,140500007,,,,0,1,1
HND-012135,2011,140500026,,,,1,2,3
HND-012136,2011,140500027,,,,3,2,5
HND-012143,2011,140500047,,,,1,2,3
HND-012123,2011,140500001,,,,6,12,18
HND-012123,2011,140500001,,,,6,9,15
HND-012123,2011,140500001,,,,9,10,19
HND-012123,2011,140500001,,,,3,9,12
,2011,140600047,,,,0,5,5
,2011,140600048,,,,3,1,4
,2011,140600050,,,,1,4,5
HND-012160,2011,140600015,,,,0,1,1
HND-012163,2011,140600020,,,,0,1,1
HND-012164,2011,140600051,,,,0,2,2
,2011,140600049,,,,2,1,3
HND-012158,2011,140600013,,,,2,4,6
HND-012157,2011,140600012,,,,8,14,22
HND-012160,2011,140600015,,,,3,2,5
HND-012163,2011,140600020,,,,2,5,7
,2011,140600049,,,,0,2,2
HND-012164,2011,140600051,,,,1,3,4
HND-012157,2011,140600012,,,,13,16,29
HND-012158,2011,140600013,,,,12,11,23
HND-012160,2011,140600015,,,,8,9,17
HND-012163,2011,140600020,,,,3,2,5
HND-012164,2011,140600051,,,,0,5,5
,2011,140600049,,,,3,1,4
HND-012148,2011,140600003,,,,9,11,20
HND-012150,2011,140600005,,,,0,5,5
HND-012151,2011,140600006,,,,1,3,4
HND-012154,2011,140600009,,,,1,0,1
HND-012155,2011,140600010,,,,6,5,11
HND-012156,2011,140600011,,,,1,0,1
HND-012146,2011,140600001,,,,4,11,15
HND-012147,2011,140600002,,,,2,4,6
HND-012149,2011,140600004,,,,1,4,5
HND-012152,2011,140600007,,,,11,10,21
HND-012153,2011,140600008,,,,4,1,5
HND-012161,2011,140600018,,,,2,2,4
HND-012162,2011,140600019,,,,3,5,8
HND-012146,2011,140600001,,,,7,6,13
HND-012147,2011,140600002,,,,2,7,9
HND-012149,2011,140600004,,,,3,2,5
HND-012150,2011,140600005,,,,1,5,6
HND-012152,2011,140600007,,,,8,8,16
HND-012153,2011,140600008,,,,2,2,4
HND-012154,2011,140600009,,,,2,0,2
HND-012162,2011,140600019,,,,1,3,4
HND-012148,2011,140600003,,,,12,9,21
HND-012151,2011,140600006,,,,1,2,3
HND-012155,2011,140600010,,,,1,7,8
HND-012156,2011,140600011,,,,2,0,2
HND-012161,2011,140600018,,,,3,0,3
HND-012146,2011,140600001,,,,11,5,16
HND-012147,2011,140600002,,,,5,3,8
HND-012149,2011,140600004,,,,7,2,9
HND-012150,2011,140600005,,,,4,6,10
HND-012152,2011,140600007,,,,9,14,23
HND-012153,2011,140600008,,,,1,0,1
HND-012162,2011,140600019,,,,3,1,4
HND-012148,2011,140600003,,,,6,9,15
HND-012151,2011,140600006,,,,2,0,2
HND-012155,2011,140600010,,,,1,1,2
HND-012161,2011,140600018,,,,0,1,1
HND-012146,2011,140600001,,,,7,12,19
HND-012147,2011,140600002,,,,8,5,13
HND-012150,2011,140600005,,,,3,7,10
HND-012152,2011,140600007,,,,9,11,20
HND-012154,2011,140600009,,,,0,1,1
HND-012156,2011,140600011,,,,0,1,1
HND-012162,2011,140600019,,,,3,2,5
HND-012148,2011,140600003,,,,11,5,16
HND-012149,2011,140600004,,,,2,2,4
HND-012151,2011,140600006,,,,0,2,2
HND-012153,2011,140600008,,,,2,2,4
HND-012155,2011,140600010,,,,3,4,7
HND-012161,2011,140600018,,,,1,1,2
HND-012146,2011,140600001,,,,7,7,14
HND-012150,2011,140600005,,,,0,3,3
HND-012151,2011,140600006,,,,2,1,3
HND-012156,2011,140600011,,,,0,1,1
HND-012147,2011,140600002,,,,7,3,10
HND-012148,2011,140600003,,,,10,8,18
HND-012149,2011,140600004,,,,1,2,3
HND-012152,2011,140600007,,,,12,14,26
HND-012153,2011,140600008,,,,1,2,3
HND-012155,2011,140600010,,,,0,3,3
HND-012161,2011,140600018,,,,1,1,2
HND-012162,2011,140600019,,,,3,1,4
HND-012148,2011,140600003,,,,6,12,18
HND-012151,2011,140600006,,,,3,1,4
HND-012155,2011,140600010,,,,2,4,6
HND-012146,2011,140600001,,,,10,15,25
HND-012147,2011,140600002,,,,4,7,11
HND-012149,2011,140600004,,,,1,6,7
HND-012150,2011,140600005,,,,5,1,6
HND-012152,2011,140600007,,,,20,12,32
HND-012154,2011,140600009,,,,0,1,1
HND-012162,2011,140600019,,,,2,2,4
HND-012159,2011,140600014,,,,31,26,57
HND-012159,2011,140600014,,,,23,26,49
HND-012159,2011,140600014,,,,25,27,52
HND-012159,2011,140600014,,,,11,14,25
HND-012159,2011,140600014,,,,16,12,28
HND-012159,2011,140600014,,,,15,20,35
,2011,140700053,,,,6,6,12
,2011,140700054,,,,3,4,7
HND-012179,2011,140700016,,,,8,5,13
HND-012181,2011,140700018,,,,3,4,7
HND-012183,2011,140700020,,,,1,5,6
HND-012185,2011,140700034,,,,2,1,3
HND-012194,2011,140700056,,,,0,4,4
HND-012196,2011,140700059,,,,2,1,3
HND-012180,2011,140700017,,,,2,4,6
HND-012186,2011,140700035,,,,0,2,2
HND-012191,2011,140700052,,,,3,2,5
HND-012195,2011,140700058,,,,1,0,1
,2011,140700060,,,,2,3,5
HND-012197,2011,140700061,,,,0,4,4
HND-012179,2011,140700016,,,,3,8,11
HND-012180,2011,140700017,,,,12,15,27
HND-012181,2011,140700018,,,,11,9,20
HND-012185,2011,140700034,,,,6,1,7
HND-012191,2011,140700052,,,,2,1,3
HND-012194,2011,140700056,,,,4,0,4
HND-012196,2011,140700059,,,,3,2,5
HND-012182,2011,140700019,,,,6,6,12
HND-012183,2011,140700020,,,,8,3,11
HND-012186,2011,140700035,,,,1,4,5
HND-012195,2011,140700058,,,,3,2,5
,2011,140700060,,,,3,1,4
HND-012197,2011,140700061,,,,2,3,5
HND-012180,2011,140700017,,,,17,13,30
HND-012182,2011,140700019,,,,6,4,10
HND-012185,2011,140700034,,,,0,1,1
HND-012194,2011,140700056,,,,3,2,5
,2011,140700060,,,,3,1,4
HND-012197,2011,140700061,,,,1,1,2
HND-012179,2011,140700016,,,,8,10,18
HND-012181,2011,140700018,,,,9,10,19
HND-012183,2011,140700020,,,,9,5,14
HND-012186,2011,140700035,,,,2,1,3
HND-012191,2011,140700052,,,,1,4,5
HND-012195,2011,140700058,,,,6,4,10
HND-012196,2011,140700059,,,,1,1,2
HND-012166,2011,140700002,,,,23,17,40
HND-012167,2011,140700003,,,,2,3,5
,2011,140700004,,,,10,11,21
HND-012169,2011,140700006,,,,23,19,42
HND-012173,2011,140700010,,,,5,5,10
HND-012174,2011,140700011,,,,3,4,7
HND-012176,2011,140700013,,,,6,4,10
,2011,140700039,,,,0,3,3
HND-012168,2011,140700005,,,,26,12,38
HND-012171,2011,140700008,,,,2,2,4
HND-012172,2011,140700009,,,,4,6,10
HND-012175,2011,140700012,,,,4,0,4
HND-012177,2011,140700014,,,,1,1,2
HND-012178,2011,140700015,,,,2,1,3
HND-012187,2011,140700038,,,,5,2,7
HND-012189,2011,140700040,,,,9,2,11
HND-012190,2011,140700051,,,,0,1,1
HND-012191,2011,140700052,,,,1,0,1
HND-012166,2011,140700002,,,,10,15,25
HND-012167,2011,140700003,,,,3,3,6
HND-012168,2011,140700005,,,,15,13,28
HND-012169,2011,140700006,,,,15,7,22
HND-012172,2011,140700009,,,,1,2,3
,2011,140700039,,,,3,6,9
HND-012165,2011,140700001,,,,2,3,5
,2011,140700004,,,,8,9,17
HND-012170,2011,140700007,,,,2,5,7
HND-012171,2011,140700008,,,,3,4,7
HND-012173,2011,140700010,,,,3,3,6
HND-012174,2011,140700011,,,,4,4,8
HND-012175,2011,140700012,,,,1,2,3
HND-012176,2011,140700013,,,,5,6,11
HND-012177,2011,140700014,,,,2,3,5
HND-012178,2011,140700015,,,,2,2,4
HND-012187,2011,140700038,,,,0,1,1
HND-012189,2011,140700040,,,,6,0,6
HND-012190,2011,140700051,,,,1,0,1
HND-012191,2011,140700052,,,,1,4,5
HND-012193,2011,140700055,,,,0,1,1
HND-012166,2011,140700002,,,,20,15,35
HND-012168,2011,140700005,,,,20,21,41
HND-012171,2011,140700008,,,,4,1,5
HND-012172,2011,140700009,,,,4,1,5
HND-012175,2011,140700012,,,,2,3,5
HND-012177,2011,140700014,,,,3,2,5
HND-012178,2011,140700015,,,,3,1,4
HND-012187,2011,140700038,,,,3,5,8
HND-012189,2011,140700040,,,,4,4,8
HND-012190,2011,140700051,,,,2,2,4
HND-012191,2011,140700052,,,,2,0,2
HND-012165,2011,140700001,,,,1,1,2
HND-012167,2011,140700003,,,,3,3,6
,2011,140700004,,,,11,4,15
HND-012169,2011,140700006,,,,20,14,34
HND-012170,2011,140700007,,,,8,1,9
HND-012173,2011,140700010,,,,6,0,6
HND-012174,2011,140700011,,,,4,3,7
HND-012176,2011,140700013,,,,8,3,11
,2011,140700039,,,,4,1,5
HND-012193,2011,140700055,,,,1,5,6
HND-012166,2011,140700002,,,,18,18,36
HND-012167,2011,140700003,,,,0,4,4
HND-012169,2011,140700006,,,,14,12,26
HND-012170,2011,140700007,,,,4,8,12
HND-012172,2011,140700009,,,,3,3,6
HND-012174,2011,140700011,,,,3,10,13
HND-012189,2011,140700040,,,,6,3,9
HND-012165,2011,140700001,,,,2,1,3
,2011,140700004,,,,8,9,17
HND-012168,2011,140700005,,,,20,21,41
HND-012171,2011,140700008,,,,4,3,7
HND-012173,2011,140700010,,,,8,2,10
HND-012175,2011,140700012,,,,1,3,4
HND-012176,2011,140700013,,,,0,4,4
HND-012177,2011,140700014,,,,1,0,1
HND-012178,2011,140700015,,,,4,3,7
HND-012187,2011,140700038,,,,4,1,5
,2011,140700039,,,,2,6,8
HND-012190,2011,140700051,,,,1,2,3
HND-012191,2011,140700052,,,,1,1,2
HND-012193,2011,140700055,,,,3,2,5
HND-012165,2011,140700001,,,,2,1,3
HND-012166,2011,140700002,,,,13,23,36
HND-012167,2011,140700003,,,,6,5,11
HND-012169,2011,140700006,,,,19,7,26
HND-012170,2011,140700007,,,,3,3,6
HND-012172,2011,140700009,,,,4,4,8
HND-012173,2011,140700010,,,,4,2,6
HND-012174,2011,140700011,,,,1,3,4
HND-012176,2011,140700013,,,,6,3,9
HND-012187,2011,140700038,,,,3,3,6
HND-012189,2011,140700040,,,,5,4,9
HND-012190,2011,140700051,,,,1,1,2
HND-012191,2011,140700052,,,,0,1,1
,2011,140700004,,,,10,17,27
HND-012168,2011,140700005,,,,19,18,37
HND-012171,2011,140700008,,,,1,4,5
HND-012175,2011,140700012,,,,2,1,3
HND-012177,2011,140700014,,,,2,2,4
HND-012178,2011,140700015,,,,0,8,8
,2011,140700039,,,,3,4,7
HND-012165,2011,140700001,,,,0,2,2
,2011,140700004,,,,7,8,15
HND-012170,2011,140700007,,,,0,2,2
HND-012171,2011,140700008,,,,2,3,5
HND-012173,2011,140700010,,,,5,4,9
HND-012174,2011,140700011,,,,3,5,8
HND-012175,2011,140700012,,,,4,0,4
HND-012176,2011,140700013,,,,1,4,5
HND-012177,2011,140700014,,,,3,1,4
HND-012178,2011,140700015,,,,1,3,4
HND-012187,2011,140700038,,,,1,2,3
HND-012189,2011,140700040,,,,7,7,14
HND-012190,2011,140700051,,,,1,0,1
HND-012193,2011,140700055,,,,1,1,2
HND-012166,2011,140700002,,,,17,10,27
HND-012167,2011,140700003,,,,3,5,8
HND-012168,2011,140700005,,,,20,23,43
HND-012169,2011,140700006,,,,5,16,21
HND-012172,2011,140700009,,,,2,3,5
,2011,140700039,,,,4,2,6
HND-012184,2011,140700021,,,,58,80,138
HND-012184,2011,140700021,,,,60,56,116
HND-012184,2011,140700021,,,,37,76,113
HND-012184,2011,140700021,,,,24,49,73
HND-012184,2011,140700021,,,,29,38,67
HND-012184,2011,140700021,,,,20,27,47
,2011,140800029,,,,3,6,9
,2011,140800056,,,,3,3,6
,2011,140800050,,,,3,4,7
,2011,140800051,,,,2,4,6
,2011,140800054,,,,6,3,9
,2011,140800055,,,,4,4,8
HND-012211,2011,140800014,,,,0,2,2
HND-012211,2011,140800014,,,,10,11,21
HND-012212,2011,140800015,,,,4,11,15
HND-012213,2011,140800016,,,,1,5,6
HND-012214,2011,140800017,,,,6,8,14
HND-012211,2011,140800014,,,,17,7,24
HND-012212,2011,140800015,,,,5,6,11
HND-012213,2011,140800016,,,,1,2,3
HND-012214,2011,140800017,,,,8,12,20
HND-012199,2011,140800001,,,,0,1,1
HND-012201,2011,140800003,,,,19,14,33
HND-012202,2011,140800004,,,,4,3,7
HND-012205,2011,140800007,,,,0,2,2
HND-012206,2011,140800008,,,,5,4,9
,2011,140800010,,,,6,5,11
HND-012208,2011,140800011,,,,1,1,2
HND-012210,2011,140800013,,,,2,2,4
HND-012215,2011,140800019,,,,0,2,2
HND-012216,2011,140800020,,,,14,11,25
HND-012218,2011,140800022,,,,0,1,1
HND-012219,2011,140800053,,,,2,2,4
HND-012221,2011,140800058,,,,2,3,5
HND-012200,2011,140800002,,,,1,3,4
HND-012203,2011,140800005,,,,4,7,11
HND-012207,2011,140800009,,,,9,1,10
HND-012209,2011,140800012,,,,2,1,3
HND-012220,2011,140800057,,,,2,1,3
HND-012199,2011,140800001,,,,0,1,1
HND-012201,2011,140800003,,,,12,9,21
HND-012202,2011,140800004,,,,0,2,2
HND-012203,2011,140800005,,,,8,5,13
HND-012206,2011,140800008,,,,4,3,7
,2011,140800010,,,,6,3,9
HND-012208,2011,140800011,,,,1,3,4
HND-012209,2011,140800012,,,,3,2,5
HND-012210,2011,140800013,,,,0,5,5
HND-012216,2011,140800020,,,,8,6,14
HND-012218,2011,140800022,,,,1,2,3
HND-012219,2011,140800053,,,,5,1,6
HND-012221,2011,140800058,,,,0,1,1
HND-012200,2011,140800002,,,,0,1,1
HND-012204,2011,140800006,,,,2,0,2
HND-012205,2011,140800007,,,,1,0,1
HND-012207,2011,140800009,,,,2,1,3
HND-012215,2011,140800019,,,,1,2,3
HND-012220,2011,140800057,,,,1,0,1
HND-012201,2011,140800003,,,,11,7,18
HND-012202,2011,140800004,,,,3,1,4
HND-012206,2011,140800008,,,,7,3,10
,2011,140800010,,,,4,5,9
HND-012208,2011,140800011,,,,10,2,12
HND-012210,2011,140800013,,,,5,0,5
HND-012215,2011,140800019,,,,4,1,5
HND-012216,2011,140800020,,,,6,6,12
HND-012218,2011,140800022,,,,0,1,1
HND-012220,2011,140800057,,,,0,1,1
HND-012200,2011,140800002,,,,2,1,3
HND-012203,2011,140800005,,,,10,5,15
HND-012204,2011,140800006,,,,2,0,2
HND-012207,2011,140800009,,,,5,4,9
HND-012209,2011,140800012,,,,4,5,9
HND-012219,2011,140800053,,,,1,1,2
HND-012221,2011,140800058,,,,1,3,4
HND-012199,2011,140800001,,,,1,0,1
HND-012200,2011,140800002,,,,1,1,2
HND-012201,2011,140800003,,,,11,19,30
HND-012202,2011,140800004,,,,2,4,6
HND-012203,2011,140800005,,,,3,6,9
HND-012206,2011,140800008,,,,2,2,4
HND-012207,2011,140800009,,,,3,0,3
,2011,140800010,,,,5,6,11
HND-012209,2011,140800012,,,,2,0,2
HND-012210,2011,140800013,,,,1,2,3
HND-012219,2011,140800053,,,,2,2,4
HND-012204,2011,140800006,,,,1,1,2
HND-012205,2011,140800007,,,,0,2,2
HND-012208,2011,140800011,,,,1,6,7
HND-012215,2011,140800019,,,,3,5,8
HND-012216,2011,140800020,,,,4,7,11
HND-012218,2011,140800022,,,,1,0,1
HND-012220,2011,140800057,,,,2,1,3
HND-012199,2011,140800001,,,,1,2,3
HND-012200,2011,140800002,,,,2,0,2
HND-012201,2011,140800003,,,,9,13,22
HND-012203,2011,140800005,,,,7,7,14
HND-012207,2011,140800009,,,,2,2,4
,2011,140800010,,,,4,3,7
HND-012209,2011,140800012,,,,9,8,17
HND-012219,2011,140800053,,,,4,3,7
HND-012221,2011,140800058,,,,0,1,1
HND-012202,2011,140800004,,,,1,3,4
HND-012204,2011,140800006,,,,2,0,2
HND-012205,2011,140800007,,,,2,2,4
HND-012206,2011,140800008,,,,3,2,5
HND-012208,2011,140800011,,,,3,2,5
HND-012215,2011,140800019,,,,1,2,3
HND-012216,2011,140800020,,,,10,11,21
HND-012218,2011,140800022,,,,1,0,1
HND-012220,2011,140800057,,,,3,1,4
HND-012204,2011,140800006,,,,1,0,1
HND-012205,2011,140800007,,,,2,1,3
HND-012207,2011,140800009,,,,4,1,5
HND-012215,2011,140800019,,,,2,2,4
HND-012220,2011,140800057,,,,1,0,1
HND-012199,2011,140800001,,,,3,1,4
HND-012201,2011,140800003,,,,14,9,23
HND-012202,2011,140800004,,,,5,2,7
HND-012203,2011,140800005,,,,7,4,11
HND-012206,2011,140800008,,,,4,8,12
,2011,140800010,,,,4,1,5
HND-012208,2011,140800011,,,,2,3,5
HND-012210,2011,140800013,,,,1,0,1
HND-012216,2011,140800020,,,,11,5,16
HND-012219,2011,140800053,,,,7,8,15
HND-012221,2011,140800058,,,,0,1,1
HND-012201,2011,140800003,,,,13,18,31
HND-012201,2011,140800003,,,,18,16,34
HND-012201,2011,140800003,,,,13,6,19
HND-012241,2011,140900022,,,,8,4,12
HND-012246,2011,140900049,,,,5,3,8
,2011,140900050,,,,6,4,10
,2011,140900061,,,,8,5,13
,2011,140900063,,,,3,2,5
,2011,140900066,,,,10,2,12
HND-012248,2011,140900067,,,,3,3,6
HND-012224,2011,140900004,,,,7,9,16
HND-012247,2011,140900064,,,,4,4,8
,2011,140900065,,,,7,2,9
,2011,140900068,,,,4,3,7
HND-012237,2011,140900017,,,,14,13,27
HND-012238,2011,140900018,,,,4,4,8
,2011,140900020,,,,4,7,11
HND-012245,2011,140900047,,,,0,2,2
,2011,140900048,,,,6,3,9
HND-012239,2011,140900019,,,,4,7,11
HND-012240,2011,140900021,,,,1,0,1
HND-012243,2011,140900045,,,,3,1,4
HND-012238,2011,140900018,,,,7,6,13
,2011,140900020,,,,3,7,10
HND-012240,2011,140900021,,,,3,3,6
HND-012242,2011,140900024,,,,2,1,3
HND-012243,2011,140900045,,,,2,3,5
HND-012245,2011,140900047,,,,5,3,8
HND-012237,2011,140900017,,,,13,11,24
HND-012239,2011,140900019,,,,3,2,5
,2011,140900048,,,,2,8,10
HND-012239,2011,140900019,,,,2,2,4
HND-012243,2011,140900045,,,,5,2,7
HND-012245,2011,140900047,,,,3,4,7
HND-012237,2011,140900017,,,,13,13,26
HND-012238,2011,140900018,,,,6,8,14
,2011,140900020,,,,5,7,12
HND-012240,2011,140900021,,,,6,6,12
HND-012242,2011,140900024,,,,3,6,9
,2011,140900048,,,,4,0,4
HND-012222,2011,140900002,,,,2,3,5
HND-012225,2011,140900005,,,,8,8,16
HND-012228,2011,140900008,,,,7,3,10
HND-012229,2011,140900009,,,,5,2,7
HND-012231,2011,140900011,,,,2,5,7
HND-012232,2011,140900012,,,,18,21,39
HND-012233,2011,140900013,,,,6,5,11
HND-012236,2011,140900016,,,,6,3,9
,2011,140900020,,,,3,6,9
HND-012240,2011,140900021,,,,6,6,12
HND-012249,2011,140900069,,,,2,0,2
HND-012223,2011,140900003,,,,8,11,19
HND-012224,2011,140900004,,,,3,6,9
HND-012226,2011,140900006,,,,3,4,7
HND-012227,2011,140900007,,,,3,5,8
HND-012230,2011,140900010,,,,4,9,13
HND-012234,2011,140900014,,,,3,2,5
HND-012235,2011,140900015,,,,7,5,12
HND-012241,2011,140900022,,,,1,6,7
HND-012244,2011,140900046,,,,2,1,3
HND-012222,2011,140900002,,,,6,2,8
HND-012224,2011,140900004,,,,6,6,12
HND-012227,2011,140900007,,,,0,2,2
HND-012228,2011,140900008,,,,10,4,14
HND-012232,2011,140900012,,,,14,13,27
HND-012235,2011,140900015,,,,5,2,7
HND-012236,2011,140900016,,,,2,4,6
HND-012244,2011,140900046,,,,1,1,2
HND-012223,2011,140900003,,,,11,11,22
HND-012225,2011,140900005,,,,7,6,13
HND-012226,2011,140900006,,,,5,3,8
HND-012229,2011,140900009,,,,3,4,7
HND-012230,2011,140900010,,,,4,4,8
HND-012231,2011,140900011,,,,6,3,9
HND-012233,2011,140900013,,,,4,2,6
HND-012234,2011,140900014,,,,1,0,1
,2011,140900020,,,,6,6,12
HND-012240,2011,140900021,,,,4,4,8
HND-012241,2011,140900022,,,,4,3,7
HND-012249,2011,140900069,,,,2,5,7
HND-012223,2011,140900003,,,,17,10,27
HND-012224,2011,140900004,,,,8,4,12
HND-012226,2011,140900006,,,,9,7,16
HND-012227,2011,140900007,,,,7,3,10
HND-012228,2011,140900008,,,,4,2,6
HND-012230,2011,140900010,,,,3,2,5
HND-012235,2011,140900015,,,,3,2,5
HND-012241,2011,140900022,,,,4,3,7
HND-012244,2011,140900046,,,,1,1,2
HND-012222,2011,140900002,,,,4,7,11
HND-012225,2011,140900005,,,,9,9,18
HND-012229,2011,140900009,,,,5,3,8
HND-012231,2011,140900011,,,,6,3,9
HND-012232,2011,140900012,,,,17,10,27
HND-012233,2011,140900013,,,,8,7,15
HND-012234,2011,140900014,,,,2,2,4
HND-012236,2011,140900016,,,,12,7,19
,2011,140900020,,,,8,4,12
HND-012240,2011,140900021,,,,4,4,8
HND-012249,2011,140900069,,,,1,3,4
HND-012222,2011,140900002,,,,6,4,10
HND-012224,2011,140900004,,,,6,5,11
HND-012225,2011,140900005,,,,8,8,16
HND-012228,2011,140900008,,,,5,3,8
HND-012232,2011,140900012,,,,18,18,36
HND-012233,2011,140900013,,,,4,4,8
HND-012236,2011,140900016,,,,6,4,10
HND-012240,2011,140900021,,,,2,6,8
HND-012244,2011,140900046,,,,3,1,4
HND-012223,2011,140900003,,,,14,16,30
HND-012226,2011,140900006,,,,0,8,8
HND-012227,2011,140900007,,,,3,3,6
HND-012229,2011,140900009,,,,5,5,10
HND-012230,2011,140900010,,,,2,3,5
HND-012231,2011,140900011,,,,5,3,8
HND-012234,2011,140900014,,,,2,4,6
HND-012235,2011,140900015,,,,6,3,9
,2011,140900020,,,,6,5,11
HND-012241,2011,140900022,,,,1,3,4
HND-012249,2011,140900069,,,,1,1,2
HND-012222,2011,140900002,,,,6,8,14
HND-012224,2011,140900004,,,,5,9,14
HND-012225,2011,140900005,,,,6,12,18
HND-012228,2011,140900008,,,,2,5,7
HND-012229,2011,140900009,,,,3,4,7
HND-012231,2011,140900011,,,,4,4,8
HND-012232,2011,140900012,,,,16,21,37
HND-012233,2011,140900013,,,,8,6,14
HND-012236,2011,140900016,,,,1,3,4
HND-012240,2011,140900021,,,,3,4,7
HND-012249,2011,140900069,,,,3,2,5
HND-012223,2011,140900003,,,,12,15,27
HND-012226,2011,140900006,,,,3,8,11
HND-012227,2011,140900007,,,,3,5,8
HND-012230,2011,140900010,,,,5,5,10
HND-012234,2011,140900014,,,,1,0,1
HND-012235,2011,140900015,,,,0,2,2
,2011,140900020,,,,5,9,14
HND-012241,2011,140900022,,,,1,2,3
HND-012223,2011,140900003,,,,18,12,30
HND-012225,2011,140900005,,,,10,4,14
HND-012226,2011,140900006,,,,4,9,13
HND-012229,2011,140900009,,,,12,4,16
HND-012230,2011,140900010,,,,3,2,5
HND-012231,2011,140900011,,,,2,0,2
HND-012233,2011,140900013,,,,6,6,12
HND-012234,2011,140900014,,,,7,3,10
,2011,140900020,,,,4,5,9
HND-012240,2011,140900021,,,,3,3,6
HND-012241,2011,140900022,,,,2,3,5
HND-012249,2011,140900069,,,,2,0,2
HND-012222,2011,140900002,,,,6,8,14
HND-012224,2011,140900004,,,,4,5,9
HND-012227,2011,140900007,,,,1,3,4
HND-012228,2011,140900008,,,,2,4,6
HND-012232,2011,140900012,,,,16,15,31
HND-012235,2011,140900015,,,,3,3,6
HND-012236,2011,140900016,,,,2,5,7
HND-012244,2011,140900046,,,,1,1,2
HND-012232,2011,140900012,,,,19,36,55
HND-012225,2011,140900005,,,,5,17,22
HND-012225,2011,140900005,,,,6,11,17
HND-012232,2011,140900012,,,,21,23,44
HND-012225,2011,140900005,,,,5,8,13
HND-012232,2011,140900012,,,,19,30,49
HND-012225,2011,140900005,,,,4,8,12
HND-012277,2011,141000070,,,,4,1,5
HND-012278,2011,141000071,,,,3,3,6
HND-012276,2011,141000067,,,,5,2,7
,2011,141000072,,,,2,2,4
HND-012265,2011,141000015,,,,4,0,4
HND-012266,2011,141000016,,,,3,1,4
HND-012274,2011,141000044,,,,3,2,5
HND-012275,2011,141000066,,,,1,0,1
HND-012267,2011,141000017,,,,1,1,2
HND-012269,2011,141000021,,,,2,0,2
HND-012270,2011,141000022,,,,0,2,2
,2011,141000069,,,,0,3,3
HND-012265,2011,141000015,,,,18,11,29
HND-012267,2011,141000017,,,,3,4,7
HND-012268,2011,141000018,,,,3,2,5
HND-012274,2011,141000044,,,,3,3,6
HND-012275,2011,141000066,,,,3,4,7
,2011,141000069,,,,2,3,5
HND-012266,2011,141000016,,,,4,3,7
HND-012269,2011,141000021,,,,8,4,12
HND-012270,2011,141000022,,,,4,7,11
HND-012265,2011,141000015,,,,16,12,28
HND-012268,2011,141000018,,,,6,5,11
HND-012275,2011,141000066,,,,2,4,6
HND-012266,2011,141000016,,,,3,6,9
HND-012267,2011,141000017,,,,4,4,8
HND-012269,2011,141000021,,,,7,4,11
HND-012270,2011,141000022,,,,6,1,7
HND-012274,2011,141000044,,,,3,3,6
,2011,141000069,,,,7,4,11
HND-012251,2011,141000001,,,,1,3,4
HND-012256,2011,141000006,,,,2,0,2
HND-012258,2011,141000008,,,,21,16,37
HND-012259,2011,141000009,,,,4,0,4
HND-012262,2011,141000012,,,,2,7,9
HND-012263,2011,141000013,,,,3,2,5
HND-012264,2011,141000014,,,,2,10,12
HND-012271,2011,141000033,,,,1,6,7
HND-012272,2011,141000037,,,,1,4,5
HND-012252,2011,141000002,,,,15,10,25
HND-012253,2011,141000003,,,,2,3,5
HND-012254,2011,141000004,,,,10,16,26
HND-012255,2011,141000005,,,,8,5,13
HND-012257,2011,141000007,,,,4,2,6
HND-012261,2011,141000011,,,,2,2,4
HND-012273,2011,141000043,,,,1,2,3
HND-012251,2011,141000001,,,,3,2,5
HND-012252,2011,141000002,,,,11,5,16
HND-012253,2011,141000003,,,,2,4,6
HND-012254,2011,141000004,,,,8,6,14
HND-012256,2011,141000006,,,,3,1,4
HND-012257,2011,141000007,,,,2,8,10
HND-012258,2011,141000008,,,,12,19,31
HND-012264,2011,141000014,,,,10,0,10
HND-012271,2011,141000033,,,,2,3,5
HND-012272,2011,141000037,,,,1,0,1
HND-012273,2011,141000043,,,,5,3,8
HND-012255,2011,141000005,,,,6,6,12
HND-012259,2011,141000009,,,,5,0,5
HND-012261,2011,141000011,,,,6,4,10
HND-012262,2011,141000012,,,,5,5,10
HND-012263,2011,141000013,,,,1,0,1
HND-012251,2011,141000001,,,,2,6,8
HND-012256,2011,141000006,,,,0,2,2
HND-012258,2011,141000008,,,,13,17,30
HND-012259,2011,141000009,,,,3,0,3
HND-012263,2011,141000013,,,,1,4,5
HND-012264,2011,141000014,,,,5,2,7
HND-012273,2011,141000043,,,,1,1,2
HND-012252,2011,141000002,,,,15,10,25
HND-012253,2011,141000003,,,,3,5,8
HND-012254,2011,141000004,,,,10,8,18
HND-012255,2011,141000005,,,,10,5,15
HND-012257,2011,141000007,,,,8,7,15
HND-012261,2011,141000011,,,,4,2,6
HND-012262,2011,141000012,,,,3,4,7
HND-012272,2011,141000037,,,,0,2,2
HND-012251,2011,141000001,,,,6,4,10
HND-012252,2011,141000002,,,,12,9,21
HND-012253,2011,141000003,,,,2,3,5
HND-012254,2011,141000004,,,,5,7,12
HND-012255,2011,141000005,,,,6,2,8
HND-012256,2011,141000006,,,,2,1,3
HND-012257,2011,141000007,,,,9,6,15
HND-012260,2011,141000010,,,,3,4,7
HND-012261,2011,141000011,,,,7,3,10
HND-012271,2011,141000033,,,,0,2,2
HND-012272,2011,141000037,,,,0,1,1
HND-012273,2011,141000043,,,,1,0,1
HND-012258,2011,141000008,,,,11,10,21
HND-012259,2011,141000009,,,,4,3,7
HND-012262,2011,141000012,,,,1,3,4
HND-012263,2011,141000013,,,,4,1,5
HND-012264,2011,141000014,,,,0,2,2
HND-012252,2011,141000002,,,,9,6,15
HND-012253,2011,141000003,,,,4,6,10
HND-012254,2011,141000004,,,,2,10,12
HND-012255,2011,141000005,,,,4,2,6
HND-012257,2011,141000007,,,,3,8,11
HND-012260,2011,141000010,,,,2,1,3
HND-012261,2011,141000011,,,,2,7,9
HND-012271,2011,141000033,,,,1,1,2
HND-012272,2011,141000037,,,,0,1,1
HND-012251,2011,141000001,,,,4,3,7
HND-012256,2011,141000006,,,,2,2,4
HND-012258,2011,141000008,,,,13,12,25
HND-012259,2011,141000009,,,,6,5,11
HND-012262,2011,141000012,,,,4,1,5
HND-012263,2011,141000013,,,,2,4,6
HND-012264,2011,141000014,,,,6,1,7
HND-012273,2011,141000043,,,,4,3,7
HND-012255,2011,141000005,,,,9,4,13
HND-012259,2011,141000009,,,,7,3,10
HND-012260,2011,141000010,,,,1,1,2
HND-012261,2011,141000011,,,,2,4,6
HND-012262,2011,141000012,,,,0,3,3
HND-012263,2011,141000013,,,,2,0,2
HND-012251,2011,141000001,,,,5,7,12
HND-012252,2011,141000002,,,,7,8,15
HND-012253,2011,141000003,,,,5,1,6
HND-012254,2011,141000004,,,,5,3,8
HND-012256,2011,141000006,,,,0,8,8
HND-012257,2011,141000007,,,,4,10,14
HND-012258,2011,141000008,,,,10,16,26
HND-012264,2011,141000014,,,,0,3,3
HND-012271,2011,141000033,,,,0,3,3
HND-012273,2011,141000043,,,,2,2,4
HND-012258,2011,141000008,,,,23,25,48
HND-012258,2011,141000008,,,,12,26,38
HND-012258,2011,141000008,,,,14,20,34
HND-012280,2011,141100003,,,,5,4,9
HND-012298,2011,141100043,,,,10,8,18
HND-012299,2011,141100044,,,,3,11,14
,2011,141100069,,,,2,4,6
HND-012305,2011,141100065,,,,2,2,4
,2011,141100067,,,,3,1,4
,2011,141100070,,,,3,3,6
HND-012292,2011,141100016,,,,5,3,8
HND-012306,2011,141100066,,,,3,4,7
HND-012297,2011,141100042,,,,5,4,9
HND-012304,2011,141100064,,,,1,0,1
HND-012307,2011,141100071,,,,1,3,4
HND-012296,2011,141100030,,,,5,3,8
HND-012297,2011,141100042,,,,1,3,4
HND-012292,2011,141100016,,,,15,18,33
HND-012293,2011,141100017,,,,7,12,19
HND-012304,2011,141100064,,,,9,6,15
HND-012306,2011,141100066,,,,0,1,1
HND-012307,2011,141100071,,,,3,2,5
HND-012292,2011,141100016,,,,27,25,52
HND-012293,2011,141100017,,,,10,7,17
HND-012304,2011,141100064,,,,3,5,8
HND-012307,2011,141100071,,,,5,4,9
HND-012296,2011,141100030,,,,8,9,17
HND-012297,2011,141100042,,,,1,1,2
HND-012306,2011,141100066,,,,4,1,5
HND-012279,2011,141100002,,,,9,9,18
HND-012280,2011,141100003,,,,4,3,7
HND-012281,2011,141100004,,,,9,13,22
HND-012283,2011,141100006,,,,2,4,6
HND-012284,2011,141100007,,,,1,3,4
HND-012286,2011,141100010,,,,6,4,10
HND-012287,2011,141100011,,,,5,3,8
,2011,141100018,,,,4,2,6
HND-012300,2011,141100046,,,,3,0,3
HND-012282,2011,141100005,,,,28,30,58
HND-012285,2011,141100008,,,,6,1,7
,2011,141100009,,,,18,15,33
HND-012288,2011,141100012,,,,3,1,4
HND-012289,2011,141100013,,,,0,3,3
HND-012290,2011,141100014,,,,3,1,4
HND-012291,2011,141100015,,,,1,2,3
HND-012301,2011,141100061,,,,1,1,2
HND-012282,2011,141100005,,,,33,27,60
HND-012283,2011,141100006,,,,6,4,10
,2011,141100009,,,,7,11,18
HND-012291,2011,141100015,,,,1,3,4
,2011,141100018,,,,5,3,8
HND-012300,2011,141100046,,,,3,1,4
HND-012302,2011,141100062,,,,2,1,3
HND-012303,2011,141100063,,,,2,2,4
HND-012279,2011,141100002,,,,6,5,11
HND-012280,2011,141100003,,,,2,4,6
HND-012281,2011,141100004,,,,7,15,22
HND-012284,2011,141100007,,,,3,3,6
HND-012285,2011,141100008,,,,3,1,4
HND-012286,2011,141100010,,,,3,2,5
HND-012287,2011,141100011,,,,6,4,10
HND-012288,2011,141100012,,,,4,7,11
HND-012290,2011,141100014,,,,1,3,4
HND-012301,2011,141100061,,,,4,5,9
HND-012282,2011,141100005,,,,26,27,53
HND-012285,2011,141100008,,,,1,5,6
,2011,141100009,,,,7,15,22
HND-012288,2011,141100012,,,,7,5,12
HND-012289,2011,141100013,,,,4,1,5
HND-012290,2011,141100014,,,,1,2,3
HND-012291,2011,141100015,,,,2,0,2
HND-012300,2011,141100046,,,,1,1,2
HND-012301,2011,141100061,,,,4,4,8
HND-012302,2011,141100062,,,,2,2,4
HND-012303,2011,141100063,,,,1,3,4
HND-012279,2011,141100002,,,,6,4,10
HND-012280,2011,141100003,,,,7,4,11
HND-012281,2011,141100004,,,,6,11,17
HND-012283,2011,141100006,,,,2,1,3
HND-012284,2011,141100007,,,,2,4,6
HND-012286,2011,141100010,,,,5,3,8
HND-012287,2011,141100011,,,,3,1,4
,2011,141100018,,,,6,1,7
HND-012279,2011,141100002,,,,5,6,11
HND-012281,2011,141100004,,,,9,11,20
HND-012282,2011,141100005,,,,33,30,63
HND-012283,2011,141100006,,,,2,2,4
,2011,141100009,,,,8,7,15
,2011,141100018,,,,5,1,6
HND-012302,2011,141100062,,,,4,2,6
HND-012303,2011,141100063,,,,0,3,3
HND-012280,2011,141100003,,,,9,9,18
HND-012284,2011,141100007,,,,2,6,8
HND-012285,2011,141100008,,,,3,6,9
HND-012286,2011,141100010,,,,0,4,4
HND-012287,2011,141100011,,,,0,7,7
HND-012288,2011,141100012,,,,1,6,7
HND-012289,2011,141100013,,,,2,1,3
HND-012291,2011,141100015,,,,2,1,3
HND-012300,2011,141100046,,,,4,4,8
HND-012301,2011,141100061,,,,0,8,8
HND-012279,2011,141100002,,,,5,3,8
HND-012280,2011,141100003,,,,4,1,5
HND-012281,2011,141100004,,,,14,5,19
HND-012283,2011,141100006,,,,1,0,1
HND-012286,2011,141100010,,,,0,2,2
HND-012287,2011,141100011,,,,5,1,6
,2011,141100018,,,,6,2,8
HND-012303,2011,141100063,,,,2,1,3
HND-012282,2011,141100005,,,,31,32,63
HND-012285,2011,141100008,,,,3,6,9
,2011,141100009,,,,6,11,17
HND-012288,2011,141100012,,,,1,4,5
HND-012289,2011,141100013,,,,2,1,3
HND-012290,2011,141100014,,,,1,4,5
HND-012291,2011,141100015,,,,2,3,5
HND-012300,2011,141100046,,,,1,0,1
HND-012301,2011,141100061,,,,4,6,10
HND-012279,2011,141100002,,,,5,5,10
HND-012280,2011,141100003,,,,6,2,8
HND-012281,2011,141100004,,,,13,13,26
HND-012284,2011,141100007,,,,2,6,8
HND-012285,2011,141100008,,,,5,1,6
HND-012286,2011,141100010,,,,4,2,6
HND-012287,2011,141100011,,,,2,3,5
HND-012288,2011,141100012,,,,4,3,7
HND-012290,2011,141100014,,,,3,1,4
HND-012301,2011,141100061,,,,2,0,2
HND-012282,2011,141100005,,,,24,41,65
HND-012283,2011,141100006,,,,4,1,5
,2011,141100009,,,,15,13,28
HND-012289,2011,141100013,,,,1,3,4
HND-012291,2011,141100015,,,,2,1,3
,2011,141100018,,,,2,3,5
HND-012302,2011,141100062,,,,0,4,4
HND-012303,2011,141100063,,,,2,1,3
HND-012281,2011,141100004,,,,14,17,31
,2011,141100009,,,,9,8,17
HND-012295,2011,141100019,,,,33,29,62
HND-012281,2011,141100004,,,,7,18,25
,2011,141100009,,,,5,5,10
HND-012295,2011,141100019,,,,17,18,35
HND-012281,2011,141100004,,,,7,21,28
HND-012295,2011,141100019,,,,18,22,40
,2011,141100009,,,,3,9,12
HND-012295,2011,141100019,,,,5,18,23
,2011,141100009,,,,4,10,14
HND-012295,2011,141100019,,,,13,11,24
,2011,141200027,,,,2,3,5
HND-012326,2011,141200031,,,,1,6,7
,2011,141200033,,,,2,2,4
HND-012334,2011,141200050,,,,1,5,6
,2011,141200025,,,,5,4,9
,2011,141200039,,,,4,4,8
,2011,141200044,,,,3,3,6
HND-012323,2011,141200016,,,,7,6,13
HND-012324,2011,141200017,,,,3,2,5
HND-012325,2011,141200020,,,,3,3,6
HND-012322,2011,141200015,,,,4,1,5
HND-012327,2011,141200032,,,,2,4,6
HND-012328,2011,141200034,,,,5,4,9
HND-012323,2011,141200016,,,,7,4,11
HND-012324,2011,141200017,,,,7,2,9
HND-012325,2011,141200020,,,,4,3,7
HND-012327,2011,141200032,,,,5,5,10
HND-012328,2011,141200034,,,,11,7,18
HND-012322,2011,141200015,,,,7,9,16
,2011,141200006,,,,4,8,12
HND-012316,2011,141200009,,,,0,3,3
HND-012318,2011,141200011,,,,7,2,9
HND-012319,2011,141200012,,,,1,1,2
HND-012320,2011,141200013,,,,3,0,3
HND-012321,2011,141200014,,,,0,4,4
HND-012329,2011,141200035,,,,4,2,6
HND-012330,2011,141200036,,,,2,4,6
HND-012331,2011,141200037,,,,2,4,6
,2011,141200056,,,,1,2,3
HND-012309,2011,141200001,,,,8,8,16
HND-012310,2011,141200002,,,,7,3,10
HND-012311,2011,141200003,,,,3,2,5
HND-012312,2011,141200004,,,,2,3,5
HND-012313,2011,141200005,,,,6,7,13
HND-012314,2011,141200007,,,,1,3,4
HND-012315,2011,141200008,,,,4,3,7
HND-012332,2011,141200041,,,,1,2,3
HND-012333,2011,141200042,,,,1,1,2
HND-012335,2011,141200065,,,,0,1,1
HND-012310,2011,141200002,,,,7,7,14
HND-012312,2011,141200004,,,,1,0,1
,2011,141200006,,,,4,3,7
HND-012317,2011,141200010,,,,1,0,1
HND-012319,2011,141200012,,,,4,2,6
HND-012320,2011,141200013,,,,3,2,5
HND-012321,2011,141200014,,,,1,2,3
HND-012330,2011,141200036,,,,1,1,2
HND-012333,2011,141200042,,,,3,0,3
HND-012309,2011,141200001,,,,6,8,14
HND-012311,2011,141200003,,,,4,2,6
HND-012313,2011,141200005,,,,8,7,15
HND-012314,2011,141200007,,,,2,1,3
HND-012316,2011,141200009,,,,2,2,4
HND-012318,2011,141200011,,,,0,3,3
HND-012329,2011,141200035,,,,3,0,3
HND-012331,2011,141200037,,,,2,0,2
HND-012335,2011,141200065,,,,3,3,6
,2011,141200006,,,,4,5,9
HND-012316,2011,141200009,,,,1,2,3
HND-012318,2011,141200011,,,,1,1,2
HND-012319,2011,141200012,,,,3,2,5
HND-012320,2011,141200013,,,,3,3,6
HND-012321,2011,141200014,,,,5,1,6
HND-012332,2011,141200041,,,,2,0,2
HND-012333,2011,141200042,,,,1,1,2
HND-012309,2011,141200001,,,,3,8,11
HND-012310,2011,141200002,,,,12,9,21
HND-012311,2011,141200003,,,,2,2,4
HND-012312,2011,141200004,,,,1,3,4
HND-012313,2011,141200005,,,,6,4,10
HND-012314,2011,141200007,,,,3,1,4
HND-012315,2011,141200008,,,,4,2,6
HND-012317,2011,141200010,,,,2,0,2
HND-012329,2011,141200035,,,,2,4,6
HND-012330,2011,141200036,,,,0,2,2
HND-012331,2011,141200037,,,,1,1,2
,2011,141200056,,,,2,0,2
HND-012335,2011,141200065,,,,3,2,5
HND-012310,2011,141200002,,,,11,5,16
HND-012311,2011,141200003,,,,11,3,14
HND-012312,2011,141200004,,,,1,2,3
,2011,141200006,,,,9,8,17
HND-012314,2011,141200007,,,,1,5,6
HND-012317,2011,141200010,,,,4,1,5
HND-012320,2011,141200013,,,,1,2,3
HND-012330,2011,141200036,,,,0,1,1
HND-012332,2011,141200041,,,,1,2,3
HND-012335,2011,141200065,,,,1,0,1
HND-012309,2011,141200001,,,,5,7,12
HND-012313,2011,141200005,,,,3,4,7
HND-012315,2011,141200008,,,,3,2,5
HND-012316,2011,141200009,,,,1,3,4
HND-012318,2011,141200011,,,,5,5,10
HND-012319,2011,141200012,,,,2,1,3
HND-012329,2011,141200035,,,,3,1,4
HND-012331,2011,141200037,,,,1,1,2
,2011,141200056,,,,2,2,4
HND-012309,2011,141200001,,,,10,7,17
HND-012310,2011,141200002,,,,4,7,11
HND-012311,2011,141200003,,,,5,3,8
HND-012313,2011,141200005,,,,6,5,11
,2011,141200006,,,,2,12,14
HND-012314,2011,141200007,,,,2,1,3
HND-012317,2011,141200010,,,,0,6,6
HND-012330,2011,141200036,,,,0,1,1
HND-012335,2011,141200065,,,,0,3,3
HND-012315,2011,141200008,,,,8,6,14
HND-012316,2011,141200009,,,,1,1,2
HND-012318,2011,141200011,,,,9,2,11
HND-012319,2011,141200012,,,,5,0,5
HND-012320,2011,141200013,,,,2,2,4
HND-012321,2011,141200014,,,,0,1,1
HND-012329,2011,141200035,,,,3,3,6
HND-012333,2011,141200042,,,,5,1,6
HND-012309,2011,141200001,,,,6,4,10
HND-012311,2011,141200003,,,,3,3,6
HND-012313,2011,141200005,,,,5,5,10
HND-012314,2011,141200007,,,,6,1,7
HND-012315,2011,141200008,,,,4,3,7
HND-012316,2011,141200009,,,,1,0,1
HND-012318,2011,141200011,,,,1,3,4
HND-012329,2011,141200035,,,,0,1,1
HND-012331,2011,141200037,,,,0,1,1
HND-012310,2011,141200002,,,,11,8,19
HND-012312,2011,141200004,,,,1,1,2
,2011,141200006,,,,5,4,9
HND-012317,2011,141200010,,,,0,1,1
HND-012319,2011,141200012,,,,3,3,6
HND-012320,2011,141200013,,,,1,1,2
HND-012330,2011,141200036,,,,1,0,1
,2011,141200006,,,,10,7,17
,2011,141200006,,,,6,7,13
,2011,141200006,,,,7,10,17
,2011,141300112,,,,4,6,10
HND-012386,2011,141300114,,,,6,6,12
,2011,141300116,,,,6,6,12
,2011,141300125,,,,6,4,10
,2011,141300126,,,,5,2,7
HND-012350,2011,141300015,,,,8,5,13
,2011,141300111,,,,4,3,7
HND-012387,2011,141300117,,,,5,2,7
,2011,141300120,,,,9,4,13
,2011,141300121,,,,6,9,15
,2011,141300123,,,,3,4,7
HND-012390,2011,141300124,,,,2,3,5
HND-012361,2011,141300029,,,,15,21,36
HND-012362,2011,141300030,,,,2,1,3
HND-012368,2011,141300043,,,,2,5,7
HND-012369,2011,141300044,,,,4,0,4
HND-012372,2011,141300056,,,,1,3,4
HND-012376,2011,141300069,,,,2,0,2
,2011,141300073,,,,3,2,5
HND-012384,2011,141300109,,,,1,3,4
HND-012385,2011,141300110,,,,1,2,3
HND-012388,2011,141300119,,,,3,1,4
,2011,141300128,,,,2,3,5
HND-012391,2011,141300129,,,,6,6,12
,2011,141300048,,,,2,4,6
HND-012371,2011,141300055,,,,2,0,2
HND-012375,2011,141300065,,,,4,1,5
,2011,141300067,,,,4,0,4
HND-012377,2011,141300075,,,,9,10,19
HND-012383,2011,141300108,,,,1,2,3
HND-012361,2011,141300029,,,,42,27,69
HND-012368,2011,141300043,,,,5,3,8
HND-012369,2011,141300044,,,,7,10,17
HND-012371,2011,141300055,,,,2,3,5
,2011,141300067,,,,9,9,18
HND-012376,2011,141300069,,,,6,2,8
,2011,141300073,,,,3,7,10
HND-012384,2011,141300109,,,,5,5,10
HND-012385,2011,141300110,,,,1,1,2
HND-012388,2011,141300119,,,,2,1,3
,2011,141300128,,,,2,5,7
HND-012391,2011,141300129,,,,19,15,34
HND-012362,2011,141300030,,,,10,7,17
HND-012363,2011,141300032,,,,2,3,5
,2011,141300048,,,,5,11,16
HND-012372,2011,141300056,,,,5,6,11
HND-012375,2011,141300065,,,,4,6,10
,2011,141300066,,,,2,3,5
HND-012377,2011,141300075,,,,13,9,22
HND-012380,2011,141300079,,,,3,4,7
HND-012383,2011,141300108,,,,3,4,7
HND-012361,2011,141300029,,,,42,46,88
HND-012363,2011,141300032,,,,6,6,12
,2011,141300048,,,,8,9,17
HND-012371,2011,141300055,,,,6,5,11
HND-012372,2011,141300056,,,,4,6,10
,2011,141300067,,,,6,9,15
HND-012376,2011,141300069,,,,8,1,9
HND-012377,2011,141300075,,,,8,12,20
HND-012380,2011,141300079,,,,8,5,13
HND-012383,2011,141300108,,,,2,1,3
HND-012391,2011,141300129,,,,9,8,17
HND-012362,2011,141300030,,,,13,12,25
HND-012368,2011,141300043,,,,5,6,11
HND-012369,2011,141300044,,,,13,13,26
HND-012375,2011,141300065,,,,6,10,16
,2011,141300066,,,,2,1,3
,2011,141300073,,,,5,2,7
HND-012384,2011,141300109,,,,6,6,12
HND-012385,2011,141300110,,,,5,6,11
HND-012388,2011,141300119,,,,0,2,2
,2011,141300128,,,,3,4,7
HND-012336,2011,141300001,,,,57,72,129
,2011,141300005,,,,21,22,43
HND-012343,2011,141300008,,,,9,13,22
HND-012344,2011,141300009,,,,3,8,11
HND-012352,2011,141300018,,,,4,0,4
,2011,141300019,,,,2,1,3
HND-012358,2011,141300026,,,,7,1,8
HND-012364,2011,141300034,,,,3,2,5
HND-012365,2011,141300035,,,,6,4,10
,2011,141300048,,,,7,8,15
HND-012373,2011,141300057,,,,3,0,3
,2011,141300066,,,,7,2,9
,2011,141300067,,,,7,6,13
HND-012378,2011,141300076,,,,2,1,3
HND-012382,2011,141300107,,,,5,0,5
HND-012389,2011,141300122,,,,0,2,2
HND-012337,2011,141300002,,,,11,3,14
HND-012338,2011,141300003,,,,9,10,19
HND-012339,2011,141300004,,,,7,0,7
HND-012341,2011,141300006,,,,23,8,31
,2011,141300007,,,,2,2,4
HND-012345,2011,141300010,,,,6,11,17
HND-012346,2011,141300011,,,,7,5,12
HND-012347,2011,141300012,,,,4,7,11
HND-012348,2011,141300013,,,,9,8,17
HND-012349,2011,141300014,,,,9,2,11
HND-012350,2011,141300015,,,,6,6,12
HND-012351,2011,141300017,,,,2,3,5
HND-012354,2011,141300022,,,,3,1,4
HND-012355,2011,141300023,,,,3,7,10
HND-012356,2011,141300024,,,,5,3,8
HND-012357,2011,141300025,,,,5,5,10
HND-012359,2011,141300027,,,,3,6,9
HND-012360,2011,141300028,,,,2,4,6
HND-012366,2011,141300036,,,,7,8,15
HND-012370,2011,141300054,,,,4,5,9
HND-012374,2011,141300061,,,,2,3,5
HND-012379,2011,141300077,,,,4,7,11
HND-012381,2011,141300081,,,,4,1,5
HND-012341,2011,141300006,,,,9,14,23
HND-012344,2011,141300009,,,,7,5,12
HND-012345,2011,141300010,,,,12,11,23
HND-012346,2011,141300011,,,,2,3,5
,2011,141300019,,,,2,4,6
HND-012358,2011,141300026,,,,6,3,9
HND-012359,2011,141300027,,,,8,6,14
HND-012364,2011,141300034,,,,4,4,8
,2011,141300048,,,,5,9,14
HND-012370,2011,141300054,,,,5,2,7
HND-012374,2011,141300061,,,,1,2,3
,2011,141300067,,,,5,2,7
HND-012382,2011,141300107,,,,2,4,6
HND-012389,2011,141300122,,,,0,1,1
HND-012336,2011,141300001,,,,71,59,130
HND-012337,2011,141300002,,,,14,8,22
HND-012338,2011,141300003,,,,8,10,18
HND-012339,2011,141300004,,,,0,2,2
,2011,141300005,,,,9,16,25
,2011,141300007,,,,7,11,18
HND-012343,2011,141300008,,,,13,6,19
HND-012347,2011,141300012,,,,3,2,5
HND-012348,2011,141300013,,,,9,4,13
HND-012349,2011,141300014,,,,2,5,7
HND-012350,2011,141300015,,,,9,3,12
HND-012351,2011,141300017,,,,2,1,3
HND-012352,2011,141300018,,,,0,3,3
HND-012354,2011,141300022,,,,2,4,6
HND-012355,2011,141300023,,,,3,2,5
HND-012356,2011,141300024,,,,5,0,5
HND-012357,2011,141300025,,,,0,5,5
HND-012360,2011,141300028,,,,2,1,3
HND-012365,2011,141300035,,,,3,0,3
HND-012373,2011,141300057,,,,2,3,5
,2011,141300066,,,,2,2,4
HND-012378,2011,141300076,,,,2,2,4
HND-012379,2011,141300077,,,,5,5,10
HND-012381,2011,141300081,,,,3,2,5
HND-012337,2011,141300002,,,,4,13,17
HND-012338,2011,141300003,,,,4,4,8
HND-012339,2011,141300004,,,,6,4,10
HND-012341,2011,141300006,,,,16,11,27
,2011,141300007,,,,9,10,19
HND-012345,2011,141300010,,,,6,7,13
HND-012346,2011,141300011,,,,2,2,4
HND-012347,2011,141300012,,,,4,5,9
HND-012348,2011,141300013,,,,5,6,11
HND-012349,2011,141300014,,,,3,3,6
HND-012350,2011,141300015,,,,4,5,9
HND-012351,2011,141300017,,,,5,0,5
HND-012354,2011,141300022,,,,2,3,5
HND-012355,2011,141300023,,,,2,5,7
HND-012356,2011,141300024,,,,2,4,6
HND-012357,2011,141300025,,,,3,2,5
HND-012359,2011,141300027,,,,5,5,10
HND-012366,2011,141300036,,,,5,9,14
HND-012370,2011,141300054,,,,4,2,6
HND-012374,2011,141300061,,,,2,1,3
HND-012379,2011,141300077,,,,10,6,16
HND-012381,2011,141300081,,,,3,4,7
HND-012336,2011,141300001,,,,62,59,121
,2011,141300005,,,,11,16,27
HND-012343,2011,141300008,,,,7,6,13
HND-012344,2011,141300009,,,,1,8,9
HND-012352,2011,141300018,,,,6,3,9
,2011,141300019,,,,2,3,5
HND-012358,2011,141300026,,,,6,4,10
HND-012364,2011,141300034,,,,2,7,9
HND-012365,2011,141300035,,,,1,4,5
,2011,141300048,,,,2,4,6
HND-012373,2011,141300057,,,,6,6,12
,2011,141300066,,,,6,2,8
,2011,141300067,,,,4,5,9
HND-012378,2011,141300076,,,,4,2,6
HND-012382,2011,141300107,,,,5,3,8
HND-012389,2011,141300122,,,,3,2,5
HND-012341,2011,141300006,,,,18,24,42
HND-012344,2011,141300009,,,,2,3,5
HND-012345,2011,141300010,,,,6,8,14
HND-012346,2011,141300011,,,,2,3,5
HND-012347,2011,141300012,,,,1,5,6
HND-012349,2011,141300014,,,,4,4,8
HND-012354,2011,141300022,,,,4,7,11
HND-012356,2011,141300024,,,,1,0,1
HND-012359,2011,141300027,,,,1,1,2
HND-012364,2011,141300034,,,,5,8,13
HND-012366,2011,141300036,,,,2,3,5
,2011,141300048,,,,6,6,12
HND-012370,2011,141300054,,,,8,1,9
HND-012374,2011,141300061,,,,3,0,3
HND-012382,2011,141300107,,,,2,1,3
HND-012389,2011,141300122,,,,0,1,1
HND-012336,2011,141300001,,,,74,75,149
HND-012337,2011,141300002,,,,6,8,14
HND-012338,2011,141300003,,,,8,9,17
HND-012339,2011,141300004,,,,3,5,8
,2011,141300005,,,,17,20,37
,2011,141300007,,,,3,1,4
HND-012343,2011,141300008,,,,6,9,15
HND-012348,2011,141300013,,,,5,8,13
HND-012350,2011,141300015,,,,6,3,9
HND-012351,2011,141300017,,,,2,5,7
HND-012352,2011,141300018,,,,1,2,3
,2011,141300019,,,,0,2,2
HND-012355,2011,141300023,,,,0,3,3
HND-012357,2011,141300025,,,,3,2,5
HND-012358,2011,141300026,,,,6,1,7
HND-012360,2011,141300028,,,,4,1,5
HND-012365,2011,141300035,,,,2,5,7
HND-012373,2011,141300057,,,,6,2,8
,2011,141300066,,,,5,3,8
,2011,141300067,,,,3,2,5
HND-012378,2011,141300076,,,,4,0,4
HND-012379,2011,141300077,,,,7,3,10
HND-012381,2011,141300081,,,,4,1,5
HND-012337,2011,141300002,,,,9,12,21
HND-012339,2011,141300004,,,,1,7,8
HND-012341,2011,141300006,,,,24,15,39
HND-012345,2011,141300010,,,,1,3,4
HND-012347,2011,141300012,,,,4,10,14
HND-012348,2011,141300013,,,,4,3,7
HND-012349,2011,141300014,,,,6,5,11
HND-012354,2011,141300022,,,,3,0,3
HND-012355,2011,141300023,,,,2,1,3
HND-012356,2011,141300024,,,,3,0,3
HND-012359,2011,141300027,,,,0,1,1
HND-012360,2011,141300028,,,,1,4,5
HND-012364,2011,141300034,,,,1,4,5
HND-012365,2011,141300035,,,,3,4,7
,2011,141300048,,,,8,3,11
HND-012370,2011,141300054,,,,7,1,8
HND-012373,2011,141300057,,,,4,1,5
HND-012382,2011,141300107,,,,4,5,9
HND-012389,2011,141300122,,,,0,2,2
HND-012336,2011,141300001,,,,72,76,148
HND-012338,2011,141300003,,,,2,13,15
,2011,141300005,,,,19,11,30
,2011,141300007,,,,9,3,12
HND-012343,2011,141300008,,,,6,8,14
HND-012344,2011,141300009,,,,2,4,6
HND-012350,2011,141300015,,,,4,5,9
HND-012352,2011,141300018,,,,5,1,6
,2011,141300019,,,,3,2,5
HND-012357,2011,141300025,,,,2,3,5
HND-012358,2011,141300026,,,,3,4,7
HND-012366,2011,141300036,,,,3,3,6
,2011,141300066,,,,7,3,10
,2011,141300067,,,,1,0,1
HND-012378,2011,141300076,,,,1,6,7
HND-012379,2011,141300077,,,,6,6,12
HND-012381,2011,141300081,,,,1,1,2
HND-012336,2011,141300001,,,,68,77,145
HND-012337,2011,141300002,,,,9,4,13
HND-012338,2011,141300003,,,,4,4,8
HND-012339,2011,141300004,,,,1,4,5
,2011,141300005,,,,12,13,25
,2011,141300007,,,,5,8,13
HND-012343,2011,141300008,,,,2,6,8
HND-012347,2011,141300012,,,,4,3,7
HND-012348,2011,141300013,,,,4,5,9
HND-012349,2011,141300014,,,,0,1,1
HND-012350,2011,141300015,,,,2,6,8
HND-012351,2011,141300017,,,,0,4,4
HND-012352,2011,141300018,,,,0,2,2
HND-012354,2011,141300022,,,,3,5,8
HND-012355,2011,141300023,,,,1,1,2
HND-012356,2011,141300024,,,,0,3,3
HND-012357,2011,141300025,,,,3,1,4
HND-012360,2011,141300028,,,,2,6,8
HND-012365,2011,141300035,,,,2,5,7
HND-012373,2011,141300057,,,,4,1,5
,2011,141300066,,,,5,7,12
HND-012378,2011,141300076,,,,1,0,1
HND-012379,2011,141300077,,,,5,1,6
HND-012381,2011,141300081,,,,1,2,3
HND-012341,2011,141300006,,,,20,14,34
HND-012344,2011,141300009,,,,3,3,6
HND-012345,2011,141300010,,,,3,4,7
,2011,141300019,,,,3,1,4
HND-012358,2011,141300026,,,,4,3,7
HND-012359,2011,141300027,,,,5,4,9
HND-012364,2011,141300034,,,,4,1,5
HND-012366,2011,141300036,,,,1,0,1
,2011,141300048,,,,7,2,9
HND-012370,2011,141300054,,,,2,2,4
HND-012374,2011,141300061,,,,3,4,7
,2011,141300067,,,,3,4,7
HND-012382,2011,141300107,,,,3,1,4
,2011,141300005,,,,7,30,37
,2011,141300048,,,,4,3,7
,2011,141300068,,,,2,2,4
HND-012337,2011,141300002,,,,15,33,48
HND-012367,2011,141300037,,,,199,182,381
HND-012367,2011,141300037,,,,145,170,315
,2011,141300048,,,,4,7,11
,2011,141300005,,,,7,19,26
,2011,141300068,,,,2,4,6
HND-012367,2011,141300037,,,,92,141,233
,2011,141300068,,,,5,4,9
,2011,141300005,,,,1,17,18
,2011,141300048,,,,3,2,5
HND-012367,2011,141300037,,,,85,152,237
,2011,141300068,,,,5,6,11
HND-012367,2011,141300037,,,,67,103,170
,2011,141300068,,,,2,9,11
HND-012367,2011,141300037,,,,35,72,107
,2011,141300068,,,,0,2,2
,2011,141400055,,,,0,3,3
,2011,141400036,,,,10,4,14
,2011,141400048,,,,2,3,5
,2011,141400050,,,,5,1,6
,2011,141400054,,,,3,2,5
HND-012408,2011,141400016,,,,4,0,4
HND-012409,2011,141400017,,,,0,5,5
HND-012410,2011,141400032,,,,0,1,1
HND-012411,2011,141400037,,,,2,1,3
HND-012415,2011,141400042,,,,1,4,5
,2011,141400039,,,,0,2,2
HND-012408,2011,141400016,,,,7,4,11
HND-012409,2011,141400017,,,,5,7,12
HND-012410,2011,141400032,,,,2,3,5
,2011,141400036,,,,5,4,9
HND-012411,2011,141400037,,,,3,1,4
HND-012414,2011,141400041,,,,2,0,2
HND-012415,2011,141400042,,,,0,4,4
HND-012408,2011,141400016,,,,3,12,15
HND-012409,2011,141400017,,,,11,13,24
HND-012410,2011,141400032,,,,2,2,4
HND-012411,2011,141400037,,,,3,1,4
HND-012414,2011,141400041,,,,4,4,8
HND-012415,2011,141400042,,,,1,5,6
,2011,141400036,,,,0,5,5
,2011,141400039,,,,2,3,5
HND-012397,2011,141400005,,,,1,0,1
HND-012400,2011,141400008,,,,2,4,6
HND-012401,2011,141400009,,,,3,2,5
HND-012405,2011,141400013,,,,4,2,6
,2011,141400038,,,,3,3,6
HND-012393,2011,141400001,,,,8,7,15
HND-012394,2011,141400002,,,,9,4,13
HND-012395,2011,141400003,,,,2,1,3
HND-012396,2011,141400004,,,,6,2,8
HND-012398,2011,141400006,,,,2,1,3
HND-012399,2011,141400007,,,,11,6,17
HND-012402,2011,141400010,,,,6,0,6
HND-012403,2011,141400011,,,,2,1,3
HND-012406,2011,141400014,,,,4,0,4
HND-012416,2011,141400046,,,,2,1,3
HND-012393,2011,141400001,,,,8,9,17
HND-012394,2011,141400002,,,,9,3,12
HND-012396,2011,141400004,,,,5,2,7
HND-012397,2011,141400005,,,,0,1,1
HND-012399,2011,141400007,,,,10,12,22
HND-012400,2011,141400008,,,,2,0,2
HND-012402,2011,141400010,,,,5,2,7
HND-012403,2011,141400011,,,,1,0,1
HND-012404,2011,141400012,,,,2,2,4
HND-012405,2011,141400013,,,,2,2,4
HND-012406,2011,141400014,,,,3,2,5
HND-012407,2011,141400015,,,,1,2,3
HND-012416,2011,141400046,,,,1,2,3
HND-012398,2011,141400006,,,,2,7,9
HND-012401,2011,141400009,,,,1,1,2
,2011,141400038,,,,4,3,7
HND-012393,2011,141400001,,,,11,14,25
HND-012394,2011,141400002,,,,2,4,6
HND-012395,2011,141400003,,,,1,2,3
HND-012396,2011,141400004,,,,2,5,7
HND-012397,2011,141400005,,,,2,1,3
HND-012398,2011,141400006,,,,0,2,2
HND-012399,2011,141400007,,,,6,5,11
HND-012402,2011,141400010,,,,3,8,11
HND-012403,2011,141400011,,,,2,1,3
HND-012405,2011,141400013,,,,4,0,4
HND-012406,2011,141400014,,,,5,1,6
HND-012416,2011,141400046,,,,3,2,5
HND-012400,2011,141400008,,,,0,7,7
HND-012401,2011,141400009,,,,3,5,8
HND-012407,2011,141400015,,,,0,3,3
,2011,141400038,,,,0,2,2
HND-012393,2011,141400001,,,,11,11,22
HND-012395,2011,141400003,,,,2,4,6
HND-012397,2011,141400005,,,,2,2,4
HND-012399,2011,141400007,,,,8,10,18
HND-012400,2011,141400008,,,,3,2,5
HND-012404,2011,141400012,,,,1,1,2
HND-012405,2011,141400013,,,,5,5,10
HND-012406,2011,141400014,,,,3,4,7
HND-012407,2011,141400015,,,,2,2,4
HND-012394,2011,141400002,,,,11,1,12
HND-012396,2011,141400004,,,,3,3,6
HND-012398,2011,141400006,,,,2,2,4
HND-012401,2011,141400009,,,,4,5,9
HND-012402,2011,141400010,,,,4,4,8
HND-012403,2011,141400011,,,,1,0,1
HND-012416,2011,141400046,,,,7,0,7
HND-012394,2011,141400002,,,,1,6,7
HND-012395,2011,141400003,,,,2,1,3
HND-012396,2011,141400004,,,,3,2,5
HND-012398,2011,141400006,,,,4,4,8
HND-012402,2011,141400010,,,,3,2,5
HND-012403,2011,141400011,,,,2,0,2
HND-012404,2011,141400012,,,,1,1,2
HND-012406,2011,141400014,,,,2,7,9
HND-012393,2011,141400001,,,,13,11,24
HND-012397,2011,141400005,,,,1,1,2
HND-012399,2011,141400007,,,,5,13,18
HND-012400,2011,141400008,,,,6,2,8
HND-012401,2011,141400009,,,,5,1,6
HND-012405,2011,141400013,,,,1,3,4
HND-012407,2011,141400015,,,,1,0,1
HND-012416,2011,141400046,,,,0,2,2
HND-012393,2011,141400001,,,,8,12,20
HND-012394,2011,141400002,,,,3,4,7
HND-012395,2011,141400003,,,,1,1,2
HND-012396,2011,141400004,,,,2,2,4
HND-012397,2011,141400005,,,,1,2,3
HND-012399,2011,141400007,,,,8,8,16
HND-012400,2011,141400008,,,,1,3,4
HND-012402,2011,141400010,,,,1,5,6
HND-012403,2011,141400011,,,,2,2,4
HND-012405,2011,141400013,,,,1,5,6
HND-012406,2011,141400014,,,,4,3,7
HND-012407,2011,141400015,,,,0,4,4
,2011,141400038,,,,1,0,1
HND-012398,2011,141400006,,,,1,1,2
HND-012401,2011,141400009,,,,2,4,6
HND-012393,2011,141400001,,,,13,22,35
HND-012393,2011,141400001,,,,13,9,22
HND-012400,2011,141400008,,,,5,5,10
HND-012393,2011,141400001,,,,8,13,21
,2011,141500071,,,,3,6,9
HND-012443,2011,141500030,,,,14,4,18
,2011,141500031,,,,5,3,8
,2011,141500069,,,,4,1,5
HND-012448,2011,141500072,,,,1,4,5
,2011,141500073,,,,4,5,9
HND-012449,2011,141500074,,,,4,5,9
HND-012436,2011,141500022,,,,1,3,4
HND-012439,2011,141500025,,,,1,3,4
HND-012444,2011,141500032,,,,2,1,3
HND-012435,2011,141500021,,,,26,26,52
HND-012436,2011,141500022,,,,9,7,16
HND-012437,2011,141500023,,,,4,7,11
HND-012438,2011,141500024,,,,16,9,25
HND-012440,2011,141500026,,,,5,5,10
HND-012441,2011,141500027,,,,4,10,14
HND-012439,2011,141500025,,,,8,7,15
HND-012444,2011,141500032,,,,2,5,7
HND-012444,2011,141500032,,,,6,12,18
HND-012435,2011,141500021,,,,9,22,31
HND-012436,2011,141500022,,,,7,9,16
HND-012437,2011,141500023,,,,7,12,19
HND-012438,2011,141500024,,,,13,14,27
HND-012439,2011,141500025,,,,3,7,10
HND-012440,2011,141500026,,,,5,7,12
HND-012441,2011,141500027,,,,4,6,10
HND-012418,2011,141500002,,,,30,24,54
HND-012421,2011,141500005,,,,8,5,13
HND-012423,2011,141500007,,,,12,7,19
HND-012424,2011,141500008,,,,15,11,26
HND-012425,2011,141500009,,,,8,5,13
HND-012426,2011,141500010,,,,1,0,1
HND-012427,2011,141500011,,,,5,4,9
HND-012432,2011,141500018,,,,1,0,1
HND-012433,2011,141500019,,,,0,1,1
HND-012446,2011,141500068,,,,1,5,6
HND-012417,2011,141500001,,,,3,0,3
HND-012419,2011,141500003,,,,6,7,13
HND-012420,2011,141500004,,,,4,3,7
HND-012422,2011,141500006,,,,0,1,1
HND-012428,2011,141500013,,,,9,2,11
HND-012429,2011,141500014,,,,3,5,8
HND-012430,2011,141500016,,,,2,1,3
HND-012431,2011,141500017,,,,1,0,1
HND-012434,2011,141500020,,,,2,2,4
HND-012417,2011,141500001,,,,2,1,3
HND-012418,2011,141500002,,,,31,32,63
HND-012422,2011,141500006,,,,2,0,2
HND-012424,2011,141500008,,,,28,16,44
HND-012425,2011,141500009,,,,9,10,19
HND-012426,2011,141500010,,,,1,1,2
HND-012427,2011,141500011,,,,1,3,4
HND-012429,2011,141500014,,,,5,10,15
HND-012430,2011,141500016,,,,7,2,9
HND-012446,2011,141500068,,,,4,1,5
HND-012419,2011,141500003,,,,8,6,14
HND-012420,2011,141500004,,,,2,7,9
HND-012421,2011,141500005,,,,6,1,7
HND-012423,2011,141500007,,,,13,11,24
HND-012428,2011,141500013,,,,2,7,9
HND-012431,2011,141500017,,,,0,2,2
HND-012432,2011,141500018,,,,1,1,2
HND-012433,2011,141500019,,,,4,2,6
HND-012434,2011,141500020,,,,3,1,4
HND-012445,2011,141500067,,,,1,2,3
HND-012418,2011,141500002,,,,33,28,61
HND-012421,2011,141500005,,,,4,7,11
HND-012424,2011,141500008,,,,16,22,38
HND-012425,2011,141500009,,,,5,4,9
HND-012427,2011,141500011,,,,3,5,8
HND-012433,2011,141500019,,,,0,1,1
HND-012446,2011,141500068,,,,1,1,2
HND-012417,2011,141500001,,,,1,1,2
HND-012419,2011,141500003,,,,8,7,15
HND-012420,2011,141500004,,,,6,7,13
HND-012422,2011,141500006,,,,1,0,1
HND-012423,2011,141500007,,,,19,10,29
HND-012428,2011,141500013,,,,3,1,4
HND-012429,2011,141500014,,,,6,10,16
HND-012430,2011,141500016,,,,2,1,3
HND-012431,2011,141500017,,,,2,1,3
HND-012432,2011,141500018,,,,1,3,4
HND-012434,2011,141500020,,,,4,1,5
HND-012445,2011,141500067,,,,3,2,5
HND-012422,2011,141500006,,,,3,2,5
HND-012425,2011,141500009,,,,5,6,11
HND-012426,2011,141500010,,,,2,1,3
HND-012427,2011,141500011,,,,6,3,9
HND-012428,2011,141500013,,,,6,3,9
HND-012429,2011,141500014,,,,8,6,14
HND-012430,2011,141500016,,,,3,2,5
HND-012431,2011,141500017,,,,1,2,3
HND-012434,2011,141500020,,,,4,6,10
HND-012418,2011,141500002,,,,10,20,30
HND-012419,2011,141500003,,,,11,6,17
HND-012420,2011,141500004,,,,7,7,14
HND-012421,2011,141500005,,,,4,4,8
HND-012423,2011,141500007,,,,9,12,21
HND-012424,2011,141500008,,,,14,22,36
HND-012432,2011,141500018,,,,0,1,1
HND-012433,2011,141500019,,,,1,1,2
HND-012445,2011,141500067,,,,3,0,3
HND-012446,2011,141500068,,,,4,5,9
HND-012417,2011,141500001,,,,3,0,3
HND-012420,2011,141500004,,,,6,6,12
HND-012422,2011,141500006,,,,3,1,4
HND-012426,2011,141500010,,,,6,3,9
HND-012427,2011,141500011,,,,3,3,6
HND-012428,2011,141500013,,,,2,1,3
HND-012429,2011,141500014,,,,5,4,9
HND-012430,2011,141500016,,,,2,1,3
HND-012431,2011,141500017,,,,3,0,3
HND-012434,2011,141500020,,,,3,1,4
HND-012418,2011,141500002,,,,20,29,49
HND-012419,2011,141500003,,,,8,3,11
HND-012421,2011,141500005,,,,4,7,11
HND-012423,2011,141500007,,,,11,16,27
HND-012424,2011,141500008,,,,16,30,46
HND-012425,2011,141500009,,,,9,12,21
HND-012433,2011,141500019,,,,0,1,1
HND-012445,2011,141500067,,,,1,1,2
HND-012446,2011,141500068,,,,3,0,3
HND-012419,2011,141500003,,,,5,6,11
HND-012420,2011,141500004,,,,4,7,11
HND-012421,2011,141500005,,,,4,6,10
HND-012423,2011,141500007,,,,15,12,27
HND-012428,2011,141500013,,,,2,2,4
HND-012431,2011,141500017,,,,0,2,2
HND-012432,2011,141500018,,,,1,4,5
HND-012434,2011,141500020,,,,5,6,11
HND-012445,2011,141500067,,,,0,2,2
HND-012417,2011,141500001,,,,1,2,3
HND-012418,2011,141500002,,,,20,32,52
HND-012422,2011,141500006,,,,2,4,6
HND-012424,2011,141500008,,,,24,18,42
HND-012425,2011,141500009,,,,9,7,16
HND-012426,2011,141500010,,,,1,1,2
HND-012427,2011,141500011,,,,3,2,5
HND-012429,2011,141500014,,,,4,8,12
HND-012430,2011,141500016,,,,1,0,1
HND-012433,2011,141500019,,,,1,2,3
HND-012446,2011,141500068,,,,1,1,2
HND-012424,2011,141500008,,,,10,17,27
HND-012442,2011,141500028,,,,30,52,82
HND-012424,2011,141500008,,,,12,12,24
HND-012442,2011,141500028,,,,36,45,81
HND-012424,2011,141500008,,,,7,17,24
HND-012442,2011,141500028,,,,17,17,34
HND-012442,2011,141500028,,,,64,95,159
HND-012442,2011,141500028,,,,56,44,100
HND-012442,2011,141500028,,,,38,58,96
,2011,141600061,,,,5,5,10
HND-012486,2011,141600064,,,,2,3,5
HND-012488,2011,141600066,,,,3,0,3
HND-012456,2011,141600007,,,,3,5,8
,2011,141600055,,,,3,0,3
HND-012483,2011,141600057,,,,4,2,6
,2011,141600058,,,,3,3,6
HND-012484,2011,141600059,,,,3,3,6
,2011,141600063,,,,2,3,5
HND-012487,2011,141600065,,,,5,2,7
,2011,141600067,,,,3,1,4
,2011,141600068,,,,3,4,7
HND-012489,2011,141600069,,,,3,4,7
,2011,141600070,,,,4,2,6
HND-012472,2011,141600023,,,,5,15,20
HND-012478,2011,141600040,,,,2,1,3
HND-012479,2011,141600041,,,,1,5,6
HND-012485,2011,141600060,,,,4,1,5
HND-012473,2011,141600024,,,,3,2,5
HND-012474,2011,141600027,,,,5,2,7
HND-012475,2011,141600028,,,,2,2,4
HND-012476,2011,141600029,,,,8,10,18
,2011,141600030,,,,3,5,8
HND-012472,2011,141600023,,,,13,14,27
HND-012475,2011,141600028,,,,3,2,5
,2011,141600030,,,,3,2,5
HND-012485,2011,141600060,,,,1,2,3
HND-012473,2011,141600024,,,,7,3,10
HND-012474,2011,141600027,,,,3,1,4
HND-012476,2011,141600029,,,,6,2,8
HND-012478,2011,141600040,,,,4,1,5
HND-012479,2011,141600041,,,,1,0,1
HND-012473,2011,141600024,,,,8,8,16
HND-012474,2011,141600027,,,,5,2,7
HND-012476,2011,141600029,,,,5,3,8
,2011,141600030,,,,2,4,6
HND-012478,2011,141600040,,,,1,1,2
HND-012479,2011,141600041,,,,3,2,5
HND-012472,2011,141600023,,,,17,17,34
HND-012475,2011,141600028,,,,3,4,7
HND-012485,2011,141600060,,,,4,5,9
HND-012450,2011,141600001,,,,34,34,68
HND-012451,2011,141600002,,,,2,0,2
HND-012452,2011,141600003,,,,1,0,1
HND-012453,2011,141600004,,,,4,3,7
HND-012454,2011,141600005,,,,13,12,25
HND-012456,2011,141600007,,,,5,2,7
HND-012457,2011,141600008,,,,5,3,8
HND-012459,2011,141600010,,,,5,3,8
HND-012460,2011,141600011,,,,5,1,6
HND-012461,2011,141600012,,,,6,2,8
HND-012462,2011,141600013,,,,1,2,3
HND-012465,2011,141600016,,,,5,1,6
HND-012468,2011,141600019,,,,2,2,4
HND-012469,2011,141600020,,,,0,2,2
,2011,141600030,,,,10,4,14
HND-012480,2011,141600044,,,,2,2,4
HND-012481,2011,141600045,,,,1,0,1
HND-012482,2011,141600054,,,,2,2,4
HND-012458,2011,141600009,,,,1,1,2
HND-012466,2011,141600017,,,,4,1,5
HND-012467,2011,141600018,,,,1,1,2
HND-012470,2011,141600021,,,,1,1,2
HND-012471,2011,141600022,,,,7,2,9
HND-012450,2011,141600001,,,,38,23,61
HND-012451,2011,141600002,,,,1,6,7
HND-012452,2011,141600003,,,,2,2,4
HND-012453,2011,141600004,,,,3,3,6
HND-012455,2011,141600006,,,,1,2,3
HND-012456,2011,141600007,,,,3,4,7
HND-012459,2011,141600010,,,,3,4,7
HND-012460,2011,141600011,,,,1,1,2
HND-012466,2011,141600017,,,,3,0,3
HND-012467,2011,141600018,,,,1,0,1
HND-012468,2011,141600019,,,,3,2,5
HND-012470,2011,141600021,,,,1,1,2
HND-012471,2011,141600022,,,,6,3,9
,2011,141600030,,,,8,6,14
HND-012481,2011,141600045,,,,2,1,3
HND-012454,2011,141600005,,,,12,10,22
HND-012457,2011,141600008,,,,4,5,9
HND-012461,2011,141600012,,,,3,3,6
HND-012462,2011,141600013,,,,0,5,5
HND-012463,2011,141600014,,,,1,1,2
HND-012465,2011,141600016,,,,3,1,4
HND-012480,2011,141600044,,,,1,1,2
HND-012482,2011,141600054,,,,1,1,2
HND-012451,2011,141600002,,,,1,3,4
HND-012453,2011,141600004,,,,1,3,4
HND-012455,2011,141600006,,,,6,2,8
HND-012458,2011,141600009,,,,2,0,2
HND-012466,2011,141600017,,,,1,2,3
HND-012467,2011,141600018,,,,0,2,2
HND-012469,2011,141600020,,,,1,5,6
HND-012471,2011,141600022,,,,8,5,13
,2011,141600030,,,,5,7,12
HND-012481,2011,141600045,,,,2,1,3
HND-012482,2011,141600054,,,,3,3,6
HND-012450,2011,141600001,,,,45,39,84
HND-012454,2011,141600005,,,,7,8,15
HND-012456,2011,141600007,,,,0,1,1
HND-012457,2011,141600008,,,,1,2,3
HND-012459,2011,141600010,,,,4,3,7
HND-012460,2011,141600011,,,,3,0,3
HND-012461,2011,141600012,,,,6,3,9
HND-012462,2011,141600013,,,,5,2,7
HND-012465,2011,141600016,,,,4,3,7
HND-012468,2011,141600019,,,,3,3,6
HND-012450,2011,141600001,,,,29,29,58
HND-012451,2011,141600002,,,,1,1,2
HND-012452,2011,141600003,,,,2,2,4
HND-012453,2011,141600004,,,,6,3,9
HND-012454,2011,141600005,,,,15,8,23
HND-012456,2011,141600007,,,,1,5,6
HND-012459,2011,141600010,,,,2,1,3
HND-012460,2011,141600011,,,,1,4,5
HND-012463,2011,141600014,,,,0,1,1
HND-012467,2011,141600018,,,,0,1,1
HND-012468,2011,141600019,,,,6,4,10
HND-012469,2011,141600020,,,,1,1,2
HND-012471,2011,141600022,,,,3,3,6
HND-012455,2011,141600006,,,,8,4,12
HND-012457,2011,141600008,,,,2,3,5
HND-012461,2011,141600012,,,,3,7,10
HND-012462,2011,141600013,,,,2,4,6
HND-012464,2011,141600015,,,,2,1,3
HND-012465,2011,141600016,,,,2,4,6
HND-012470,2011,141600021,,,,1,2,3
,2011,141600030,,,,11,5,16
HND-012480,2011,141600044,,,,1,1,2
HND-012481,2011,141600045,,,,2,2,4
HND-012482,2011,141600054,,,,2,4,6
HND-012450,2011,141600001,,,,28,35,63
HND-012451,2011,141600002,,,,1,1,2
HND-012452,2011,141600003,,,,1,0,1
HND-012453,2011,141600004,,,,6,1,7
HND-012454,2011,141600005,,,,7,16,23
HND-012456,2011,141600007,,,,2,1,3
HND-012457,2011,141600008,,,,3,3,6
HND-012459,2011,141600010,,,,5,2,7
HND-012460,2011,141600011,,,,2,2,4
HND-012461,2011,141600012,,,,2,3,5
HND-012463,2011,141600014,,,,4,2,6
HND-012465,2011,141600016,,,,6,1,7
HND-012468,2011,141600019,,,,3,2,5
HND-012469,2011,141600020,,,,1,2,3
HND-012471,2011,141600022,,,,3,3,6
HND-012455,2011,141600006,,,,4,2,6
HND-012458,2011,141600009,,,,0,2,2
HND-012462,2011,141600013,,,,4,4,8
HND-012466,2011,141600017,,,,3,2,5
HND-012467,2011,141600018,,,,0,2,2
HND-012470,2011,141600021,,,,1,4,5
,2011,141600030,,,,8,5,13
HND-012480,2011,141600044,,,,1,1,2
HND-012481,2011,141600045,,,,1,1,2
HND-012482,2011,141600054,,,,1,3,4
HND-012454,2011,141600005,,,,6,13,19
HND-012457,2011,141600008,,,,3,3,6
HND-012458,2011,141600009,,,,0,1,1
HND-012461,2011,141600012,,,,3,3,6
HND-012462,2011,141600013,,,,4,4,8
HND-012463,2011,141600014,,,,0,1,1
HND-012465,2011,141600016,,,,2,3,5
HND-012480,2011,141600044,,,,0,1,1
HND-012482,2011,141600054,,,,1,2,3
HND-012450,2011,141600001,,,,34,45,79
HND-012452,2011,141600003,,,,2,1,3
HND-012453,2011,141600004,,,,1,4,5
HND-012455,2011,141600006,,,,1,2,3
HND-012456,2011,141600007,,,,5,0,5
HND-012459,2011,141600010,,,,2,2,4
HND-012460,2011,141600011,,,,2,1,3
HND-012464,2011,141600015,,,,2,0,2
HND-012466,2011,141600017,,,,0,2,2
HND-012467,2011,141600018,,,,5,1,6
HND-012468,2011,141600019,,,,2,2,4
HND-012469,2011,141600020,,,,2,2,4
HND-012470,2011,141600021,,,,1,0,1
HND-012471,2011,141600022,,,,5,2,7
,2011,141600030,,,,11,9,20
HND-012481,2011,141600045,,,,4,1,5
HND-012450,2011,141600001,,,,25,18,43
HND-012454,2011,141600005,,,,12,11,23
,2011,141600030,,,,2,2,4
,2011,141600030,,,,5,12,17
HND-012450,2011,141600001,,,,8,18,26
HND-012454,2011,141600005,,,,8,13,21
HND-012450,2011,141600001,,,,8,19,27
HND-012454,2011,141600005,,,,3,4,7
,2011,141600030,,,,2,8,10
,2011,141600030,,,,6,6,12
,2011,150100174,,,,11,13,24
HND-012679,2011,150100253,,,,8,7,15
,2011,150100259,,,,6,4,10
HND-012683,2011,150100264,,,,6,11,17
HND-012685,2011,150100270,,,,5,4,9
HND-012686,2011,150100271,,,,11,8,19
HND-012688,2011,150100274,,,,7,7,14
HND-012702,2011,150100341,,,,9,6,15
HND-012704,2011,150100348,,,,10,12,22
HND-012705,2011,150100352,,,,10,5,15
HND-012708,2011,150100355,,,,2,6,8
HND-012713,2011,150100375,,,,2,8,10
HND-012726,2011,150100396,,,,4,6,10
HND-012678,2011,150100252,,,,20,32,52
HND-012680,2011,150100254,,,,8,10,18
HND-012681,2011,150100255,,,,5,5,10
HND-012687,2011,150100272,,,,6,8,14
,2011,150100275,,,,11,10,21
HND-012700,2011,150100337,,,,9,6,15
HND-012703,2011,150100346,,,,10,6,16
HND-012706,2011,150100353,,,,8,2,10
HND-012707,2011,150100354,,,,8,6,14
,2011,150100372,,,,5,4,9
HND-012712,2011,150100373,,,,7,8,15
HND-012717,2011,150100381,,,,5,8,13
HND-012722,2011,150100388,,,,6,3,9
,2011,150100397,,,,7,6,13
HND-012531,2011,150100043,,,,12,24,36
HND-012622,2011,150100150,,,,3,2,5
HND-012624,2011,150100152,,,,2,0,2
,2011,150100170,,,,2,0,2
,2011,150100176,,,,1,1,2
HND-012636,2011,150100178,,,,0,3,3
HND-012651,2011,150100197,,,,1,0,1
HND-012675,2011,150100245,,,,1,0,1
HND-012709,2011,150100362,,,,2,3,5
HND-012710,2011,150100368,,,,2,1,3
HND-012719,2011,150100383,,,,1,1,2
,2011,150100384,,,,1,2,3
HND-012720,2011,150100386,,,,2,4,6
,2011,150100394,,,,1,1,2
HND-012596,2011,150100110,,,,9,12,21
HND-012604,2011,150100125,,,,0,1,1
HND-012619,2011,150100146,,,,8,6,14
,2011,150100165,,,,2,2,4
,2011,150100175,,,,8,5,13
,2011,150100179,,,,0,4,4
HND-012654,2011,150100200,,,,6,0,6
,2011,150100201,,,,6,4,10
,2011,150100360,,,,1,2,3
,2011,150100361,,,,1,2,3
HND-012711,2011,150100370,,,,3,1,4
,2011,150100376,,,,4,2,6
,2011,150100392,,,,3,1,4
HND-012531,2011,150100043,,,,18,25,43
,2011,150100126,,,,32,40,72
HND-012605,2011,150100127,,,,16,14,30
HND-012606,2011,150100128,,,,3,8,11
HND-012610,2011,150100132,,,,17,18,35
HND-012611,2011,150100133,,,,14,14,28
,2011,150100134,,,,11,13,24
HND-012612,2011,150100136,,,,27,29,56
HND-012613,2011,150100137,,,,5,6,11
HND-012614,2011,150100138,,,,11,22,33
HND-012615,2011,150100139,,,,11,22,33
,2011,150100149,,,,6,6,12
HND-012623,2011,150100151,,,,4,6,10
HND-012631,2011,150100161,,,,1,0,1
HND-012632,2011,150100162,,,,5,2,7
,2011,150100165,,,,9,5,14
,2011,150100170,,,,3,6,9
,2011,150100172,,,,7,9,16
,2011,150100176,,,,4,2,6
HND-012636,2011,150100178,,,,5,3,8
HND-012650,2011,150100196,,,,1,3,4
HND-012654,2011,150100200,,,,8,2,10
,2011,150100201,,,,7,5,12
HND-012658,2011,150100206,,,,5,9,14
,2011,150100226,,,,0,2,2
,2011,150100227,,,,30,21,51
,2011,150100241,,,,6,11,17
HND-012674,2011,150100244,,,,2,11,13
HND-012675,2011,150100245,,,,6,7,13
,2011,150100247,,,,4,2,6
,2011,150100249,,,,6,6,12
HND-012684,2011,150100267,,,,1,3,4
,2011,150100360,,,,3,2,5
HND-012709,2011,150100362,,,,1,4,5
,2011,150100367,,,,4,3,7
HND-012710,2011,150100368,,,,4,5,9
,2011,150100376,,,,2,2,4
,2011,150100379,,,,7,6,13
HND-012719,2011,150100383,,,,3,4,7
,2011,150100392,,,,5,5,10
HND-012596,2011,150100110,,,,3,3,6
,2011,150100118,,,,5,2,7
HND-012604,2011,150100125,,,,7,4,11
HND-012607,2011,150100129,,,,3,11,14
HND-012609,2011,150100131,,,,4,2,6
HND-012616,2011,150100140,,,,2,3,5
,2011,150100142,,,,6,1,7
HND-012617,2011,150100143,,,,9,6,15
HND-012618,2011,150100145,,,,7,2,9
HND-012619,2011,150100146,,,,43,28,71
HND-012620,2011,150100147,,,,3,6,9
HND-012621,2011,150100148,,,,15,15,30
HND-012624,2011,150100152,,,,1,5,6
,2011,150100153,,,,2,11,13
HND-012626,2011,150100155,,,,4,10,14
HND-012627,2011,150100156,,,,5,8,13
HND-012628,2011,150100157,,,,2,2,4
HND-012629,2011,150100158,,,,0,1,1
,2011,150100160,,,,5,3,8
,2011,150100164,,,,3,4,7
HND-012633,2011,150100167,,,,9,11,20
,2011,150100175,,,,9,8,17
,2011,150100179,,,,0,5,5
HND-012643,2011,150100187,,,,16,22,38
HND-012649,2011,150100195,,,,15,4,19
HND-012651,2011,150100197,,,,3,4,7
HND-012652,2011,150100198,,,,6,6,12
HND-012653,2011,150100199,,,,3,5,8
HND-012661,2011,150100212,,,,4,4,8
HND-012676,2011,150100246,,,,11,6,17
,2011,150100324,,,,8,7,15
HND-012701,2011,150100340,,,,5,6,11
,2011,150100361,,,,3,2,5
HND-012711,2011,150100370,,,,12,3,15
,2011,150100384,,,,2,0,2
,2011,150100385,,,,5,5,10
HND-012720,2011,150100386,,,,4,1,5
HND-012721,2011,150100387,,,,5,4,9
HND-012724,2011,150100391,,,,5,5,10
,2011,150100394,,,,2,3,5
HND-012531,2011,150100043,,,,30,25,55
,2011,150100118,,,,8,7,15
HND-012604,2011,150100125,,,,10,4,14
HND-012607,2011,150100129,,,,9,17,26
HND-012608,2011,150100130,,,,14,14,28
,2011,150100142,,,,5,8,13
HND-012617,2011,150100143,,,,14,13,27
HND-012618,2011,150100145,,,,6,15,21
HND-012619,2011,150100146,,,,70,70,140
HND-012620,2011,150100147,,,,13,13,26
HND-012621,2011,150100148,,,,25,35,60
HND-012624,2011,150100152,,,,2,4,6
,2011,150100153,,,,1,3,4
HND-012627,2011,150100156,,,,9,8,17
HND-012628,2011,150100157,,,,14,7,21
HND-012629,2011,150100158,,,,13,9,22
HND-012631,2011,150100161,,,,9,10,19
,2011,150100165,,,,21,12,33
HND-012633,2011,150100167,,,,20,11,31
HND-012643,2011,150100187,,,,17,15,32
HND-012649,2011,150100195,,,,6,6,12
HND-012651,2011,150100197,,,,2,4,6
HND-012652,2011,150100198,,,,4,5,9
HND-012653,2011,150100199,,,,3,5,8
HND-012658,2011,150100206,,,,5,7,12
,2011,150100226,,,,3,2,5
HND-012676,2011,150100246,,,,10,4,14
HND-012684,2011,150100267,,,,5,5,10
HND-012711,2011,150100370,,,,4,3,7
HND-012719,2011,150100383,,,,6,0,6
HND-012724,2011,150100391,,,,9,4,13
,2011,150100394,,,,3,1,4
HND-012725,2011,150100395,,,,8,4,12
HND-012596,2011,150100110,,,,1,4,5
,2011,150100126,,,,35,26,61
HND-012605,2011,150100127,,,,21,22,43
HND-012606,2011,150100128,,,,7,7,14
HND-012609,2011,150100131,,,,34,27,61
HND-012610,2011,150100132,,,,6,11,17
HND-012611,2011,150100133,,,,16,21,37
HND-012612,2011,150100136,,,,66,48,114
HND-012613,2011,150100137,,,,6,5,11
HND-012614,2011,150100138,,,,14,19,33
HND-012615,2011,150100139,,,,20,17,37
HND-012616,2011,150100140,,,,2,3,5
,2011,150100149,,,,12,7,19
HND-012622,2011,150100150,,,,15,9,24
HND-012623,2011,150100151,,,,8,5,13
HND-012626,2011,150100155,,,,28,21,49
,2011,150100160,,,,7,7,14
HND-012632,2011,150100162,,,,4,2,6
,2011,150100164,,,,1,9,10
,2011,150100166,,,,5,8,13
,2011,150100170,,,,9,5,14
,2011,150100172,,,,22,22,44
,2011,150100175,,,,15,15,30
,2011,150100176,,,,4,1,5
HND-012636,2011,150100178,,,,6,3,9
,2011,150100179,,,,1,5,6
HND-012650,2011,150100196,,,,2,6,8
HND-012654,2011,150100200,,,,7,3,10
,2011,150100201,,,,4,3,7
HND-012661,2011,150100212,,,,7,5,12
,2011,150100227,,,,27,22,49
,2011,150100241,,,,3,2,5
HND-012674,2011,150100244,,,,5,4,9
HND-012675,2011,150100245,,,,3,4,7
,2011,150100247,,,,0,3,3
,2011,150100249,,,,24,22,46
,2011,150100324,,,,13,16,29
HND-012701,2011,150100340,,,,5,7,12
,2011,150100360,,,,11,12,23
,2011,150100361,,,,1,4,5
HND-012709,2011,150100362,,,,6,7,13
,2011,150100367,,,,4,4,8
HND-012710,2011,150100368,,,,5,3,8
,2011,150100376,,,,3,2,5
,2011,150100379,,,,8,3,11
,2011,150100384,,,,3,3,6
,2011,150100385,,,,7,2,9
HND-012720,2011,150100386,,,,5,4,9
HND-012721,2011,150100387,,,,3,4,7
,2011,150100392,,,,2,2,4
HND-012491,2011,150100002,,,,48,33,81
HND-012496,2011,150100007,,,,5,2,7
HND-012498,2011,150100009,,,,11,5,16
HND-012502,2011,150100013,,,,4,8,12
HND-012505,2011,150100016,,,,23,13,36
HND-012506,2011,150100017,,,,6,6,12
HND-012508,2011,150100019,,,,46,29,75
HND-012509,2011,150100020,,,,57,53,110
HND-012510,2011,150100021,,,,26,35,61
HND-012512,2011,150100023,,,,13,20,33
HND-012513,2011,150100024,,,,16,16,32
HND-012516,2011,150100027,,,,14,5,19
HND-012517,2011,150100028,,,,11,9,20
HND-012520,2011,150100032,,,,21,15,36
HND-012522,2011,150100034,,,,25,20,45
HND-012523,2011,150100035,,,,17,7,24
HND-012524,2011,150100036,,,,17,16,33
HND-012527,2011,150100039,,,,8,8,16
HND-012528,2011,150100040,,,,10,5,15
HND-012529,2011,150100041,,,,9,7,16
HND-012531,2011,150100043,,,,5,4,9
HND-012532,2011,150100044,,,,10,7,17
HND-012534,2011,150100046,,,,13,14,27
HND-012535,2011,150100047,,,,9,11,20
HND-012536,2011,150100048,,,,11,4,15
HND-012540,2011,150100052,,,,9,10,19
HND-012543,2011,150100055,,,,11,10,21
HND-012544,2011,150100056,,,,5,2,7
HND-012548,2011,150100060,,,,1,1,2
HND-012550,2011,150100062,,,,4,0,4
HND-012551,2011,150100063,,,,91,75,166
HND-012553,2011,150100065,,,,3,3,6
HND-012556,2011,150100068,,,,6,6,12
HND-012557,2011,150100069,,,,3,2,5
HND-012560,2011,150100072,,,,11,18,29
HND-012563,2011,150100075,,,,21,19,40
HND-012567,2011,150100079,,,,4,3,7
HND-012570,2011,150100082,,,,5,4,9
HND-012573,2011,150100085,,,,3,2,5
HND-012577,2011,150100089,,,,3,4,7
HND-012582,2011,150100095,,,,7,2,9
HND-012583,2011,150100096,,,,1,1,2
HND-012585,2011,150100098,,,,28,36,64
HND-012586,2011,150100099,,,,4,2,6
HND-012587,2011,150100100,,,,4,5,9
HND-012589,2011,150100103,,,,2,4,6
HND-012590,2011,150100104,,,,10,6,16
HND-012592,2011,150100106,,,,8,11,19
HND-012593,2011,150100107,,,,1,1,2
HND-012594,2011,150100108,,,,4,5,9
HND-012597,2011,150100112,,,,2,3,5
,2011,150100119,,,,24,14,38
HND-012602,2011,150100122,,,,1,1,2
HND-012603,2011,150100123,,,,7,9,16
HND-012608,2011,150100130,,,,25,24,49
HND-012630,2011,150100159,,,,4,1,5
,2011,150100166,,,,4,6,10
,2011,150100170,,,,4,6,10
,2011,150100174,,,,0,3,3
,2011,150100176,,,,12,7,19
,2011,150100179,,,,20,21,41
HND-012637,2011,150100180,,,,1,3,4
HND-012638,2011,150100182,,,,10,13,23
HND-012639,2011,150100183,,,,5,7,12
HND-012640,2011,150100184,,,,4,4,8
HND-012642,2011,150100186,,,,5,2,7
HND-012644,2011,150100188,,,,4,2,6
HND-012645,2011,150100189,,,,35,39,74
,2011,150100192,,,,5,3,8
HND-012664,2011,150100220,,,,6,2,8
,2011,150100227,,,,28,25,53
HND-012668,2011,150100231,,,,15,16,31
HND-012669,2011,150100233,,,,5,3,8
,2011,150100241,,,,5,4,9
HND-012673,2011,150100242,,,,4,2,6
,2011,150100243,,,,13,15,28
,2011,150100247,,,,0,1,1
,2011,150100326,,,,8,1,9
HND-012692,2011,150100329,,,,1,4,5
HND-012693,2011,150100330,,,,7,4,11
HND-012694,2011,150100331,,,,4,4,8
HND-012695,2011,150100332,,,,11,3,14
HND-012698,2011,150100335,,,,4,3,7
HND-012714,2011,150100377,,,,6,10,16
HND-012716,2011,150100380,,,,7,4,11
,2011,150100398,,,,4,3,7
HND-012490,2011,150100001,,,,18,18,36
HND-012492,2011,150100003,,,,82,63,145
HND-012493,2011,150100004,,,,16,4,20
HND-012494,2011,150100005,,,,6,13,19
HND-012495,2011,150100006,,,,36,21,57
HND-012497,2011,150100008,,,,5,1,6
HND-012499,2011,150100010,,,,5,11,16
HND-012500,2011,150100011,,,,11,12,23
HND-012501,2011,150100012,,,,6,3,9
HND-012503,2011,150100014,,,,11,7,18
HND-012504,2011,150100015,,,,9,4,13
HND-012507,2011,150100018,,,,12,13,25
HND-012511,2011,150100022,,,,18,12,30
HND-012514,2011,150100025,,,,3,2,5
HND-012515,2011,150100026,,,,29,23,52
HND-012518,2011,150100030,,,,2,0,2
HND-012519,2011,150100031,,,,4,8,12
HND-012521,2011,150100033,,,,26,19,45
HND-012525,2011,150100037,,,,9,6,15
HND-012526,2011,150100038,,,,10,7,17
HND-012530,2011,150100042,,,,10,2,12
HND-012533,2011,150100045,,,,16,7,23
HND-012537,2011,150100049,,,,14,10,24
HND-012538,2011,150100050,,,,3,1,4
HND-012539,2011,150100051,,,,23,11,34
HND-012541,2011,150100053,,,,7,6,13
HND-012542,2011,150100054,,,,3,2,5
HND-012545,2011,150100057,,,,3,2,5
HND-012546,2011,150100058,,,,13,4,17
HND-012547,2011,150100059,,,,28,29,57
HND-012549,2011,150100061,,,,9,7,16
HND-012552,2011,150100064,,,,6,7,13
HND-012554,2011,150100066,,,,8,3,11
HND-012555,2011,150100067,,,,9,6,15
HND-012558,2011,150100070,,,,1,3,4
HND-012559,2011,150100071,,,,14,12,26
HND-012561,2011,150100073,,,,10,7,17
HND-012562,2011,150100074,,,,8,9,17
HND-012564,2011,150100076,,,,8,11,19
HND-012565,2011,150100077,,,,6,2,8
HND-012566,2011,150100078,,,,4,5,9
HND-012568,2011,150100080,,,,10,2,12
HND-012569,2011,150100081,,,,10,4,14
,2011,150100083,,,,4,5,9
HND-012572,2011,150100084,,,,32,29,61
HND-012574,2011,150100086,,,,2,4,6
HND-012575,2011,150100087,,,,7,8,15
HND-012576,2011,150100088,,,,1,1,2
HND-012578,2011,150100091,,,,5,5,10
HND-012579,2011,150100092,,,,9,8,17
HND-012580,2011,150100093,,,,3,0,3
HND-012581,2011,150100094,,,,5,5,10
HND-012584,2011,150100097,,,,18,15,33
HND-012588,2011,150100101,,,,2,7,9
HND-012591,2011,150100105,,,,19,19,38
HND-012595,2011,150100109,,,,8,7,15
HND-012596,2011,150100110,,,,25,32,57
HND-012598,2011,150100113,,,,2,4,6
HND-012599,2011,150100114,,,,4,7,11
HND-012600,2011,150100116,,,,20,8,28
,2011,150100118,,,,16,8,24
HND-012601,2011,150100121,,,,2,1,3
,2011,150100126,,,,40,30,70
,2011,150100135,,,,11,13,24
HND-012626,2011,150100155,,,,18,22,40
HND-012647,2011,150100193,,,,3,0,3
HND-012657,2011,150100204,,,,5,1,6
HND-012660,2011,150100211,,,,11,10,21
HND-012662,2011,150100217,,,,9,10,19
HND-012663,2011,150100218,,,,18,8,26
HND-012665,2011,150100223,,,,5,9,14
,2011,150100226,,,,2,4,6
HND-012666,2011,150100228,,,,35,27,62
HND-012667,2011,150100229,,,,4,6,10
,2011,150100230,,,,5,5,10
HND-012670,2011,150100234,,,,5,4,9
HND-012671,2011,150100235,,,,8,3,11
HND-012689,2011,150100318,,,,10,5,15
,2011,150100324,,,,18,10,28
HND-012690,2011,150100325,,,,14,5,19
,2011,150100327,,,,2,0,2
HND-012691,2011,150100328,,,,3,4,7
HND-012696,2011,150100333,,,,9,3,12
HND-012697,2011,150100334,,,,2,1,3
HND-012699,2011,150100336,,,,3,6,9
HND-012715,2011,150100378,,,,4,1,5
HND-012491,2011,150100002,,,,38,48,86
HND-012492,2011,150100003,,,,43,57,100
HND-012494,2011,150100005,,,,10,10,20
HND-012497,2011,150100008,,,,3,5,8
HND-012498,2011,150100009,,,,9,12,21
HND-012501,2011,150100012,,,,0,3,3
HND-012504,2011,150100015,,,,9,8,17
HND-012508,2011,150100019,,,,33,51,84
HND-012512,2011,150100023,,,,15,21,36
HND-012515,2011,150100026,,,,24,30,54
HND-012516,2011,150100027,,,,9,16,25
HND-012519,2011,150100031,,,,5,8,13
HND-012520,2011,150100032,,,,11,16,27
HND-012524,2011,150100036,,,,11,14,25
HND-012525,2011,150100037,,,,13,7,20
HND-012527,2011,150100039,,,,9,9,18
HND-012528,2011,150100040,,,,5,8,13
HND-012529,2011,150100041,,,,6,3,9
HND-012530,2011,150100042,,,,9,3,12
HND-012532,2011,150100044,,,,8,12,20
HND-012533,2011,150100045,,,,9,9,18
HND-012536,2011,150100048,,,,6,5,11
HND-012541,2011,150100053,,,,4,6,10
HND-012544,2011,150100056,,,,1,4,5
HND-012545,2011,150100057,,,,2,2,4
HND-012547,2011,150100059,,,,28,17,45
HND-012548,2011,150100060,,,,10,5,15
HND-012549,2011,150100061,,,,9,9,18
HND-012550,2011,150100062,,,,2,5,7
HND-012551,2011,150100063,,,,87,85,172
HND-012552,2011,150100064,,,,11,9,20
HND-012555,2011,150100067,,,,8,8,16
HND-012556,2011,150100068,,,,5,9,14
HND-012561,2011,150100073,,,,8,4,12
HND-012564,2011,150100076,,,,6,13,19
HND-012565,2011,150100077,,,,9,3,12
HND-012567,2011,150100079,,,,1,2,3
,2011,150100083,,,,3,4,7
HND-012573,2011,150100085,,,,2,3,5
HND-012574,2011,150100086,,,,5,3,8
HND-012575,2011,150100087,,,,10,4,14
HND-012577,2011,150100089,,,,4,4,8
HND-012578,2011,150100091,,,,2,4,6
HND-012580,2011,150100093,,,,3,5,8
HND-012583,2011,150100096,,,,6,2,8
HND-012585,2011,150100098,,,,34,23,57
HND-012586,2011,150100099,,,,3,1,4
HND-012588,2011,150100101,,,,3,0,3
HND-012590,2011,150100104,,,,4,6,10
HND-012591,2011,150100105,,,,19,19,38
HND-012592,2011,150100106,,,,11,8,19
HND-012596,2011,150100110,,,,19,28,47
HND-012600,2011,150100116,,,,8,14,22
,2011,150100118,,,,10,2,12
HND-012601,2011,150100121,,,,4,4,8
HND-012608,2011,150100130,,,,17,13,30
,2011,150100179,,,,16,20,36
HND-012638,2011,150100182,,,,11,8,19
HND-012645,2011,150100189,,,,27,32,59
HND-012660,2011,150100211,,,,15,9,24
HND-012662,2011,150100217,,,,5,1,6
,2011,150100226,,,,6,5,11
HND-012666,2011,150100228,,,,39,34,73
HND-012671,2011,150100235,,,,9,1,10
HND-012672,2011,150100236,,,,10,12,22
,2011,150100243,,,,3,7,10
HND-012689,2011,150100318,,,,8,13,21
,2011,150100324,,,,14,15,29
HND-012690,2011,150100325,,,,6,3,9
HND-012691,2011,150100328,,,,3,3,6
HND-012694,2011,150100331,,,,1,7,8
HND-012695,2011,150100332,,,,11,5,16
HND-012696,2011,150100333,,,,3,3,6
HND-012714,2011,150100377,,,,6,5,11
HND-012723,2011,150100390,,,,3,4,7
HND-012490,2011,150100001,,,,14,11,25
HND-012493,2011,150100004,,,,10,7,17
HND-012495,2011,150100006,,,,22,19,41
HND-012496,2011,150100007,,,,4,1,5
HND-012499,2011,150100010,,,,8,3,11
HND-012500,2011,150100011,,,,8,12,20
HND-012502,2011,150100013,,,,10,9,19
HND-012503,2011,150100014,,,,18,8,26
HND-012505,2011,150100016,,,,12,14,26
HND-012506,2011,150100017,,,,10,6,16
HND-012507,2011,150100018,,,,14,7,21
HND-012509,2011,150100020,,,,50,40,90
HND-012510,2011,150100021,,,,30,19,49
HND-012511,2011,150100022,,,,10,7,17
HND-012513,2011,150100024,,,,11,13,24
HND-012514,2011,150100025,,,,8,5,13
HND-012517,2011,150100028,,,,13,11,24
HND-012518,2011,150100030,,,,2,3,5
HND-012521,2011,150100033,,,,26,24,50
HND-012522,2011,150100034,,,,10,19,29
HND-012523,2011,150100035,,,,7,8,15
HND-012526,2011,150100038,,,,5,3,8
HND-012531,2011,150100043,,,,6,4,10
HND-012534,2011,150100046,,,,6,12,18
HND-012535,2011,150100047,,,,13,8,21
HND-012537,2011,150100049,,,,15,10,25
HND-012538,2011,150100050,,,,0,4,4
HND-012539,2011,150100051,,,,28,14,42
HND-012540,2011,150100052,,,,10,4,14
HND-012542,2011,150100054,,,,4,1,5
HND-012543,2011,150100055,,,,10,9,19
HND-012546,2011,150100058,,,,11,12,23
HND-012553,2011,150100065,,,,2,4,6
HND-012554,2011,150100066,,,,9,3,12
HND-012557,2011,150100069,,,,4,0,4
HND-012558,2011,150100070,,,,3,5,8
HND-012559,2011,150100071,,,,4,6,10
HND-012560,2011,150100072,,,,14,13,27
HND-012562,2011,150100074,,,,11,9,20
HND-012563,2011,150100075,,,,14,10,24
HND-012566,2011,150100078,,,,5,3,8
HND-012568,2011,150100080,,,,6,6,12
HND-012569,2011,150100081,,,,7,6,13
HND-012570,2011,150100082,,,,4,1,5
HND-012572,2011,150100084,,,,21,20,41
HND-012576,2011,150100088,,,,1,1,2
HND-012579,2011,150100092,,,,10,8,18
HND-012581,2011,150100094,,,,3,3,6
HND-012582,2011,150100095,,,,4,3,7
HND-012584,2011,150100097,,,,17,16,33
HND-012587,2011,150100100,,,,1,1,2
HND-012589,2011,150100103,,,,2,0,2
HND-012593,2011,150100107,,,,1,1,2
HND-012594,2011,150100108,,,,2,3,5
HND-012595,2011,150100109,,,,4,6,10
HND-012597,2011,150100112,,,,5,5,10
HND-012598,2011,150100113,,,,4,4,8
HND-012599,2011,150100114,,,,4,1,5
,2011,150100119,,,,15,9,24
HND-012602,2011,150100122,,,,3,2,5
HND-012603,2011,150100123,,,,8,6,14
,2011,150100126,,,,34,26,60
,2011,150100135,,,,14,13,27
HND-012626,2011,150100155,,,,28,25,53
HND-012630,2011,150100159,,,,1,2,3
,2011,150100166,,,,4,8,12
,2011,150100170,,,,4,2,6
,2011,150100176,,,,6,6,12
HND-012637,2011,150100180,,,,1,1,2
HND-012639,2011,150100183,,,,8,6,14
HND-012640,2011,150100184,,,,4,4,8
HND-012641,2011,150100185,,,,5,1,6
HND-012642,2011,150100186,,,,2,1,3
HND-012644,2011,150100188,,,,8,5,13
,2011,150100192,,,,4,5,9
HND-012647,2011,150100193,,,,3,0,3
HND-012657,2011,150100204,,,,3,2,5
HND-012663,2011,150100218,,,,15,6,21
HND-012664,2011,150100220,,,,3,9,12
HND-012665,2011,150100223,,,,5,3,8
,2011,150100227,,,,27,17,44
HND-012667,2011,150100229,,,,6,3,9
,2011,150100230,,,,8,2,10
HND-012668,2011,150100231,,,,6,0,6
HND-012669,2011,150100233,,,,7,10,17
HND-012670,2011,150100234,,,,8,6,14
,2011,150100241,,,,3,3,6
HND-012673,2011,150100242,,,,4,2,6
,2011,150100247,,,,1,0,1
,2011,150100326,,,,0,4,4
,2011,150100327,,,,4,0,4
HND-012692,2011,150100329,,,,0,6,6
HND-012693,2011,150100330,,,,9,7,16
HND-012697,2011,150100334,,,,3,0,3
HND-012698,2011,150100335,,,,7,4,11
HND-012699,2011,150100336,,,,5,5,10
HND-012715,2011,150100378,,,,7,6,13
HND-012716,2011,150100380,,,,3,0,3
,2011,150100398,,,,4,5,9
HND-012492,2011,150100003,,,,49,48,97
HND-012493,2011,150100004,,,,3,8,11
HND-012494,2011,150100005,,,,8,9,17
HND-012495,2011,150100006,,,,10,27,37
HND-012497,2011,150100008,,,,2,2,4
HND-012499,2011,150100010,,,,6,3,9
HND-012501,2011,150100012,,,,2,0,2
HND-012503,2011,150100014,,,,13,7,20
HND-012504,2011,150100015,,,,10,5,15
HND-012507,2011,150100018,,,,17,8,25
HND-012514,2011,150100025,,,,5,2,7
HND-012515,2011,150100026,,,,35,34,69
HND-012520,2011,150100032,,,,19,18,37
HND-012522,2011,150100034,,,,16,13,29
HND-012523,2011,150100035,,,,6,7,13
HND-012524,2011,150100036,,,,17,7,24
HND-012527,2011,150100039,,,,9,12,21
HND-012528,2011,150100040,,,,9,4,13
HND-012529,2011,150100041,,,,8,3,11
HND-012531,2011,150100043,,,,2,8,10
HND-012532,2011,150100044,,,,16,12,28
HND-012535,2011,150100047,,,,11,7,18
HND-012536,2011,150100048,,,,8,14,22
HND-012543,2011,150100055,,,,7,7,14
HND-012544,2011,150100056,,,,0,1,1
HND-012548,2011,150100060,,,,3,1,4
HND-012549,2011,150100061,,,,6,6,12
HND-012552,2011,150100064,,,,9,9,18
HND-012554,2011,150100066,,,,6,1,7
HND-012555,2011,150100067,,,,11,3,14
HND-012560,2011,150100072,,,,17,10,27
HND-012563,2011,150100075,,,,28,18,46
HND-012564,2011,150100076,,,,2,5,7
HND-012567,2011,150100079,,,,3,1,4
HND-012570,2011,150100082,,,,8,2,10
HND-012573,2011,150100085,,,,3,1,4
HND-012577,2011,150100089,,,,6,6,12
HND-012582,2011,150100095,,,,4,1,5
HND-012583,2011,150100096,,,,9,6,15
HND-012585,2011,150100098,,,,22,17,39
HND-012586,2011,150100099,,,,2,5,7
HND-012588,2011,150100101,,,,6,3,9
HND-012591,2011,150100105,,,,23,13,36
HND-012595,2011,150100109,,,,8,9,17
HND-012596,2011,150100110,,,,25,30,55
HND-012598,2011,150100113,,,,2,3,5
HND-012599,2011,150100114,,,,4,2,6
HND-012600,2011,150100116,,,,12,10,22
,2011,150100118,,,,6,8,14
HND-012601,2011,150100121,,,,1,7,8
,2011,150100126,,,,26,31,57
,2011,150100135,,,,15,19,34
HND-012626,2011,150100155,,,,19,18,37
,2011,150100179,,,,20,17,37
HND-012641,2011,150100185,,,,0,3,3
HND-012647,2011,150100193,,,,1,4,5
HND-012664,2011,150100220,,,,5,8,13
,2011,150100227,,,,23,18,41
,2011,150100230,,,,5,4,9
HND-012670,2011,150100234,,,,1,4,5
HND-012671,2011,150100235,,,,2,3,5
HND-012689,2011,150100318,,,,9,5,14
,2011,150100324,,,,13,7,20
HND-012690,2011,150100325,,,,1,4,5
,2011,150100327,,,,2,2,4
HND-012691,2011,150100328,,,,2,3,5
HND-012696,2011,150100333,,,,3,6,9
HND-012697,2011,150100334,,,,8,8,16
HND-012699,2011,150100336,,,,6,4,10
HND-012715,2011,150100378,,,,2,3,5
HND-012490,2011,150100001,,,,9,10,19
HND-012491,2011,150100002,,,,55,31,86
HND-012496,2011,150100007,,,,3,0,3
HND-012498,2011,150100009,,,,2,8,10
HND-012500,2011,150100011,,,,22,5,27
HND-012502,2011,150100013,,,,6,5,11
HND-012505,2011,150100016,,,,31,14,45
HND-012506,2011,150100017,,,,8,5,13
HND-012508,2011,150100019,,,,30,36,66
HND-012509,2011,150100020,,,,51,39,90
HND-012510,2011,150100021,,,,27,25,52
HND-012511,2011,150100022,,,,13,15,28
HND-012512,2011,150100023,,,,18,22,40
HND-012513,2011,150100024,,,,20,13,33
HND-012516,2011,150100027,,,,15,9,24
HND-012517,2011,150100028,,,,15,10,25
HND-012518,2011,150100030,,,,1,2,3
HND-012519,2011,150100031,,,,9,4,13
HND-012521,2011,150100033,,,,26,19,45
HND-012525,2011,150100037,,,,4,9,13
HND-012526,2011,150100038,,,,7,5,12
HND-012530,2011,150100042,,,,8,6,14
HND-012533,2011,150100045,,,,12,11,23
HND-012534,2011,150100046,,,,12,13,25
HND-012537,2011,150100049,,,,14,5,19
HND-012538,2011,150100050,,,,4,3,7
HND-012539,2011,150100051,,,,18,17,35
HND-012540,2011,150100052,,,,2,3,5
HND-012541,2011,150100053,,,,5,6,11
HND-012542,2011,150100054,,,,2,4,6
HND-012545,2011,150100057,,,,1,1,2
HND-012546,2011,150100058,,,,5,7,12
HND-012547,2011,150100059,,,,24,23,47
HND-012550,2011,150100062,,,,3,2,5
HND-012551,2011,150100063,,,,94,77,171
HND-012553,2011,150100065,,,,1,3,4
HND-012556,2011,150100068,,,,7,10,17
HND-012557,2011,150100069,,,,2,0,2
HND-012558,2011,150100070,,,,7,3,10
HND-012559,2011,150100071,,,,5,11,16
HND-012561,2011,150100073,,,,8,3,11
HND-012562,2011,150100074,,,,21,11,32
HND-012565,2011,150100077,,,,5,8,13
HND-012566,2011,150100078,,,,5,2,7
HND-012568,2011,150100080,,,,16,8,24
HND-012569,2011,150100081,,,,13,11,24
,2011,150100083,,,,2,6,8
HND-012572,2011,150100084,,,,23,13,36
HND-012574,2011,150100086,,,,9,5,14
HND-012575,2011,150100087,,,,7,5,12
HND-012576,2011,150100088,,,,2,0,2
HND-012578,2011,150100091,,,,7,4,11
HND-012579,2011,150100092,,,,7,23,30
HND-012580,2011,150100093,,,,3,2,5
HND-012581,2011,150100094,,,,3,2,5
HND-012584,2011,150100097,,,,16,15,31
HND-012587,2011,150100100,,,,4,5,9
HND-012589,2011,150100103,,,,4,4,8
HND-012590,2011,150100104,,,,6,3,9
HND-012592,2011,150100106,,,,9,5,14
HND-012593,2011,150100107,,,,4,6,10
HND-012594,2011,150100108,,,,4,8,12
HND-012597,2011,150100112,,,,8,5,13
,2011,150100119,,,,14,1,15
HND-012602,2011,150100122,,,,3,0,3
HND-012603,2011,150100123,,,,6,5,11
HND-012608,2011,150100130,,,,23,17,40
HND-012630,2011,150100159,,,,0,2,2
,2011,150100166,,,,5,3,8
,2011,150100170,,,,2,7,9
,2011,150100174,,,,2,2,4
,2011,150100176,,,,1,1,2
HND-012637,2011,150100180,,,,3,1,4
HND-012638,2011,150100182,,,,9,4,13
HND-012639,2011,150100183,,,,8,0,8
HND-012640,2011,150100184,,,,2,5,7
HND-012642,2011,150100186,,,,3,4,7
HND-012644,2011,150100188,,,,6,1,7
HND-012645,2011,150100189,,,,28,21,49
,2011,150100192,,,,4,8,12
HND-012657,2011,150100204,,,,2,1,3
HND-012660,2011,150100211,,,,4,8,12
HND-012662,2011,150100217,,,,5,2,7
HND-012663,2011,150100218,,,,7,14,21
HND-012665,2011,150100223,,,,4,7,11
,2011,150100226,,,,6,6,12
HND-012666,2011,150100228,,,,27,28,55
HND-012667,2011,150100229,,,,7,2,9
HND-012668,2011,150100231,,,,1,5,6
HND-012669,2011,150100233,,,,7,2,9
,2011,150100241,,,,4,4,8
HND-012673,2011,150100242,,,,4,3,7
,2011,150100243,,,,5,4,9
,2011,150100247,,,,1,0,1
,2011,150100326,,,,2,4,6
HND-012692,2011,150100329,,,,7,2,9
HND-012693,2011,150100330,,,,5,5,10
HND-012694,2011,150100331,,,,3,3,6
HND-012695,2011,150100332,,,,7,2,9
HND-012698,2011,150100335,,,,5,4,9
HND-012714,2011,150100377,,,,1,0,1
HND-012716,2011,150100380,,,,3,2,5
HND-012723,2011,150100390,,,,6,5,11
,2011,150100398,,,,5,4,9
HND-012491,2011,150100002,,,,37,27,64
HND-012494,2011,150100005,,,,14,11,25
HND-012498,2011,150100009,,,,4,6,10
HND-012504,2011,150100015,,,,8,7,15
HND-012505,2011,150100016,,,,11,13,24
HND-012508,2011,150100019,,,,26,32,58
HND-012510,2011,150100021,,,,29,23,52
HND-012512,2011,150100023,,,,22,19,41
HND-012515,2011,150100026,,,,41,22,63
HND-012516,2011,150100027,,,,11,9,20
HND-012519,2011,150100031,,,,7,7,14
HND-012520,2011,150100032,,,,17,12,29
HND-012524,2011,150100036,,,,14,13,27
HND-012525,2011,150100037,,,,6,8,14
HND-012528,2011,150100040,,,,8,5,13
HND-012530,2011,150100042,,,,2,9,11
HND-012532,2011,150100044,,,,6,13,19
HND-012533,2011,150100045,,,,7,9,16
HND-012536,2011,150100048,,,,6,7,13
HND-012539,2011,150100051,,,,19,24,43
HND-012541,2011,150100053,,,,11,8,19
HND-012544,2011,150100056,,,,3,3,6
HND-012545,2011,150100057,,,,3,0,3
HND-012547,2011,150100059,,,,29,28,57
HND-012548,2011,150100060,,,,7,4,11
HND-012549,2011,150100061,,,,14,5,19
HND-012550,2011,150100062,,,,3,5,8
HND-012551,2011,150100063,,,,69,70,139
HND-012552,2011,150100064,,,,9,9,18
HND-012553,2011,150100065,,,,1,3,4
HND-012556,2011,150100068,,,,15,7,22
HND-012559,2011,150100071,,,,10,9,19
HND-012561,2011,150100073,,,,7,9,16
HND-012564,2011,150100076,,,,5,5,10
HND-012565,2011,150100077,,,,8,6,14
HND-012567,2011,150100079,,,,0,3,3
HND-012569,2011,150100081,,,,4,11,15
,2011,150100083,,,,1,1,2
HND-012574,2011,150100086,,,,3,4,7
HND-012575,2011,150100087,,,,10,1,11
HND-012577,2011,150100089,,,,3,4,7
HND-012578,2011,150100091,,,,12,4,16
HND-012580,2011,150100093,,,,2,3,5
HND-012583,2011,150100096,,,,6,10,16
HND-012588,2011,150100101,,,,0,2,2
HND-012595,2011,150100109,,,,4,5,9
HND-012597,2011,150100112,,,,10,4,14
HND-012598,2011,150100113,,,,4,0,4
HND-012599,2011,150100114,,,,0,1,1
HND-012603,2011,150100123,,,,5,3,8
,2011,150100126,,,,23,34,57
HND-012608,2011,150100130,,,,21,21,42
,2011,150100166,,,,5,5,10
,2011,150100179,,,,20,14,34
HND-012638,2011,150100182,,,,11,7,18
HND-012645,2011,150100189,,,,21,26,47
HND-012657,2011,150100204,,,,3,2,5
HND-012660,2011,150100211,,,,6,4,10
HND-012662,2011,150100217,,,,5,3,8
,2011,150100226,,,,2,2,4
HND-012666,2011,150100228,,,,34,24,58
HND-012667,2011,150100229,,,,4,3,7
HND-012669,2011,150100233,,,,6,6,12
HND-012671,2011,150100235,,,,2,0,2
HND-012672,2011,150100236,,,,9,9,18
,2011,150100243,,,,5,8,13
HND-012689,2011,150100318,,,,5,3,8
HND-012691,2011,150100328,,,,2,3,5
HND-012692,2011,150100329,,,,2,6,8
HND-012694,2011,150100331,,,,4,3,7
HND-012696,2011,150100333,,,,1,1,2
HND-012699,2011,150100336,,,,6,7,13
HND-012714,2011,150100377,,,,1,2,3
HND-012715,2011,150100378,,,,1,3,4
HND-012716,2011,150100380,,,,2,1,3
HND-012723,2011,150100390,,,,6,4,10
HND-012490,2011,150100001,,,,14,9,23
HND-012492,2011,150100003,,,,55,57,112
HND-012493,2011,150100004,,,,9,5,14
HND-012495,2011,150100006,,,,17,15,32
HND-012496,2011,150100007,,,,3,0,3
HND-012499,2011,150100010,,,,4,7,11
HND-012500,2011,150100011,,,,10,8,18
HND-012501,2011,150100012,,,,1,2,3
HND-012502,2011,150100013,,,,12,10,22
HND-012503,2011,150100014,,,,10,9,19
HND-012506,2011,150100017,,,,9,2,11
HND-012507,2011,150100018,,,,13,19,32
HND-012509,2011,150100020,,,,45,37,82
HND-012511,2011,150100022,,,,12,14,26
HND-012513,2011,150100024,,,,16,13,29
HND-012517,2011,150100028,,,,5,3,8
HND-012518,2011,150100030,,,,1,2,3
HND-012521,2011,150100033,,,,18,33,51
HND-012522,2011,150100034,,,,5,7,12
HND-012523,2011,150100035,,,,7,13,20
HND-012526,2011,150100038,,,,8,3,11
HND-012527,2011,150100039,,,,6,10,16
HND-012529,2011,150100041,,,,12,4,16
HND-012531,2011,150100043,,,,3,0,3
HND-012534,2011,150100046,,,,10,9,19
HND-012535,2011,150100047,,,,7,7,14
HND-012537,2011,150100049,,,,17,9,26
HND-012538,2011,150100050,,,,2,3,5
HND-012540,2011,150100052,,,,4,1,5
HND-012542,2011,150100054,,,,4,3,7
HND-012543,2011,150100055,,,,10,8,18
HND-012546,2011,150100058,,,,19,9,28
HND-012554,2011,150100066,,,,4,2,6
HND-012555,2011,150100067,,,,2,8,10
HND-012557,2011,150100069,,,,1,0,1
HND-012558,2011,150100070,,,,3,4,7
HND-012560,2011,150100072,,,,16,13,29
HND-012562,2011,150100074,,,,24,11,35
HND-012563,2011,150100075,,,,8,13,21
HND-012566,2011,150100078,,,,6,6,12
HND-012568,2011,150100080,,,,3,4,7
HND-012570,2011,150100082,,,,4,4,8
HND-012572,2011,150100084,,,,14,10,24
HND-012573,2011,150100085,,,,3,4,7
HND-012576,2011,150100088,,,,0,2,2
HND-012579,2011,150100092,,,,14,17,31
HND-012581,2011,150100094,,,,1,1,2
HND-012582,2011,150100095,,,,2,2,4
HND-012584,2011,150100097,,,,15,16,31
HND-012585,2011,150100098,,,,24,23,47
HND-012586,2011,150100099,,,,1,1,2
HND-012587,2011,150100100,,,,2,2,4
HND-012589,2011,150100103,,,,2,2,4
HND-012590,2011,150100104,,,,3,6,9
HND-012591,2011,150100105,,,,18,15,33
HND-012592,2011,150100106,,,,12,9,21
HND-012593,2011,150100107,,,,0,1,1
HND-012594,2011,150100108,,,,5,2,7
HND-012596,2011,150100110,,,,30,21,51
HND-012600,2011,150100116,,,,7,5,12
,2011,150100118,,,,13,12,25
,2011,150100119,,,,8,8,16
HND-012601,2011,150100121,,,,0,4,4
HND-012602,2011,150100122,,,,1,0,1
,2011,150100135,,,,16,19,35
HND-012626,2011,150100155,,,,18,14,32
,2011,150100170,,,,4,10,14
,2011,150100174,,,,7,3,10
,2011,150100176,,,,2,1,3
HND-012637,2011,150100180,,,,1,1,2
HND-012639,2011,150100183,,,,5,12,17
HND-012640,2011,150100184,,,,2,4,6
HND-012641,2011,150100185,,,,1,0,1
HND-012642,2011,150100186,,,,1,5,6
HND-012644,2011,150100188,,,,2,2,4
,2011,150100192,,,,1,3,4
HND-012647,2011,150100193,,,,2,1,3
HND-012663,2011,150100218,,,,7,10,17
HND-012664,2011,150100220,,,,7,4,11
HND-012665,2011,150100223,,,,5,4,9
,2011,150100227,,,,13,25,38
,2011,150100230,,,,0,2,2
HND-012668,2011,150100231,,,,3,0,3
HND-012670,2011,150100234,,,,1,2,3
,2011,150100241,,,,3,3,6
HND-012673,2011,150100242,,,,2,9,11
,2011,150100247,,,,0,1,1
,2011,150100324,,,,7,4,11
HND-012690,2011,150100325,,,,0,2,2
,2011,150100326,,,,1,6,7
,2011,150100327,,,,3,2,5
HND-012693,2011,150100330,,,,4,5,9
HND-012695,2011,150100332,,,,0,3,3
HND-012697,2011,150100334,,,,4,4,8
HND-012698,2011,150100335,,,,5,3,8
,2011,150100398,,,,4,5,9
HND-012491,2011,150100002,,,,30,41,71
HND-012494,2011,150100005,,,,4,12,16
HND-012498,2011,150100009,,,,2,7,9
HND-012502,2011,150100013,,,,5,14,19
HND-012504,2011,150100015,,,,4,8,12
HND-012505,2011,150100016,,,,16,17,33
HND-012506,2011,150100017,,,,3,1,4
HND-012508,2011,150100019,,,,28,30,58
HND-012509,2011,150100020,,,,43,28,71
HND-012510,2011,150100021,,,,23,21,44
HND-012512,2011,150100023,,,,14,18,32
HND-012513,2011,150100024,,,,25,14,39
HND-012515,2011,150100026,,,,26,28,54
HND-012516,2011,150100027,,,,9,12,21
HND-012518,2011,150100030,,,,1,2,3
HND-012519,2011,150100031,,,,6,4,10
HND-012521,2011,150100033,,,,19,20,39
HND-012524,2011,150100036,,,,6,13,19
HND-012525,2011,150100037,,,,9,9,18
HND-012526,2011,150100038,,,,8,7,15
HND-012528,2011,150100040,,,,10,2,12
HND-012530,2011,150100042,,,,2,4,6
HND-012533,2011,150100045,,,,9,18,27
HND-012536,2011,150100048,,,,10,10,20
HND-012537,2011,150100049,,,,8,4,12
HND-012538,2011,150100050,,,,1,5,6
HND-012539,2011,150100051,,,,28,16,44
HND-012541,2011,150100053,,,,7,5,12
HND-012542,2011,150100054,,,,0,2,2
HND-012544,2011,150100056,,,,1,1,2
HND-012545,2011,150100057,,,,1,1,2
HND-012547,2011,150100059,,,,35,30,65
HND-012548,2011,150100060,,,,0,2,2
HND-012550,2011,150100062,,,,3,6,9
HND-012551,2011,150100063,,,,91,93,184
HND-012552,2011,150100064,,,,6,8,14
HND-012553,2011,150100065,,,,1,1,2
HND-012556,2011,150100068,,,,5,4,9
HND-012559,2011,150100071,,,,8,5,13
HND-012561,2011,150100073,,,,7,7,14
HND-012562,2011,150100074,,,,9,11,20
HND-012564,2011,150100076,,,,10,6,16
HND-012565,2011,150100077,,,,2,5,7
HND-012569,2011,150100081,,,,5,4,9
,2011,150100083,,,,4,0,4
HND-012574,2011,150100086,,,,3,1,4
HND-012575,2011,150100087,,,,2,1,3
HND-012578,2011,150100091,,,,9,7,16
HND-012580,2011,150100093,,,,3,4,7
HND-012581,2011,150100094,,,,4,1,5
HND-012583,2011,150100096,,,,4,4,8
HND-012588,2011,150100101,,,,6,0,6
HND-012591,2011,150100105,,,,19,17,36
HND-012595,2011,150100109,,,,8,10,18
HND-012598,2011,150100113,,,,0,1,1
HND-012599,2011,150100114,,,,2,4,6
HND-012600,2011,150100116,,,,7,5,12
,2011,150100118,,,,17,16,33
HND-012603,2011,150100123,,,,3,11,14
,2011,150100126,,,,30,27,57
HND-012608,2011,150100130,,,,18,23,41
,2011,150100166,,,,5,9,14
,2011,150100176,,,,1,4,5
,2011,150100179,,,,11,13,24
HND-012637,2011,150100180,,,,1,7,8
HND-012638,2011,150100182,,,,11,6,17
HND-012640,2011,150100184,,,,2,2,4
HND-012642,2011,150100186,,,,5,3,8
HND-012645,2011,150100189,,,,21,21,42
HND-012657,2011,150100204,,,,1,3,4
HND-012660,2011,150100211,,,,3,6,9
HND-012662,2011,150100217,,,,7,9,16
HND-012663,2011,150100218,,,,5,4,9
HND-012665,2011,150100223,,,,1,7,8
,2011,150100226,,,,3,2,5
HND-012666,2011,150100228,,,,23,33,56
HND-012667,2011,150100229,,,,5,2,7
HND-012669,2011,150100233,,,,5,8,13
,2011,150100243,,,,4,2,6
,2011,150100326,,,,2,3,5
HND-012692,2011,150100329,,,,6,6,12
HND-012693,2011,150100330,,,,8,3,11
HND-012694,2011,150100331,,,,3,3,6
HND-012696,2011,150100333,,,,2,5,7
HND-012697,2011,150100334,,,,5,3,8
HND-012699,2011,150100336,,,,5,2,7
HND-012714,2011,150100377,,,,2,1,3
HND-012715,2011,150100378,,,,0,1,1
HND-012716,2011,150100380,,,,4,4,8
HND-012723,2011,150100390,,,,5,3,8
HND-012490,2011,150100001,,,,10,10,20
HND-012492,2011,150100003,,,,48,58,106
HND-012493,2011,150100004,,,,11,5,16
HND-012495,2011,150100006,,,,13,18,31
HND-012496,2011,150100007,,,,2,2,4
HND-012497,2011,150100008,,,,0,1,1
HND-012499,2011,150100010,,,,6,6,12
HND-012500,2011,150100011,,,,6,16,22
HND-012501,2011,150100012,,,,3,1,4
HND-012503,2011,150100014,,,,4,6,10
HND-012507,2011,150100018,,,,10,9,19
HND-012511,2011,150100022,,,,7,8,15
HND-012514,2011,150100025,,,,3,1,4
HND-012517,2011,150100028,,,,5,9,14
HND-012520,2011,150100032,,,,10,13,23
HND-012522,2011,150100034,,,,11,7,18
HND-012523,2011,150100035,,,,2,9,11
HND-012527,2011,150100039,,,,1,3,4
HND-012529,2011,150100041,,,,6,5,11
HND-012531,2011,150100043,,,,2,3,5
HND-012532,2011,150100044,,,,13,7,20
HND-012534,2011,150100046,,,,11,18,29
HND-012535,2011,150100047,,,,5,9,14
HND-012540,2011,150100052,,,,4,2,6
HND-012543,2011,150100055,,,,8,10,18
HND-012546,2011,150100058,,,,9,6,15
HND-012549,2011,150100061,,,,8,3,11
HND-012554,2011,150100066,,,,3,2,5
HND-012555,2011,150100067,,,,1,6,7
HND-012557,2011,150100069,,,,0,1,1
HND-012558,2011,150100070,,,,3,0,3
HND-012560,2011,150100072,,,,21,7,28
HND-012563,2011,150100075,,,,10,11,21
HND-012566,2011,150100078,,,,6,4,10
HND-012567,2011,150100079,,,,1,4,5
HND-012568,2011,150100080,,,,16,10,26
HND-012570,2011,150100082,,,,5,5,10
HND-012572,2011,150100084,,,,32,24,56
HND-012573,2011,150100085,,,,6,1,7
HND-012576,2011,150100088,,,,2,2,4
HND-012577,2011,150100089,,,,5,3,8
HND-012579,2011,150100092,,,,2,11,13
HND-012582,2011,150100095,,,,0,4,4
HND-012584,2011,150100097,,,,16,14,30
HND-012585,2011,150100098,,,,18,19,37
HND-012586,2011,150100099,,,,2,2,4
HND-012587,2011,150100100,,,,5,2,7
HND-012589,2011,150100103,,,,6,8,14
HND-012590,2011,150100104,,,,6,2,8
HND-012592,2011,150100106,,,,8,9,17
HND-012593,2011,150100107,,,,1,1,2
HND-012594,2011,150100108,,,,2,4,6
HND-012596,2011,150100110,,,,19,16,35
HND-012597,2011,150100112,,,,6,4,10
,2011,150100119,,,,5,9,14
HND-012601,2011,150100121,,,,1,5,6
HND-012602,2011,150100122,,,,0,2,2
,2011,150100135,,,,21,17,38
HND-012626,2011,150100155,,,,16,8,24
HND-012630,2011,150100159,,,,1,3,4
,2011,150100170,,,,8,8,16
,2011,150100174,,,,2,1,3
HND-012639,2011,150100183,,,,5,7,12
HND-012641,2011,150100185,,,,3,1,4
HND-012644,2011,150100188,,,,10,4,14
,2011,150100192,,,,2,3,5
HND-012647,2011,150100193,,,,1,2,3
HND-012664,2011,150100220,,,,2,7,9
,2011,150100227,,,,16,27,43
,2011,150100230,,,,2,0,2
HND-012668,2011,150100231,,,,0,3,3
HND-012670,2011,150100234,,,,4,1,5
HND-012671,2011,150100235,,,,3,1,4
,2011,150100241,,,,6,4,10
HND-012673,2011,150100242,,,,1,4,5
HND-012689,2011,150100318,,,,6,12,18
,2011,150100324,,,,9,5,14
,2011,150100327,,,,1,0,1
HND-012691,2011,150100328,,,,3,2,5
HND-012695,2011,150100332,,,,1,1,2
HND-012698,2011,150100335,,,,4,4,8
,2011,150100398,,,,1,3,4
HND-012490,2011,150100001,,,,11,11,22
HND-012493,2011,150100004,,,,6,9,15
HND-012495,2011,150100006,,,,16,15,31
HND-012496,2011,150100007,,,,2,0,2
HND-012499,2011,150100010,,,,2,8,10
HND-012500,2011,150100011,,,,8,10,18
HND-012502,2011,150100013,,,,8,9,17
HND-012503,2011,150100014,,,,6,5,11
HND-012505,2011,150100016,,,,17,16,33
HND-012506,2011,150100017,,,,1,4,5
HND-012509,2011,150100020,,,,36,35,71
HND-012510,2011,150100021,,,,32,27,59
HND-012511,2011,150100022,,,,6,10,16
HND-012513,2011,150100024,,,,22,17,39
HND-012517,2011,150100028,,,,7,10,17
HND-012518,2011,150100030,,,,5,2,7
HND-012521,2011,150100033,,,,28,27,55
HND-012522,2011,150100034,,,,10,10,20
HND-012523,2011,150100035,,,,6,3,9
HND-012526,2011,150100038,,,,5,5,10
HND-012531,2011,150100043,,,,0,1,1
HND-012534,2011,150100046,,,,13,17,30
HND-012535,2011,150100047,,,,5,9,14
HND-012537,2011,150100049,,,,8,9,17
HND-012538,2011,150100050,,,,6,2,8
HND-012539,2011,150100051,,,,25,24,49
HND-012540,2011,150100052,,,,2,2,4
HND-012542,2011,150100054,,,,3,2,5
HND-012543,2011,150100055,,,,5,8,13
HND-012546,2011,150100058,,,,6,10,16
HND-012553,2011,150100065,,,,3,6,9
HND-012554,2011,150100066,,,,2,6,8
HND-012557,2011,150100069,,,,3,1,4
HND-012558,2011,150100070,,,,2,3,5
HND-012559,2011,150100071,,,,4,2,6
HND-012560,2011,150100072,,,,8,8,16
HND-012562,2011,150100074,,,,8,14,22
HND-012563,2011,150100075,,,,13,7,20
HND-012566,2011,150100078,,,,6,4,10
HND-012568,2011,150100080,,,,3,8,11
HND-012569,2011,150100081,,,,10,9,19
HND-012570,2011,150100082,,,,4,5,9
HND-012572,2011,150100084,,,,8,12,20
HND-012576,2011,150100088,,,,0,2,2
HND-012579,2011,150100092,,,,9,8,17
HND-012581,2011,150100094,,,,2,4,6
HND-012582,2011,150100095,,,,1,0,1
HND-012584,2011,150100097,,,,18,18,36
HND-012588,2011,150100101,,,,2,3,5
HND-012590,2011,150100104,,,,2,6,8
HND-012591,2011,150100105,,,,12,13,25
HND-012592,2011,150100106,,,,10,3,13
HND-012596,2011,150100110,,,,10,16,26
HND-012600,2011,150100116,,,,6,6,12
,2011,150100118,,,,15,12,27
HND-012601,2011,150100121,,,,1,3,4
,2011,150100135,,,,30,22,52
HND-012626,2011,150100155,,,,23,9,32
,2011,150100170,,,,7,6,13
,2011,150100174,,,,2,1,3
HND-012637,2011,150100180,,,,2,3,5
HND-012639,2011,150100183,,,,4,4,8
HND-012640,2011,150100184,,,,3,6,9
HND-012641,2011,150100185,,,,1,0,1
HND-012642,2011,150100186,,,,2,2,4
HND-012644,2011,150100188,,,,2,4,6
,2011,150100192,,,,3,1,4
HND-012657,2011,150100204,,,,3,0,3
HND-012663,2011,150100218,,,,2,12,14
HND-012664,2011,150100220,,,,1,3,4
HND-012665,2011,150100223,,,,4,4,8
,2011,150100227,,,,22,18,40
HND-012667,2011,150100229,,,,2,5,7
,2011,150100230,,,,0,2,2
HND-012668,2011,150100231,,,,2,1,3
HND-012669,2011,150100233,,,,6,8,14
HND-012670,2011,150100234,,,,0,3,3
,2011,150100241,,,,7,5,12
HND-012673,2011,150100242,,,,1,2,3
,2011,150100326,,,,1,2,3
,2011,150100327,,,,2,1,3
HND-012692,2011,150100329,,,,0,2,2
HND-012693,2011,150100330,,,,2,4,6
HND-012697,2011,150100334,,,,2,2,4
HND-012698,2011,150100335,,,,3,4,7
HND-012699,2011,150100336,,,,2,7,9
HND-012715,2011,150100378,,,,0,2,2
HND-012716,2011,150100380,,,,1,3,4
,2011,150100398,,,,3,0,3
HND-012491,2011,150100002,,,,23,26,49
HND-012492,2011,150100003,,,,64,67,131
HND-012494,2011,150100005,,,,9,12,21
HND-012497,2011,150100008,,,,1,0,1
HND-012498,2011,150100009,,,,4,7,11
HND-012501,2011,150100012,,,,1,0,1
HND-012504,2011,150100015,,,,1,5,6
HND-012507,2011,150100018,,,,15,12,27
HND-012508,2011,150100019,,,,25,26,51
HND-012512,2011,150100023,,,,21,21,42
HND-012515,2011,150100026,,,,29,25,54
HND-012516,2011,150100027,,,,9,3,12
HND-012519,2011,150100031,,,,4,8,12
HND-012520,2011,150100032,,,,13,15,28
HND-012524,2011,150100036,,,,18,17,35
HND-012525,2011,150100037,,,,6,4,10
HND-012527,2011,150100039,,,,2,3,5
HND-012528,2011,150100040,,,,5,3,8
HND-012529,2011,150100041,,,,4,3,7
HND-012530,2011,150100042,,,,3,5,8
HND-012532,2011,150100044,,,,13,7,20
HND-012533,2011,150100045,,,,6,12,18
HND-012536,2011,150100048,,,,8,7,15
HND-012541,2011,150100053,,,,6,4,10
HND-012544,2011,150100056,,,,1,1,2
HND-012545,2011,150100057,,,,4,0,4
HND-012547,2011,150100059,,,,23,33,56
HND-012548,2011,150100060,,,,1,0,1
HND-012549,2011,150100061,,,,8,10,18
HND-012550,2011,150100062,,,,3,1,4
HND-012551,2011,150100063,,,,65,73,138
HND-012552,2011,150100064,,,,6,12,18
HND-012555,2011,150100067,,,,3,4,7
HND-012556,2011,150100068,,,,8,2,10
HND-012561,2011,150100073,,,,8,2,10
HND-012564,2011,150100076,,,,6,7,13
HND-012565,2011,150100077,,,,4,4,8
HND-012567,2011,150100079,,,,2,0,2
,2011,150100083,,,,5,2,7
HND-012573,2011,150100085,,,,2,1,3
HND-012574,2011,150100086,,,,7,3,10
HND-012575,2011,150100087,,,,3,5,8
HND-012577,2011,150100089,,,,7,13,20
HND-012578,2011,150100091,,,,3,3,6
HND-012580,2011,150100093,,,,4,2,6
HND-012583,2011,150100096,,,,6,10,16
HND-012585,2011,150100098,,,,19,17,36
HND-012586,2011,150100099,,,,4,4,8
HND-012587,2011,150100100,,,,3,3,6
HND-012589,2011,150100103,,,,6,6,12
HND-012594,2011,150100108,,,,2,6,8
HND-012595,2011,150100109,,,,6,1,7
HND-012597,2011,150100112,,,,1,2,3
HND-012598,2011,150100113,,,,2,2,4
HND-012599,2011,150100114,,,,0,2,2
,2011,150100119,,,,10,4,14
HND-012602,2011,150100122,,,,2,1,3
HND-012603,2011,150100123,,,,0,1,1
,2011,150100126,,,,22,28,50
HND-012608,2011,150100130,,,,16,21,37
,2011,150100166,,,,5,5,10
,2011,150100179,,,,7,20,27
HND-012638,2011,150100182,,,,6,7,13
HND-012645,2011,150100189,,,,15,20,35
HND-012647,2011,150100193,,,,1,2,3
HND-012660,2011,150100211,,,,1,5,6
HND-012662,2011,150100217,,,,5,2,7
,2011,150100226,,,,2,8,10
HND-012666,2011,150100228,,,,27,31,58
HND-012671,2011,150100235,,,,3,2,5
HND-012672,2011,150100236,,,,2,3,5
,2011,150100243,,,,0,2,2
HND-012689,2011,150100318,,,,4,1,5
HND-012690,2011,150100325,,,,1,3,4
HND-012691,2011,150100328,,,,1,1,2
HND-012694,2011,150100331,,,,5,2,7
HND-012695,2011,150100332,,,,2,1,3
HND-012696,2011,150100333,,,,2,3,5
HND-012714,2011,150100377,,,,1,0,1
HND-012723,2011,150100390,,,,1,3,4
HND-012491,2011,150100002,,,,36,95,131
HND-012505,2011,150100016,,,,3,18,21
HND-012512,2011,150100023,,,,10,18,28
HND-012513,2011,150100024,,,,22,29,51
HND-012515,2011,150100026,,,,19,13,32
HND-012522,2011,150100034,,,,12,11,23
HND-012524,2011,150100036,,,,33,30,63
HND-012532,2011,150100044,,,,17,15,32
HND-012534,2011,150100046,,,,15,14,29
HND-012560,2011,150100072,,,,17,18,35
HND-012563,2011,150100075,,,,8,15,23
HND-012585,2011,150100098,,,,13,12,25
HND-012592,2011,150100106,,,,12,20,32
HND-012608,2011,150100130,,,,25,30,55
,2011,150100135,,,,18,36,54
HND-012634,2011,150100169,,,,254,301,555
HND-012635,2011,150100171,,,,28,32,60
,2011,150100179,,,,5,9,14
HND-012645,2011,150100189,,,,18,36,54
HND-012656,2011,150100203,,,,29,21,50
HND-012659,2011,150100209,,,,75,64,139
,2011,150100215,,,,4,1,5
HND-012664,2011,150100220,,,,9,8,17
,2011,150100221,,,,8,0,8
,2011,150100248,,,,6,27,33
HND-012490,2011,150100001,,,,7,14,21
HND-012495,2011,150100006,,,,11,16,27
HND-012500,2011,150100011,,,,16,15,31
HND-012519,2011,150100031,,,,8,11,19
HND-012521,2011,150100033,,,,25,13,38
HND-012539,2011,150100051,,,,14,14,28
HND-012547,2011,150100059,,,,49,61,110
HND-012562,2011,150100074,,,,12,8,20
HND-012572,2011,150100084,,,,7,10,17
,2011,150100126,,,,26,27,53
,2011,150100168,,,,16,16,32
,2011,150100170,,,,7,10,17
,2011,150100173,,,,11,8,19
,2011,150100174,,,,4,10,14
,2011,150100214,,,,4,10,14
,2011,150100216,,,,1,3,4
HND-012663,2011,150100218,,,,21,10,31
,2011,150100227,,,,13,20,33
HND-012666,2011,150100228,,,,34,41,75
,2011,150100389,,,,19,10,29
HND-012491,2011,150100002,,,,28,48,76
HND-012512,2011,150100023,,,,18,20,38
HND-012515,2011,150100026,,,,15,24,39
HND-012519,2011,150100031,,,,7,9,16
HND-012524,2011,150100036,,,,22,20,42
HND-012532,2011,150100044,,,,8,6,14
HND-012547,2011,150100059,,,,42,67,109
HND-012585,2011,150100098,,,,7,11,18
HND-012608,2011,150100130,,,,26,33,59
HND-012634,2011,150100169,,,,190,269,459
,2011,150100170,,,,9,11,20
,2011,150100174,,,,15,6,21
,2011,150100179,,,,9,10,19
HND-012645,2011,150100189,,,,26,20,46
HND-012656,2011,150100203,,,,14,27,41
HND-012659,2011,150100209,,,,55,51,106
,2011,150100216,,,,2,1,3
,2011,150100227,,,,15,15,30
HND-012666,2011,150100228,,,,30,27,57
HND-012490,2011,150100001,,,,5,7,12
HND-012495,2011,150100006,,,,2,13,15
HND-012500,2011,150100011,,,,16,9,25
HND-012505,2011,150100016,,,,7,10,17
HND-012513,2011,150100024,,,,15,16,31
HND-012521,2011,150100033,,,,12,9,21
HND-012522,2011,150100034,,,,10,7,17
HND-012534,2011,150100046,,,,14,6,20
HND-012539,2011,150100051,,,,20,15,35
HND-012560,2011,150100072,,,,1,13,14
HND-012562,2011,150100074,,,,5,3,8
HND-012563,2011,150100075,,,,5,12,17
HND-012572,2011,150100084,,,,6,12,18
HND-012592,2011,150100106,,,,6,13,19
,2011,150100126,,,,28,19,47
,2011,150100135,,,,17,40,57
,2011,150100168,,,,22,14,36
HND-012635,2011,150100171,,,,29,23,52
,2011,150100173,,,,11,5,16
,2011,150100215,,,,4,0,4
HND-012663,2011,150100218,,,,7,7,14
HND-012664,2011,150100220,,,,3,7,10
,2011,150100248,,,,7,28,35
,2011,150100389,,,,24,24,48
HND-012491,2011,150100002,,,,23,53,76
HND-012505,2011,150100016,,,,7,10,17
HND-012512,2011,150100023,,,,8,14,22
HND-012515,2011,150100026,,,,9,18,27
HND-012519,2011,150100031,,,,8,12,20
HND-012524,2011,150100036,,,,13,15,28
HND-012532,2011,150100044,,,,11,8,19
HND-012539,2011,150100051,,,,12,9,21
HND-012547,2011,150100059,,,,32,40,72
,2011,150100126,,,,19,29,48
HND-012608,2011,150100130,,,,20,28,48
HND-012634,2011,150100169,,,,157,227,384
,2011,150100170,,,,6,9,15
,2011,150100173,,,,9,15,24
,2011,150100174,,,,5,6,11
,2011,150100179,,,,1,6,7
HND-012645,2011,150100189,,,,13,24,37
HND-012656,2011,150100203,,,,12,15,27
HND-012659,2011,150100209,,,,49,47,96
,2011,150100214,,,,9,9,18
,2011,150100215,,,,2,5,7
,2011,150100216,,,,0,3,3
HND-012666,2011,150100228,,,,31,33,64
,2011,150100248,,,,5,50,55
HND-012490,2011,150100001,,,,7,7,14
HND-012495,2011,150100006,,,,1,6,7
HND-012500,2011,150100011,,,,6,6,12
HND-012513,2011,150100024,,,,13,18,31
HND-012521,2011,150100033,,,,11,10,21
HND-012522,2011,150100034,,,,8,5,13
HND-012534,2011,150100046,,,,9,10,19
HND-012560,2011,150100072,,,,7,12,19
HND-012562,2011,150100074,,,,5,6,11
HND-012563,2011,150100075,,,,9,6,15
HND-012572,2011,150100084,,,,7,5,12
HND-012585,2011,150100098,,,,8,8,16
HND-012592,2011,150100106,,,,6,14,20
,2011,150100135,,,,21,27,48
,2011,150100168,,,,25,18,43
HND-012635,2011,150100171,,,,13,25,38
HND-012663,2011,150100218,,,,9,5,14
HND-012664,2011,150100220,,,,6,6,12
,2011,150100389,,,,31,24,55
HND-012608,2011,150100130,,,,25,34,59
,2011,150100168,,,,50,48,98
HND-012655,2011,150100202,,,,166,344,510
,2011,150100221,,,,22,0,22
,2011,150100126,,,,15,29,44
,2011,150100135,,,,14,20,34
HND-012634,2011,150100169,,,,359,488,847
,2011,150100170,,,,5,4,9
HND-012635,2011,150100171,,,,11,29,40
,2011,150100173,,,,14,24,38
,2011,150100174,,,,12,17,29
HND-012656,2011,150100203,,,,16,11,27
HND-012659,2011,150100209,,,,37,45,82
,2011,150100214,,,,12,14,26
,2011,150100216,,,,7,8,15
,2011,150100248,,,,20,33,53
,2011,150100389,,,,69,64,133
HND-012608,2011,150100130,,,,16,17,33
,2011,150100168,,,,46,43,89
,2011,150100221,,,,33,0,33
,2011,150100389,,,,64,67,131
,2011,150100126,,,,14,12,26
,2011,150100135,,,,16,19,35
HND-012634,2011,150100169,,,,246,321,567
,2011,150100170,,,,11,6,17
HND-012635,2011,150100171,,,,14,13,27
,2011,150100173,,,,18,25,43
,2011,150100174,,,,14,11,25
HND-012655,2011,150100202,,,,157,385,542
HND-012656,2011,150100203,,,,10,6,16
HND-012659,2011,150100209,,,,32,35,67
,2011,150100214,,,,13,18,31
,2011,150100216,,,,4,12,16
,2011,150100248,,,,8,37,45
,2011,150100126,,,,14,22,36
,2011,150100135,,,,4,3,7
HND-012634,2011,150100169,,,,154,251,405
HND-012635,2011,150100171,,,,10,26,36
,2011,150100173,,,,87,122,209
HND-012655,2011,150100202,,,,155,313,468
HND-012656,2011,150100203,,,,7,8,15
HND-012659,2011,150100209,,,,22,35,57
,2011,150100216,,,,6,12,18
,2011,150100389,,,,46,50,96
HND-012608,2011,150100130,,,,9,22,31
,2011,150100168,,,,24,25,49
,2011,150100221,,,,35,0,35
HND-012752,2011,150200018,,,,7,4,11
HND-012757,2011,150200023,,,,3,3,6
HND-012790,2011,150200075,,,,6,2,8
,2011,150200076,,,,4,5,9
HND-012792,2011,150200079,,,,4,6,10
,2011,150200080,,,,5,8,13
,2011,150200081,,,,3,2,5
,2011,150200083,,,,4,4,8
HND-012793,2011,150200084,,,,18,16,34
,2011,150200086,,,,4,6,10
,2011,150200088,,,,1,6,7
,2011,150200096,,,,4,6,10
,2011,150200099,,,,8,4,12
HND-012803,2011,150200107,,,,5,4,9
,2011,150200108,,,,6,5,11
,2011,150200109,,,,5,4,9
HND-012751,2011,150200017,,,,4,5,9
,2011,150200073,,,,6,4,10
,2011,150200074,,,,3,7,10
HND-012791,2011,150200077,,,,6,5,11
,2011,150200082,,,,4,2,6
,2011,150200085,,,,1,6,7
,2011,150200093,,,,3,9,12
HND-012798,2011,150200094,,,,6,7,13
,2011,150200097,,,,1,4,5
HND-012800,2011,150200098,,,,3,7,10
,2011,150200102,,,,4,4,8
HND-012802,2011,150200106,,,,0,2,2
HND-012769,2011,150200038,,,,8,9,17
HND-012770,2011,150200042,,,,7,5,12
,2011,150200063,,,,1,2,3
,2011,150200030,,,,5,1,6
HND-012768,2011,150200037,,,,15,7,22
HND-012771,2011,150200043,,,,8,4,12
HND-012802,2011,150200106,,,,3,6,9
,2011,150200030,,,,4,6,10
HND-012768,2011,150200037,,,,33,45,78
HND-012769,2011,150200038,,,,27,20,47
HND-012770,2011,150200042,,,,2,5,7
HND-012802,2011,150200106,,,,4,2,6
HND-012771,2011,150200043,,,,9,4,13
,2011,150200063,,,,10,10,20
HND-012735,2011,150200001,,,,2,4,6
HND-012738,2011,150200004,,,,5,5,10
HND-012741,2011,150200007,,,,10,3,13
HND-012742,2011,150200008,,,,4,3,7
HND-012748,2011,150200014,,,,57,40,97
HND-012749,2011,150200015,,,,9,10,19
HND-012750,2011,150200016,,,,3,4,7
HND-012753,2011,150200019,,,,8,3,11
HND-012754,2011,150200020,,,,2,1,3
HND-012755,2011,150200021,,,,1,6,7
HND-012757,2011,150200023,,,,6,4,10
HND-012758,2011,150200024,,,,4,5,9
HND-012760,2011,150200026,,,,1,3,4
HND-012761,2011,150200027,,,,6,3,9
HND-012762,2011,150200028,,,,18,15,33
HND-012767,2011,150200036,,,,6,4,10
HND-012773,2011,150200048,,,,6,5,11
HND-012774,2011,150200049,,,,5,3,8
HND-012780,2011,150200055,,,,7,0,7
HND-012781,2011,150200056,,,,13,3,16
HND-012787,2011,150200065,,,,3,7,10
HND-012788,2011,150200069,,,,5,6,11
HND-012789,2011,150200071,,,,2,2,4
HND-012797,2011,150200091,,,,7,4,11
HND-012736,2011,150200002,,,,50,29,79
HND-012737,2011,150200003,,,,7,6,13
HND-012739,2011,150200005,,,,3,3,6
HND-012740,2011,150200006,,,,5,2,7
HND-012743,2011,150200009,,,,12,8,20
HND-012744,2011,150200010,,,,26,13,39
HND-012745,2011,150200011,,,,1,2,3
HND-012746,2011,150200012,,,,5,4,9
HND-012747,2011,150200013,,,,5,0,5
HND-012751,2011,150200017,,,,2,2,4
HND-012752,2011,150200018,,,,3,3,6
HND-012756,2011,150200022,,,,5,5,10
HND-012759,2011,150200025,,,,6,2,8
,2011,150200029,,,,7,4,11
,2011,150200030,,,,8,13,21
HND-012763,2011,150200031,,,,7,2,9
HND-012764,2011,150200032,,,,4,9,13
HND-012765,2011,150200034,,,,4,7,11
,2011,150200035,,,,3,1,4
HND-012772,2011,150200047,,,,5,3,8
HND-012775,2011,150200050,,,,11,8,19
HND-012776,2011,150200051,,,,2,2,4
HND-012777,2011,150200052,,,,2,2,4
HND-012778,2011,150200053,,,,1,1,2
HND-012779,2011,150200054,,,,6,6,12
HND-012782,2011,150200057,,,,2,3,5
,2011,150200058,,,,7,8,15
HND-012784,2011,150200060,,,,3,1,4
HND-012785,2011,150200062,,,,1,0,1
HND-012786,2011,150200064,,,,2,4,6
,2011,150200070,,,,8,6,14
HND-012794,2011,150200087,,,,3,2,5
,2011,150200089,,,,8,7,15
HND-012796,2011,150200090,,,,2,4,6
HND-012799,2011,150200095,,,,2,0,2
HND-012735,2011,150200001,,,,4,0,4
HND-012736,2011,150200002,,,,30,33,63
HND-012737,2011,150200003,,,,6,3,9
HND-012740,2011,150200006,,,,2,1,3
HND-012741,2011,150200007,,,,5,5,10
HND-012744,2011,150200010,,,,16,15,31
HND-012746,2011,150200012,,,,7,7,14
HND-012748,2011,150200014,,,,37,45,82
HND-012749,2011,150200015,,,,4,9,13
HND-012752,2011,150200018,,,,4,2,6
HND-012757,2011,150200023,,,,3,3,6
HND-012760,2011,150200026,,,,5,3,8
HND-012761,2011,150200027,,,,2,7,9
,2011,150200029,,,,3,5,8
,2011,150200030,,,,5,4,9
HND-012764,2011,150200032,,,,5,5,10
HND-012765,2011,150200034,,,,2,2,4
,2011,150200035,,,,1,0,1
HND-012772,2011,150200047,,,,5,7,12
HND-012773,2011,150200048,,,,4,3,7
HND-012775,2011,150200050,,,,6,3,9
HND-012777,2011,150200052,,,,4,2,6
HND-012779,2011,150200054,,,,0,1,1
HND-012780,2011,150200055,,,,0,1,1
,2011,150200058,,,,5,8,13
HND-012784,2011,150200060,,,,4,1,5
HND-012785,2011,150200062,,,,3,6,9
HND-012786,2011,150200064,,,,1,1,2
HND-012794,2011,150200087,,,,1,2,3
HND-012799,2011,150200095,,,,3,2,5
HND-012738,2011,150200004,,,,2,3,5
HND-012739,2011,150200005,,,,3,2,5
HND-012742,2011,150200008,,,,2,2,4
HND-012743,2011,150200009,,,,14,5,19
HND-012745,2011,150200011,,,,1,3,4
HND-012747,2011,150200013,,,,0,3,3
HND-012750,2011,150200016,,,,2,2,4
HND-012751,2011,150200017,,,,3,1,4
HND-012753,2011,150200019,,,,3,2,5
HND-012754,2011,150200020,,,,1,2,3
HND-012755,2011,150200021,,,,6,8,14
HND-012756,2011,150200022,,,,3,2,5
HND-012758,2011,150200024,,,,4,5,9
HND-012759,2011,150200025,,,,4,3,7
HND-012762,2011,150200028,,,,9,10,19
HND-012763,2011,150200031,,,,8,7,15
HND-012767,2011,150200036,,,,1,3,4
HND-012774,2011,150200049,,,,3,3,6
HND-012776,2011,150200051,,,,2,1,3
HND-012778,2011,150200053,,,,2,1,3
HND-012781,2011,150200056,,,,2,8,10
HND-012782,2011,150200057,,,,4,2,6
HND-012787,2011,150200065,,,,2,4,6
HND-012788,2011,150200069,,,,10,5,15
,2011,150200070,,,,6,3,9
HND-012789,2011,150200071,,,,4,0,4
,2011,150200089,,,,11,2,13
HND-012796,2011,150200090,,,,5,3,8
HND-012797,2011,150200091,,,,5,2,7
HND-012736,2011,150200002,,,,41,51,92
HND-012737,2011,150200003,,,,3,2,5
HND-012740,2011,150200006,,,,4,1,5
HND-012741,2011,150200007,,,,8,4,12
HND-012743,2011,150200009,,,,6,15,21
HND-012744,2011,150200010,,,,12,17,29
HND-012745,2011,150200011,,,,1,4,5
HND-012746,2011,150200012,,,,2,9,11
HND-012747,2011,150200013,,,,3,0,3
HND-012751,2011,150200017,,,,2,2,4
HND-012752,2011,150200018,,,,5,2,7
HND-012759,2011,150200025,,,,0,2,2
HND-012760,2011,150200026,,,,2,2,4
,2011,150200029,,,,1,2,3
,2011,150200030,,,,5,7,12
HND-012763,2011,150200031,,,,6,1,7
HND-012764,2011,150200032,,,,0,6,6
HND-012765,2011,150200034,,,,1,1,2
,2011,150200035,,,,3,0,3
HND-012772,2011,150200047,,,,2,8,10
HND-012775,2011,150200050,,,,2,5,7
HND-012776,2011,150200051,,,,1,3,4
HND-012777,2011,150200052,,,,3,1,4
HND-012779,2011,150200054,,,,3,2,5
HND-012782,2011,150200057,,,,6,7,13
,2011,150200058,,,,4,1,5
HND-012784,2011,150200060,,,,4,0,4
HND-012785,2011,150200062,,,,3,2,5
HND-012786,2011,150200064,,,,0,2,2
,2011,150200070,,,,5,6,11
HND-012794,2011,150200087,,,,3,1,4
,2011,150200089,,,,3,6,9
HND-012796,2011,150200090,,,,9,5,14
HND-012799,2011,150200095,,,,1,2,3
HND-012735,2011,150200001,,,,4,3,7
HND-012738,2011,150200004,,,,2,0,2
HND-012739,2011,150200005,,,,1,2,3
HND-012742,2011,150200008,,,,1,4,5
HND-012748,2011,150200014,,,,46,41,87
HND-012749,2011,150200015,,,,7,4,11
HND-012750,2011,150200016,,,,0,3,3
HND-012753,2011,150200019,,,,7,2,9
HND-012754,2011,150200020,,,,0,3,3
HND-012755,2011,150200021,,,,3,6,9
HND-012756,2011,150200022,,,,4,7,11
HND-012757,2011,150200023,,,,4,7,11
HND-012758,2011,150200024,,,,3,2,5
HND-012761,2011,150200027,,,,2,1,3
HND-012762,2011,150200028,,,,9,10,19
HND-012767,2011,150200036,,,,3,1,4
HND-012773,2011,150200048,,,,3,4,7
HND-012774,2011,150200049,,,,2,1,3
HND-012780,2011,150200055,,,,2,5,7
HND-012781,2011,150200056,,,,6,8,14
HND-012787,2011,150200065,,,,3,2,5
HND-012788,2011,150200069,,,,6,2,8
HND-012797,2011,150200091,,,,5,2,7
HND-012735,2011,150200001,,,,6,3,9
HND-012737,2011,150200003,,,,10,4,14
HND-012738,2011,150200004,,,,2,4,6
HND-012740,2011,150200006,,,,2,2,4
HND-012741,2011,150200007,,,,6,5,11
HND-012742,2011,150200008,,,,1,2,3
HND-012744,2011,150200010,,,,11,19,30
HND-012746,2011,150200012,,,,1,3,4
HND-012748,2011,150200014,,,,57,55,112
HND-012749,2011,150200015,,,,3,2,5
HND-012752,2011,150200018,,,,5,5,10
HND-012753,2011,150200019,,,,3,4,7
HND-012755,2011,150200021,,,,5,5,10
HND-012757,2011,150200023,,,,6,2,8
HND-012760,2011,150200026,,,,0,2,2
HND-012761,2011,150200027,,,,4,0,4
,2011,150200030,,,,5,11,16
HND-012764,2011,150200032,,,,6,4,10
,2011,150200035,,,,0,1,1
HND-012773,2011,150200048,,,,4,5,9
HND-012775,2011,150200050,,,,1,5,6
HND-012777,2011,150200052,,,,4,1,5
HND-012780,2011,150200055,,,,0,1,1
,2011,150200058,,,,5,1,6
HND-012785,2011,150200062,,,,1,3,4
HND-012788,2011,150200069,,,,3,4,7
HND-012794,2011,150200087,,,,4,0,4
HND-012736,2011,150200002,,,,46,35,81
HND-012739,2011,150200005,,,,0,2,2
HND-012743,2011,150200009,,,,4,8,12
HND-012745,2011,150200011,,,,2,0,2
HND-012747,2011,150200013,,,,2,4,6
HND-012750,2011,150200016,,,,2,1,3
HND-012751,2011,150200017,,,,1,1,2
HND-012754,2011,150200020,,,,4,1,5
HND-012756,2011,150200022,,,,3,5,8
HND-012758,2011,150200024,,,,2,2,4
HND-012759,2011,150200025,,,,2,1,3
HND-012762,2011,150200028,,,,11,12,23
,2011,150200029,,,,3,1,4
HND-012763,2011,150200031,,,,2,2,4
HND-012767,2011,150200036,,,,2,2,4
HND-012772,2011,150200047,,,,1,4,5
HND-012774,2011,150200049,,,,1,2,3
HND-012776,2011,150200051,,,,2,1,3
HND-012778,2011,150200053,,,,3,5,8
HND-012779,2011,150200054,,,,5,0,5
HND-012781,2011,150200056,,,,4,2,6
HND-012782,2011,150200057,,,,5,1,6
HND-012784,2011,150200060,,,,5,5,10
HND-012786,2011,150200064,,,,0,2,2
HND-012787,2011,150200065,,,,1,2,3
,2011,150200070,,,,2,6,8
HND-012789,2011,150200071,,,,2,2,4
,2011,150200089,,,,2,2,4
HND-012796,2011,150200090,,,,8,4,12
HND-012797,2011,150200091,,,,5,2,7
HND-012799,2011,150200095,,,,4,1,5
HND-012735,2011,150200001,,,,3,7,10
HND-012737,2011,150200003,,,,6,2,8
HND-012738,2011,150200004,,,,0,3,3
HND-012741,2011,150200007,,,,4,1,5
HND-012742,2011,150200008,,,,1,2,3
HND-012746,2011,150200012,,,,7,3,10
HND-012748,2011,150200014,,,,49,53,102
HND-012749,2011,150200015,,,,3,6,9
HND-012753,2011,150200019,,,,7,7,14
HND-012754,2011,150200020,,,,4,3,7
HND-012755,2011,150200021,,,,6,7,13
HND-012757,2011,150200023,,,,15,4,19
HND-012758,2011,150200024,,,,5,3,8
HND-012761,2011,150200027,,,,9,5,14
HND-012763,2011,150200031,,,,4,5,9
HND-012764,2011,150200032,,,,2,2,4
HND-012765,2011,150200034,,,,0,5,5
HND-012772,2011,150200047,,,,8,3,11
HND-012775,2011,150200050,,,,4,5,9
HND-012776,2011,150200051,,,,0,1,1
HND-012778,2011,150200053,,,,2,1,3
HND-012781,2011,150200056,,,,2,3,5
HND-012782,2011,150200057,,,,3,3,6
,2011,150200058,,,,4,4,8
HND-012788,2011,150200069,,,,2,1,3
,2011,150200070,,,,5,3,8
HND-012794,2011,150200087,,,,1,2,3
,2011,150200089,,,,0,7,7
HND-012796,2011,150200090,,,,2,1,3
HND-012799,2011,150200095,,,,1,6,7
HND-012736,2011,150200002,,,,43,49,92
HND-012739,2011,150200005,,,,5,0,5
HND-012740,2011,150200006,,,,1,3,4
HND-012743,2011,150200009,,,,4,7,11
HND-012744,2011,150200010,,,,11,23,34
HND-012745,2011,150200011,,,,1,1,2
HND-012747,2011,150200013,,,,2,1,3
HND-012750,2011,150200016,,,,2,4,6
HND-012751,2011,150200017,,,,0,3,3
HND-012752,2011,150200018,,,,3,6,9
HND-012756,2011,150200022,,,,1,3,4
HND-012759,2011,150200025,,,,1,2,3
HND-012762,2011,150200028,,,,8,7,15
,2011,150200029,,,,7,2,9
,2011,150200030,,,,9,9,18
,2011,150200035,,,,2,3,5
HND-012767,2011,150200036,,,,4,4,8
HND-012773,2011,150200048,,,,1,4,5
HND-012774,2011,150200049,,,,3,1,4
HND-012777,2011,150200052,,,,3,2,5
HND-012780,2011,150200055,,,,2,2,4
HND-012784,2011,150200060,,,,0,4,4
HND-012785,2011,150200062,,,,3,3,6
HND-012786,2011,150200064,,,,1,6,7
HND-012787,2011,150200065,,,,3,1,4
HND-012789,2011,150200071,,,,1,1,2
HND-012797,2011,150200091,,,,2,1,3
HND-012738,2011,150200004,,,,0,4,4
HND-012739,2011,150200005,,,,2,3,5
HND-012742,2011,150200008,,,,2,0,2
HND-012743,2011,150200009,,,,2,11,13
HND-012747,2011,150200013,,,,4,4,8
HND-012750,2011,150200016,,,,9,2,11
HND-012751,2011,150200017,,,,1,2,3
HND-012753,2011,150200019,,,,3,2,5
HND-012754,2011,150200020,,,,1,1,2
HND-012755,2011,150200021,,,,9,10,19
HND-012756,2011,150200022,,,,1,4,5
HND-012758,2011,150200024,,,,2,2,4
HND-012759,2011,150200025,,,,2,2,4
HND-012762,2011,150200028,,,,7,7,14
,2011,150200030,,,,6,4,10
HND-012764,2011,150200032,,,,5,5,10
,2011,150200035,,,,0,3,3
HND-012772,2011,150200047,,,,5,0,5
HND-012773,2011,150200048,,,,2,2,4
HND-012775,2011,150200050,,,,2,4,6
HND-012777,2011,150200052,,,,3,2,5
HND-012779,2011,150200054,,,,4,4,8
HND-012780,2011,150200055,,,,2,2,4
,2011,150200058,,,,2,1,3
HND-012787,2011,150200065,,,,0,1,1
HND-012788,2011,150200069,,,,1,2,3
HND-012794,2011,150200087,,,,2,2,4
HND-012799,2011,150200095,,,,1,1,2
HND-012735,2011,150200001,,,,3,3,6
HND-012736,2011,150200002,,,,55,52,107
HND-012737,2011,150200003,,,,5,2,7
HND-012740,2011,150200006,,,,7,4,11
HND-012741,2011,150200007,,,,7,5,12
HND-012744,2011,150200010,,,,11,18,29
HND-012746,2011,150200012,,,,5,9,14
HND-012748,2011,150200014,,,,52,57,109
HND-012749,2011,150200015,,,,3,4,7
HND-012752,2011,150200018,,,,4,3,7
HND-012757,2011,150200023,,,,6,6,12
HND-012760,2011,150200026,,,,3,1,4
HND-012761,2011,150200027,,,,9,5,14
,2011,150200029,,,,0,2,2
HND-012763,2011,150200031,,,,0,4,4
HND-012774,2011,150200049,,,,5,2,7
HND-012776,2011,150200051,,,,3,2,5
HND-012778,2011,150200053,,,,3,1,4
HND-012781,2011,150200056,,,,7,1,8
HND-012782,2011,150200057,,,,2,6,8
HND-012784,2011,150200060,,,,4,1,5
HND-012785,2011,150200062,,,,2,1,3
HND-012786,2011,150200064,,,,2,0,2
,2011,150200070,,,,4,2,6
HND-012789,2011,150200071,,,,0,1,1
,2011,150200089,,,,1,1,2
HND-012796,2011,150200090,,,,4,2,6
HND-012797,2011,150200091,,,,3,0,3
HND-012748,2011,150200014,,,,12,14,26
HND-012753,2011,150200019,,,,9,12,21
HND-012783,2011,150200059,,,,129,156,285
,2011,150200072,,,,62,64,126
HND-012740,2011,150200006,,,,7,8,15
HND-012756,2011,150200022,,,,6,8,14
HND-012740,2011,150200006,,,,4,3,7
HND-012748,2011,150200014,,,,8,5,13
HND-012753,2011,150200019,,,,8,4,12
HND-012756,2011,150200022,,,,11,3,14
HND-012783,2011,150200059,,,,87,127,214
,2011,150200072,,,,49,49,98
HND-012740,2011,150200006,,,,7,2,9
HND-012748,2011,150200014,,,,8,10,18
HND-012753,2011,150200019,,,,5,6,11
HND-012783,2011,150200059,,,,64,95,159
HND-012756,2011,150200022,,,,5,4,9
,2011,150200072,,,,35,43,78
,2011,150200072,,,,111,111,222
HND-012783,2011,150200059,,,,86,101,187
,2011,150200072,,,,59,55,114
HND-012783,2011,150200059,,,,59,119,178
HND-012783,2011,150200059,,,,26,56,82
,2011,150300004,,,,6,4,10
HND-012808,2011,150300005,,,,6,4,10
HND-012892,2011,150300097,,,,6,9,15
HND-012911,2011,150300118,,,,4,5,9
,2011,150300175,,,,8,2,10
,2011,150300177,,,,8,6,14
HND-013023,2011,150300290,,,,8,5,13
,2011,150300294,,,,4,6,10
,2011,150300295,,,,6,5,11
HND-013025,2011,150300296,,,,4,12,16
,2011,150300298,,,,6,6,12
HND-013027,2011,150300300,,,,6,7,13
HND-013028,2011,150300301,,,,17,8,25
,2011,150300304,,,,8,6,14
HND-013029,2011,150300306,,,,9,12,21
HND-013030,2011,150300307,,,,6,8,14
HND-013033,2011,150300312,,,,6,5,11
HND-013045,2011,150300394,,,,12,8,20
,2011,150300395,,,,6,4,10
HND-013047,2011,150300402,,,,8,8,16
HND-013049,2011,150300411,,,,9,9,18
HND-013052,2011,150300419,,,,3,8,11
HND-013053,2011,150300424,,,,6,4,10
,2011,150300426,,,,3,6,9
HND-013054,2011,150300429,,,,7,4,11
HND-013056,2011,150300432,,,,9,12,21
HND-013058,2011,150300436,,,,7,4,11
,2011,150300442,,,,6,4,10
,2011,150300456,,,,8,7,15
HND-012914,2011,150300122,,,,3,9,12
HND-012963,2011,150300196,,,,5,7,12
HND-013024,2011,150300291,,,,5,6,11
HND-013026,2011,150300297,,,,9,5,14
,2011,150300299,,,,12,6,18
,2011,150300302,,,,5,7,12
,2011,150300308,,,,6,4,10
HND-013031,2011,150300310,,,,8,11,19
HND-013032,2011,150300311,,,,7,5,12
,2011,150300314,,,,5,11,16
,2011,150300319,,,,7,3,10
,2011,150300320,,,,7,7,14
,2011,150300393,,,,4,10,14
,2011,150300396,,,,6,4,10
HND-013046,2011,150300398,,,,8,4,12
,2011,150300399,,,,6,4,10
,2011,150300404,,,,11,6,17
,2011,150300408,,,,5,6,11
HND-013048,2011,150300409,,,,4,6,10
,2011,150300410,,,,4,6,10
,2011,150300417,,,,5,6,11
HND-013051,2011,150300418,,,,9,9,18
,2011,150300421,,,,5,6,11
,2011,150300425,,,,5,5,10
,2011,150300427,,,,7,5,12
,2011,150300430,,,,6,6,12
,2011,150300438,,,,7,6,13
HND-013059,2011,150300440,,,,5,5,10
,2011,150300444,,,,6,7,13
,2011,150300446,,,,6,7,13
,2011,150300453,,,,9,9,18
HND-013064,2011,150300454,,,,7,8,15
HND-013065,2011,150300455,,,,9,8,17
HND-013007,2011,150300261,,,,21,10,31
,2011,150300414,,,,6,6,12
HND-012937,2011,150300152,,,,3,1,4
HND-012942,2011,150300157,,,,7,11,18
HND-012946,2011,150300162,,,,1,0,1
,2011,150300262,,,,1,2,3
HND-013061,2011,150300450,,,,0,1,1
,2011,150300112,,,,1,4,5
,2011,150300114,,,,0,2,2
,2011,150300145,,,,16,8,24
HND-012934,2011,150300147,,,,11,13,24
HND-012940,2011,150300155,,,,9,4,13
HND-012942,2011,150300157,,,,15,19,34
HND-012945,2011,150300160,,,,2,3,5
HND-012947,2011,150300163,,,,4,4,8
HND-012948,2011,150300164,,,,1,1,2
,2011,150300165,,,,3,3,6
,2011,150300166,,,,2,2,4
HND-012952,2011,150300180,,,,5,2,7
HND-012953,2011,150300182,,,,1,5,6
HND-013002,2011,150300255,,,,6,4,10
HND-013003,2011,150300256,,,,3,4,7
HND-013007,2011,150300261,,,,11,19,30
,2011,150300414,,,,9,7,16
HND-012809,2011,150300006,,,,3,6,9
,2011,150300142,,,,8,3,11
HND-012933,2011,150300146,,,,7,7,14
HND-012935,2011,150300148,,,,15,13,28
,2011,150300150,,,,20,23,43
HND-012936,2011,150300151,,,,8,8,16
HND-012937,2011,150300152,,,,8,10,18
HND-012938,2011,150300153,,,,2,5,7
HND-012939,2011,150300154,,,,1,2,3
HND-012941,2011,150300156,,,,1,2,3
HND-012943,2011,150300158,,,,1,1,2
HND-012946,2011,150300162,,,,4,3,7
HND-012951,2011,150300179,,,,4,0,4
,2011,150300181,,,,2,0,2
HND-012954,2011,150300183,,,,1,3,4
HND-012955,2011,150300184,,,,6,2,8
HND-013004,2011,150300257,,,,19,16,35
,2011,150300262,,,,2,1,3
,2011,150300268,,,,2,7,9
HND-013050,2011,150300412,,,,3,4,7
,2011,150300415,,,,3,2,5
,2011,150300448,,,,4,1,5
HND-013061,2011,150300450,,,,6,5,11
HND-013063,2011,150300452,,,,12,5,17
HND-012809,2011,150300006,,,,9,4,13
,2011,150300145,,,,11,7,18
HND-012933,2011,150300146,,,,24,20,44
HND-012934,2011,150300147,,,,37,31,68
HND-012935,2011,150300148,,,,38,30,68
,2011,150300150,,,,32,44,76
HND-012937,2011,150300152,,,,12,11,23
HND-012938,2011,150300153,,,,8,2,10
HND-012939,2011,150300154,,,,19,10,29
HND-012941,2011,150300156,,,,10,12,22
HND-012943,2011,150300158,,,,15,7,22
,2011,150300161,,,,8,10,18
HND-012946,2011,150300162,,,,9,4,13
HND-012951,2011,150300179,,,,9,13,22
,2011,150300181,,,,4,6,10
HND-012953,2011,150300182,,,,15,16,31
HND-012954,2011,150300183,,,,7,13,20
HND-012955,2011,150300184,,,,3,6,9
HND-013004,2011,150300257,,,,30,24,54
,2011,150300268,,,,10,2,12
HND-013050,2011,150300412,,,,2,7,9
,2011,150300415,,,,8,7,15
,2011,150300448,,,,2,9,11
HND-013061,2011,150300450,,,,9,12,21
,2011,150300112,,,,14,6,20
,2011,150300114,,,,3,9,12
,2011,150300142,,,,5,8,13
HND-012936,2011,150300151,,,,16,23,39
HND-012940,2011,150300155,,,,4,3,7
HND-012942,2011,150300157,,,,29,22,51
HND-012945,2011,150300160,,,,11,14,25
HND-012947,2011,150300163,,,,6,9,15
HND-012948,2011,150300164,,,,4,6,10
,2011,150300165,,,,8,5,13
,2011,150300166,,,,7,4,11
HND-012952,2011,150300180,,,,6,8,14
HND-012956,2011,150300185,,,,17,17,34
HND-013002,2011,150300255,,,,9,10,19
HND-013003,2011,150300256,,,,7,6,13
HND-013007,2011,150300261,,,,23,15,38
,2011,150300262,,,,2,2,4
,2011,150300414,,,,4,7,11
HND-013063,2011,150300452,,,,7,5,12
HND-012805,2011,150300001,,,,5,6,11
HND-012806,2011,150300002,,,,2,5,7
HND-012807,2011,150300003,,,,4,3,7
,2011,150300004,,,,5,8,13
HND-012810,2011,150300007,,,,56,48,104
HND-012815,2011,150300013,,,,9,4,13
HND-012818,2011,150300016,,,,6,4,10
HND-012819,2011,150300017,,,,1,6,7
HND-012821,2011,150300019,,,,5,4,9
HND-012822,2011,150300020,,,,5,8,13
,2011,150300021,,,,11,6,17
HND-012823,2011,150300022,,,,12,14,26
HND-012825,2011,150300024,,,,1,1,2
HND-012827,2011,150300026,,,,3,2,5
HND-012828,2011,150300027,,,,26,39,65
,2011,150300028,,,,0,2,2
HND-012830,2011,150300031,,,,14,11,25
HND-012834,2011,150300035,,,,11,5,16
HND-012836,2011,150300039,,,,0,5,5
HND-012837,2011,150300040,,,,12,9,21
HND-012838,2011,150300041,,,,11,6,17
HND-012839,2011,150300042,,,,5,0,5
HND-012841,2011,150300044,,,,17,13,30
HND-012845,2011,150300048,,,,5,5,10
HND-012850,2011,150300053,,,,2,2,4
HND-012853,2011,150300056,,,,10,6,16
HND-012854,2011,150300057,,,,5,4,9
HND-012856,2011,150300059,,,,1,3,4
HND-012860,2011,150300063,,,,1,0,1
HND-012863,2011,150300066,,,,4,4,8
,2011,150300068,,,,49,41,90
HND-012871,2011,150300075,,,,9,10,19
HND-012872,2011,150300076,,,,4,0,4
HND-012874,2011,150300079,,,,5,5,10
HND-012875,2011,150300080,,,,2,3,5
HND-012876,2011,150300081,,,,2,2,4
HND-012878,2011,150300083,,,,3,3,6
HND-012879,2011,150300084,,,,5,3,8
HND-012880,2011,150300085,,,,20,13,33
HND-012881,2011,150300086,,,,6,7,13
HND-012882,2011,150300087,,,,5,2,7
HND-012888,2011,150300093,,,,2,5,7
HND-012890,2011,150300095,,,,2,1,3
HND-012891,2011,150300096,,,,4,4,8
HND-012895,2011,150300100,,,,5,6,11
HND-012898,2011,150300103,,,,1,2,3
HND-012899,2011,150300104,,,,2,1,3
HND-012901,2011,150300106,,,,2,2,4
HND-012902,2011,150300107,,,,1,4,5
HND-012903,2011,150300108,,,,0,1,1
HND-012905,2011,150300110,,,,5,1,6
,2011,150300112,,,,6,3,9
HND-012907,2011,150300113,,,,6,4,10
,2011,150300114,,,,7,6,13
HND-012909,2011,150300116,,,,11,6,17
HND-012910,2011,150300117,,,,1,2,3
HND-012911,2011,150300118,,,,1,3,4
HND-012913,2011,150300120,,,,4,5,9
HND-012915,2011,150300123,,,,1,0,1
HND-012917,2011,150300125,,,,7,6,13
HND-012918,2011,150300126,,,,1,6,7
HND-012919,2011,150300128,,,,28,16,44
HND-012922,2011,150300131,,,,3,0,3
HND-012923,2011,150300132,,,,3,1,4
HND-012926,2011,150300135,,,,13,9,22
HND-012928,2011,150300137,,,,10,9,19
,2011,150300138,,,,17,16,33
HND-012929,2011,150300139,,,,4,9,13
HND-012931,2011,150300141,,,,5,5,10
HND-012944,2011,150300159,,,,10,14,24
,2011,150300166,,,,13,8,21
HND-012958,2011,150300187,,,,6,1,7
HND-012959,2011,150300188,,,,4,3,7
HND-012960,2011,150300189,,,,1,1,2
HND-012962,2011,150300191,,,,0,1,1
,2011,150300192,,,,3,3,6
HND-012966,2011,150300199,,,,1,2,3
HND-012967,2011,150300201,,,,3,9,12
HND-012968,2011,150300202,,,,1,1,2
HND-012970,2011,150300204,,,,1,2,3
HND-012971,2011,150300205,,,,6,3,9
HND-012975,2011,150300212,,,,3,6,9
HND-012979,2011,150300225,,,,2,2,4
HND-012980,2011,150300226,,,,1,4,5
HND-012984,2011,150300231,,,,7,4,11
HND-012987,2011,150300236,,,,6,4,10
HND-012988,2011,150300237,,,,10,1,11
HND-012990,2011,150300239,,,,4,7,11
HND-012991,2011,150300240,,,,3,3,6
HND-012992,2011,150300241,,,,2,2,4
HND-012993,2011,150300242,,,,5,8,13
HND-012994,2011,150300243,,,,3,3,6
,2011,150300247,,,,3,1,4
HND-012998,2011,150300248,,,,5,5,10
HND-012999,2011,150300249,,,,2,0,2
HND-013001,2011,150300253,,,,15,6,21
HND-013006,2011,150300260,,,,6,2,8
HND-013008,2011,150300263,,,,5,2,7
HND-013009,2011,150300264,,,,5,2,7
HND-013015,2011,150300273,,,,2,5,7
,2011,150300276,,,,4,2,6
HND-013017,2011,150300277,,,,2,4,6
HND-013018,2011,150300281,,,,0,2,2
,2011,150300282,,,,6,2,8
HND-013019,2011,150300283,,,,5,2,7
HND-013020,2011,150300285,,,,1,1,2
HND-013022,2011,150300287,,,,0,1,1
HND-013034,2011,150300372,,,,3,5,8
HND-013035,2011,150300373,,,,8,3,11
HND-013037,2011,150300377,,,,0,3,3
HND-013038,2011,150300380,,,,2,1,3
HND-013039,2011,150300384,,,,3,2,5
HND-013040,2011,150300386,,,,3,2,5
,2011,150300387,,,,2,1,3
HND-013042,2011,150300389,,,,6,3,9
HND-013055,2011,150300431,,,,1,1,2
HND-013061,2011,150300450,,,,9,8,17
HND-013062,2011,150300451,,,,5,5,10
HND-012808,2011,150300005,,,,5,7,12
,2011,150300008,,,,15,10,25
HND-012811,2011,150300009,,,,12,7,19
HND-012812,2011,150300010,,,,2,10,12
HND-012813,2011,150300011,,,,3,6,9
HND-012814,2011,150300012,,,,15,9,24
HND-012816,2011,150300014,,,,5,4,9
HND-012817,2011,150300015,,,,36,17,53
HND-012820,2011,150300018,,,,3,8,11
HND-012824,2011,150300023,,,,10,4,14
HND-012826,2011,150300025,,,,17,15,32
HND-012829,2011,150300030,,,,5,2,7
HND-012831,2011,150300032,,,,2,7,9
HND-012832,2011,150300033,,,,5,3,8
HND-012833,2011,150300034,,,,9,16,25
HND-012835,2011,150300037,,,,13,4,17
,2011,150300038,,,,4,6,10
HND-012840,2011,150300043,,,,8,10,18
HND-012842,2011,150300045,,,,20,13,33
HND-012843,2011,150300046,,,,0,6,6
HND-012844,2011,150300047,,,,4,1,5
HND-012846,2011,150300049,,,,7,3,10
HND-012847,2011,150300050,,,,5,3,8
HND-012848,2011,150300051,,,,5,4,9
HND-012849,2011,150300052,,,,12,8,20
HND-012851,2011,150300054,,,,1,2,3
HND-012852,2011,150300055,,,,4,4,8
HND-012855,2011,150300058,,,,8,8,16
HND-012857,2011,150300060,,,,1,2,3
HND-012858,2011,150300061,,,,2,1,3
HND-012859,2011,150300062,,,,2,2,4
HND-012861,2011,150300064,,,,7,5,12
HND-012862,2011,150300065,,,,6,2,8
HND-012864,2011,150300067,,,,53,39,92
HND-012866,2011,150300070,,,,6,7,13
HND-012867,2011,150300071,,,,11,0,11
HND-012868,2011,150300072,,,,2,2,4
HND-012869,2011,150300073,,,,2,3,5
HND-012870,2011,150300074,,,,3,0,3
,2011,150300077,,,,41,39,80
HND-012873,2011,150300078,,,,5,3,8
HND-012877,2011,150300082,,,,1,0,1
HND-012883,2011,150300088,,,,5,1,6
HND-012884,2011,150300089,,,,5,4,9
HND-012885,2011,150300090,,,,2,5,7
HND-012886,2011,150300091,,,,1,2,3
HND-012889,2011,150300094,,,,6,2,8
HND-012892,2011,150300097,,,,5,6,11
HND-012893,2011,150300098,,,,7,6,13
HND-012894,2011,150300099,,,,43,42,85
HND-012896,2011,150300101,,,,6,3,9
HND-012900,2011,150300105,,,,1,2,3
HND-012904,2011,150300109,,,,5,7,12
HND-012906,2011,150300111,,,,5,5,10
HND-012908,2011,150300115,,,,5,2,7
HND-012912,2011,150300119,,,,0,3,3
HND-012914,2011,150300122,,,,4,6,10
HND-012916,2011,150300124,,,,31,35,66
HND-012920,2011,150300129,,,,8,7,15
HND-012924,2011,150300133,,,,5,2,7
HND-012925,2011,150300134,,,,55,43,98
HND-012927,2011,150300136,,,,8,7,15
HND-012930,2011,150300140,,,,3,5,8
,2011,150300142,,,,4,8,12
HND-012932,2011,150300143,,,,2,1,3
,2011,150300181,,,,3,8,11
HND-012957,2011,150300186,,,,5,6,11
HND-012961,2011,150300190,,,,1,3,4
HND-012964,2011,150300197,,,,7,12,19
HND-012965,2011,150300198,,,,1,0,1
HND-012969,2011,150300203,,,,2,4,6
HND-012972,2011,150300206,,,,6,2,8
HND-012974,2011,150300209,,,,1,4,5
HND-012976,2011,150300216,,,,4,4,8
,2011,150300220,,,,12,6,18
HND-012977,2011,150300221,,,,1,2,3
,2011,150300222,,,,2,2,4
,2011,150300223,,,,9,9,18
,2011,150300224,,,,3,7,10
HND-012981,2011,150300228,,,,4,5,9
HND-012982,2011,150300229,,,,4,7,11
HND-012983,2011,150300230,,,,1,1,2
HND-012985,2011,150300234,,,,16,17,33
HND-012986,2011,150300235,,,,1,4,5
HND-012989,2011,150300238,,,,8,12,20
HND-012995,2011,150300245,,,,0,2,2
HND-012996,2011,150300246,,,,7,4,11
,2011,150300250,,,,3,1,4
HND-013000,2011,150300251,,,,1,1,2
,2011,150300258,,,,2,2,4
HND-013005,2011,150300259,,,,5,8,13
HND-013010,2011,150300265,,,,8,1,9
,2011,150300268,,,,6,15,21
HND-013013,2011,150300270,,,,5,7,12
,2011,150300271,,,,2,1,3
HND-013014,2011,150300272,,,,9,7,16
,2011,150300274,,,,3,5,8
HND-013016,2011,150300275,,,,1,2,3
HND-013021,2011,150300286,,,,5,4,9
,2011,150300374,,,,12,7,19
HND-013036,2011,150300375,,,,2,3,5
,2011,150300379,,,,1,1,2
HND-013041,2011,150300388,,,,5,4,9
HND-013043,2011,150300390,,,,1,2,3
HND-013044,2011,150300391,,,,2,6,8
,2011,150300415,,,,2,2,4
HND-013056,2011,150300432,,,,6,4,10
HND-013060,2011,150300449,,,,8,6,14
HND-012805,2011,150300001,,,,7,2,9
HND-012807,2011,150300003,,,,1,5,6
HND-012811,2011,150300009,,,,8,8,16
HND-012814,2011,150300012,,,,7,10,17
HND-012817,2011,150300015,,,,19,26,45
HND-012821,2011,150300019,,,,6,8,14
,2011,150300021,,,,3,10,13
HND-012824,2011,150300023,,,,7,8,15
HND-012832,2011,150300033,,,,5,7,12
HND-012835,2011,150300037,,,,10,8,18
HND-012836,2011,150300039,,,,2,0,2
HND-012837,2011,150300040,,,,12,10,22
HND-012839,2011,150300042,,,,3,1,4
HND-012841,2011,150300044,,,,8,18,26
HND-012842,2011,150300045,,,,22,13,35
HND-012845,2011,150300048,,,,6,10,16
HND-012846,2011,150300049,,,,2,6,8
HND-012848,2011,150300051,,,,6,7,13
HND-012850,2011,150300053,,,,8,1,9
HND-012851,2011,150300054,,,,3,2,5
HND-012853,2011,150300056,,,,13,4,17
HND-012854,2011,150300057,,,,1,1,2
HND-012857,2011,150300060,,,,0,1,1
HND-012859,2011,150300062,,,,2,5,7
HND-012862,2011,150300065,,,,8,5,13
HND-012864,2011,150300067,,,,47,49,96
,2011,150300068,,,,57,38,95
HND-012867,2011,150300071,,,,6,3,9
HND-012869,2011,150300073,,,,2,2,4
HND-012872,2011,150300076,,,,2,4,6
HND-012874,2011,150300079,,,,5,5,10
HND-012875,2011,150300080,,,,1,3,4
HND-012876,2011,150300081,,,,6,2,8
HND-012879,2011,150300084,,,,3,4,7
HND-012882,2011,150300087,,,,2,2,4
HND-012886,2011,150300091,,,,3,2,5
HND-012888,2011,150300093,,,,0,1,1
HND-012891,2011,150300096,,,,4,0,4
HND-012892,2011,150300097,,,,10,9,19
HND-012894,2011,150300099,,,,27,26,53
HND-012896,2011,150300101,,,,1,4,5
HND-012901,2011,150300106,,,,2,3,5
HND-012906,2011,150300111,,,,6,6,12
HND-012909,2011,150300116,,,,1,6,7
HND-012913,2011,150300120,,,,6,1,7
HND-012914,2011,150300122,,,,1,5,6
HND-012915,2011,150300123,,,,2,4,6
HND-012918,2011,150300126,,,,10,4,14
HND-012922,2011,150300131,,,,3,6,9
HND-012927,2011,150300136,,,,12,11,23
HND-012928,2011,150300137,,,,8,5,13
,2011,150300138,,,,25,13,38
HND-012929,2011,150300139,,,,2,2,4
HND-012931,2011,150300141,,,,5,4,9
HND-012944,2011,150300159,,,,6,10,16
,2011,150300181,,,,6,1,7
HND-012957,2011,150300186,,,,9,2,11
HND-012958,2011,150300187,,,,1,4,5
HND-012959,2011,150300188,,,,5,2,7
HND-012961,2011,150300190,,,,3,2,5
HND-012964,2011,150300197,,,,7,7,14
HND-012965,2011,150300198,,,,2,0,2
HND-012968,2011,150300202,,,,1,1,2
HND-012971,2011,150300205,,,,6,5,11
HND-012975,2011,150300212,,,,11,8,19
HND-012976,2011,150300216,,,,4,2,6
HND-012977,2011,150300221,,,,1,1,2
,2011,150300223,,,,4,2,6
HND-012980,2011,150300226,,,,1,2,3
HND-012982,2011,150300229,,,,2,2,4
HND-012985,2011,150300234,,,,25,25,50
HND-012986,2011,150300235,,,,2,1,3
HND-012987,2011,150300236,,,,1,7,8
HND-012990,2011,150300239,,,,7,8,15
HND-012992,2011,150300241,,,,2,2,4
HND-012994,2011,150300243,,,,6,3,9
HND-012996,2011,150300246,,,,2,2,4
,2011,150300247,,,,5,0,5
HND-012999,2011,150300249,,,,1,1,2
,2011,150300250,,,,3,4,7
HND-013000,2011,150300251,,,,5,1,6
HND-013001,2011,150300253,,,,9,7,16
,2011,150300258,,,,1,1,2
HND-013006,2011,150300260,,,,3,5,8
HND-013009,2011,150300264,,,,1,2,3
HND-013010,2011,150300265,,,,1,2,3
,2011,150300268,,,,9,6,15
HND-013013,2011,150300270,,,,3,6,9
HND-013016,2011,150300275,,,,2,1,3
HND-013018,2011,150300281,,,,6,6,12
HND-013019,2011,150300283,,,,2,2,4
HND-013020,2011,150300285,,,,2,1,3
HND-013021,2011,150300286,,,,5,1,6
HND-013022,2011,150300287,,,,1,1,2
HND-013034,2011,150300372,,,,3,2,5
,2011,150300374,,,,5,12,17
HND-013036,2011,150300375,,,,3,1,4
HND-013041,2011,150300388,,,,3,2,5
HND-013055,2011,150300431,,,,2,1,3
HND-013057,2011,150300433,,,,2,2,4
HND-012806,2011,150300002,,,,7,5,12
,2011,150300004,,,,3,1,4
HND-012808,2011,150300005,,,,11,9,20
HND-012810,2011,150300007,,,,63,49,112
,2011,150300008,,,,10,12,22
HND-012812,2011,150300010,,,,19,10,29
HND-012813,2011,150300011,,,,9,5,14
HND-012815,2011,150300013,,,,4,3,7
HND-012818,2011,150300016,,,,6,2,8
HND-012819,2011,150300017,,,,6,4,10
HND-012820,2011,150300018,,,,4,5,9
HND-012822,2011,150300020,,,,16,9,25
HND-012823,2011,150300022,,,,15,8,23
HND-012825,2011,150300024,,,,5,3,8
HND-012826,2011,150300025,,,,8,13,21
HND-012827,2011,150300026,,,,8,3,11
HND-012828,2011,150300027,,,,34,37,71
,2011,150300028,,,,1,0,1
HND-012829,2011,150300030,,,,1,5,6
HND-012830,2011,150300031,,,,13,10,23
HND-012831,2011,150300032,,,,1,5,6
HND-012833,2011,150300034,,,,14,7,21
HND-012834,2011,150300035,,,,5,5,10
,2011,150300038,,,,4,4,8
HND-012838,2011,150300041,,,,3,10,13
HND-012840,2011,150300043,,,,17,5,22
HND-012843,2011,150300046,,,,5,4,9
HND-012844,2011,150300047,,,,4,1,5
HND-012847,2011,150300050,,,,5,2,7
HND-012849,2011,150300052,,,,7,3,10
HND-012852,2011,150300055,,,,5,2,7
HND-012855,2011,150300058,,,,5,5,10
HND-012856,2011,150300059,,,,1,1,2
HND-012858,2011,150300061,,,,2,1,3
HND-012860,2011,150300063,,,,5,1,6
HND-012861,2011,150300064,,,,2,5,7
HND-012863,2011,150300066,,,,5,3,8
HND-012866,2011,150300070,,,,10,7,17
HND-012868,2011,150300072,,,,1,0,1
HND-012870,2011,150300074,,,,5,2,7
HND-012871,2011,150300075,,,,13,3,16
,2011,150300077,,,,40,35,75
HND-012873,2011,150300078,,,,9,5,14
HND-012878,2011,150300083,,,,0,2,2
HND-012880,2011,150300085,,,,15,25,40
HND-012881,2011,150300086,,,,5,2,7
HND-012884,2011,150300089,,,,6,3,9
HND-012885,2011,150300090,,,,4,1,5
HND-012889,2011,150300094,,,,4,1,5
HND-012890,2011,150300095,,,,6,6,12
HND-012893,2011,150300098,,,,5,1,6
HND-012895,2011,150300100,,,,2,4,6
HND-012898,2011,150300103,,,,2,1,3
HND-012899,2011,150300104,,,,2,2,4
HND-012900,2011,150300105,,,,0,1,1
HND-012902,2011,150300107,,,,0,1,1
HND-012903,2011,150300108,,,,0,3,3
,2011,150300112,,,,5,7,12
HND-012907,2011,150300113,,,,8,6,14
,2011,150300114,,,,8,6,14
HND-012908,2011,150300115,,,,1,5,6
HND-012910,2011,150300117,,,,4,4,8
HND-012911,2011,150300118,,,,3,1,4
HND-012912,2011,150300119,,,,4,0,4
,2011,150300121,,,,2,3,5
HND-012916,2011,150300124,,,,35,33,68
HND-012917,2011,150300125,,,,5,8,13
HND-012919,2011,150300128,,,,16,9,25
HND-012920,2011,150300129,,,,3,0,3
HND-012923,2011,150300132,,,,2,8,10
HND-012924,2011,150300133,,,,3,3,6
HND-012925,2011,150300134,,,,60,59,119
HND-012926,2011,150300135,,,,10,7,17
HND-012930,2011,150300140,,,,3,0,3
,2011,150300142,,,,8,2,10
HND-012932,2011,150300143,,,,2,3,5
,2011,150300166,,,,7,5,12
HND-012960,2011,150300189,,,,1,1,2
HND-012962,2011,150300191,,,,2,2,4
,2011,150300192,,,,3,1,4
HND-012966,2011,150300199,,,,1,3,4
HND-012967,2011,150300201,,,,6,2,8
HND-012969,2011,150300203,,,,3,2,5
HND-012970,2011,150300204,,,,6,1,7
HND-012972,2011,150300206,,,,6,4,10
HND-012973,2011,150300207,,,,3,4,7
HND-012974,2011,150300209,,,,1,6,7
,2011,150300220,,,,5,6,11
,2011,150300222,,,,3,2,5
,2011,150300224,,,,5,6,11
HND-012979,2011,150300225,,,,2,2,4
HND-012981,2011,150300228,,,,11,1,12
HND-012983,2011,150300230,,,,6,3,9
HND-012984,2011,150300231,,,,3,3,6
HND-012988,2011,150300237,,,,0,4,4
HND-012989,2011,150300238,,,,12,6,18
HND-012991,2011,150300240,,,,1,2,3
HND-012993,2011,150300242,,,,1,3,4
HND-012995,2011,150300245,,,,4,2,6
HND-012998,2011,150300248,,,,7,5,12
HND-013005,2011,150300259,,,,9,5,14
HND-013008,2011,150300263,,,,4,5,9
,2011,150300271,,,,0,4,4
HND-013015,2011,150300273,,,,1,1,2
,2011,150300274,,,,0,3,3
,2011,150300276,,,,3,2,5
HND-013017,2011,150300277,,,,0,2,2
,2011,150300282,,,,1,0,1
HND-013035,2011,150300373,,,,8,5,13
HND-013038,2011,150300380,,,,1,3,4
HND-013039,2011,150300384,,,,2,1,3
HND-013040,2011,150300386,,,,1,4,5
,2011,150300387,,,,0,3,3
HND-013043,2011,150300390,,,,0,1,1
HND-013044,2011,150300391,,,,4,8,12
,2011,150300415,,,,1,6,7
HND-013056,2011,150300432,,,,7,5,12
HND-013060,2011,150300449,,,,0,4,4
HND-013061,2011,150300450,,,,3,9,12
HND-013062,2011,150300451,,,,1,1,2
HND-012808,2011,150300005,,,,8,3,11
,2011,150300008,,,,20,13,33
HND-012811,2011,150300009,,,,14,5,19
HND-012812,2011,150300010,,,,11,8,19
HND-012814,2011,150300012,,,,7,8,15
HND-012816,2011,150300014,,,,2,1,3
HND-012817,2011,150300015,,,,35,22,57
HND-012820,2011,150300018,,,,4,3,7
HND-012824,2011,150300023,,,,14,11,25
HND-012826,2011,150300025,,,,12,9,21
HND-012829,2011,150300030,,,,2,2,4
HND-012831,2011,150300032,,,,2,2,4
HND-012833,2011,150300034,,,,16,15,31
HND-012835,2011,150300037,,,,7,7,14
,2011,150300038,,,,3,2,5
HND-012840,2011,150300043,,,,10,10,20
HND-012843,2011,150300046,,,,6,7,13
HND-012844,2011,150300047,,,,3,4,7
HND-012846,2011,150300049,,,,8,8,16
HND-012847,2011,150300050,,,,2,2,4
HND-012848,2011,150300051,,,,3,4,7
HND-012849,2011,150300052,,,,8,5,13
HND-012851,2011,150300054,,,,0,1,1
HND-012852,2011,150300055,,,,11,7,18
HND-012855,2011,150300058,,,,1,2,3
HND-012857,2011,150300060,,,,2,0,2
HND-012858,2011,150300061,,,,5,2,7
HND-012859,2011,150300062,,,,2,2,4
HND-012861,2011,150300064,,,,4,4,8
HND-012862,2011,150300065,,,,9,6,15
HND-012864,2011,150300067,,,,57,62,119
HND-012866,2011,150300070,,,,5,7,12
HND-012867,2011,150300071,,,,5,4,9
HND-012868,2011,150300072,,,,0,3,3
HND-012869,2011,150300073,,,,3,3,6
HND-012870,2011,150300074,,,,6,4,10
,2011,150300077,,,,37,38,75
HND-012873,2011,150300078,,,,5,10,15
HND-012877,2011,150300082,,,,2,1,3
HND-012884,2011,150300089,,,,6,3,9
HND-012885,2011,150300090,,,,5,4,9
HND-012886,2011,150300091,,,,5,1,6
HND-012889,2011,150300094,,,,4,5,9
HND-012890,2011,150300095,,,,2,1,3
HND-012893,2011,150300098,,,,2,4,6
HND-012894,2011,150300099,,,,44,30,74
HND-012896,2011,150300101,,,,4,0,4
HND-012904,2011,150300109,,,,5,5,10
HND-012906,2011,150300111,,,,12,4,16
HND-012912,2011,150300119,,,,2,0,2
,2011,150300121,,,,6,1,7
HND-012914,2011,150300122,,,,6,6,12
HND-012920,2011,150300129,,,,6,7,13
HND-012921,2011,150300130,,,,1,2,3
HND-012924,2011,150300133,,,,5,10,15
HND-012925,2011,150300134,,,,77,63,140
HND-012927,2011,150300136,,,,12,9,21
,2011,150300138,,,,14,16,30
HND-012929,2011,150300139,,,,5,1,6
,2011,150300142,,,,5,6,11
HND-012932,2011,150300143,,,,2,5,7
,2011,150300181,,,,3,2,5
HND-012957,2011,150300186,,,,5,2,7
HND-012961,2011,150300190,,,,1,0,1
HND-012964,2011,150300197,,,,4,2,6
HND-012965,2011,150300198,,,,2,1,3
HND-012969,2011,150300203,,,,6,2,8
HND-012972,2011,150300206,,,,4,5,9
HND-012973,2011,150300207,,,,5,2,7
HND-012976,2011,150300216,,,,7,2,9
,2011,150300220,,,,5,3,8
HND-012977,2011,150300221,,,,1,4,5
,2011,150300222,,,,0,1,1
,2011,150300224,,,,4,4,8
HND-012981,2011,150300228,,,,2,4,6
HND-012982,2011,150300229,,,,7,5,12
HND-012985,2011,150300234,,,,19,16,35
HND-012989,2011,150300238,,,,8,2,10
HND-012994,2011,150300243,,,,1,1,2
HND-012995,2011,150300245,,,,1,3,4
HND-012996,2011,150300246,,,,3,1,4
HND-012999,2011,150300249,,,,1,1,2
,2011,150300250,,,,3,3,6
HND-013000,2011,150300251,,,,3,2,5
HND-013001,2011,150300253,,,,11,7,18
,2011,150300258,,,,3,3,6
HND-013005,2011,150300259,,,,2,4,6
HND-013010,2011,150300265,,,,4,3,7
,2011,150300268,,,,10,6,16
HND-013013,2011,150300270,,,,5,7,12
,2011,150300271,,,,3,0,3
HND-013014,2011,150300272,,,,5,3,8
,2011,150300274,,,,2,3,5
HND-013016,2011,150300275,,,,1,3,4
HND-013019,2011,150300283,,,,1,3,4
HND-013021,2011,150300286,,,,3,3,6
,2011,150300374,,,,8,5,13
HND-013036,2011,150300375,,,,1,1,2
,2011,150300379,,,,1,1,2
HND-013041,2011,150300388,,,,1,0,1
HND-013043,2011,150300390,,,,3,1,4
HND-013055,2011,150300431,,,,0,5,5
HND-013056,2011,150300432,,,,2,5,7
HND-013060,2011,150300449,,,,1,0,1
HND-012805,2011,150300001,,,,3,3,6
HND-012806,2011,150300002,,,,2,1,3
HND-012807,2011,150300003,,,,1,3,4
,2011,150300004,,,,3,2,5
HND-012810,2011,150300007,,,,51,68,119
HND-012813,2011,150300011,,,,9,2,11
HND-012815,2011,150300013,,,,2,11,13
HND-012818,2011,150300016,,,,5,4,9
HND-012819,2011,150300017,,,,5,6,11
HND-012821,2011,150300019,,,,8,9,17
HND-012822,2011,150300020,,,,5,2,7
,2011,150300021,,,,6,6,12
HND-012823,2011,150300022,,,,12,19,31
HND-012825,2011,150300024,,,,6,3,9
HND-012827,2011,150300026,,,,5,4,9
HND-012828,2011,150300027,,,,37,33,70
,2011,150300028,,,,3,1,4
HND-012830,2011,150300031,,,,19,21,40
HND-012832,2011,150300033,,,,5,4,9
HND-012834,2011,150300035,,,,2,5,7
HND-012836,2011,150300039,,,,1,5,6
HND-012837,2011,150300040,,,,25,12,37
HND-012838,2011,150300041,,,,6,7,13
HND-012839,2011,150300042,,,,3,4,7
HND-012841,2011,150300044,,,,13,11,24
HND-012842,2011,150300045,,,,23,16,39
HND-012845,2011,150300048,,,,8,4,12
HND-012850,2011,150300053,,,,3,5,8
HND-012853,2011,150300056,,,,3,5,8
HND-012854,2011,150300057,,,,2,2,4
HND-012856,2011,150300059,,,,0,1,1
HND-012860,2011,150300063,,,,4,5,9
HND-012863,2011,150300066,,,,1,3,4
,2011,150300068,,,,32,48,80
HND-012871,2011,150300075,,,,2,8,10
HND-012872,2011,150300076,,,,2,2,4
HND-012874,2011,150300079,,,,4,3,7
HND-012875,2011,150300080,,,,2,1,3
HND-012876,2011,150300081,,,,2,0,2
HND-012878,2011,150300083,,,,3,2,5
HND-012879,2011,150300084,,,,2,2,4
HND-012880,2011,150300085,,,,24,27,51
HND-012881,2011,150300086,,,,3,6,9
HND-012882,2011,150300087,,,,6,5,11
HND-012883,2011,150300088,,,,3,2,5
HND-012888,2011,150300093,,,,4,1,5
HND-012891,2011,150300096,,,,5,4,9
HND-012892,2011,150300097,,,,8,10,18
HND-012895,2011,150300100,,,,1,4,5
HND-012898,2011,150300103,,,,0,1,1
HND-012899,2011,150300104,,,,4,5,9
HND-012900,2011,150300105,,,,5,3,8
HND-012901,2011,150300106,,,,2,1,3
HND-012902,2011,150300107,,,,2,2,4
HND-012903,2011,150300108,,,,1,1,2
HND-012905,2011,150300110,,,,5,0,5
,2011,150300112,,,,7,8,15
HND-012907,2011,150300113,,,,10,5,15
,2011,150300114,,,,5,7,12
HND-012908,2011,150300115,,,,4,2,6
HND-012909,2011,150300116,,,,12,4,16
HND-012910,2011,150300117,,,,1,0,1
HND-012911,2011,150300118,,,,0,3,3
HND-012913,2011,150300120,,,,4,8,12
HND-012915,2011,150300123,,,,2,0,2
HND-012916,2011,150300124,,,,32,25,57
HND-012917,2011,150300125,,,,21,9,30
HND-012918,2011,150300126,,,,2,3,5
HND-012919,2011,150300128,,,,15,11,26
HND-012922,2011,150300131,,,,2,2,4
HND-012923,2011,150300132,,,,6,4,10
HND-012926,2011,150300135,,,,5,4,9
HND-012928,2011,150300137,,,,8,9,17
HND-012931,2011,150300141,,,,5,4,9
HND-012944,2011,150300159,,,,11,9,20
,2011,150300166,,,,7,4,11
HND-012958,2011,150300187,,,,2,4,6
HND-012959,2011,150300188,,,,3,3,6
HND-012960,2011,150300189,,,,0,3,3
HND-012962,2011,150300191,,,,3,3,6
,2011,150300192,,,,2,1,3
HND-012966,2011,150300199,,,,3,0,3
HND-012967,2011,150300201,,,,7,7,14
HND-012970,2011,150300204,,,,1,0,1
HND-012971,2011,150300205,,,,3,4,7
HND-012974,2011,150300209,,,,1,1,2
HND-012975,2011,150300212,,,,3,1,4
,2011,150300223,,,,5,5,10
HND-012979,2011,150300225,,,,4,1,5
HND-012980,2011,150300226,,,,3,1,4
HND-012983,2011,150300230,,,,0,1,1
HND-012984,2011,150300231,,,,8,8,16
HND-012987,2011,150300236,,,,1,2,3
HND-012988,2011,150300237,,,,2,5,7
HND-012990,2011,150300239,,,,2,1,3
HND-012991,2011,150300240,,,,2,1,3
HND-012992,2011,150300241,,,,1,4,5
HND-012993,2011,150300242,,,,3,4,7
,2011,150300247,,,,2,2,4
HND-012998,2011,150300248,,,,5,1,6
HND-013006,2011,150300260,,,,1,3,4
HND-013008,2011,150300263,,,,4,6,10
HND-013009,2011,150300264,,,,4,0,4
HND-013015,2011,150300273,,,,0,1,1
,2011,150300276,,,,1,1,2
HND-013017,2011,150300277,,,,4,4,8
HND-013018,2011,150300281,,,,2,3,5
,2011,150300282,,,,2,2,4
HND-013020,2011,150300285,,,,2,1,3
HND-013022,2011,150300287,,,,0,3,3
HND-013034,2011,150300372,,,,4,3,7
HND-013035,2011,150300373,,,,8,5,13
HND-013037,2011,150300377,,,,2,2,4
HND-013039,2011,150300384,,,,4,2,6
HND-013040,2011,150300386,,,,3,1,4
,2011,150300387,,,,1,0,1
HND-013042,2011,150300389,,,,3,0,3
HND-013044,2011,150300391,,,,7,6,13
HND-013057,2011,150300433,,,,3,0,3
HND-013061,2011,150300450,,,,4,5,9
HND-013062,2011,150300451,,,,1,2,3
HND-012805,2011,150300001,,,,4,4,8
HND-012807,2011,150300003,,,,2,2,4
HND-012817,2011,150300015,,,,27,30,57
HND-012818,2011,150300016,,,,4,7,11
HND-012821,2011,150300019,,,,5,6,11
HND-012822,2011,150300020,,,,9,8,17
,2011,150300021,,,,6,10,16
HND-012824,2011,150300023,,,,11,5,16
HND-012825,2011,150300024,,,,3,3,6
HND-012827,2011,150300026,,,,3,2,5
,2011,150300028,,,,1,1,2
HND-012832,2011,150300033,,,,3,9,12
HND-012833,2011,150300034,,,,16,20,36
HND-012835,2011,150300037,,,,9,3,12
HND-012839,2011,150300042,,,,4,4,8
HND-012842,2011,150300045,,,,18,12,30
HND-012846,2011,150300049,,,,5,0,5
HND-012847,2011,150300050,,,,1,4,5
HND-012848,2011,150300051,,,,3,8,11
HND-012850,2011,150300053,,,,7,6,13
HND-012851,2011,150300054,,,,2,2,4
HND-012854,2011,150300057,,,,2,1,3
HND-012855,2011,150300058,,,,4,5,9
HND-012859,2011,150300062,,,,2,0,2
HND-012862,2011,150300065,,,,3,8,11
HND-012863,2011,150300066,,,,4,4,8
HND-012864,2011,150300067,,,,50,67,117
,2011,150300068,,,,42,53,95
HND-012867,2011,150300071,,,,9,6,15
HND-012869,2011,150300073,,,,1,0,1
HND-012872,2011,150300076,,,,4,4,8
HND-012875,2011,150300080,,,,0,4,4
HND-012877,2011,150300082,,,,0,2,2
HND-012879,2011,150300084,,,,3,0,3
HND-012883,2011,150300088,,,,6,4,10
HND-012885,2011,150300090,,,,7,2,9
HND-012886,2011,150300091,,,,4,4,8
HND-012888,2011,150300093,,,,4,1,5
HND-012889,2011,150300094,,,,1,3,4
HND-012891,2011,150300096,,,,4,2,6
HND-012892,2011,150300097,,,,6,7,13
HND-012893,2011,150300098,,,,1,1,2
HND-012894,2011,150300099,,,,22,26,48
HND-012895,2011,150300100,,,,2,1,3
HND-012898,2011,150300103,,,,2,4,6
HND-012899,2011,150300104,,,,5,1,6
HND-012901,2011,150300106,,,,3,1,4
HND-012903,2011,150300108,,,,7,2,9
HND-012905,2011,150300110,,,,1,3,4
,2011,150300112,,,,6,13,19
HND-012907,2011,150300113,,,,5,5,10
HND-012909,2011,150300116,,,,6,6,12
HND-012910,2011,150300117,,,,0,1,1
HND-012911,2011,150300118,,,,3,4,7
HND-012913,2011,150300120,,,,5,7,12
HND-012914,2011,150300122,,,,4,1,5
HND-012915,2011,150300123,,,,2,2,4
HND-012918,2011,150300126,,,,5,3,8
HND-012919,2011,150300128,,,,18,19,37
HND-012922,2011,150300131,,,,3,5,8
HND-012926,2011,150300135,,,,5,2,7
HND-012927,2011,150300136,,,,3,8,11
HND-012928,2011,150300137,,,,9,7,16
,2011,150300138,,,,14,17,31
HND-012929,2011,150300139,,,,7,4,11
HND-012931,2011,150300141,,,,2,2,4
HND-012944,2011,150300159,,,,5,5,10
HND-012957,2011,150300186,,,,2,5,7
HND-012958,2011,150300187,,,,8,1,9
HND-012959,2011,150300188,,,,1,0,1
HND-012962,2011,150300191,,,,1,3,4
HND-012965,2011,150300198,,,,1,3,4
HND-012966,2011,150300199,,,,5,5,10
HND-012968,2011,150300202,,,,1,3,4
HND-012971,2011,150300205,,,,6,4,10
HND-012972,2011,150300206,,,,4,3,7
HND-012976,2011,150300216,,,,3,3,6
HND-012977,2011,150300221,,,,2,5,7
,2011,150300223,,,,2,3,5
,2011,150300224,,,,3,3,6
HND-012980,2011,150300226,,,,1,1,2
HND-012982,2011,150300229,,,,4,2,6
HND-012985,2011,150300234,,,,23,30,53
HND-012987,2011,150300236,,,,4,2,6
HND-012990,2011,150300239,,,,3,3,6
HND-012992,2011,150300241,,,,1,0,1
HND-012994,2011,150300243,,,,1,3,4
HND-012996,2011,150300246,,,,1,0,1
,2011,150300247,,,,2,1,3
HND-012999,2011,150300249,,,,1,1,2
,2011,150300250,,,,0,3,3
HND-013001,2011,150300253,,,,6,8,14
,2011,150300258,,,,1,2,3
HND-013006,2011,150300260,,,,1,3,4
HND-013009,2011,150300264,,,,2,0,2
HND-013010,2011,150300265,,,,1,1,2
,2011,150300268,,,,6,6,12
HND-013014,2011,150300272,,,,1,2,3
HND-013016,2011,150300275,,,,1,3,4
,2011,150300276,,,,0,4,4
HND-013018,2011,150300281,,,,1,1,2
HND-013019,2011,150300283,,,,2,1,3
HND-013020,2011,150300285,,,,3,2,5
HND-013021,2011,150300286,,,,1,2,3
HND-013022,2011,150300287,,,,1,3,4
HND-013034,2011,150300372,,,,2,2,4
,2011,150300374,,,,6,4,10
HND-013036,2011,150300375,,,,2,1,3
HND-013037,2011,150300377,,,,2,3,5
,2011,150300379,,,,1,1,2
HND-013040,2011,150300386,,,,4,3,7
HND-013042,2011,150300389,,,,1,1,2
HND-013055,2011,150300431,,,,1,1,2
HND-013057,2011,150300433,,,,2,2,4
HND-013061,2011,150300450,,,,6,3,9
HND-013062,2011,150300451,,,,1,2,3
HND-012806,2011,150300002,,,,4,0,4
,2011,150300004,,,,6,3,9
HND-012808,2011,150300005,,,,2,7,9
HND-012810,2011,150300007,,,,47,42,89
,2011,150300008,,,,15,17,32
HND-012811,2011,150300009,,,,10,8,18
HND-012812,2011,150300010,,,,12,14,26
HND-012813,2011,150300011,,,,11,2,13
HND-012814,2011,150300012,,,,12,5,17
HND-012815,2011,150300013,,,,5,7,12
HND-012816,2011,150300014,,,,2,1,3
HND-012819,2011,150300017,,,,3,3,6
HND-012820,2011,150300018,,,,2,9,11
HND-012823,2011,150300022,,,,14,16,30
HND-012826,2011,150300025,,,,8,13,21
HND-012828,2011,150300027,,,,50,42,92
HND-012829,2011,150300030,,,,3,2,5
HND-012830,2011,150300031,,,,22,16,38
HND-012831,2011,150300032,,,,3,2,5
HND-012834,2011,150300035,,,,3,1,4
,2011,150300038,,,,3,8,11
HND-012836,2011,150300039,,,,4,3,7
HND-012837,2011,150300040,,,,18,12,30
HND-012838,2011,150300041,,,,4,7,11
HND-012840,2011,150300043,,,,11,6,17
HND-012841,2011,150300044,,,,10,12,22
HND-012843,2011,150300046,,,,4,2,6
HND-012844,2011,150300047,,,,0,2,2
HND-012845,2011,150300048,,,,5,4,9
HND-012849,2011,150300052,,,,4,9,13
HND-012852,2011,150300055,,,,2,8,10
HND-012853,2011,150300056,,,,9,3,12
HND-012856,2011,150300059,,,,2,2,4
HND-012857,2011,150300060,,,,3,1,4
HND-012858,2011,150300061,,,,1,1,2
HND-012860,2011,150300063,,,,3,0,3
HND-012861,2011,150300064,,,,4,4,8
HND-012866,2011,150300070,,,,1,10,11
HND-012868,2011,150300072,,,,0,2,2
HND-012870,2011,150300074,,,,4,1,5
HND-012871,2011,150300075,,,,7,7,14
,2011,150300077,,,,31,46,77
HND-012873,2011,150300078,,,,3,9,12
HND-012874,2011,150300079,,,,8,6,14
HND-012876,2011,150300081,,,,1,2,3
HND-012878,2011,150300083,,,,3,4,7
HND-012880,2011,150300085,,,,11,14,25
HND-012881,2011,150300086,,,,1,4,5
HND-012882,2011,150300087,,,,1,3,4
HND-012884,2011,150300089,,,,2,2,4
HND-012890,2011,150300095,,,,2,3,5
HND-012896,2011,150300101,,,,1,1,2
HND-012900,2011,150300105,,,,1,0,1
HND-012902,2011,150300107,,,,2,3,5
HND-012904,2011,150300109,,,,5,4,9
HND-012906,2011,150300111,,,,4,6,10
,2011,150300114,,,,6,5,11
HND-012908,2011,150300115,,,,7,0,7
,2011,150300121,,,,1,1,2
HND-012916,2011,150300124,,,,39,33,72
HND-012917,2011,150300125,,,,8,6,14
HND-012920,2011,150300129,,,,2,4,6
HND-012921,2011,150300130,,,,2,1,3
HND-012923,2011,150300132,,,,2,4,6
HND-012924,2011,150300133,,,,7,4,11
HND-012925,2011,150300134,,,,58,58,116
HND-012930,2011,150300140,,,,4,0,4
,2011,150300142,,,,3,5,8
HND-012932,2011,150300143,,,,2,0,2
,2011,150300166,,,,7,7,14
,2011,150300181,,,,10,7,17
HND-012960,2011,150300189,,,,3,3,6
HND-012961,2011,150300190,,,,5,1,6
,2011,150300192,,,,2,1,3
HND-012967,2011,150300201,,,,6,6,12
HND-012969,2011,150300203,,,,7,4,11
HND-012970,2011,150300204,,,,3,3,6
HND-012973,2011,150300207,,,,6,2,8
HND-012974,2011,150300209,,,,4,1,5
HND-012975,2011,150300212,,,,7,2,9
,2011,150300220,,,,3,5,8
,2011,150300222,,,,2,3,5
HND-012981,2011,150300228,,,,6,4,10
HND-012983,2011,150300230,,,,1,2,3
HND-012984,2011,150300231,,,,5,4,9
HND-012986,2011,150300235,,,,2,2,4
HND-012989,2011,150300238,,,,6,6,12
HND-012991,2011,150300240,,,,1,2,3
HND-012993,2011,150300242,,,,1,1,2
HND-012995,2011,150300245,,,,1,2,3
HND-012998,2011,150300248,,,,3,2,5
HND-013000,2011,150300251,,,,2,4,6
HND-013005,2011,150300259,,,,6,5,11
HND-013008,2011,150300263,,,,2,5,7
HND-013013,2011,150300270,,,,5,3,8
,2011,150300271,,,,1,1,2
HND-013015,2011,150300273,,,,2,1,3
,2011,150300274,,,,3,1,4
HND-013017,2011,150300277,,,,4,3,7
,2011,150300282,,,,2,4,6
HND-013035,2011,150300373,,,,3,2,5
HND-013038,2011,150300380,,,,0,4,4
HND-013039,2011,150300384,,,,2,3,5
,2011,150300387,,,,1,0,1
HND-013041,2011,150300388,,,,2,6,8
HND-013043,2011,150300390,,,,2,2,4
HND-013044,2011,150300391,,,,6,4,10
HND-013056,2011,150300432,,,,1,3,4
HND-013060,2011,150300449,,,,3,0,3
HND-012805,2011,150300001,,,,1,9,10
HND-012807,2011,150300003,,,,2,2,4
,2011,150300004,,,,0,3,3
HND-012815,2011,150300013,,,,8,5,13
HND-012817,2011,150300015,,,,33,17,50
HND-012818,2011,150300016,,,,10,10,20
HND-012819,2011,150300017,,,,4,5,9
HND-012821,2011,150300019,,,,3,12,15
HND-012822,2011,150300020,,,,10,8,18
,2011,150300021,,,,5,6,11
HND-012823,2011,150300022,,,,21,16,37
HND-012824,2011,150300023,,,,12,8,20
HND-012825,2011,150300024,,,,5,7,12
HND-012827,2011,150300026,,,,3,2,5
HND-012828,2011,150300027,,,,16,39,55
HND-012829,2011,150300030,,,,2,2,4
HND-012832,2011,150300033,,,,7,3,10
HND-012833,2011,150300034,,,,17,8,25
HND-012835,2011,150300037,,,,3,10,13
,2011,150300038,,,,9,3,12
HND-012842,2011,150300045,,,,12,17,29
HND-012843,2011,150300046,,,,5,1,6
HND-012846,2011,150300049,,,,7,5,12
HND-012847,2011,150300050,,,,2,3,5
HND-012848,2011,150300051,,,,6,3,9
HND-012849,2011,150300052,,,,5,7,12
HND-012851,2011,150300054,,,,1,2,3
HND-012854,2011,150300057,,,,4,4,8
HND-012855,2011,150300058,,,,2,3,5
HND-012860,2011,150300063,,,,3,3,6
HND-012862,2011,150300065,,,,12,3,15
HND-012863,2011,150300066,,,,3,4,7
,2011,150300068,,,,40,49,89
HND-012866,2011,150300070,,,,6,6,12
HND-012867,2011,150300071,,,,5,9,14
HND-012869,2011,150300073,,,,2,2,4
HND-012870,2011,150300074,,,,2,4,6
HND-012872,2011,150300076,,,,3,6,9
,2011,150300077,,,,38,39,77
HND-012873,2011,150300078,,,,2,9,11
HND-012875,2011,150300080,,,,3,3,6
HND-012877,2011,150300082,,,,4,7,11
HND-012879,2011,150300084,,,,2,0,2
HND-012883,2011,150300088,,,,4,2,6
HND-012884,2011,150300089,,,,5,0,5
HND-012885,2011,150300090,,,,2,1,3
HND-012886,2011,150300091,,,,3,1,4
HND-012888,2011,150300093,,,,1,2,3
HND-012889,2011,150300094,,,,2,2,4
HND-012892,2011,150300097,,,,12,10,22
HND-012893,2011,150300098,,,,4,4,8
HND-012894,2011,150300099,,,,25,34,59
HND-012896,2011,150300101,,,,2,1,3
HND-012900,2011,150300105,,,,4,2,6
HND-012904,2011,150300109,,,,3,3,6
HND-012906,2011,150300111,,,,4,4,8
,2011,150300114,,,,1,7,8
HND-012908,2011,150300115,,,,2,1,3
HND-012912,2011,150300119,,,,2,1,3
,2011,150300121,,,,0,1,1
HND-012916,2011,150300124,,,,20,37,57
HND-012917,2011,150300125,,,,1,6,7
HND-012920,2011,150300129,,,,0,2,2
HND-012922,2011,150300131,,,,3,0,3
HND-012923,2011,150300132,,,,3,3,6
HND-012926,2011,150300135,,,,9,7,16
HND-012928,2011,150300137,,,,7,10,17
,2011,150300138,,,,26,20,46
HND-012929,2011,150300139,,,,1,2,3
HND-012931,2011,150300141,,,,4,6,10
HND-012944,2011,150300159,,,,7,9,16
HND-012957,2011,150300186,,,,4,1,5
HND-012958,2011,150300187,,,,1,11,12
HND-012959,2011,150300188,,,,0,1,1
HND-012960,2011,150300189,,,,5,2,7
HND-012962,2011,150300191,,,,2,3,5
HND-012966,2011,150300199,,,,3,2,5
HND-012969,2011,150300203,,,,2,4,6
HND-012971,2011,150300205,,,,2,3,5
HND-012972,2011,150300206,,,,2,5,7
HND-012974,2011,150300209,,,,2,0,2
HND-012976,2011,150300216,,,,3,2,5
,2011,150300220,,,,2,4,6
HND-012977,2011,150300221,,,,1,4,5
,2011,150300223,,,,2,2,4
,2011,150300224,,,,8,3,11
HND-012980,2011,150300226,,,,3,2,5
HND-012981,2011,150300228,,,,1,6,7
HND-012982,2011,150300229,,,,3,6,9
HND-012984,2011,150300231,,,,5,4,9
HND-012988,2011,150300237,,,,3,1,4
HND-012990,2011,150300239,,,,5,4,9
HND-012991,2011,150300240,,,,1,0,1
HND-012992,2011,150300241,,,,2,1,3
HND-012994,2011,150300243,,,,0,3,3
HND-012996,2011,150300246,,,,0,3,3
,2011,150300247,,,,1,1,2
HND-012998,2011,150300248,,,,3,1,4
HND-012999,2011,150300249,,,,1,1,2
,2011,150300250,,,,0,4,4
HND-013001,2011,150300253,,,,6,9,15
,2011,150300258,,,,1,0,1
HND-013010,2011,150300265,,,,1,1,2
,2011,150300268,,,,3,8,11
HND-013015,2011,150300273,,,,0,5,5
HND-013016,2011,150300275,,,,0,1,1
,2011,150300276,,,,1,3,4
HND-013018,2011,150300281,,,,1,0,1
HND-013019,2011,150300283,,,,3,0,3
HND-013020,2011,150300285,,,,3,3,6
HND-013021,2011,150300286,,,,5,6,11
HND-013022,2011,150300287,,,,1,2,3
,2011,150300374,,,,3,3,6
,2011,150300379,,,,1,3,4
HND-013038,2011,150300380,,,,1,1,2
,2011,150300387,,,,2,1,3
HND-013055,2011,150300431,,,,3,1,4
HND-013057,2011,150300433,,,,2,1,3
HND-013061,2011,150300450,,,,2,2,4
HND-013062,2011,150300451,,,,2,2,4
HND-012806,2011,150300002,,,,5,1,6
HND-012808,2011,150300005,,,,7,7,14
HND-012810,2011,150300007,,,,69,65,134
,2011,150300008,,,,12,9,21
HND-012811,2011,150300009,,,,8,9,17
HND-012812,2011,150300010,,,,8,8,16
HND-012813,2011,150300011,,,,8,4,12
HND-012814,2011,150300012,,,,11,7,18
HND-012816,2011,150300014,,,,2,1,3
HND-012820,2011,150300018,,,,7,4,11
HND-012826,2011,150300025,,,,15,17,32
HND-012830,2011,150300031,,,,18,20,38
HND-012831,2011,150300032,,,,5,3,8
HND-012834,2011,150300035,,,,1,0,1
HND-012836,2011,150300039,,,,2,1,3
HND-012837,2011,150300040,,,,12,13,25
HND-012838,2011,150300041,,,,5,2,7
HND-012839,2011,150300042,,,,1,2,3
HND-012840,2011,150300043,,,,8,11,19
HND-012841,2011,150300044,,,,12,11,23
HND-012844,2011,150300047,,,,1,3,4
HND-012845,2011,150300048,,,,5,8,13
HND-012850,2011,150300053,,,,2,3,5
HND-012852,2011,150300055,,,,6,5,11
HND-012853,2011,150300056,,,,7,12,19
HND-012856,2011,150300059,,,,3,1,4
HND-012857,2011,150300060,,,,3,2,5
HND-012858,2011,150300061,,,,3,2,5
HND-012859,2011,150300062,,,,2,4,6
HND-012861,2011,150300064,,,,3,3,6
HND-012864,2011,150300067,,,,56,57,113
HND-012868,2011,150300072,,,,4,2,6
HND-012871,2011,150300075,,,,7,7,14
HND-012874,2011,150300079,,,,2,10,12
HND-012876,2011,150300081,,,,1,4,5
HND-012878,2011,150300083,,,,2,2,4
HND-012880,2011,150300085,,,,15,24,39
HND-012881,2011,150300086,,,,5,2,7
HND-012882,2011,150300087,,,,2,6,8
HND-012890,2011,150300095,,,,4,4,8
HND-012891,2011,150300096,,,,1,0,1
HND-012895,2011,150300100,,,,4,0,4
HND-012898,2011,150300103,,,,6,1,7
HND-012899,2011,150300104,,,,1,1,2
HND-012901,2011,150300106,,,,2,1,3
HND-012902,2011,150300107,,,,1,1,2
HND-012903,2011,150300108,,,,4,3,7
HND-012905,2011,150300110,,,,2,0,2
,2011,150300112,,,,4,7,11
HND-012907,2011,150300113,,,,5,7,12
HND-012909,2011,150300116,,,,6,9,15
HND-012910,2011,150300117,,,,0,3,3
HND-012911,2011,150300118,,,,3,2,5
HND-012913,2011,150300120,,,,4,2,6
HND-012914,2011,150300122,,,,3,6,9
HND-012915,2011,150300123,,,,3,2,5
HND-012918,2011,150300126,,,,2,5,7
HND-012919,2011,150300128,,,,19,18,37
HND-012921,2011,150300130,,,,3,2,5
HND-012924,2011,150300133,,,,6,3,9
HND-012925,2011,150300134,,,,57,53,110
HND-012927,2011,150300136,,,,8,7,15
HND-012930,2011,150300140,,,,3,1,4
,2011,150300142,,,,1,4,5
HND-012932,2011,150300143,,,,7,0,7
,2011,150300166,,,,7,5,12
,2011,150300181,,,,4,8,12
HND-012961,2011,150300190,,,,2,1,3
,2011,150300192,,,,2,3,5
HND-012965,2011,150300198,,,,0,3,3
HND-012967,2011,150300201,,,,2,5,7
HND-012968,2011,150300202,,,,0,4,4
HND-012970,2011,150300204,,,,1,2,3
HND-012973,2011,150300207,,,,3,2,5
HND-012975,2011,150300212,,,,5,0,5
,2011,150300222,,,,0,1,1
HND-012979,2011,150300225,,,,2,6,8
HND-012985,2011,150300234,,,,17,22,39
HND-012989,2011,150300238,,,,6,8,14
HND-012995,2011,150300245,,,,0,1,1
HND-013000,2011,150300251,,,,3,0,3
HND-013005,2011,150300259,,,,2,6,8
HND-013006,2011,150300260,,,,4,4,8
HND-013008,2011,150300263,,,,0,6,6
HND-013009,2011,150300264,,,,5,0,5
HND-013013,2011,150300270,,,,4,7,11
,2011,150300271,,,,6,0,6
HND-013014,2011,150300272,,,,2,1,3
,2011,150300274,,,,2,2,4
HND-013017,2011,150300277,,,,2,6,8
,2011,150300282,,,,2,0,2
HND-013034,2011,150300372,,,,0,2,2
HND-013035,2011,150300373,,,,6,3,9
HND-013036,2011,150300375,,,,7,4,11
HND-013037,2011,150300377,,,,2,0,2
HND-013039,2011,150300384,,,,1,3,4
HND-013040,2011,150300386,,,,4,2,6
HND-013042,2011,150300389,,,,0,2,2
HND-013043,2011,150300390,,,,3,1,4
HND-013044,2011,150300391,,,,4,5,9
HND-013056,2011,150300432,,,,0,4,4
HND-013060,2011,150300449,,,,3,2,5
HND-012806,2011,150300002,,,,1,6,7
,2011,150300004,,,,5,1,6
HND-012808,2011,150300005,,,,1,8,9
HND-012810,2011,150300007,,,,61,75,136
,2011,150300008,,,,13,21,34
HND-012812,2011,150300010,,,,8,11,19
HND-012813,2011,150300011,,,,10,6,16
HND-012815,2011,150300013,,,,3,6,9
HND-012816,2011,150300014,,,,2,1,3
HND-012818,2011,150300016,,,,7,2,9
HND-012819,2011,150300017,,,,3,0,3
HND-012820,2011,150300018,,,,8,7,15
HND-012822,2011,150300020,,,,8,7,15
HND-012823,2011,150300022,,,,24,22,46
HND-012825,2011,150300024,,,,5,2,7
HND-012826,2011,150300025,,,,8,16,24
HND-012827,2011,150300026,,,,5,1,6
HND-012828,2011,150300027,,,,48,43,91
,2011,150300028,,,,0,2,2
HND-012829,2011,150300030,,,,2,3,5
HND-012830,2011,150300031,,,,16,10,26
HND-012831,2011,150300032,,,,1,1,2
HND-012833,2011,150300034,,,,18,22,40
HND-012834,2011,150300035,,,,3,4,7
,2011,150300038,,,,5,4,9
HND-012838,2011,150300041,,,,1,7,8
HND-012840,2011,150300043,,,,9,7,16
HND-012843,2011,150300046,,,,3,3,6
HND-012844,2011,150300047,,,,4,1,5
HND-012847,2011,150300050,,,,4,2,6
HND-012849,2011,150300052,,,,7,12,19
HND-012852,2011,150300055,,,,6,5,11
HND-012855,2011,150300058,,,,4,5,9
HND-012856,2011,150300059,,,,2,4,6
HND-012858,2011,150300061,,,,3,2,5
HND-012860,2011,150300063,,,,5,3,8
HND-012861,2011,150300064,,,,1,5,6
HND-012863,2011,150300066,,,,4,1,5
HND-012866,2011,150300070,,,,5,3,8
HND-012868,2011,150300072,,,,2,0,2
HND-012870,2011,150300074,,,,5,3,8
HND-012871,2011,150300075,,,,8,7,15
,2011,150300077,,,,28,44,72
HND-012873,2011,150300078,,,,10,6,16
HND-012878,2011,150300083,,,,1,2,3
HND-012880,2011,150300085,,,,18,22,40
HND-012881,2011,150300086,,,,1,4,5
HND-012884,2011,150300089,,,,1,3,4
HND-012885,2011,150300090,,,,4,2,6
HND-012889,2011,150300094,,,,1,1,2
HND-012890,2011,150300095,,,,4,1,5
HND-012893,2011,150300098,,,,1,1,2
HND-012896,2011,150300101,,,,3,2,5
HND-012901,2011,150300106,,,,2,1,3
HND-012906,2011,150300111,,,,5,7,12
HND-012909,2011,150300116,,,,3,9,12
HND-012913,2011,150300120,,,,3,5,8
HND-012914,2011,150300122,,,,3,4,7
HND-012918,2011,150300126,,,,2,4,6
HND-012921,2011,150300130,,,,0,3,3
HND-012923,2011,150300132,,,,3,3,6
HND-012924,2011,150300133,,,,5,6,11
HND-012925,2011,150300134,,,,70,66,136
HND-012926,2011,150300135,,,,10,5,15
HND-012930,2011,150300140,,,,1,1,2
HND-012932,2011,150300143,,,,6,3,9
HND-012960,2011,150300189,,,,1,1,2
HND-012962,2011,150300191,,,,2,4,6
,2011,150300192,,,,1,3,4
HND-012966,2011,150300199,,,,4,4,8
HND-012967,2011,150300201,,,,4,4,8
HND-012969,2011,150300203,,,,4,2,6
HND-012970,2011,150300204,,,,1,3,4
HND-012973,2011,150300207,,,,5,5,10
HND-012974,2011,150300209,,,,4,3,7
,2011,150300220,,,,0,3,3
,2011,150300222,,,,0,1,1
,2011,150300224,,,,5,4,9
HND-012979,2011,150300225,,,,1,4,5
HND-012981,2011,150300228,,,,2,4,6
HND-012983,2011,150300230,,,,1,1,2
HND-012984,2011,150300231,,,,5,8,13
HND-012988,2011,150300237,,,,2,1,3
HND-012989,2011,150300238,,,,4,6,10
HND-012991,2011,150300240,,,,0,1,1
HND-012993,2011,150300242,,,,0,1,1
HND-012998,2011,150300248,,,,3,2,5
HND-013005,2011,150300259,,,,4,5,9
HND-013008,2011,150300263,,,,1,1,2
,2011,150300271,,,,1,1,2
,2011,150300274,,,,2,3,5
HND-013017,2011,150300277,,,,4,4,8
,2011,150300282,,,,0,2,2
HND-013034,2011,150300372,,,,4,3,7
,2011,150300374,,,,1,4,5
HND-013036,2011,150300375,,,,2,1,3
HND-013038,2011,150300380,,,,1,2,3
HND-013042,2011,150300389,,,,5,1,6
HND-013043,2011,150300390,,,,4,1,5
HND-013044,2011,150300391,,,,2,1,3
HND-013056,2011,150300432,,,,7,3,10
HND-013060,2011,150300449,,,,0,2,2
HND-013061,2011,150300450,,,,8,5,13
HND-013062,2011,150300451,,,,0,2,2
HND-012805,2011,150300001,,,,3,8,11
HND-012807,2011,150300003,,,,1,4,5
HND-012811,2011,150300009,,,,5,3,8
HND-012814,2011,150300012,,,,13,10,23
HND-012817,2011,150300015,,,,28,21,49
HND-012821,2011,150300019,,,,9,4,13
,2011,150300021,,,,5,5,10
HND-012824,2011,150300023,,,,8,12,20
HND-012832,2011,150300033,,,,2,4,6
HND-012835,2011,150300037,,,,8,10,18
HND-012836,2011,150300039,,,,3,1,4
HND-012837,2011,150300040,,,,15,15,30
HND-012839,2011,150300042,,,,3,3,6
HND-012841,2011,150300044,,,,10,19,29
HND-012842,2011,150300045,,,,30,24,54
HND-012845,2011,150300048,,,,8,7,15
HND-012846,2011,150300049,,,,4,4,8
HND-012848,2011,150300051,,,,6,5,11
HND-012850,2011,150300053,,,,8,8,16
HND-012851,2011,150300054,,,,2,3,5
HND-012853,2011,150300056,,,,11,4,15
HND-012854,2011,150300057,,,,2,1,3
HND-012857,2011,150300060,,,,1,2,3
HND-012859,2011,150300062,,,,3,2,5
HND-012862,2011,150300065,,,,9,5,14
HND-012864,2011,150300067,,,,60,54,114
,2011,150300068,,,,36,38,74
HND-012867,2011,150300071,,,,7,5,12
HND-012869,2011,150300073,,,,1,2,3
HND-012872,2011,150300076,,,,1,2,3
HND-012874,2011,150300079,,,,3,3,6
HND-012875,2011,150300080,,,,4,1,5
HND-012876,2011,150300081,,,,0,1,1
HND-012877,2011,150300082,,,,2,0,2
HND-012879,2011,150300084,,,,2,1,3
HND-012882,2011,150300087,,,,7,2,9
HND-012883,2011,150300088,,,,3,1,4
HND-012886,2011,150300091,,,,3,2,5
HND-012888,2011,150300093,,,,0,1,1
HND-012891,2011,150300096,,,,2,4,6
HND-012892,2011,150300097,,,,7,2,9
HND-012894,2011,150300099,,,,25,27,52
HND-012895,2011,150300100,,,,2,7,9
HND-012898,2011,150300103,,,,4,4,8
HND-012899,2011,150300104,,,,3,2,5
HND-012900,2011,150300105,,,,1,0,1
HND-012902,2011,150300107,,,,2,1,3
HND-012903,2011,150300108,,,,3,3,6
HND-012904,2011,150300109,,,,4,3,7
HND-012905,2011,150300110,,,,2,0,2
,2011,150300112,,,,9,8,17
HND-012907,2011,150300113,,,,2,5,7
,2011,150300114,,,,12,13,25
HND-012908,2011,150300115,,,,1,4,5
HND-012910,2011,150300117,,,,1,3,4
HND-012911,2011,150300118,,,,4,1,5
HND-012912,2011,150300119,,,,1,3,4
,2011,150300121,,,,3,0,3
HND-012916,2011,150300124,,,,30,33,63
HND-012917,2011,150300125,,,,5,5,10
HND-012919,2011,150300128,,,,13,14,27
HND-012920,2011,150300129,,,,3,3,6
HND-012922,2011,150300131,,,,5,2,7
HND-012927,2011,150300136,,,,12,8,20
HND-012928,2011,150300137,,,,5,5,10
,2011,150300138,,,,15,14,29
HND-012929,2011,150300139,,,,4,3,7
HND-012931,2011,150300141,,,,4,1,5
,2011,150300142,,,,1,3,4
HND-012944,2011,150300159,,,,17,9,26
,2011,150300166,,,,10,3,13
,2011,150300181,,,,4,4,8
HND-012957,2011,150300186,,,,3,1,4
HND-012958,2011,150300187,,,,2,3,5
HND-012959,2011,150300188,,,,4,1,5
HND-012961,2011,150300190,,,,1,0,1
HND-012965,2011,150300198,,,,1,3,4
HND-012968,2011,150300202,,,,0,3,3
HND-012971,2011,150300205,,,,3,2,5
HND-012975,2011,150300212,,,,3,3,6
HND-012976,2011,150300216,,,,2,4,6
HND-012977,2011,150300221,,,,4,0,4
,2011,150300223,,,,2,0,2
HND-012980,2011,150300226,,,,4,2,6
HND-012982,2011,150300229,,,,4,3,7
HND-012985,2011,150300234,,,,23,21,44
HND-012986,2011,150300235,,,,2,0,2
HND-012987,2011,150300236,,,,3,2,5
HND-012990,2011,150300239,,,,5,3,8
HND-012992,2011,150300241,,,,2,2,4
HND-012994,2011,150300243,,,,1,1,2
,2011,150300247,,,,1,2,3
HND-012999,2011,150300249,,,,1,3,4
HND-013000,2011,150300251,,,,2,2,4
HND-013001,2011,150300253,,,,14,10,24
,2011,150300258,,,,1,1,2
HND-013006,2011,150300260,,,,2,1,3
HND-013009,2011,150300264,,,,0,4,4
HND-013010,2011,150300265,,,,2,1,3
,2011,150300268,,,,8,10,18
HND-013013,2011,150300270,,,,4,8,12
HND-013014,2011,150300272,,,,4,0,4
HND-013016,2011,150300275,,,,1,0,1
HND-013019,2011,150300283,,,,0,6,6
HND-013020,2011,150300285,,,,0,1,1
HND-013021,2011,150300286,,,,2,4,6
HND-013022,2011,150300287,,,,5,2,7
HND-013035,2011,150300373,,,,2,4,6
HND-013037,2011,150300377,,,,1,1,2
HND-013039,2011,150300384,,,,0,1,1
HND-013040,2011,150300386,,,,0,3,3
,2011,150300387,,,,3,3,6
HND-013055,2011,150300431,,,,1,1,2
HND-013057,2011,150300433,,,,1,1,2
HND-012818,2011,150300016,,,,10,14,24
HND-012819,2011,150300017,,,,7,6,13
,2011,150300021,,,,8,3,11
HND-012823,2011,150300022,,,,21,32,53
HND-012824,2011,150300023,,,,13,13,26
HND-012837,2011,150300040,,,,18,25,43
HND-012845,2011,150300048,,,,6,11,17
HND-012887,2011,150300092,,,,394,399,793
,2011,150300112,,,,2,9,11
HND-012919,2011,150300128,,,,25,16,41
HND-012949,2011,150300171,,,,69,100,169
HND-012984,2011,150300231,,,,8,2,10
HND-013012,2011,150300269,,,,130,193,323
,2011,150300414,,,,0,1,1
HND-012814,2011,150300012,,,,6,6,12
HND-012835,2011,150300037,,,,18,9,27
,2011,150300038,,,,11,11,22
HND-012840,2011,150300043,,,,22,19,41
HND-012842,2011,150300045,,,,31,24,55
HND-012846,2011,150300049,,,,11,15,26
HND-012925,2011,150300134,,,,38,55,93
,2011,150300169,,,,8,7,15
,2011,150300170,,,,24,2,26
HND-012950,2011,150300172,,,,39,44,83
HND-012985,2011,150300234,,,,15,20,35
HND-013011,2011,150300266,,,,68,62,130
HND-013061,2011,150300450,,,,8,12,20
HND-012814,2011,150300012,,,,5,10,15
,2011,150300021,,,,1,6,7
HND-012824,2011,150300023,,,,4,12,16
HND-012835,2011,150300037,,,,6,15,21
HND-012837,2011,150300040,,,,14,7,21
HND-012842,2011,150300045,,,,22,31,53
HND-012845,2011,150300048,,,,6,10,16
HND-012846,2011,150300049,,,,2,7,9
HND-012887,2011,150300092,,,,293,322,615
,2011,150300112,,,,9,8,17
HND-012919,2011,150300128,,,,15,23,38
,2011,150300170,,,,17,8,25
HND-012950,2011,150300172,,,,19,37,56
HND-012985,2011,150300234,,,,10,24,34
HND-013061,2011,150300450,,,,7,1,8
HND-012818,2011,150300016,,,,9,10,19
HND-012819,2011,150300017,,,,6,3,9
HND-012823,2011,150300022,,,,25,22,47
,2011,150300038,,,,16,11,27
HND-012840,2011,150300043,,,,15,26,41
HND-012925,2011,150300134,,,,21,35,56
,2011,150300169,,,,5,7,12
HND-012949,2011,150300171,,,,58,73,131
HND-012984,2011,150300231,,,,4,5,9
HND-013011,2011,150300266,,,,44,80,124
HND-013012,2011,150300269,,,,102,124,226
,2011,150300414,,,,3,1,4
HND-012814,2011,150300012,,,,6,8,14
HND-012818,2011,150300016,,,,3,7,10
,2011,150300021,,,,12,4,16
HND-012824,2011,150300023,,,,11,8,19
HND-012835,2011,150300037,,,,5,4,9
HND-012842,2011,150300045,,,,30,33,63
HND-012846,2011,150300049,,,,2,4,6
HND-012887,2011,150300092,,,,244,255,499
,2011,150300112,,,,6,5,11
HND-012919,2011,150300128,,,,15,22,37
,2011,150300170,,,,15,13,28
HND-012985,2011,150300234,,,,7,23,30
HND-013011,2011,150300266,,,,50,70,120
HND-013012,2011,150300269,,,,107,152,259
,2011,150300414,,,,1,1,2
HND-012819,2011,150300017,,,,4,3,7
HND-012823,2011,150300022,,,,17,22,39
,2011,150300038,,,,13,10,23
HND-012837,2011,150300040,,,,9,5,14
HND-012840,2011,150300043,,,,33,26,59
HND-012845,2011,150300048,,,,9,5,14
HND-012925,2011,150300134,,,,15,41,56
,2011,150300169,,,,3,17,20
HND-012949,2011,150300171,,,,50,74,124
HND-012950,2011,150300172,,,,14,33,47
HND-012984,2011,150300231,,,,7,5,12
HND-013061,2011,150300450,,,,1,6,7
HND-012887,2011,150300092,,,,300,382,682
,2011,150300112,,,,4,1,5
,2011,150300169,,,,10,16,26
HND-013061,2011,150300450,,,,4,9,13
HND-012823,2011,150300022,,,,13,19,32
,2011,150300170,,,,33,11,44
HND-012949,2011,150300171,,,,47,51,98
HND-012950,2011,150300172,,,,46,32,78
HND-013011,2011,150300266,,,,47,69,116
HND-013012,2011,150300269,,,,94,160,254
,2011,150300414,,,,1,0,1
,2011,150300434,,,,39,27,66
HND-012887,2011,150300092,,,,217,246,463
,2011,150300169,,,,11,14,25
,2011,150300170,,,,31,12,43
HND-012949,2011,150300171,,,,15,25,40
HND-012950,2011,150300172,,,,19,27,46
HND-012823,2011,150300022,,,,12,17,29
,2011,150300112,,,,6,2,8
HND-013011,2011,150300266,,,,31,71,102
HND-013012,2011,150300269,,,,77,114,191
,2011,150300414,,,,0,1,1
HND-012823,2011,150300022,,,,9,16,25
HND-013012,2011,150300269,,,,67,85,152
HND-012887,2011,150300092,,,,169,191,360
,2011,150300112,,,,0,3,3
,2011,150300169,,,,18,8,26
HND-012949,2011,150300171,,,,7,14,21
HND-012950,2011,150300172,,,,16,32,48
,2011,150400039,,,,2,7,9
HND-013095,2011,150400040,,,,5,1,6
,2011,150400041,,,,6,2,8
,2011,150400042,,,,4,5,9
,2011,150400044,,,,5,6,11
,2011,150400043,,,,9,7,16
,2011,150400045,,,,3,5,8
HND-013086,2011,150400019,,,,5,3,8
,2011,150400020,,,,6,3,9
HND-013087,2011,150400021,,,,8,14,22
HND-013088,2011,150400022,,,,2,1,3
HND-013092,2011,150400027,,,,3,1,4
HND-013084,2011,150400017,,,,13,11,24
HND-013085,2011,150400018,,,,2,3,5
,2011,150400026,,,,5,3,8
HND-013084,2011,150400017,,,,16,17,33
HND-013085,2011,150400018,,,,7,9,16
,2011,150400026,,,,0,5,5
HND-013086,2011,150400019,,,,3,5,8
,2011,150400020,,,,4,8,12
HND-013087,2011,150400021,,,,11,6,17
HND-013088,2011,150400022,,,,12,1,13
HND-013092,2011,150400027,,,,6,8,14
HND-013071,2011,150400003,,,,12,4,16
HND-013073,2011,150400006,,,,4,1,5
HND-013074,2011,150400007,,,,3,5,8
HND-013076,2011,150400009,,,,5,4,9
HND-013079,2011,150400012,,,,7,7,14
HND-013082,2011,150400015,,,,5,4,9
HND-013090,2011,150400024,,,,2,3,5
HND-013069,2011,150400001,,,,23,17,40
HND-013070,2011,150400002,,,,1,1,2
HND-013072,2011,150400005,,,,2,4,6
HND-013075,2011,150400008,,,,6,6,12
HND-013077,2011,150400010,,,,8,5,13
HND-013078,2011,150400011,,,,8,6,14
HND-013080,2011,150400013,,,,11,11,22
HND-013081,2011,150400014,,,,4,1,5
HND-013091,2011,150400025,,,,6,5,11
HND-013093,2011,150400028,,,,11,7,18
HND-013094,2011,150400029,,,,7,4,11
HND-013096,2011,150400046,,,,0,2,2
HND-013069,2011,150400001,,,,14,18,32
HND-013070,2011,150400002,,,,0,3,3
HND-013072,2011,150400005,,,,1,1,2
HND-013075,2011,150400008,,,,1,4,5
HND-013076,2011,150400009,,,,2,2,4
HND-013077,2011,150400010,,,,7,5,12
HND-013078,2011,150400011,,,,3,11,14
HND-013079,2011,150400012,,,,7,5,12
HND-013081,2011,150400014,,,,4,0,4
HND-013091,2011,150400025,,,,6,7,13
HND-013094,2011,150400029,,,,1,3,4
HND-013071,2011,150400003,,,,12,11,23
HND-013073,2011,150400006,,,,4,5,9
HND-013074,2011,150400007,,,,7,5,12
HND-013080,2011,150400013,,,,5,7,12
HND-013082,2011,150400015,,,,5,8,13
HND-013083,2011,150400016,,,,1,2,3
HND-013093,2011,150400028,,,,6,7,13
HND-013096,2011,150400046,,,,1,0,1
HND-013069,2011,150400001,,,,21,21,42
HND-013070,2011,150400002,,,,3,2,5
HND-013072,2011,150400005,,,,3,1,4
HND-013075,2011,150400008,,,,2,2,4
HND-013077,2011,150400010,,,,10,5,15
HND-013078,2011,150400011,,,,3,3,6
HND-013080,2011,150400013,,,,5,4,9
HND-013081,2011,150400014,,,,7,1,8
HND-013083,2011,150400016,,,,1,2,3
HND-013091,2011,150400025,,,,1,3,4
HND-013093,2011,150400028,,,,18,11,29
HND-013094,2011,150400029,,,,4,4,8
HND-013096,2011,150400046,,,,0,2,2
HND-013071,2011,150400003,,,,8,8,16
HND-013073,2011,150400006,,,,4,2,6
HND-013074,2011,150400007,,,,6,5,11
HND-013076,2011,150400009,,,,8,8,16
HND-013079,2011,150400012,,,,10,8,18
HND-013082,2011,150400015,,,,5,5,10
HND-013090,2011,150400024,,,,2,1,3
HND-013069,2011,150400001,,,,19,28,47
HND-013072,2011,150400005,,,,3,0,3
HND-013073,2011,150400006,,,,2,5,7
HND-013076,2011,150400009,,,,7,3,10
HND-013077,2011,150400010,,,,8,6,14
HND-013078,2011,150400011,,,,5,7,12
HND-013079,2011,150400012,,,,6,8,14
HND-013081,2011,150400014,,,,2,0,2
HND-013082,2011,150400015,,,,7,5,12
HND-013094,2011,150400029,,,,2,0,2
HND-013070,2011,150400002,,,,1,5,6
HND-013071,2011,150400003,,,,8,8,16
HND-013074,2011,150400007,,,,3,5,8
HND-013075,2011,150400008,,,,5,1,6
HND-013080,2011,150400013,,,,9,14,23
HND-013083,2011,150400016,,,,3,2,5
HND-013090,2011,150400024,,,,1,1,2
HND-013091,2011,150400025,,,,6,4,10
HND-013093,2011,150400028,,,,7,7,14
HND-013096,2011,150400046,,,,2,1,3
HND-013071,2011,150400003,,,,9,6,15
HND-013072,2011,150400005,,,,2,0,2
HND-013073,2011,150400006,,,,1,2,3
HND-013076,2011,150400009,,,,5,4,9
HND-013077,2011,150400010,,,,10,7,17
HND-013079,2011,150400012,,,,8,8,16
HND-013081,2011,150400014,,,,2,2,4
HND-013082,2011,150400015,,,,3,9,12
HND-013069,2011,150400001,,,,19,22,41
HND-013070,2011,150400002,,,,4,2,6
HND-013074,2011,150400007,,,,3,8,11
HND-013075,2011,150400008,,,,1,1,2
HND-013078,2011,150400011,,,,4,6,10
HND-013080,2011,150400013,,,,6,9,15
HND-013083,2011,150400016,,,,0,2,2
HND-013090,2011,150400024,,,,1,2,3
HND-013091,2011,150400025,,,,7,8,15
HND-013093,2011,150400028,,,,6,7,13
HND-013094,2011,150400029,,,,1,0,1
HND-013096,2011,150400046,,,,3,0,3
HND-013071,2011,150400003,,,,6,13,19
HND-013073,2011,150400006,,,,5,2,7
HND-013074,2011,150400007,,,,4,7,11
HND-013080,2011,150400013,,,,5,14,19
HND-013082,2011,150400015,,,,6,2,8
HND-013083,2011,150400016,,,,0,3,3
HND-013090,2011,150400024,,,,0,1,1
HND-013093,2011,150400028,,,,16,6,22
HND-013096,2011,150400046,,,,3,1,4
HND-013069,2011,150400001,,,,17,15,32
HND-013070,2011,150400002,,,,1,2,3
HND-013072,2011,150400005,,,,2,0,2
HND-013075,2011,150400008,,,,0,1,1
HND-013076,2011,150400009,,,,0,2,2
HND-013077,2011,150400010,,,,12,9,21
HND-013078,2011,150400011,,,,6,5,11
HND-013079,2011,150400012,,,,11,10,21
HND-013081,2011,150400014,,,,3,2,5
HND-013091,2011,150400025,,,,2,4,6
HND-013094,2011,150400029,,,,1,1,2
HND-013077,2011,150400010,,,,8,11,19
HND-013079,2011,150400012,,,,6,9,15
HND-013089,2011,150400023,,,,38,29,67
HND-013077,2011,150400010,,,,10,11,21
HND-013079,2011,150400012,,,,7,7,14
HND-013089,2011,150400023,,,,31,38,69
HND-013077,2011,150400010,,,,7,13,20
HND-013079,2011,150400012,,,,12,8,20
HND-013089,2011,150400023,,,,24,24,48
HND-013089,2011,150400023,,,,31,29,60
HND-013089,2011,150400023,,,,28,28,56
HND-013089,2011,150400023,,,,25,11,36
,2011,150500143,,,,6,5,11
HND-013209,2011,150500190,,,,4,3,7
HND-013210,2011,150500193,,,,2,8,10
,2011,150500195,,,,6,14,20
HND-013213,2011,150500197,,,,10,8,18
HND-013215,2011,150500202,,,,3,8,11
,2011,150500204,,,,6,4,10
,2011,150500208,,,,5,6,11
,2011,150500212,,,,3,7,10
,2011,150500215,,,,4,8,12
,2011,150500216,,,,4,9,13
,2011,150500219,,,,7,3,10
HND-013130,2011,150500036,,,,9,6,15
HND-013200,2011,150500140,,,,9,7,16
HND-013201,2011,150500144,,,,7,6,13
,2011,150500186,,,,4,6,10
HND-013208,2011,150500187,,,,3,8,11
,2011,150500188,,,,6,4,10
,2011,150500192,,,,7,4,11
,2011,150500203,,,,7,3,10
HND-013216,2011,150500206,,,,9,12,21
,2011,150500207,,,,6,6,12
HND-013217,2011,150500210,,,,6,4,10
,2011,150500211,,,,2,8,10
,2011,150500213,,,,9,4,13
,2011,150500214,,,,6,4,10
,2011,150500217,,,,3,8,11
,2011,150500218,,,,4,9,13
HND-013157,2011,150500072,,,,1,1,2
HND-013147,2011,150500057,,,,1,2,3
HND-013150,2011,150500060,,,,0,1,1
HND-013155,2011,150500068,,,,5,1,6
HND-013159,2011,150500074,,,,0,2,2
HND-013184,2011,150500106,,,,1,1,2
HND-013211,2011,150500194,,,,2,3,5
HND-013147,2011,150500057,,,,10,6,16
,2011,150500058,,,,2,7,9
HND-013149,2011,150500059,,,,5,3,8
,2011,150500066,,,,3,2,5
HND-013158,2011,150500073,,,,3,2,5
,2011,150500145,,,,1,3,4
,2011,150500189,,,,2,3,5
HND-013211,2011,150500194,,,,2,2,4
HND-013103,2011,150500009,,,,0,6,6
HND-013150,2011,150500060,,,,8,15,23
HND-013151,2011,150500061,,,,3,2,5
HND-013153,2011,150500064,,,,0,3,3
,2011,150500065,,,,1,9,10
HND-013155,2011,150500068,,,,4,4,8
HND-013156,2011,150500070,,,,0,2,2
HND-013157,2011,150500072,,,,4,4,8
HND-013159,2011,150500074,,,,5,3,8
HND-013184,2011,150500106,,,,2,7,9
HND-013214,2011,150500201,,,,5,3,8
,2011,150500209,,,,3,1,4
,2011,150500058,,,,6,8,14
HND-013151,2011,150500061,,,,10,6,16
,2011,150500066,,,,7,7,14
HND-013157,2011,150500072,,,,7,4,11
HND-013159,2011,150500074,,,,6,6,12
,2011,150500145,,,,11,9,20
,2011,150500189,,,,0,3,3
HND-013103,2011,150500009,,,,11,5,16
HND-013147,2011,150500057,,,,34,22,56
HND-013149,2011,150500059,,,,2,3,5
HND-013150,2011,150500060,,,,13,12,25
HND-013153,2011,150500064,,,,6,6,12
,2011,150500065,,,,6,0,6
HND-013155,2011,150500068,,,,1,1,2
HND-013156,2011,150500070,,,,9,7,16
HND-013158,2011,150500073,,,,6,4,10
HND-013184,2011,150500106,,,,14,18,32
HND-013211,2011,150500194,,,,3,6,9
HND-013214,2011,150500201,,,,6,3,9
,2011,150500209,,,,2,3,5
,2011,150500001,,,,13,6,19
HND-013098,2011,150500003,,,,1,3,4
HND-013101,2011,150500007,,,,6,3,9
HND-013105,2011,150500011,,,,9,6,15
HND-013107,2011,150500013,,,,5,3,8
HND-013110,2011,150500016,,,,5,10,15
HND-013111,2011,150500017,,,,2,3,5
HND-013113,2011,150500019,,,,5,6,11
HND-013116,2011,150500022,,,,27,24,51
,2011,150500025,,,,3,8,11
HND-013120,2011,150500026,,,,7,4,11
,2011,150500029,,,,5,6,11
HND-013125,2011,150500031,,,,8,6,14
HND-013127,2011,150500033,,,,7,8,15
HND-013130,2011,150500036,,,,12,10,22
HND-013131,2011,150500037,,,,2,4,6
HND-013135,2011,150500041,,,,6,7,13
HND-013136,2011,150500043,,,,3,1,4
HND-013138,2011,150500046,,,,4,6,10
HND-013139,2011,150500047,,,,3,7,10
HND-013141,2011,150500049,,,,11,7,18
HND-013142,2011,150500050,,,,7,5,12
,2011,150500052,,,,4,1,5
HND-013145,2011,150500055,,,,6,11,17
,2011,150500076,,,,2,2,4
HND-013162,2011,150500077,,,,6,6,12
,2011,150500079,,,,7,1,8
HND-013165,2011,150500080,,,,2,4,6
HND-013167,2011,150500082,,,,1,1,2
HND-013170,2011,150500088,,,,1,1,2
HND-013171,2011,150500090,,,,5,4,9
HND-013173,2011,150500092,,,,2,10,12
HND-013175,2011,150500094,,,,4,2,6
HND-013176,2011,150500098,,,,3,4,7
HND-013179,2011,150500101,,,,4,0,4
,2011,150500105,,,,3,3,6
HND-013186,2011,150500110,,,,5,8,13
HND-013188,2011,150500112,,,,3,2,5
,2011,150500114,,,,4,6,10
HND-013190,2011,150500116,,,,3,1,4
HND-013191,2011,150500117,,,,5,4,9
HND-013192,2011,150500118,,,,3,2,5
HND-013197,2011,150500128,,,,8,7,15
HND-013205,2011,150500183,,,,21,12,33
HND-013219,2011,150500220,,,,4,7,11
,2011,150500222,,,,2,5,7
HND-013097,2011,150500002,,,,0,1,1
HND-013099,2011,150500004,,,,35,31,66
HND-013100,2011,150500005,,,,3,1,4
HND-013102,2011,150500008,,,,7,5,12
HND-013103,2011,150500009,,,,9,8,17
HND-013104,2011,150500010,,,,8,1,9
HND-013106,2011,150500012,,,,1,0,1
HND-013108,2011,150500014,,,,5,5,10
HND-013109,2011,150500015,,,,3,4,7
HND-013112,2011,150500018,,,,4,1,5
HND-013114,2011,150500020,,,,8,6,14
HND-013115,2011,150500021,,,,4,1,5
HND-013117,2011,150500023,,,,12,10,22
HND-013118,2011,150500024,,,,1,0,1
HND-013121,2011,150500027,,,,8,8,16
HND-013122,2011,150500028,,,,7,7,14
HND-013124,2011,150500030,,,,2,0,2
HND-013126,2011,150500032,,,,12,9,21
,2011,150500034,,,,5,2,7
HND-013129,2011,150500035,,,,2,4,6
HND-013132,2011,150500038,,,,6,9,15
HND-013133,2011,150500039,,,,5,7,12
HND-013134,2011,150500040,,,,6,4,10
HND-013137,2011,150500045,,,,4,1,5
HND-013140,2011,150500048,,,,7,5,12
,2011,150500051,,,,7,10,17
HND-013146,2011,150500056,,,,2,1,3
HND-013160,2011,150500075,,,,6,3,9
HND-013163,2011,150500078,,,,3,2,5
HND-013166,2011,150500081,,,,4,4,8
HND-013168,2011,150500083,,,,5,6,11
HND-013169,2011,150500086,,,,6,5,11
HND-013177,2011,150500099,,,,6,8,14
HND-013180,2011,150500102,,,,7,9,16
HND-013181,2011,150500103,,,,3,1,4
HND-013182,2011,150500104,,,,5,2,7
HND-013185,2011,150500108,,,,11,14,25
HND-013187,2011,150500111,,,,3,3,6
HND-013189,2011,150500115,,,,3,2,5
HND-013193,2011,150500121,,,,8,9,17
,2011,150500125,,,,3,0,3
,2011,150500126,,,,3,9,12
HND-013196,2011,150500127,,,,5,6,11
HND-013198,2011,150500129,,,,1,2,3
,2011,150500130,,,,7,3,10
HND-013202,2011,150500177,,,,12,5,17
HND-013203,2011,150500178,,,,9,4,13
HND-013206,2011,150500184,,,,0,3,3
HND-013207,2011,150500185,,,,3,6,9
HND-013220,2011,150500221,,,,3,3,6
HND-013221,2011,150500223,,,,3,4,7
HND-013222,2011,150500224,,,,2,3,5
HND-013223,2011,150500225,,,,6,7,13
HND-013224,2011,150500226,,,,4,7,11
,2011,150500227,,,,12,1,13
,2011,150500001,,,,11,10,21
HND-013097,2011,150500002,,,,3,2,5
HND-013098,2011,150500003,,,,1,2,3
HND-013101,2011,150500007,,,,2,1,3
HND-013102,2011,150500008,,,,4,4,8
HND-013104,2011,150500010,,,,5,6,11
HND-013105,2011,150500011,,,,9,6,15
HND-013107,2011,150500013,,,,1,0,1
HND-013108,2011,150500014,,,,6,11,17
HND-013110,2011,150500016,,,,6,7,13
HND-013111,2011,150500017,,,,3,3,6
HND-013112,2011,150500018,,,,0,2,2
HND-013117,2011,150500023,,,,6,10,16
HND-013120,2011,150500026,,,,8,4,12
HND-013121,2011,150500027,,,,4,5,9
,2011,150500029,,,,8,9,17
HND-013129,2011,150500035,,,,2,2,4
HND-013130,2011,150500036,,,,12,13,25
HND-013133,2011,150500039,,,,6,7,13
HND-013137,2011,150500045,,,,5,3,8
HND-013138,2011,150500046,,,,1,2,3
HND-013142,2011,150500050,,,,8,9,17
,2011,150500051,,,,7,9,16
HND-013146,2011,150500056,,,,4,5,9
HND-013160,2011,150500075,,,,3,5,8
,2011,150500079,,,,5,2,7
HND-013165,2011,150500080,,,,2,3,5
HND-013166,2011,150500081,,,,2,0,2
HND-013167,2011,150500082,,,,2,1,3
HND-013168,2011,150500083,,,,3,3,6
HND-013170,2011,150500088,,,,2,1,3
HND-013171,2011,150500090,,,,6,1,7
HND-013172,2011,150500091,,,,1,3,4
HND-013175,2011,150500094,,,,5,2,7
HND-013176,2011,150500098,,,,7,2,9
HND-013179,2011,150500101,,,,3,1,4
,2011,150500107,,,,14,10,24
HND-013186,2011,150500110,,,,3,3,6
,2011,150500114,,,,3,2,5
HND-013189,2011,150500115,,,,4,4,8
HND-013190,2011,150500116,,,,1,1,2
HND-013191,2011,150500117,,,,5,5,10
HND-013192,2011,150500118,,,,2,0,2
,2011,150500125,,,,4,2,6
HND-013197,2011,150500128,,,,4,3,7
HND-013198,2011,150500129,,,,6,1,7
HND-013206,2011,150500184,,,,7,3,10
HND-013222,2011,150500224,,,,3,2,5
HND-013224,2011,150500226,,,,1,2,3
HND-013099,2011,150500004,,,,24,35,59
HND-013100,2011,150500005,,,,2,1,3
HND-013103,2011,150500009,,,,5,17,22
HND-013106,2011,150500012,,,,5,5,10
HND-013109,2011,150500015,,,,4,6,10
HND-013113,2011,150500019,,,,6,7,13
HND-013114,2011,150500020,,,,5,7,12
HND-013115,2011,150500021,,,,2,1,3
HND-013116,2011,150500022,,,,18,15,33
HND-013118,2011,150500024,,,,1,1,2
,2011,150500025,,,,8,5,13
HND-013122,2011,150500028,,,,5,6,11
HND-013124,2011,150500030,,,,2,1,3
HND-013125,2011,150500031,,,,4,8,12
HND-013126,2011,150500032,,,,7,6,13
HND-013127,2011,150500033,,,,12,8,20
,2011,150500034,,,,3,2,5
HND-013131,2011,150500037,,,,11,5,16
HND-013132,2011,150500038,,,,7,4,11
HND-013134,2011,150500040,,,,4,5,9
HND-013135,2011,150500041,,,,4,3,7
HND-013136,2011,150500043,,,,3,1,4
HND-013139,2011,150500047,,,,7,7,14
HND-013140,2011,150500048,,,,7,3,10
HND-013141,2011,150500049,,,,11,10,21
,2011,150500052,,,,3,4,7
HND-013145,2011,150500055,,,,7,10,17
,2011,150500076,,,,9,10,19
HND-013163,2011,150500078,,,,7,3,10
HND-013169,2011,150500086,,,,3,2,5
HND-013173,2011,150500092,,,,5,2,7
HND-013177,2011,150500099,,,,6,6,12
HND-013180,2011,150500102,,,,8,4,12
HND-013181,2011,150500103,,,,1,1,2
HND-013182,2011,150500104,,,,4,7,11
,2011,150500105,,,,1,3,4
HND-013185,2011,150500108,,,,8,13,21
HND-013187,2011,150500111,,,,3,6,9
HND-013188,2011,150500112,,,,1,0,1
HND-013193,2011,150500121,,,,3,0,3
,2011,150500126,,,,3,4,7
HND-013196,2011,150500127,,,,3,2,5
,2011,150500130,,,,3,0,3
HND-013202,2011,150500177,,,,9,6,15
HND-013203,2011,150500178,,,,4,4,8
HND-013205,2011,150500183,,,,0,4,4
HND-013207,2011,150500185,,,,3,3,6
HND-013219,2011,150500220,,,,2,4,6
HND-013220,2011,150500221,,,,3,4,7
HND-013221,2011,150500223,,,,4,0,4
HND-013223,2011,150500225,,,,5,6,11
,2011,150500227,,,,1,1,2
,2011,150500001,,,,6,5,11
HND-013098,2011,150500003,,,,2,0,2
HND-013101,2011,150500007,,,,2,3,5
HND-013105,2011,150500011,,,,7,8,15
HND-013107,2011,150500013,,,,0,1,1
HND-013110,2011,150500016,,,,7,11,18
HND-013111,2011,150500017,,,,6,4,10
HND-013113,2011,150500019,,,,9,11,20
,2011,150500025,,,,5,6,11
HND-013120,2011,150500026,,,,10,8,18
,2011,150500029,,,,0,6,6
HND-013124,2011,150500030,,,,1,4,5
HND-013126,2011,150500032,,,,11,5,16
HND-013129,2011,150500035,,,,4,6,10
HND-013132,2011,150500038,,,,4,3,7
HND-013133,2011,150500039,,,,4,6,10
HND-013134,2011,150500040,,,,5,6,11
HND-013137,2011,150500045,,,,4,3,7
HND-013140,2011,150500048,,,,4,4,8
,2011,150500051,,,,5,7,12
HND-013146,2011,150500056,,,,6,4,10
HND-013160,2011,150500075,,,,4,6,10
HND-013163,2011,150500078,,,,8,14,22
HND-013166,2011,150500081,,,,5,5,10
HND-013168,2011,150500083,,,,0,1,1
HND-013169,2011,150500086,,,,5,2,7
HND-013172,2011,150500091,,,,1,1,2
HND-013180,2011,150500102,,,,3,10,13
HND-013181,2011,150500103,,,,5,5,10
HND-013182,2011,150500104,,,,6,3,9
HND-013185,2011,150500108,,,,13,11,24
HND-013187,2011,150500111,,,,3,2,5
HND-013189,2011,150500115,,,,4,4,8
HND-013193,2011,150500121,,,,10,9,19
,2011,150500125,,,,3,7,10
,2011,150500126,,,,4,1,5
HND-013196,2011,150500127,,,,3,3,6
HND-013198,2011,150500129,,,,2,1,3
HND-013202,2011,150500177,,,,6,5,11
HND-013203,2011,150500178,,,,7,3,10
HND-013206,2011,150500184,,,,7,3,10
HND-013207,2011,150500185,,,,0,4,4
HND-013219,2011,150500220,,,,3,2,5
,2011,150500222,,,,2,1,3
HND-013097,2011,150500002,,,,3,2,5
HND-013099,2011,150500004,,,,39,36,75
HND-013100,2011,150500005,,,,3,3,6
HND-013102,2011,150500008,,,,7,3,10
HND-013103,2011,150500009,,,,12,8,20
HND-013104,2011,150500010,,,,2,7,9
HND-013106,2011,150500012,,,,3,1,4
HND-013108,2011,150500014,,,,14,5,19
HND-013109,2011,150500015,,,,6,3,9
HND-013112,2011,150500018,,,,5,9,14
HND-013114,2011,150500020,,,,7,10,17
HND-013115,2011,150500021,,,,0,2,2
HND-013116,2011,150500022,,,,24,25,49
HND-013117,2011,150500023,,,,9,13,22
HND-013118,2011,150500024,,,,2,0,2
HND-013121,2011,150500027,,,,7,4,11
HND-013122,2011,150500028,,,,10,8,18
HND-013125,2011,150500031,,,,4,3,7
HND-013127,2011,150500033,,,,9,12,21
HND-013130,2011,150500036,,,,13,8,21
HND-013131,2011,150500037,,,,5,2,7
HND-013135,2011,150500041,,,,0,1,1
HND-013136,2011,150500043,,,,2,1,3
HND-013138,2011,150500046,,,,3,2,5
HND-013139,2011,150500047,,,,10,4,14
HND-013141,2011,150500049,,,,12,9,21
HND-013142,2011,150500050,,,,4,12,16
,2011,150500052,,,,5,3,8
HND-013145,2011,150500055,,,,6,2,8
,2011,150500076,,,,5,4,9
HND-013162,2011,150500077,,,,1,5,6
,2011,150500079,,,,5,1,6
HND-013165,2011,150500080,,,,0,2,2
HND-013167,2011,150500082,,,,1,0,1
HND-013170,2011,150500088,,,,2,0,2
HND-013171,2011,150500090,,,,2,1,3
HND-013173,2011,150500092,,,,3,0,3
HND-013175,2011,150500094,,,,5,2,7
HND-013176,2011,150500098,,,,10,7,17
HND-013177,2011,150500099,,,,3,1,4
HND-013179,2011,150500101,,,,2,5,7
,2011,150500105,,,,1,0,1
HND-013186,2011,150500110,,,,1,5,6
HND-013188,2011,150500112,,,,0,2,2
,2011,150500114,,,,2,1,3
HND-013190,2011,150500116,,,,2,2,4
HND-013191,2011,150500117,,,,2,0,2
HND-013192,2011,150500118,,,,0,4,4
HND-013197,2011,150500128,,,,3,1,4
HND-013205,2011,150500183,,,,0,2,2
HND-013220,2011,150500221,,,,3,0,3
HND-013221,2011,150500223,,,,2,3,5
HND-013222,2011,150500224,,,,1,2,3
HND-013223,2011,150500225,,,,5,3,8
HND-013224,2011,150500226,,,,1,2,3
,2011,150500227,,,,1,0,1
,2011,150500001,,,,1,5,6
HND-013097,2011,150500002,,,,3,3,6
HND-013102,2011,150500008,,,,4,5,9
HND-013104,2011,150500010,,,,2,7,9
HND-013105,2011,150500011,,,,3,3,6
HND-013106,2011,150500012,,,,3,1,4
HND-013108,2011,150500014,,,,8,2,10
HND-013111,2011,150500017,,,,2,0,2
HND-013112,2011,150500018,,,,6,2,8
HND-013115,2011,150500021,,,,1,4,5
HND-013117,2011,150500023,,,,14,16,30
HND-013120,2011,150500026,,,,6,6,12
HND-013121,2011,150500027,,,,5,3,8
HND-013127,2011,150500033,,,,7,2,9
HND-013130,2011,150500036,,,,3,6,9
HND-013131,2011,150500037,,,,6,7,13
HND-013133,2011,150500039,,,,2,14,16
HND-013136,2011,150500043,,,,0,3,3
HND-013137,2011,150500045,,,,3,0,3
HND-013138,2011,150500046,,,,3,5,8
HND-013142,2011,150500050,,,,8,6,14
,2011,150500051,,,,10,6,16
,2011,150500052,,,,4,5,9
HND-013160,2011,150500075,,,,5,4,9
,2011,150500076,,,,4,3,7
,2011,150500079,,,,2,2,4
HND-013165,2011,150500080,,,,2,0,2
HND-013166,2011,150500081,,,,1,1,2
HND-013167,2011,150500082,,,,1,1,2
HND-013170,2011,150500088,,,,3,1,4
HND-013171,2011,150500090,,,,3,1,4
HND-013172,2011,150500091,,,,2,0,2
HND-013173,2011,150500092,,,,5,2,7
HND-013175,2011,150500094,,,,2,1,3
HND-013176,2011,150500098,,,,8,7,15
HND-013179,2011,150500101,,,,2,0,2
HND-013180,2011,150500102,,,,7,5,12
HND-013187,2011,150500111,,,,3,5,8
HND-013189,2011,150500115,,,,8,3,11
HND-013191,2011,150500117,,,,0,5,5
HND-013193,2011,150500121,,,,15,11,26
,2011,150500125,,,,2,5,7
HND-013197,2011,150500128,,,,6,4,10
HND-013198,2011,150500129,,,,2,4,6
HND-013205,2011,150500183,,,,0,1,1
HND-013221,2011,150500223,,,,3,5,8
HND-013222,2011,150500224,,,,3,0,3
HND-013224,2011,150500226,,,,0,1,1
HND-013098,2011,150500003,,,,1,1,2
HND-013099,2011,150500004,,,,32,34,66
HND-013100,2011,150500005,,,,2,1,3
HND-013101,2011,150500007,,,,1,3,4
HND-013103,2011,150500009,,,,11,9,20
HND-013107,2011,150500013,,,,0,2,2
HND-013109,2011,150500015,,,,1,3,4
HND-013110,2011,150500016,,,,3,2,5
HND-013113,2011,150500019,,,,7,5,12
HND-013114,2011,150500020,,,,4,4,8
HND-013116,2011,150500022,,,,27,26,53
HND-013118,2011,150500024,,,,1,3,4
,2011,150500025,,,,7,8,15
HND-013122,2011,150500028,,,,3,10,13
,2011,150500029,,,,1,8,9
HND-013124,2011,150500030,,,,1,2,3
HND-013125,2011,150500031,,,,5,3,8
HND-013126,2011,150500032,,,,8,11,19
HND-013129,2011,150500035,,,,2,0,2
HND-013132,2011,150500038,,,,4,3,7
HND-013134,2011,150500040,,,,3,2,5
HND-013135,2011,150500041,,,,5,1,6
HND-013139,2011,150500047,,,,4,6,10
HND-013140,2011,150500048,,,,1,1,2
HND-013141,2011,150500049,,,,6,10,16
HND-013145,2011,150500055,,,,9,8,17
HND-013146,2011,150500056,,,,2,2,4
HND-013162,2011,150500077,,,,5,9,14
HND-013163,2011,150500078,,,,6,4,10
HND-013168,2011,150500083,,,,7,1,8
HND-013169,2011,150500086,,,,3,2,5
HND-013177,2011,150500099,,,,3,5,8
HND-013181,2011,150500103,,,,1,2,3
HND-013182,2011,150500104,,,,3,5,8
,2011,150500105,,,,1,0,1
,2011,150500107,,,,9,5,14
HND-013185,2011,150500108,,,,14,9,23
HND-013186,2011,150500110,,,,4,4,8
HND-013188,2011,150500112,,,,1,1,2
,2011,150500114,,,,2,3,5
HND-013190,2011,150500116,,,,1,2,3
HND-013192,2011,150500118,,,,5,1,6
,2011,150500126,,,,2,4,6
HND-013196,2011,150500127,,,,0,5,5
,2011,150500130,,,,0,1,1
HND-013202,2011,150500177,,,,7,4,11
HND-013203,2011,150500178,,,,5,3,8
HND-013206,2011,150500184,,,,2,0,2
HND-013219,2011,150500220,,,,2,1,3
HND-013220,2011,150500221,,,,2,1,3
,2011,150500222,,,,3,0,3
HND-013223,2011,150500225,,,,2,5,7
HND-013097,2011,150500002,,,,5,1,6
HND-013099,2011,150500004,,,,35,44,79
HND-013100,2011,150500005,,,,2,0,2
HND-013102,2011,150500008,,,,5,4,9
HND-013104,2011,150500010,,,,4,6,10
HND-013105,2011,150500011,,,,6,4,10
HND-013106,2011,150500012,,,,1,3,4
HND-013108,2011,150500014,,,,5,5,10
HND-013109,2011,150500015,,,,4,6,10
HND-013112,2011,150500018,,,,1,3,4
HND-013114,2011,150500020,,,,4,4,8
HND-013115,2011,150500021,,,,2,2,4
HND-013117,2011,150500023,,,,9,10,19
HND-013118,2011,150500024,,,,1,3,4
HND-013120,2011,150500026,,,,9,5,14
HND-013121,2011,150500027,,,,6,4,10
HND-013125,2011,150500031,,,,6,7,13
HND-013127,2011,150500033,,,,6,7,13
HND-013130,2011,150500036,,,,5,6,11
HND-013131,2011,150500037,,,,3,2,5
HND-013133,2011,150500039,,,,3,2,5
HND-013135,2011,150500041,,,,2,3,5
HND-013138,2011,150500046,,,,3,4,7
HND-013139,2011,150500047,,,,6,5,11
HND-013141,2011,150500049,,,,10,4,14
HND-013142,2011,150500050,,,,4,3,7
,2011,150500051,,,,8,5,13
,2011,150500052,,,,4,3,7
HND-013145,2011,150500055,,,,6,10,16
,2011,150500076,,,,3,2,5
HND-013162,2011,150500077,,,,4,4,8
,2011,150500079,,,,1,2,3
HND-013165,2011,150500080,,,,4,2,6
HND-013167,2011,150500082,,,,3,2,5
HND-013170,2011,150500088,,,,1,1,2
HND-013171,2011,150500090,,,,2,2,4
HND-013172,2011,150500091,,,,1,2,3
HND-013173,2011,150500092,,,,3,3,6
HND-013175,2011,150500094,,,,1,4,5
HND-013176,2011,150500098,,,,3,5,8
HND-013179,2011,150500101,,,,1,1,2
HND-013180,2011,150500102,,,,8,9,17
HND-013182,2011,150500104,,,,3,1,4
HND-013187,2011,150500111,,,,2,1,3
HND-013189,2011,150500115,,,,3,2,5
HND-013193,2011,150500121,,,,2,4,6
,2011,150500125,,,,0,1,1
,2011,150500126,,,,2,1,3
HND-013196,2011,150500127,,,,1,2,3
HND-013198,2011,150500129,,,,2,0,2
HND-013220,2011,150500221,,,,0,3,3
HND-013221,2011,150500223,,,,6,1,7
HND-013222,2011,150500224,,,,3,0,3
HND-013223,2011,150500225,,,,0,4,4
HND-013224,2011,150500226,,,,1,0,1
,2011,150500001,,,,5,6,11
HND-013098,2011,150500003,,,,1,4,5
HND-013103,2011,150500009,,,,5,11,16
HND-013107,2011,150500013,,,,6,1,7
HND-013110,2011,150500016,,,,10,6,16
HND-013111,2011,150500017,,,,3,5,8
HND-013113,2011,150500019,,,,13,8,21
HND-013116,2011,150500022,,,,17,18,35
,2011,150500025,,,,13,9,22
HND-013122,2011,150500028,,,,5,3,8
,2011,150500029,,,,1,4,5
HND-013124,2011,150500030,,,,1,1,2
HND-013126,2011,150500032,,,,8,7,15
,2011,150500034,,,,1,1,2
HND-013129,2011,150500035,,,,1,7,8
HND-013132,2011,150500038,,,,1,3,4
HND-013134,2011,150500040,,,,4,7,11
HND-013137,2011,150500045,,,,2,4,6
HND-013140,2011,150500048,,,,5,4,9
HND-013146,2011,150500056,,,,3,4,7
HND-013160,2011,150500075,,,,4,3,7
HND-013163,2011,150500078,,,,4,1,5
HND-013166,2011,150500081,,,,6,1,7
HND-013169,2011,150500086,,,,5,7,12
HND-013177,2011,150500099,,,,1,3,4
HND-013181,2011,150500103,,,,2,0,2
,2011,150500105,,,,0,1,1
HND-013185,2011,150500108,,,,9,14,23
HND-013186,2011,150500110,,,,2,3,5
HND-013188,2011,150500112,,,,1,1,2
,2011,150500114,,,,1,1,2
HND-013190,2011,150500116,,,,2,2,4
HND-013191,2011,150500117,,,,0,3,3
HND-013192,2011,150500118,,,,4,1,5
HND-013197,2011,150500128,,,,2,0,2
,2011,150500130,,,,1,3,4
HND-013202,2011,150500177,,,,3,5,8
HND-013203,2011,150500178,,,,5,4,9
HND-013206,2011,150500184,,,,2,3,5
HND-013207,2011,150500185,,,,1,2,3
HND-013219,2011,150500220,,,,2,0,2
,2011,150500222,,,,2,0,2
HND-013099,2011,150500004,,,,42,33,75
HND-013100,2011,150500005,,,,1,3,4
HND-013103,2011,150500009,,,,3,10,13
HND-013106,2011,150500012,,,,4,0,4
HND-013109,2011,150500015,,,,1,2,3
HND-013113,2011,150500019,,,,5,5,10
HND-013114,2011,150500020,,,,2,2,4
HND-013115,2011,150500021,,,,4,1,5
HND-013116,2011,150500022,,,,16,17,33
HND-013118,2011,150500024,,,,3,1,4
,2011,150500025,,,,8,7,15
HND-013122,2011,150500028,,,,5,4,9
HND-013124,2011,150500030,,,,1,5,6
HND-013125,2011,150500031,,,,5,2,7
HND-013126,2011,150500032,,,,8,6,14
HND-013127,2011,150500033,,,,12,9,21
HND-013131,2011,150500037,,,,2,5,7
HND-013132,2011,150500038,,,,2,4,6
HND-013134,2011,150500040,,,,3,3,6
HND-013135,2011,150500041,,,,2,0,2
HND-013136,2011,150500043,,,,3,3,6
HND-013139,2011,150500047,,,,4,8,12
HND-013140,2011,150500048,,,,1,4,5
HND-013141,2011,150500049,,,,9,11,20
,2011,150500052,,,,1,4,5
HND-013145,2011,150500055,,,,7,8,15
,2011,150500076,,,,4,5,9
HND-013162,2011,150500077,,,,1,0,1
HND-013163,2011,150500078,,,,1,4,5
HND-013169,2011,150500086,,,,3,3,6
HND-013173,2011,150500092,,,,2,2,4
HND-013177,2011,150500099,,,,1,1,2
HND-013180,2011,150500102,,,,3,9,12
HND-013181,2011,150500103,,,,3,1,4
HND-013182,2011,150500104,,,,1,4,5
HND-013185,2011,150500108,,,,15,12,27
HND-013187,2011,150500111,,,,4,2,6
HND-013188,2011,150500112,,,,2,0,2
HND-013193,2011,150500121,,,,0,1,1
HND-013196,2011,150500127,,,,0,2,2
,2011,150500130,,,,0,3,3
HND-013202,2011,150500177,,,,1,1,2
HND-013203,2011,150500178,,,,4,3,7
HND-013207,2011,150500185,,,,0,2,2
,2011,150500222,,,,0,2,2
HND-013221,2011,150500223,,,,4,0,4
HND-013223,2011,150500225,,,,2,0,2
,2011,150500001,,,,10,6,16
HND-013097,2011,150500002,,,,2,0,2
HND-013098,2011,150500003,,,,1,1,2
HND-013101,2011,150500007,,,,0,1,1
HND-013102,2011,150500008,,,,4,3,7
HND-013104,2011,150500010,,,,8,9,17
HND-013105,2011,150500011,,,,6,4,10
HND-013107,2011,150500013,,,,1,0,1
HND-013108,2011,150500014,,,,5,6,11
HND-013110,2011,150500016,,,,13,12,25
HND-013111,2011,150500017,,,,0,1,1
HND-013112,2011,150500018,,,,5,3,8
HND-013117,2011,150500023,,,,13,9,22
HND-013120,2011,150500026,,,,5,8,13
HND-013121,2011,150500027,,,,4,4,8
,2011,150500029,,,,5,4,9
HND-013129,2011,150500035,,,,4,6,10
HND-013130,2011,150500036,,,,10,4,14
HND-013133,2011,150500039,,,,4,12,16
HND-013137,2011,150500045,,,,4,2,6
HND-013138,2011,150500046,,,,6,4,10
HND-013142,2011,150500050,,,,1,6,7
,2011,150500051,,,,1,5,6
HND-013146,2011,150500056,,,,3,2,5
HND-013160,2011,150500075,,,,4,0,4
,2011,150500079,,,,1,4,5
HND-013165,2011,150500080,,,,2,1,3
HND-013166,2011,150500081,,,,2,1,3
HND-013167,2011,150500082,,,,2,0,2
HND-013168,2011,150500083,,,,1,0,1
HND-013170,2011,150500088,,,,1,0,1
HND-013171,2011,150500090,,,,3,1,4
HND-013172,2011,150500091,,,,1,3,4
HND-013175,2011,150500094,,,,2,4,6
HND-013176,2011,150500098,,,,7,4,11
HND-013179,2011,150500101,,,,2,2,4
,2011,150500105,,,,1,1,2
,2011,150500107,,,,8,6,14
HND-013186,2011,150500110,,,,4,3,7
HND-013189,2011,150500115,,,,7,1,8
HND-013190,2011,150500116,,,,4,0,4
HND-013191,2011,150500117,,,,2,0,2
HND-013192,2011,150500118,,,,1,2,3
,2011,150500125,,,,2,0,2
HND-013197,2011,150500128,,,,1,3,4
HND-013198,2011,150500129,,,,2,2,4
HND-013206,2011,150500184,,,,0,1,1
HND-013222,2011,150500224,,,,0,1,1
HND-013224,2011,150500226,,,,1,0,1
HND-013103,2011,150500009,,,,8,13,21
HND-013110,2011,150500016,,,,11,16,27
HND-013116,2011,150500022,,,,24,13,37
,2011,150500107,,,,50,53,103
HND-013185,2011,150500108,,,,10,21,31
HND-013112,2011,150500018,,,,6,9,15
HND-013117,2011,150500023,,,,6,9,15
HND-013152,2011,150500063,,,,69,53,122
HND-013110,2011,150500016,,,,20,10,30
HND-013112,2011,150500018,,,,5,4,9
HND-013117,2011,150500023,,,,5,7,12
HND-013152,2011,150500063,,,,35,58,93
,2011,150500107,,,,38,63,101
HND-013103,2011,150500009,,,,7,11,18
HND-013116,2011,150500022,,,,9,15,24
HND-013185,2011,150500108,,,,3,10,13
HND-013112,2011,150500018,,,,8,9,17
HND-013117,2011,150500023,,,,0,6,6
,2011,150500107,,,,42,38,80
HND-013103,2011,150500009,,,,3,13,16
HND-013110,2011,150500016,,,,8,8,16
HND-013116,2011,150500022,,,,14,15,29
HND-013152,2011,150500063,,,,37,57,94
HND-013185,2011,150500108,,,,5,9,14
HND-013152,2011,150500063,,,,43,51,94
,2011,150500107,,,,35,56,91
,2011,150500107,,,,21,33,54
HND-013152,2011,150500063,,,,39,30,69
HND-013152,2011,150500063,,,,35,45,80
HND-013242,2011,150600048,,,,5,5,10
HND-013243,2011,150600050,,,,5,7,12
HND-013245,2011,150600052,,,,5,5,10
HND-013248,2011,150600055,,,,7,3,10
HND-013251,2011,150600058,,,,4,6,10
HND-013254,2011,150600062,,,,4,6,10
HND-013256,2011,150600065,,,,6,4,10
HND-013259,2011,150600068,,,,8,1,9
HND-013265,2011,150600074,,,,7,4,11
,2011,150600075,,,,6,4,10
HND-013238,2011,150600016,,,,12,8,20
HND-013244,2011,150600051,,,,6,4,10
HND-013246,2011,150600053,,,,6,5,11
HND-013249,2011,150600056,,,,4,6,10
HND-013250,2011,150600057,,,,4,7,11
HND-013252,2011,150600059,,,,5,5,10
HND-013253,2011,150600060,,,,6,5,11
,2011,150600061,,,,3,7,10
HND-013255,2011,150600063,,,,7,3,10
HND-013257,2011,150600066,,,,6,4,10
HND-013258,2011,150600067,,,,7,3,10
HND-013266,2011,150600076,,,,8,3,11
HND-013235,2011,150600011,,,,20,15,35
HND-013229,2011,150600004,,,,9,15,24
HND-013230,2011,150600005,,,,6,4,10
HND-013233,2011,150600008,,,,4,1,5
HND-013240,2011,150600037,,,,4,0,4
HND-013241,2011,150600038,,,,4,1,5
HND-013252,2011,150600059,,,,6,4,10
HND-013264,2011,150600073,,,,4,9,13
HND-013227,2011,150600001,,,,12,6,18
HND-013228,2011,150600003,,,,10,6,16
HND-013231,2011,150600006,,,,7,9,16
HND-013232,2011,150600007,,,,3,3,6
HND-013234,2011,150600009,,,,3,4,7
HND-013236,2011,150600012,,,,0,2,2
HND-013239,2011,150600036,,,,5,2,7
HND-013247,2011,150600054,,,,3,4,7
HND-013263,2011,150600072,,,,0,1,1
HND-013229,2011,150600004,,,,17,15,32
HND-013230,2011,150600005,,,,9,13,22
HND-013234,2011,150600009,,,,4,2,6
HND-013239,2011,150600036,,,,3,3,6
HND-013240,2011,150600037,,,,3,1,4
HND-013263,2011,150600072,,,,0,5,5
HND-013227,2011,150600001,,,,11,11,22
HND-013228,2011,150600003,,,,10,6,16
HND-013231,2011,150600006,,,,9,5,14
HND-013232,2011,150600007,,,,1,4,5
HND-013233,2011,150600008,,,,2,4,6
HND-013236,2011,150600012,,,,3,0,3
HND-013241,2011,150600038,,,,3,5,8
HND-013247,2011,150600054,,,,3,1,4
HND-013252,2011,150600059,,,,2,3,5
HND-013264,2011,150600073,,,,5,8,13
HND-013229,2011,150600004,,,,11,14,25
HND-013230,2011,150600005,,,,9,9,18
HND-013233,2011,150600008,,,,4,6,10
HND-013239,2011,150600036,,,,4,1,5
HND-013247,2011,150600054,,,,2,1,3
HND-013263,2011,150600072,,,,4,0,4
HND-013227,2011,150600001,,,,9,8,17
HND-013228,2011,150600003,,,,7,6,13
HND-013231,2011,150600006,,,,8,6,14
HND-013232,2011,150600007,,,,8,7,15
HND-013234,2011,150600009,,,,2,6,8
HND-013236,2011,150600012,,,,4,1,5
HND-013240,2011,150600037,,,,4,4,8
HND-013241,2011,150600038,,,,7,2,9
HND-013252,2011,150600059,,,,7,12,19
HND-013264,2011,150600073,,,,9,4,13
HND-013228,2011,150600003,,,,4,4,8
HND-013229,2011,150600004,,,,15,17,32
HND-013230,2011,150600005,,,,4,7,11
HND-013231,2011,150600006,,,,6,6,12
HND-013234,2011,150600009,,,,2,1,3
HND-013239,2011,150600036,,,,3,2,5
HND-013240,2011,150600037,,,,0,1,1
HND-013263,2011,150600072,,,,3,3,6
HND-013227,2011,150600001,,,,4,4,8
HND-013232,2011,150600007,,,,6,6,12
HND-013233,2011,150600008,,,,3,1,4
HND-013236,2011,150600012,,,,4,0,4
HND-013241,2011,150600038,,,,6,1,7
HND-013247,2011,150600054,,,,3,1,4
HND-013252,2011,150600059,,,,2,7,9
HND-013264,2011,150600073,,,,11,6,17
HND-013228,2011,150600003,,,,8,3,11
HND-013229,2011,150600004,,,,26,24,50
HND-013231,2011,150600006,,,,6,9,15
HND-013232,2011,150600007,,,,5,4,9
HND-013234,2011,150600009,,,,4,1,5
HND-013239,2011,150600036,,,,1,1,2
HND-013240,2011,150600037,,,,1,0,1
HND-013241,2011,150600038,,,,3,2,5
HND-013227,2011,150600001,,,,2,4,6
HND-013230,2011,150600005,,,,7,4,11
HND-013233,2011,150600008,,,,3,4,7
HND-013236,2011,150600012,,,,2,4,6
HND-013247,2011,150600054,,,,5,0,5
HND-013252,2011,150600059,,,,3,3,6
HND-013263,2011,150600072,,,,0,7,7
HND-013264,2011,150600073,,,,6,2,8
HND-013227,2011,150600001,,,,8,13,21
HND-013228,2011,150600003,,,,11,1,12
HND-013231,2011,150600006,,,,6,7,13
HND-013232,2011,150600007,,,,3,1,4
HND-013233,2011,150600008,,,,0,1,1
HND-013236,2011,150600012,,,,4,4,8
HND-013241,2011,150600038,,,,5,1,6
HND-013247,2011,150600054,,,,0,3,3
HND-013252,2011,150600059,,,,1,1,2
HND-013264,2011,150600073,,,,5,2,7
HND-013229,2011,150600004,,,,13,13,26
HND-013230,2011,150600005,,,,3,8,11
HND-013234,2011,150600009,,,,5,1,6
HND-013239,2011,150600036,,,,3,2,5
HND-013263,2011,150600072,,,,2,0,2
HND-013231,2011,150600006,,,,6,5,11
HND-013237,2011,150600013,,,,42,38,80
HND-013237,2011,150600013,,,,22,29,51
HND-013231,2011,150600006,,,,3,6,9
HND-013231,2011,150600006,,,,2,2,4
HND-013237,2011,150600013,,,,33,28,61
HND-013237,2011,150600013,,,,31,22,53
HND-013237,2011,150600013,,,,29,24,53
HND-013237,2011,150600013,,,,8,20,28
,2011,150700038,,,,12,5,17
,2011,150700075,,,,3,4,7
,2011,150700079,,,,2,6,8
HND-013308,2011,150700086,,,,2,3,5
,2011,150700090,,,,0,5,5
,2011,150700094,,,,3,3,6
,2011,150700039,,,,3,3,6
,2011,150700040,,,,6,6,12
HND-013301,2011,150700041,,,,6,8,14
,2011,150700042,,,,8,3,11
,2011,150700044,,,,4,4,8
,2011,150700074,,,,3,3,6
HND-013302,2011,150700076,,,,2,3,5
,2011,150700077,,,,5,7,12
,2011,150700078,,,,3,4,7
,2011,150700085,,,,3,4,7
,2011,150700088,,,,7,1,8
,2011,150700089,,,,3,3,6
HND-013279,2011,150700013,,,,3,9,12
HND-013280,2011,150700015,,,,7,4,11
HND-013293,2011,150700029,,,,4,3,7
,2011,150700043,,,,4,4,8
,2011,150700024,,,,9,3,12
HND-013300,2011,150700037,,,,3,7,10
HND-013280,2011,150700015,,,,4,4,8
HND-013293,2011,150700029,,,,5,6,11
HND-013300,2011,150700037,,,,4,4,8
,2011,150700043,,,,2,5,7
HND-013279,2011,150700013,,,,4,6,10
,2011,150700024,,,,3,3,6
HND-013267,2011,150700001,,,,7,7,14
HND-013268,2011,150700002,,,,7,4,11
HND-013270,2011,150700004,,,,2,4,6
HND-013271,2011,150700005,,,,7,3,10
HND-013274,2011,150700008,,,,10,10,20
HND-013275,2011,150700009,,,,0,2,2
HND-013276,2011,150700010,,,,6,8,14
HND-013278,2011,150700012,,,,15,7,22
HND-013283,2011,150700018,,,,2,1,3
HND-013284,2011,150700019,,,,4,1,5
HND-013289,2011,150700025,,,,1,4,5
HND-013295,2011,150700032,,,,4,6,10
HND-013297,2011,150700034,,,,8,8,16
HND-013298,2011,150700035,,,,9,8,17
HND-013303,2011,150700080,,,,6,3,9
HND-013304,2011,150700081,,,,3,2,5
HND-013305,2011,150700082,,,,4,6,10
HND-013307,2011,150700084,,,,11,11,22
HND-013269,2011,150700003,,,,9,7,16
HND-013272,2011,150700006,,,,6,8,14
HND-013273,2011,150700007,,,,16,12,28
HND-013277,2011,150700011,,,,6,9,15
HND-013281,2011,150700016,,,,11,10,21
HND-013282,2011,150700017,,,,4,2,6
HND-013285,2011,150700020,,,,1,4,5
HND-013286,2011,150700021,,,,5,7,12
HND-013287,2011,150700022,,,,11,5,16
HND-013291,2011,150700027,,,,13,10,23
HND-013292,2011,150700028,,,,0,2,2
HND-013294,2011,150700031,,,,1,2,3
HND-013296,2011,150700033,,,,7,2,9
HND-013299,2011,150700036,,,,6,6,12
HND-013306,2011,150700083,,,,9,5,14
HND-013267,2011,150700001,,,,10,7,17
HND-013271,2011,150700005,,,,3,5,8
HND-013272,2011,150700006,,,,6,12,18
HND-013275,2011,150700009,,,,3,1,4
HND-013281,2011,150700016,,,,15,16,31
HND-013286,2011,150700021,,,,3,8,11
HND-013291,2011,150700027,,,,8,4,12
HND-013294,2011,150700031,,,,0,1,1
HND-013296,2011,150700033,,,,1,5,6
HND-013297,2011,150700034,,,,1,0,1
HND-013304,2011,150700081,,,,2,2,4
HND-013306,2011,150700083,,,,10,5,15
HND-013307,2011,150700084,,,,4,2,6
HND-013268,2011,150700002,,,,6,4,10
HND-013269,2011,150700003,,,,4,7,11
HND-013270,2011,150700004,,,,7,2,9
HND-013273,2011,150700007,,,,12,18,30
HND-013274,2011,150700008,,,,14,8,22
HND-013276,2011,150700010,,,,6,2,8
HND-013277,2011,150700011,,,,5,3,8
HND-013278,2011,150700012,,,,13,12,25
HND-013282,2011,150700017,,,,5,6,11
HND-013283,2011,150700018,,,,2,3,5
HND-013285,2011,150700020,,,,2,4,6
HND-013287,2011,150700022,,,,6,7,13
HND-013289,2011,150700025,,,,6,2,8
HND-013292,2011,150700028,,,,0,3,3
HND-013295,2011,150700032,,,,5,5,10
HND-013298,2011,150700035,,,,8,6,14
HND-013299,2011,150700036,,,,8,11,19
HND-013303,2011,150700080,,,,5,2,7
HND-013305,2011,150700082,,,,2,5,7
HND-013267,2011,150700001,,,,9,11,20
HND-013268,2011,150700002,,,,11,7,18
HND-013270,2011,150700004,,,,6,10,16
HND-013271,2011,150700005,,,,5,5,10
HND-013274,2011,150700008,,,,6,14,20
HND-013275,2011,150700009,,,,2,3,5
HND-013276,2011,150700010,,,,7,1,8
HND-013278,2011,150700012,,,,14,10,24
HND-013283,2011,150700018,,,,3,0,3
HND-013284,2011,150700019,,,,4,0,4
HND-013289,2011,150700025,,,,7,3,10
HND-013294,2011,150700031,,,,3,1,4
HND-013296,2011,150700033,,,,1,2,3
HND-013299,2011,150700036,,,,6,6,12
HND-013306,2011,150700083,,,,6,6,12
HND-013269,2011,150700003,,,,7,6,13
HND-013272,2011,150700006,,,,4,7,11
HND-013273,2011,150700007,,,,8,11,19
HND-013277,2011,150700011,,,,4,4,8
HND-013281,2011,150700016,,,,2,1,3
HND-013282,2011,150700017,,,,9,9,18
HND-013285,2011,150700020,,,,3,3,6
HND-013286,2011,150700021,,,,5,3,8
HND-013287,2011,150700022,,,,12,7,19
HND-013291,2011,150700027,,,,4,3,7
HND-013292,2011,150700028,,,,2,2,4
HND-013295,2011,150700032,,,,6,4,10
HND-013297,2011,150700034,,,,3,0,3
HND-013298,2011,150700035,,,,5,2,7
HND-013303,2011,150700080,,,,0,4,4
HND-013304,2011,150700081,,,,4,5,9
HND-013305,2011,150700082,,,,4,4,8
HND-013307,2011,150700084,,,,6,1,7
HND-013269,2011,150700003,,,,4,9,13
HND-013271,2011,150700005,,,,5,4,9
HND-013272,2011,150700006,,,,3,9,12
HND-013273,2011,150700007,,,,9,6,15
HND-013275,2011,150700009,,,,11,10,21
HND-013281,2011,150700016,,,,3,1,4
HND-013282,2011,150700017,,,,3,2,5
HND-013284,2011,150700019,,,,2,0,2
HND-013286,2011,150700021,,,,1,1,2
HND-013291,2011,150700027,,,,1,3,4
HND-013294,2011,150700031,,,,1,1,2
HND-013295,2011,150700032,,,,1,3,4
HND-013297,2011,150700034,,,,4,11,15
HND-013303,2011,150700080,,,,2,2,4
HND-013304,2011,150700081,,,,1,1,2
HND-013306,2011,150700083,,,,2,6,8
HND-013307,2011,150700084,,,,4,2,6
HND-013267,2011,150700001,,,,11,10,21
HND-013268,2011,150700002,,,,4,7,11
HND-013270,2011,150700004,,,,10,3,13
HND-013274,2011,150700008,,,,9,11,20
HND-013276,2011,150700010,,,,0,2,2
HND-013277,2011,150700011,,,,3,6,9
HND-013278,2011,150700012,,,,10,9,19
HND-013283,2011,150700018,,,,2,1,3
HND-013285,2011,150700020,,,,4,4,8
HND-013287,2011,150700022,,,,12,12,24
HND-013289,2011,150700025,,,,9,7,16
HND-013292,2011,150700028,,,,2,3,5
HND-013296,2011,150700033,,,,2,4,6
HND-013298,2011,150700035,,,,6,6,12
HND-013299,2011,150700036,,,,2,0,2
HND-013305,2011,150700082,,,,3,5,8
HND-013269,2011,150700003,,,,9,6,15
HND-013272,2011,150700006,,,,3,8,11
HND-013273,2011,150700007,,,,6,8,14
HND-013275,2011,150700009,,,,3,1,4
HND-013277,2011,150700011,,,,2,1,3
HND-013281,2011,150700016,,,,3,8,11
HND-013282,2011,150700017,,,,10,3,13
HND-013284,2011,150700019,,,,3,1,4
HND-013285,2011,150700020,,,,3,2,5
HND-013286,2011,150700021,,,,1,1,2
HND-013291,2011,150700027,,,,2,0,2
HND-013292,2011,150700028,,,,2,3,5
HND-013294,2011,150700031,,,,2,2,4
HND-013295,2011,150700032,,,,6,4,10
HND-013297,2011,150700034,,,,5,4,9
HND-013298,2011,150700035,,,,5,3,8
HND-013303,2011,150700080,,,,5,1,6
HND-013304,2011,150700081,,,,1,1,2
HND-013305,2011,150700082,,,,5,2,7
HND-013307,2011,150700084,,,,7,3,10
HND-013267,2011,150700001,,,,13,6,19
HND-013268,2011,150700002,,,,9,17,26
HND-013270,2011,150700004,,,,2,3,5
HND-013271,2011,150700005,,,,5,3,8
HND-013274,2011,150700008,,,,7,8,15
HND-013276,2011,150700010,,,,3,3,6
HND-013278,2011,150700012,,,,9,6,15
HND-013283,2011,150700018,,,,3,2,5
HND-013287,2011,150700022,,,,7,5,12
HND-013289,2011,150700025,,,,2,2,4
HND-013296,2011,150700033,,,,1,1,2
HND-013299,2011,150700036,,,,4,1,5
HND-013306,2011,150700083,,,,0,3,3
HND-013268,2011,150700002,,,,14,7,21
HND-013269,2011,150700003,,,,4,10,14
HND-013273,2011,150700007,,,,8,4,12
HND-013274,2011,150700008,,,,5,4,9
HND-013276,2011,150700010,,,,3,2,5
HND-013277,2011,150700011,,,,4,2,6
HND-013278,2011,150700012,,,,7,6,13
HND-013282,2011,150700017,,,,2,1,3
HND-013283,2011,150700018,,,,4,0,4
HND-013285,2011,150700020,,,,3,3,6
HND-013287,2011,150700022,,,,8,5,13
HND-013292,2011,150700028,,,,2,1,3
HND-013295,2011,150700032,,,,5,7,12
HND-013298,2011,150700035,,,,0,4,4
HND-013299,2011,150700036,,,,1,1,2
HND-013267,2011,150700001,,,,13,12,25
HND-013271,2011,150700005,,,,2,4,6
HND-013272,2011,150700006,,,,3,4,7
HND-013275,2011,150700009,,,,5,5,10
HND-013281,2011,150700016,,,,1,1,2
HND-013284,2011,150700019,,,,2,0,2
HND-013286,2011,150700021,,,,5,1,6
HND-013294,2011,150700031,,,,0,2,2
HND-013296,2011,150700033,,,,0,1,1
HND-013297,2011,150700034,,,,6,12,18
HND-013304,2011,150700081,,,,0,1,1
HND-013306,2011,150700083,,,,0,2,2
HND-013307,2011,150700084,,,,5,2,7
HND-013267,2011,150700001,,,,18,19,37
HND-013268,2011,150700002,,,,6,8,14
HND-013274,2011,150700008,,,,9,2,11
HND-013278,2011,150700012,,,,10,10,20
HND-013287,2011,150700022,,,,9,7,16
,2011,150700045,,,,22,7,29
,2011,150700045,,,,10,2,12
HND-013267,2011,150700001,,,,21,17,38
HND-013268,2011,150700002,,,,11,11,22
HND-013274,2011,150700008,,,,4,7,11
HND-013278,2011,150700012,,,,6,6,12
HND-013287,2011,150700022,,,,4,8,12
,2011,150700046,,,,1,0,1
HND-013267,2011,150700001,,,,10,19,29
,2011,150700045,,,,4,9,13
HND-013268,2011,150700002,,,,5,8,13
HND-013274,2011,150700008,,,,3,5,8
HND-013278,2011,150700012,,,,6,4,10
HND-013287,2011,150700022,,,,2,9,11
,2011,150700046,,,,3,1,4
HND-013267,2011,150700001,,,,12,14,26
,2011,150700045,,,,13,4,17
,2011,150700046,,,,6,10,16
HND-013267,2011,150700001,,,,8,10,18
,2011,150700045,,,,10,9,19
,2011,150700046,,,,5,5,10
HND-013267,2011,150700001,,,,5,5,10
,2011,150800119,,,,6,7,13
,2011,150800120,,,,6,4,10
HND-013386,2011,150800123,,,,7,1,8
HND-013387,2011,150800124,,,,2,8,10
HND-013388,2011,150800125,,,,11,12,23
HND-013389,2011,150800127,,,,8,8,16
,2011,150800128,,,,3,6,9
HND-013391,2011,150800131,,,,9,7,16
,2011,150800141,,,,5,9,14
HND-013398,2011,150800142,,,,3,4,7
,2011,150800154,,,,4,6,10
,2011,150800155,,,,6,3,9
,2011,150800157,,,,6,6,12
,2011,150800160,,,,4,5,9
,2011,150800121,,,,7,8,15
HND-013385,2011,150800122,,,,5,3,8
HND-013390,2011,150800129,,,,5,7,12
HND-013392,2011,150800132,,,,2,8,10
HND-013393,2011,150800133,,,,5,5,10
,2011,150800134,,,,9,6,15
,2011,150800143,,,,3,4,7
,2011,150800144,,,,7,5,12
,2011,150800145,,,,5,5,10
HND-013351,2011,150800050,,,,0,2,2
HND-013353,2011,150800053,,,,3,0,3
HND-013354,2011,150800054,,,,1,2,3
,2011,150800056,,,,4,4,8
HND-013355,2011,150800057,,,,7,6,13
,2011,150800069,,,,4,4,8
,2011,150800070,,,,1,4,5
,2011,150800071,,,,5,2,7
HND-013367,2011,150800073,,,,0,3,3
HND-013349,2011,150800048,,,,18,20,38
HND-013350,2011,150800049,,,,6,9,15
HND-013352,2011,150800052,,,,2,5,7
HND-013378,2011,150800097,,,,0,2,2
HND-013394,2011,150800135,,,,7,5,12
,2011,150800156,,,,7,9,16
HND-013349,2011,150800048,,,,43,39,82
HND-013350,2011,150800049,,,,2,3,5
HND-013352,2011,150800052,,,,12,7,19
,2011,150800056,,,,5,2,7
HND-013378,2011,150800097,,,,15,14,29
HND-013394,2011,150800135,,,,14,15,29
HND-013351,2011,150800050,,,,4,4,8
HND-013353,2011,150800053,,,,6,7,13
HND-013354,2011,150800054,,,,4,6,10
HND-013355,2011,150800057,,,,4,4,8
,2011,150800069,,,,2,3,5
,2011,150800070,,,,3,3,6
,2011,150800071,,,,4,6,10
HND-013367,2011,150800073,,,,7,6,13
,2011,150800156,,,,12,13,25
HND-013310,2011,150800001,,,,17,14,31
HND-013311,2011,150800002,,,,2,5,7
HND-013312,2011,150800003,,,,0,1,1
HND-013316,2011,150800007,,,,2,4,6
HND-013317,2011,150800008,,,,2,2,4
HND-013319,2011,150800010,,,,5,5,10
HND-013321,2011,150800012,,,,0,1,1
HND-013322,2011,150800014,,,,1,0,1
,2011,150800015,,,,7,8,15
,2011,150800018,,,,8,9,17
HND-013330,2011,150800026,,,,7,4,11
HND-013331,2011,150800027,,,,9,7,16
HND-013333,2011,150800029,,,,1,5,6
HND-013336,2011,150800032,,,,5,3,8
HND-013339,2011,150800035,,,,3,4,7
HND-013341,2011,150800038,,,,1,4,5
HND-013342,2011,150800039,,,,7,7,14
HND-013344,2011,150800041,,,,1,4,5
HND-013346,2011,150800043,,,,3,7,10
HND-013347,2011,150800046,,,,0,3,3
HND-013348,2011,150800047,,,,7,3,10
HND-013357,2011,150800059,,,,7,5,12
HND-013362,2011,150800065,,,,3,2,5
,2011,150800066,,,,13,12,25
HND-013368,2011,150800077,,,,3,8,11
HND-013372,2011,150800085,,,,4,2,6
HND-013373,2011,150800086,,,,4,6,10
HND-013376,2011,150800095,,,,3,3,6
HND-013379,2011,150800098,,,,7,1,8
HND-013380,2011,150800099,,,,1,0,1
HND-013381,2011,150800100,,,,13,12,25
HND-013383,2011,150800103,,,,8,6,14
,2011,150800117,,,,1,5,6
HND-013397,2011,150800140,,,,1,1,2
HND-013399,2011,150800148,,,,2,3,5
HND-013400,2011,150800149,,,,4,4,8
HND-013401,2011,150800150,,,,0,5,5
HND-013402,2011,150800152,,,,5,1,6
,2011,150800158,,,,5,7,12
HND-013313,2011,150800004,,,,73,63,136
HND-013314,2011,150800005,,,,3,6,9
HND-013315,2011,150800006,,,,2,7,9
HND-013318,2011,150800009,,,,5,8,13
,2011,150800011,,,,1,1,2
HND-013323,2011,150800016,,,,8,9,17
HND-013324,2011,150800017,,,,1,4,5
HND-013326,2011,150800019,,,,6,2,8
HND-013327,2011,150800021,,,,11,10,21
HND-013328,2011,150800024,,,,1,1,2
HND-013329,2011,150800025,,,,1,3,4
HND-013332,2011,150800028,,,,7,6,13
HND-013334,2011,150800030,,,,6,2,8
HND-013335,2011,150800031,,,,5,0,5
HND-013337,2011,150800033,,,,4,3,7
HND-013338,2011,150800034,,,,3,2,5
HND-013340,2011,150800037,,,,1,1,2
HND-013343,2011,150800040,,,,1,2,3
HND-013345,2011,150800042,,,,3,1,4
HND-013358,2011,150800061,,,,2,3,5
HND-013359,2011,150800062,,,,5,3,8
HND-013360,2011,150800063,,,,10,2,12
HND-013361,2011,150800064,,,,2,2,4
HND-013364,2011,150800067,,,,6,4,10
HND-013366,2011,150800072,,,,7,0,7
HND-013369,2011,150800078,,,,5,4,9
HND-013370,2011,150800083,,,,3,2,5
HND-013371,2011,150800084,,,,1,0,1
HND-013374,2011,150800087,,,,9,5,14
HND-013375,2011,150800092,,,,1,2,3
HND-013377,2011,150800096,,,,5,5,10
HND-013382,2011,150800101,,,,9,2,11
HND-013384,2011,150800118,,,,2,1,3
HND-013396,2011,150800139,,,,3,4,7
,2011,150800146,,,,3,3,6
HND-013403,2011,150800153,,,,2,0,2
,2011,150800159,,,,8,5,13
HND-013310,2011,150800001,,,,11,10,21
HND-013312,2011,150800003,,,,2,2,4
HND-013313,2011,150800004,,,,51,72,123
HND-013315,2011,150800006,,,,6,5,11
HND-013316,2011,150800007,,,,5,3,8
HND-013318,2011,150800009,,,,7,6,13
HND-013319,2011,150800010,,,,7,4,11
,2011,150800011,,,,2,1,3
HND-013322,2011,150800014,,,,2,1,3
HND-013323,2011,150800016,,,,12,10,22
HND-013324,2011,150800017,,,,1,2,3
,2011,150800018,,,,10,13,23
HND-013329,2011,150800025,,,,1,3,4
HND-013332,2011,150800028,,,,10,7,17
HND-013333,2011,150800029,,,,2,2,4
HND-013334,2011,150800030,,,,5,7,12
HND-013335,2011,150800031,,,,5,0,5
HND-013336,2011,150800032,,,,3,5,8
HND-013338,2011,150800034,,,,1,1,2
HND-013340,2011,150800037,,,,2,4,6
HND-013341,2011,150800038,,,,3,1,4
HND-013345,2011,150800042,,,,1,2,3
HND-013357,2011,150800059,,,,5,5,10
HND-013359,2011,150800062,,,,4,3,7
HND-013361,2011,150800064,,,,2,1,3
HND-013362,2011,150800065,,,,3,7,10
HND-013371,2011,150800084,,,,4,7,11
HND-013372,2011,150800085,,,,0,2,2
HND-013375,2011,150800092,,,,3,1,4
HND-013379,2011,150800098,,,,7,3,10
HND-013381,2011,150800100,,,,3,7,10
HND-013383,2011,150800103,,,,13,5,18
,2011,150800117,,,,3,8,11
HND-013384,2011,150800118,,,,4,1,5
HND-013396,2011,150800139,,,,1,2,3
,2011,150800146,,,,2,2,4
HND-013401,2011,150800150,,,,2,2,4
HND-013403,2011,150800153,,,,4,5,9
HND-013311,2011,150800002,,,,1,1,2
HND-013314,2011,150800005,,,,4,4,8
HND-013317,2011,150800008,,,,1,1,2
HND-013321,2011,150800012,,,,2,3,5
,2011,150800015,,,,5,6,11
HND-013326,2011,150800019,,,,5,4,9
HND-013327,2011,150800021,,,,8,18,26
HND-013328,2011,150800024,,,,1,1,2
HND-013330,2011,150800026,,,,7,4,11
HND-013331,2011,150800027,,,,7,7,14
HND-013337,2011,150800033,,,,2,2,4
HND-013339,2011,150800035,,,,3,0,3
HND-013342,2011,150800039,,,,6,9,15
HND-013343,2011,150800040,,,,1,1,2
HND-013344,2011,150800041,,,,1,1,2
HND-013346,2011,150800043,,,,6,3,9
HND-013347,2011,150800046,,,,3,2,5
HND-013348,2011,150800047,,,,4,2,6
HND-013358,2011,150800061,,,,2,2,4
HND-013360,2011,150800063,,,,5,5,10
,2011,150800066,,,,13,8,21
HND-013364,2011,150800067,,,,5,7,12
HND-013366,2011,150800072,,,,4,4,8
HND-013368,2011,150800077,,,,4,3,7
HND-013369,2011,150800078,,,,3,4,7
HND-013370,2011,150800083,,,,4,6,10
HND-013373,2011,150800086,,,,8,1,9
HND-013374,2011,150800087,,,,9,11,20
HND-013376,2011,150800095,,,,2,1,3
HND-013377,2011,150800096,,,,6,6,12
HND-013380,2011,150800099,,,,2,1,3
HND-013382,2011,150800101,,,,2,10,12
HND-013395,2011,150800138,,,,2,1,3
HND-013397,2011,150800140,,,,1,2,3
HND-013399,2011,150800148,,,,4,2,6
HND-013400,2011,150800149,,,,1,3,4
HND-013402,2011,150800152,,,,5,3,8
,2011,150800158,,,,5,4,9
HND-013313,2011,150800004,,,,53,51,104
HND-013314,2011,150800005,,,,1,1,2
HND-013315,2011,150800006,,,,6,7,13
HND-013318,2011,150800009,,,,0,6,6
,2011,150800011,,,,2,1,3
HND-013323,2011,150800016,,,,12,7,19
HND-013324,2011,150800017,,,,5,3,8
HND-013326,2011,150800019,,,,2,7,9
HND-013327,2011,150800021,,,,16,12,28
HND-013328,2011,150800024,,,,3,1,4
HND-013329,2011,150800025,,,,1,0,1
HND-013332,2011,150800028,,,,3,4,7
HND-013334,2011,150800030,,,,1,6,7
HND-013335,2011,150800031,,,,2,0,2
HND-013337,2011,150800033,,,,1,4,5
HND-013338,2011,150800034,,,,0,6,6
HND-013340,2011,150800037,,,,2,1,3
HND-013341,2011,150800038,,,,3,0,3
HND-013343,2011,150800040,,,,4,2,6
HND-013345,2011,150800042,,,,2,2,4
HND-013357,2011,150800059,,,,5,4,9
HND-013358,2011,150800061,,,,1,1,2
HND-013359,2011,150800062,,,,6,8,14
HND-013360,2011,150800063,,,,2,2,4
HND-013361,2011,150800064,,,,4,2,6
HND-013364,2011,150800067,,,,4,4,8
HND-013366,2011,150800072,,,,5,1,6
HND-013369,2011,150800078,,,,1,2,3
HND-013370,2011,150800083,,,,5,7,12
HND-013371,2011,150800084,,,,2,1,3
HND-013374,2011,150800087,,,,13,6,19
HND-013375,2011,150800092,,,,1,3,4
HND-013377,2011,150800096,,,,2,7,9
HND-013379,2011,150800098,,,,6,7,13
HND-013381,2011,150800100,,,,10,8,18
,2011,150800117,,,,8,4,12
HND-013384,2011,150800118,,,,0,1,1
HND-013396,2011,150800139,,,,1,2,3
,2011,150800146,,,,1,0,1
HND-013403,2011,150800153,,,,4,1,5
HND-013310,2011,150800001,,,,11,18,29
HND-013311,2011,150800002,,,,4,5,9
HND-013312,2011,150800003,,,,1,2,3
HND-013316,2011,150800007,,,,0,3,3
HND-013317,2011,150800008,,,,3,2,5
HND-013319,2011,150800010,,,,4,9,13
HND-013322,2011,150800014,,,,1,0,1
,2011,150800015,,,,3,5,8
,2011,150800018,,,,12,11,23
HND-013330,2011,150800026,,,,6,4,10
HND-013331,2011,150800027,,,,3,3,6
HND-013333,2011,150800029,,,,6,3,9
HND-013336,2011,150800032,,,,8,5,13
HND-013339,2011,150800035,,,,1,5,6
HND-013342,2011,150800039,,,,10,4,14
HND-013344,2011,150800041,,,,6,6,12
HND-013346,2011,150800043,,,,5,2,7
HND-013347,2011,150800046,,,,2,1,3
HND-013348,2011,150800047,,,,5,4,9
HND-013362,2011,150800065,,,,0,3,3
,2011,150800066,,,,14,16,30
HND-013368,2011,150800077,,,,5,2,7
HND-013373,2011,150800086,,,,3,2,5
HND-013376,2011,150800095,,,,3,5,8
HND-013380,2011,150800099,,,,2,4,6
HND-013382,2011,150800101,,,,4,3,7
HND-013383,2011,150800103,,,,8,4,12
HND-013397,2011,150800140,,,,1,0,1
HND-013399,2011,150800148,,,,3,0,3
HND-013400,2011,150800149,,,,1,3,4
HND-013401,2011,150800150,,,,1,0,1
HND-013402,2011,150800152,,,,4,5,9
HND-013310,2011,150800001,,,,20,13,33
HND-013312,2011,150800003,,,,3,0,3
HND-013315,2011,150800006,,,,7,8,15
HND-013316,2011,150800007,,,,5,1,6
HND-013319,2011,150800010,,,,4,8,12
,2011,150800011,,,,2,2,4
HND-013321,2011,150800012,,,,2,0,2
HND-013322,2011,150800014,,,,1,2,3
HND-013324,2011,150800017,,,,3,3,6
,2011,150800018,,,,7,10,17
HND-013329,2011,150800025,,,,2,2,4
HND-013330,2011,150800026,,,,3,5,8
HND-013333,2011,150800029,,,,4,2,6
HND-013334,2011,150800030,,,,6,2,8
HND-013335,2011,150800031,,,,2,3,5
HND-013336,2011,150800032,,,,2,3,5
HND-013338,2011,150800034,,,,3,1,4
HND-013339,2011,150800035,,,,1,1,2
HND-013341,2011,150800038,,,,1,1,2
HND-013347,2011,150800046,,,,3,3,6
HND-013357,2011,150800059,,,,3,1,4
HND-013359,2011,150800062,,,,9,5,14
HND-013361,2011,150800064,,,,3,3,6
HND-013362,2011,150800065,,,,3,0,3
HND-013368,2011,150800077,,,,1,2,3
HND-013371,2011,150800084,,,,6,2,8
HND-013376,2011,150800095,,,,1,1,2
HND-013379,2011,150800098,,,,7,2,9
HND-013381,2011,150800100,,,,0,3,3
HND-013383,2011,150800103,,,,5,3,8
,2011,150800117,,,,5,4,9
HND-013396,2011,150800139,,,,0,1,1
HND-013397,2011,150800140,,,,4,1,5
HND-013399,2011,150800148,,,,1,3,4
HND-013400,2011,150800149,,,,2,1,3
HND-013401,2011,150800150,,,,2,0,2
HND-013313,2011,150800004,,,,61,48,109
HND-013314,2011,150800005,,,,1,1,2
HND-013317,2011,150800008,,,,2,4,6
HND-013318,2011,150800009,,,,2,5,7
,2011,150800015,,,,1,5,6
HND-013323,2011,150800016,,,,12,12,24
HND-013326,2011,150800019,,,,6,3,9
HND-013327,2011,150800021,,,,10,7,17
HND-013328,2011,150800024,,,,1,0,1
HND-013331,2011,150800027,,,,2,3,5
HND-013332,2011,150800028,,,,6,6,12
HND-013342,2011,150800039,,,,4,8,12
HND-013343,2011,150800040,,,,3,2,5
HND-013344,2011,150800041,,,,6,4,10
HND-013345,2011,150800042,,,,1,0,1
HND-013346,2011,150800043,,,,9,3,12
HND-013348,2011,150800047,,,,2,1,3
HND-013358,2011,150800061,,,,0,3,3
HND-013360,2011,150800063,,,,2,5,7
,2011,150800066,,,,8,6,14
HND-013364,2011,150800067,,,,7,5,12
HND-013366,2011,150800072,,,,2,5,7
HND-013369,2011,150800078,,,,0,2,2
HND-013370,2011,150800083,,,,5,7,12
HND-013373,2011,150800086,,,,6,5,11
HND-013374,2011,150800087,,,,7,10,17
HND-013375,2011,150800092,,,,1,1,2
HND-013377,2011,150800096,,,,9,7,16
HND-013380,2011,150800099,,,,2,1,3
HND-013382,2011,150800101,,,,5,2,7
HND-013384,2011,150800118,,,,2,4,6
HND-013395,2011,150800138,,,,4,2,6
,2011,150800146,,,,1,3,4
HND-013402,2011,150800152,,,,1,1,2
HND-013403,2011,150800153,,,,6,11,17
HND-013310,2011,150800001,,,,15,11,26
HND-013313,2011,150800004,,,,45,44,89
HND-013314,2011,150800005,,,,1,0,1
HND-013315,2011,150800006,,,,9,1,10
HND-013316,2011,150800007,,,,4,4,8
HND-013319,2011,150800010,,,,0,9,9
,2011,150800011,,,,2,4,6
HND-013321,2011,150800012,,,,3,2,5
HND-013324,2011,150800017,,,,3,1,4
HND-013328,2011,150800024,,,,0,1,1
HND-013330,2011,150800026,,,,3,4,7
HND-013331,2011,150800027,,,,3,3,6
HND-013332,2011,150800028,,,,6,5,11
HND-013333,2011,150800029,,,,5,5,10
HND-013334,2011,150800030,,,,5,3,8
HND-013336,2011,150800032,,,,2,5,7
HND-013338,2011,150800034,,,,0,1,1
HND-013339,2011,150800035,,,,1,1,2
HND-013341,2011,150800038,,,,1,0,1
HND-013342,2011,150800039,,,,0,10,10
HND-013346,2011,150800043,,,,5,4,9
HND-013347,2011,150800046,,,,5,1,6
HND-013348,2011,150800047,,,,2,4,6
HND-013357,2011,150800059,,,,3,3,6
HND-013359,2011,150800062,,,,3,8,11
HND-013360,2011,150800063,,,,5,3,8
HND-013361,2011,150800064,,,,1,2,3
HND-013364,2011,150800067,,,,5,4,9
HND-013368,2011,150800077,,,,3,2,5
HND-013372,2011,150800085,,,,6,2,8
HND-013376,2011,150800095,,,,2,3,5
HND-013379,2011,150800098,,,,5,4,9
HND-013380,2011,150800099,,,,1,2,3
HND-013381,2011,150800100,,,,1,1,2
HND-013383,2011,150800103,,,,7,9,16
,2011,150800117,,,,6,1,7
HND-013397,2011,150800140,,,,3,1,4
HND-013399,2011,150800148,,,,3,0,3
HND-013401,2011,150800150,,,,1,2,3
HND-013311,2011,150800002,,,,1,1,2
HND-013312,2011,150800003,,,,1,1,2
HND-013317,2011,150800008,,,,5,4,9
HND-013318,2011,150800009,,,,5,4,9
HND-013322,2011,150800014,,,,0,1,1
,2011,150800015,,,,2,4,6
HND-013323,2011,150800016,,,,7,11,18
,2011,150800018,,,,6,7,13
HND-013326,2011,150800019,,,,3,5,8
HND-013327,2011,150800021,,,,4,15,19
HND-013329,2011,150800025,,,,2,3,5
HND-013335,2011,150800031,,,,2,0,2
HND-013340,2011,150800037,,,,3,2,5
HND-013343,2011,150800040,,,,2,1,3
HND-013344,2011,150800041,,,,3,1,4
HND-013345,2011,150800042,,,,1,0,1
HND-013362,2011,150800065,,,,2,1,3
,2011,150800066,,,,9,11,20
HND-013366,2011,150800072,,,,3,1,4
HND-013369,2011,150800078,,,,1,0,1
HND-013370,2011,150800083,,,,3,6,9
HND-013371,2011,150800084,,,,5,1,6
HND-013373,2011,150800086,,,,8,5,13
HND-013374,2011,150800087,,,,9,7,16
HND-013377,2011,150800096,,,,1,2,3
HND-013382,2011,150800101,,,,8,5,13
HND-013384,2011,150800118,,,,1,1,2
HND-013395,2011,150800138,,,,1,0,1
,2011,150800146,,,,0,2,2
HND-013402,2011,150800152,,,,2,3,5
HND-013310,2011,150800001,,,,20,18,38
HND-013312,2011,150800003,,,,0,1,1
HND-013313,2011,150800004,,,,42,62,104
HND-013315,2011,150800006,,,,5,0,5
HND-013316,2011,150800007,,,,2,4,6
HND-013318,2011,150800009,,,,1,4,5
HND-013319,2011,150800010,,,,7,7,14
,2011,150800011,,,,1,2,3
HND-013322,2011,150800014,,,,3,1,4
HND-013323,2011,150800016,,,,8,10,18
HND-013324,2011,150800017,,,,3,4,7
,2011,150800018,,,,2,11,13
HND-013329,2011,150800025,,,,1,0,1
HND-013332,2011,150800028,,,,6,3,9
HND-013333,2011,150800029,,,,4,2,6
HND-013337,2011,150800033,,,,2,0,2
HND-013339,2011,150800035,,,,2,3,5
HND-013342,2011,150800039,,,,6,4,10
HND-013343,2011,150800040,,,,1,1,2
HND-013344,2011,150800041,,,,4,1,5
HND-013346,2011,150800043,,,,2,6,8
HND-013347,2011,150800046,,,,2,2,4
HND-013348,2011,150800047,,,,7,1,8
HND-013359,2011,150800062,,,,7,1,8
HND-013361,2011,150800064,,,,4,3,7
HND-013366,2011,150800072,,,,3,1,4
HND-013368,2011,150800077,,,,4,1,5
HND-013369,2011,150800078,,,,1,0,1
HND-013370,2011,150800083,,,,7,2,9
HND-013373,2011,150800086,,,,1,4,5
HND-013374,2011,150800087,,,,5,6,11
HND-013376,2011,150800095,,,,2,4,6
HND-013377,2011,150800096,,,,2,0,2
HND-013380,2011,150800099,,,,6,2,8
HND-013382,2011,150800101,,,,5,9,14
HND-013395,2011,150800138,,,,0,1,1
HND-013399,2011,150800148,,,,2,2,4
HND-013400,2011,150800149,,,,1,0,1
HND-013402,2011,150800152,,,,0,3,3
HND-013311,2011,150800002,,,,3,3,6
HND-013314,2011,150800005,,,,3,6,9
HND-013317,2011,150800008,,,,2,0,2
HND-013321,2011,150800012,,,,3,2,5
,2011,150800015,,,,3,5,8
HND-013326,2011,150800019,,,,11,1,12
HND-013327,2011,150800021,,,,3,8,11
HND-013330,2011,150800026,,,,4,5,9
HND-013331,2011,150800027,,,,1,5,6
HND-013334,2011,150800030,,,,3,2,5
HND-013335,2011,150800031,,,,3,3,6
HND-013336,2011,150800032,,,,6,5,11
HND-013338,2011,150800034,,,,2,0,2
HND-013340,2011,150800037,,,,3,2,5
HND-013341,2011,150800038,,,,0,2,2
HND-013357,2011,150800059,,,,6,6,12
HND-013358,2011,150800061,,,,0,3,3
HND-013360,2011,150800063,,,,1,2,3
,2011,150800066,,,,12,9,21
HND-013364,2011,150800067,,,,3,6,9
HND-013371,2011,150800084,,,,1,5,6
HND-013372,2011,150800085,,,,3,1,4
HND-013375,2011,150800092,,,,0,1,1
HND-013379,2011,150800098,,,,3,5,8
HND-013381,2011,150800100,,,,0,4,4
HND-013383,2011,150800103,,,,6,5,11
,2011,150800117,,,,5,5,10
HND-013384,2011,150800118,,,,3,2,5
HND-013396,2011,150800139,,,,1,0,1
,2011,150800146,,,,2,1,3
HND-013401,2011,150800150,,,,3,1,4
HND-013310,2011,150800001,,,,24,27,51
HND-013356,2011,150800058,,,,80,119,199
HND-013323,2011,150800016,,,,3,7,10
HND-013324,2011,150800017,,,,4,2,6
HND-013382,2011,150800101,,,,7,10,17
HND-013310,2011,150800001,,,,20,15,35
HND-013323,2011,150800016,,,,7,6,13
HND-013324,2011,150800017,,,,7,5,12
HND-013356,2011,150800058,,,,96,103,199
HND-013382,2011,150800101,,,,6,7,13
HND-013310,2011,150800001,,,,11,12,23
HND-013324,2011,150800017,,,,8,2,10
HND-013356,2011,150800058,,,,65,84,149
HND-013323,2011,150800016,,,,8,8,16
HND-013382,2011,150800101,,,,8,6,14
HND-013356,2011,150800058,,,,66,82,148
HND-013356,2011,150800058,,,,34,56,90
HND-013356,2011,150800058,,,,19,74,93
,2011,150900043,,,,5,4,9
HND-013437,2011,150900058,,,,3,2,5
,2011,150900060,,,,2,2,4
,2011,150900061,,,,7,8,15
,2011,150900063,,,,8,4,12
,2011,150900064,,,,6,3,9
HND-013441,2011,150900067,,,,1,5,6
,2011,150900068,,,,7,10,17
HND-013444,2011,150900071,,,,4,5,9
,2011,150900045,,,,3,5,8
HND-013439,2011,150900062,,,,7,6,13
HND-013440,2011,150900065,,,,5,6,11
,2011,150900066,,,,3,4,7
HND-013429,2011,150900029,,,,6,1,7
HND-013433,2011,150900035,,,,6,10,16
HND-013436,2011,150900040,,,,7,5,12
HND-013430,2011,150900030,,,,3,5,8
,2011,150900031,,,,1,3,4
HND-013431,2011,150900032,,,,1,1,2
,2011,150900034,,,,4,4,8
HND-013443,2011,150900070,,,,2,3,5
HND-013429,2011,150900029,,,,5,6,11
HND-013433,2011,150900035,,,,9,11,20
HND-013436,2011,150900040,,,,1,1,2
HND-013430,2011,150900030,,,,3,0,3
,2011,150900031,,,,3,2,5
HND-013431,2011,150900032,,,,4,6,10
,2011,150900034,,,,3,1,4
HND-013443,2011,150900070,,,,4,1,5
HND-013404,2011,150900001,,,,20,22,42
,2011,150900005,,,,5,6,11
HND-013409,2011,150900006,,,,6,4,10
HND-013412,2011,150900009,,,,3,1,4
HND-013416,2011,150900013,,,,9,4,13
HND-013418,2011,150900015,,,,7,3,10
HND-013419,2011,150900016,,,,1,2,3
HND-013420,2011,150900017,,,,2,4,6
HND-013422,2011,150900019,,,,3,1,4
,2011,150900023,,,,3,2,5
HND-013427,2011,150900026,,,,9,7,16
HND-013434,2011,150900036,,,,2,4,6
HND-013442,2011,150900069,,,,2,2,4
,2011,150900002,,,,1,1,2
HND-013406,2011,150900003,,,,0,2,2
HND-013407,2011,150900004,,,,6,2,8
HND-013410,2011,150900007,,,,0,1,1
HND-013411,2011,150900008,,,,8,5,13
HND-013413,2011,150900010,,,,3,2,5
HND-013414,2011,150900011,,,,0,6,6
HND-013415,2011,150900012,,,,3,7,10
HND-013417,2011,150900014,,,,5,2,7
,2011,150900018,,,,2,4,6
HND-013423,2011,150900021,,,,1,0,1
HND-013424,2011,150900022,,,,4,5,9
HND-013426,2011,150900024,,,,2,0,2
HND-013428,2011,150900027,,,,3,3,6
HND-013435,2011,150900037,,,,2,3,5
HND-013404,2011,150900001,,,,26,18,44
,2011,150900002,,,,3,0,3
HND-013407,2011,150900004,,,,2,6,8
,2011,150900005,,,,7,8,15
HND-013411,2011,150900008,,,,10,3,13
HND-013413,2011,150900010,,,,5,2,7
HND-013415,2011,150900012,,,,3,0,3
HND-013417,2011,150900014,,,,5,8,13
HND-013418,2011,150900015,,,,6,6,12
,2011,150900018,,,,2,1,3
HND-013422,2011,150900019,,,,1,4,5
HND-013424,2011,150900022,,,,1,0,1
HND-013426,2011,150900024,,,,2,0,2
HND-013434,2011,150900036,,,,5,1,6
HND-013435,2011,150900037,,,,1,0,1
HND-013406,2011,150900003,,,,3,1,4
HND-013409,2011,150900006,,,,8,7,15
HND-013410,2011,150900007,,,,2,0,2
HND-013412,2011,150900009,,,,2,1,3
HND-013414,2011,150900011,,,,2,4,6
HND-013416,2011,150900013,,,,8,5,13
HND-013419,2011,150900016,,,,1,1,2
HND-013420,2011,150900017,,,,4,2,6
HND-013423,2011,150900021,,,,2,0,2
,2011,150900023,,,,1,1,2
HND-013427,2011,150900026,,,,4,3,7
HND-013428,2011,150900027,,,,4,3,7
HND-013442,2011,150900069,,,,1,0,1
,2011,150900002,,,,0,1,1
HND-013406,2011,150900003,,,,2,3,5
HND-013407,2011,150900004,,,,2,2,4
HND-013410,2011,150900007,,,,1,0,1
HND-013411,2011,150900008,,,,4,9,13
HND-013413,2011,150900010,,,,4,3,7
HND-013414,2011,150900011,,,,1,1,2
HND-013415,2011,150900012,,,,6,1,7
HND-013417,2011,150900014,,,,5,7,12
HND-013418,2011,150900015,,,,1,3,4
,2011,150900018,,,,6,7,13
HND-013423,2011,150900021,,,,2,1,3
HND-013424,2011,150900022,,,,2,1,3
HND-013426,2011,150900024,,,,1,1,2
HND-013435,2011,150900037,,,,3,0,3
HND-013404,2011,150900001,,,,20,18,38
,2011,150900005,,,,3,2,5
HND-013409,2011,150900006,,,,2,4,6
HND-013412,2011,150900009,,,,2,1,3
HND-013416,2011,150900013,,,,8,2,10
HND-013419,2011,150900016,,,,1,3,4
HND-013420,2011,150900017,,,,2,1,3
HND-013422,2011,150900019,,,,0,2,2
,2011,150900023,,,,0,1,1
HND-013427,2011,150900026,,,,5,6,11
HND-013428,2011,150900027,,,,5,5,10
HND-013434,2011,150900036,,,,5,3,8
HND-013442,2011,150900069,,,,1,2,3
HND-013404,2011,150900001,,,,24,20,44
,2011,150900002,,,,0,1,1
HND-013407,2011,150900004,,,,3,2,5
,2011,150900005,,,,7,4,11
HND-013411,2011,150900008,,,,5,10,15
HND-013412,2011,150900009,,,,4,4,8
HND-013415,2011,150900012,,,,3,6,9
HND-013418,2011,150900015,,,,2,5,7
HND-013422,2011,150900019,,,,1,1,2
HND-013424,2011,150900022,,,,5,1,6
HND-013434,2011,150900036,,,,4,2,6
HND-013435,2011,150900037,,,,2,3,5
HND-013406,2011,150900003,,,,2,2,4
HND-013409,2011,150900006,,,,2,9,11
HND-013410,2011,150900007,,,,2,0,2
HND-013413,2011,150900010,,,,4,1,5
HND-013414,2011,150900011,,,,6,5,11
HND-013416,2011,150900013,,,,8,4,12
HND-013417,2011,150900014,,,,4,5,9
HND-013419,2011,150900016,,,,2,1,3
HND-013420,2011,150900017,,,,1,0,1
,2011,150900018,,,,6,3,9
HND-013423,2011,150900021,,,,1,1,2
HND-013426,2011,150900024,,,,2,3,5
HND-013427,2011,150900026,,,,6,6,12
HND-013428,2011,150900027,,,,7,5,12
HND-013442,2011,150900069,,,,1,0,1
HND-013404,2011,150900001,,,,21,24,45
,2011,150900002,,,,2,0,2
,2011,150900005,,,,4,5,9
HND-013412,2011,150900009,,,,4,1,5
HND-013418,2011,150900015,,,,3,5,8
HND-013419,2011,150900016,,,,2,3,5
HND-013422,2011,150900019,,,,1,1,2
HND-013427,2011,150900026,,,,8,11,19
HND-013434,2011,150900036,,,,1,6,7
HND-013435,2011,150900037,,,,2,0,2
HND-013406,2011,150900003,,,,1,1,2
HND-013407,2011,150900004,,,,4,5,9
HND-013409,2011,150900006,,,,3,8,11
HND-013410,2011,150900007,,,,2,1,3
HND-013411,2011,150900008,,,,9,8,17
HND-013413,2011,150900010,,,,2,5,7
HND-013414,2011,150900011,,,,4,5,9
HND-013415,2011,150900012,,,,5,1,6
HND-013416,2011,150900013,,,,3,3,6
HND-013417,2011,150900014,,,,4,3,7
HND-013420,2011,150900017,,,,1,1,2
,2011,150900018,,,,3,2,5
HND-013423,2011,150900021,,,,1,1,2
HND-013424,2011,150900022,,,,1,3,4
,2011,150900023,,,,1,0,1
HND-013426,2011,150900024,,,,0,1,1
HND-013428,2011,150900027,,,,7,3,10
HND-013442,2011,150900069,,,,1,0,1
HND-013406,2011,150900003,,,,2,5,7
HND-013409,2011,150900006,,,,2,3,5
HND-013410,2011,150900007,,,,3,3,6
HND-013412,2011,150900009,,,,0,3,3
HND-013414,2011,150900011,,,,3,1,4
HND-013416,2011,150900013,,,,2,9,11
HND-013419,2011,150900016,,,,1,4,5
HND-013420,2011,150900017,,,,0,4,4
HND-013423,2011,150900021,,,,3,3,6
,2011,150900023,,,,3,2,5
HND-013427,2011,150900026,,,,2,7,9
HND-013428,2011,150900027,,,,1,1,2
HND-013442,2011,150900069,,,,0,1,1
HND-013404,2011,150900001,,,,15,21,36
,2011,150900002,,,,3,2,5
HND-013407,2011,150900004,,,,4,0,4
,2011,150900005,,,,2,1,3
HND-013411,2011,150900008,,,,4,6,10
HND-013413,2011,150900010,,,,5,5,10
HND-013415,2011,150900012,,,,5,3,8
HND-013417,2011,150900014,,,,4,7,11
HND-013418,2011,150900015,,,,5,7,12
,2011,150900018,,,,3,0,3
HND-013422,2011,150900019,,,,0,1,1
HND-013424,2011,150900022,,,,4,1,5
HND-013434,2011,150900036,,,,1,6,7
HND-013427,2011,150900026,,,,19,12,31
HND-013411,2011,150900008,,,,6,12,18
HND-013432,2011,150900033,,,,25,30,55
HND-013411,2011,150900008,,,,5,11,16
HND-013427,2011,150900026,,,,6,14,20
HND-013432,2011,150900033,,,,32,36,68
HND-013411,2011,150900008,,,,3,5,8
HND-013427,2011,150900026,,,,15,14,29
HND-013432,2011,150900033,,,,34,35,69
HND-013432,2011,150900033,,,,25,26,51
HND-013432,2011,150900033,,,,33,18,51
HND-013432,2011,150900033,,,,18,20,38
,2011,151000052,,,,5,5,10
,2011,151000053,,,,5,2,7
,2011,151000055,,,,4,9,13
,2011,151000068,,,,5,6,11
,2011,151000070,,,,7,7,14
,2011,151000072,,,,7,7,14
HND-013483,2011,151000077,,,,4,6,10
,2011,151000080,,,,5,3,8
,2011,151000081,,,,3,7,10
,2011,151000056,,,,4,4,8
,2011,151000067,,,,7,6,13
,2011,151000078,,,,2,5,7
HND-013484,2011,151000079,,,,7,7,14
,2011,151000082,,,,8,3,11
,2011,151000074,,,,0,3,3
HND-013447,2011,151000019,,,,4,7,11
,2011,151000020,,,,1,1,2
HND-013448,2011,151000021,,,,7,9,16
HND-013449,2011,151000022,,,,1,3,4
HND-013466,2011,151000040,,,,1,1,2
HND-013481,2011,151000073,,,,15,4,19
,2011,151000074,,,,2,0,2
,2011,151000020,,,,8,3,11
HND-013466,2011,151000040,,,,10,10,20
,2011,151000074,,,,4,4,8
HND-013447,2011,151000019,,,,8,5,13
HND-013448,2011,151000021,,,,15,7,22
HND-013449,2011,151000022,,,,14,18,32
HND-013445,2011,151000001,,,,22,21,43
HND-013446,2011,151000002,,,,7,4,11
HND-013450,2011,151000023,,,,5,5,10
HND-013452,2011,151000026,,,,10,9,19
HND-013453,2011,151000027,,,,27,7,34
HND-013458,2011,151000032,,,,7,3,10
HND-013459,2011,151000033,,,,1,6,7
HND-013460,2011,151000034,,,,11,8,19
HND-013461,2011,151000035,,,,3,5,8
HND-013463,2011,151000037,,,,10,10,20
HND-013464,2011,151000038,,,,11,8,19
HND-013468,2011,151000042,,,,9,6,15
HND-013469,2011,151000043,,,,2,4,6
HND-013470,2011,151000044,,,,15,13,28
HND-013471,2011,151000045,,,,5,3,8
HND-013474,2011,151000048,,,,9,8,17
HND-013475,2011,151000060,,,,12,11,23
HND-013478,2011,151000063,,,,9,4,13
HND-013479,2011,151000064,,,,2,2,4
HND-013480,2011,151000065,,,,4,9,13
HND-013486,2011,151000084,,,,12,12,24
HND-013487,2011,151000086,,,,4,4,8
HND-013451,2011,151000025,,,,0,1,1
HND-013454,2011,151000028,,,,15,23,38
HND-013455,2011,151000029,,,,7,3,10
HND-013456,2011,151000030,,,,4,3,7
HND-013457,2011,151000031,,,,6,3,9
HND-013462,2011,151000036,,,,7,7,14
HND-013465,2011,151000039,,,,11,6,17
HND-013466,2011,151000040,,,,25,13,38
HND-013467,2011,151000041,,,,10,7,17
HND-013472,2011,151000046,,,,6,3,9
HND-013473,2011,151000047,,,,20,11,31
HND-013476,2011,151000061,,,,10,3,13
HND-013445,2011,151000001,,,,18,15,33
HND-013452,2011,151000026,,,,2,9,11
HND-013455,2011,151000029,,,,6,4,10
HND-013456,2011,151000030,,,,5,2,7
HND-013457,2011,151000031,,,,4,2,6
HND-013458,2011,151000032,,,,10,9,19
HND-013459,2011,151000033,,,,1,3,4
HND-013460,2011,151000034,,,,1,5,6
HND-013462,2011,151000036,,,,12,15,27
HND-013463,2011,151000037,,,,5,3,8
HND-013466,2011,151000040,,,,14,9,23
HND-013467,2011,151000041,,,,3,2,5
HND-013468,2011,151000042,,,,4,9,13
HND-013469,2011,151000043,,,,2,2,4
HND-013470,2011,151000044,,,,10,5,15
HND-013472,2011,151000046,,,,4,4,8
HND-013476,2011,151000061,,,,4,3,7
HND-013477,2011,151000062,,,,3,3,6
HND-013478,2011,151000063,,,,2,4,6
HND-013479,2011,151000064,,,,1,0,1
HND-013482,2011,151000075,,,,3,2,5
HND-013487,2011,151000086,,,,0,3,3
HND-013446,2011,151000002,,,,7,5,12
HND-013450,2011,151000023,,,,2,3,5
HND-013451,2011,151000025,,,,2,0,2
HND-013453,2011,151000027,,,,11,15,26
HND-013454,2011,151000028,,,,11,8,19
HND-013461,2011,151000035,,,,2,4,6
HND-013464,2011,151000038,,,,8,12,20
HND-013465,2011,151000039,,,,7,5,12
HND-013471,2011,151000045,,,,2,1,3
HND-013473,2011,151000047,,,,19,12,31
HND-013474,2011,151000048,,,,9,11,20
HND-013475,2011,151000060,,,,4,5,9
HND-013480,2011,151000065,,,,5,6,11
HND-013486,2011,151000084,,,,4,3,7
HND-013451,2011,151000025,,,,2,1,3
HND-013454,2011,151000028,,,,4,11,15
HND-013455,2011,151000029,,,,1,2,3
HND-013456,2011,151000030,,,,1,7,8
HND-013457,2011,151000031,,,,3,2,5
HND-013460,2011,151000034,,,,3,4,7
HND-013462,2011,151000036,,,,14,10,24
HND-013465,2011,151000039,,,,6,7,13
HND-013466,2011,151000040,,,,13,9,22
HND-013467,2011,151000041,,,,7,4,11
HND-013468,2011,151000042,,,,2,0,2
HND-013470,2011,151000044,,,,4,5,9
HND-013472,2011,151000046,,,,4,7,11
HND-013473,2011,151000047,,,,13,16,29
HND-013476,2011,151000061,,,,0,2,2
HND-013445,2011,151000001,,,,20,23,43
HND-013446,2011,151000002,,,,5,5,10
HND-013450,2011,151000023,,,,1,1,2
HND-013452,2011,151000026,,,,2,5,7
HND-013453,2011,151000027,,,,13,13,26
HND-013459,2011,151000033,,,,3,3,6
HND-013461,2011,151000035,,,,2,1,3
HND-013463,2011,151000037,,,,4,4,8
HND-013464,2011,151000038,,,,7,8,15
HND-013469,2011,151000043,,,,2,2,4
HND-013471,2011,151000045,,,,2,4,6
HND-013474,2011,151000048,,,,2,2,4
HND-013475,2011,151000060,,,,3,6,9
HND-013477,2011,151000062,,,,0,2,2
HND-013478,2011,151000063,,,,7,7,14
HND-013479,2011,151000064,,,,1,1,2
HND-013480,2011,151000065,,,,1,6,7
HND-013482,2011,151000075,,,,4,4,8
HND-013486,2011,151000084,,,,1,1,2
HND-013487,2011,151000086,,,,2,0,2
HND-013445,2011,151000001,,,,20,30,50
HND-013452,2011,151000026,,,,2,4,6
HND-013455,2011,151000029,,,,1,4,5
HND-013458,2011,151000032,,,,2,4,6
HND-013459,2011,151000033,,,,1,1,2
HND-013460,2011,151000034,,,,3,3,6
HND-013461,2011,151000035,,,,1,1,2
HND-013463,2011,151000037,,,,4,5,9
HND-013468,2011,151000042,,,,5,3,8
HND-013469,2011,151000043,,,,2,1,3
HND-013470,2011,151000044,,,,1,4,5
HND-013471,2011,151000045,,,,1,3,4
HND-013475,2011,151000060,,,,3,11,14
HND-013476,2011,151000061,,,,6,2,8
HND-013477,2011,151000062,,,,0,1,1
HND-013478,2011,151000063,,,,2,5,7
HND-013479,2011,151000064,,,,1,3,4
HND-013480,2011,151000065,,,,3,3,6
HND-013487,2011,151000086,,,,0,3,3
HND-013446,2011,151000002,,,,5,5,10
HND-013450,2011,151000023,,,,1,0,1
HND-013451,2011,151000025,,,,2,3,5
HND-013453,2011,151000027,,,,2,6,8
HND-013454,2011,151000028,,,,1,8,9
HND-013456,2011,151000030,,,,5,4,9
HND-013457,2011,151000031,,,,3,5,8
HND-013462,2011,151000036,,,,11,5,16
HND-013464,2011,151000038,,,,4,7,11
HND-013465,2011,151000039,,,,5,3,8
HND-013466,2011,151000040,,,,16,10,26
HND-013467,2011,151000041,,,,2,1,3
HND-013472,2011,151000046,,,,2,5,7
HND-013473,2011,151000047,,,,16,12,28
HND-013474,2011,151000048,,,,6,9,15
HND-013486,2011,151000084,,,,1,1,2
HND-013445,2011,151000001,,,,23,22,45
HND-013446,2011,151000002,,,,4,4,8
HND-013452,2011,151000026,,,,3,4,7
HND-013458,2011,151000032,,,,0,2,2
HND-013459,2011,151000033,,,,2,1,3
HND-013460,2011,151000034,,,,4,2,6
HND-013461,2011,151000035,,,,0,1,1
HND-013463,2011,151000037,,,,5,3,8
HND-013464,2011,151000038,,,,5,5,10
HND-013468,2011,151000042,,,,3,3,6
HND-013469,2011,151000043,,,,2,2,4
HND-013470,2011,151000044,,,,3,3,6
HND-013471,2011,151000045,,,,1,1,2
HND-013474,2011,151000048,,,,3,3,6
HND-013475,2011,151000060,,,,7,9,16
HND-013477,2011,151000062,,,,0,1,1
HND-013478,2011,151000063,,,,3,4,7
HND-013480,2011,151000065,,,,1,1,2
HND-013486,2011,151000084,,,,1,0,1
HND-013487,2011,151000086,,,,1,0,1
HND-013451,2011,151000025,,,,1,4,5
HND-013453,2011,151000027,,,,8,2,10
HND-013454,2011,151000028,,,,7,5,12
HND-013455,2011,151000029,,,,1,5,6
HND-013456,2011,151000030,,,,1,3,4
HND-013457,2011,151000031,,,,4,4,8
HND-013462,2011,151000036,,,,6,9,15
HND-013465,2011,151000039,,,,2,1,3
HND-013466,2011,151000040,,,,6,10,16
HND-013467,2011,151000041,,,,3,0,3
HND-013472,2011,151000046,,,,0,2,2
HND-013473,2011,151000047,,,,13,15,28
HND-013476,2011,151000061,,,,0,3,3
HND-013445,2011,151000001,,,,14,13,27
HND-013452,2011,151000026,,,,4,6,10
HND-013455,2011,151000029,,,,7,3,10
HND-013461,2011,151000035,,,,0,1,1
HND-013464,2011,151000038,,,,2,0,2
HND-013465,2011,151000039,,,,0,4,4
HND-013471,2011,151000045,,,,1,1,2
HND-013473,2011,151000047,,,,12,14,26
HND-013474,2011,151000048,,,,0,7,7
HND-013478,2011,151000063,,,,2,1,3
HND-013486,2011,151000084,,,,3,0,3
HND-013446,2011,151000002,,,,1,3,4
HND-013451,2011,151000025,,,,1,0,1
HND-013453,2011,151000027,,,,9,8,17
HND-013454,2011,151000028,,,,3,5,8
HND-013456,2011,151000030,,,,2,7,9
HND-013457,2011,151000031,,,,2,1,3
HND-013458,2011,151000032,,,,2,4,6
HND-013459,2011,151000033,,,,2,1,3
HND-013460,2011,151000034,,,,0,3,3
HND-013462,2011,151000036,,,,2,7,9
HND-013463,2011,151000037,,,,3,3,6
HND-013466,2011,151000040,,,,5,7,12
HND-013467,2011,151000041,,,,2,3,5
HND-013468,2011,151000042,,,,1,2,3
HND-013469,2011,151000043,,,,1,2,3
HND-013470,2011,151000044,,,,5,2,7
HND-013472,2011,151000046,,,,3,3,6
HND-013475,2011,151000060,,,,9,2,11
HND-013480,2011,151000065,,,,1,2,3
HND-013487,2011,151000086,,,,1,0,1
HND-013445,2011,151000001,,,,29,18,47
,2011,151000059,,,,26,22,48
,2011,151000059,,,,24,33,57
HND-013445,2011,151000001,,,,8,11,19
HND-013445,2011,151000001,,,,17,10,27
,2011,151000059,,,,15,19,34
,2011,151000059,,,,26,16,42
,2011,151000059,,,,16,18,34
,2011,151000059,,,,12,11,23
,2011,151100078,,,,8,5,13
,2011,151100082,,,,8,10,18
HND-013538,2011,151100095,,,,6,4,10
,2011,151100054,,,,10,7,17
,2011,151100056,,,,5,6,11
HND-013531,2011,151100057,,,,15,15,30
,2011,151100076,,,,9,2,11
HND-013533,2011,151100080,,,,9,3,12
,2011,151100081,,,,5,4,9
,2011,151100089,,,,8,7,15
,2011,151100090,,,,5,6,11
,2011,151100091,,,,6,9,15
,2011,151100092,,,,4,5,9
HND-013536,2011,151100093,,,,3,7,10
HND-013537,2011,151100094,,,,4,4,8
HND-013522,2011,151100043,,,,6,4,10
,2011,151100045,,,,1,3,4
,2011,151100084,,,,5,2,7
,2011,151100086,,,,2,0,2
HND-013510,2011,151100026,,,,12,6,18
HND-013520,2011,151100040,,,,6,4,10
HND-013523,2011,151100044,,,,1,4,5
HND-013528,2011,151100050,,,,3,0,3
HND-013529,2011,151100051,,,,1,2,3
HND-013532,2011,151100079,,,,5,4,9
HND-013534,2011,151100083,,,,4,3,7
HND-013535,2011,151100085,,,,2,1,3
HND-013527,2011,151100049,,,,5,5,10
HND-013532,2011,151100079,,,,1,2,3
HND-013534,2011,151100083,,,,6,3,9
,2011,151100084,,,,4,3,7
HND-013535,2011,151100085,,,,6,2,8
HND-013510,2011,151100026,,,,22,25,47
HND-013519,2011,151100039,,,,4,5,9
HND-013520,2011,151100040,,,,6,2,8
HND-013521,2011,151100041,,,,4,2,6
HND-013522,2011,151100043,,,,2,4,6
HND-013523,2011,151100044,,,,4,2,6
,2011,151100045,,,,0,4,4
HND-013524,2011,151100046,,,,2,1,3
HND-013528,2011,151100050,,,,3,3,6
HND-013529,2011,151100051,,,,5,4,9
HND-013530,2011,151100052,,,,2,4,6
,2011,151100086,,,,1,5,6
HND-013510,2011,151100026,,,,17,18,35
HND-013519,2011,151100039,,,,7,7,14
HND-013522,2011,151100043,,,,3,5,8
HND-013523,2011,151100044,,,,1,3,4
,2011,151100045,,,,3,3,6
HND-013528,2011,151100050,,,,4,3,7
HND-013529,2011,151100051,,,,1,1,2
HND-013530,2011,151100052,,,,4,6,10
,2011,151100086,,,,4,5,9
HND-013520,2011,151100040,,,,13,19,32
HND-013521,2011,151100041,,,,8,6,14
HND-013524,2011,151100046,,,,4,5,9
HND-013527,2011,151100049,,,,1,5,6
HND-013532,2011,151100079,,,,3,2,5
HND-013534,2011,151100083,,,,2,3,5
,2011,151100084,,,,0,1,1
HND-013535,2011,151100085,,,,5,3,8
HND-013488,2011,151100001,,,,11,5,16
HND-013489,2011,151100002,,,,33,40,73
HND-013490,2011,151100003,,,,5,3,8
HND-013492,2011,151100005,,,,2,1,3
HND-013493,2011,151100006,,,,4,5,9
HND-013494,2011,151100007,,,,3,0,3
HND-013497,2011,151100010,,,,1,3,4
HND-013498,2011,151100011,,,,17,14,31
HND-013503,2011,151100016,,,,12,13,25
HND-013511,2011,151100028,,,,3,3,6
HND-013512,2011,151100029,,,,4,3,7
HND-013513,2011,151100030,,,,5,5,10
HND-013514,2011,151100031,,,,2,1,3
HND-013515,2011,151100032,,,,4,2,6
HND-013516,2011,151100034,,,,3,3,6
,2011,151100036,,,,1,0,1
HND-013491,2011,151100004,,,,24,21,45
HND-013495,2011,151100008,,,,9,9,18
HND-013496,2011,151100009,,,,2,4,6
HND-013499,2011,151100012,,,,17,10,27
HND-013500,2011,151100013,,,,1,0,1
HND-013501,2011,151100014,,,,6,5,11
HND-013502,2011,151100015,,,,3,3,6
HND-013504,2011,151100017,,,,0,4,4
HND-013506,2011,151100020,,,,15,14,29
HND-013507,2011,151100021,,,,6,1,7
HND-013508,2011,151100023,,,,2,6,8
HND-013509,2011,151100024,,,,1,2,3
,2011,151100035,,,,2,0,2
HND-013517,2011,151100037,,,,0,1,1
HND-013518,2011,151100038,,,,4,2,6
HND-013525,2011,151100047,,,,8,2,10
HND-013488,2011,151100001,,,,12,11,23
HND-013493,2011,151100006,,,,1,5,6
HND-013496,2011,151100009,,,,5,3,8
HND-013500,2011,151100013,,,,1,3,4
HND-013502,2011,151100015,,,,9,5,14
HND-013504,2011,151100017,,,,3,2,5
HND-013505,2011,151100019,,,,4,2,6
HND-013508,2011,151100023,,,,4,2,6
HND-013509,2011,151100024,,,,2,2,4
HND-013511,2011,151100028,,,,1,1,2
HND-013513,2011,151100030,,,,3,7,10
HND-013514,2011,151100031,,,,3,1,4
,2011,151100036,,,,3,0,3
HND-013518,2011,151100038,,,,0,2,2
HND-013525,2011,151100047,,,,3,4,7
HND-013489,2011,151100002,,,,49,41,90
HND-013490,2011,151100003,,,,7,4,11
HND-013491,2011,151100004,,,,40,24,64
HND-013492,2011,151100005,,,,1,0,1
HND-013494,2011,151100007,,,,3,0,3
HND-013495,2011,151100008,,,,8,7,15
HND-013497,2011,151100010,,,,2,1,3
HND-013498,2011,151100011,,,,15,14,29
HND-013499,2011,151100012,,,,13,15,28
HND-013501,2011,151100014,,,,4,6,10
HND-013503,2011,151100016,,,,17,9,26
HND-013506,2011,151100020,,,,20,12,32
HND-013507,2011,151100021,,,,4,5,9
HND-013512,2011,151100029,,,,4,0,4
HND-013515,2011,151100032,,,,2,2,4
HND-013516,2011,151100034,,,,4,4,8
,2011,151100035,,,,2,3,5
HND-013517,2011,151100037,,,,1,3,4
HND-013491,2011,151100004,,,,29,27,56
HND-013493,2011,151100006,,,,3,4,7
HND-013495,2011,151100008,,,,6,6,12
HND-013496,2011,151100009,,,,6,5,11
HND-013499,2011,151100012,,,,10,11,21
HND-013500,2011,151100013,,,,0,3,3
HND-013501,2011,151100014,,,,6,8,14
HND-013502,2011,151100015,,,,7,6,13
HND-013504,2011,151100017,,,,3,2,5
HND-013506,2011,151100020,,,,9,8,17
HND-013507,2011,151100021,,,,2,1,3
HND-013508,2011,151100023,,,,0,4,4
HND-013509,2011,151100024,,,,1,2,3
,2011,151100035,,,,3,0,3
HND-013518,2011,151100038,,,,1,1,2
HND-013525,2011,151100047,,,,6,4,10
HND-013488,2011,151100001,,,,13,7,20
HND-013489,2011,151100002,,,,48,37,85
HND-013490,2011,151100003,,,,5,4,9
HND-013492,2011,151100005,,,,4,2,6
HND-013494,2011,151100007,,,,1,3,4
HND-013497,2011,151100010,,,,6,3,9
HND-013498,2011,151100011,,,,26,15,41
HND-013503,2011,151100016,,,,16,14,30
HND-013505,2011,151100019,,,,7,4,11
HND-013511,2011,151100028,,,,0,3,3
HND-013512,2011,151100029,,,,2,3,5
HND-013513,2011,151100030,,,,2,2,4
HND-013514,2011,151100031,,,,4,5,9
HND-013515,2011,151100032,,,,1,1,2
HND-013516,2011,151100034,,,,3,4,7
,2011,151100036,,,,1,2,3
HND-013488,2011,151100001,,,,11,8,19
HND-013489,2011,151100002,,,,42,46,88
HND-013493,2011,151100006,,,,2,4,6
HND-013505,2011,151100019,,,,1,4,5
HND-013508,2011,151100023,,,,1,0,1
HND-013511,2011,151100028,,,,4,0,4
HND-013513,2011,151100030,,,,6,4,10
,2011,151100036,,,,1,2,3
HND-013525,2011,151100047,,,,9,4,13
HND-013490,2011,151100003,,,,3,1,4
HND-013491,2011,151100004,,,,32,33,65
HND-013492,2011,151100005,,,,2,1,3
HND-013494,2011,151100007,,,,1,1,2
HND-013495,2011,151100008,,,,5,8,13
HND-013496,2011,151100009,,,,6,6,12
HND-013497,2011,151100010,,,,8,10,18
HND-013498,2011,151100011,,,,9,8,17
HND-013499,2011,151100012,,,,14,21,35
HND-013500,2011,151100013,,,,1,4,5
HND-013501,2011,151100014,,,,4,5,9
HND-013502,2011,151100015,,,,9,9,18
HND-013503,2011,151100016,,,,16,9,25
HND-013504,2011,151100017,,,,4,3,7
HND-013506,2011,151100020,,,,5,11,16
HND-013507,2011,151100021,,,,3,1,4
HND-013509,2011,151100024,,,,5,3,8
HND-013512,2011,151100029,,,,7,5,12
HND-013515,2011,151100032,,,,6,2,8
HND-013516,2011,151100034,,,,4,8,12
HND-013517,2011,151100037,,,,1,4,5
HND-013518,2011,151100038,,,,2,1,3
HND-013488,2011,151100001,,,,4,6,10
HND-013489,2011,151100002,,,,37,30,67
HND-013493,2011,151100006,,,,6,4,10
HND-013494,2011,151100007,,,,3,3,6
HND-013497,2011,151100010,,,,7,7,14
HND-013498,2011,151100011,,,,13,9,22
HND-013503,2011,151100016,,,,23,20,43
HND-013505,2011,151100019,,,,2,0,2
HND-013511,2011,151100028,,,,6,4,10
HND-013512,2011,151100029,,,,4,2,6
HND-013513,2011,151100030,,,,5,5,10
HND-013514,2011,151100031,,,,1,1,2
HND-013515,2011,151100032,,,,1,2,3
HND-013516,2011,151100034,,,,4,1,5
,2011,151100036,,,,2,1,3
HND-013525,2011,151100047,,,,4,1,5
HND-013491,2011,151100004,,,,30,27,57
HND-013492,2011,151100005,,,,4,3,7
HND-013495,2011,151100008,,,,7,6,13
HND-013496,2011,151100009,,,,9,6,15
HND-013499,2011,151100012,,,,17,14,31
HND-013500,2011,151100013,,,,4,2,6
HND-013501,2011,151100014,,,,6,6,12
HND-013502,2011,151100015,,,,6,1,7
HND-013504,2011,151100017,,,,3,1,4
HND-013506,2011,151100020,,,,6,6,12
HND-013507,2011,151100021,,,,1,2,3
HND-013509,2011,151100024,,,,1,3,4
,2011,151100035,,,,2,3,5
HND-013517,2011,151100037,,,,1,1,2
HND-013489,2011,151100002,,,,37,29,66
HND-013490,2011,151100003,,,,4,1,5
HND-013491,2011,151100004,,,,26,34,60
HND-013492,2011,151100005,,,,2,0,2
HND-013495,2011,151100008,,,,5,5,10
HND-013497,2011,151100010,,,,4,6,10
HND-013498,2011,151100011,,,,11,8,19
HND-013499,2011,151100012,,,,8,5,13
HND-013501,2011,151100014,,,,4,6,10
HND-013503,2011,151100016,,,,11,12,23
HND-013506,2011,151100020,,,,0,6,6
HND-013507,2011,151100021,,,,0,3,3
HND-013512,2011,151100029,,,,2,5,7
HND-013515,2011,151100032,,,,2,2,4
HND-013516,2011,151100034,,,,0,1,1
HND-013517,2011,151100037,,,,1,0,1
HND-013488,2011,151100001,,,,6,7,13
HND-013493,2011,151100006,,,,1,4,5
HND-013496,2011,151100009,,,,6,6,12
HND-013500,2011,151100013,,,,1,2,3
HND-013502,2011,151100015,,,,1,6,7
HND-013508,2011,151100023,,,,0,4,4
HND-013509,2011,151100024,,,,2,3,5
HND-013511,2011,151100028,,,,2,3,5
HND-013513,2011,151100030,,,,2,4,6
HND-013514,2011,151100031,,,,1,2,3
,2011,151100036,,,,0,2,2
HND-013525,2011,151100047,,,,4,2,6
HND-013489,2011,151100002,,,,33,41,74
HND-013498,2011,151100011,,,,8,13,21
HND-013499,2011,151100012,,,,15,16,31
HND-013526,2011,151100048,,,,53,69,122
HND-013489,2011,151100002,,,,40,45,85
HND-013498,2011,151100011,,,,3,10,13
HND-013499,2011,151100012,,,,8,19,27
HND-013526,2011,151100048,,,,44,85,129
HND-013489,2011,151100002,,,,14,28,42
HND-013498,2011,151100011,,,,5,7,12
HND-013499,2011,151100012,,,,7,14,21
HND-013526,2011,151100048,,,,48,54,102
HND-013526,2011,151100048,,,,39,43,82
HND-013526,2011,151100048,,,,16,44,60
HND-013526,2011,151100048,,,,24,46,70
,2011,151200053,,,,5,5,10
HND-013562,2011,151200054,,,,4,7,11
,2011,151200057,,,,6,4,10
,2011,151200045,,,,8,10,18
HND-013564,2011,151200056,,,,8,2,10
,2011,151200062,,,,3,3,6
HND-013546,2011,151200009,,,,12,12,24
HND-013549,2011,151200014,,,,2,2,4
,2011,151200062,,,,3,3,6
,2011,151200055,,,,5,6,11
HND-013546,2011,151200009,,,,13,10,23
HND-013549,2011,151200014,,,,3,6,9
,2011,151200062,,,,6,8,14
HND-013540,2011,151200002,,,,16,21,37
HND-013541,2011,151200003,,,,8,12,20
HND-013543,2011,151200005,,,,11,14,25
,2011,151200007,,,,4,2,6
HND-013545,2011,151200008,,,,3,2,5
HND-013550,2011,151200015,,,,3,2,5
HND-013552,2011,151200018,,,,5,2,7
HND-013553,2011,151200019,,,,3,4,7
HND-013556,2011,151200022,,,,8,15,23
HND-013557,2011,151200023,,,,1,1,2
HND-013558,2011,151200040,,,,11,18,29
HND-013559,2011,151200044,,,,3,1,4
,2011,151200058,,,,5,1,6
,2011,151200059,,,,1,2,3
,2011,151200063,,,,3,2,5
HND-013539,2011,151200001,,,,11,13,24
HND-013542,2011,151200004,,,,6,4,10
HND-013544,2011,151200006,,,,3,4,7
HND-013547,2011,151200011,,,,1,1,2
HND-013548,2011,151200013,,,,2,3,5
,2011,151200016,,,,1,1,2
HND-013551,2011,151200017,,,,2,0,2
HND-013554,2011,151200020,,,,3,3,6
HND-013555,2011,151200021,,,,2,5,7
HND-013560,2011,151200051,,,,2,4,6
,2011,151200052,,,,3,8,11
,2011,151200060,,,,3,1,4
,2011,151200061,,,,1,4,5
HND-013540,2011,151200002,,,,17,32,49
HND-013545,2011,151200008,,,,1,2,3
HND-013547,2011,151200011,,,,1,2,3
,2011,151200016,,,,3,4,7
HND-013558,2011,151200040,,,,5,4,9
,2011,151200052,,,,5,4,9
,2011,151200058,,,,1,2,3
HND-013539,2011,151200001,,,,10,7,17
HND-013541,2011,151200003,,,,7,6,13
HND-013542,2011,151200004,,,,8,5,13
HND-013543,2011,151200005,,,,5,7,12
HND-013544,2011,151200006,,,,4,4,8
,2011,151200007,,,,3,3,6
HND-013548,2011,151200013,,,,2,1,3
HND-013550,2011,151200015,,,,2,5,7
HND-013551,2011,151200017,,,,3,0,3
HND-013552,2011,151200018,,,,5,0,5
HND-013554,2011,151200020,,,,3,5,8
HND-013555,2011,151200021,,,,3,4,7
HND-013556,2011,151200022,,,,2,1,3
HND-013557,2011,151200023,,,,4,0,4
HND-013559,2011,151200044,,,,0,5,5
HND-013560,2011,151200051,,,,2,2,4
,2011,151200059,,,,0,1,1
,2011,151200060,,,,1,0,1
,2011,151200063,,,,3,0,3
HND-013540,2011,151200002,,,,18,14,32
HND-013541,2011,151200003,,,,14,13,27
HND-013543,2011,151200005,,,,2,3,5
,2011,151200007,,,,5,0,5
HND-013545,2011,151200008,,,,1,2,3
HND-013550,2011,151200015,,,,5,1,6
HND-013552,2011,151200018,,,,7,3,10
HND-013553,2011,151200019,,,,0,2,2
HND-013556,2011,151200022,,,,3,1,4
HND-013557,2011,151200023,,,,2,1,3
HND-013560,2011,151200051,,,,5,1,6
,2011,151200052,,,,4,3,7
,2011,151200063,,,,1,0,1
HND-013539,2011,151200001,,,,8,9,17
HND-013542,2011,151200004,,,,5,4,9
HND-013544,2011,151200006,,,,4,6,10
HND-013547,2011,151200011,,,,2,2,4
HND-013548,2011,151200013,,,,0,1,1
,2011,151200016,,,,0,1,1
HND-013551,2011,151200017,,,,2,2,4
HND-013554,2011,151200020,,,,4,3,7
HND-013555,2011,151200021,,,,1,4,5
HND-013558,2011,151200040,,,,6,6,12
HND-013559,2011,151200044,,,,4,4,8
,2011,151200058,,,,3,1,4
,2011,151200059,,,,1,0,1
,2011,151200060,,,,0,1,1
,2011,151200061,,,,2,3,5
HND-013539,2011,151200001,,,,10,2,12
HND-013540,2011,151200002,,,,17,15,32
HND-013544,2011,151200006,,,,8,5,13
HND-013547,2011,151200011,,,,3,1,4
,2011,151200016,,,,2,1,3
HND-013553,2011,151200019,,,,3,3,6
HND-013558,2011,151200040,,,,9,7,16
,2011,151200052,,,,3,4,7
,2011,151200058,,,,1,2,3
HND-013541,2011,151200003,,,,7,8,15
HND-013542,2011,151200004,,,,2,4,6
HND-013543,2011,151200005,,,,2,5,7
,2011,151200007,,,,3,0,3
HND-013545,2011,151200008,,,,3,3,6
HND-013550,2011,151200015,,,,4,4,8
HND-013551,2011,151200017,,,,2,2,4
HND-013552,2011,151200018,,,,3,1,4
HND-013554,2011,151200020,,,,4,2,6
HND-013555,2011,151200021,,,,3,2,5
HND-013556,2011,151200022,,,,1,0,1
HND-013557,2011,151200023,,,,2,1,3
HND-013559,2011,151200044,,,,3,3,6
,2011,151200059,,,,1,1,2
,2011,151200060,,,,0,3,3
,2011,151200061,,,,1,0,1
HND-013539,2011,151200001,,,,11,9,20
HND-013544,2011,151200006,,,,2,4,6
HND-013547,2011,151200011,,,,3,0,3
,2011,151200016,,,,3,4,7
HND-013554,2011,151200020,,,,6,5,11
HND-013555,2011,151200021,,,,2,0,2
HND-013558,2011,151200040,,,,7,7,14
,2011,151200058,,,,1,1,2
,2011,151200059,,,,0,2,2
,2011,151200060,,,,1,2,3
,2011,151200061,,,,1,1,2
HND-013540,2011,151200002,,,,20,16,36
HND-013541,2011,151200003,,,,12,11,23
HND-013542,2011,151200004,,,,1,1,2
HND-013543,2011,151200005,,,,2,6,8
,2011,151200007,,,,2,4,6
HND-013545,2011,151200008,,,,1,3,4
HND-013548,2011,151200013,,,,0,2,2
HND-013550,2011,151200015,,,,1,0,1
HND-013551,2011,151200017,,,,3,2,5
HND-013552,2011,151200018,,,,3,0,3
HND-013553,2011,151200019,,,,0,1,1
HND-013556,2011,151200022,,,,1,0,1
HND-013560,2011,151200051,,,,1,3,4
,2011,151200052,,,,1,0,1
,2011,151200063,,,,0,2,2
HND-013539,2011,151200001,,,,6,4,10
HND-013541,2011,151200003,,,,7,8,15
HND-013542,2011,151200004,,,,2,1,3
HND-013543,2011,151200005,,,,1,4,5
HND-013544,2011,151200006,,,,5,2,7
HND-013548,2011,151200013,,,,1,2,3
HND-013550,2011,151200015,,,,5,1,6
HND-013551,2011,151200017,,,,1,0,1
HND-013552,2011,151200018,,,,2,3,5
HND-013554,2011,151200020,,,,3,3,6
HND-013555,2011,151200021,,,,1,4,5
HND-013556,2011,151200022,,,,1,3,4
HND-013557,2011,151200023,,,,0,1,1
HND-013559,2011,151200044,,,,1,4,5
HND-013560,2011,151200051,,,,0,1,1
,2011,151200059,,,,1,1,2
,2011,151200061,,,,1,0,1
,2011,151200063,,,,2,0,2
HND-013540,2011,151200002,,,,15,14,29
HND-013545,2011,151200008,,,,0,2,2
HND-013547,2011,151200011,,,,1,1,2
,2011,151200016,,,,0,1,1
HND-013553,2011,151200019,,,,1,0,1
HND-013558,2011,151200040,,,,10,6,16
,2011,151200052,,,,2,1,3
,2011,151200058,,,,0,1,1
HND-013539,2011,151200001,,,,14,8,22
HND-013540,2011,151200002,,,,17,15,32
,2011,151200043,,,,11,15,26
HND-013539,2011,151200001,,,,8,11,19
HND-013540,2011,151200002,,,,10,18,28
,2011,151200043,,,,12,7,19
HND-013539,2011,151200001,,,,7,8,15
HND-013540,2011,151200002,,,,14,16,30
,2011,151200043,,,,5,5,10
HND-013540,2011,151200002,,,,15,20,35
,2011,151200043,,,,7,2,9
,2011,151200043,,,,8,7,15
HND-013540,2011,151200002,,,,11,6,17
HND-013540,2011,151200002,,,,4,8,12
,2011,151300032,,,,5,4,9
HND-013592,2011,151300059,,,,3,7,10
,2011,151300060,,,,4,4,8
HND-013593,2011,151300066,,,,5,5,10
,2011,151300067,,,,4,6,10
HND-013587,2011,151300033,,,,4,6,10
,2011,151300035,,,,3,6,9
,2011,151300068,,,,6,3,9
,2011,151300071,,,,4,6,10
,2011,151300072,,,,3,6,9
HND-013596,2011,151300073,,,,5,5,10
HND-013578,2011,151300009,,,,18,17,35
,2011,151300028,,,,0,1,1
,2011,151300047,,,,3,3,6
,2011,151300055,,,,3,1,4
,2011,151300063,,,,1,2,3
,2011,151300065,,,,3,0,3
HND-013595,2011,151300070,,,,3,4,7
,2011,151300010,,,,3,1,4
,2011,151300011,,,,2,5,7
,2011,151300029,,,,2,2,4
,2011,151300062,,,,6,6,12
,2011,151300064,,,,1,2,3
,2011,151300010,,,,2,3,5
,2011,151300011,,,,2,6,8
,2011,151300047,,,,2,2,4
,2011,151300062,,,,2,4,6
,2011,151300063,,,,4,2,6
,2011,151300064,,,,0,5,5
HND-013578,2011,151300009,,,,37,28,65
,2011,151300028,,,,2,1,3
,2011,151300029,,,,3,3,6
,2011,151300055,,,,1,2,3
,2011,151300065,,,,2,3,5
HND-013595,2011,151300070,,,,11,14,25
HND-013572,2011,151300002,,,,12,16,28
HND-013573,2011,151300003,,,,0,3,3
HND-013574,2011,151300004,,,,3,3,6
HND-013576,2011,151300006,,,,2,3,5
HND-013577,2011,151300007,,,,3,3,6
HND-013581,2011,151300017,,,,1,1,2
,2011,151300018,,,,0,1,1
HND-013584,2011,151300022,,,,7,2,9
HND-013585,2011,151300023,,,,0,2,2
HND-013586,2011,151300024,,,,2,3,5
,2011,151300027,,,,0,1,1
HND-013588,2011,151300054,,,,0,4,4
HND-013589,2011,151300056,,,,1,2,3
HND-013571,2011,151300001,,,,45,47,92
HND-013575,2011,151300005,,,,9,2,11
,2011,151300011,,,,15,12,27
HND-013580,2011,151300016,,,,2,2,4
HND-013582,2011,151300019,,,,8,9,17
HND-013583,2011,151300021,,,,6,5,11
HND-013590,2011,151300057,,,,6,0,6
HND-013591,2011,151300058,,,,2,2,4
HND-013594,2011,151300069,,,,1,2,3
HND-013576,2011,151300006,,,,4,0,4
,2011,151300011,,,,6,5,11
HND-013580,2011,151300016,,,,2,3,5
HND-013581,2011,151300017,,,,1,2,3
HND-013583,2011,151300021,,,,8,0,8
HND-013584,2011,151300022,,,,5,3,8
HND-013586,2011,151300024,,,,2,9,11
HND-013589,2011,151300056,,,,3,2,5
HND-013591,2011,151300058,,,,1,1,2
HND-013571,2011,151300001,,,,64,56,120
HND-013572,2011,151300002,,,,17,18,35
HND-013573,2011,151300003,,,,1,2,3
HND-013574,2011,151300004,,,,3,3,6
HND-013575,2011,151300005,,,,6,7,13
HND-013577,2011,151300007,,,,3,3,6
HND-013582,2011,151300019,,,,1,8,9
HND-013585,2011,151300023,,,,0,1,1
,2011,151300027,,,,0,2,2
HND-013588,2011,151300054,,,,3,1,4
HND-013590,2011,151300057,,,,4,3,7
HND-013594,2011,151300069,,,,1,2,3
HND-013575,2011,151300005,,,,7,5,12
,2011,151300011,,,,8,5,13
HND-013580,2011,151300016,,,,3,2,5
HND-013582,2011,151300019,,,,2,7,9
HND-013583,2011,151300021,,,,5,2,7
HND-013590,2011,151300057,,,,3,2,5
HND-013591,2011,151300058,,,,2,0,2
HND-013594,2011,151300069,,,,1,2,3
HND-013571,2011,151300001,,,,64,63,127
HND-013572,2011,151300002,,,,10,17,27
HND-013573,2011,151300003,,,,2,0,2
HND-013574,2011,151300004,,,,3,4,7
HND-013576,2011,151300006,,,,3,2,5
HND-013577,2011,151300007,,,,3,1,4
HND-013581,2011,151300017,,,,1,0,1
HND-013584,2011,151300022,,,,6,6,12
HND-013585,2011,151300023,,,,1,1,2
HND-013586,2011,151300024,,,,4,3,7
,2011,151300027,,,,3,1,4
HND-013588,2011,151300054,,,,0,3,3
HND-013589,2011,151300056,,,,3,0,3
HND-013576,2011,151300006,,,,3,2,5
,2011,151300011,,,,3,3,6
HND-013580,2011,151300016,,,,1,4,5
HND-013581,2011,151300017,,,,1,5,6
HND-013583,2011,151300021,,,,3,1,4
HND-013584,2011,151300022,,,,2,1,3
HND-013585,2011,151300023,,,,2,0,2
HND-013586,2011,151300024,,,,2,3,5
,2011,151300027,,,,1,1,2
HND-013589,2011,151300056,,,,2,2,4
HND-013571,2011,151300001,,,,58,72,130
HND-013572,2011,151300002,,,,11,2,13
HND-013573,2011,151300003,,,,3,1,4
HND-013574,2011,151300004,,,,5,2,7
HND-013575,2011,151300005,,,,9,7,16
HND-013582,2011,151300019,,,,2,5,7
HND-013588,2011,151300054,,,,4,0,4
HND-013590,2011,151300057,,,,0,1,1
HND-013591,2011,151300058,,,,2,0,2
HND-013594,2011,151300069,,,,0,2,2
HND-013572,2011,151300002,,,,13,5,18
HND-013574,2011,151300004,,,,6,3,9
HND-013576,2011,151300006,,,,3,2,5
HND-013581,2011,151300017,,,,1,0,1
,2011,151300018,,,,2,0,2
HND-013584,2011,151300022,,,,1,0,1
HND-013585,2011,151300023,,,,1,2,3
HND-013586,2011,151300024,,,,5,0,5
HND-013590,2011,151300057,,,,5,1,6
HND-013591,2011,151300058,,,,2,0,2
HND-013571,2011,151300001,,,,60,80,140
HND-013573,2011,151300003,,,,0,2,2
HND-013575,2011,151300005,,,,4,6,10
HND-013577,2011,151300007,,,,0,5,5
,2011,151300011,,,,3,2,5
HND-013580,2011,151300016,,,,2,0,2
HND-013582,2011,151300019,,,,7,3,10
HND-013583,2011,151300021,,,,4,2,6
HND-013588,2011,151300054,,,,0,2,2
HND-013589,2011,151300056,,,,3,1,4
HND-013571,2011,151300001,,,,51,75,126
HND-013572,2011,151300002,,,,8,3,11
HND-013573,2011,151300003,,,,1,0,1
HND-013574,2011,151300004,,,,4,2,6
HND-013575,2011,151300005,,,,5,3,8
HND-013577,2011,151300007,,,,2,1,3
,2011,151300018,,,,0,2,2
HND-013582,2011,151300019,,,,4,1,5
HND-013585,2011,151300023,,,,2,0,2
,2011,151300027,,,,2,0,2
HND-013591,2011,151300058,,,,2,0,2
HND-013576,2011,151300006,,,,3,3,6
,2011,151300011,,,,8,3,11
HND-013580,2011,151300016,,,,1,5,6
HND-013581,2011,151300017,,,,1,0,1
HND-013583,2011,151300021,,,,1,2,3
HND-013584,2011,151300022,,,,0,1,1
HND-013588,2011,151300054,,,,1,1,2
HND-013590,2011,151300057,,,,2,3,5
HND-013574,2011,151300004,,,,6,4,10
HND-013575,2011,151300005,,,,10,15,25
HND-013579,2011,151300014,,,,54,66,120
,2011,151300020,,,,3,6,9
,2011,151300036,,,,14,17,31
HND-013579,2011,151300014,,,,43,61,104
,2011,151300020,,,,6,7,13
,2011,151300036,,,,9,10,19
HND-013574,2011,151300004,,,,2,7,9
HND-013575,2011,151300005,,,,20,6,26
HND-013579,2011,151300014,,,,33,54,87
,2011,151300036,,,,17,20,37
HND-013574,2011,151300004,,,,4,6,10
HND-013575,2011,151300005,,,,7,4,11
,2011,151300020,,,,3,3,6
HND-013579,2011,151300014,,,,45,66,111
,2011,151300036,,,,25,30,55
,2011,151300020,,,,6,10,16
,2011,151300020,,,,7,8,15
,2011,151300036,,,,20,47,67
HND-013579,2011,151300014,,,,39,43,82
HND-013579,2011,151300014,,,,35,40,75
,2011,151400033,,,,5,6,11
HND-013624,2011,151400034,,,,3,7,10
HND-013625,2011,151400036,,,,3,9,12
HND-013629,2011,151400066,,,,9,4,13
,2011,151400073,,,,4,4,8
,2011,151400035,,,,5,10,15
,2011,151400038,,,,6,4,10
,2011,151400042,,,,6,4,10
HND-013630,2011,151400069,,,,6,6,12
,2011,151400070,,,,12,12,24
,2011,151400072,,,,7,6,13
,2011,151400030,,,,1,4,5
,2011,151400067,,,,2,0,2
,2011,151400080,,,,1,2,3
HND-013634,2011,151400081,,,,4,4,8
,2011,151400074,,,,2,0,2
,2011,151400077,,,,3,1,4
HND-013613,2011,151400017,,,,10,8,18
HND-013615,2011,151400019,,,,5,14,19
,2011,151400030,,,,3,4,7
,2011,151400074,,,,2,9,11
,2011,151400077,,,,0,4,4
,2011,151400080,,,,1,5,6
HND-013634,2011,151400081,,,,1,4,5
HND-013614,2011,151400018,,,,1,2,3
,2011,151400067,,,,4,3,7
,2011,151400068,,,,3,9,12
HND-013613,2011,151400017,,,,24,18,42
HND-013614,2011,151400018,,,,9,6,15
HND-013615,2011,151400019,,,,1,3,4
,2011,151400068,,,,1,4,5
,2011,151400074,,,,4,7,11
,2011,151400030,,,,4,0,4
,2011,151400067,,,,3,3,6
,2011,151400077,,,,7,1,8
,2011,151400080,,,,1,2,3
HND-013634,2011,151400081,,,,3,1,4
HND-013598,2011,151400001,,,,9,5,14
HND-013603,2011,151400006,,,,1,3,4
HND-013606,2011,151400009,,,,4,5,9
HND-013607,2011,151400010,,,,9,14,23
,2011,151400011,,,,2,2,4
HND-013612,2011,151400016,,,,2,3,5
HND-013616,2011,151400020,,,,6,11,17
HND-013617,2011,151400021,,,,9,4,13
HND-013622,2011,151400029,,,,9,5,14
HND-013623,2011,151400031,,,,0,3,3
HND-013626,2011,151400061,,,,6,4,10
HND-013599,2011,151400002,,,,17,16,33
HND-013600,2011,151400003,,,,4,0,4
HND-013601,2011,151400004,,,,6,9,15
HND-013604,2011,151400007,,,,5,7,12
HND-013605,2011,151400008,,,,3,4,7
HND-013608,2011,151400012,,,,1,2,3
HND-013609,2011,151400013,,,,1,0,1
HND-013610,2011,151400014,,,,6,3,9
HND-013611,2011,151400015,,,,5,5,10
HND-013618,2011,151400022,,,,3,1,4
HND-013619,2011,151400023,,,,24,8,32
HND-013621,2011,151400028,,,,19,8,27
HND-013627,2011,151400062,,,,9,5,14
HND-013628,2011,151400063,,,,10,6,16
HND-013631,2011,151400076,,,,3,1,4
HND-013632,2011,151400078,,,,6,2,8
HND-013633,2011,151400079,,,,10,3,13
HND-013599,2011,151400002,,,,18,22,40
HND-013602,2011,151400005,,,,3,0,3
HND-013605,2011,151400008,,,,5,3,8
HND-013606,2011,151400009,,,,12,4,16
HND-013609,2011,151400013,,,,3,1,4
HND-013611,2011,151400015,,,,4,3,7
HND-013621,2011,151400028,,,,10,10,20
HND-013622,2011,151400029,,,,4,2,6
HND-013631,2011,151400076,,,,6,1,7
HND-013598,2011,151400001,,,,9,5,14
HND-013600,2011,151400003,,,,1,0,1
HND-013601,2011,151400004,,,,2,1,3
HND-013603,2011,151400006,,,,6,3,9
HND-013604,2011,151400007,,,,4,5,9
HND-013607,2011,151400010,,,,8,5,13
,2011,151400011,,,,2,0,2
HND-013608,2011,151400012,,,,1,1,2
HND-013610,2011,151400014,,,,2,0,2
HND-013612,2011,151400016,,,,9,15,24
HND-013616,2011,151400020,,,,6,5,11
HND-013617,2011,151400021,,,,10,1,11
HND-013618,2011,151400022,,,,8,2,10
HND-013619,2011,151400023,,,,9,6,15
HND-013623,2011,151400031,,,,1,1,2
HND-013626,2011,151400061,,,,4,9,13
HND-013627,2011,151400062,,,,8,11,19
HND-013628,2011,151400063,,,,7,5,12
HND-013632,2011,151400078,,,,5,3,8
HND-013633,2011,151400079,,,,3,4,7
HND-013599,2011,151400002,,,,18,22,40
HND-013600,2011,151400003,,,,6,0,6
HND-013602,2011,151400005,,,,1,3,4
HND-013604,2011,151400007,,,,11,14,25
HND-013605,2011,151400008,,,,7,1,8
HND-013608,2011,151400012,,,,2,5,7
HND-013609,2011,151400013,,,,1,2,3
HND-013610,2011,151400014,,,,8,9,17
HND-013611,2011,151400015,,,,3,4,7
HND-013618,2011,151400022,,,,5,0,5
HND-013619,2011,151400023,,,,3,3,6
HND-013621,2011,151400028,,,,3,9,12
HND-013627,2011,151400062,,,,15,5,20
HND-013628,2011,151400063,,,,4,7,11
HND-013631,2011,151400076,,,,1,2,3
HND-013633,2011,151400079,,,,5,1,6
HND-013598,2011,151400001,,,,6,2,8
HND-013601,2011,151400004,,,,5,3,8
HND-013603,2011,151400006,,,,1,2,3
HND-013606,2011,151400009,,,,4,3,7
HND-013607,2011,151400010,,,,6,8,14
,2011,151400011,,,,1,2,3
HND-013612,2011,151400016,,,,5,2,7
HND-013616,2011,151400020,,,,11,8,19
HND-013617,2011,151400021,,,,9,5,14
HND-013622,2011,151400029,,,,2,1,3
HND-013623,2011,151400031,,,,4,2,6
HND-013626,2011,151400061,,,,4,5,9
HND-013632,2011,151400078,,,,2,5,7
HND-013599,2011,151400002,,,,19,17,36
HND-013603,2011,151400006,,,,0,2,2
HND-013605,2011,151400008,,,,2,1,3
HND-013606,2011,151400009,,,,7,1,8
HND-013611,2011,151400015,,,,3,2,5
HND-013621,2011,151400028,,,,5,7,12
HND-013622,2011,151400029,,,,0,4,4
HND-013631,2011,151400076,,,,2,1,3
HND-013598,2011,151400001,,,,7,4,11
HND-013600,2011,151400003,,,,2,1,3
HND-013601,2011,151400004,,,,5,6,11
HND-013602,2011,151400005,,,,0,2,2
HND-013604,2011,151400007,,,,9,2,11
HND-013607,2011,151400010,,,,6,8,14
HND-013608,2011,151400012,,,,1,2,3
HND-013609,2011,151400013,,,,1,4,5
HND-013610,2011,151400014,,,,5,8,13
HND-013612,2011,151400016,,,,1,0,1
HND-013616,2011,151400020,,,,3,9,12
HND-013617,2011,151400021,,,,6,5,11
HND-013618,2011,151400022,,,,7,4,11
HND-013619,2011,151400023,,,,3,4,7
HND-013623,2011,151400031,,,,4,6,10
HND-013626,2011,151400061,,,,0,5,5
HND-013627,2011,151400062,,,,6,5,11
HND-013628,2011,151400063,,,,3,8,11
HND-013632,2011,151400078,,,,0,1,1
HND-013633,2011,151400079,,,,1,1,2
HND-013598,2011,151400001,,,,7,5,12
HND-013603,2011,151400006,,,,0,5,5
HND-013606,2011,151400009,,,,12,10,22
HND-013616,2011,151400020,,,,7,11,18
HND-013617,2011,151400021,,,,7,8,15
HND-013622,2011,151400029,,,,1,0,1
HND-013626,2011,151400061,,,,1,4,5
HND-013632,2011,151400078,,,,4,4,8
HND-013599,2011,151400002,,,,20,26,46
HND-013600,2011,151400003,,,,3,1,4
HND-013601,2011,151400004,,,,3,5,8
HND-013602,2011,151400005,,,,2,8,10
HND-013604,2011,151400007,,,,0,6,6
HND-013605,2011,151400008,,,,3,1,4
HND-013607,2011,151400010,,,,8,11,19
,2011,151400011,,,,1,4,5
HND-013608,2011,151400012,,,,1,0,1
HND-013610,2011,151400014,,,,9,6,15
HND-013611,2011,151400015,,,,5,6,11
HND-013612,2011,151400016,,,,5,5,10
HND-013618,2011,151400022,,,,5,5,10
HND-013619,2011,151400023,,,,3,3,6
HND-013621,2011,151400028,,,,2,4,6
HND-013623,2011,151400031,,,,4,8,12
HND-013627,2011,151400062,,,,4,6,10
HND-013628,2011,151400063,,,,6,6,12
HND-013631,2011,151400076,,,,3,2,5
HND-013598,2011,151400001,,,,4,1,5
HND-013600,2011,151400003,,,,5,5,10
HND-013601,2011,151400004,,,,3,6,9
HND-013603,2011,151400006,,,,1,1,2
HND-013604,2011,151400007,,,,4,3,7
HND-013607,2011,151400010,,,,2,6,8
,2011,151400011,,,,0,2,2
HND-013608,2011,151400012,,,,4,2,6
HND-013610,2011,151400014,,,,6,3,9
HND-013612,2011,151400016,,,,3,6,9
HND-013616,2011,151400020,,,,1,5,6
HND-013617,2011,151400021,,,,4,3,7
HND-013618,2011,151400022,,,,4,6,10
HND-013619,2011,151400023,,,,3,5,8
HND-013626,2011,151400061,,,,1,4,5
HND-013627,2011,151400062,,,,4,2,6
HND-013628,2011,151400063,,,,2,3,5
HND-013631,2011,151400076,,,,1,0,1
HND-013633,2011,151400079,,,,0,2,2
HND-013599,2011,151400002,,,,19,27,46
HND-013606,2011,151400009,,,,3,7,10
HND-013609,2011,151400013,,,,1,1,2
HND-013611,2011,151400015,,,,5,3,8
HND-013621,2011,151400028,,,,3,3,6
HND-013622,2011,151400029,,,,0,1,1
HND-013623,2011,151400031,,,,0,1,1
HND-013632,2011,151400078,,,,0,1,1
HND-013606,2011,151400009,,,,13,5,18
HND-013607,2011,151400010,,,,10,6,16
HND-013620,2011,151400025,,,,23,36,59
HND-013606,2011,151400009,,,,3,8,11
HND-013620,2011,151400025,,,,10,23,33
HND-013607,2011,151400010,,,,7,6,13
HND-013606,2011,151400009,,,,8,8,16
HND-013607,2011,151400010,,,,6,5,11
HND-013620,2011,151400025,,,,21,23,44
HND-013620,2011,151400025,,,,17,27,44
HND-013620,2011,151400025,,,,19,23,42
HND-013620,2011,151400025,,,,14,16,30
HND-013636,2011,151500002,,,,5,3,8
HND-013684,2011,151500065,,,,15,10,25
HND-013685,2011,151500067,,,,5,2,7
,2011,151500068,,,,4,4,8
HND-013687,2011,151500070,,,,3,7,10
,2011,151500071,,,,5,8,13
HND-013691,2011,151500076,,,,7,5,12
,2011,151500078,,,,7,5,12
HND-013693,2011,151500079,,,,6,1,7
HND-013680,2011,151500050,,,,7,2,9
,2011,151500066,,,,5,5,10
HND-013686,2011,151500069,,,,9,10,19
,2011,151500075,,,,7,2,9
HND-013692,2011,151500077,,,,6,5,11
HND-013694,2011,151500080,,,,8,3,11
HND-013668,2011,151500034,,,,5,6,11
HND-013669,2011,151500035,,,,8,4,12
HND-013673,2011,151500039,,,,3,4,7
HND-013674,2011,151500041,,,,6,3,9
HND-013688,2011,151500072,,,,9,7,16
HND-013689,2011,151500073,,,,4,2,6
HND-013690,2011,151500074,,,,4,2,6
HND-013670,2011,151500036,,,,4,1,5
HND-013671,2011,151500037,,,,6,6,12
HND-013695,2011,151500082,,,,7,2,9
HND-013696,2011,151500083,,,,5,6,11
HND-013669,2011,151500035,,,,6,3,9
HND-013670,2011,151500036,,,,4,6,10
HND-013671,2011,151500037,,,,1,2,3
HND-013695,2011,151500082,,,,5,4,9
HND-013696,2011,151500083,,,,9,4,13
HND-013668,2011,151500034,,,,8,12,20
HND-013673,2011,151500039,,,,3,1,4
HND-013674,2011,151500041,,,,2,5,7
HND-013688,2011,151500072,,,,9,6,15
HND-013689,2011,151500073,,,,5,5,10
HND-013690,2011,151500074,,,,4,2,6
HND-013635,2011,151500001,,,,24,25,49
HND-013639,2011,151500005,,,,9,8,17
HND-013642,2011,151500008,,,,5,3,8
HND-013643,2011,151500009,,,,6,2,8
HND-013646,2011,151500012,,,,4,3,7
HND-013647,2011,151500013,,,,6,1,7
HND-013648,2011,151500014,,,,3,5,8
HND-013649,2011,151500015,,,,2,2,4
HND-013651,2011,151500017,,,,6,17,23
HND-013652,2011,151500018,,,,2,1,3
HND-013659,2011,151500025,,,,4,3,7
HND-013662,2011,151500028,,,,7,2,9
HND-013667,2011,151500033,,,,3,3,6
,2011,151500046,,,,0,2,2
HND-013636,2011,151500002,,,,6,2,8
HND-013637,2011,151500003,,,,7,8,15
HND-013638,2011,151500004,,,,11,1,12
HND-013640,2011,151500006,,,,14,17,31
HND-013641,2011,151500007,,,,4,2,6
HND-013644,2011,151500010,,,,3,1,4
HND-013645,2011,151500011,,,,10,7,17
HND-013650,2011,151500016,,,,3,2,5
HND-013653,2011,151500019,,,,4,3,7
HND-013654,2011,151500020,,,,3,0,3
HND-013655,2011,151500021,,,,4,0,4
HND-013656,2011,151500022,,,,1,1,2
HND-013657,2011,151500023,,,,8,8,16
HND-013658,2011,151500024,,,,5,6,11
HND-013660,2011,151500026,,,,6,2,8
HND-013661,2011,151500027,,,,2,8,10
HND-013664,2011,151500030,,,,4,4,8
HND-013665,2011,151500031,,,,2,1,3
HND-013666,2011,151500032,,,,7,5,12
HND-013675,2011,151500042,,,,0,5,5
HND-013676,2011,151500043,,,,4,3,7
HND-013677,2011,151500044,,,,3,2,5
HND-013678,2011,151500045,,,,0,3,3
HND-013679,2011,151500047,,,,6,3,9
HND-013681,2011,151500062,,,,2,1,3
HND-013682,2011,151500063,,,,3,5,8
HND-013683,2011,151500064,,,,1,3,4
HND-013635,2011,151500001,,,,13,16,29
HND-013636,2011,151500002,,,,4,10,14
HND-013637,2011,151500003,,,,10,8,18
HND-013638,2011,151500004,,,,7,8,15
HND-013639,2011,151500005,,,,6,6,12
HND-013641,2011,151500007,,,,2,2,4
HND-013642,2011,151500008,,,,5,11,16
HND-013644,2011,151500010,,,,2,2,4
HND-013645,2011,151500011,,,,9,9,18
HND-013646,2011,151500012,,,,4,3,7
HND-013647,2011,151500013,,,,4,1,5
HND-013648,2011,151500014,,,,12,9,21
HND-013650,2011,151500016,,,,3,2,5
HND-013651,2011,151500017,,,,12,5,17
HND-013657,2011,151500023,,,,5,3,8
HND-013658,2011,151500024,,,,7,6,13
HND-013659,2011,151500025,,,,2,3,5
HND-013661,2011,151500027,,,,3,6,9
HND-013662,2011,151500028,,,,3,5,8
HND-013664,2011,151500030,,,,5,6,11
HND-013665,2011,151500031,,,,1,1,2
HND-013666,2011,151500032,,,,6,9,15
HND-013667,2011,151500033,,,,4,5,9
HND-013678,2011,151500045,,,,1,0,1
HND-013682,2011,151500063,,,,4,3,7
HND-013640,2011,151500006,,,,7,12,19
HND-013643,2011,151500009,,,,4,4,8
HND-013649,2011,151500015,,,,3,3,6
HND-013652,2011,151500018,,,,0,3,3
HND-013653,2011,151500019,,,,6,3,9
HND-013654,2011,151500020,,,,1,7,8
HND-013655,2011,151500021,,,,1,1,2
HND-013660,2011,151500026,,,,6,3,9
HND-013675,2011,151500042,,,,3,1,4
HND-013676,2011,151500043,,,,2,4,6
HND-013677,2011,151500044,,,,1,1,2
HND-013679,2011,151500047,,,,3,2,5
HND-013681,2011,151500062,,,,1,1,2
HND-013683,2011,151500064,,,,2,1,3
HND-013635,2011,151500001,,,,19,16,35
HND-013636,2011,151500002,,,,1,4,5
HND-013637,2011,151500003,,,,6,9,15
HND-013638,2011,151500004,,,,10,4,14
HND-013639,2011,151500005,,,,8,6,14
HND-013640,2011,151500006,,,,8,10,18
HND-013641,2011,151500007,,,,4,4,8
HND-013644,2011,151500010,,,,3,1,4
HND-013645,2011,151500011,,,,10,7,17
HND-013650,2011,151500016,,,,2,1,3
HND-013653,2011,151500019,,,,5,2,7
HND-013654,2011,151500020,,,,5,2,7
HND-013655,2011,151500021,,,,0,2,2
HND-013656,2011,151500022,,,,2,2,4
HND-013657,2011,151500023,,,,8,1,9
HND-013658,2011,151500024,,,,4,5,9
HND-013659,2011,151500025,,,,2,3,5
HND-013660,2011,151500026,,,,4,3,7
HND-013661,2011,151500027,,,,3,4,7
HND-013664,2011,151500030,,,,3,9,12
HND-013665,2011,151500031,,,,3,1,4
HND-013666,2011,151500032,,,,4,8,12
HND-013675,2011,151500042,,,,2,0,2
HND-013676,2011,151500043,,,,2,2,4
HND-013677,2011,151500044,,,,2,2,4
HND-013678,2011,151500045,,,,1,2,3
HND-013679,2011,151500047,,,,5,6,11
HND-013681,2011,151500062,,,,2,2,4
HND-013682,2011,151500063,,,,4,6,10
HND-013683,2011,151500064,,,,2,2,4
HND-013642,2011,151500008,,,,4,4,8
HND-013643,2011,151500009,,,,3,6,9
HND-013646,2011,151500012,,,,5,4,9
HND-013647,2011,151500013,,,,4,2,6
HND-013648,2011,151500014,,,,11,3,14
HND-013649,2011,151500015,,,,4,6,10
HND-013651,2011,151500017,,,,9,5,14
HND-013652,2011,151500018,,,,3,4,7
HND-013662,2011,151500028,,,,1,1,2
HND-013667,2011,151500033,,,,4,0,4
,2011,151500046,,,,1,1,2
HND-013635,2011,151500001,,,,8,18,26
HND-013636,2011,151500002,,,,4,3,7
HND-013637,2011,151500003,,,,12,8,20
HND-013638,2011,151500004,,,,4,3,7
HND-013639,2011,151500005,,,,2,6,8
HND-013641,2011,151500007,,,,7,3,10
HND-013642,2011,151500008,,,,5,6,11
HND-013644,2011,151500010,,,,2,3,5
HND-013645,2011,151500011,,,,7,10,17
HND-013646,2011,151500012,,,,7,2,9
HND-013647,2011,151500013,,,,6,6,12
HND-013648,2011,151500014,,,,4,4,8
HND-013649,2011,151500015,,,,4,3,7
HND-013650,2011,151500016,,,,1,2,3
HND-013651,2011,151500017,,,,3,3,6
HND-013657,2011,151500023,,,,4,0,4
HND-013659,2011,151500025,,,,2,4,6
HND-013661,2011,151500027,,,,5,2,7
HND-013662,2011,151500028,,,,2,3,5
HND-013666,2011,151500032,,,,1,5,6
HND-013667,2011,151500033,,,,4,1,5
HND-013640,2011,151500006,,,,5,10,15
HND-013643,2011,151500009,,,,2,3,5
HND-013652,2011,151500018,,,,1,3,4
HND-013653,2011,151500019,,,,7,0,7
HND-013654,2011,151500020,,,,3,3,6
HND-013655,2011,151500021,,,,2,1,3
HND-013656,2011,151500022,,,,0,4,4
HND-013658,2011,151500024,,,,10,12,22
HND-013660,2011,151500026,,,,6,6,12
HND-013664,2011,151500030,,,,7,5,12
HND-013665,2011,151500031,,,,0,1,1
HND-013675,2011,151500042,,,,3,0,3
HND-013676,2011,151500043,,,,3,2,5
HND-013677,2011,151500044,,,,1,0,1
HND-013678,2011,151500045,,,,2,0,2
,2011,151500046,,,,1,1,2
HND-013679,2011,151500047,,,,4,4,8
HND-013681,2011,151500062,,,,2,2,4
HND-013682,2011,151500063,,,,3,3,6
HND-013683,2011,151500064,,,,2,2,4
HND-013635,2011,151500001,,,,15,18,33
HND-013637,2011,151500003,,,,9,20,29
HND-013639,2011,151500005,,,,4,6,10
HND-013641,2011,151500007,,,,6,4,10
HND-013642,2011,151500008,,,,16,5,21
HND-013643,2011,151500009,,,,4,7,11
HND-013646,2011,151500012,,,,1,2,3
HND-013647,2011,151500013,,,,8,2,10
HND-013648,2011,151500014,,,,8,4,12
HND-013649,2011,151500015,,,,4,6,10
HND-013651,2011,151500017,,,,6,11,17
HND-013652,2011,151500018,,,,5,2,7
HND-013657,2011,151500023,,,,3,3,6
HND-013659,2011,151500025,,,,3,3,6
HND-013661,2011,151500027,,,,2,3,5
HND-013662,2011,151500028,,,,4,6,10
HND-013664,2011,151500030,,,,14,5,19
HND-013665,2011,151500031,,,,3,0,3
HND-013675,2011,151500042,,,,1,3,4
HND-013676,2011,151500043,,,,1,3,4
HND-013677,2011,151500044,,,,4,2,6
HND-013678,2011,151500045,,,,3,2,5
HND-013679,2011,151500047,,,,2,3,5
HND-013636,2011,151500002,,,,7,4,11
HND-013638,2011,151500004,,,,8,4,12
HND-013640,2011,151500006,,,,7,5,12
HND-013644,2011,151500010,,,,2,2,4
HND-013645,2011,151500011,,,,6,10,16
HND-013650,2011,151500016,,,,1,2,3
HND-013653,2011,151500019,,,,6,4,10
HND-013654,2011,151500020,,,,3,4,7
HND-013655,2011,151500021,,,,1,2,3
HND-013656,2011,151500022,,,,1,3,4
HND-013658,2011,151500024,,,,4,2,6
HND-013660,2011,151500026,,,,6,9,15
HND-013666,2011,151500032,,,,3,3,6
HND-013667,2011,151500033,,,,2,3,5
,2011,151500046,,,,1,1,2
HND-013681,2011,151500062,,,,2,2,4
HND-013682,2011,151500063,,,,2,2,4
HND-013683,2011,151500064,,,,1,1,2
HND-013640,2011,151500006,,,,12,14,26
HND-013643,2011,151500009,,,,5,6,11
HND-013649,2011,151500015,,,,4,2,6
HND-013651,2011,151500017,,,,4,4,8
HND-013652,2011,151500018,,,,0,1,1
HND-013653,2011,151500019,,,,4,3,7
HND-013654,2011,151500020,,,,3,0,3
HND-013655,2011,151500021,,,,1,2,3
HND-013660,2011,151500026,,,,6,4,10
HND-013664,2011,151500030,,,,3,4,7
HND-013665,2011,151500031,,,,0,1,1
HND-013666,2011,151500032,,,,2,6,8
HND-013667,2011,151500033,,,,2,2,4
HND-013678,2011,151500045,,,,2,1,3
HND-013681,2011,151500062,,,,1,2,3
HND-013683,2011,151500064,,,,1,2,3
HND-013635,2011,151500001,,,,7,24,31
HND-013636,2011,151500002,,,,4,9,13
HND-013638,2011,151500004,,,,7,10,17
HND-013639,2011,151500005,,,,3,5,8
HND-013641,2011,151500007,,,,4,5,9
HND-013642,2011,151500008,,,,3,5,8
HND-013644,2011,151500010,,,,1,4,5
HND-013645,2011,151500011,,,,5,1,6
HND-013646,2011,151500012,,,,2,4,6
HND-013647,2011,151500013,,,,4,2,6
HND-013648,2011,151500014,,,,6,5,11
HND-013650,2011,151500016,,,,3,0,3
HND-013656,2011,151500022,,,,4,1,5
HND-013657,2011,151500023,,,,5,4,9
HND-013658,2011,151500024,,,,6,3,9
HND-013659,2011,151500025,,,,5,4,9
HND-013661,2011,151500027,,,,3,6,9
HND-013662,2011,151500028,,,,1,7,8
HND-013675,2011,151500042,,,,0,1,1
HND-013676,2011,151500043,,,,1,2,3
HND-013677,2011,151500044,,,,0,2,2
,2011,151500046,,,,1,3,4
HND-013679,2011,151500047,,,,3,6,9
HND-013682,2011,151500063,,,,3,2,5
HND-013641,2011,151500007,,,,6,9,15
HND-013648,2011,151500014,,,,15,15,30
HND-013672,2011,151500038,,,,40,20,60
HND-013636,2011,151500002,,,,19,17,36
HND-013640,2011,151500006,,,,15,15,30
HND-013636,2011,151500002,,,,17,17,34
HND-013641,2011,151500007,,,,9,10,19
HND-013648,2011,151500014,,,,6,7,13
HND-013640,2011,151500006,,,,19,13,32
HND-013672,2011,151500038,,,,30,31,61
HND-013636,2011,151500002,,,,14,12,26
HND-013641,2011,151500007,,,,9,11,20
HND-013648,2011,151500014,,,,14,10,24
HND-013640,2011,151500006,,,,12,14,26
HND-013672,2011,151500038,,,,26,32,58
HND-013672,2011,151500038,,,,42,39,81
HND-013672,2011,151500038,,,,19,20,39
HND-013672,2011,151500038,,,,18,18,36
HND-013715,2011,151600045,,,,6,5,11
HND-013718,2011,151600048,,,,7,4,11
HND-013719,2011,151600049,,,,7,3,10
HND-013723,2011,151600055,,,,5,9,14
HND-013725,2011,151600057,,,,8,2,10
HND-013716,2011,151600046,,,,5,5,10
HND-013717,2011,151600047,,,,9,1,10
HND-013720,2011,151600051,,,,9,9,18
HND-013721,2011,151600052,,,,7,3,10
HND-013722,2011,151600053,,,,5,5,10
,2011,151600054,,,,6,6,12
HND-013724,2011,151600056,,,,4,6,10
HND-013707,2011,151600011,,,,4,9,13
HND-013707,2011,151600011,,,,11,3,14
HND-013712,2011,151600041,,,,0,3,3
HND-013708,2011,151600012,,,,4,1,5
HND-013707,2011,151600011,,,,23,13,36
HND-013708,2011,151600012,,,,7,5,12
HND-013712,2011,151600041,,,,4,5,9
HND-013697,2011,151600001,,,,33,18,51
HND-013701,2011,151600005,,,,3,6,9
HND-013704,2011,151600008,,,,5,8,13
HND-013705,2011,151600009,,,,3,1,4
,2011,151600039,,,,2,2,4
,2011,151600044,,,,6,5,11
HND-013698,2011,151600002,,,,6,6,12
HND-013699,2011,151600003,,,,2,4,6
HND-013700,2011,151600004,,,,1,2,3
HND-013702,2011,151600006,,,,6,4,10
HND-013703,2011,151600007,,,,1,4,5
HND-013710,2011,151600014,,,,29,19,48
HND-013713,2011,151600043,,,,3,5,8
HND-013702,2011,151600006,,,,4,3,7
HND-013705,2011,151600009,,,,3,3,6
,2011,151600039,,,,1,3,4
HND-013697,2011,151600001,,,,45,32,77
HND-013698,2011,151600002,,,,10,8,18
HND-013699,2011,151600003,,,,3,3,6
HND-013700,2011,151600004,,,,3,2,5
HND-013701,2011,151600005,,,,6,5,11
HND-013703,2011,151600007,,,,2,1,3
HND-013704,2011,151600008,,,,8,5,13
HND-013710,2011,151600014,,,,17,18,35
HND-013713,2011,151600043,,,,4,3,7
,2011,151600044,,,,3,6,9
HND-013704,2011,151600008,,,,7,12,19
HND-013713,2011,151600043,,,,4,5,9
HND-013697,2011,151600001,,,,29,40,69
HND-013698,2011,151600002,,,,13,4,17
HND-013699,2011,151600003,,,,4,1,5
HND-013700,2011,151600004,,,,1,4,5
HND-013701,2011,151600005,,,,7,4,11
HND-013702,2011,151600006,,,,1,4,5
HND-013703,2011,151600007,,,,0,1,1
HND-013710,2011,151600014,,,,19,19,38
,2011,151600039,,,,1,0,1
,2011,151600044,,,,2,2,4
HND-013700,2011,151600004,,,,3,6,9
HND-013702,2011,151600006,,,,5,6,11
HND-013705,2011,151600009,,,,4,4,8
,2011,151600039,,,,2,2,4
HND-013697,2011,151600001,,,,42,39,81
HND-013698,2011,151600002,,,,11,8,19
HND-013699,2011,151600003,,,,5,2,7
HND-013701,2011,151600005,,,,3,4,7
HND-013703,2011,151600007,,,,5,6,11
HND-013704,2011,151600008,,,,8,6,14
HND-013710,2011,151600014,,,,17,16,33
HND-013713,2011,151600043,,,,5,2,7
,2011,151600044,,,,4,3,7
HND-013698,2011,151600002,,,,11,6,17
HND-013700,2011,151600004,,,,6,4,10
HND-013702,2011,151600006,,,,3,5,8
,2011,151600044,,,,3,5,8
HND-013697,2011,151600001,,,,35,29,64
HND-013699,2011,151600003,,,,6,1,7
HND-013701,2011,151600005,,,,5,6,11
HND-013703,2011,151600007,,,,0,1,1
HND-013704,2011,151600008,,,,5,2,7
HND-013705,2011,151600009,,,,4,1,5
HND-013710,2011,151600014,,,,8,12,20
HND-013713,2011,151600043,,,,4,6,10
HND-013697,2011,151600001,,,,47,45,92
HND-013698,2011,151600002,,,,8,7,15
HND-013699,2011,151600003,,,,2,4,6
HND-013700,2011,151600004,,,,2,6,8
HND-013701,2011,151600005,,,,4,5,9
HND-013703,2011,151600007,,,,4,4,8
HND-013704,2011,151600008,,,,5,8,13
HND-013710,2011,151600014,,,,12,15,27
HND-013713,2011,151600043,,,,1,2,3
,2011,151600044,,,,2,2,4
HND-013702,2011,151600006,,,,2,4,6
HND-013705,2011,151600009,,,,3,5,8
,2011,151600039,,,,1,1,2
HND-013698,2011,151600002,,,,5,11,16
HND-013709,2011,151600013,,,,72,68,140
HND-013710,2011,151600014,,,,16,19,35
HND-013698,2011,151600002,,,,6,9,15
HND-013709,2011,151600013,,,,39,44,83
HND-013710,2011,151600014,,,,23,23,46
HND-013709,2011,151600013,,,,48,57,105
HND-013698,2011,151600002,,,,6,6,12
HND-013710,2011,151600014,,,,16,20,36
HND-013709,2011,151600013,,,,42,50,92
HND-013709,2011,151600013,,,,58,33,91
HND-013709,2011,151600013,,,,27,33,60
HND-013786,2011,151700064,,,,6,4,10
HND-013805,2011,151700102,,,,15,5,20
HND-013808,2011,151700108,,,,8,4,12
HND-013810,2011,151700110,,,,10,5,15
HND-013820,2011,151700135,,,,8,2,10
HND-013821,2011,151700136,,,,16,10,26
HND-013822,2011,151700137,,,,5,7,12
HND-013824,2011,151700140,,,,6,4,10
HND-013826,2011,151700144,,,,16,8,24
HND-013827,2011,151700145,,,,7,7,14
HND-013828,2011,151700146,,,,4,6,10
,2011,151700147,,,,3,7,10
,2011,151700148,,,,6,9,15
HND-013829,2011,151700149,,,,5,6,11
HND-013832,2011,151700155,,,,10,6,16
HND-013833,2011,151700156,,,,3,8,11
HND-013837,2011,151700161,,,,4,6,10
HND-013838,2011,151700162,,,,9,4,13
,2011,151700168,,,,6,6,12
HND-013843,2011,151700170,,,,4,9,13
HND-013794,2011,151700082,,,,5,9,14
,2011,151700100,,,,2,11,13
HND-013806,2011,151700103,,,,11,9,20
,2011,151700106,,,,7,8,15
HND-013809,2011,151700109,,,,9,4,13
,2011,151700129,,,,10,7,17
HND-013818,2011,151700132,,,,10,6,16
,2011,151700133,,,,13,5,18
HND-013819,2011,151700134,,,,7,4,11
HND-013823,2011,151700139,,,,2,8,10
,2011,151700141,,,,6,4,10
HND-013825,2011,151700142,,,,10,3,13
HND-013836,2011,151700160,,,,5,5,10
,2011,151700164,,,,8,5,13
HND-013840,2011,151700166,,,,5,5,10
HND-013841,2011,151700167,,,,9,7,16
HND-013842,2011,151700169,,,,2,11,13
HND-013844,2011,151700171,,,,5,5,10
HND-013785,2011,151700063,,,,2,1,3
HND-013789,2011,151700067,,,,3,3,6
HND-013831,2011,151700152,,,,6,1,7
HND-013781,2011,151700059,,,,0,1,1
HND-013830,2011,151700150,,,,6,3,9
HND-013780,2011,151700058,,,,14,9,23
HND-013782,2011,151700060,,,,4,4,8
HND-013783,2011,151700061,,,,2,4,6
HND-013786,2011,151700064,,,,5,3,8
HND-013788,2011,151700066,,,,3,1,4
,2011,151700092,,,,4,0,4
,2011,151700151,,,,4,6,10
HND-013831,2011,151700152,,,,1,4,5
HND-013781,2011,151700059,,,,6,4,10
HND-013785,2011,151700063,,,,0,1,1
HND-013787,2011,151700065,,,,2,0,2
HND-013789,2011,151700067,,,,9,12,21
HND-013790,2011,151700069,,,,6,5,11
HND-013798,2011,151700086,,,,6,6,12
HND-013807,2011,151700107,,,,7,7,14
HND-013830,2011,151700150,,,,6,5,11
HND-013839,2011,151700163,,,,3,1,4
HND-013780,2011,151700058,,,,34,34,68
HND-013781,2011,151700059,,,,5,3,8
HND-013787,2011,151700065,,,,9,6,15
,2011,151700068,,,,9,3,12
HND-013790,2011,151700069,,,,3,4,7
HND-013798,2011,151700086,,,,3,4,7
HND-013807,2011,151700107,,,,3,3,6
,2011,151700151,,,,3,5,8
HND-013831,2011,151700152,,,,2,3,5
HND-013839,2011,151700163,,,,9,1,10
HND-013782,2011,151700060,,,,2,9,11
HND-013783,2011,151700061,,,,11,8,19
HND-013785,2011,151700063,,,,11,7,18
HND-013786,2011,151700064,,,,9,11,20
HND-013788,2011,151700066,,,,7,7,14
HND-013789,2011,151700067,,,,8,10,18
,2011,151700092,,,,6,4,10
HND-013830,2011,151700150,,,,8,5,13
HND-013734,2011,151700009,,,,4,5,9
HND-013740,2011,151700015,,,,5,8,13
HND-013743,2011,151700018,,,,4,0,4
HND-013744,2011,151700019,,,,3,7,10
HND-013745,2011,151700020,,,,9,5,14
HND-013746,2011,151700021,,,,13,7,20
HND-013747,2011,151700022,,,,2,12,14
HND-013749,2011,151700024,,,,11,10,21
HND-013751,2011,151700026,,,,6,4,10
HND-013762,2011,151700038,,,,10,9,19
HND-013763,2011,151700039,,,,10,14,24
HND-013764,2011,151700040,,,,2,0,2
HND-013765,2011,151700041,,,,11,11,22
HND-013766,2011,151700042,,,,1,4,5
HND-013767,2011,151700044,,,,11,11,22
HND-013769,2011,151700046,,,,8,11,19
HND-013772,2011,151700050,,,,4,5,9
HND-013773,2011,151700051,,,,10,3,13
,2011,151700052,,,,2,3,5
HND-013776,2011,151700054,,,,5,3,8
HND-013778,2011,151700056,,,,3,6,9
HND-013791,2011,151700070,,,,2,3,5
HND-013792,2011,151700071,,,,9,4,13
HND-013795,2011,151700083,,,,3,1,4
,2011,151700085,,,,11,1,12
HND-013799,2011,151700087,,,,4,2,6
,2011,151700088,,,,3,5,8
,2011,151700092,,,,7,5,12
,2011,151700093,,,,12,11,23
HND-013801,2011,151700094,,,,8,7,15
HND-013802,2011,151700095,,,,0,2,2
HND-013814,2011,151700126,,,,0,1,1
HND-013816,2011,151700128,,,,5,8,13
,2011,151700158,,,,2,2,4
HND-013727,2011,151700001,,,,42,51,93
HND-013728,2011,151700002,,,,4,3,7
HND-013729,2011,151700003,,,,2,7,9
HND-013730,2011,151700004,,,,14,5,19
HND-013731,2011,151700005,,,,20,20,40
HND-013732,2011,151700007,,,,0,2,2
HND-013733,2011,151700008,,,,10,6,16
HND-013735,2011,151700010,,,,5,4,9
HND-013736,2011,151700011,,,,5,8,13
HND-013737,2011,151700012,,,,5,4,9
HND-013738,2011,151700013,,,,5,3,8
HND-013739,2011,151700014,,,,26,30,56
HND-013741,2011,151700016,,,,21,14,35
HND-013742,2011,151700017,,,,9,5,14
HND-013748,2011,151700023,,,,3,8,11
HND-013750,2011,151700025,,,,8,8,16
HND-013752,2011,151700027,,,,11,7,18
HND-013753,2011,151700028,,,,13,4,17
HND-013754,2011,151700029,,,,3,3,6
HND-013755,2011,151700030,,,,6,3,9
HND-013756,2011,151700031,,,,5,3,8
HND-013757,2011,151700033,,,,1,5,6
HND-013758,2011,151700034,,,,5,2,7
HND-013759,2011,151700035,,,,3,3,6
HND-013760,2011,151700036,,,,6,4,10
HND-013761,2011,151700037,,,,8,10,18
HND-013768,2011,151700045,,,,3,9,12
HND-013770,2011,151700047,,,,32,33,65
HND-013771,2011,151700048,,,,4,3,7
HND-013775,2011,151700053,,,,6,3,9
HND-013777,2011,151700055,,,,8,6,14
HND-013779,2011,151700057,,,,5,3,8
HND-013793,2011,151700079,,,,1,2,3
HND-013794,2011,151700082,,,,6,4,10
,2011,151700084,,,,3,3,6
HND-013803,2011,151700096,,,,2,2,4
HND-013811,2011,151700121,,,,0,2,2
HND-013812,2011,151700122,,,,0,4,4
HND-013727,2011,151700001,,,,29,26,55
HND-013731,2011,151700005,,,,8,10,18
HND-013733,2011,151700008,,,,7,10,17
HND-013734,2011,151700009,,,,4,7,11
HND-013737,2011,151700012,,,,11,3,14
HND-013738,2011,151700013,,,,4,5,9
HND-013739,2011,151700014,,,,23,16,39
HND-013740,2011,151700015,,,,5,6,11
HND-013742,2011,151700017,,,,2,5,7
HND-013743,2011,151700018,,,,4,0,4
HND-013753,2011,151700028,,,,25,9,34
HND-013754,2011,151700029,,,,6,1,7
HND-013757,2011,151700033,,,,3,0,3
HND-013758,2011,151700034,,,,2,2,4
HND-013759,2011,151700035,,,,4,1,5
HND-013761,2011,151700037,,,,6,7,13
HND-013762,2011,151700038,,,,10,10,20
HND-013764,2011,151700040,,,,2,1,3
HND-013765,2011,151700041,,,,9,11,20
HND-013769,2011,151700046,,,,5,3,8
HND-013771,2011,151700048,,,,2,3,5
HND-013791,2011,151700070,,,,2,6,8
HND-013792,2011,151700071,,,,8,7,15
HND-013793,2011,151700079,,,,4,2,6
HND-013795,2011,151700083,,,,1,3,4
,2011,151700084,,,,3,2,5
,2011,151700085,,,,7,4,11
HND-013799,2011,151700087,,,,3,5,8
,2011,151700093,,,,6,9,15
HND-013801,2011,151700094,,,,4,6,10
HND-013802,2011,151700095,,,,2,2,4
HND-013803,2011,151700096,,,,3,0,3
HND-013812,2011,151700122,,,,2,0,2
HND-013814,2011,151700126,,,,2,2,4
HND-013815,2011,151700127,,,,2,0,2
HND-013728,2011,151700002,,,,2,1,3
HND-013729,2011,151700003,,,,10,8,18
HND-013730,2011,151700004,,,,3,6,9
HND-013732,2011,151700007,,,,3,1,4
HND-013735,2011,151700010,,,,2,1,3
HND-013736,2011,151700011,,,,6,5,11
HND-013741,2011,151700016,,,,21,12,33
HND-013744,2011,151700019,,,,4,2,6
HND-013745,2011,151700020,,,,6,5,11
HND-013746,2011,151700021,,,,12,10,22
HND-013747,2011,151700022,,,,4,2,6
HND-013748,2011,151700023,,,,7,5,12
HND-013749,2011,151700024,,,,9,13,22
HND-013750,2011,151700025,,,,6,4,10
HND-013751,2011,151700026,,,,6,2,8
HND-013752,2011,151700027,,,,8,7,15
HND-013755,2011,151700030,,,,3,2,5
HND-013756,2011,151700031,,,,3,4,7
HND-013760,2011,151700036,,,,5,6,11
HND-013763,2011,151700039,,,,15,8,23
HND-013766,2011,151700042,,,,2,4,6
HND-013767,2011,151700044,,,,2,7,9
HND-013768,2011,151700045,,,,2,5,7
HND-013770,2011,151700047,,,,29,31,60
HND-013772,2011,151700050,,,,5,4,9
HND-013773,2011,151700051,,,,1,6,7
,2011,151700052,,,,4,1,5
HND-013775,2011,151700053,,,,5,2,7
HND-013776,2011,151700054,,,,4,3,7
HND-013777,2011,151700055,,,,10,2,12
HND-013778,2011,151700056,,,,6,5,11
HND-013779,2011,151700057,,,,2,5,7
,2011,151700088,,,,1,4,5
,2011,151700092,,,,6,3,9
HND-013811,2011,151700121,,,,2,1,3
HND-013816,2011,151700128,,,,5,0,5
HND-013834,2011,151700157,,,,4,2,6
,2011,151700158,,,,0,2,2
HND-013727,2011,151700001,,,,32,34,66
HND-013728,2011,151700002,,,,4,1,5
HND-013729,2011,151700003,,,,3,3,6
HND-013730,2011,151700004,,,,13,8,21
HND-013731,2011,151700005,,,,15,12,27
HND-013732,2011,151700007,,,,3,4,7
HND-013733,2011,151700008,,,,8,4,12
HND-013735,2011,151700010,,,,3,4,7
HND-013736,2011,151700011,,,,1,5,6
HND-013737,2011,151700012,,,,3,3,6
HND-013738,2011,151700013,,,,6,6,12
HND-013739,2011,151700014,,,,12,13,25
HND-013740,2011,151700015,,,,8,0,8
HND-013741,2011,151700016,,,,12,16,28
HND-013742,2011,151700017,,,,7,8,15
HND-013748,2011,151700023,,,,4,8,12
HND-013750,2011,151700025,,,,5,5,10
HND-013752,2011,151700027,,,,7,10,17
HND-013753,2011,151700028,,,,9,9,18
HND-013754,2011,151700029,,,,2,1,3
HND-013755,2011,151700030,,,,2,4,6
HND-013756,2011,151700031,,,,0,2,2
HND-013757,2011,151700033,,,,3,2,5
HND-013758,2011,151700034,,,,2,3,5
HND-013759,2011,151700035,,,,1,0,1
HND-013760,2011,151700036,,,,5,5,10
HND-013761,2011,151700037,,,,9,6,15
HND-013768,2011,151700045,,,,1,4,5
HND-013770,2011,151700047,,,,31,33,64
HND-013771,2011,151700048,,,,3,1,4
HND-013775,2011,151700053,,,,3,2,5
HND-013777,2011,151700055,,,,6,5,11
HND-013779,2011,151700057,,,,4,5,9
HND-013793,2011,151700079,,,,2,4,6
HND-013794,2011,151700082,,,,3,9,12
,2011,151700084,,,,1,2,3
HND-013802,2011,151700095,,,,2,4,6
HND-013803,2011,151700096,,,,4,2,6
HND-013811,2011,151700121,,,,1,1,2
HND-013812,2011,151700122,,,,3,0,3
HND-013734,2011,151700009,,,,3,3,6
HND-013743,2011,151700018,,,,0,3,3
HND-013744,2011,151700019,,,,3,6,9
HND-013745,2011,151700020,,,,4,2,6
HND-013746,2011,151700021,,,,13,9,22
HND-013747,2011,151700022,,,,4,3,7
HND-013749,2011,151700024,,,,8,6,14
HND-013751,2011,151700026,,,,5,6,11
HND-013762,2011,151700038,,,,8,13,21
HND-013763,2011,151700039,,,,7,12,19
HND-013764,2011,151700040,,,,4,1,5
HND-013765,2011,151700041,,,,6,1,7
HND-013766,2011,151700042,,,,2,5,7
HND-013767,2011,151700044,,,,13,16,29
HND-013769,2011,151700046,,,,6,1,7
HND-013772,2011,151700050,,,,8,3,11
HND-013773,2011,151700051,,,,0,2,2
,2011,151700052,,,,3,2,5
HND-013776,2011,151700054,,,,1,2,3
HND-013778,2011,151700056,,,,5,6,11
HND-013792,2011,151700071,,,,11,4,15
HND-013795,2011,151700083,,,,1,3,4
,2011,151700085,,,,4,9,13
HND-013799,2011,151700087,,,,1,3,4
,2011,151700088,,,,2,2,4
,2011,151700092,,,,4,4,8
,2011,151700093,,,,13,9,22
HND-013801,2011,151700094,,,,4,7,11
HND-013814,2011,151700126,,,,0,3,3
HND-013816,2011,151700128,,,,2,2,4
,2011,151700158,,,,3,3,6
HND-013727,2011,151700001,,,,33,31,64
HND-013728,2011,151700002,,,,3,0,3
HND-013729,2011,151700003,,,,1,1,2
HND-013732,2011,151700007,,,,5,1,6
HND-013733,2011,151700008,,,,7,9,16
HND-013734,2011,151700009,,,,3,7,10
HND-013735,2011,151700010,,,,1,1,2
HND-013736,2011,151700011,,,,1,3,4
HND-013740,2011,151700015,,,,7,4,11
HND-013743,2011,151700018,,,,2,1,3
HND-013747,2011,151700022,,,,8,7,15
HND-013748,2011,151700023,,,,3,3,6
HND-013751,2011,151700026,,,,1,4,5
HND-013752,2011,151700027,,,,6,6,12
HND-013754,2011,151700029,,,,3,1,4
HND-013757,2011,151700033,,,,3,3,6
HND-013759,2011,151700035,,,,2,2,4
HND-013761,2011,151700037,,,,5,7,12
HND-013762,2011,151700038,,,,9,6,15
HND-013764,2011,151700040,,,,5,1,6
HND-013765,2011,151700041,,,,9,9,18
HND-013769,2011,151700046,,,,3,7,10
HND-013772,2011,151700050,,,,5,6,11
HND-013773,2011,151700051,,,,5,2,7
HND-013778,2011,151700056,,,,4,1,5
HND-013791,2011,151700070,,,,0,1,1
HND-013792,2011,151700071,,,,5,6,11
HND-013793,2011,151700079,,,,0,1,1
HND-013794,2011,151700082,,,,2,4,6
HND-013795,2011,151700083,,,,2,1,3
,2011,151700084,,,,4,3,7
,2011,151700085,,,,4,5,9
HND-013799,2011,151700087,,,,0,3,3
,2011,151700093,,,,5,12,17
HND-013801,2011,151700094,,,,5,6,11
HND-013802,2011,151700095,,,,1,1,2
HND-013803,2011,151700096,,,,2,0,2
HND-013814,2011,151700126,,,,3,2,5
HND-013815,2011,151700127,,,,4,1,5
HND-013834,2011,151700157,,,,1,0,1
,2011,151700158,,,,2,0,2
HND-013730,2011,151700004,,,,3,6,9
HND-013731,2011,151700005,,,,3,6,9
HND-013737,2011,151700012,,,,6,3,9
HND-013738,2011,151700013,,,,3,1,4
HND-013739,2011,151700014,,,,10,14,24
HND-013741,2011,151700016,,,,8,7,15
HND-013742,2011,151700017,,,,6,6,12
HND-013744,2011,151700019,,,,5,4,9
HND-013745,2011,151700020,,,,4,3,7
HND-013746,2011,151700021,,,,11,10,21
HND-013749,2011,151700024,,,,5,4,9
HND-013750,2011,151700025,,,,9,4,13
HND-013753,2011,151700028,,,,14,14,28
HND-013755,2011,151700030,,,,3,2,5
HND-013756,2011,151700031,,,,2,1,3
HND-013758,2011,151700034,,,,3,3,6
HND-013760,2011,151700036,,,,9,7,16
HND-013763,2011,151700039,,,,7,14,21
HND-013766,2011,151700042,,,,3,2,5
HND-013767,2011,151700044,,,,5,8,13
HND-013768,2011,151700045,,,,3,2,5
HND-013770,2011,151700047,,,,33,26,59
HND-013771,2011,151700048,,,,0,5,5
,2011,151700052,,,,3,2,5
HND-013775,2011,151700053,,,,4,2,6
HND-013776,2011,151700054,,,,0,7,7
HND-013777,2011,151700055,,,,2,4,6
HND-013779,2011,151700057,,,,7,4,11
,2011,151700088,,,,0,2,2
,2011,151700092,,,,4,6,10
HND-013811,2011,151700121,,,,1,1,2
HND-013812,2011,151700122,,,,2,1,3
HND-013816,2011,151700128,,,,1,3,4
HND-013727,2011,151700001,,,,40,41,81
HND-013728,2011,151700002,,,,0,4,4
HND-013729,2011,151700003,,,,0,5,5
HND-013730,2011,151700004,,,,5,8,13
HND-013731,2011,151700005,,,,4,5,9
HND-013732,2011,151700007,,,,2,2,4
HND-013733,2011,151700008,,,,8,10,18
HND-013735,2011,151700010,,,,0,1,1
HND-013736,2011,151700011,,,,2,6,8
HND-013737,2011,151700012,,,,4,8,12
HND-013739,2011,151700014,,,,12,4,16
HND-013741,2011,151700016,,,,13,7,20
HND-013747,2011,151700022,,,,9,4,13
HND-013748,2011,151700023,,,,2,7,9
HND-013749,2011,151700024,,,,8,7,15
HND-013750,2011,151700025,,,,6,2,8
HND-013752,2011,151700027,,,,3,5,8
HND-013753,2011,151700028,,,,6,12,18
HND-013759,2011,151700035,,,,1,2,3
HND-013762,2011,151700038,,,,12,5,17
HND-013763,2011,151700039,,,,8,15,23
HND-013764,2011,151700040,,,,1,2,3
HND-013765,2011,151700041,,,,4,3,7
HND-013766,2011,151700042,,,,5,0,5
HND-013767,2011,151700044,,,,8,1,9
HND-013769,2011,151700046,,,,6,6,12
HND-013772,2011,151700050,,,,3,6,9
HND-013773,2011,151700051,,,,4,2,6
HND-013778,2011,151700056,,,,4,2,6
HND-013791,2011,151700070,,,,0,2,2
HND-013792,2011,151700071,,,,5,6,11
HND-013793,2011,151700079,,,,1,3,4
HND-013794,2011,151700082,,,,0,2,2
HND-013795,2011,151700083,,,,1,1,2
,2011,151700084,,,,1,1,2
,2011,151700085,,,,1,3,4
HND-013799,2011,151700087,,,,6,2,8
,2011,151700088,,,,1,0,1
,2011,151700093,,,,16,6,22
HND-013801,2011,151700094,,,,2,7,9
HND-013802,2011,151700095,,,,3,3,6
HND-013803,2011,151700096,,,,4,3,7
HND-013814,2011,151700126,,,,2,1,3
HND-013815,2011,151700127,,,,0,4,4
HND-013816,2011,151700128,,,,3,7,10
HND-013834,2011,151700157,,,,1,0,1
,2011,151700158,,,,1,1,2
HND-013734,2011,151700009,,,,2,2,4
HND-013738,2011,151700013,,,,1,1,2
HND-013740,2011,151700015,,,,4,6,10
HND-013742,2011,151700017,,,,2,5,7
HND-013743,2011,151700018,,,,1,1,2
HND-013744,2011,151700019,,,,10,5,15
HND-013745,2011,151700020,,,,2,4,6
HND-013746,2011,151700021,,,,14,12,26
HND-013751,2011,151700026,,,,4,5,9
HND-013754,2011,151700029,,,,2,7,9
HND-013755,2011,151700030,,,,2,7,9
HND-013756,2011,151700031,,,,1,6,7
HND-013757,2011,151700033,,,,1,6,7
HND-013758,2011,151700034,,,,8,5,13
HND-013760,2011,151700036,,,,2,8,10
HND-013761,2011,151700037,,,,1,7,8
HND-013770,2011,151700047,,,,36,27,63
,2011,151700052,,,,1,0,1
HND-013775,2011,151700053,,,,1,1,2
HND-013776,2011,151700054,,,,2,1,3
HND-013777,2011,151700055,,,,4,3,7
HND-013779,2011,151700057,,,,6,1,7
,2011,151700092,,,,7,6,13
HND-013811,2011,151700121,,,,2,1,3
HND-013812,2011,151700122,,,,1,2,3
HND-013727,2011,151700001,,,,25,34,59
HND-013731,2011,151700005,,,,9,9,18
HND-013733,2011,151700008,,,,8,6,14
HND-013734,2011,151700009,,,,6,4,10
HND-013737,2011,151700012,,,,2,9,11
HND-013738,2011,151700013,,,,7,5,12
HND-013739,2011,151700014,,,,5,7,12
HND-013740,2011,151700015,,,,6,4,10
HND-013742,2011,151700017,,,,2,1,3
HND-013743,2011,151700018,,,,5,1,6
HND-013753,2011,151700028,,,,14,15,29
HND-013754,2011,151700029,,,,1,0,1
HND-013755,2011,151700030,,,,5,4,9
HND-013756,2011,151700031,,,,3,2,5
HND-013760,2011,151700036,,,,4,1,5
HND-013763,2011,151700039,,,,9,7,16
HND-013766,2011,151700042,,,,1,1,2
HND-013767,2011,151700044,,,,11,9,20
HND-013768,2011,151700045,,,,3,2,5
HND-013770,2011,151700047,,,,24,27,51
HND-013772,2011,151700050,,,,6,4,10
HND-013773,2011,151700051,,,,13,6,19
,2011,151700052,,,,1,1,2
HND-013775,2011,151700053,,,,5,0,5
HND-013776,2011,151700054,,,,2,1,3
HND-013777,2011,151700055,,,,0,3,3
HND-013778,2011,151700056,,,,1,2,3
HND-013779,2011,151700057,,,,3,1,4
,2011,151700088,,,,0,1,1
,2011,151700092,,,,3,8,11
HND-013811,2011,151700121,,,,2,2,4
HND-013816,2011,151700128,,,,1,4,5
HND-013728,2011,151700002,,,,2,0,2
HND-013729,2011,151700003,,,,2,2,4
HND-013730,2011,151700004,,,,4,7,11
HND-013732,2011,151700007,,,,1,2,3
HND-013736,2011,151700011,,,,4,7,11
HND-013741,2011,151700016,,,,11,11,22
HND-013744,2011,151700019,,,,7,6,13
HND-013745,2011,151700020,,,,3,3,6
HND-013746,2011,151700021,,,,10,11,21
HND-013747,2011,151700022,,,,3,5,8
HND-013748,2011,151700023,,,,3,1,4
HND-013749,2011,151700024,,,,6,7,13
HND-013750,2011,151700025,,,,3,7,10
HND-013751,2011,151700026,,,,6,4,10
HND-013752,2011,151700027,,,,5,9,14
HND-013757,2011,151700033,,,,2,3,5
HND-013758,2011,151700034,,,,5,3,8
HND-013759,2011,151700035,,,,1,4,5
HND-013761,2011,151700037,,,,6,3,9
HND-013762,2011,151700038,,,,8,5,13
HND-013764,2011,151700040,,,,2,0,2
HND-013765,2011,151700041,,,,3,4,7
HND-013769,2011,151700046,,,,4,5,9
HND-013771,2011,151700048,,,,1,1,2
HND-013791,2011,151700070,,,,1,0,1
HND-013792,2011,151700071,,,,2,5,7
HND-013793,2011,151700079,,,,2,1,3
HND-013795,2011,151700083,,,,2,2,4
,2011,151700084,,,,0,1,1
,2011,151700085,,,,2,2,4
HND-013799,2011,151700087,,,,1,2,3
,2011,151700093,,,,9,8,17
HND-013801,2011,151700094,,,,4,4,8
HND-013803,2011,151700096,,,,1,3,4
HND-013812,2011,151700122,,,,3,1,4
HND-013814,2011,151700126,,,,1,1,2
HND-013815,2011,151700127,,,,2,1,3
HND-013763,2011,151700039,,,,6,15,21
,2011,151700090,,,,27,25,52
,2011,151700091,,,,80,87,167
HND-013739,2011,151700014,,,,27,17,44
HND-013752,2011,151700027,,,,9,9,18
HND-013780,2011,151700058,,,,72,69,141
,2011,151700092,,,,1,4,5
HND-013752,2011,151700027,,,,11,5,16
HND-013780,2011,151700058,,,,54,59,113
,2011,151700092,,,,2,4,6
HND-013739,2011,151700014,,,,11,8,19
HND-013763,2011,151700039,,,,14,9,23
,2011,151700090,,,,18,20,38
,2011,151700091,,,,54,97,151
HND-013752,2011,151700027,,,,9,4,13
,2011,151700091,,,,56,97,153
,2011,151700092,,,,1,5,6
HND-013739,2011,151700014,,,,14,8,22
HND-013763,2011,151700039,,,,7,11,18
HND-013780,2011,151700058,,,,56,57,113
,2011,151700090,,,,12,15,27
HND-013780,2011,151700058,,,,43,68,111
,2011,151700091,,,,61,120,181
HND-013780,2011,151700058,,,,32,51,83
,2011,151700090,,,,5,4,9
,2011,151700091,,,,43,109,152
HND-013780,2011,151700058,,,,34,41,75
,2011,151700090,,,,11,6,17
HND-013864,2011,151800038,,,,6,2,8
,2011,151800039,,,,4,2,6
,2011,151800040,,,,1,4,5
,2011,151800041,,,,2,5,7
HND-013865,2011,151800042,,,,5,3,8
,2011,151800043,,,,5,4,9
,2011,151800036,,,,4,5,9
HND-013863,2011,151800037,,,,5,4,9
HND-013858,2011,151800014,,,,6,15,21
HND-013859,2011,151800015,,,,9,3,12
,2011,151800020,,,,1,0,1
HND-013857,2011,151800013,,,,9,17,26
HND-013860,2011,151800016,,,,5,1,6
,2011,151800044,,,,1,2,3
HND-013857,2011,151800013,,,,26,15,41
HND-013860,2011,151800016,,,,4,8,12
,2011,151800020,,,,5,8,13
,2011,151800044,,,,3,2,5
HND-013858,2011,151800014,,,,12,15,27
HND-013859,2011,151800015,,,,5,2,7
HND-013846,2011,151800002,,,,7,5,12
HND-013847,2011,151800003,,,,2,3,5
HND-013848,2011,151800004,,,,25,35,60
HND-013849,2011,151800005,,,,10,9,19
HND-013851,2011,151800007,,,,4,0,4
HND-013852,2011,151800008,,,,6,4,10
HND-013854,2011,151800010,,,,4,3,7
HND-013855,2011,151800011,,,,11,13,24
HND-013856,2011,151800012,,,,0,4,4
HND-013862,2011,151800021,,,,3,4,7
HND-013845,2011,151800001,,,,10,11,21
HND-013850,2011,151800006,,,,9,9,18
HND-013853,2011,151800009,,,,0,3,3
HND-013845,2011,151800001,,,,11,10,21
HND-013846,2011,151800002,,,,11,8,19
HND-013847,2011,151800003,,,,1,5,6
HND-013850,2011,151800006,,,,7,2,9
HND-013854,2011,151800010,,,,7,5,12
HND-013855,2011,151800011,,,,15,13,28
HND-013862,2011,151800021,,,,3,6,9
HND-013848,2011,151800004,,,,46,34,80
HND-013849,2011,151800005,,,,11,18,29
HND-013852,2011,151800008,,,,3,2,5
HND-013853,2011,151800009,,,,3,7,10
HND-013856,2011,151800012,,,,1,3,4
HND-013845,2011,151800001,,,,12,17,29
HND-013850,2011,151800006,,,,11,7,18
HND-013853,2011,151800009,,,,0,1,1
HND-013846,2011,151800002,,,,3,8,11
HND-013847,2011,151800003,,,,3,6,9
HND-013848,2011,151800004,,,,44,33,77
HND-013849,2011,151800005,,,,23,9,32
HND-013851,2011,151800007,,,,0,3,3
HND-013852,2011,151800008,,,,6,1,7
HND-013854,2011,151800010,,,,3,5,8
HND-013855,2011,151800011,,,,18,15,33
HND-013856,2011,151800012,,,,3,1,4
HND-013862,2011,151800021,,,,4,4,8
HND-013845,2011,151800001,,,,10,10,20
HND-013846,2011,151800002,,,,0,9,9
HND-013847,2011,151800003,,,,4,2,6
HND-013849,2011,151800005,,,,9,8,17
HND-013851,2011,151800007,,,,4,1,5
HND-013854,2011,151800010,,,,8,9,17
HND-013855,2011,151800011,,,,13,14,27
HND-013856,2011,151800012,,,,4,5,9
HND-013862,2011,151800021,,,,5,1,6
HND-013848,2011,151800004,,,,48,33,81
HND-013850,2011,151800006,,,,6,6,12
HND-013852,2011,151800008,,,,1,6,7
HND-013853,2011,151800009,,,,1,6,7
HND-013845,2011,151800001,,,,10,11,21
HND-013846,2011,151800002,,,,3,4,7
HND-013847,2011,151800003,,,,6,1,7
HND-013848,2011,151800004,,,,29,42,71
HND-013849,2011,151800005,,,,25,14,39
HND-013851,2011,151800007,,,,3,0,3
HND-013852,2011,151800008,,,,5,7,12
HND-013854,2011,151800010,,,,1,6,7
HND-013856,2011,151800012,,,,5,1,6
HND-013850,2011,151800006,,,,4,7,11
HND-013853,2011,151800009,,,,3,5,8
HND-013855,2011,151800011,,,,8,10,18
HND-013862,2011,151800021,,,,3,3,6
HND-013845,2011,151800001,,,,11,5,16
HND-013846,2011,151800002,,,,1,3,4
HND-013847,2011,151800003,,,,0,6,6
HND-013850,2011,151800006,,,,3,7,10
HND-013851,2011,151800007,,,,4,1,5
HND-013854,2011,151800010,,,,0,2,2
HND-013855,2011,151800011,,,,23,18,41
HND-013862,2011,151800021,,,,2,5,7
HND-013848,2011,151800004,,,,21,35,56
HND-013849,2011,151800005,,,,12,14,26
HND-013852,2011,151800008,,,,6,3,9
HND-013853,2011,151800009,,,,2,2,4
HND-013856,2011,151800012,,,,3,4,7
HND-013855,2011,151800011,,,,16,21,37
HND-013861,2011,151800018,,,,56,57,113
HND-013855,2011,151800011,,,,12,22,34
HND-013861,2011,151800018,,,,70,64,134
HND-013861,2011,151800018,,,,55,59,114
HND-013855,2011,151800011,,,,11,10,21
HND-013861,2011,151800018,,,,49,55,104
HND-013861,2011,151800018,,,,62,48,110
HND-013861,2011,151800018,,,,23,40,63
HND-013926,2011,151900082,,,,6,7,13
,2011,151900085,,,,1,7,8
HND-013929,2011,151900087,,,,7,7,14
,2011,151900088,,,,8,4,12
HND-013931,2011,151900090,,,,9,4,13
,2011,151900096,,,,4,4,8
HND-013936,2011,151900099,,,,7,3,10
HND-013870,2011,151900003,,,,5,3,8
HND-013925,2011,151900081,,,,4,7,11
HND-013928,2011,151900086,,,,7,6,13
HND-013930,2011,151900089,,,,6,8,14
,2011,151900092,,,,5,3,8
HND-013932,2011,151900094,,,,9,3,12
HND-013933,2011,151900095,,,,7,3,10
,2011,151900071,,,,2,2,4
HND-013909,2011,151900042,,,,12,19,31
HND-013914,2011,151900049,,,,3,7,10
HND-013920,2011,151900055,,,,8,3,11
HND-013921,2011,151900056,,,,6,4,10
HND-013923,2011,151900058,,,,3,3,6
,2011,151900071,,,,1,0,1
HND-013924,2011,151900078,,,,5,2,7
HND-013870,2011,151900003,,,,2,1,3
HND-013910,2011,151900043,,,,7,2,9
,2011,151900044,,,,1,4,5
HND-013911,2011,151900045,,,,4,4,8
HND-013912,2011,151900046,,,,5,1,6
HND-013913,2011,151900047,,,,5,3,8
HND-013915,2011,151900050,,,,2,4,6
HND-013916,2011,151900051,,,,3,6,9
HND-013917,2011,151900052,,,,3,4,7
HND-013922,2011,151900057,,,,6,3,9
,2011,151900070,,,,3,3,6
HND-013909,2011,151900042,,,,23,19,42
HND-013914,2011,151900049,,,,7,8,15
HND-013915,2011,151900050,,,,5,3,8
HND-013916,2011,151900051,,,,3,5,8
HND-013920,2011,151900055,,,,22,32,54
HND-013921,2011,151900056,,,,3,4,7
,2011,151900070,,,,4,5,9
HND-013924,2011,151900078,,,,0,7,7
HND-013870,2011,151900003,,,,3,3,6
HND-013910,2011,151900043,,,,5,9,14
,2011,151900044,,,,8,3,11
HND-013911,2011,151900045,,,,5,4,9
HND-013912,2011,151900046,,,,6,6,12
HND-013913,2011,151900047,,,,6,10,16
HND-013917,2011,151900052,,,,4,6,10
HND-013922,2011,151900057,,,,4,7,11
HND-013923,2011,151900058,,,,6,5,11
,2011,151900071,,,,2,3,5
HND-013868,2011,151900001,,,,14,18,32
HND-013873,2011,151900006,,,,2,1,3
HND-013874,2011,151900007,,,,49,53,102
HND-013876,2011,151900009,,,,2,1,3
HND-013882,2011,151900015,,,,5,5,10
HND-013884,2011,151900017,,,,2,4,6
HND-013885,2011,151900018,,,,4,2,6
HND-013886,2011,151900019,,,,10,2,12
HND-013887,2011,151900020,,,,2,2,4
HND-013888,2011,151900021,,,,4,2,6
HND-013889,2011,151900022,,,,2,1,3
HND-013891,2011,151900024,,,,4,7,11
HND-013893,2011,151900026,,,,3,2,5
HND-013896,2011,151900029,,,,1,6,7
HND-013899,2011,151900032,,,,2,2,4
HND-013900,2011,151900033,,,,1,5,6
HND-013902,2011,151900035,,,,6,4,10
HND-013904,2011,151900037,,,,2,2,4
HND-013905,2011,151900038,,,,2,6,8
HND-013908,2011,151900041,,,,17,19,36
,2011,151900044,,,,7,14,21
HND-013927,2011,151900084,,,,3,3,6
HND-013935,2011,151900098,,,,0,4,4
HND-013869,2011,151900002,,,,10,7,17
HND-013870,2011,151900003,,,,9,9,18
HND-013871,2011,151900004,,,,4,4,8
HND-013872,2011,151900005,,,,4,2,6
HND-013875,2011,151900008,,,,5,6,11
HND-013877,2011,151900010,,,,4,2,6
HND-013878,2011,151900011,,,,5,7,12
HND-013879,2011,151900012,,,,1,1,2
HND-013880,2011,151900013,,,,9,9,18
HND-013881,2011,151900014,,,,1,9,10
HND-013883,2011,151900016,,,,6,9,15
HND-013890,2011,151900023,,,,8,9,17
HND-013892,2011,151900025,,,,5,5,10
HND-013894,2011,151900027,,,,4,3,7
HND-013895,2011,151900028,,,,5,7,12
HND-013897,2011,151900030,,,,1,2,3
HND-013898,2011,151900031,,,,4,6,10
HND-013903,2011,151900036,,,,1,5,6
HND-013906,2011,151900039,,,,1,1,2
HND-013907,2011,151900040,,,,3,3,6
HND-013934,2011,151900097,,,,1,0,1
HND-013872,2011,151900005,,,,2,1,3
HND-013874,2011,151900007,,,,58,45,103
HND-013875,2011,151900008,,,,4,7,11
HND-013876,2011,151900009,,,,1,2,3
HND-013879,2011,151900012,,,,4,4,8
HND-013880,2011,151900013,,,,7,8,15
HND-013881,2011,151900014,,,,6,1,7
HND-013882,2011,151900015,,,,3,2,5
HND-013884,2011,151900017,,,,3,3,6
HND-013885,2011,151900018,,,,4,6,10
HND-013895,2011,151900028,,,,4,8,12
HND-013896,2011,151900029,,,,3,1,4
HND-013902,2011,151900035,,,,3,2,5
HND-013905,2011,151900038,,,,3,9,12
HND-013906,2011,151900039,,,,2,0,2
HND-013907,2011,151900040,,,,1,1,2
HND-013868,2011,151900001,,,,19,16,35
HND-013869,2011,151900002,,,,6,11,17
HND-013870,2011,151900003,,,,10,7,17
HND-013871,2011,151900004,,,,5,3,8
HND-013877,2011,151900010,,,,7,6,13
HND-013878,2011,151900011,,,,4,6,10
HND-013883,2011,151900016,,,,8,7,15
HND-013886,2011,151900019,,,,2,11,13
HND-013887,2011,151900020,,,,0,1,1
HND-013888,2011,151900021,,,,1,1,2
HND-013889,2011,151900022,,,,0,3,3
HND-013890,2011,151900023,,,,4,1,5
HND-013891,2011,151900024,,,,1,5,6
HND-013892,2011,151900025,,,,7,3,10
HND-013893,2011,151900026,,,,1,0,1
HND-013894,2011,151900027,,,,0,2,2
HND-013897,2011,151900030,,,,4,2,6
HND-013898,2011,151900031,,,,4,1,5
HND-013899,2011,151900032,,,,3,0,3
HND-013900,2011,151900033,,,,7,2,9
HND-013901,2011,151900034,,,,3,1,4
HND-013904,2011,151900037,,,,1,2,3
HND-013908,2011,151900041,,,,20,18,38
,2011,151900044,,,,3,6,9
HND-013927,2011,151900084,,,,8,4,12
HND-013934,2011,151900097,,,,1,1,2
HND-013935,2011,151900098,,,,0,1,1
HND-013869,2011,151900002,,,,13,10,23
HND-013870,2011,151900003,,,,9,8,17
HND-013871,2011,151900004,,,,3,5,8
HND-013875,2011,151900008,,,,8,11,19
HND-013877,2011,151900010,,,,8,5,13
HND-013878,2011,151900011,,,,3,7,10
HND-013879,2011,151900012,,,,4,4,8
HND-013880,2011,151900013,,,,9,5,14
HND-013881,2011,151900014,,,,7,2,9
HND-013883,2011,151900016,,,,7,1,8
HND-013884,2011,151900017,,,,6,5,11
HND-013890,2011,151900023,,,,8,5,13
HND-013892,2011,151900025,,,,3,8,11
HND-013894,2011,151900027,,,,4,4,8
HND-013895,2011,151900028,,,,6,5,11
HND-013896,2011,151900029,,,,3,3,6
HND-013899,2011,151900032,,,,1,4,5
HND-013900,2011,151900033,,,,4,0,4
HND-013902,2011,151900035,,,,2,3,5
HND-013904,2011,151900037,,,,3,2,5
HND-013905,2011,151900038,,,,1,3,4
,2011,151900044,,,,5,6,11
HND-013927,2011,151900084,,,,7,4,11
HND-013935,2011,151900098,,,,1,1,2
HND-013868,2011,151900001,,,,14,12,26
HND-013873,2011,151900006,,,,3,1,4
HND-013874,2011,151900007,,,,61,63,124
HND-013876,2011,151900009,,,,3,1,4
HND-013882,2011,151900015,,,,4,1,5
HND-013885,2011,151900018,,,,5,3,8
HND-013886,2011,151900019,,,,6,4,10
HND-013887,2011,151900020,,,,0,1,1
HND-013888,2011,151900021,,,,1,8,9
HND-013889,2011,151900022,,,,0,2,2
HND-013891,2011,151900024,,,,6,2,8
HND-013893,2011,151900026,,,,1,2,3
HND-013897,2011,151900030,,,,1,2,3
HND-013898,2011,151900031,,,,2,3,5
HND-013901,2011,151900034,,,,3,1,4
HND-013903,2011,151900036,,,,3,1,4
HND-013906,2011,151900039,,,,0,2,2
HND-013907,2011,151900040,,,,2,3,5
HND-013908,2011,151900041,,,,12,10,22
HND-013934,2011,151900097,,,,3,0,3
HND-013873,2011,151900006,,,,1,1,2
HND-013874,2011,151900007,,,,47,47,94
HND-013875,2011,151900008,,,,9,3,12
HND-013879,2011,151900012,,,,7,4,11
HND-013880,2011,151900013,,,,7,6,13
HND-013881,2011,151900014,,,,6,4,10
HND-013882,2011,151900015,,,,9,3,12
HND-013884,2011,151900017,,,,2,1,3
HND-013885,2011,151900018,,,,6,3,9
HND-013887,2011,151900020,,,,3,0,3
HND-013888,2011,151900021,,,,5,1,6
HND-013893,2011,151900026,,,,1,1,2
HND-013896,2011,151900029,,,,1,0,1
HND-013903,2011,151900036,,,,4,3,7
HND-013905,2011,151900038,,,,5,5,10
HND-013906,2011,151900039,,,,1,2,3
HND-013907,2011,151900040,,,,4,0,4
HND-013868,2011,151900001,,,,13,22,35
HND-013869,2011,151900002,,,,8,8,16
HND-013870,2011,151900003,,,,9,7,16
HND-013871,2011,151900004,,,,3,1,4
HND-013872,2011,151900005,,,,2,0,2
HND-013878,2011,151900011,,,,1,5,6
HND-013883,2011,151900016,,,,3,3,6
HND-013886,2011,151900019,,,,7,3,10
HND-013889,2011,151900022,,,,4,1,5
HND-013890,2011,151900023,,,,2,3,5
HND-013891,2011,151900024,,,,2,8,10
HND-013892,2011,151900025,,,,5,2,7
HND-013894,2011,151900027,,,,2,3,5
HND-013895,2011,151900028,,,,4,7,11
HND-013897,2011,151900030,,,,1,1,2
HND-013898,2011,151900031,,,,1,2,3
HND-013899,2011,151900032,,,,2,2,4
HND-013900,2011,151900033,,,,4,1,5
HND-013901,2011,151900034,,,,0,3,3
HND-013902,2011,151900035,,,,4,4,8
HND-013904,2011,151900037,,,,1,1,2
HND-013908,2011,151900041,,,,18,10,28
,2011,151900044,,,,4,6,10
HND-013927,2011,151900084,,,,2,4,6
HND-013935,2011,151900098,,,,1,1,2
HND-013868,2011,151900001,,,,14,12,26
HND-013873,2011,151900006,,,,3,0,3
HND-013874,2011,151900007,,,,69,60,129
HND-013876,2011,151900009,,,,0,1,1
HND-013880,2011,151900013,,,,4,9,13
HND-013882,2011,151900015,,,,8,6,14
HND-013884,2011,151900017,,,,2,4,6
HND-013885,2011,151900018,,,,3,2,5
HND-013886,2011,151900019,,,,7,5,12
HND-013887,2011,151900020,,,,2,0,2
HND-013888,2011,151900021,,,,1,0,1
HND-013893,2011,151900026,,,,1,0,1
HND-013896,2011,151900029,,,,4,1,5
HND-013897,2011,151900030,,,,2,3,5
HND-013898,2011,151900031,,,,7,2,9
HND-013903,2011,151900036,,,,5,1,6
HND-013906,2011,151900039,,,,2,2,4
HND-013907,2011,151900040,,,,1,0,1
HND-013869,2011,151900002,,,,7,5,12
HND-013870,2011,151900003,,,,14,9,23
HND-013871,2011,151900004,,,,5,8,13
HND-013872,2011,151900005,,,,1,0,1
HND-013875,2011,151900008,,,,4,4,8
HND-013877,2011,151900010,,,,0,1,1
HND-013878,2011,151900011,,,,3,8,11
HND-013879,2011,151900012,,,,0,7,7
HND-013881,2011,151900014,,,,5,3,8
HND-013883,2011,151900016,,,,5,9,14
HND-013889,2011,151900022,,,,5,3,8
HND-013890,2011,151900023,,,,3,8,11
HND-013891,2011,151900024,,,,4,7,11
HND-013892,2011,151900025,,,,5,4,9
HND-013894,2011,151900027,,,,2,3,5
HND-013895,2011,151900028,,,,4,9,13
HND-013899,2011,151900032,,,,4,1,5
HND-013900,2011,151900033,,,,4,5,9
HND-013902,2011,151900035,,,,1,1,2
HND-013904,2011,151900037,,,,1,1,2
HND-013905,2011,151900038,,,,2,4,6
HND-013908,2011,151900041,,,,21,23,44
,2011,151900044,,,,5,2,7
HND-013927,2011,151900084,,,,3,2,5
HND-013934,2011,151900097,,,,0,1,1
HND-013935,2011,151900098,,,,0,2,2
HND-013868,2011,151900001,,,,14,13,27
HND-013869,2011,151900002,,,,9,11,20
HND-013870,2011,151900003,,,,11,11,22
HND-013871,2011,151900004,,,,3,1,4
HND-013873,2011,151900006,,,,2,3,5
HND-013877,2011,151900010,,,,3,9,12
HND-013878,2011,151900011,,,,1,7,8
HND-013883,2011,151900016,,,,3,5,8
HND-013885,2011,151900018,,,,8,4,12
HND-013886,2011,151900019,,,,4,6,10
HND-013887,2011,151900020,,,,3,1,4
HND-013888,2011,151900021,,,,4,2,6
HND-013889,2011,151900022,,,,0,4,4
HND-013890,2011,151900023,,,,5,6,11
HND-013891,2011,151900024,,,,2,3,5
HND-013892,2011,151900025,,,,4,3,7
HND-013893,2011,151900026,,,,0,1,1
HND-013894,2011,151900027,,,,0,3,3
HND-013897,2011,151900030,,,,1,2,3
HND-013898,2011,151900031,,,,2,1,3
HND-013899,2011,151900032,,,,1,1,2
HND-013900,2011,151900033,,,,2,0,2
HND-013901,2011,151900034,,,,2,2,4
HND-013903,2011,151900036,,,,2,4,6
HND-013904,2011,151900037,,,,2,2,4
HND-013908,2011,151900041,,,,25,15,40
,2011,151900044,,,,7,6,13
HND-013927,2011,151900084,,,,1,5,6
HND-013935,2011,151900098,,,,1,0,1
HND-013872,2011,151900005,,,,0,1,1
HND-013874,2011,151900007,,,,60,59,119
HND-013875,2011,151900008,,,,6,12,18
HND-013876,2011,151900009,,,,2,4,6
HND-013879,2011,151900012,,,,6,5,11
HND-013880,2011,151900013,,,,6,4,10
HND-013881,2011,151900014,,,,2,0,2
HND-013882,2011,151900015,,,,5,4,9
HND-013884,2011,151900017,,,,5,4,9
HND-013895,2011,151900028,,,,11,4,15
HND-013896,2011,151900029,,,,3,3,6
HND-013902,2011,151900035,,,,3,2,5
HND-013905,2011,151900038,,,,2,2,4
HND-013906,2011,151900039,,,,1,1,2
HND-013907,2011,151900040,,,,2,0,2
HND-013868,2011,151900001,,,,10,11,21
HND-013885,2011,151900018,,,,13,5,18
HND-013918,2011,151900053,,,,120,111,231
HND-013869,2011,151900002,,,,13,9,22
HND-013878,2011,151900011,,,,7,13,20
,2011,151900044,,,,6,7,13
HND-013919,2011,151900054,,,,25,18,43
HND-013885,2011,151900018,,,,4,2,6
HND-013919,2011,151900054,,,,13,27,40
HND-013868,2011,151900001,,,,6,18,24
HND-013869,2011,151900002,,,,5,13,18
HND-013878,2011,151900011,,,,16,8,24
,2011,151900044,,,,12,7,19
HND-013918,2011,151900053,,,,104,110,214
HND-013885,2011,151900018,,,,9,4,13
HND-013918,2011,151900053,,,,67,77,144
HND-013868,2011,151900001,,,,14,16,30
HND-013869,2011,151900002,,,,11,5,16
HND-013878,2011,151900011,,,,19,9,28
,2011,151900044,,,,3,8,11
HND-013919,2011,151900054,,,,11,19,30
HND-013918,2011,151900053,,,,100,82,182
HND-013919,2011,151900054,,,,14,13,27
HND-013919,2011,151900054,,,,13,7,20
HND-013918,2011,151900053,,,,58,50,108
HND-013918,2011,151900053,,,,35,49,84
HND-013919,2011,151900054,,,,9,17,26
HND-013952,2011,152000017,,,,8,15,23
,2011,152000018,,,,9,3,12
,2011,152000025,,,,3,3,6
,2011,152000021,,,,2,4,6
,2011,152000022,,,,3,1,4
HND-013946,2011,152000010,,,,5,4,9
HND-013947,2011,152000011,,,,3,6,9
HND-013949,2011,152000013,,,,6,3,9
,2011,152000021,,,,3,2,5
HND-013945,2011,152000009,,,,22,20,42
HND-013948,2011,152000012,,,,5,5,10
,2011,152000022,,,,1,1,2
HND-013955,2011,152000027,,,,2,4,6
HND-013956,2011,152000028,,,,3,2,5
HND-013945,2011,152000009,,,,27,21,48
HND-013948,2011,152000012,,,,5,5,10
HND-013955,2011,152000027,,,,13,3,16
HND-013956,2011,152000028,,,,6,1,7
HND-013946,2011,152000010,,,,26,22,48
HND-013947,2011,152000011,,,,11,7,18
HND-013949,2011,152000013,,,,7,7,14
,2011,152000021,,,,3,3,6
,2011,152000022,,,,3,3,6
HND-013938,2011,152000002,,,,19,9,28
HND-013941,2011,152000005,,,,3,2,5
HND-013954,2011,152000019,,,,10,10,20
HND-013937,2011,152000001,,,,4,14,18
HND-013939,2011,152000003,,,,54,44,98
HND-013940,2011,152000004,,,,2,2,4
,2011,152000006,,,,8,7,15
HND-013943,2011,152000007,,,,23,17,40
HND-013944,2011,152000008,,,,25,26,51
,2011,152000024,,,,0,1,1
HND-013937,2011,152000001,,,,6,6,12
HND-013939,2011,152000003,,,,42,44,86
HND-013940,2011,152000004,,,,2,1,3
HND-013941,2011,152000005,,,,1,4,5
,2011,152000006,,,,10,9,19
HND-013943,2011,152000007,,,,25,22,47
,2011,152000024,,,,2,3,5
HND-013938,2011,152000002,,,,17,10,27
HND-013944,2011,152000008,,,,13,13,26
HND-013954,2011,152000019,,,,8,14,22
HND-013937,2011,152000001,,,,5,7,12
HND-013939,2011,152000003,,,,38,38,76
HND-013940,2011,152000004,,,,4,2,6
,2011,152000006,,,,9,15,24
HND-013943,2011,152000007,,,,20,25,45
HND-013944,2011,152000008,,,,12,16,28
HND-013938,2011,152000002,,,,10,18,28
HND-013941,2011,152000005,,,,2,2,4
HND-013954,2011,152000019,,,,5,7,12
HND-013939,2011,152000003,,,,34,29,63
HND-013940,2011,152000004,,,,2,2,4
HND-013941,2011,152000005,,,,9,3,12
,2011,152000006,,,,4,4,8
HND-013943,2011,152000007,,,,22,24,46
HND-013954,2011,152000019,,,,6,7,13
HND-013937,2011,152000001,,,,9,8,17
HND-013938,2011,152000002,,,,10,18,28
HND-013944,2011,152000008,,,,16,24,40
,2011,152000024,,,,4,2,6
HND-013938,2011,152000002,,,,23,13,36
HND-013939,2011,152000003,,,,45,62,107
HND-013941,2011,152000005,,,,6,1,7
HND-013943,2011,152000007,,,,32,36,68
HND-013954,2011,152000019,,,,3,8,11
HND-013937,2011,152000001,,,,13,17,30
HND-013940,2011,152000004,,,,5,4,9
,2011,152000006,,,,4,13,17
HND-013944,2011,152000008,,,,20,27,47
,2011,152000024,,,,1,0,1
HND-013938,2011,152000002,,,,18,22,40
HND-013944,2011,152000008,,,,22,19,41
HND-013954,2011,152000019,,,,5,3,8
HND-013937,2011,152000001,,,,10,8,18
HND-013939,2011,152000003,,,,53,49,102
HND-013940,2011,152000004,,,,0,4,4
HND-013941,2011,152000005,,,,3,7,10
,2011,152000006,,,,2,7,9
HND-013943,2011,152000007,,,,28,36,64
,2011,152000024,,,,4,1,5
HND-013950,2011,152000015,,,,55,65,120
HND-013951,2011,152000016,,,,56,50,106
HND-013950,2011,152000015,,,,58,65,123
HND-013951,2011,152000016,,,,45,53,98
HND-013950,2011,152000015,,,,53,65,118
HND-013951,2011,152000016,,,,37,46,83
HND-013951,2011,152000016,,,,22,31,53
HND-013950,2011,152000015,,,,42,62,104
HND-013951,2011,152000016,,,,14,15,29
HND-013950,2011,152000015,,,,37,58,95
HND-013950,2011,152000015,,,,28,35,63
HND-013951,2011,152000016,,,,13,24,37
,2011,152100077,,,,6,4,10
,2011,152100079,,,,8,2,10
,2011,152100083,,,,8,4,12
,2011,152100085,,,,4,6,10
,2011,152100089,,,,9,9,18
,2011,152100080,,,,2,8,10
,2011,152100084,,,,3,7,10
HND-013976,2011,152100020,,,,9,17,26
HND-013977,2011,152100022,,,,8,7,15
HND-013978,2011,152100025,,,,1,1,2
,2011,152100086,,,,3,3,6
,2011,152100087,,,,2,1,3
,2011,152100021,,,,2,8,10
,2011,152100024,,,,5,1,6
,2011,152100031,,,,4,3,7
,2011,152100082,,,,2,4,6
,2011,152100088,,,,2,3,5
,2011,152100021,,,,14,6,20
,2011,152100024,,,,3,6,9
HND-013978,2011,152100025,,,,10,11,21
HND-013979,2011,152100027,,,,11,3,14
,2011,152100086,,,,3,6,9
,2011,152100087,,,,6,6,12
HND-013976,2011,152100020,,,,10,15,25
HND-013977,2011,152100022,,,,6,4,10
,2011,152100031,,,,6,5,11
,2011,152100082,,,,3,5,8
,2011,152100088,,,,5,5,10
HND-013959,2011,152100003,,,,6,4,10
HND-013960,2011,152100004,,,,2,0,2
HND-013962,2011,152100006,,,,8,3,11
HND-013963,2011,152100007,,,,10,8,18
HND-013965,2011,152100009,,,,5,2,7
HND-013966,2011,152100010,,,,1,1,2
HND-013970,2011,152100014,,,,2,2,4
HND-013971,2011,152100015,,,,3,0,3
HND-013973,2011,152100017,,,,5,1,6
HND-013974,2011,152100018,,,,1,1,2
HND-013957,2011,152100001,,,,15,9,24
HND-013958,2011,152100002,,,,5,6,11
,2011,152100005,,,,3,6,9
HND-013964,2011,152100008,,,,2,7,9
HND-013967,2011,152100011,,,,0,1,1
HND-013968,2011,152100012,,,,2,4,6
HND-013969,2011,152100013,,,,1,4,5
HND-013972,2011,152100016,,,,1,6,7
HND-013975,2011,152100019,,,,4,2,6
HND-013981,2011,152100029,,,,5,6,11
HND-013982,2011,152100033,,,,9,8,17
HND-013983,2011,152100076,,,,2,2,4
,2011,152100082,,,,2,2,4
HND-013958,2011,152100002,,,,10,5,15
HND-013959,2011,152100003,,,,9,4,13
HND-013965,2011,152100009,,,,1,4,5
HND-013966,2011,152100010,,,,1,1,2
HND-013969,2011,152100013,,,,3,1,4
HND-013970,2011,152100014,,,,4,5,9
HND-013972,2011,152100016,,,,7,2,9
HND-013973,2011,152100017,,,,2,2,4
HND-013975,2011,152100019,,,,6,2,8
HND-013957,2011,152100001,,,,13,18,31
HND-013960,2011,152100004,,,,4,6,10
,2011,152100005,,,,8,6,14
HND-013962,2011,152100006,,,,10,5,15
HND-013963,2011,152100007,,,,14,7,21
HND-013964,2011,152100008,,,,4,4,8
HND-013968,2011,152100012,,,,1,5,6
HND-013971,2011,152100015,,,,1,0,1
HND-013974,2011,152100018,,,,5,3,8
HND-013981,2011,152100029,,,,4,5,9
HND-013982,2011,152100033,,,,8,10,18
HND-013983,2011,152100076,,,,2,2,4
,2011,152100082,,,,1,2,3
HND-013957,2011,152100001,,,,16,11,27
HND-013958,2011,152100002,,,,4,4,8
HND-013959,2011,152100003,,,,5,5,10
,2011,152100005,,,,13,12,25
HND-013964,2011,152100008,,,,4,9,13
HND-013967,2011,152100011,,,,2,1,3
HND-013969,2011,152100013,,,,0,6,6
HND-013972,2011,152100016,,,,1,2,3
HND-013975,2011,152100019,,,,2,1,3
HND-013981,2011,152100029,,,,2,3,5
HND-013960,2011,152100004,,,,3,1,4
HND-013962,2011,152100006,,,,11,5,16
HND-013963,2011,152100007,,,,9,7,16
HND-013965,2011,152100009,,,,2,2,4
HND-013966,2011,152100010,,,,3,0,3
HND-013968,2011,152100012,,,,8,3,11
HND-013970,2011,152100014,,,,2,2,4
HND-013971,2011,152100015,,,,1,2,3
HND-013973,2011,152100017,,,,2,0,2
HND-013974,2011,152100018,,,,1,1,2
HND-013982,2011,152100033,,,,6,10,16
HND-013983,2011,152100076,,,,0,2,2
,2011,152100082,,,,0,1,1
HND-013959,2011,152100003,,,,6,11,17
HND-013960,2011,152100004,,,,2,1,3
HND-013962,2011,152100006,,,,7,7,14
HND-013965,2011,152100009,,,,5,1,6
HND-013966,2011,152100010,,,,1,1,2
HND-013967,2011,152100011,,,,1,1,2
HND-013970,2011,152100014,,,,3,6,9
HND-013971,2011,152100015,,,,4,2,6
HND-013972,2011,152100016,,,,5,4,9
HND-013973,2011,152100017,,,,3,2,5
HND-013957,2011,152100001,,,,16,10,26
HND-013958,2011,152100002,,,,7,3,10
,2011,152100005,,,,10,5,15
HND-013963,2011,152100007,,,,10,10,20
HND-013964,2011,152100008,,,,6,5,11
HND-013968,2011,152100012,,,,1,2,3
HND-013969,2011,152100013,,,,3,2,5
HND-013974,2011,152100018,,,,4,1,5
HND-013975,2011,152100019,,,,1,4,5
HND-013981,2011,152100029,,,,2,2,4
HND-013982,2011,152100033,,,,14,7,21
HND-013983,2011,152100076,,,,1,1,2
,2011,152100082,,,,2,2,4
HND-013959,2011,152100003,,,,7,15,22
HND-013960,2011,152100004,,,,4,1,5
HND-013962,2011,152100006,,,,13,6,19
HND-013963,2011,152100007,,,,12,9,21
HND-013966,2011,152100010,,,,2,1,3
HND-013970,2011,152100014,,,,11,4,15
HND-013971,2011,152100015,,,,2,2,4
HND-013972,2011,152100016,,,,0,4,4
HND-013973,2011,152100017,,,,3,2,5
HND-013983,2011,152100076,,,,0,2,2
,2011,152100082,,,,0,3,3
HND-013957,2011,152100001,,,,17,23,40
HND-013958,2011,152100002,,,,4,9,13
,2011,152100005,,,,10,5,15
HND-013964,2011,152100008,,,,4,8,12
HND-013967,2011,152100011,,,,2,2,4
HND-013968,2011,152100012,,,,2,4,6
HND-013969,2011,152100013,,,,3,0,3
HND-013974,2011,152100018,,,,2,2,4
HND-013975,2011,152100019,,,,4,3,7
HND-013981,2011,152100029,,,,2,1,3
HND-013982,2011,152100033,,,,11,11,22
HND-013957,2011,152100001,,,,17,29,46
HND-013960,2011,152100004,,,,8,8,16
,2011,152100005,,,,7,13,20
HND-013962,2011,152100006,,,,12,15,27
HND-013963,2011,152100007,,,,9,12,21
HND-013964,2011,152100008,,,,7,9,16
HND-013968,2011,152100012,,,,1,3,4
HND-013971,2011,152100015,,,,4,4,8
HND-013974,2011,152100018,,,,3,1,4
HND-013981,2011,152100029,,,,2,3,5
HND-013982,2011,152100033,,,,13,14,27
HND-013983,2011,152100076,,,,1,3,4
,2011,152100082,,,,2,1,3
HND-013958,2011,152100002,,,,7,5,12
HND-013959,2011,152100003,,,,7,7,14
HND-013965,2011,152100009,,,,2,3,5
HND-013966,2011,152100010,,,,3,0,3
HND-013967,2011,152100011,,,,0,3,3
HND-013969,2011,152100013,,,,1,2,3
HND-013970,2011,152100014,,,,3,3,6
HND-013972,2011,152100016,,,,1,5,6
HND-013973,2011,152100017,,,,6,2,8
HND-013975,2011,152100019,,,,1,3,4
HND-013959,2011,152100003,,,,26,22,48
HND-013962,2011,152100006,,,,14,14,28
HND-013980,2011,152100028,,,,28,37,65
,2011,152100068,,,,3,6,9
,2011,152100005,,,,10,6,16
HND-013982,2011,152100033,,,,14,10,24
HND-013959,2011,152100003,,,,13,16,29
,2011,152100068,,,,5,5,10
,2011,152100005,,,,16,12,28
HND-013962,2011,152100006,,,,11,18,29
HND-013980,2011,152100028,,,,24,22,46
HND-013982,2011,152100033,,,,10,19,29
HND-013959,2011,152100003,,,,14,13,27
HND-013962,2011,152100006,,,,13,18,31
HND-013980,2011,152100028,,,,22,28,50
,2011,152100005,,,,15,16,31
HND-013982,2011,152100033,,,,7,10,17
,2011,152100068,,,,3,1,4
,2011,152100068,,,,14,20,34
HND-013980,2011,152100028,,,,41,35,76
,2011,152100068,,,,13,12,25
HND-013980,2011,152100028,,,,27,39,66
HND-013980,2011,152100028,,,,27,18,45
HND-014031,2011,152200059,,,,11,7,18
HND-014034,2011,152200081,,,,2,8,10
HND-014038,2011,152200086,,,,7,3,10
,2011,152200120,,,,5,5,10
HND-014053,2011,152200122,,,,8,3,11
,2011,152200055,,,,7,4,11
,2011,152200057,,,,4,7,11
HND-014030,2011,152200058,,,,5,7,12
HND-014039,2011,152200088,,,,8,5,13
,2011,152200118,,,,4,5,9
HND-014052,2011,152200119,,,,2,6,8
,2011,152200121,,,,7,3,10
,2011,152200089,,,,3,0,3
HND-014040,2011,152200090,,,,4,4,8
,2011,152200095,,,,2,1,3
,2011,152200098,,,,1,3,4
,2011,152200100,,,,2,1,3
,2011,152200101,,,,0,2,2
HND-014045,2011,152200104,,,,2,2,4
HND-014029,2011,152200052,,,,3,2,5
HND-014042,2011,152200092,,,,2,4,6
,2011,152200093,,,,1,0,1
,2011,152200099,,,,1,2,3
HND-014044,2011,152200103,,,,0,1,1
,2011,152200108,,,,1,1,2
,2011,152200109,,,,7,3,10
HND-014048,2011,152200110,,,,2,0,2
,2011,152200111,,,,1,2,3
HND-014050,2011,152200113,,,,3,4,7
,2011,152200114,,,,1,1,2
,2011,152200116,,,,3,2,5
HND-014009,2011,152200026,,,,11,10,21
,2011,152200028,,,,3,3,6
HND-014012,2011,152200030,,,,4,1,5
HND-014029,2011,152200052,,,,2,2,4
,2011,152200089,,,,4,4,8
HND-014040,2011,152200090,,,,1,2,3
HND-014041,2011,152200091,,,,1,1,2
,2011,152200093,,,,3,1,4
,2011,152200099,,,,5,0,5
,2011,152200100,,,,5,1,6
,2011,152200101,,,,3,2,5
HND-014044,2011,152200103,,,,1,1,2
HND-014045,2011,152200104,,,,9,5,14
,2011,152200106,,,,1,1,2
,2011,152200109,,,,3,3,6
HND-014048,2011,152200110,,,,3,6,9
,2011,152200111,,,,3,3,6
HND-014049,2011,152200112,,,,3,3,6
,2011,152200114,,,,2,2,4
,2011,152200116,,,,2,9,11
,2011,152200117,,,,2,1,3
HND-014010,2011,152200027,,,,3,7,10
HND-014011,2011,152200029,,,,10,3,13
HND-014025,2011,152200045,,,,12,9,21
HND-014042,2011,152200092,,,,3,1,4
,2011,152200095,,,,5,0,5
,2011,152200098,,,,4,6,10
HND-014043,2011,152200102,,,,4,4,8
HND-014046,2011,152200105,,,,4,6,10
HND-014047,2011,152200107,,,,4,4,8
,2011,152200108,,,,5,7,12
HND-014050,2011,152200113,,,,8,4,12
HND-014010,2011,152200027,,,,4,2,6
HND-014011,2011,152200029,,,,5,6,11
HND-014042,2011,152200092,,,,3,3,6
,2011,152200093,,,,3,4,7
,2011,152200095,,,,2,2,4
,2011,152200098,,,,2,0,2
HND-014046,2011,152200105,,,,4,1,5
,2011,152200108,,,,4,3,7
,2011,152200111,,,,1,2,3
HND-014050,2011,152200113,,,,3,3,6
HND-014009,2011,152200026,,,,9,12,21
,2011,152200028,,,,5,10,15
HND-014012,2011,152200030,,,,8,8,16
HND-014029,2011,152200052,,,,3,0,3
,2011,152200089,,,,0,2,2
HND-014040,2011,152200090,,,,5,9,14
HND-014041,2011,152200091,,,,2,5,7
,2011,152200099,,,,2,2,4
,2011,152200100,,,,1,5,6
,2011,152200101,,,,3,1,4
HND-014043,2011,152200102,,,,4,3,7
HND-014044,2011,152200103,,,,3,2,5
HND-014045,2011,152200104,,,,1,12,13
,2011,152200106,,,,6,4,10
HND-014047,2011,152200107,,,,6,6,12
,2011,152200109,,,,5,4,9
HND-014048,2011,152200110,,,,4,1,5
HND-014049,2011,152200112,,,,8,4,12
,2011,152200114,,,,2,4,6
,2011,152200116,,,,4,1,5
,2011,152200117,,,,2,2,4
HND-013984,2011,152200001,,,,18,4,22
HND-013987,2011,152200004,,,,6,7,13
HND-013988,2011,152200005,,,,6,1,7
HND-013989,2011,152200006,,,,5,3,8
HND-013990,2011,152200007,,,,10,13,23
HND-013991,2011,152200008,,,,2,3,5
HND-013994,2011,152200011,,,,10,4,14
HND-013996,2011,152200013,,,,3,2,5
HND-013997,2011,152200014,,,,17,8,25
HND-013999,2011,152200016,,,,18,10,28
HND-014002,2011,152200019,,,,9,7,16
HND-014003,2011,152200020,,,,1,2,3
HND-014005,2011,152200022,,,,5,3,8
HND-014007,2011,152200024,,,,5,5,10
HND-014008,2011,152200025,,,,3,2,5
HND-014015,2011,152200033,,,,3,2,5
HND-014016,2011,152200034,,,,5,7,12
HND-014018,2011,152200036,,,,9,4,13
HND-014019,2011,152200037,,,,10,8,18
HND-014021,2011,152200039,,,,3,4,7
HND-014022,2011,152200041,,,,5,3,8
HND-014024,2011,152200043,,,,4,4,8
HND-014027,2011,152200049,,,,5,5,10
HND-014035,2011,152200082,,,,4,5,9
HND-014036,2011,152200083,,,,2,4,6
HND-014051,2011,152200115,,,,3,3,6
HND-014054,2011,152200123,,,,10,7,17
HND-013985,2011,152200002,,,,2,4,6
HND-013986,2011,152200003,,,,18,21,39
HND-013992,2011,152200009,,,,2,4,6
HND-013993,2011,152200010,,,,9,8,17
HND-013995,2011,152200012,,,,12,8,20
HND-013998,2011,152200015,,,,13,17,30
HND-014000,2011,152200017,,,,11,5,16
HND-014001,2011,152200018,,,,14,14,28
HND-014004,2011,152200021,,,,1,4,5
HND-014006,2011,152200023,,,,2,3,5
HND-014014,2011,152200032,,,,3,0,3
HND-014017,2011,152200035,,,,3,1,4
HND-014020,2011,152200038,,,,1,2,3
HND-014023,2011,152200042,,,,9,3,12
HND-014026,2011,152200047,,,,3,3,6
HND-014028,2011,152200050,,,,8,6,14
HND-014032,2011,152200079,,,,4,4,8
HND-014033,2011,152200080,,,,8,0,8
HND-014034,2011,152200081,,,,3,0,3
,2011,152200084,,,,11,2,13
HND-013986,2011,152200003,,,,13,25,38
HND-013987,2011,152200004,,,,6,4,10
HND-013989,2011,152200006,,,,3,3,6
HND-013990,2011,152200007,,,,10,4,14
HND-013995,2011,152200012,,,,1,5,6
HND-013996,2011,152200013,,,,2,6,8
HND-013998,2011,152200015,,,,14,8,22
HND-014001,2011,152200018,,,,12,17,29
HND-014003,2011,152200020,,,,5,3,8
HND-014004,2011,152200021,,,,2,2,4
HND-014006,2011,152200023,,,,0,4,4
HND-014007,2011,152200024,,,,1,3,4
HND-014016,2011,152200034,,,,4,6,10
HND-014017,2011,152200035,,,,4,1,5
HND-014018,2011,152200036,,,,6,2,8
HND-014019,2011,152200037,,,,3,2,5
HND-014026,2011,152200047,,,,3,6,9
HND-014027,2011,152200049,,,,3,6,9
HND-014028,2011,152200050,,,,5,6,11
HND-014032,2011,152200079,,,,5,4,9
HND-014036,2011,152200083,,,,2,3,5
,2011,152200084,,,,3,8,11
HND-014051,2011,152200115,,,,1,4,5
HND-013984,2011,152200001,,,,11,18,29
HND-013985,2011,152200002,,,,7,4,11
HND-013988,2011,152200005,,,,4,2,6
HND-013991,2011,152200008,,,,4,2,6
HND-013993,2011,152200010,,,,9,4,13
HND-013994,2011,152200011,,,,10,8,18
HND-013997,2011,152200014,,,,15,10,25
HND-013999,2011,152200016,,,,7,5,12
HND-014000,2011,152200017,,,,6,10,16
HND-014002,2011,152200019,,,,6,6,12
HND-014005,2011,152200022,,,,3,5,8
HND-014008,2011,152200025,,,,3,0,3
HND-014014,2011,152200032,,,,3,1,4
HND-014015,2011,152200033,,,,1,2,3
HND-014020,2011,152200038,,,,5,3,8
HND-014021,2011,152200039,,,,4,7,11
HND-014022,2011,152200041,,,,7,10,17
HND-014023,2011,152200042,,,,0,2,2
HND-014024,2011,152200043,,,,2,1,3
HND-014033,2011,152200080,,,,4,6,10
HND-014034,2011,152200081,,,,1,1,2
HND-014035,2011,152200082,,,,7,6,13
HND-013985,2011,152200002,,,,5,4,9
HND-013986,2011,152200003,,,,16,24,40
HND-013992,2011,152200009,,,,4,3,7
HND-013995,2011,152200012,,,,8,4,12
HND-013998,2011,152200015,,,,12,16,28
HND-014000,2011,152200017,,,,4,3,7
HND-014001,2011,152200018,,,,8,6,14
HND-014004,2011,152200021,,,,9,4,13
HND-014006,2011,152200023,,,,2,2,4
HND-014007,2011,152200024,,,,4,1,5
HND-014014,2011,152200032,,,,2,3,5
HND-014017,2011,152200035,,,,2,6,8
HND-014020,2011,152200038,,,,1,2,3
HND-014023,2011,152200042,,,,1,1,2
HND-014026,2011,152200047,,,,4,4,8
HND-014028,2011,152200050,,,,7,2,9
HND-014033,2011,152200080,,,,1,1,2
,2011,152200084,,,,0,4,4
HND-013984,2011,152200001,,,,13,13,26
HND-013987,2011,152200004,,,,1,8,9
HND-013988,2011,152200005,,,,3,4,7
HND-013989,2011,152200006,,,,4,0,4
HND-013990,2011,152200007,,,,3,8,11
HND-013991,2011,152200008,,,,1,0,1
HND-013993,2011,152200010,,,,2,2,4
HND-013994,2011,152200011,,,,8,7,15
HND-013996,2011,152200013,,,,4,5,9
HND-013997,2011,152200014,,,,5,9,14
HND-013999,2011,152200016,,,,10,13,23
HND-014002,2011,152200019,,,,10,5,15
HND-014003,2011,152200020,,,,1,3,4
HND-014005,2011,152200022,,,,4,3,7
HND-014008,2011,152200025,,,,4,2,6
HND-014015,2011,152200033,,,,5,3,8
HND-014016,2011,152200034,,,,3,7,10
HND-014018,2011,152200036,,,,6,2,8
HND-014019,2011,152200037,,,,3,5,8
HND-014021,2011,152200039,,,,3,7,10
HND-014022,2011,152200041,,,,9,3,12
HND-014024,2011,152200043,,,,2,1,3
HND-014027,2011,152200049,,,,0,2,2
HND-014032,2011,152200079,,,,5,3,8
HND-014034,2011,152200081,,,,1,0,1
HND-014035,2011,152200082,,,,8,4,12
HND-014036,2011,152200083,,,,1,2,3
HND-014051,2011,152200115,,,,1,1,2
HND-013987,2011,152200004,,,,7,7,14
HND-013989,2011,152200006,,,,4,2,6
HND-013990,2011,152200007,,,,4,6,10
HND-013995,2011,152200012,,,,7,4,11
HND-013996,2011,152200013,,,,5,5,10
HND-014001,2011,152200018,,,,4,12,16
HND-014002,2011,152200019,,,,5,7,12
HND-014003,2011,152200020,,,,4,7,11
HND-014004,2011,152200021,,,,2,5,7
HND-014007,2011,152200024,,,,0,2,2
HND-014008,2011,152200025,,,,4,0,4
HND-014016,2011,152200034,,,,5,9,14
HND-014017,2011,152200035,,,,3,0,3
HND-014019,2011,152200037,,,,2,4,6
HND-014020,2011,152200038,,,,1,3,4
HND-014022,2011,152200041,,,,3,5,8
HND-014026,2011,152200047,,,,2,8,10
HND-014028,2011,152200050,,,,4,5,9
HND-014032,2011,152200079,,,,6,6,12
HND-014034,2011,152200081,,,,2,2,4
HND-014036,2011,152200083,,,,1,1,2
,2011,152200084,,,,4,2,6
HND-014051,2011,152200115,,,,1,3,4
HND-013984,2011,152200001,,,,11,17,28
HND-013985,2011,152200002,,,,7,4,11
HND-013986,2011,152200003,,,,6,7,13
HND-013988,2011,152200005,,,,3,2,5
HND-013991,2011,152200008,,,,3,0,3
HND-013993,2011,152200010,,,,4,2,6
HND-013994,2011,152200011,,,,7,7,14
HND-013997,2011,152200014,,,,10,19,29
HND-013998,2011,152200015,,,,7,12,19
HND-013999,2011,152200016,,,,3,8,11
HND-014000,2011,152200017,,,,0,5,5
HND-014005,2011,152200022,,,,5,1,6
HND-014006,2011,152200023,,,,6,2,8
HND-014014,2011,152200032,,,,3,2,5
HND-014015,2011,152200033,,,,6,3,9
HND-014018,2011,152200036,,,,4,7,11
HND-014021,2011,152200039,,,,4,1,5
HND-014023,2011,152200042,,,,4,1,5
HND-014024,2011,152200043,,,,2,1,3
HND-014027,2011,152200049,,,,2,2,4
HND-014035,2011,152200082,,,,1,4,5
HND-014054,2011,152200123,,,,1,0,1
HND-013984,2011,152200001,,,,10,23,33
HND-013987,2011,152200004,,,,4,11,15
HND-013988,2011,152200005,,,,4,8,12
HND-013989,2011,152200006,,,,11,3,14
HND-013990,2011,152200007,,,,3,5,8
HND-013994,2011,152200011,,,,2,3,5
HND-013995,2011,152200012,,,,3,6,9
HND-013996,2011,152200013,,,,4,4,8
HND-013999,2011,152200016,,,,9,11,20
HND-014002,2011,152200019,,,,3,5,8
HND-014003,2011,152200020,,,,0,3,3
HND-014007,2011,152200024,,,,0,2,2
HND-014008,2011,152200025,,,,1,2,3
HND-014017,2011,152200035,,,,0,1,1
HND-014019,2011,152200037,,,,1,3,4
HND-014026,2011,152200047,,,,0,2,2
HND-014028,2011,152200050,,,,0,2,2
HND-014032,2011,152200079,,,,3,3,6
HND-014033,2011,152200080,,,,0,3,3
HND-014034,2011,152200081,,,,3,7,10
,2011,152200084,,,,1,2,3
HND-014051,2011,152200115,,,,5,1,6
HND-013985,2011,152200002,,,,7,8,15
HND-013986,2011,152200003,,,,8,9,17
HND-013991,2011,152200008,,,,1,1,2
HND-013992,2011,152200009,,,,0,2,2
HND-013993,2011,152200010,,,,3,3,6
HND-013997,2011,152200014,,,,8,9,17
HND-013998,2011,152200015,,,,1,7,8
HND-014000,2011,152200017,,,,3,1,4
HND-014001,2011,152200018,,,,3,9,12
HND-014004,2011,152200021,,,,0,3,3
HND-014005,2011,152200022,,,,4,3,7
HND-014006,2011,152200023,,,,4,2,6
HND-014015,2011,152200033,,,,1,4,5
HND-014016,2011,152200034,,,,3,0,3
HND-014018,2011,152200036,,,,2,6,8
HND-014021,2011,152200039,,,,1,3,4
HND-014022,2011,152200041,,,,6,7,13
HND-014023,2011,152200042,,,,3,4,7
HND-014024,2011,152200043,,,,1,1,2
HND-014027,2011,152200049,,,,4,3,7
HND-014035,2011,152200082,,,,5,4,9
HND-014036,2011,152200083,,,,0,1,1
HND-013984,2011,152200001,,,,20,15,35
HND-013985,2011,152200002,,,,6,1,7
HND-013988,2011,152200005,,,,5,2,7
HND-013991,2011,152200008,,,,0,3,3
HND-013993,2011,152200010,,,,2,2,4
HND-013994,2011,152200011,,,,1,3,4
HND-013997,2011,152200014,,,,6,9,15
HND-013999,2011,152200016,,,,8,2,10
HND-014000,2011,152200017,,,,4,2,6
HND-014002,2011,152200019,,,,7,4,11
HND-014005,2011,152200022,,,,5,5,10
HND-014008,2011,152200025,,,,2,3,5
HND-014014,2011,152200032,,,,1,0,1
HND-014015,2011,152200033,,,,2,6,8
HND-014020,2011,152200038,,,,1,3,4
HND-014021,2011,152200039,,,,2,3,5
HND-014023,2011,152200042,,,,1,0,1
HND-014024,2011,152200043,,,,0,2,2
HND-014028,2011,152200050,,,,2,3,5
HND-014035,2011,152200082,,,,3,1,4
HND-013986,2011,152200003,,,,11,19,30
HND-013987,2011,152200004,,,,8,9,17
HND-013989,2011,152200006,,,,2,3,5
HND-013990,2011,152200007,,,,5,5,10
HND-013995,2011,152200012,,,,7,1,8
HND-013996,2011,152200013,,,,4,4,8
HND-013998,2011,152200015,,,,2,5,7
HND-014001,2011,152200018,,,,7,7,14
HND-014003,2011,152200020,,,,3,1,4
HND-014004,2011,152200021,,,,3,1,4
HND-014007,2011,152200024,,,,1,3,4
HND-014016,2011,152200034,,,,1,0,1
HND-014017,2011,152200035,,,,2,2,4
HND-014018,2011,152200036,,,,1,5,6
HND-014019,2011,152200037,,,,1,4,5
HND-014022,2011,152200041,,,,4,6,10
HND-014026,2011,152200047,,,,4,1,5
HND-014027,2011,152200049,,,,2,1,3
HND-014032,2011,152200079,,,,2,5,7
HND-014033,2011,152200080,,,,2,0,2
HND-014034,2011,152200081,,,,1,3,4
HND-014036,2011,152200083,,,,0,3,3
,2011,152200084,,,,0,3,3
HND-014051,2011,152200115,,,,1,1,2
HND-013988,2011,152200005,,,,7,9,16
HND-013996,2011,152200013,,,,9,10,19
HND-013999,2011,152200016,,,,2,8,10
HND-013986,2011,152200003,,,,5,12,17
HND-013998,2011,152200015,,,,12,14,26
HND-014013,2011,152200031,,,,13,18,31
HND-013986,2011,152200003,,,,12,12,24
HND-013996,2011,152200013,,,,8,9,17
HND-013998,2011,152200015,,,,9,14,23
HND-013988,2011,152200005,,,,4,10,14
HND-013999,2011,152200016,,,,4,14,18
HND-014013,2011,152200031,,,,13,22,35
HND-013986,2011,152200003,,,,9,12,21
HND-013996,2011,152200013,,,,3,10,13
HND-014013,2011,152200031,,,,24,17,41
HND-013988,2011,152200005,,,,1,11,12
HND-013998,2011,152200015,,,,9,9,18
HND-013999,2011,152200016,,,,7,10,17
HND-014013,2011,152200031,,,,15,28,43
HND-014013,2011,152200031,,,,17,15,32
HND-014013,2011,152200031,,,,8,4,12
,2011,152300189,,,,1,9,10
,2011,152300195,,,,6,6,12
HND-014178,2011,152300201,,,,10,6,16
,2011,152300202,,,,4,6,10
HND-014186,2011,152300214,,,,9,6,15
,2011,152300216,,,,5,5,10
,2011,152300220,,,,5,5,10
,2011,152300229,,,,4,6,10
HND-014205,2011,152300245,,,,4,6,10
HND-014207,2011,152300248,,,,5,5,10
HND-014208,2011,152300250,,,,4,6,10
,2011,152300253,,,,7,1,8
,2011,152300256,,,,4,4,8
,2011,152300259,,,,4,4,8
,2011,152300261,,,,5,5,10
,2011,152300262,,,,7,5,12
,2011,152300265,,,,5,5,10
HND-014119,2011,152300068,,,,5,8,13
HND-014163,2011,152300158,,,,8,8,16
,2011,152300190,,,,8,4,12
,2011,152300191,,,,7,3,10
HND-014173,2011,152300192,,,,8,3,11
HND-014174,2011,152300193,,,,7,3,10
HND-014175,2011,152300196,,,,7,3,10
HND-014176,2011,152300197,,,,4,7,11
,2011,152300199,,,,10,2,12
,2011,152300212,,,,4,8,12
,2011,152300213,,,,6,4,10
HND-014187,2011,152300215,,,,7,6,13
,2011,152300217,,,,7,5,12
,2011,152300218,,,,6,6,12
,2011,152300221,,,,5,5,10
HND-014191,2011,152300225,,,,6,4,10
,2011,152300227,,,,4,6,10
,2011,152300228,,,,3,7,10
,2011,152300251,,,,5,5,10
,2011,152300258,,,,4,7,11
,2011,152300260,,,,4,7,11
,2011,152300263,,,,5,5,10
HND-014210,2011,152300264,,,,3,5,8
,2011,152300266,,,,6,4,10
,2011,152300074,,,,3,3,6
,2011,152300069,,,,1,0,1
HND-014176,2011,152300197,,,,3,3,6
HND-014206,2011,152300246,,,,5,2,7
HND-014117,2011,152300066,,,,8,8,16
,2011,152300074,,,,0,3,3
HND-014124,2011,152300076,,,,1,1,2
HND-014118,2011,152300067,,,,4,12,16
,2011,152300070,,,,10,6,16
,2011,152300074,,,,5,2,7
HND-014124,2011,152300076,,,,13,6,19
HND-014206,2011,152300246,,,,5,2,7
HND-014117,2011,152300066,,,,20,19,39
HND-014119,2011,152300068,,,,14,17,31
,2011,152300069,,,,2,10,12
HND-014123,2011,152300075,,,,13,8,21
,2011,152300168,,,,9,5,14
HND-014176,2011,152300197,,,,4,8,12
,2011,152300002,,,,1,0,1
HND-014059,2011,152300005,,,,3,2,5
HND-014061,2011,152300007,,,,15,19,34
HND-014062,2011,152300008,,,,1,1,2
,2011,152300010,,,,16,13,29
,2011,152300012,,,,5,0,5
HND-014068,2011,152300014,,,,3,2,5
HND-014069,2011,152300015,,,,9,3,12
HND-014071,2011,152300017,,,,1,3,4
HND-014072,2011,152300018,,,,15,10,25
HND-014076,2011,152300022,,,,22,20,42
HND-014079,2011,152300025,,,,2,7,9
HND-014082,2011,152300028,,,,8,1,9
HND-014084,2011,152300031,,,,7,3,10
HND-014087,2011,152300034,,,,17,26,43
HND-014088,2011,152300036,,,,7,4,11
HND-014089,2011,152300037,,,,10,10,20
HND-014092,2011,152300040,,,,4,1,5
HND-014093,2011,152300041,,,,6,3,9
HND-014096,2011,152300044,,,,1,1,2
HND-014098,2011,152300046,,,,6,4,10
HND-014099,2011,152300047,,,,13,16,29
HND-014101,2011,152300049,,,,42,33,75
HND-014103,2011,152300051,,,,10,3,13
HND-014104,2011,152300052,,,,14,9,23
HND-014105,2011,152300053,,,,8,4,12
,2011,152300056,,,,4,1,5
HND-014111,2011,152300060,,,,8,5,13
,2011,152300061,,,,8,3,11
,2011,152300063,,,,4,2,6
,2011,152300064,,,,5,6,11
HND-014126,2011,152300082,,,,6,4,10
HND-014128,2011,152300085,,,,8,7,15
,2011,152300091,,,,3,8,11
,2011,152300092,,,,4,2,6
HND-014135,2011,152300093,,,,1,3,4
,2011,152300099,,,,4,3,7
HND-014143,2011,152300102,,,,9,7,16
HND-014147,2011,152300107,,,,3,2,5
HND-014148,2011,152300108,,,,3,1,4
,2011,152300120,,,,3,1,4
HND-014150,2011,152300121,,,,10,11,21
,2011,152300122,,,,7,7,14
HND-014152,2011,152300136,,,,13,7,20
HND-014153,2011,152300137,,,,4,4,8
,2011,152300143,,,,22,5,27
,2011,152300148,,,,9,8,17
HND-014160,2011,152300149,,,,7,5,12
HND-014161,2011,152300151,,,,4,8,12
,2011,152300152,,,,5,8,13
,2011,152300153,,,,9,7,16
HND-014164,2011,152300162,,,,12,11,23
HND-014166,2011,152300164,,,,14,14,28
,2011,152300166,,,,5,5,10
HND-014169,2011,152300181,,,,2,3,5
HND-014170,2011,152300182,,,,4,6,10
HND-014172,2011,152300184,,,,22,18,40
HND-014179,2011,152300204,,,,3,0,3
HND-014181,2011,152300206,,,,0,8,8
,2011,152300209,,,,3,2,5
,2011,152300224,,,,5,6,11
,2011,152300230,,,,3,2,5
,2011,152300231,,,,3,0,3
HND-014194,2011,152300232,,,,11,18,29
,2011,152300233,,,,8,8,16
HND-014197,2011,152300236,,,,4,3,7
HND-014199,2011,152300239,,,,9,8,17
HND-014200,2011,152300240,,,,4,4,8
HND-014201,2011,152300241,,,,1,1,2
HND-014202,2011,152300242,,,,5,3,8
,2011,152300243,,,,2,0,2
HND-014056,2011,152300001,,,,5,6,11
HND-014057,2011,152300003,,,,9,2,11
HND-014058,2011,152300004,,,,16,10,26
,2011,152300006,,,,6,9,15
HND-014063,2011,152300009,,,,18,17,35
HND-014065,2011,152300011,,,,4,6,10
HND-014067,2011,152300013,,,,0,1,1
HND-014070,2011,152300016,,,,5,8,13
HND-014073,2011,152300019,,,,3,3,6
HND-014074,2011,152300020,,,,1,1,2
HND-014075,2011,152300021,,,,4,6,10
HND-014077,2011,152300023,,,,7,3,10
HND-014078,2011,152300024,,,,2,3,5
HND-014080,2011,152300026,,,,16,12,28
HND-014081,2011,152300027,,,,12,12,24
HND-014083,2011,152300029,,,,5,1,6
HND-014085,2011,152300032,,,,6,5,11
HND-014086,2011,152300033,,,,4,2,6
HND-014090,2011,152300038,,,,5,5,10
HND-014091,2011,152300039,,,,5,1,6
,2011,152300042,,,,1,2,3
HND-014095,2011,152300043,,,,4,1,5
HND-014097,2011,152300045,,,,6,14,20
,2011,152300048,,,,3,5,8
HND-014102,2011,152300050,,,,4,1,5
HND-014106,2011,152300054,,,,7,8,15
,2011,152300055,,,,8,3,11
,2011,152300057,,,,4,2,6
HND-014110,2011,152300058,,,,3,2,5
HND-014113,2011,152300062,,,,12,14,26
HND-014116,2011,152300065,,,,1,1,2
HND-014120,2011,152300071,,,,2,3,5
HND-014121,2011,152300072,,,,3,1,4
HND-014122,2011,152300073,,,,3,4,7
,2011,152300081,,,,8,4,12
HND-014127,2011,152300084,,,,3,5,8
,2011,152300086,,,,2,5,7
HND-014130,2011,152300087,,,,2,2,4
,2011,152300089,,,,2,2,4
HND-014132,2011,152300090,,,,4,7,11
,2011,152300095,,,,3,6,9
,2011,152300096,,,,4,4,8
HND-014139,2011,152300097,,,,7,4,11
HND-014140,2011,152300098,,,,5,5,10
,2011,152300100,,,,8,3,11
,2011,152300101,,,,8,9,17
HND-014146,2011,152300106,,,,4,5,9
HND-014149,2011,152300109,,,,4,7,11
HND-014154,2011,152300138,,,,6,7,13
,2011,152300139,,,,12,11,23
HND-014156,2011,152300141,,,,1,1,2
,2011,152300142,,,,4,2,6
,2011,152300163,,,,10,3,13
HND-014167,2011,152300165,,,,3,4,7
HND-014168,2011,152300171,,,,2,4,6
HND-014171,2011,152300183,,,,2,5,7
,2011,152300205,,,,8,2,10
,2011,152300207,,,,7,3,10
HND-014183,2011,152300208,,,,3,4,7
HND-014185,2011,152300210,,,,5,4,9
,2011,152300221,,,,4,9,13
HND-014189,2011,152300223,,,,7,2,9
,2011,152300234,,,,6,5,11
,2011,152300235,,,,9,4,13
,2011,152300238,,,,1,1,2
,2011,152300244,,,,4,0,4
,2011,152300002,,,,3,2,5
HND-014057,2011,152300003,,,,5,2,7
HND-014059,2011,152300005,,,,4,5,9
HND-014062,2011,152300008,,,,1,1,2
,2011,152300012,,,,2,1,3
HND-014069,2011,152300015,,,,8,12,20
HND-014072,2011,152300018,,,,12,10,22
HND-014076,2011,152300022,,,,21,20,41
HND-014077,2011,152300023,,,,6,6,12
HND-014082,2011,152300028,,,,5,3,8
HND-014083,2011,152300029,,,,4,3,7
HND-014084,2011,152300031,,,,9,7,16
HND-014086,2011,152300033,,,,11,2,13
HND-014087,2011,152300034,,,,18,16,34
HND-014088,2011,152300036,,,,3,2,5
HND-014091,2011,152300039,,,,4,4,8
HND-014093,2011,152300041,,,,2,5,7
,2011,152300042,,,,7,4,11
HND-014095,2011,152300043,,,,2,1,3
HND-014098,2011,152300046,,,,3,1,4
HND-014104,2011,152300052,,,,10,12,22
,2011,152300055,,,,0,1,1
HND-014110,2011,152300058,,,,4,5,9
HND-014111,2011,152300060,,,,7,3,10
,2011,152300061,,,,0,3,3
,2011,152300064,,,,5,3,8
HND-014116,2011,152300065,,,,2,2,4
HND-014120,2011,152300071,,,,2,5,7
HND-014122,2011,152300073,,,,2,4,6
,2011,152300081,,,,10,2,12
HND-014127,2011,152300084,,,,2,5,7
HND-014128,2011,152300085,,,,7,2,9
,2011,152300086,,,,7,2,9
HND-014130,2011,152300087,,,,4,5,9
,2011,152300092,,,,2,3,5
,2011,152300095,,,,5,4,9
HND-014140,2011,152300098,,,,2,1,3
,2011,152300100,,,,6,5,11
,2011,152300101,,,,5,4,9
HND-014143,2011,152300102,,,,5,5,10
HND-014146,2011,152300106,,,,9,1,10
HND-014147,2011,152300107,,,,7,7,14
HND-014149,2011,152300109,,,,7,2,9
HND-014150,2011,152300121,,,,7,7,14
HND-014153,2011,152300137,,,,3,2,5
HND-014154,2011,152300138,,,,5,7,12
HND-014156,2011,152300141,,,,1,2,3
,2011,152300143,,,,11,11,22
HND-014160,2011,152300149,,,,7,8,15
,2011,152300152,,,,1,0,1
,2011,152300163,,,,10,7,17
,2011,152300166,,,,3,3,6
HND-014168,2011,152300171,,,,2,3,5
HND-014170,2011,152300182,,,,3,3,6
,2011,152300205,,,,5,3,8
HND-014183,2011,152300208,,,,2,9,11
,2011,152300209,,,,2,1,3
HND-014189,2011,152300223,,,,1,0,1
,2011,152300224,,,,2,3,5
,2011,152300234,,,,1,1,2
HND-014197,2011,152300236,,,,3,1,4
HND-014199,2011,152300239,,,,5,3,8
HND-014200,2011,152300240,,,,2,2,4
,2011,152300243,,,,3,2,5
,2011,152300244,,,,2,0,2
HND-014056,2011,152300001,,,,5,8,13
HND-014058,2011,152300004,,,,15,5,20
,2011,152300006,,,,4,1,5
HND-014061,2011,152300007,,,,21,8,29
HND-014063,2011,152300009,,,,11,8,19
,2011,152300010,,,,10,15,25
HND-014065,2011,152300011,,,,5,8,13
HND-014067,2011,152300013,,,,7,1,8
HND-014068,2011,152300014,,,,1,2,3
HND-014070,2011,152300016,,,,4,5,9
HND-014071,2011,152300017,,,,2,0,2
HND-014073,2011,152300019,,,,3,1,4
HND-014074,2011,152300020,,,,5,1,6
HND-014075,2011,152300021,,,,7,3,10
HND-014078,2011,152300024,,,,2,4,6
HND-014079,2011,152300025,,,,3,1,4
HND-014080,2011,152300026,,,,8,5,13
HND-014081,2011,152300027,,,,9,10,19
HND-014085,2011,152300032,,,,6,10,16
HND-014089,2011,152300037,,,,9,6,15
HND-014090,2011,152300038,,,,5,3,8
HND-014092,2011,152300040,,,,4,6,10
HND-014096,2011,152300044,,,,2,1,3
HND-014097,2011,152300045,,,,9,2,11
HND-014099,2011,152300047,,,,6,5,11
,2011,152300048,,,,5,2,7
HND-014101,2011,152300049,,,,34,49,83
HND-014102,2011,152300050,,,,4,2,6
HND-014103,2011,152300051,,,,9,4,13
HND-014105,2011,152300053,,,,5,8,13
HND-014106,2011,152300054,,,,3,15,18
,2011,152300056,,,,0,3,3
,2011,152300057,,,,4,4,8
HND-014113,2011,152300062,,,,7,12,19
,2011,152300063,,,,4,11,15
HND-014121,2011,152300072,,,,8,5,13
HND-014126,2011,152300082,,,,4,4,8
,2011,152300089,,,,2,4,6
HND-014132,2011,152300090,,,,6,1,7
,2011,152300091,,,,7,1,8
HND-014135,2011,152300093,,,,0,3,3
,2011,152300094,,,,8,8,16
,2011,152300096,,,,4,3,7
HND-014139,2011,152300097,,,,2,7,9
,2011,152300099,,,,5,6,11
HND-014148,2011,152300108,,,,2,2,4
,2011,152300120,,,,1,4,5
,2011,152300122,,,,4,4,8
HND-014152,2011,152300136,,,,3,6,9
,2011,152300139,,,,3,7,10
,2011,152300142,,,,1,1,2
,2011,152300148,,,,6,7,13
HND-014161,2011,152300151,,,,2,3,5
,2011,152300153,,,,14,6,20
HND-014164,2011,152300162,,,,1,3,4
HND-014166,2011,152300164,,,,3,4,7
HND-014167,2011,152300165,,,,3,2,5
HND-014169,2011,152300181,,,,3,4,7
HND-014171,2011,152300183,,,,1,3,4
HND-014172,2011,152300184,,,,15,8,23
HND-014179,2011,152300204,,,,3,1,4
HND-014181,2011,152300206,,,,1,2,3
,2011,152300207,,,,4,3,7
HND-014185,2011,152300210,,,,5,3,8
,2011,152300221,,,,8,3,11
,2011,152300230,,,,3,0,3
,2011,152300231,,,,1,1,2
HND-014194,2011,152300232,,,,4,6,10
,2011,152300235,,,,5,5,10
,2011,152300238,,,,4,2,6
HND-014201,2011,152300241,,,,5,1,6
HND-014202,2011,152300242,,,,0,3,3
,2011,152300002,,,,1,2,3
HND-014059,2011,152300005,,,,5,2,7
HND-014061,2011,152300007,,,,11,15,26
HND-014062,2011,152300008,,,,2,1,3
,2011,152300010,,,,15,15,30
,2011,152300012,,,,2,1,3
HND-014069,2011,152300015,,,,12,9,21
HND-014071,2011,152300017,,,,0,5,5
HND-014072,2011,152300018,,,,12,6,18
HND-014076,2011,152300022,,,,16,18,34
HND-014079,2011,152300025,,,,3,3,6
HND-014082,2011,152300028,,,,2,6,8
HND-014084,2011,152300031,,,,5,2,7
HND-014085,2011,152300032,,,,7,6,13
HND-014086,2011,152300033,,,,8,4,12
HND-014091,2011,152300039,,,,3,6,9
,2011,152300042,,,,7,3,10
HND-014095,2011,152300043,,,,2,2,4
,2011,152300048,,,,1,0,1
HND-014102,2011,152300050,,,,3,4,7
HND-014104,2011,152300052,,,,9,9,18
HND-014106,2011,152300054,,,,11,5,16
,2011,152300055,,,,2,0,2
,2011,152300057,,,,1,1,2
HND-014110,2011,152300058,,,,8,3,11
HND-014111,2011,152300060,,,,3,7,10
,2011,152300061,,,,3,2,5
,2011,152300063,,,,8,0,8
,2011,152300064,,,,0,7,7
HND-014120,2011,152300071,,,,9,9,18
HND-014121,2011,152300072,,,,8,12,20
HND-014122,2011,152300073,,,,4,3,7
,2011,152300081,,,,4,2,6
HND-014127,2011,152300084,,,,7,3,10
,2011,152300086,,,,1,3,4
HND-014130,2011,152300087,,,,3,3,6
,2011,152300089,,,,2,3,5
HND-014132,2011,152300090,,,,4,2,6
,2011,152300092,,,,1,3,4
,2011,152300095,,,,3,4,7
HND-014139,2011,152300097,,,,7,4,11
HND-014140,2011,152300098,,,,4,5,9
,2011,152300100,,,,4,5,9
,2011,152300101,,,,8,11,19
HND-014146,2011,152300106,,,,3,4,7
HND-014149,2011,152300109,,,,8,2,10
HND-014152,2011,152300136,,,,9,4,13
HND-014153,2011,152300137,,,,3,1,4
,2011,152300143,,,,2,3,5
,2011,152300148,,,,2,5,7
HND-014160,2011,152300149,,,,5,11,16
HND-014161,2011,152300151,,,,5,5,10
,2011,152300152,,,,1,0,1
,2011,152300153,,,,4,2,6
,2011,152300163,,,,4,0,4
HND-014169,2011,152300181,,,,3,2,5
HND-014170,2011,152300182,,,,3,2,5
HND-014172,2011,152300184,,,,17,7,24
,2011,152300205,,,,0,2,2
,2011,152300207,,,,4,2,6
HND-014183,2011,152300208,,,,4,0,4
HND-014185,2011,152300210,,,,4,4,8
,2011,152300221,,,,3,4,7
HND-014189,2011,152300223,,,,2,0,2
,2011,152300230,,,,3,0,3
,2011,152300234,,,,2,2,4
HND-014197,2011,152300236,,,,2,6,8
HND-014199,2011,152300239,,,,2,1,3
HND-014200,2011,152300240,,,,0,1,1
HND-014201,2011,152300241,,,,4,1,5
,2011,152300243,,,,6,3,9
HND-014056,2011,152300001,,,,4,4,8
HND-014057,2011,152300003,,,,4,3,7
HND-014058,2011,152300004,,,,16,6,22
,2011,152300006,,,,3,1,4
HND-014063,2011,152300009,,,,13,17,30
HND-014065,2011,152300011,,,,7,8,15
HND-014067,2011,152300013,,,,4,1,5
HND-014068,2011,152300014,,,,1,1,2
HND-014070,2011,152300016,,,,4,3,7
HND-014073,2011,152300019,,,,3,2,5
HND-014074,2011,152300020,,,,4,6,10
HND-014075,2011,152300021,,,,5,3,8
HND-014077,2011,152300023,,,,5,10,15
HND-014078,2011,152300024,,,,2,3,5
HND-014080,2011,152300026,,,,7,10,17
HND-014081,2011,152300027,,,,11,9,20
HND-014083,2011,152300029,,,,7,2,9
HND-014087,2011,152300034,,,,19,16,35
HND-014088,2011,152300036,,,,3,2,5
HND-014089,2011,152300037,,,,3,5,8
HND-014090,2011,152300038,,,,2,6,8
HND-014092,2011,152300040,,,,5,1,6
HND-014093,2011,152300041,,,,5,3,8
HND-014096,2011,152300044,,,,1,2,3
HND-014097,2011,152300045,,,,9,11,20
HND-014098,2011,152300046,,,,3,3,6
HND-014099,2011,152300047,,,,5,11,16
HND-014101,2011,152300049,,,,53,54,107
HND-014103,2011,152300051,,,,2,2,4
HND-014105,2011,152300053,,,,6,3,9
,2011,152300056,,,,4,1,5
HND-014113,2011,152300062,,,,12,3,15
HND-014116,2011,152300065,,,,1,2,3
HND-014126,2011,152300082,,,,3,6,9
HND-014128,2011,152300085,,,,2,4,6
,2011,152300091,,,,5,3,8
HND-014135,2011,152300093,,,,2,4,6
,2011,152300096,,,,3,3,6
,2011,152300099,,,,7,1,8
HND-014143,2011,152300102,,,,1,3,4
HND-014147,2011,152300107,,,,10,4,14
HND-014148,2011,152300108,,,,2,0,2
,2011,152300120,,,,2,1,3
HND-014150,2011,152300121,,,,7,3,10
,2011,152300122,,,,5,3,8
HND-014154,2011,152300138,,,,3,1,4
,2011,152300139,,,,2,2,4
HND-014156,2011,152300141,,,,1,2,3
,2011,152300142,,,,5,1,6
HND-014164,2011,152300162,,,,9,6,15
HND-014166,2011,152300164,,,,3,2,5
HND-014167,2011,152300165,,,,3,4,7
,2011,152300166,,,,1,1,2
HND-014168,2011,152300171,,,,4,1,5
HND-014171,2011,152300183,,,,1,0,1
HND-014179,2011,152300204,,,,2,2,4
HND-014181,2011,152300206,,,,3,1,4
,2011,152300209,,,,1,1,2
,2011,152300224,,,,2,3,5
,2011,152300231,,,,0,2,2
HND-014194,2011,152300232,,,,2,0,2
,2011,152300235,,,,2,3,5
,2011,152300238,,,,0,1,1
HND-014202,2011,152300242,,,,4,2,6
,2011,152300244,,,,3,2,5
HND-014057,2011,152300003,,,,5,2,7
HND-014062,2011,152300008,,,,1,1,2
HND-014063,2011,152300009,,,,16,13,29
,2011,152300012,,,,0,2,2
HND-014067,2011,152300013,,,,6,1,7
HND-014072,2011,152300018,,,,8,10,18
HND-014073,2011,152300019,,,,1,3,4
HND-014075,2011,152300021,,,,6,6,12
HND-014076,2011,152300022,,,,23,14,37
HND-014077,2011,152300023,,,,7,7,14
HND-014080,2011,152300026,,,,8,14,22
HND-014083,2011,152300029,,,,5,3,8
HND-014084,2011,152300031,,,,8,7,15
HND-014086,2011,152300033,,,,8,5,13
HND-014087,2011,152300034,,,,15,16,31
HND-014088,2011,152300036,,,,1,5,6
HND-014089,2011,152300037,,,,9,8,17
HND-014091,2011,152300039,,,,4,3,7
HND-014092,2011,152300040,,,,7,4,11
HND-014093,2011,152300041,,,,6,2,8
HND-014095,2011,152300043,,,,0,2,2
HND-014096,2011,152300044,,,,3,3,6
HND-014098,2011,152300046,,,,3,1,4
HND-014104,2011,152300052,,,,15,15,30
HND-014105,2011,152300053,,,,6,11,17
HND-014110,2011,152300058,,,,1,5,6
HND-014111,2011,152300060,,,,4,2,6
,2011,152300064,,,,5,2,7
HND-014116,2011,152300065,,,,2,0,2
HND-014120,2011,152300071,,,,4,2,6
HND-014127,2011,152300084,,,,3,6,9
HND-014128,2011,152300085,,,,3,5,8
HND-014130,2011,152300087,,,,1,2,3
,2011,152300092,,,,0,2,2
HND-014135,2011,152300093,,,,17,16,33
,2011,152300095,,,,3,5,8
HND-014140,2011,152300098,,,,3,6,9
,2011,152300099,,,,4,5,9
,2011,152300100,,,,2,4,6
HND-014143,2011,152300102,,,,1,8,9
HND-014146,2011,152300106,,,,3,4,7
HND-014147,2011,152300107,,,,5,0,5
,2011,152300120,,,,2,3,5
HND-014150,2011,152300121,,,,2,1,3
HND-014153,2011,152300137,,,,0,1,1
HND-014154,2011,152300138,,,,3,2,5
HND-014156,2011,152300141,,,,2,2,4
,2011,152300143,,,,6,7,13
HND-014160,2011,152300149,,,,8,5,13
,2011,152300163,,,,3,2,5
HND-014166,2011,152300164,,,,3,3,6
,2011,152300166,,,,4,3,7
HND-014168,2011,152300171,,,,3,6,9
HND-014170,2011,152300182,,,,3,5,8
HND-014183,2011,152300208,,,,4,2,6
,2011,152300209,,,,2,1,3
,2011,152300224,,,,3,3,6
,2011,152300234,,,,2,1,3
,2011,152300235,,,,1,2,3
HND-014197,2011,152300236,,,,0,1,1
,2011,152300244,,,,3,3,6
HND-014056,2011,152300001,,,,2,3,5
HND-014058,2011,152300004,,,,4,4,8
HND-014059,2011,152300005,,,,2,4,6
,2011,152300006,,,,3,1,4
HND-014061,2011,152300007,,,,14,15,29
,2011,152300010,,,,11,8,19
HND-014065,2011,152300011,,,,5,11,16
HND-014068,2011,152300014,,,,1,1,2
HND-014069,2011,152300015,,,,11,6,17
HND-014070,2011,152300016,,,,3,5,8
HND-014071,2011,152300017,,,,1,1,2
HND-014074,2011,152300020,,,,1,2,3
HND-014078,2011,152300024,,,,3,2,5
HND-014079,2011,152300025,,,,6,8,14
HND-014081,2011,152300027,,,,12,11,23
HND-014082,2011,152300028,,,,3,3,6
HND-014085,2011,152300032,,,,5,3,8
HND-014090,2011,152300038,,,,2,4,6
,2011,152300042,,,,1,3,4
HND-014097,2011,152300045,,,,9,9,18
HND-014099,2011,152300047,,,,3,2,5
,2011,152300048,,,,0,4,4
HND-014101,2011,152300049,,,,57,55,112
HND-014102,2011,152300050,,,,2,7,9
HND-014103,2011,152300051,,,,6,2,8
HND-014106,2011,152300054,,,,6,3,9
,2011,152300056,,,,1,3,4
,2011,152300057,,,,2,2,4
,2011,152300061,,,,1,5,6
HND-014113,2011,152300062,,,,7,6,13
,2011,152300063,,,,4,6,10
HND-014121,2011,152300072,,,,5,3,8
HND-014122,2011,152300073,,,,2,6,8
,2011,152300081,,,,3,2,5
HND-014126,2011,152300082,,,,3,2,5
,2011,152300086,,,,3,4,7
,2011,152300089,,,,1,1,2
HND-014132,2011,152300090,,,,6,5,11
,2011,152300091,,,,6,3,9
,2011,152300096,,,,3,2,5
HND-014139,2011,152300097,,,,6,2,8
,2011,152300101,,,,2,7,9
HND-014148,2011,152300108,,,,3,2,5
HND-014149,2011,152300109,,,,3,5,8
,2011,152300122,,,,7,6,13
HND-014152,2011,152300136,,,,7,3,10
,2011,152300139,,,,1,4,5
,2011,152300142,,,,3,0,3
,2011,152300148,,,,4,4,8
HND-014161,2011,152300151,,,,4,4,8
,2011,152300153,,,,2,6,8
HND-014164,2011,152300162,,,,1,2,3
HND-014167,2011,152300165,,,,1,3,4
HND-014169,2011,152300181,,,,2,2,4
HND-014171,2011,152300183,,,,2,3,5
HND-014179,2011,152300204,,,,2,3,5
,2011,152300205,,,,1,4,5
HND-014181,2011,152300206,,,,2,0,2
,2011,152300207,,,,2,0,2
HND-014185,2011,152300210,,,,5,5,10
,2011,152300221,,,,6,2,8
HND-014189,2011,152300223,,,,1,0,1
,2011,152300230,,,,3,3,6
,2011,152300231,,,,1,0,1
HND-014194,2011,152300232,,,,2,5,7
,2011,152300238,,,,2,3,5
HND-014199,2011,152300239,,,,1,2,3
HND-014200,2011,152300240,,,,1,1,2
HND-014201,2011,152300241,,,,3,1,4
HND-014202,2011,152300242,,,,1,2,3
,2011,152300243,,,,2,4,6
HND-014056,2011,152300001,,,,4,2,6
,2011,152300002,,,,0,3,3
HND-014057,2011,152300003,,,,4,1,5
HND-014063,2011,152300009,,,,8,10,18
HND-014065,2011,152300011,,,,4,6,10
,2011,152300012,,,,1,0,1
HND-014067,2011,152300013,,,,4,1,5
HND-014073,2011,152300019,,,,3,1,4
HND-014074,2011,152300020,,,,1,5,6
HND-014075,2011,152300021,,,,7,6,13
HND-014077,2011,152300023,,,,7,10,17
HND-014078,2011,152300024,,,,0,3,3
HND-014080,2011,152300026,,,,7,7,14
HND-014083,2011,152300029,,,,3,5,8
HND-014084,2011,152300031,,,,9,9,18
HND-014087,2011,152300034,,,,20,12,32
HND-014088,2011,152300036,,,,4,4,8
HND-014089,2011,152300037,,,,9,0,9
HND-014092,2011,152300040,,,,7,4,11
HND-014093,2011,152300041,,,,1,5,6
HND-014095,2011,152300043,,,,1,0,1
HND-014096,2011,152300044,,,,3,2,5
HND-014098,2011,152300046,,,,1,2,3
HND-014099,2011,152300047,,,,3,8,11
HND-014101,2011,152300049,,,,44,53,97
HND-014103,2011,152300051,,,,1,2,3
HND-014104,2011,152300052,,,,11,5,16
HND-014105,2011,152300053,,,,5,5,10
HND-014111,2011,152300060,,,,3,8,11
HND-014113,2011,152300062,,,,3,7,10
HND-014116,2011,152300065,,,,1,1,2
HND-014120,2011,152300071,,,,3,1,4
HND-014126,2011,152300082,,,,5,5,10
HND-014128,2011,152300085,,,,3,4,7
HND-014130,2011,152300087,,,,3,1,4
,2011,152300092,,,,3,3,6
HND-014135,2011,152300093,,,,1,0,1
HND-014140,2011,152300098,,,,4,2,6
,2011,152300099,,,,4,4,8
,2011,152300100,,,,3,2,5
HND-014143,2011,152300102,,,,2,3,5
HND-014147,2011,152300107,,,,5,5,10
HND-014148,2011,152300108,,,,1,2,3
,2011,152300120,,,,0,1,1
HND-014150,2011,152300121,,,,2,1,3
,2011,152300122,,,,4,6,10
HND-014154,2011,152300138,,,,3,0,3
HND-014156,2011,152300141,,,,2,0,2
,2011,152300142,,,,0,1,1
,2011,152300143,,,,6,4,10
HND-014160,2011,152300149,,,,2,4,6
,2011,152300152,,,,1,1,2
HND-014164,2011,152300162,,,,2,5,7
,2011,152300163,,,,2,1,3
HND-014166,2011,152300164,,,,1,1,2
,2011,152300166,,,,1,0,1
HND-014168,2011,152300171,,,,7,2,9
HND-014171,2011,152300183,,,,0,3,3
HND-014181,2011,152300206,,,,2,0,2
,2011,152300209,,,,2,0,2
,2011,152300234,,,,1,3,4
,2011,152300235,,,,2,3,5
HND-014197,2011,152300236,,,,1,0,1
,2011,152300244,,,,2,1,3
HND-014058,2011,152300004,,,,9,8,17
HND-014059,2011,152300005,,,,1,1,2
,2011,152300006,,,,2,5,7
HND-014061,2011,152300007,,,,10,10,20
HND-014062,2011,152300008,,,,1,1,2
,2011,152300010,,,,5,11,16
HND-014068,2011,152300014,,,,1,0,1
HND-014069,2011,152300015,,,,6,11,17
HND-014070,2011,152300016,,,,4,4,8
HND-014071,2011,152300017,,,,2,4,6
HND-014072,2011,152300018,,,,12,5,17
HND-014076,2011,152300022,,,,15,16,31
HND-014079,2011,152300025,,,,6,4,10
HND-014081,2011,152300027,,,,13,9,22
HND-014082,2011,152300028,,,,2,2,4
HND-014085,2011,152300032,,,,11,6,17
HND-014086,2011,152300033,,,,8,7,15
HND-014090,2011,152300038,,,,3,3,6
HND-014091,2011,152300039,,,,4,5,9
,2011,152300042,,,,4,1,5
HND-014097,2011,152300045,,,,8,5,13
,2011,152300048,,,,6,0,6
HND-014102,2011,152300050,,,,4,0,4
HND-014106,2011,152300054,,,,5,6,11
,2011,152300055,,,,0,1,1
,2011,152300056,,,,2,2,4
HND-014110,2011,152300058,,,,2,1,3
,2011,152300061,,,,2,3,5
,2011,152300063,,,,2,6,8
,2011,152300064,,,,4,7,11
HND-014121,2011,152300072,,,,2,5,7
HND-014122,2011,152300073,,,,6,5,11
,2011,152300081,,,,1,3,4
HND-014127,2011,152300084,,,,3,2,5
,2011,152300086,,,,4,7,11
,2011,152300089,,,,3,0,3
HND-014132,2011,152300090,,,,5,4,9
,2011,152300091,,,,1,2,3
,2011,152300095,,,,4,4,8
,2011,152300096,,,,3,4,7
HND-014139,2011,152300097,,,,4,5,9
,2011,152300101,,,,5,5,10
HND-014146,2011,152300106,,,,4,0,4
HND-014149,2011,152300109,,,,2,2,4
HND-014152,2011,152300136,,,,7,5,12
,2011,152300139,,,,1,1,2
,2011,152300148,,,,4,4,8
HND-014161,2011,152300151,,,,5,3,8
,2011,152300153,,,,1,2,3
HND-014167,2011,152300165,,,,2,6,8
HND-014170,2011,152300182,,,,6,1,7
HND-014172,2011,152300184,,,,17,6,23
HND-014179,2011,152300204,,,,1,0,1
,2011,152300205,,,,4,5,9
,2011,152300207,,,,1,1,2
HND-014183,2011,152300208,,,,0,1,1
HND-014185,2011,152300210,,,,2,5,7
,2011,152300221,,,,1,5,6
HND-014189,2011,152300223,,,,2,4,6
,2011,152300230,,,,2,2,4
,2011,152300231,,,,2,2,4
HND-014194,2011,152300232,,,,3,2,5
HND-014199,2011,152300239,,,,7,3,10
HND-014200,2011,152300240,,,,3,0,3
HND-014201,2011,152300241,,,,0,2,2
HND-014202,2011,152300242,,,,2,1,3
HND-014056,2011,152300001,,,,8,3,11
HND-014058,2011,152300004,,,,4,4,8
,2011,152300006,,,,4,1,5
HND-014061,2011,152300007,,,,12,14,26
HND-014063,2011,152300009,,,,3,7,10
,2011,152300010,,,,2,4,6
HND-014065,2011,152300011,,,,4,3,7
HND-014067,2011,152300013,,,,1,1,2
HND-014068,2011,152300014,,,,3,1,4
HND-014070,2011,152300016,,,,3,3,6
HND-014071,2011,152300017,,,,2,3,5
HND-014073,2011,152300019,,,,0,2,2
HND-014074,2011,152300020,,,,2,2,4
HND-014075,2011,152300021,,,,2,4,6
HND-014078,2011,152300024,,,,4,3,7
HND-014079,2011,152300025,,,,2,1,3
HND-014080,2011,152300026,,,,11,3,14
HND-014081,2011,152300027,,,,7,9,16
HND-014085,2011,152300032,,,,3,3,6
HND-014089,2011,152300037,,,,4,5,9
HND-014090,2011,152300038,,,,1,4,5
HND-014092,2011,152300040,,,,6,4,10
HND-014096,2011,152300044,,,,3,1,4
HND-014097,2011,152300045,,,,5,7,12
HND-014099,2011,152300047,,,,5,5,10
,2011,152300048,,,,5,1,6
HND-014101,2011,152300049,,,,31,36,67
HND-014102,2011,152300050,,,,4,4,8
HND-014103,2011,152300051,,,,4,4,8
HND-014105,2011,152300053,,,,4,9,13
HND-014106,2011,152300054,,,,5,4,9
,2011,152300056,,,,4,0,4
,2011,152300057,,,,3,1,4
HND-014113,2011,152300062,,,,5,8,13
,2011,152300063,,,,6,1,7
HND-014121,2011,152300072,,,,4,3,7
HND-014126,2011,152300082,,,,0,1,1
HND-014132,2011,152300090,,,,4,2,6
,2011,152300091,,,,2,4,6
HND-014135,2011,152300093,,,,1,4,5
HND-014139,2011,152300097,,,,7,5,12
,2011,152300099,,,,2,1,3
HND-014148,2011,152300108,,,,2,1,3
,2011,152300122,,,,8,7,15
HND-014152,2011,152300136,,,,2,2,4
,2011,152300139,,,,3,3,6
,2011,152300142,,,,1,0,1
,2011,152300148,,,,5,3,8
HND-014161,2011,152300151,,,,3,1,4
,2011,152300153,,,,4,2,6
HND-014164,2011,152300162,,,,7,2,9
HND-014167,2011,152300165,,,,1,3,4
HND-014169,2011,152300181,,,,4,0,4
HND-014171,2011,152300183,,,,3,1,4
HND-014172,2011,152300184,,,,2,10,12
HND-014179,2011,152300204,,,,3,1,4
HND-014181,2011,152300206,,,,3,3,6
HND-014185,2011,152300210,,,,6,2,8
,2011,152300221,,,,1,3,4
,2011,152300230,,,,1,0,1
,2011,152300231,,,,1,0,1
HND-014194,2011,152300232,,,,2,0,2
,2011,152300235,,,,2,0,2
,2011,152300238,,,,1,4,5
HND-014201,2011,152300241,,,,1,0,1
HND-014202,2011,152300242,,,,0,3,3
,2011,152300002,,,,2,1,3
HND-014057,2011,152300003,,,,2,2,4
HND-014059,2011,152300005,,,,7,3,10
HND-014062,2011,152300008,,,,2,1,3
,2011,152300012,,,,4,1,5
HND-014069,2011,152300015,,,,8,13,21
HND-014072,2011,152300018,,,,9,10,19
HND-014076,2011,152300022,,,,13,16,29
HND-014077,2011,152300023,,,,4,7,11
HND-014082,2011,152300028,,,,4,2,6
HND-014083,2011,152300029,,,,5,2,7
HND-014084,2011,152300031,,,,5,4,9
HND-014086,2011,152300033,,,,2,4,6
HND-014087,2011,152300034,,,,13,10,23
HND-014088,2011,152300036,,,,1,3,4
HND-014091,2011,152300039,,,,8,7,15
HND-014093,2011,152300041,,,,3,9,12
,2011,152300042,,,,3,6,9
HND-014095,2011,152300043,,,,3,1,4
HND-014098,2011,152300046,,,,6,6,12
HND-014104,2011,152300052,,,,13,14,27
,2011,152300055,,,,0,3,3
HND-014110,2011,152300058,,,,2,4,6
HND-014111,2011,152300060,,,,3,9,12
,2011,152300061,,,,4,2,6
,2011,152300064,,,,2,3,5
HND-014116,2011,152300065,,,,1,1,2
HND-014120,2011,152300071,,,,2,2,4
HND-014122,2011,152300073,,,,3,5,8
,2011,152300081,,,,1,3,4
HND-014127,2011,152300084,,,,4,4,8
HND-014128,2011,152300085,,,,3,1,4
,2011,152300086,,,,4,5,9
HND-014130,2011,152300087,,,,2,2,4
,2011,152300092,,,,2,2,4
,2011,152300095,,,,2,1,3
HND-014140,2011,152300098,,,,2,1,3
,2011,152300100,,,,2,2,4
,2011,152300101,,,,4,8,12
HND-014143,2011,152300102,,,,1,4,5
HND-014146,2011,152300106,,,,2,6,8
HND-014147,2011,152300107,,,,6,7,13
HND-014149,2011,152300109,,,,2,9,11
HND-014150,2011,152300121,,,,4,2,6
HND-014153,2011,152300137,,,,1,3,4
HND-014154,2011,152300138,,,,3,4,7
HND-014156,2011,152300141,,,,1,2,3
,2011,152300143,,,,2,2,4
HND-014160,2011,152300149,,,,5,3,8
,2011,152300152,,,,1,0,1
,2011,152300163,,,,1,3,4
HND-014168,2011,152300171,,,,3,1,4
HND-014170,2011,152300182,,,,1,5,6
,2011,152300205,,,,2,1,3
HND-014183,2011,152300208,,,,1,2,3
HND-014189,2011,152300223,,,,1,1,2
,2011,152300224,,,,1,0,1
,2011,152300234,,,,0,1,1
HND-014197,2011,152300236,,,,1,2,3
HND-014199,2011,152300239,,,,3,6,9
,2011,152300244,,,,4,4,8
HND-014063,2011,152300009,,,,7,9,16
HND-014069,2011,152300015,,,,8,18,26
HND-014084,2011,152300031,,,,15,12,27
HND-014104,2011,152300052,,,,28,27,55
HND-014105,2011,152300053,,,,12,17,29
HND-014144,2011,152300103,,,,81,112,193
HND-014145,2011,152300104,,,,47,36,83
,2011,152300249,,,,3,1,4
,2011,152300057,,,,0,3,3
HND-014111,2011,152300060,,,,7,9,16
HND-014084,2011,152300031,,,,15,16,31
HND-014104,2011,152300052,,,,23,16,39
HND-014111,2011,152300060,,,,5,8,13
HND-014144,2011,152300103,,,,43,91,134
HND-014145,2011,152300104,,,,34,36,70
,2011,152300249,,,,4,3,7
HND-014063,2011,152300009,,,,0,2,2
HND-014069,2011,152300015,,,,14,14,28
HND-014105,2011,152300053,,,,10,11,21
,2011,152300057,,,,0,4,4
HND-014063,2011,152300009,,,,7,9,16
HND-014069,2011,152300015,,,,8,14,22
HND-014084,2011,152300031,,,,10,16,26
HND-014104,2011,152300052,,,,18,15,33
HND-014105,2011,152300053,,,,13,8,21
HND-014111,2011,152300060,,,,5,10,15
,2011,152300249,,,,4,6,10
,2011,152300057,,,,2,1,3
HND-014144,2011,152300103,,,,45,77,122
HND-014145,2011,152300104,,,,37,40,77
HND-014069,2011,152300015,,,,6,7,13
HND-014144,2011,152300103,,,,81,112,193
HND-014145,2011,152300104,,,,25,34,59
,2011,152300249,,,,15,11,26
HND-014144,2011,152300103,,,,64,86,150
HND-014145,2011,152300104,,,,19,24,43
HND-014069,2011,152300015,,,,8,6,14
,2011,152300249,,,,8,13,21
HND-014144,2011,152300103,,,,33,46,79
HND-014145,2011,152300104,,,,24,16,40
HND-014267,2011,160100072,,,,5,3,8
,2011,160100134,,,,7,8,15
,2011,160100147,,,,7,3,10
HND-014301,2011,160100148,,,,6,6,12
HND-014308,2011,160100159,,,,6,8,14
,2011,160100160,,,,5,4,9
HND-014311,2011,160100164,,,,4,5,9
HND-014312,2011,160100165,,,,3,8,11
,2011,160100070,,,,7,7,14
,2011,160100137,,,,3,5,8
,2011,160100141,,,,8,4,12
HND-014302,2011,160100149,,,,7,6,13
HND-014307,2011,160100157,,,,6,6,12
,2011,160100158,,,,3,3,6
HND-014309,2011,160100161,,,,3,2,5
HND-014310,2011,160100162,,,,6,3,9
HND-014251,2011,160100046,,,,2,10,12
HND-014254,2011,160100049,,,,14,7,21
HND-014257,2011,160100052,,,,1,1,2
HND-014261,2011,160100058,,,,1,3,4
HND-014275,2011,160100084,,,,10,10,20
,2011,160100085,,,,13,13,26
HND-014285,2011,160100096,,,,5,3,8
HND-014289,2011,160100108,,,,3,2,5
HND-014290,2011,160100109,,,,1,0,1
HND-014293,2011,160100130,,,,3,3,6
,2011,160100154,,,,2,1,3
HND-014306,2011,160100156,,,,0,1,1
HND-014244,2011,160100036,,,,2,0,2
HND-014250,2011,160100044,,,,11,30,41
HND-014253,2011,160100048,,,,4,1,5
HND-014255,2011,160100050,,,,4,5,9
HND-014258,2011,160100053,,,,4,2,6
HND-014264,2011,160100067,,,,0,1,1
,2011,160100071,,,,2,1,3
HND-014268,2011,160100076,,,,1,1,2
HND-014269,2011,160100077,,,,6,5,11
,2011,160100078,,,,2,2,4
HND-014272,2011,160100081,,,,5,3,8
HND-014273,2011,160100082,,,,1,3,4
HND-014274,2011,160100083,,,,3,3,6
HND-014277,2011,160100086,,,,18,10,28
,2011,160100107,,,,1,2,3
HND-014295,2011,160100136,,,,0,1,1
HND-014296,2011,160100138,,,,1,2,3
HND-014303,2011,160100151,,,,2,4,6
HND-014304,2011,160100152,,,,4,5,9
,2011,160100163,,,,1,4,5
,2011,160100011,,,,1,2,3
HND-014250,2011,160100044,,,,25,15,40
HND-014251,2011,160100046,,,,8,10,18
HND-014252,2011,160100047,,,,1,7,8
HND-014254,2011,160100049,,,,9,12,21
HND-014257,2011,160100052,,,,5,4,9
HND-014258,2011,160100053,,,,3,3,6
HND-014261,2011,160100058,,,,7,0,7
HND-014269,2011,160100077,,,,11,4,15
HND-014273,2011,160100082,,,,3,10,13
HND-014274,2011,160100083,,,,3,7,10
HND-014275,2011,160100084,,,,21,25,46
HND-014285,2011,160100096,,,,6,7,13
,2011,160100107,,,,7,5,12
HND-014289,2011,160100108,,,,4,1,5
HND-014294,2011,160100132,,,,1,5,6
HND-014295,2011,160100136,,,,3,2,5
HND-014303,2011,160100151,,,,4,2,6
,2011,160100154,,,,1,2,3
,2011,160100163,,,,3,0,3
HND-014244,2011,160100036,,,,3,4,7
HND-014253,2011,160100048,,,,6,15,21
HND-014255,2011,160100050,,,,6,4,10
HND-014256,2011,160100051,,,,10,9,19
HND-014264,2011,160100067,,,,4,2,6
HND-014265,2011,160100068,,,,7,3,10
,2011,160100071,,,,3,2,5
HND-014268,2011,160100076,,,,5,2,7
,2011,160100078,,,,2,5,7
HND-014271,2011,160100080,,,,2,13,15
HND-014272,2011,160100081,,,,11,5,16
,2011,160100085,,,,25,18,43
HND-014277,2011,160100086,,,,29,38,67
,2011,160100099,,,,2,1,3
HND-014290,2011,160100109,,,,3,2,5
HND-014293,2011,160100130,,,,6,4,10
HND-014296,2011,160100138,,,,3,2,5
HND-014304,2011,160100152,,,,10,9,19
HND-014306,2011,160100156,,,,6,1,7
,2011,160100011,,,,5,1,6
HND-014244,2011,160100036,,,,3,6,9
HND-014250,2011,160100044,,,,33,28,61
HND-014253,2011,160100048,,,,8,6,14
HND-014255,2011,160100050,,,,6,10,16
HND-014258,2011,160100053,,,,6,4,10
,2011,160100071,,,,6,6,12
HND-014268,2011,160100076,,,,8,5,13
HND-014269,2011,160100077,,,,6,12,18
,2011,160100078,,,,3,2,5
HND-014271,2011,160100080,,,,14,12,26
HND-014272,2011,160100081,,,,15,7,22
HND-014273,2011,160100082,,,,8,9,17
HND-014274,2011,160100083,,,,3,4,7
HND-014277,2011,160100086,,,,32,32,64
,2011,160100088,,,,9,15,24
,2011,160100099,,,,8,3,11
HND-014290,2011,160100109,,,,2,5,7
HND-014293,2011,160100130,,,,4,8,12
HND-014304,2011,160100152,,,,7,5,12
,2011,160100154,,,,5,9,14
HND-014306,2011,160100156,,,,5,4,9
HND-014251,2011,160100046,,,,14,17,31
HND-014252,2011,160100047,,,,5,11,16
HND-014254,2011,160100049,,,,13,11,24
HND-014256,2011,160100051,,,,5,4,9
HND-014257,2011,160100052,,,,3,6,9
HND-014261,2011,160100058,,,,3,6,9
HND-014262,2011,160100060,,,,10,11,21
HND-014264,2011,160100067,,,,7,6,13
HND-014265,2011,160100068,,,,11,9,20
HND-014270,2011,160100079,,,,5,4,9
HND-014275,2011,160100084,,,,32,19,51
,2011,160100085,,,,45,23,68
HND-014285,2011,160100096,,,,6,7,13
,2011,160100107,,,,8,7,15
HND-014289,2011,160100108,,,,6,2,8
HND-014294,2011,160100132,,,,6,1,7
HND-014295,2011,160100136,,,,5,2,7
HND-014296,2011,160100138,,,,6,4,10
HND-014303,2011,160100151,,,,3,1,4
,2011,160100163,,,,8,3,11
HND-014213,2011,160100003,,,,2,5,7
HND-014214,2011,160100004,,,,12,17,29
HND-014216,2011,160100006,,,,9,11,20
HND-014217,2011,160100007,,,,11,12,23
HND-014218,2011,160100008,,,,5,3,8
,2011,160100011,,,,8,13,21
HND-014221,2011,160100012,,,,10,15,25
HND-014222,2011,160100013,,,,31,34,65
HND-014223,2011,160100014,,,,8,3,11
HND-014224,2011,160100015,,,,4,1,5
HND-014229,2011,160100020,,,,5,6,11
HND-014231,2011,160100022,,,,4,2,6
HND-014233,2011,160100024,,,,13,9,22
HND-014234,2011,160100025,,,,7,9,16
HND-014237,2011,160100028,,,,4,1,5
HND-014239,2011,160100031,,,,4,8,12
HND-014241,2011,160100033,,,,8,6,14
HND-014242,2011,160100034,,,,8,3,11
HND-014245,2011,160100037,,,,1,0,1
HND-014246,2011,160100038,,,,7,5,12
HND-014247,2011,160100039,,,,13,8,21
HND-014253,2011,160100048,,,,10,12,22
HND-014279,2011,160100089,,,,0,1,1
HND-014281,2011,160100091,,,,3,3,6
HND-014286,2011,160100102,,,,4,6,10
HND-014287,2011,160100104,,,,1,0,1
,2011,160100107,,,,14,13,27
HND-014291,2011,160100110,,,,2,1,3
HND-014299,2011,160100145,,,,4,0,4
HND-014305,2011,160100153,,,,12,10,22
HND-014211,2011,160100001,,,,13,14,27
HND-014212,2011,160100002,,,,41,39,80
HND-014215,2011,160100005,,,,8,12,20
HND-014219,2011,160100009,,,,3,5,8
HND-014220,2011,160100010,,,,53,53,106
HND-014225,2011,160100016,,,,12,5,17
HND-014226,2011,160100017,,,,3,7,10
HND-014227,2011,160100018,,,,43,35,78
HND-014228,2011,160100019,,,,14,16,30
HND-014230,2011,160100021,,,,9,3,12
HND-014232,2011,160100023,,,,14,14,28
HND-014235,2011,160100026,,,,9,6,15
HND-014236,2011,160100027,,,,11,16,27
HND-014238,2011,160100029,,,,2,4,6
HND-014240,2011,160100032,,,,4,1,5
HND-014243,2011,160100035,,,,9,10,19
HND-014244,2011,160100036,,,,2,3,5
HND-014248,2011,160100040,,,,5,0,5
HND-014249,2011,160100041,,,,5,6,11
HND-014278,2011,160100087,,,,4,2,6
,2011,160100088,,,,14,12,26
HND-014282,2011,160100092,,,,2,3,5
HND-014284,2011,160100095,,,,3,0,3
HND-014288,2011,160100105,,,,4,7,11
HND-014292,2011,160100127,,,,4,6,10
HND-014298,2011,160100144,,,,6,4,10
HND-014300,2011,160100146,,,,3,2,5
,2011,160100154,,,,9,6,15
HND-014211,2011,160100001,,,,13,13,26
HND-014214,2011,160100004,,,,14,14,28
HND-014215,2011,160100005,,,,3,10,13
HND-014216,2011,160100006,,,,13,8,21
HND-014218,2011,160100008,,,,3,5,8
HND-014220,2011,160100010,,,,52,45,97
,2011,160100011,,,,9,7,16
HND-014221,2011,160100012,,,,6,15,21
HND-014222,2011,160100013,,,,39,41,80
HND-014224,2011,160100015,,,,1,4,5
HND-014227,2011,160100018,,,,47,33,80
HND-014228,2011,160100019,,,,11,8,19
HND-014231,2011,160100022,,,,5,2,7
HND-014235,2011,160100026,,,,9,14,23
HND-014238,2011,160100029,,,,2,2,4
HND-014241,2011,160100033,,,,6,4,10
HND-014244,2011,160100036,,,,5,1,6
HND-014245,2011,160100037,,,,2,2,4
HND-014247,2011,160100039,,,,10,4,14
HND-014248,2011,160100040,,,,1,1,2
HND-014253,2011,160100048,,,,11,12,23
HND-014278,2011,160100087,,,,3,5,8
,2011,160100088,,,,13,17,30
HND-014283,2011,160100093,,,,1,1,2
HND-014286,2011,160100102,,,,2,5,7
HND-014291,2011,160100110,,,,3,2,5
HND-014292,2011,160100127,,,,4,2,6
HND-014305,2011,160100153,,,,12,7,19
,2011,160100154,,,,6,9,15
HND-014212,2011,160100002,,,,47,42,89
HND-014213,2011,160100003,,,,6,0,6
HND-014217,2011,160100007,,,,19,14,33
HND-014219,2011,160100009,,,,2,3,5
HND-014223,2011,160100014,,,,9,4,13
HND-014225,2011,160100016,,,,7,6,13
HND-014226,2011,160100017,,,,12,3,15
HND-014229,2011,160100020,,,,7,7,14
HND-014230,2011,160100021,,,,2,2,4
HND-014232,2011,160100023,,,,14,15,29
HND-014233,2011,160100024,,,,8,13,21
HND-014236,2011,160100027,,,,11,11,22
HND-014237,2011,160100028,,,,2,3,5
HND-014239,2011,160100031,,,,3,2,5
HND-014240,2011,160100032,,,,3,4,7
HND-014242,2011,160100034,,,,2,3,5
HND-014243,2011,160100035,,,,7,5,12
HND-014246,2011,160100038,,,,1,5,6
HND-014249,2011,160100041,,,,3,7,10
HND-014279,2011,160100089,,,,0,1,1
HND-014280,2011,160100090,,,,0,2,2
HND-014281,2011,160100091,,,,2,2,4
HND-014282,2011,160100092,,,,7,7,14
HND-014284,2011,160100095,,,,2,0,2
HND-014287,2011,160100104,,,,2,1,3
HND-014288,2011,160100105,,,,7,7,14
,2011,160100107,,,,2,3,5
HND-014298,2011,160100144,,,,6,5,11
HND-014299,2011,160100145,,,,0,2,2
HND-014300,2011,160100146,,,,3,1,4
HND-014213,2011,160100003,,,,2,2,4
HND-014214,2011,160100004,,,,17,13,30
HND-014216,2011,160100006,,,,12,8,20
HND-014217,2011,160100007,,,,21,12,33
HND-014218,2011,160100008,,,,5,3,8
,2011,160100011,,,,8,7,15
HND-014221,2011,160100012,,,,11,8,19
HND-014222,2011,160100013,,,,27,33,60
HND-014223,2011,160100014,,,,1,4,5
HND-014224,2011,160100015,,,,7,4,11
HND-014229,2011,160100020,,,,2,6,8
HND-014231,2011,160100022,,,,2,0,2
HND-014233,2011,160100024,,,,11,6,17
HND-014234,2011,160100025,,,,3,6,9
HND-014237,2011,160100028,,,,1,1,2
HND-014238,2011,160100029,,,,1,0,1
HND-014243,2011,160100035,,,,5,4,9
HND-014244,2011,160100036,,,,3,3,6
HND-014248,2011,160100040,,,,2,1,3
HND-014249,2011,160100041,,,,6,3,9
HND-014278,2011,160100087,,,,3,2,5
,2011,160100088,,,,18,14,32
HND-014282,2011,160100092,,,,7,4,11
HND-014284,2011,160100095,,,,1,0,1
HND-014288,2011,160100105,,,,10,6,16
HND-014292,2011,160100127,,,,4,6,10
HND-014299,2011,160100145,,,,2,1,3
HND-014305,2011,160100153,,,,6,4,10
HND-014211,2011,160100001,,,,21,15,36
HND-014212,2011,160100002,,,,44,44,88
HND-014215,2011,160100005,,,,10,8,18
HND-014219,2011,160100009,,,,6,0,6
HND-014220,2011,160100010,,,,39,36,75
HND-014225,2011,160100016,,,,9,4,13
HND-014226,2011,160100017,,,,1,4,5
HND-014227,2011,160100018,,,,42,36,78
HND-014228,2011,160100019,,,,9,13,22
HND-014230,2011,160100021,,,,11,5,16
HND-014232,2011,160100023,,,,10,12,22
HND-014235,2011,160100026,,,,7,7,14
HND-014236,2011,160100027,,,,17,13,30
HND-014239,2011,160100031,,,,2,4,6
HND-014240,2011,160100032,,,,4,2,6
HND-014241,2011,160100033,,,,6,2,8
HND-014242,2011,160100034,,,,5,5,10
HND-014245,2011,160100037,,,,0,1,1
HND-014246,2011,160100038,,,,4,1,5
HND-014247,2011,160100039,,,,8,6,14
HND-014253,2011,160100048,,,,12,6,18
HND-014279,2011,160100089,,,,1,2,3
HND-014280,2011,160100090,,,,0,2,2
HND-014281,2011,160100091,,,,2,3,5
HND-014283,2011,160100093,,,,2,0,2
HND-014286,2011,160100102,,,,2,3,5
HND-014287,2011,160100104,,,,1,1,2
,2011,160100107,,,,7,11,18
HND-014291,2011,160100110,,,,1,4,5
HND-014298,2011,160100144,,,,2,2,4
HND-014300,2011,160100146,,,,0,4,4
,2011,160100154,,,,3,4,7
HND-014211,2011,160100001,,,,14,21,35
HND-014214,2011,160100004,,,,13,13,26
HND-014215,2011,160100005,,,,10,6,16
HND-014216,2011,160100006,,,,16,7,23
HND-014218,2011,160100008,,,,4,5,9
HND-014220,2011,160100010,,,,42,40,82
HND-014224,2011,160100015,,,,3,3,6
HND-014225,2011,160100016,,,,7,8,15
HND-014227,2011,160100018,,,,36,45,81
HND-014228,2011,160100019,,,,7,13,20
HND-014232,2011,160100023,,,,15,12,27
HND-014234,2011,160100025,,,,6,5,11
HND-014235,2011,160100026,,,,12,5,17
HND-014238,2011,160100029,,,,2,1,3
HND-014239,2011,160100031,,,,2,1,3
HND-014241,2011,160100033,,,,5,2,7
HND-014244,2011,160100036,,,,5,3,8
HND-014245,2011,160100037,,,,2,1,3
HND-014247,2011,160100039,,,,6,9,15
HND-014248,2011,160100040,,,,4,2,6
HND-014253,2011,160100048,,,,11,12,23
,2011,160100088,,,,18,16,34
HND-014281,2011,160100091,,,,1,1,2
HND-014283,2011,160100093,,,,0,1,1
HND-014286,2011,160100102,,,,6,6,12
HND-014287,2011,160100104,,,,2,2,4
,2011,160100107,,,,7,7,14
HND-014291,2011,160100110,,,,2,0,2
HND-014292,2011,160100127,,,,1,0,1
HND-014298,2011,160100144,,,,8,6,14
HND-014300,2011,160100146,,,,6,2,8
HND-014305,2011,160100153,,,,7,9,16
,2011,160100154,,,,4,2,6
HND-014212,2011,160100002,,,,61,41,102
HND-014213,2011,160100003,,,,1,1,2
HND-014217,2011,160100007,,,,20,7,27
HND-014219,2011,160100009,,,,6,1,7
,2011,160100011,,,,10,7,17
HND-014221,2011,160100012,,,,7,6,13
HND-014222,2011,160100013,,,,38,25,63
HND-014223,2011,160100014,,,,6,2,8
HND-014226,2011,160100017,,,,5,7,12
HND-014229,2011,160100020,,,,12,5,17
HND-014230,2011,160100021,,,,6,4,10
HND-014231,2011,160100022,,,,5,4,9
HND-014233,2011,160100024,,,,9,13,22
HND-014236,2011,160100027,,,,18,20,38
HND-014240,2011,160100032,,,,2,4,6
HND-014242,2011,160100034,,,,5,4,9
HND-014243,2011,160100035,,,,4,3,7
HND-014246,2011,160100038,,,,4,4,8
HND-014249,2011,160100041,,,,1,1,2
HND-014278,2011,160100087,,,,2,5,7
HND-014279,2011,160100089,,,,2,0,2
HND-014282,2011,160100092,,,,5,5,10
HND-014284,2011,160100095,,,,2,2,4
HND-014288,2011,160100105,,,,9,1,10
HND-014299,2011,160100145,,,,3,0,3
HND-014211,2011,160100001,,,,11,9,20
HND-014215,2011,160100005,,,,4,7,11
HND-014218,2011,160100008,,,,1,3,4
HND-014219,2011,160100009,,,,3,6,9
HND-014220,2011,160100010,,,,54,50,104
HND-014224,2011,160100015,,,,8,4,12
HND-014225,2011,160100016,,,,7,9,16
HND-014227,2011,160100018,,,,53,51,104
HND-014228,2011,160100019,,,,10,10,20
HND-014232,2011,160100023,,,,9,8,17
HND-014235,2011,160100026,,,,16,7,23
HND-014236,2011,160100027,,,,11,12,23
HND-014238,2011,160100029,,,,2,5,7
HND-014239,2011,160100031,,,,2,3,5
HND-014241,2011,160100033,,,,2,4,6
HND-014242,2011,160100034,,,,8,5,13
HND-014244,2011,160100036,,,,2,1,3
HND-014245,2011,160100037,,,,1,1,2
HND-014246,2011,160100038,,,,2,0,2
HND-014247,2011,160100039,,,,7,5,12
HND-014253,2011,160100048,,,,11,8,19
,2011,160100088,,,,11,17,28
HND-014281,2011,160100091,,,,1,4,5
HND-014283,2011,160100093,,,,1,0,1
HND-014286,2011,160100102,,,,12,3,15
HND-014287,2011,160100104,,,,4,0,4
,2011,160100107,,,,6,6,12
HND-014291,2011,160100110,,,,4,5,9
HND-014298,2011,160100144,,,,4,4,8
HND-014300,2011,160100146,,,,1,0,1
,2011,160100154,,,,5,2,7
HND-014212,2011,160100002,,,,53,26,79
HND-014213,2011,160100003,,,,3,2,5
HND-014214,2011,160100004,,,,22,29,51
HND-014216,2011,160100006,,,,9,10,19
HND-014217,2011,160100007,,,,24,23,47
,2011,160100011,,,,10,11,21
HND-014221,2011,160100012,,,,6,12,18
HND-014222,2011,160100013,,,,33,27,60
HND-014223,2011,160100014,,,,10,0,10
HND-014226,2011,160100017,,,,8,9,17
HND-014229,2011,160100020,,,,8,6,14
HND-014230,2011,160100021,,,,4,4,8
HND-014231,2011,160100022,,,,6,3,9
HND-014233,2011,160100024,,,,7,10,17
HND-014234,2011,160100025,,,,4,3,7
HND-014237,2011,160100028,,,,5,4,9
HND-014240,2011,160100032,,,,1,2,3
HND-014243,2011,160100035,,,,4,6,10
HND-014248,2011,160100040,,,,2,0,2
HND-014249,2011,160100041,,,,6,5,11
HND-014278,2011,160100087,,,,3,3,6
HND-014279,2011,160100089,,,,2,1,3
HND-014280,2011,160100090,,,,1,1,2
HND-014282,2011,160100092,,,,3,5,8
HND-014284,2011,160100095,,,,1,0,1
HND-014288,2011,160100105,,,,6,5,11
HND-014292,2011,160100127,,,,8,4,12
HND-014299,2011,160100145,,,,1,0,1
HND-014212,2011,160100002,,,,66,54,120
HND-014213,2011,160100003,,,,4,3,7
HND-014217,2011,160100007,,,,28,27,55
HND-014219,2011,160100009,,,,5,10,15
HND-014223,2011,160100014,,,,7,2,9
HND-014225,2011,160100016,,,,9,11,20
HND-014226,2011,160100017,,,,5,5,10
HND-014229,2011,160100020,,,,0,7,7
HND-014230,2011,160100021,,,,10,12,22
HND-014232,2011,160100023,,,,6,10,16
HND-014233,2011,160100024,,,,8,13,21
HND-014236,2011,160100027,,,,19,11,30
HND-014237,2011,160100028,,,,1,0,1
HND-014239,2011,160100031,,,,2,2,4
HND-014240,2011,160100032,,,,4,1,5
HND-014242,2011,160100034,,,,3,5,8
HND-014243,2011,160100035,,,,9,7,16
HND-014246,2011,160100038,,,,1,2,3
HND-014249,2011,160100041,,,,6,4,10
HND-014279,2011,160100089,,,,5,6,11
HND-014280,2011,160100090,,,,0,1,1
HND-014281,2011,160100091,,,,3,1,4
HND-014282,2011,160100092,,,,8,8,16
HND-014284,2011,160100095,,,,5,1,6
HND-014287,2011,160100104,,,,1,2,3
HND-014288,2011,160100105,,,,8,9,17
,2011,160100107,,,,9,6,15
HND-014298,2011,160100144,,,,2,5,7
HND-014299,2011,160100145,,,,1,0,1
HND-014211,2011,160100001,,,,9,16,25
HND-014214,2011,160100004,,,,17,27,44
HND-014215,2011,160100005,,,,10,7,17
HND-014216,2011,160100006,,,,4,5,9
HND-014218,2011,160100008,,,,4,6,10
HND-014220,2011,160100010,,,,46,52,98
,2011,160100011,,,,13,8,21
HND-014221,2011,160100012,,,,12,9,21
HND-014222,2011,160100013,,,,41,38,79
HND-014224,2011,160100015,,,,3,2,5
HND-014227,2011,160100018,,,,50,42,92
HND-014228,2011,160100019,,,,7,13,20
HND-014231,2011,160100022,,,,5,2,7
HND-014234,2011,160100025,,,,3,1,4
HND-014235,2011,160100026,,,,11,9,20
HND-014238,2011,160100029,,,,2,1,3
HND-014241,2011,160100033,,,,1,3,4
HND-014244,2011,160100036,,,,2,3,5
HND-014245,2011,160100037,,,,1,1,2
HND-014247,2011,160100039,,,,5,4,9
HND-014248,2011,160100040,,,,3,3,6
HND-014253,2011,160100048,,,,13,9,22
HND-014278,2011,160100087,,,,2,1,3
,2011,160100088,,,,14,22,36
HND-014283,2011,160100093,,,,2,0,2
HND-014286,2011,160100102,,,,4,6,10
HND-014291,2011,160100110,,,,1,2,3
HND-014292,2011,160100127,,,,2,2,4
,2011,160100154,,,,7,3,10
,2011,160100011,,,,4,4,8
HND-014232,2011,160100023,,,,16,9,25
HND-014236,2011,160100027,,,,26,12,38
HND-014263,2011,160100064,,,,109,92,201
,2011,160100066,,,,29,31,60
HND-014214,2011,160100004,,,,13,13,26
HND-014217,2011,160100007,,,,17,15,32
HND-014221,2011,160100012,,,,20,13,33
HND-014260,2011,160100055,,,,134,91,225
,2011,160100057,,,,6,7,13
HND-014266,2011,160100069,,,,88,120,208
HND-014286,2011,160100102,,,,7,15,22
,2011,160100103,,,,15,19,34
,2011,160100107,,,,4,0,4
,2011,160100155,,,,2,11,13
HND-014214,2011,160100004,,,,13,12,25
HND-014221,2011,160100012,,,,13,23,36
HND-014260,2011,160100055,,,,102,86,188
HND-014266,2011,160100069,,,,67,82,149
HND-014286,2011,160100102,,,,10,10,20
,2011,160100107,,,,3,4,7
,2011,160100155,,,,10,7,17
HND-014217,2011,160100007,,,,13,16,29
,2011,160100011,,,,3,1,4
HND-014232,2011,160100023,,,,6,10,16
HND-014236,2011,160100027,,,,24,24,48
HND-014259,2011,160100054,,,,29,56,85
,2011,160100057,,,,5,11,16
HND-014263,2011,160100064,,,,86,55,141
,2011,160100066,,,,43,30,73
,2011,160100103,,,,12,11,23
HND-014214,2011,160100004,,,,13,5,18
HND-014221,2011,160100012,,,,7,4,11
,2011,160100057,,,,16,18,34
HND-014263,2011,160100064,,,,90,71,161
,2011,160100066,,,,18,24,42
HND-014266,2011,160100069,,,,58,63,121
,2011,160100103,,,,7,6,13
HND-014217,2011,160100007,,,,8,6,14
HND-014232,2011,160100023,,,,6,7,13
HND-014236,2011,160100027,,,,10,14,24
HND-014259,2011,160100054,,,,15,47,62
HND-014260,2011,160100055,,,,89,72,161
HND-014286,2011,160100102,,,,12,7,19
,2011,160100155,,,,8,21,29
HND-014260,2011,160100055,,,,268,136,404
HND-014263,2011,160100064,,,,134,153,287
,2011,160100066,,,,25,40,65
HND-014286,2011,160100102,,,,8,13,21
,2011,160100155,,,,33,64,97
HND-014259,2011,160100054,,,,184,362,546
,2011,160100057,,,,14,23,37
HND-014266,2011,160100069,,,,30,53,83
HND-014259,2011,160100054,,,,254,421,675
HND-014260,2011,160100055,,,,212,106,318
,2011,160100066,,,,20,24,44
HND-014286,2011,160100102,,,,8,10,18
,2011,160100057,,,,14,15,29
HND-014263,2011,160100064,,,,103,96,199
HND-014266,2011,160100069,,,,5,30,35
,2011,160100155,,,,17,34,51
,2011,160100057,,,,18,25,43
,2011,160100063,,,,1,11,12
HND-014259,2011,160100054,,,,125,225,350
HND-014260,2011,160100055,,,,160,80,240
HND-014263,2011,160100064,,,,61,71,132
,2011,160100066,,,,1,12,13
HND-014286,2011,160100102,,,,7,6,13
,2011,160100155,,,,8,23,31
,2011,160100057,,,,8,16,24
HND-014336,2011,160200042,,,,5,7,12
HND-014345,2011,160200096,,,,3,2,5
,2011,160200105,,,,4,3,7
HND-014348,2011,160200109,,,,3,2,5
HND-014351,2011,160200113,,,,3,4,7
,2011,160200115,,,,2,3,5
,2011,160200046,,,,13,16,29
,2011,160200053,,,,2,5,7
HND-014344,2011,160200074,,,,4,5,9
,2011,160200103,,,,8,2,10
,2011,160200104,,,,1,9,10
,2011,160200106,,,,4,1,5
,2011,160200110,,,,2,5,7
HND-014349,2011,160200111,,,,6,1,7
HND-014350,2011,160200112,,,,2,9,11
HND-014352,2011,160200114,,,,3,2,5
HND-014339,2011,160200048,,,,1,0,1
HND-014340,2011,160200050,,,,0,2,2
HND-014342,2011,160200054,,,,2,1,3
HND-014347,2011,160200108,,,,4,2,6
HND-014331,2011,160200017,,,,4,4,8
HND-014335,2011,160200041,,,,4,2,6
HND-014337,2011,160200043,,,,1,2,3
HND-014331,2011,160200017,,,,9,13,22
HND-014335,2011,160200041,,,,2,3,5
,2011,160200044,,,,5,3,8
HND-014338,2011,160200047,,,,1,8,9
HND-014339,2011,160200048,,,,9,2,11
HND-014347,2011,160200108,,,,10,17,27
HND-014333,2011,160200019,,,,9,14,23
HND-014337,2011,160200043,,,,2,2,4
HND-014340,2011,160200050,,,,1,3,4
HND-014342,2011,160200054,,,,12,5,17
HND-014337,2011,160200043,,,,8,4,12
,2011,160200044,,,,6,10,16
HND-014338,2011,160200047,,,,5,5,10
HND-014347,2011,160200108,,,,25,33,58
HND-014331,2011,160200017,,,,10,10,20
HND-014333,2011,160200019,,,,7,11,18
HND-014335,2011,160200041,,,,5,2,7
HND-014339,2011,160200048,,,,6,3,9
HND-014340,2011,160200050,,,,6,5,11
HND-014342,2011,160200054,,,,9,3,12
HND-014316,2011,160200001,,,,47,40,87
HND-014317,2011,160200002,,,,9,6,15
HND-014319,2011,160200004,,,,21,8,29
HND-014323,2011,160200008,,,,4,4,8
HND-014325,2011,160200010,,,,2,4,6
HND-014326,2011,160200011,,,,11,9,20
HND-014328,2011,160200013,,,,7,4,11
HND-014329,2011,160200014,,,,6,2,8
HND-014334,2011,160200020,,,,6,2,8
HND-014346,2011,160200102,,,,8,10,18
HND-014318,2011,160200003,,,,10,9,19
HND-014320,2011,160200005,,,,10,10,20
HND-014321,2011,160200006,,,,5,4,9
HND-014322,2011,160200007,,,,3,11,14
HND-014324,2011,160200009,,,,6,6,12
HND-014327,2011,160200012,,,,7,9,16
HND-014330,2011,160200015,,,,6,4,10
HND-014341,2011,160200052,,,,2,1,3
HND-014343,2011,160200055,,,,0,3,3
HND-014316,2011,160200001,,,,48,42,90
HND-014317,2011,160200002,,,,9,4,13
HND-014319,2011,160200004,,,,14,18,32
HND-014320,2011,160200005,,,,13,8,21
HND-014323,2011,160200008,,,,9,5,14
HND-014324,2011,160200009,,,,4,4,8
HND-014325,2011,160200010,,,,1,1,2
HND-014326,2011,160200011,,,,12,10,22
HND-014327,2011,160200012,,,,4,4,8
HND-014329,2011,160200014,,,,5,1,6
HND-014330,2011,160200015,,,,3,4,7
HND-014341,2011,160200052,,,,0,2,2
HND-014343,2011,160200055,,,,0,2,2
HND-014318,2011,160200003,,,,3,4,7
HND-014321,2011,160200006,,,,2,2,4
HND-014322,2011,160200007,,,,4,7,11
HND-014328,2011,160200013,,,,8,6,14
HND-014334,2011,160200020,,,,4,4,8
HND-014346,2011,160200102,,,,7,6,13
HND-014316,2011,160200001,,,,44,43,87
HND-014317,2011,160200002,,,,12,12,24
HND-014319,2011,160200004,,,,10,13,23
HND-014320,2011,160200005,,,,9,14,23
HND-014323,2011,160200008,,,,3,3,6
HND-014325,2011,160200010,,,,2,3,5
HND-014326,2011,160200011,,,,6,10,16
HND-014328,2011,160200013,,,,9,5,14
HND-014329,2011,160200014,,,,0,3,3
HND-014334,2011,160200020,,,,7,5,12
HND-014341,2011,160200052,,,,3,2,5
HND-014343,2011,160200055,,,,3,1,4
HND-014346,2011,160200102,,,,2,7,9
HND-014318,2011,160200003,,,,8,5,13
HND-014321,2011,160200006,,,,4,1,5
HND-014322,2011,160200007,,,,7,5,12
HND-014324,2011,160200009,,,,4,2,6
HND-014327,2011,160200012,,,,3,3,6
HND-014330,2011,160200015,,,,5,1,6
HND-014316,2011,160200001,,,,42,42,84
HND-014317,2011,160200002,,,,4,4,8
HND-014320,2011,160200005,,,,8,8,16
HND-014324,2011,160200009,,,,5,6,11
HND-014325,2011,160200010,,,,4,0,4
HND-014327,2011,160200012,,,,3,7,10
HND-014329,2011,160200014,,,,8,5,13
HND-014330,2011,160200015,,,,3,3,6
HND-014343,2011,160200055,,,,2,0,2
HND-014318,2011,160200003,,,,4,3,7
HND-014319,2011,160200004,,,,11,9,20
HND-014321,2011,160200006,,,,1,2,3
HND-014322,2011,160200007,,,,8,2,10
HND-014323,2011,160200008,,,,5,2,7
HND-014326,2011,160200011,,,,4,4,8
HND-014328,2011,160200013,,,,4,3,7
HND-014334,2011,160200020,,,,10,7,17
HND-014341,2011,160200052,,,,2,1,3
HND-014316,2011,160200001,,,,24,43,67
HND-014320,2011,160200005,,,,13,7,20
HND-014321,2011,160200006,,,,3,0,3
HND-014324,2011,160200009,,,,4,6,10
HND-014325,2011,160200010,,,,2,4,6
HND-014327,2011,160200012,,,,5,2,7
HND-014330,2011,160200015,,,,1,1,2
HND-014317,2011,160200002,,,,7,6,13
HND-014318,2011,160200003,,,,3,5,8
HND-014319,2011,160200004,,,,12,13,25
HND-014322,2011,160200007,,,,4,4,8
HND-014323,2011,160200008,,,,5,7,12
HND-014326,2011,160200011,,,,8,10,18
HND-014328,2011,160200013,,,,5,4,9
HND-014329,2011,160200014,,,,1,2,3
HND-014334,2011,160200020,,,,6,7,13
HND-014341,2011,160200052,,,,5,0,5
HND-014343,2011,160200055,,,,1,2,3
HND-014318,2011,160200003,,,,6,5,11
HND-014321,2011,160200006,,,,3,1,4
HND-014322,2011,160200007,,,,2,3,5
HND-014328,2011,160200013,,,,4,7,11
HND-014334,2011,160200020,,,,9,7,16
HND-014316,2011,160200001,,,,39,30,69
HND-014317,2011,160200002,,,,5,5,10
HND-014319,2011,160200004,,,,16,8,24
HND-014320,2011,160200005,,,,11,9,20
HND-014323,2011,160200008,,,,3,3,6
HND-014324,2011,160200009,,,,6,4,10
HND-014325,2011,160200010,,,,3,0,3
HND-014326,2011,160200011,,,,10,8,18
HND-014327,2011,160200012,,,,2,4,6
HND-014329,2011,160200014,,,,3,2,5
HND-014330,2011,160200015,,,,3,0,3
HND-014319,2011,160200004,,,,7,14,21
HND-014323,2011,160200008,,,,4,7,11
HND-014326,2011,160200011,,,,12,8,20
HND-014332,2011,160200018,,,,53,45,98
HND-014319,2011,160200004,,,,14,12,26
HND-014323,2011,160200008,,,,6,12,18
HND-014326,2011,160200011,,,,4,7,11
HND-014332,2011,160200018,,,,34,28,62
HND-014319,2011,160200004,,,,7,2,9
HND-014323,2011,160200008,,,,6,3,9
HND-014326,2011,160200011,,,,9,7,16
HND-014332,2011,160200018,,,,29,31,60
HND-014332,2011,160200018,,,,12,16,28
HND-014332,2011,160200018,,,,11,17,28
HND-014332,2011,160200018,,,,8,14,22
HND-014361,2011,160300008,,,,1,7,8
HND-014378,2011,160300025,,,,5,5,10
HND-014379,2011,160300026,,,,14,7,21
,2011,160300039,,,,11,5,16
,2011,160300042,,,,12,6,18
,2011,160300060,,,,1,5,6
HND-014399,2011,160300064,,,,7,13,20
,2011,160300065,,,,10,6,16
HND-014401,2011,160300071,,,,5,9,14
HND-014403,2011,160300089,,,,1,7,8
,2011,160300123,,,,2,4,6
HND-014407,2011,160300124,,,,10,17,27
,2011,160300125,,,,3,2,5
,2011,160300126,,,,7,8,15
,2011,160300128,,,,3,6,9
,2011,160300132,,,,2,9,11
HND-014388,2011,160300044,,,,10,4,14
HND-014389,2011,160300045,,,,7,6,13
HND-014390,2011,160300046,,,,12,10,22
HND-014391,2011,160300049,,,,6,5,11
,2011,160300052,,,,7,0,7
HND-014393,2011,160300055,,,,17,9,26
HND-014394,2011,160300057,,,,18,22,40
,2011,160300067,,,,6,2,8
HND-014400,2011,160300069,,,,4,2,6
,2011,160300076,,,,8,17,25
,2011,160300121,,,,12,11,23
HND-014411,2011,160300133,,,,1,3,4
HND-014412,2011,160300134,,,,6,5,11
,2011,160300135,,,,4,5,9
,2011,160300136,,,,8,17,25
HND-014382,2011,160300031,,,,0,1,1
HND-014392,2011,160300051,,,,1,1,2
HND-014406,2011,160300120,,,,6,6,12
HND-014409,2011,160300129,,,,5,3,8
HND-014375,2011,160300022,,,,7,6,13
HND-014380,2011,160300027,,,,3,1,4
,2011,160300047,,,,2,2,4
HND-014380,2011,160300027,,,,11,7,18
HND-014382,2011,160300031,,,,12,9,21
,2011,160300047,,,,2,6,8
HND-014406,2011,160300120,,,,3,3,6
HND-014375,2011,160300022,,,,20,22,42
HND-014381,2011,160300030,,,,9,6,15
HND-014383,2011,160300032,,,,8,2,10
HND-014392,2011,160300051,,,,1,4,5
HND-014409,2011,160300129,,,,1,1,2
HND-014380,2011,160300027,,,,9,12,21
HND-014381,2011,160300030,,,,9,6,15
HND-014383,2011,160300032,,,,29,14,43
,2011,160300047,,,,0,1,1
HND-014392,2011,160300051,,,,5,5,10
HND-014375,2011,160300022,,,,34,26,60
HND-014382,2011,160300031,,,,9,9,18
HND-014406,2011,160300120,,,,3,2,5
HND-014409,2011,160300129,,,,2,5,7
HND-014355,2011,160300002,,,,29,41,70
HND-014356,2011,160300003,,,,9,8,17
HND-014358,2011,160300005,,,,8,13,21
HND-014359,2011,160300006,,,,11,12,23
HND-014362,2011,160300009,,,,6,7,13
HND-014363,2011,160300010,,,,4,4,8
HND-014365,2011,160300012,,,,7,6,13
HND-014367,2011,160300014,,,,11,11,22
HND-014368,2011,160300015,,,,11,4,15
HND-014371,2011,160300018,,,,16,8,24
HND-014372,2011,160300019,,,,5,3,8
HND-014374,2011,160300021,,,,5,2,7
HND-014377,2011,160300024,,,,3,5,8
HND-014385,2011,160300035,,,,4,3,7
HND-014386,2011,160300036,,,,5,3,8
HND-014395,2011,160300059,,,,2,3,5
,2011,160300062,,,,2,3,5
HND-014404,2011,160300117,,,,3,1,4
HND-014405,2011,160300118,,,,3,0,3
HND-014410,2011,160300131,,,,4,4,8
HND-014354,2011,160300001,,,,9,4,13
HND-014357,2011,160300004,,,,6,6,12
HND-014360,2011,160300007,,,,9,6,15
HND-014361,2011,160300008,,,,9,6,15
HND-014364,2011,160300011,,,,20,17,37
HND-014366,2011,160300013,,,,11,9,20
HND-014369,2011,160300016,,,,2,4,6
HND-014370,2011,160300017,,,,1,4,5
,2011,160300020,,,,4,5,9
HND-014384,2011,160300034,,,,8,1,9
HND-014387,2011,160300037,,,,38,28,66
,2011,160300054,,,,4,2,6
HND-014398,2011,160300063,,,,8,8,16
,2011,160300067,,,,3,1,4
,2011,160300130,,,,0,3,3
HND-014354,2011,160300001,,,,9,6,15
HND-014355,2011,160300002,,,,32,22,54
HND-014356,2011,160300003,,,,6,7,13
HND-014359,2011,160300006,,,,11,15,26
HND-014360,2011,160300007,,,,6,7,13
HND-014362,2011,160300009,,,,4,11,15
HND-014368,2011,160300015,,,,8,9,17
HND-014369,2011,160300016,,,,4,3,7
HND-014372,2011,160300019,,,,8,7,15
,2011,160300020,,,,4,4,8
HND-014374,2011,160300021,,,,1,3,4
HND-014377,2011,160300024,,,,6,5,11
HND-014384,2011,160300034,,,,3,2,5
HND-014385,2011,160300035,,,,7,5,12
,2011,160300054,,,,3,1,4
HND-014398,2011,160300063,,,,4,6,10
,2011,160300067,,,,1,1,2
HND-014410,2011,160300131,,,,4,6,10
HND-014357,2011,160300004,,,,3,11,14
HND-014358,2011,160300005,,,,11,9,20
HND-014361,2011,160300008,,,,10,7,17
HND-014363,2011,160300010,,,,7,5,12
HND-014364,2011,160300011,,,,23,14,37
HND-014365,2011,160300012,,,,9,10,19
HND-014366,2011,160300013,,,,14,11,25
HND-014367,2011,160300014,,,,15,11,26
HND-014370,2011,160300017,,,,2,2,4
HND-014371,2011,160300018,,,,11,9,20
HND-014386,2011,160300036,,,,2,2,4
HND-014387,2011,160300037,,,,29,13,42
HND-014395,2011,160300059,,,,1,2,3
,2011,160300062,,,,2,3,5
HND-014404,2011,160300117,,,,1,1,2
HND-014405,2011,160300118,,,,0,4,4
,2011,160300130,,,,1,4,5
HND-014355,2011,160300002,,,,23,31,54
HND-014356,2011,160300003,,,,9,2,11
HND-014358,2011,160300005,,,,4,7,11
HND-014359,2011,160300006,,,,15,8,23
HND-014362,2011,160300009,,,,5,5,10
HND-014363,2011,160300010,,,,4,6,10
HND-014365,2011,160300012,,,,10,6,16
HND-014368,2011,160300015,,,,8,7,15
HND-014371,2011,160300018,,,,12,13,25
HND-014372,2011,160300019,,,,7,8,15
,2011,160300020,,,,5,4,9
HND-014374,2011,160300021,,,,0,3,3
HND-014377,2011,160300024,,,,3,4,7
HND-014384,2011,160300034,,,,7,2,9
HND-014354,2011,160300001,,,,4,8,12
HND-014357,2011,160300004,,,,4,5,9
HND-014360,2011,160300007,,,,9,7,16
HND-014361,2011,160300008,,,,11,11,22
HND-014364,2011,160300011,,,,20,15,35
HND-014366,2011,160300013,,,,18,13,31
HND-014367,2011,160300014,,,,11,9,20
HND-014369,2011,160300016,,,,1,3,4
HND-014370,2011,160300017,,,,2,4,6
HND-014385,2011,160300035,,,,5,6,11
HND-014386,2011,160300036,,,,1,2,3
HND-014387,2011,160300037,,,,20,24,44
HND-014395,2011,160300059,,,,1,5,6
,2011,160300062,,,,1,1,2
HND-014398,2011,160300063,,,,7,6,13
,2011,160300067,,,,0,3,3
HND-014404,2011,160300117,,,,0,3,3
HND-014405,2011,160300118,,,,1,2,3
,2011,160300130,,,,2,3,5
HND-014354,2011,160300001,,,,4,3,7
HND-014356,2011,160300003,,,,8,6,14
HND-014357,2011,160300004,,,,9,9,18
HND-014359,2011,160300006,,,,14,7,21
HND-014360,2011,160300007,,,,5,2,7
HND-014366,2011,160300013,,,,10,12,22
HND-014369,2011,160300016,,,,1,5,6
HND-014370,2011,160300017,,,,4,3,7
HND-014372,2011,160300019,,,,8,3,11
,2011,160300020,,,,3,3,6
HND-014374,2011,160300021,,,,3,3,6
HND-014377,2011,160300024,,,,3,8,11
HND-014385,2011,160300035,,,,4,7,11
,2011,160300054,,,,5,2,7
HND-014395,2011,160300059,,,,3,3,6
HND-014398,2011,160300063,,,,3,8,11
,2011,160300067,,,,2,5,7
,2011,160300130,,,,1,1,2
HND-014355,2011,160300002,,,,33,31,64
HND-014358,2011,160300005,,,,7,7,14
HND-014361,2011,160300008,,,,7,12,19
HND-014362,2011,160300009,,,,4,3,7
HND-014363,2011,160300010,,,,4,3,7
HND-014364,2011,160300011,,,,25,19,44
HND-014365,2011,160300012,,,,12,9,21
HND-014367,2011,160300014,,,,8,4,12
HND-014368,2011,160300015,,,,2,9,11
HND-014371,2011,160300018,,,,11,9,20
HND-014384,2011,160300034,,,,2,8,10
HND-014386,2011,160300036,,,,2,0,2
HND-014387,2011,160300037,,,,20,30,50
,2011,160300062,,,,3,1,4
HND-014404,2011,160300117,,,,2,5,7
HND-014405,2011,160300118,,,,0,3,3
HND-014354,2011,160300001,,,,6,3,9
HND-014356,2011,160300003,,,,3,5,8
HND-014357,2011,160300004,,,,5,6,11
HND-014360,2011,160300007,,,,5,5,10
HND-014361,2011,160300008,,,,8,6,14
HND-014364,2011,160300011,,,,17,16,33
HND-014366,2011,160300013,,,,18,17,35
HND-014370,2011,160300017,,,,4,5,9
HND-014372,2011,160300019,,,,3,6,9
,2011,160300020,,,,3,5,8
HND-014377,2011,160300024,,,,4,5,9
HND-014385,2011,160300035,,,,7,4,11
HND-014386,2011,160300036,,,,2,0,2
HND-014395,2011,160300059,,,,3,2,5
HND-014398,2011,160300063,,,,8,5,13
,2011,160300067,,,,1,2,3
HND-014404,2011,160300117,,,,1,2,3
HND-014405,2011,160300118,,,,1,1,2
,2011,160300130,,,,2,3,5
HND-014355,2011,160300002,,,,39,36,75
HND-014358,2011,160300005,,,,6,4,10
HND-014359,2011,160300006,,,,18,19,37
HND-014362,2011,160300009,,,,6,4,10
HND-014363,2011,160300010,,,,12,6,18
HND-014365,2011,160300012,,,,14,11,25
HND-014367,2011,160300014,,,,4,1,5
HND-014368,2011,160300015,,,,6,8,14
HND-014371,2011,160300018,,,,9,14,23
HND-014374,2011,160300021,,,,1,2,3
HND-014384,2011,160300034,,,,5,3,8
HND-014387,2011,160300037,,,,17,10,27
,2011,160300054,,,,5,2,7
,2011,160300062,,,,2,2,4
HND-014357,2011,160300004,,,,6,12,18
HND-014358,2011,160300005,,,,4,9,13
HND-014361,2011,160300008,,,,7,11,18
HND-014363,2011,160300010,,,,2,3,5
HND-014364,2011,160300011,,,,15,10,25
HND-014365,2011,160300012,,,,7,5,12
HND-014366,2011,160300013,,,,24,17,41
HND-014367,2011,160300014,,,,2,4,6
HND-014370,2011,160300017,,,,1,1,2
HND-014371,2011,160300018,,,,6,8,14
HND-014386,2011,160300036,,,,4,2,6
HND-014387,2011,160300037,,,,11,13,24
HND-014395,2011,160300059,,,,2,1,3
,2011,160300062,,,,4,4,8
HND-014404,2011,160300117,,,,7,1,8
HND-014405,2011,160300118,,,,1,1,2
HND-014354,2011,160300001,,,,1,3,4
HND-014355,2011,160300002,,,,48,50,98
HND-014356,2011,160300003,,,,2,5,7
HND-014359,2011,160300006,,,,13,10,23
HND-014360,2011,160300007,,,,1,5,6
HND-014362,2011,160300009,,,,4,7,11
HND-014368,2011,160300015,,,,7,4,11
HND-014372,2011,160300019,,,,3,3,6
,2011,160300020,,,,1,4,5
HND-014374,2011,160300021,,,,1,0,1
HND-014377,2011,160300024,,,,7,3,10
HND-014384,2011,160300034,,,,6,5,11
HND-014385,2011,160300035,,,,5,2,7
,2011,160300054,,,,3,1,4
HND-014398,2011,160300063,,,,3,7,10
,2011,160300067,,,,7,1,8
HND-014362,2011,160300009,,,,10,6,16
HND-014376,2011,160300023,,,,47,55,102
,2011,160300073,,,,2,2,4
HND-014364,2011,160300011,,,,11,7,18
HND-014387,2011,160300037,,,,15,18,33
HND-014362,2011,160300009,,,,9,5,14
HND-014376,2011,160300023,,,,42,49,91
HND-014364,2011,160300011,,,,6,4,10
HND-014387,2011,160300037,,,,14,14,28
,2011,160300073,,,,2,1,3
HND-014376,2011,160300023,,,,55,47,102
HND-014362,2011,160300009,,,,7,8,15
HND-014364,2011,160300011,,,,3,4,7
HND-014387,2011,160300037,,,,11,11,22
,2011,160300073,,,,5,0,5
HND-014376,2011,160300023,,,,44,34,78
,2011,160300073,,,,5,3,8
,2011,160300073,,,,5,2,7
HND-014376,2011,160300023,,,,22,25,47
HND-014376,2011,160300023,,,,18,29,47
,2011,160300073,,,,8,3,11
HND-014425,2011,160400010,,,,5,2,7
HND-014426,2011,160400011,,,,4,7,11
HND-014451,2011,160400058,,,,6,7,13
HND-014454,2011,160400066,,,,4,4,8
HND-014455,2011,160400069,,,,5,9,14
,2011,160400073,,,,2,3,5
,2011,160400075,,,,5,5,10
,2011,160400076,,,,6,7,13
,2011,160400079,,,,6,6,12
,2011,160400070,,,,4,2,6
,2011,160400071,,,,4,4,8
,2011,160400072,,,,2,4,6
,2011,160400074,,,,3,3,6
,2011,160400078,,,,5,1,6
,2011,160400080,,,,2,2,4
HND-014447,2011,160400036,,,,0,1,1
,2011,160400039,,,,1,0,1
HND-014446,2011,160400034,,,,2,2,4
,2011,160400039,,,,2,0,2
HND-014442,2011,160400028,,,,1,1,2
HND-014443,2011,160400029,,,,3,5,8
HND-014444,2011,160400031,,,,8,6,14
,2011,160400035,,,,3,1,4
HND-014447,2011,160400036,,,,0,5,5
,2011,160400057,,,,11,15,26
HND-014442,2011,160400028,,,,23,29,52
HND-014443,2011,160400029,,,,19,13,32
,2011,160400030,,,,12,12,24
HND-014444,2011,160400031,,,,40,27,67
HND-014447,2011,160400036,,,,9,9,18
,2011,160400057,,,,18,29,47
HND-014446,2011,160400034,,,,13,13,26
,2011,160400035,,,,0,2,2
,2011,160400039,,,,6,8,14
HND-014416,2011,160400001,,,,28,39,67
HND-014420,2011,160400005,,,,7,9,16
HND-014421,2011,160400006,,,,15,11,26
HND-014424,2011,160400009,,,,4,3,7
HND-014430,2011,160400015,,,,7,4,11
HND-014434,2011,160400019,,,,2,0,2
HND-014435,2011,160400020,,,,6,6,12
,2011,160400021,,,,1,0,1
HND-014437,2011,160400022,,,,4,4,8
HND-014438,2011,160400023,,,,34,36,70
HND-014449,2011,160400038,,,,3,6,9
HND-014457,2011,160400077,,,,8,5,13
HND-014458,2011,160400081,,,,4,6,10
HND-014417,2011,160400002,,,,3,4,7
HND-014418,2011,160400003,,,,53,50,103
HND-014419,2011,160400004,,,,20,18,38
HND-014422,2011,160400007,,,,25,22,47
,2011,160400008,,,,7,8,15
HND-014425,2011,160400010,,,,4,2,6
HND-014426,2011,160400011,,,,4,2,6
HND-014428,2011,160400013,,,,4,1,5
HND-014429,2011,160400014,,,,5,1,6
HND-014431,2011,160400016,,,,9,3,12
HND-014432,2011,160400017,,,,6,4,10
HND-014433,2011,160400018,,,,3,3,6
HND-014440,2011,160400025,,,,10,8,18
,2011,160400026,,,,9,6,15
,2011,160400035,,,,1,3,4
HND-014448,2011,160400037,,,,21,17,38
HND-014450,2011,160400040,,,,1,0,1
HND-014452,2011,160400059,,,,2,3,5
HND-014453,2011,160400060,,,,2,2,4
HND-014416,2011,160400001,,,,43,47,90
HND-014417,2011,160400002,,,,2,2,4
HND-014419,2011,160400004,,,,19,14,33
HND-014420,2011,160400005,,,,6,6,12
,2011,160400008,,,,14,12,26
HND-014425,2011,160400010,,,,3,1,4
HND-014426,2011,160400011,,,,3,3,6
HND-014427,2011,160400012,,,,3,6,9
HND-014429,2011,160400014,,,,1,4,5
HND-014430,2011,160400015,,,,9,8,17
HND-014433,2011,160400018,,,,2,2,4
,2011,160400021,,,,1,0,1
HND-014438,2011,160400023,,,,36,22,58
,2011,160400026,,,,9,3,12
HND-014448,2011,160400037,,,,16,12,28
HND-014449,2011,160400038,,,,4,2,6
HND-014452,2011,160400059,,,,3,2,5
HND-014453,2011,160400060,,,,2,1,3
HND-014418,2011,160400003,,,,32,35,67
HND-014421,2011,160400006,,,,13,11,24
HND-014422,2011,160400007,,,,14,9,23
HND-014424,2011,160400009,,,,4,5,9
HND-014428,2011,160400013,,,,5,1,6
HND-014431,2011,160400016,,,,4,2,6
HND-014432,2011,160400017,,,,4,5,9
HND-014434,2011,160400019,,,,4,0,4
HND-014435,2011,160400020,,,,1,5,6
HND-014437,2011,160400022,,,,0,6,6
HND-014439,2011,160400024,,,,5,7,12
HND-014440,2011,160400025,,,,5,5,10
,2011,160400035,,,,0,2,2
HND-014450,2011,160400040,,,,1,3,4
HND-014457,2011,160400077,,,,1,1,2
HND-014458,2011,160400081,,,,3,2,5
HND-014417,2011,160400002,,,,0,3,3
HND-014419,2011,160400004,,,,15,15,30
HND-014422,2011,160400007,,,,19,13,32
,2011,160400008,,,,7,12,19
HND-014425,2011,160400010,,,,1,3,4
HND-014426,2011,160400011,,,,7,3,10
HND-014428,2011,160400013,,,,2,1,3
HND-014429,2011,160400014,,,,3,0,3
HND-014432,2011,160400017,,,,7,2,9
HND-014438,2011,160400023,,,,36,34,70
HND-014440,2011,160400025,,,,7,5,12
,2011,160400026,,,,5,8,13
,2011,160400035,,,,3,0,3
HND-014448,2011,160400037,,,,14,18,32
HND-014450,2011,160400040,,,,1,2,3
HND-014452,2011,160400059,,,,2,1,3
HND-014453,2011,160400060,,,,0,1,1
HND-014416,2011,160400001,,,,32,49,81
HND-014418,2011,160400003,,,,28,48,76
HND-014420,2011,160400005,,,,6,7,13
HND-014421,2011,160400006,,,,12,14,26
HND-014424,2011,160400009,,,,5,5,10
HND-014427,2011,160400012,,,,5,7,12
HND-014430,2011,160400015,,,,3,6,9
HND-014431,2011,160400016,,,,1,3,4
HND-014434,2011,160400019,,,,0,2,2
HND-014435,2011,160400020,,,,3,4,7
,2011,160400021,,,,1,1,2
HND-014437,2011,160400022,,,,1,3,4
HND-014439,2011,160400024,,,,2,4,6
HND-014457,2011,160400077,,,,1,0,1
HND-014458,2011,160400081,,,,0,2,2
HND-014416,2011,160400001,,,,46,56,102
HND-014417,2011,160400002,,,,1,1,2
HND-014420,2011,160400005,,,,7,5,12
,2011,160400008,,,,4,8,12
HND-014424,2011,160400009,,,,1,2,3
HND-014425,2011,160400010,,,,2,2,4
HND-014427,2011,160400012,,,,5,2,7
HND-014429,2011,160400014,,,,4,2,6
HND-014430,2011,160400015,,,,2,2,4
HND-014435,2011,160400020,,,,3,2,5
,2011,160400021,,,,4,0,4
HND-014438,2011,160400023,,,,33,30,63
HND-014439,2011,160400024,,,,1,5,6
,2011,160400026,,,,3,6,9
HND-014448,2011,160400037,,,,15,7,22
HND-014449,2011,160400038,,,,0,3,3
HND-014452,2011,160400059,,,,2,1,3
HND-014453,2011,160400060,,,,2,2,4
HND-014457,2011,160400077,,,,4,1,5
HND-014418,2011,160400003,,,,34,27,61
HND-014419,2011,160400004,,,,21,12,33
HND-014421,2011,160400006,,,,9,13,22
HND-014422,2011,160400007,,,,8,23,31
HND-014426,2011,160400011,,,,6,3,9
HND-014428,2011,160400013,,,,0,3,3
HND-014431,2011,160400016,,,,4,2,6
HND-014432,2011,160400017,,,,4,5,9
HND-014437,2011,160400022,,,,1,5,6
HND-014440,2011,160400025,,,,8,2,10
,2011,160400035,,,,1,2,3
HND-014450,2011,160400040,,,,1,1,2
HND-014458,2011,160400081,,,,1,1,2
HND-014416,2011,160400001,,,,47,40,87
HND-014417,2011,160400002,,,,5,3,8
HND-014420,2011,160400005,,,,5,4,9
HND-014421,2011,160400006,,,,10,11,21
HND-014424,2011,160400009,,,,2,1,3
HND-014425,2011,160400010,,,,1,0,1
HND-014427,2011,160400012,,,,3,3,6
HND-014430,2011,160400015,,,,8,7,15
HND-014433,2011,160400018,,,,2,2,4
HND-014434,2011,160400019,,,,0,8,8
HND-014435,2011,160400020,,,,6,3,9
,2011,160400021,,,,0,3,3
HND-014438,2011,160400023,,,,30,42,72
HND-014439,2011,160400024,,,,2,2,4
HND-014449,2011,160400038,,,,2,0,2
HND-014453,2011,160400060,,,,3,2,5
HND-014458,2011,160400081,,,,1,2,3
HND-014418,2011,160400003,,,,40,37,77
HND-014419,2011,160400004,,,,19,16,35
HND-014422,2011,160400007,,,,14,18,32
,2011,160400008,,,,4,5,9
HND-014426,2011,160400011,,,,2,12,14
HND-014428,2011,160400013,,,,2,1,3
HND-014429,2011,160400014,,,,3,4,7
HND-014431,2011,160400016,,,,2,2,4
HND-014432,2011,160400017,,,,6,10,16
HND-014437,2011,160400022,,,,1,6,7
HND-014440,2011,160400025,,,,3,5,8
,2011,160400026,,,,5,3,8
,2011,160400035,,,,2,1,3
HND-014448,2011,160400037,,,,17,17,34
HND-014452,2011,160400059,,,,3,0,3
HND-014418,2011,160400003,,,,35,45,80
HND-014421,2011,160400006,,,,8,10,18
HND-014422,2011,160400007,,,,22,15,37
HND-014424,2011,160400009,,,,5,5,10
HND-014431,2011,160400016,,,,1,3,4
HND-014432,2011,160400017,,,,2,4,6
HND-014434,2011,160400019,,,,2,2,4
HND-014435,2011,160400020,,,,1,1,2
HND-014437,2011,160400022,,,,5,3,8
HND-014439,2011,160400024,,,,3,4,7
HND-014440,2011,160400025,,,,3,2,5
HND-014458,2011,160400081,,,,0,2,2
HND-014416,2011,160400001,,,,61,64,125
HND-014417,2011,160400002,,,,1,4,5
HND-014419,2011,160400004,,,,10,18,28
HND-014420,2011,160400005,,,,14,5,19
,2011,160400008,,,,5,2,7
HND-014425,2011,160400010,,,,1,3,4
HND-014426,2011,160400011,,,,7,5,12
HND-014427,2011,160400012,,,,1,1,2
HND-014429,2011,160400014,,,,1,5,6
HND-014430,2011,160400015,,,,5,2,7
HND-014433,2011,160400018,,,,0,1,1
,2011,160400021,,,,3,2,5
HND-014438,2011,160400023,,,,42,45,87
,2011,160400026,,,,4,3,7
HND-014448,2011,160400037,,,,17,12,29
HND-014449,2011,160400038,,,,1,0,1
HND-014452,2011,160400059,,,,1,4,5
HND-014453,2011,160400060,,,,1,1,2
HND-014421,2011,160400006,,,,8,10,18
HND-014445,2011,160400033,,,,214,202,416
HND-014419,2011,160400004,,,,14,9,23
HND-014422,2011,160400007,,,,12,23,35
HND-014419,2011,160400004,,,,3,13,16
HND-014421,2011,160400006,,,,6,8,14
HND-014422,2011,160400007,,,,17,20,37
HND-014445,2011,160400033,,,,151,174,325
HND-014419,2011,160400004,,,,6,15,21
HND-014445,2011,160400033,,,,132,159,291
HND-014421,2011,160400006,,,,8,8,16
HND-014422,2011,160400007,,,,15,17,32
HND-014445,2011,160400033,,,,118,119,237
HND-014445,2011,160400033,,,,58,67,125
HND-014445,2011,160400033,,,,44,71,115
HND-014470,2011,160500040,,,,4,4,8
HND-014465,2011,160500008,,,,3,2,5
HND-014466,2011,160500009,,,,0,2,2
,2011,160500043,,,,1,2,3
,2011,160500011,,,,2,0,2
HND-014469,2011,160500039,,,,5,7,12
HND-014466,2011,160500009,,,,1,4,5
HND-014469,2011,160500039,,,,5,8,13
HND-014465,2011,160500008,,,,5,5,10
,2011,160500010,,,,1,1,2
,2011,160500011,,,,6,11,17
HND-014468,2011,160500014,,,,1,2,3
,2011,160500043,,,,4,3,7
HND-014465,2011,160500008,,,,10,19,29
HND-014466,2011,160500009,,,,1,4,5
,2011,160500010,,,,11,9,20
,2011,160500011,,,,3,15,18
HND-014468,2011,160500014,,,,4,8,12
,2011,160500043,,,,0,3,3
HND-014469,2011,160500039,,,,9,6,15
HND-014460,2011,160500002,,,,18,15,33
HND-014462,2011,160500005,,,,12,8,20
HND-014467,2011,160500013,,,,10,5,15
HND-014459,2011,160500001,,,,9,5,14
HND-014461,2011,160500004,,,,6,9,15
HND-014463,2011,160500006,,,,7,10,17
HND-014464,2011,160500007,,,,1,4,5
HND-014471,2011,160500041,,,,2,1,3
HND-014460,2011,160500002,,,,15,8,23
HND-014462,2011,160500005,,,,10,9,19
HND-014463,2011,160500006,,,,8,8,16
HND-014459,2011,160500001,,,,9,9,18
HND-014461,2011,160500004,,,,5,10,15
HND-014464,2011,160500007,,,,2,2,4
HND-014467,2011,160500013,,,,9,7,16
HND-014471,2011,160500041,,,,5,2,7
HND-014460,2011,160500002,,,,15,11,26
HND-014462,2011,160500005,,,,9,6,15
HND-014467,2011,160500013,,,,6,4,10
HND-014471,2011,160500041,,,,5,3,8
HND-014459,2011,160500001,,,,12,7,19
HND-014461,2011,160500004,,,,8,5,13
HND-014463,2011,160500006,,,,9,5,14
HND-014464,2011,160500007,,,,2,2,4
HND-014459,2011,160500001,,,,6,9,15
HND-014460,2011,160500002,,,,17,19,36
HND-014463,2011,160500006,,,,7,6,13
HND-014464,2011,160500007,,,,3,2,5
HND-014461,2011,160500004,,,,9,6,15
HND-014462,2011,160500005,,,,6,5,11
HND-014467,2011,160500013,,,,5,5,10
HND-014471,2011,160500041,,,,1,2,3
HND-014459,2011,160500001,,,,11,8,19
HND-014460,2011,160500002,,,,23,26,49
HND-014463,2011,160500006,,,,10,9,19
HND-014464,2011,160500007,,,,4,1,5
HND-014461,2011,160500004,,,,12,14,26
HND-014462,2011,160500005,,,,4,6,10
HND-014467,2011,160500013,,,,13,6,19
HND-014471,2011,160500041,,,,1,2,3
HND-014459,2011,160500001,,,,11,5,16
HND-014461,2011,160500004,,,,12,9,21
HND-014464,2011,160500007,,,,2,1,3
HND-014467,2011,160500013,,,,0,6,6
HND-014471,2011,160500041,,,,4,2,6
HND-014460,2011,160500002,,,,28,15,43
HND-014462,2011,160500005,,,,16,10,26
HND-014463,2011,160500006,,,,12,17,29
HND-014460,2011,160500002,,,,25,22,47
HND-014460,2011,160500002,,,,22,11,33
HND-014460,2011,160500002,,,,12,10,22
HND-014492,2011,160600025,,,,3,6,9
,2011,160600028,,,,4,3,7
,2011,160600033,,,,6,5,11
HND-014500,2011,160600043,,,,4,4,8
,2011,160600047,,,,3,7,10
HND-014505,2011,160600074,,,,3,6,9
,2011,160600075,,,,2,5,7
,2011,160600078,,,,7,4,11
,2011,160600083,,,,7,2,9
HND-014509,2011,160600089,,,,11,7,18
,2011,160600090,,,,10,1,11
,2011,160600092,,,,8,7,15
,2011,160600023,,,,5,5,10
,2011,160600073,,,,5,5,10
,2011,160600077,,,,6,2,8
HND-014506,2011,160600079,,,,6,4,10
,2011,160600080,,,,6,7,13
,2011,160600081,,,,5,3,8
HND-014508,2011,160600084,,,,7,3,10
,2011,160600085,,,,5,6,11
,2011,160600086,,,,5,3,8
,2011,160600087,,,,4,5,9
,2011,160600088,,,,5,4,9
,2011,160600091,,,,6,4,10
HND-014491,2011,160600022,,,,0,1,1
,2011,160600037,,,,1,0,1
HND-014490,2011,160600021,,,,5,3,8
HND-014489,2011,160600020,,,,5,1,6
HND-014490,2011,160600021,,,,11,11,22
HND-014491,2011,160600022,,,,4,4,8
HND-014495,2011,160600036,,,,7,2,9
HND-014488,2011,160600019,,,,7,7,14
HND-014493,2011,160600026,,,,8,4,12
,2011,160600037,,,,7,6,13
HND-014488,2011,160600019,,,,8,4,12
HND-014493,2011,160600026,,,,8,3,11
HND-014495,2011,160600036,,,,9,6,15
,2011,160600037,,,,3,5,8
HND-014489,2011,160600020,,,,6,8,14
HND-014490,2011,160600021,,,,15,7,22
HND-014491,2011,160600022,,,,7,9,16
HND-014474,2011,160600003,,,,7,8,15
HND-014476,2011,160600006,,,,11,16,27
HND-014477,2011,160600007,,,,6,8,14
HND-014480,2011,160600010,,,,16,8,24
HND-014482,2011,160600012,,,,4,4,8
HND-014483,2011,160600014,,,,12,7,19
HND-014484,2011,160600015,,,,10,15,25
HND-014487,2011,160600018,,,,4,6,10
HND-014497,2011,160600039,,,,3,2,5
HND-014499,2011,160600041,,,,9,8,17
HND-014501,2011,160600044,,,,2,4,6
HND-014503,2011,160600046,,,,4,4,8
HND-014504,2011,160600072,,,,1,2,3
HND-014507,2011,160600082,,,,12,12,24
,2011,160600002,,,,2,2,4
HND-014475,2011,160600005,,,,8,12,20
HND-014478,2011,160600008,,,,6,3,9
HND-014479,2011,160600009,,,,4,3,7
HND-014481,2011,160600011,,,,2,2,4
HND-014485,2011,160600016,,,,3,4,7
HND-014486,2011,160600017,,,,3,1,4
HND-014494,2011,160600031,,,,2,3,5
HND-014498,2011,160600040,,,,2,3,5
HND-014502,2011,160600045,,,,0,4,4
HND-014475,2011,160600005,,,,12,8,20
HND-014476,2011,160600006,,,,14,12,26
HND-014479,2011,160600009,,,,7,3,10
HND-014480,2011,160600010,,,,18,5,23
HND-014481,2011,160600011,,,,2,2,4
HND-014483,2011,160600014,,,,6,13,19
HND-014485,2011,160600016,,,,6,2,8
HND-014486,2011,160600017,,,,0,2,2
HND-014487,2011,160600018,,,,1,2,3
HND-014496,2011,160600038,,,,1,2,3
HND-014497,2011,160600039,,,,5,1,6
HND-014498,2011,160600040,,,,3,0,3
HND-014499,2011,160600041,,,,7,5,12
HND-014501,2011,160600044,,,,2,2,4
HND-014504,2011,160600072,,,,4,2,6
HND-014507,2011,160600082,,,,15,12,27
,2011,160600002,,,,2,2,4
HND-014474,2011,160600003,,,,2,3,5
HND-014477,2011,160600007,,,,7,12,19
HND-014478,2011,160600008,,,,7,5,12
HND-014482,2011,160600012,,,,3,4,7
HND-014484,2011,160600015,,,,8,7,15
HND-014494,2011,160600031,,,,3,2,5
HND-014502,2011,160600045,,,,0,4,4
HND-014503,2011,160600046,,,,4,2,6
,2011,160600002,,,,2,3,5
HND-014475,2011,160600005,,,,12,2,14
HND-014478,2011,160600008,,,,5,2,7
HND-014479,2011,160600009,,,,6,4,10
HND-014481,2011,160600011,,,,3,2,5
HND-014485,2011,160600016,,,,5,9,14
HND-014486,2011,160600017,,,,0,2,2
HND-014496,2011,160600038,,,,0,1,1
HND-014497,2011,160600039,,,,6,5,11
HND-014498,2011,160600040,,,,3,4,7
HND-014499,2011,160600041,,,,6,7,13
HND-014501,2011,160600044,,,,2,2,4
HND-014503,2011,160600046,,,,2,1,3
HND-014504,2011,160600072,,,,2,0,2
HND-014507,2011,160600082,,,,14,11,25
HND-014474,2011,160600003,,,,3,6,9
HND-014476,2011,160600006,,,,11,16,27
HND-014477,2011,160600007,,,,12,5,17
HND-014480,2011,160600010,,,,12,15,27
HND-014482,2011,160600012,,,,3,4,7
HND-014483,2011,160600014,,,,7,7,14
HND-014484,2011,160600015,,,,14,11,25
HND-014487,2011,160600018,,,,5,3,8
HND-014494,2011,160600031,,,,2,1,3
HND-014502,2011,160600045,,,,3,2,5
HND-014510,2011,160600093,,,,0,2,2
HND-014474,2011,160600003,,,,5,3,8
HND-014476,2011,160600006,,,,18,24,42
HND-014477,2011,160600007,,,,10,9,19
HND-014479,2011,160600009,,,,7,6,13
HND-014480,2011,160600010,,,,10,12,22
HND-014481,2011,160600011,,,,3,1,4
HND-014482,2011,160600012,,,,4,2,6
HND-014483,2011,160600014,,,,4,9,13
HND-014486,2011,160600017,,,,1,3,4
HND-014487,2011,160600018,,,,3,8,11
HND-014494,2011,160600031,,,,1,4,5
HND-014496,2011,160600038,,,,2,0,2
HND-014497,2011,160600039,,,,4,4,8
HND-014498,2011,160600040,,,,2,0,2
HND-014499,2011,160600041,,,,4,6,10
HND-014501,2011,160600044,,,,2,2,4
HND-014502,2011,160600045,,,,0,5,5
HND-014504,2011,160600072,,,,1,1,2
HND-014507,2011,160600082,,,,22,8,30
HND-014510,2011,160600093,,,,2,3,5
,2011,160600002,,,,2,2,4
HND-014475,2011,160600005,,,,12,11,23
HND-014478,2011,160600008,,,,6,3,9
HND-014484,2011,160600015,,,,19,11,30
HND-014485,2011,160600016,,,,6,2,8
HND-014503,2011,160600046,,,,2,2,4
HND-014474,2011,160600003,,,,1,5,6
HND-014476,2011,160600006,,,,14,12,26
HND-014477,2011,160600007,,,,5,12,17
HND-014479,2011,160600009,,,,4,3,7
HND-014480,2011,160600010,,,,12,6,18
HND-014481,2011,160600011,,,,1,3,4
HND-014482,2011,160600012,,,,3,3,6
HND-014483,2011,160600014,,,,8,5,13
HND-014484,2011,160600015,,,,5,10,15
HND-014487,2011,160600018,,,,1,4,5
HND-014494,2011,160600031,,,,6,2,8
HND-014496,2011,160600038,,,,1,2,3
HND-014498,2011,160600040,,,,1,4,5
HND-014501,2011,160600044,,,,2,1,3
HND-014502,2011,160600045,,,,0,1,1
,2011,160600002,,,,2,2,4
HND-014475,2011,160600005,,,,11,10,21
HND-014478,2011,160600008,,,,1,4,5
HND-014485,2011,160600016,,,,5,7,12
HND-014486,2011,160600017,,,,4,1,5
HND-014497,2011,160600039,,,,3,2,5
HND-014499,2011,160600041,,,,3,4,7
HND-014503,2011,160600046,,,,1,4,5
HND-014504,2011,160600072,,,,4,2,6
HND-014507,2011,160600082,,,,11,17,28
,2011,160600002,,,,7,2,9
HND-014474,2011,160600003,,,,6,1,7
HND-014477,2011,160600007,,,,15,9,24
HND-014478,2011,160600008,,,,5,3,8
HND-014482,2011,160600012,,,,3,3,6
HND-014484,2011,160600015,,,,10,12,22
HND-014494,2011,160600031,,,,1,2,3
HND-014502,2011,160600045,,,,2,0,2
HND-014503,2011,160600046,,,,2,3,5
HND-014475,2011,160600005,,,,7,7,14
HND-014476,2011,160600006,,,,12,12,24
HND-014479,2011,160600009,,,,4,7,11
HND-014480,2011,160600010,,,,10,12,22
HND-014481,2011,160600011,,,,3,1,4
HND-014483,2011,160600014,,,,3,5,8
HND-014485,2011,160600016,,,,3,2,5
HND-014486,2011,160600017,,,,4,2,6
HND-014487,2011,160600018,,,,5,7,12
HND-014496,2011,160600038,,,,1,2,3
HND-014497,2011,160600039,,,,4,1,5
HND-014498,2011,160600040,,,,2,3,5
HND-014499,2011,160600041,,,,9,7,16
HND-014501,2011,160600044,,,,1,2,3
HND-014504,2011,160600072,,,,3,0,3
HND-014507,2011,160600082,,,,17,11,28
HND-014472,2011,160600001,,,,46,38,84
HND-014476,2011,160600006,,,,60,48,108
HND-014480,2011,160600010,,,,15,11,26
HND-014484,2011,160600015,,,,16,9,25
HND-014472,2011,160600001,,,,36,29,65
HND-014484,2011,160600015,,,,7,7,14
HND-014476,2011,160600006,,,,48,32,80
HND-014480,2011,160600010,,,,9,11,20
HND-014472,2011,160600001,,,,27,25,52
HND-014484,2011,160600015,,,,5,4,9
HND-014476,2011,160600006,,,,33,22,55
HND-014480,2011,160600010,,,,5,10,15
HND-014472,2011,160600001,,,,34,28,62
HND-014472,2011,160600001,,,,16,19,35
HND-014472,2011,160600001,,,,8,10,18
HND-014472,2011,160600001,,,,40,44,84
HND-014528,2011,160700019,,,,6,5,11
,2011,160700029,,,,4,5,9
HND-014535,2011,160700032,,,,4,3,7
HND-014534,2011,160700030,,,,2,7,9
,2011,160700031,,,,3,4,7
HND-014522,2011,160700013,,,,3,4,7
HND-014524,2011,160700015,,,,10,6,16
HND-014525,2011,160700016,,,,3,3,6
,2011,160700026,,,,3,6,9
HND-014537,2011,160700049,,,,5,7,12
HND-014527,2011,160700018,,,,3,3,6
HND-014529,2011,160700020,,,,3,2,5
HND-014532,2011,160700025,,,,4,2,6
HND-014536,2011,160700033,,,,3,1,4
HND-014522,2011,160700013,,,,7,4,11
HND-014524,2011,160700015,,,,4,5,9
HND-014525,2011,160700016,,,,5,4,9
HND-014529,2011,160700020,,,,5,6,11
HND-014532,2011,160700025,,,,9,6,15
,2011,160700026,,,,3,5,8
HND-014536,2011,160700033,,,,2,3,5
HND-014518,2011,160700009,,,,1,1,2
HND-014526,2011,160700017,,,,2,4,6
HND-014527,2011,160700018,,,,10,4,14
HND-014537,2011,160700049,,,,2,6,8
HND-014518,2011,160700009,,,,5,2,7
HND-014527,2011,160700018,,,,8,8,16
HND-014522,2011,160700013,,,,5,4,9
HND-014524,2011,160700015,,,,12,4,16
HND-014525,2011,160700016,,,,6,3,9
HND-014526,2011,160700017,,,,7,9,16
HND-014529,2011,160700020,,,,4,4,8
HND-014532,2011,160700025,,,,7,9,16
,2011,160700026,,,,3,1,4
HND-014536,2011,160700033,,,,2,3,5
HND-014537,2011,160700049,,,,5,1,6
HND-014512,2011,160700002,,,,10,16,26
HND-014513,2011,160700003,,,,7,4,11
HND-014516,2011,160700006,,,,13,9,22
HND-014517,2011,160700007,,,,1,1,2
HND-014518,2011,160700009,,,,11,6,17
HND-014521,2011,160700012,,,,2,3,5
HND-014535,2011,160700032,,,,2,1,3
HND-014511,2011,160700001,,,,1,0,1
HND-014514,2011,160700004,,,,7,5,12
HND-014515,2011,160700005,,,,14,22,36
HND-014519,2011,160700010,,,,6,8,14
HND-014520,2011,160700011,,,,2,1,3
HND-014530,2011,160700023,,,,6,8,14
HND-014531,2011,160700024,,,,4,4,8
HND-014533,2011,160700027,,,,4,6,10
HND-014512,2011,160700002,,,,11,13,24
HND-014515,2011,160700005,,,,18,13,31
HND-014518,2011,160700009,,,,7,5,12
HND-014519,2011,160700010,,,,6,7,13
HND-014520,2011,160700011,,,,2,2,4
HND-014521,2011,160700012,,,,3,2,5
HND-014531,2011,160700024,,,,4,5,9
HND-014533,2011,160700027,,,,4,3,7
HND-014535,2011,160700032,,,,1,0,1
HND-014513,2011,160700003,,,,3,6,9
HND-014514,2011,160700004,,,,8,10,18
HND-014516,2011,160700006,,,,13,7,20
HND-014517,2011,160700007,,,,0,3,3
HND-014530,2011,160700023,,,,10,7,17
HND-014514,2011,160700004,,,,9,5,14
HND-014515,2011,160700005,,,,10,12,22
HND-014519,2011,160700010,,,,6,3,9
HND-014530,2011,160700023,,,,7,4,11
HND-014531,2011,160700024,,,,6,1,7
HND-014533,2011,160700027,,,,4,5,9
HND-014535,2011,160700032,,,,1,0,1
HND-014512,2011,160700002,,,,12,13,25
HND-014513,2011,160700003,,,,6,4,10
HND-014516,2011,160700006,,,,6,9,15
HND-014517,2011,160700007,,,,3,2,5
HND-014518,2011,160700009,,,,9,8,17
HND-014512,2011,160700002,,,,17,9,26
HND-014515,2011,160700005,,,,11,16,27
HND-014516,2011,160700006,,,,8,9,17
HND-014518,2011,160700009,,,,11,9,20
HND-014519,2011,160700010,,,,7,6,13
HND-014521,2011,160700012,,,,0,3,3
HND-014531,2011,160700024,,,,3,2,5
HND-014511,2011,160700001,,,,2,0,2
HND-014513,2011,160700003,,,,5,6,11
HND-014514,2011,160700004,,,,11,10,21
HND-014517,2011,160700007,,,,4,2,6
HND-014520,2011,160700011,,,,0,3,3
HND-014530,2011,160700023,,,,8,6,14
HND-014533,2011,160700027,,,,1,1,2
HND-014535,2011,160700032,,,,2,2,4
HND-014512,2011,160700002,,,,18,15,33
HND-014513,2011,160700003,,,,4,4,8
HND-014515,2011,160700005,,,,11,6,17
HND-014516,2011,160700006,,,,13,8,21
HND-014518,2011,160700009,,,,7,3,10
HND-014521,2011,160700012,,,,1,3,4
HND-014531,2011,160700024,,,,5,2,7
HND-014511,2011,160700001,,,,0,1,1
HND-014514,2011,160700004,,,,8,6,14
HND-014517,2011,160700007,,,,0,5,5
HND-014519,2011,160700010,,,,4,6,10
HND-014520,2011,160700011,,,,4,7,11
HND-014530,2011,160700023,,,,8,3,11
HND-014533,2011,160700027,,,,4,4,8
HND-014535,2011,160700032,,,,2,3,5
HND-014511,2011,160700001,,,,0,1,1
HND-014513,2011,160700003,,,,7,5,12
HND-014514,2011,160700004,,,,14,12,26
HND-014516,2011,160700006,,,,7,8,15
HND-014517,2011,160700007,,,,2,1,3
HND-014530,2011,160700023,,,,1,2,3
HND-014512,2011,160700002,,,,14,17,31
HND-014515,2011,160700005,,,,11,16,27
HND-014518,2011,160700009,,,,3,3,6
HND-014519,2011,160700010,,,,5,9,14
HND-014520,2011,160700011,,,,0,3,3
HND-014521,2011,160700012,,,,1,2,3
HND-014531,2011,160700024,,,,4,2,6
HND-014533,2011,160700027,,,,4,1,5
HND-014535,2011,160700032,,,,1,1,2
HND-014513,2011,160700003,,,,16,16,32
HND-014523,2011,160700014,,,,53,53,106
HND-014523,2011,160700014,,,,35,49,84
HND-014513,2011,160700003,,,,22,7,29
HND-014523,2011,160700014,,,,30,34,64
HND-014513,2011,160700003,,,,7,10,17
HND-014523,2011,160700014,,,,17,17,34
HND-014523,2011,160700014,,,,16,14,30
HND-014523,2011,160700014,,,,30,26,56
HND-014554,2011,160800020,,,,9,7,16
HND-014555,2011,160800021,,,,6,6,12
,2011,160800024,,,,3,6,9
,2011,160800048,,,,3,8,11
,2011,160800049,,,,1,4,5
HND-014550,2011,160800015,,,,4,8,12
HND-014551,2011,160800016,,,,6,12,18
,2011,160800019,,,,8,4,12
,2011,160800014,,,,4,2,6
HND-014552,2011,160800017,,,,3,3,6
HND-014553,2011,160800018,,,,2,1,3
HND-014552,2011,160800017,,,,7,5,12
HND-014553,2011,160800018,,,,7,3,10
,2011,160800014,,,,6,9,15
HND-014541,2011,160800004,,,,4,3,7
HND-014542,2011,160800005,,,,6,4,10
HND-014545,2011,160800008,,,,10,14,24
HND-014556,2011,160800022,,,,2,1,3
HND-014538,2011,160800001,,,,4,3,7
HND-014539,2011,160800002,,,,14,15,29
HND-014540,2011,160800003,,,,5,4,9
HND-014543,2011,160800006,,,,4,7,11
HND-014544,2011,160800007,,,,9,11,20
HND-014546,2011,160800009,,,,6,6,12
HND-014548,2011,160800011,,,,4,4,8
HND-014549,2011,160800013,,,,2,2,4
HND-014557,2011,160800023,,,,1,2,3
HND-014538,2011,160800001,,,,4,2,6
HND-014540,2011,160800003,,,,5,2,7
HND-014541,2011,160800004,,,,8,5,13
HND-014544,2011,160800007,,,,9,11,20
HND-014545,2011,160800008,,,,10,4,14
HND-014547,2011,160800010,,,,4,4,8
HND-014548,2011,160800011,,,,2,2,4
HND-014549,2011,160800013,,,,5,2,7
HND-014556,2011,160800022,,,,3,2,5
HND-014557,2011,160800023,,,,1,4,5
HND-014539,2011,160800002,,,,21,10,31
HND-014542,2011,160800005,,,,6,6,12
HND-014543,2011,160800006,,,,8,5,13
HND-014546,2011,160800009,,,,12,11,23
HND-014538,2011,160800001,,,,3,3,6
HND-014539,2011,160800002,,,,16,16,32
HND-014540,2011,160800003,,,,5,5,10
HND-014543,2011,160800006,,,,7,1,8
HND-014544,2011,160800007,,,,18,9,27
HND-014548,2011,160800011,,,,0,1,1
HND-014549,2011,160800013,,,,2,2,4
HND-014557,2011,160800023,,,,2,3,5
HND-014541,2011,160800004,,,,7,6,13
HND-014542,2011,160800005,,,,4,5,9
HND-014545,2011,160800008,,,,6,8,14
HND-014546,2011,160800009,,,,12,10,22
HND-014547,2011,160800010,,,,4,2,6
HND-014556,2011,160800022,,,,3,1,4
HND-014538,2011,160800001,,,,4,2,6
HND-014541,2011,160800004,,,,6,4,10
HND-014544,2011,160800007,,,,9,5,14
HND-014545,2011,160800008,,,,14,8,22
HND-014547,2011,160800010,,,,6,0,6
HND-014548,2011,160800011,,,,0,1,1
HND-014556,2011,160800022,,,,0,2,2
HND-014539,2011,160800002,,,,15,11,26
HND-014540,2011,160800003,,,,1,2,3
HND-014542,2011,160800005,,,,5,7,12
HND-014543,2011,160800006,,,,3,4,7
HND-014546,2011,160800009,,,,2,3,5
HND-014549,2011,160800013,,,,4,3,7
HND-014557,2011,160800023,,,,2,3,5
HND-014538,2011,160800001,,,,3,3,6
HND-014541,2011,160800004,,,,6,3,9
HND-014542,2011,160800005,,,,4,6,10
HND-014545,2011,160800008,,,,6,9,15
HND-014547,2011,160800010,,,,1,1,2
HND-014556,2011,160800022,,,,2,1,3
HND-014539,2011,160800002,,,,10,12,22
HND-014540,2011,160800003,,,,7,2,9
HND-014543,2011,160800006,,,,8,5,13
HND-014544,2011,160800007,,,,11,7,18
HND-014546,2011,160800009,,,,11,10,21
HND-014548,2011,160800011,,,,0,1,1
HND-014549,2011,160800013,,,,5,2,7
HND-014557,2011,160800023,,,,3,1,4
HND-014539,2011,160800002,,,,12,8,20
HND-014542,2011,160800005,,,,5,11,16
HND-014543,2011,160800006,,,,6,3,9
HND-014546,2011,160800009,,,,11,10,21
HND-014538,2011,160800001,,,,2,3,5
HND-014540,2011,160800003,,,,4,1,5
HND-014541,2011,160800004,,,,1,4,5
HND-014544,2011,160800007,,,,6,9,15
HND-014545,2011,160800008,,,,4,3,7
HND-014547,2011,160800010,,,,1,1,2
HND-014549,2011,160800013,,,,0,1,1
HND-014556,2011,160800022,,,,0,1,1
HND-014545,2011,160800008,,,,11,6,17
HND-014539,2011,160800002,,,,20,30,50
HND-014545,2011,160800008,,,,10,6,16
HND-014539,2011,160800002,,,,22,21,43
HND-014539,2011,160800002,,,,12,8,20
,2011,160900042,,,,6,5,11
HND-014584,2011,160900063,,,,3,4,7
HND-014577,2011,160900028,,,,10,12,22
HND-014578,2011,160900034,,,,17,9,26
HND-014581,2011,160900038,,,,11,12,23
,2011,160900039,,,,5,6,11
,2011,160900061,,,,5,4,9
HND-014570,2011,160900011,,,,3,4,7
HND-014571,2011,160900012,,,,2,4,6
HND-014579,2011,160900035,,,,0,1,1
HND-014580,2011,160900036,,,,3,1,4
HND-014570,2011,160900011,,,,9,8,17
HND-014571,2011,160900012,,,,5,6,11
HND-014580,2011,160900036,,,,7,8,15
HND-014569,2011,160900010,,,,3,7,10
HND-014572,2011,160900013,,,,2,2,4
HND-014579,2011,160900035,,,,5,5,10
HND-014569,2011,160900010,,,,28,37,65
HND-014572,2011,160900013,,,,6,4,10
HND-014579,2011,160900035,,,,5,5,10
HND-014580,2011,160900036,,,,9,4,13
HND-014570,2011,160900011,,,,11,10,21
HND-014571,2011,160900012,,,,11,11,22
HND-014561,2011,160900001,,,,14,14,28
HND-014563,2011,160900003,,,,12,10,22
HND-014564,2011,160900004,,,,14,11,25
HND-014566,2011,160900007,,,,4,5,9
HND-014573,2011,160900014,,,,6,6,12
HND-014575,2011,160900016,,,,15,15,30
HND-014562,2011,160900002,,,,37,25,62
HND-014565,2011,160900005,,,,10,11,21
HND-014567,2011,160900008,,,,3,3,6
HND-014568,2011,160900009,,,,2,2,4
HND-014574,2011,160900015,,,,2,7,9
HND-014582,2011,160900041,,,,0,1,1
HND-014583,2011,160900060,,,,2,0,2
HND-014562,2011,160900002,,,,25,23,48
HND-014563,2011,160900003,,,,10,5,15
HND-014565,2011,160900005,,,,8,8,16
HND-014568,2011,160900009,,,,1,6,7
HND-014575,2011,160900016,,,,15,15,30
HND-014582,2011,160900041,,,,3,0,3
HND-014583,2011,160900060,,,,3,1,4
HND-014561,2011,160900001,,,,13,9,22
HND-014564,2011,160900004,,,,15,8,23
HND-014566,2011,160900007,,,,4,5,9
HND-014567,2011,160900008,,,,2,3,5
HND-014573,2011,160900014,,,,6,2,8
HND-014574,2011,160900015,,,,7,6,13
HND-014562,2011,160900002,,,,27,23,50
HND-014565,2011,160900005,,,,13,7,20
HND-014568,2011,160900009,,,,4,3,7
HND-014574,2011,160900015,,,,9,2,11
HND-014575,2011,160900016,,,,15,8,23
HND-014582,2011,160900041,,,,1,1,2
HND-014583,2011,160900060,,,,4,1,5
HND-014561,2011,160900001,,,,12,15,27
HND-014563,2011,160900003,,,,5,9,14
HND-014564,2011,160900004,,,,11,5,16
HND-014566,2011,160900007,,,,9,7,16
HND-014567,2011,160900008,,,,1,1,2
HND-014573,2011,160900014,,,,1,2,3
HND-014561,2011,160900001,,,,14,11,25
HND-014562,2011,160900002,,,,33,26,59
HND-014563,2011,160900003,,,,9,0,9
HND-014566,2011,160900007,,,,7,6,13
HND-014568,2011,160900009,,,,2,2,4
HND-014573,2011,160900014,,,,1,3,4
HND-014575,2011,160900016,,,,11,9,20
HND-014583,2011,160900060,,,,1,0,1
HND-014564,2011,160900004,,,,17,8,25
HND-014565,2011,160900005,,,,8,11,19
HND-014567,2011,160900008,,,,2,0,2
HND-014574,2011,160900015,,,,6,4,10
HND-014582,2011,160900041,,,,1,3,4
HND-014561,2011,160900001,,,,8,15,23
HND-014562,2011,160900002,,,,33,30,63
HND-014563,2011,160900003,,,,8,6,14
HND-014566,2011,160900007,,,,4,7,11
HND-014573,2011,160900014,,,,5,1,6
HND-014575,2011,160900016,,,,5,10,15
HND-014583,2011,160900060,,,,1,3,4
HND-014564,2011,160900004,,,,8,7,15
HND-014565,2011,160900005,,,,8,5,13
HND-014567,2011,160900008,,,,3,4,7
HND-014568,2011,160900009,,,,2,2,4
HND-014574,2011,160900015,,,,10,7,17
HND-014582,2011,160900041,,,,0,1,1
HND-014561,2011,160900001,,,,15,12,27
HND-014564,2011,160900004,,,,8,11,19
HND-014566,2011,160900007,,,,4,4,8
HND-014567,2011,160900008,,,,0,3,3
HND-014573,2011,160900014,,,,1,4,5
HND-014574,2011,160900015,,,,9,8,17
HND-014562,2011,160900002,,,,34,41,75
HND-014563,2011,160900003,,,,9,6,15
HND-014565,2011,160900005,,,,11,11,22
HND-014568,2011,160900009,,,,0,3,3
HND-014575,2011,160900016,,,,5,7,12
HND-014582,2011,160900041,,,,3,5,8
HND-014583,2011,160900060,,,,1,1,2
HND-014561,2011,160900001,,,,16,16,32
HND-014563,2011,160900003,,,,9,10,19
HND-014575,2011,160900016,,,,12,19,31
HND-014565,2011,160900005,,,,8,8,16
HND-014574,2011,160900015,,,,4,3,7
HND-014576,2011,160900017,,,,42,31,73
HND-014563,2011,160900003,,,,1,1,2
HND-014565,2011,160900005,,,,4,7,11
HND-014575,2011,160900016,,,,16,12,28
HND-014561,2011,160900001,,,,7,10,17
HND-014574,2011,160900015,,,,10,10,20
HND-014576,2011,160900017,,,,38,25,63
HND-014563,2011,160900003,,,,4,4,8
HND-014575,2011,160900016,,,,7,13,20
HND-014561,2011,160900001,,,,4,11,15
HND-014565,2011,160900005,,,,4,4,8
HND-014574,2011,160900015,,,,5,9,14
HND-014576,2011,160900017,,,,28,21,49
HND-014576,2011,160900017,,,,32,32,64
HND-014576,2011,160900017,,,,22,30,52
HND-014576,2011,160900017,,,,23,31,54
HND-014602,2011,161000019,,,,15,10,25
,2011,161000041,,,,7,6,13
HND-014598,2011,161000014,,,,15,11,26
HND-014585,2011,161000001,,,,7,0,7
HND-014595,2011,161000011,,,,2,1,3
HND-014596,2011,161000012,,,,8,1,9
HND-014600,2011,161000016,,,,3,1,4
HND-014597,2011,161000013,,,,11,3,14
HND-014601,2011,161000018,,,,2,1,3
HND-014585,2011,161000001,,,,3,4,7
HND-014595,2011,161000011,,,,4,5,9
HND-014600,2011,161000016,,,,4,5,9
HND-014596,2011,161000012,,,,2,4,6
HND-014597,2011,161000013,,,,9,6,15
HND-014601,2011,161000018,,,,5,5,10
HND-014596,2011,161000012,,,,5,7,12
HND-014597,2011,161000013,,,,9,12,21
HND-014601,2011,161000018,,,,6,7,13
HND-014585,2011,161000001,,,,5,5,10
HND-014595,2011,161000011,,,,6,4,10
HND-014600,2011,161000016,,,,1,6,7
HND-014586,2011,161000002,,,,8,13,21
HND-014588,2011,161000004,,,,5,3,8
HND-014590,2011,161000006,,,,14,19,33
HND-014599,2011,161000015,,,,6,5,11
HND-014587,2011,161000003,,,,9,6,15
HND-014589,2011,161000005,,,,5,3,8
HND-014591,2011,161000007,,,,8,7,15
HND-014593,2011,161000009,,,,4,9,13
HND-014594,2011,161000010,,,,1,4,5
HND-014590,2011,161000006,,,,13,16,29
HND-014592,2011,161000008,,,,2,4,6
HND-014593,2011,161000009,,,,4,3,7
HND-014586,2011,161000002,,,,5,5,10
HND-014587,2011,161000003,,,,6,4,10
HND-014588,2011,161000004,,,,4,6,10
HND-014589,2011,161000005,,,,5,6,11
HND-014591,2011,161000007,,,,5,9,14
HND-014594,2011,161000010,,,,3,2,5
HND-014599,2011,161000015,,,,10,10,20
HND-014589,2011,161000005,,,,5,5,10
HND-014591,2011,161000007,,,,11,8,19
HND-014592,2011,161000008,,,,1,0,1
HND-014593,2011,161000009,,,,5,3,8
HND-014594,2011,161000010,,,,0,4,4
HND-014586,2011,161000002,,,,8,10,18
HND-014587,2011,161000003,,,,8,10,18
HND-014588,2011,161000004,,,,3,5,8
HND-014590,2011,161000006,,,,28,21,49
HND-014599,2011,161000015,,,,5,4,9
HND-014590,2011,161000006,,,,15,7,22
HND-014593,2011,161000009,,,,4,3,7
HND-014586,2011,161000002,,,,7,7,14
HND-014587,2011,161000003,,,,6,9,15
HND-014588,2011,161000004,,,,0,5,5
HND-014589,2011,161000005,,,,4,8,12
HND-014591,2011,161000007,,,,7,4,11
HND-014592,2011,161000008,,,,4,4,8
HND-014594,2011,161000010,,,,1,0,1
HND-014599,2011,161000015,,,,6,6,12
HND-014587,2011,161000003,,,,5,5,10
HND-014589,2011,161000005,,,,4,5,9
HND-014591,2011,161000007,,,,10,3,13
HND-014592,2011,161000008,,,,3,1,4
HND-014594,2011,161000010,,,,1,1,2
HND-014586,2011,161000002,,,,13,4,17
HND-014588,2011,161000004,,,,3,2,5
HND-014590,2011,161000006,,,,15,19,34
HND-014593,2011,161000009,,,,6,8,14
HND-014599,2011,161000015,,,,9,8,17
HND-014590,2011,161000006,,,,5,10,15
HND-014592,2011,161000008,,,,0,1,1
HND-014593,2011,161000009,,,,8,7,15
HND-014586,2011,161000002,,,,8,5,13
HND-014587,2011,161000003,,,,7,8,15
HND-014588,2011,161000004,,,,0,1,1
HND-014589,2011,161000005,,,,7,4,11
HND-014591,2011,161000007,,,,7,6,13
HND-014594,2011,161000010,,,,3,1,4
HND-014599,2011,161000015,,,,5,5,10
HND-014586,2011,161000002,,,,10,10,20
HND-014590,2011,161000006,,,,23,31,54
HND-014599,2011,161000015,,,,21,16,37
HND-014590,2011,161000006,,,,15,16,31
HND-014586,2011,161000002,,,,10,8,18
HND-014599,2011,161000015,,,,12,15,27
HND-014586,2011,161000002,,,,9,7,16
HND-014599,2011,161000015,,,,14,6,20
HND-014590,2011,161000006,,,,12,16,28
HND-014630,2011,161100048,,,,0,5,5
,2011,161100064,,,,10,8,18
HND-014632,2011,161100065,,,,3,3,6
HND-014633,2011,161100067,,,,4,2,6
HND-014634,2011,161100068,,,,5,5,10
HND-014636,2011,161100071,,,,8,5,13
,2011,161100072,,,,4,4,8
,2011,161100074,,,,4,3,7
,2011,161100075,,,,3,3,6
,2011,161100077,,,,5,5,10
,2011,161100078,,,,3,4,7
HND-014627,2011,161100025,,,,3,5,8
,2011,161100029,,,,5,4,9
,2011,161100066,,,,3,4,7
HND-014635,2011,161100070,,,,4,4,8
HND-014638,2011,161100076,,,,4,2,6
HND-014639,2011,161100079,,,,7,7,14
HND-014640,2011,161100080,,,,6,3,9
HND-014626,2011,161100023,,,,3,0,3
HND-014624,2011,161100020,,,,2,0,2
HND-014624,2011,161100020,,,,9,7,16
HND-014626,2011,161100023,,,,6,2,8
HND-014623,2011,161100019,,,,9,10,19
HND-014624,2011,161100020,,,,18,21,39
HND-014626,2011,161100023,,,,5,4,9
HND-014623,2011,161100019,,,,17,25,42
HND-014606,2011,161100002,,,,3,2,5
HND-014607,2011,161100003,,,,10,11,21
,2011,161100004,,,,9,6,15
HND-014609,2011,161100005,,,,2,3,5
HND-014611,2011,161100007,,,,9,5,14
HND-014616,2011,161100012,,,,34,27,61
HND-014617,2011,161100013,,,,2,3,5
HND-014618,2011,161100014,,,,32,34,66
HND-014619,2011,161100015,,,,7,2,9
HND-014621,2011,161100017,,,,7,6,13
HND-014622,2011,161100018,,,,11,4,15
HND-014629,2011,161100030,,,,3,3,6
HND-014631,2011,161100063,,,,3,6,9
HND-014605,2011,161100001,,,,6,8,14
HND-014610,2011,161100006,,,,7,10,17
HND-014612,2011,161100008,,,,5,0,5
HND-014613,2011,161100009,,,,2,3,5
HND-014614,2011,161100010,,,,2,4,6
HND-014615,2011,161100011,,,,1,2,3
HND-014620,2011,161100016,,,,1,2,3
HND-014628,2011,161100028,,,,2,2,4
HND-014641,2011,161100081,,,,6,4,10
HND-014607,2011,161100003,,,,6,2,8
HND-014609,2011,161100005,,,,0,4,4
HND-014611,2011,161100007,,,,6,5,11
HND-014612,2011,161100008,,,,2,2,4
HND-014618,2011,161100014,,,,32,34,66
HND-014619,2011,161100015,,,,8,5,13
HND-014622,2011,161100018,,,,3,1,4
HND-014629,2011,161100030,,,,2,4,6
HND-014631,2011,161100063,,,,0,3,3
HND-014641,2011,161100081,,,,0,1,1
HND-014605,2011,161100001,,,,4,1,5
HND-014606,2011,161100002,,,,1,1,2
,2011,161100004,,,,3,6,9
HND-014610,2011,161100006,,,,5,4,9
HND-014613,2011,161100009,,,,3,1,4
HND-014614,2011,161100010,,,,5,9,14
HND-014615,2011,161100011,,,,4,0,4
HND-014616,2011,161100012,,,,33,30,63
HND-014617,2011,161100013,,,,5,1,6
HND-014620,2011,161100016,,,,3,4,7
HND-014621,2011,161100017,,,,6,3,9
HND-014628,2011,161100028,,,,5,4,9
HND-014606,2011,161100002,,,,3,3,6
HND-014607,2011,161100003,,,,3,3,6
,2011,161100004,,,,6,7,13
HND-014609,2011,161100005,,,,3,3,6
HND-014611,2011,161100007,,,,5,5,10
HND-014612,2011,161100008,,,,2,3,5
HND-014616,2011,161100012,,,,28,21,49
HND-014617,2011,161100013,,,,4,6,10
HND-014618,2011,161100014,,,,40,32,72
HND-014619,2011,161100015,,,,6,3,9
HND-014621,2011,161100017,,,,7,4,11
HND-014622,2011,161100018,,,,4,3,7
HND-014629,2011,161100030,,,,3,1,4
HND-014631,2011,161100063,,,,1,2,3
HND-014605,2011,161100001,,,,7,4,11
HND-014610,2011,161100006,,,,6,6,12
HND-014613,2011,161100009,,,,2,0,2
HND-014614,2011,161100010,,,,4,3,7
HND-014615,2011,161100011,,,,0,2,2
HND-014628,2011,161100028,,,,2,1,3
HND-014609,2011,161100005,,,,2,2,4
HND-014612,2011,161100008,,,,2,2,4
HND-014613,2011,161100009,,,,1,1,2
HND-014618,2011,161100014,,,,30,34,64
HND-014622,2011,161100018,,,,5,5,10
HND-014628,2011,161100028,,,,3,3,6
HND-014629,2011,161100030,,,,4,3,7
HND-014631,2011,161100063,,,,1,3,4
HND-014605,2011,161100001,,,,6,5,11
HND-014606,2011,161100002,,,,1,0,1
HND-014607,2011,161100003,,,,3,10,13
,2011,161100004,,,,8,8,16
HND-014610,2011,161100006,,,,5,6,11
HND-014611,2011,161100007,,,,7,0,7
HND-014614,2011,161100010,,,,1,3,4
HND-014615,2011,161100011,,,,1,3,4
HND-014616,2011,161100012,,,,18,31,49
HND-014617,2011,161100013,,,,4,5,9
HND-014619,2011,161100015,,,,3,4,7
HND-014620,2011,161100016,,,,1,3,4
HND-014621,2011,161100017,,,,2,3,5
HND-014641,2011,161100081,,,,1,0,1
HND-014612,2011,161100008,,,,3,1,4
HND-014613,2011,161100009,,,,2,4,6
HND-014614,2011,161100010,,,,7,5,12
HND-014615,2011,161100011,,,,3,0,3
HND-014618,2011,161100014,,,,44,41,85
HND-014620,2011,161100016,,,,2,3,5
HND-014628,2011,161100028,,,,5,3,8
HND-014629,2011,161100030,,,,3,2,5
HND-014605,2011,161100001,,,,10,5,15
HND-014606,2011,161100002,,,,1,3,4
HND-014607,2011,161100003,,,,3,1,4
,2011,161100004,,,,8,8,16
HND-014609,2011,161100005,,,,4,5,9
HND-014610,2011,161100006,,,,6,4,10
HND-014611,2011,161100007,,,,6,3,9
HND-014616,2011,161100012,,,,12,10,22
HND-014617,2011,161100013,,,,3,3,6
HND-014619,2011,161100015,,,,3,2,5
HND-014621,2011,161100017,,,,3,4,7
HND-014622,2011,161100018,,,,4,5,9
HND-014631,2011,161100063,,,,2,5,7
HND-014641,2011,161100081,,,,0,1,1
HND-014605,2011,161100001,,,,8,7,15
HND-014606,2011,161100002,,,,1,2,3
,2011,161100004,,,,15,4,19
HND-014610,2011,161100006,,,,7,6,13
HND-014613,2011,161100009,,,,1,1,2
HND-014614,2011,161100010,,,,3,3,6
HND-014615,2011,161100011,,,,1,2,3
HND-014616,2011,161100012,,,,26,24,50
HND-014617,2011,161100013,,,,5,6,11
HND-014620,2011,161100016,,,,3,0,3
HND-014621,2011,161100017,,,,2,4,6
HND-014628,2011,161100028,,,,1,3,4
HND-014607,2011,161100003,,,,4,3,7
HND-014609,2011,161100005,,,,0,3,3
HND-014611,2011,161100007,,,,3,6,9
HND-014612,2011,161100008,,,,0,2,2
HND-014618,2011,161100014,,,,31,36,67
HND-014619,2011,161100015,,,,3,5,8
HND-014622,2011,161100018,,,,4,3,7
HND-014629,2011,161100030,,,,1,2,3
HND-014631,2011,161100063,,,,3,4,7
HND-014641,2011,161100081,,,,1,1,2
HND-014616,2011,161100012,,,,17,20,37
HND-014625,2011,161100021,,,,40,26,66
HND-014625,2011,161100021,,,,25,23,48
HND-014616,2011,161100012,,,,7,9,16
HND-014625,2011,161100021,,,,36,18,54
HND-014616,2011,161100012,,,,16,15,31
HND-014625,2011,161100021,,,,10,10,20
HND-014625,2011,161100021,,,,4,11,15
HND-014625,2011,161100021,,,,9,10,19
HND-014711,2011,161200110,,,,6,9,15
,2011,161200112,,,,7,5,12
HND-014713,2011,161200113,,,,9,8,17
HND-014714,2011,161200114,,,,8,10,18
,2011,161200119,,,,2,4,6
,2011,161200121,,,,6,3,9
HND-014720,2011,161200128,,,,6,4,10
,2011,161200131,,,,5,6,11
,2011,161200135,,,,7,4,11
,2011,161200138,,,,6,2,8
HND-014725,2011,161200141,,,,7,8,15
,2011,161200142,,,,5,5,10
,2011,161200152,,,,6,2,8
HND-014730,2011,161200154,,,,6,4,10
,2011,161200102,,,,6,4,10
HND-014709,2011,161200108,,,,5,5,10
HND-014710,2011,161200109,,,,7,8,15
HND-014712,2011,161200111,,,,2,4,6
HND-014715,2011,161200115,,,,1,5,6
,2011,161200118,,,,1,7,8
,2011,161200120,,,,6,4,10
HND-014717,2011,161200122,,,,2,4,6
,2011,161200129,,,,5,4,9
,2011,161200130,,,,8,15,23
HND-014721,2011,161200132,,,,3,6,9
HND-014722,2011,161200134,,,,3,4,7
,2011,161200136,,,,4,9,13
,2011,161200137,,,,5,5,10
,2011,161200139,,,,3,4,7
HND-014726,2011,161200144,,,,7,4,11
,2011,161200145,,,,13,9,22
,2011,161200146,,,,3,5,8
HND-014727,2011,161200147,,,,9,5,14
,2011,161200148,,,,5,8,13
HND-014728,2011,161200151,,,,3,5,8
,2011,161200155,,,,7,4,11
,2011,161200156,,,,9,7,16
HND-014731,2011,161200157,,,,7,11,18
HND-014706,2011,161200083,,,,0,4,4
HND-014708,2011,161200106,,,,4,4,8
HND-014701,2011,161200067,,,,2,2,4
HND-014686,2011,161200049,,,,4,3,7
,2011,161200058,,,,9,8,17
HND-014701,2011,161200067,,,,6,1,7
HND-014718,2011,161200125,,,,13,9,22
HND-014682,2011,161200044,,,,0,3,3
HND-014684,2011,161200046,,,,6,8,14
,2011,161200047,,,,6,1,7
HND-014685,2011,161200048,,,,3,5,8
HND-014692,2011,161200055,,,,12,12,24
,2011,161200056,,,,7,7,14
HND-014703,2011,161200071,,,,6,5,11
HND-014705,2011,161200082,,,,8,5,13
HND-014706,2011,161200083,,,,4,2,6
HND-014708,2011,161200106,,,,3,1,4
,2011,161200124,,,,9,7,16
HND-014681,2011,161200043,,,,25,25,50
HND-014682,2011,161200044,,,,20,25,45
HND-014683,2011,161200045,,,,30,28,58
HND-014684,2011,161200046,,,,11,9,20
,2011,161200047,,,,8,3,11
HND-014685,2011,161200048,,,,7,14,21
HND-014692,2011,161200055,,,,14,12,26
,2011,161200058,,,,9,10,19
HND-014701,2011,161200067,,,,4,6,10
HND-014703,2011,161200071,,,,23,13,36
HND-014706,2011,161200083,,,,3,7,10
,2011,161200107,,,,9,13,22
,2011,161200124,,,,10,9,19
HND-014680,2011,161200042,,,,14,14,28
HND-014686,2011,161200049,,,,6,12,18
,2011,161200056,,,,7,6,13
HND-014705,2011,161200082,,,,6,6,12
HND-014708,2011,161200106,,,,3,4,7
HND-014718,2011,161200125,,,,14,16,30
HND-014642,2011,161200001,,,,3,8,11
HND-014644,2011,161200003,,,,2,5,7
HND-014645,2011,161200004,,,,4,4,8
HND-014647,2011,161200006,,,,8,7,15
HND-014648,2011,161200007,,,,2,0,2
HND-014653,2011,161200012,,,,9,3,12
HND-014654,2011,161200013,,,,15,21,36
HND-014655,2011,161200014,,,,54,57,111
HND-014656,2011,161200015,,,,19,12,31
HND-014658,2011,161200017,,,,41,31,72
HND-014659,2011,161200018,,,,57,67,124
HND-014661,2011,161200020,,,,17,19,36
HND-014662,2011,161200021,,,,10,16,26
,2011,161200022,,,,40,30,70
HND-014665,2011,161200024,,,,4,8,12
HND-014667,2011,161200026,,,,41,32,73
HND-014670,2011,161200029,,,,5,6,11
,2011,161200032,,,,3,3,6
,2011,161200033,,,,10,7,17
HND-014673,2011,161200034,,,,7,3,10
,2011,161200035,,,,3,5,8
HND-014676,2011,161200037,,,,6,2,8
HND-014677,2011,161200038,,,,4,5,9
HND-014679,2011,161200040,,,,1,4,5
HND-014695,2011,161200059,,,,5,3,8
HND-014698,2011,161200063,,,,4,5,9
HND-014702,2011,161200068,,,,7,3,10
HND-014704,2011,161200081,,,,4,4,8
HND-014719,2011,161200126,,,,12,11,23
HND-014643,2011,161200002,,,,30,35,65
,2011,161200005,,,,17,8,25
HND-014649,2011,161200008,,,,5,6,11
HND-014650,2011,161200009,,,,3,4,7
HND-014651,2011,161200010,,,,2,6,8
HND-014652,2011,161200011,,,,20,20,40
HND-014657,2011,161200016,,,,16,18,34
HND-014660,2011,161200019,,,,12,26,38
HND-014664,2011,161200023,,,,2,1,3
HND-014666,2011,161200025,,,,5,4,9
,2011,161200027,,,,13,5,18
HND-014669,2011,161200028,,,,4,4,8
,2011,161200030,,,,4,2,6
HND-014671,2011,161200031,,,,2,4,6
HND-014675,2011,161200036,,,,3,4,7
HND-014678,2011,161200039,,,,1,3,4
HND-014691,2011,161200054,,,,5,4,9
HND-014696,2011,161200061,,,,6,4,10
HND-014697,2011,161200062,,,,21,14,35
HND-014699,2011,161200064,,,,9,4,13
HND-014700,2011,161200065,,,,0,3,3
,2011,161200084,,,,1,2,3
HND-014707,2011,161200085,,,,6,5,11
,2011,161200107,,,,10,5,15
,2011,161200158,,,,3,3,6
HND-014642,2011,161200001,,,,3,3,6
HND-014643,2011,161200002,,,,29,30,59
HND-014647,2011,161200006,,,,6,2,8
HND-014650,2011,161200009,,,,1,6,7
HND-014651,2011,161200010,,,,1,5,6
HND-014652,2011,161200011,,,,23,15,38
HND-014653,2011,161200012,,,,6,3,9
HND-014655,2011,161200014,,,,38,29,67
HND-014657,2011,161200016,,,,16,15,31
HND-014669,2011,161200028,,,,6,9,15
HND-014670,2011,161200029,,,,3,6,9
,2011,161200030,,,,2,1,3
HND-014671,2011,161200031,,,,5,1,6
,2011,161200032,,,,0,1,1
,2011,161200033,,,,11,5,16
HND-014673,2011,161200034,,,,9,2,11
HND-014675,2011,161200036,,,,3,7,10
HND-014676,2011,161200037,,,,3,3,6
HND-014691,2011,161200054,,,,2,7,9
HND-014696,2011,161200061,,,,4,1,5
HND-014697,2011,161200062,,,,15,16,31
HND-014698,2011,161200063,,,,3,6,9
HND-014699,2011,161200064,,,,3,6,9
HND-014707,2011,161200085,,,,4,6,10
,2011,161200102,,,,5,0,5
HND-014719,2011,161200126,,,,7,16,23
HND-014644,2011,161200003,,,,4,5,9
HND-014645,2011,161200004,,,,7,3,10
,2011,161200005,,,,10,7,17
HND-014648,2011,161200007,,,,1,3,4
HND-014649,2011,161200008,,,,4,2,6
HND-014654,2011,161200013,,,,17,12,29
HND-014656,2011,161200015,,,,15,18,33
HND-014658,2011,161200017,,,,35,39,74
HND-014659,2011,161200018,,,,52,40,92
HND-014660,2011,161200019,,,,17,15,32
HND-014661,2011,161200020,,,,15,19,34
HND-014662,2011,161200021,,,,6,7,13
,2011,161200022,,,,29,29,58
HND-014664,2011,161200023,,,,3,3,6
HND-014665,2011,161200024,,,,4,1,5
HND-014666,2011,161200025,,,,11,4,15
HND-014667,2011,161200026,,,,32,34,66
,2011,161200027,,,,9,2,11
,2011,161200035,,,,7,2,9
HND-014677,2011,161200038,,,,3,4,7
HND-014678,2011,161200039,,,,1,2,3
HND-014679,2011,161200040,,,,3,2,5
HND-014695,2011,161200059,,,,3,3,6
HND-014700,2011,161200065,,,,3,1,4
HND-014702,2011,161200068,,,,5,1,6
HND-014704,2011,161200081,,,,3,4,7
,2011,161200084,,,,3,1,4
,2011,161200107,,,,9,13,22
,2011,161200158,,,,3,5,8
HND-014643,2011,161200002,,,,28,32,60
HND-014649,2011,161200008,,,,5,1,6
HND-014650,2011,161200009,,,,1,5,6
HND-014651,2011,161200010,,,,6,3,9
HND-014652,2011,161200011,,,,14,16,30
HND-014657,2011,161200016,,,,12,13,25
HND-014660,2011,161200019,,,,8,9,17
HND-014664,2011,161200023,,,,4,1,5
HND-014666,2011,161200025,,,,2,3,5
,2011,161200027,,,,10,3,13
HND-014669,2011,161200028,,,,5,5,10
HND-014670,2011,161200029,,,,7,4,11
,2011,161200030,,,,4,3,7
HND-014671,2011,161200031,,,,2,2,4
HND-014673,2011,161200034,,,,1,3,4
HND-014675,2011,161200036,,,,6,2,8
HND-014678,2011,161200039,,,,3,6,9
HND-014691,2011,161200054,,,,14,6,20
HND-014696,2011,161200061,,,,8,3,11
HND-014697,2011,161200062,,,,23,11,34
HND-014699,2011,161200064,,,,8,8,16
HND-014700,2011,161200065,,,,2,3,5
,2011,161200084,,,,4,3,7
HND-014707,2011,161200085,,,,5,3,8
,2011,161200107,,,,6,6,12
HND-014642,2011,161200001,,,,7,5,12
HND-014644,2011,161200003,,,,6,4,10
HND-014645,2011,161200004,,,,12,9,21
,2011,161200005,,,,12,11,23
HND-014647,2011,161200006,,,,4,4,8
HND-014648,2011,161200007,,,,6,2,8
HND-014653,2011,161200012,,,,5,6,11
HND-014654,2011,161200013,,,,12,17,29
HND-014655,2011,161200014,,,,40,29,69
HND-014656,2011,161200015,,,,12,16,28
HND-014658,2011,161200017,,,,34,31,65
HND-014659,2011,161200018,,,,36,35,71
HND-014661,2011,161200020,,,,11,30,41
HND-014662,2011,161200021,,,,4,5,9
,2011,161200022,,,,25,13,38
HND-014665,2011,161200024,,,,4,4,8
HND-014667,2011,161200026,,,,16,17,33
,2011,161200032,,,,1,0,1
,2011,161200033,,,,9,9,18
HND-014676,2011,161200037,,,,4,0,4
HND-014677,2011,161200038,,,,0,3,3
HND-014679,2011,161200040,,,,6,1,7
HND-014695,2011,161200059,,,,3,1,4
HND-014698,2011,161200063,,,,1,1,2
HND-014702,2011,161200068,,,,5,6,11
HND-014704,2011,161200081,,,,4,2,6
,2011,161200102,,,,3,0,3
HND-014719,2011,161200126,,,,13,10,23
,2011,161200158,,,,5,4,9
HND-014642,2011,161200001,,,,3,5,8
HND-014647,2011,161200006,,,,2,4,6
HND-014650,2011,161200009,,,,4,5,9
HND-014651,2011,161200010,,,,1,2,3
HND-014652,2011,161200011,,,,9,10,19
HND-014653,2011,161200012,,,,4,8,12
HND-014654,2011,161200013,,,,16,13,29
HND-014655,2011,161200014,,,,32,39,71
HND-014657,2011,161200016,,,,14,10,24
HND-014658,2011,161200017,,,,29,29,58
HND-014661,2011,161200020,,,,19,15,34
HND-014662,2011,161200021,,,,2,2,4
HND-014667,2011,161200026,,,,27,24,51
HND-014670,2011,161200029,,,,5,1,6
,2011,161200030,,,,1,3,4
HND-014671,2011,161200031,,,,1,2,3
,2011,161200032,,,,1,1,2
,2011,161200033,,,,5,5,10
HND-014673,2011,161200034,,,,5,4,9
,2011,161200035,,,,1,2,3
HND-014676,2011,161200037,,,,1,1,2
HND-014691,2011,161200054,,,,10,12,22
HND-014697,2011,161200062,,,,23,21,44
HND-014698,2011,161200063,,,,4,2,6
HND-014699,2011,161200064,,,,4,10,14
HND-014707,2011,161200085,,,,2,6,8
,2011,161200102,,,,7,0,7
HND-014719,2011,161200126,,,,14,6,20
HND-014643,2011,161200002,,,,39,28,67
HND-014644,2011,161200003,,,,5,5,10
HND-014645,2011,161200004,,,,4,4,8
,2011,161200005,,,,5,11,16
HND-014648,2011,161200007,,,,2,3,5
HND-014649,2011,161200008,,,,2,2,4
HND-014656,2011,161200015,,,,17,12,29
HND-014659,2011,161200018,,,,35,31,66
HND-014660,2011,161200019,,,,9,28,37
,2011,161200022,,,,19,18,37
HND-014664,2011,161200023,,,,1,2,3
HND-014665,2011,161200024,,,,1,2,3
HND-014666,2011,161200025,,,,6,5,11
,2011,161200027,,,,4,6,10
HND-014669,2011,161200028,,,,2,2,4
HND-014675,2011,161200036,,,,1,4,5
HND-014677,2011,161200038,,,,1,4,5
HND-014678,2011,161200039,,,,2,1,3
HND-014679,2011,161200040,,,,3,1,4
HND-014695,2011,161200059,,,,1,5,6
HND-014696,2011,161200061,,,,5,4,9
HND-014700,2011,161200065,,,,1,0,1
HND-014702,2011,161200068,,,,3,3,6
HND-014704,2011,161200081,,,,2,2,4
,2011,161200084,,,,0,3,3
,2011,161200107,,,,4,8,12
,2011,161200158,,,,6,3,9
HND-014643,2011,161200002,,,,36,28,64
HND-014644,2011,161200003,,,,5,7,12
,2011,161200005,,,,8,11,19
HND-014648,2011,161200007,,,,2,1,3
HND-014649,2011,161200008,,,,3,3,6
HND-014650,2011,161200009,,,,5,5,10
HND-014657,2011,161200016,,,,12,12,24
HND-014659,2011,161200018,,,,52,57,109
HND-014660,2011,161200019,,,,4,9,13
,2011,161200022,,,,11,20,31
HND-014664,2011,161200023,,,,0,3,3
HND-014665,2011,161200024,,,,8,2,10
HND-014666,2011,161200025,,,,2,7,9
,2011,161200027,,,,3,3,6
HND-014669,2011,161200028,,,,5,0,5
,2011,161200032,,,,0,1,1
,2011,161200033,,,,7,3,10
HND-014673,2011,161200034,,,,2,3,5
,2011,161200035,,,,2,0,2
HND-014676,2011,161200037,,,,2,0,2
HND-014677,2011,161200038,,,,0,2,2
HND-014695,2011,161200059,,,,2,2,4
HND-014696,2011,161200061,,,,6,4,10
HND-014700,2011,161200065,,,,3,1,4
HND-014719,2011,161200126,,,,9,6,15
HND-014642,2011,161200001,,,,7,3,10
HND-014645,2011,161200004,,,,7,16,23
HND-014647,2011,161200006,,,,3,4,7
HND-014651,2011,161200010,,,,5,2,7
HND-014652,2011,161200011,,,,18,10,28
HND-014653,2011,161200012,,,,12,8,20
HND-014654,2011,161200013,,,,12,16,28
HND-014655,2011,161200014,,,,38,46,84
HND-014656,2011,161200015,,,,16,15,31
HND-014658,2011,161200017,,,,28,45,73
HND-014661,2011,161200020,,,,16,15,31
HND-014662,2011,161200021,,,,3,1,4
HND-014667,2011,161200026,,,,29,30,59
HND-014670,2011,161200029,,,,3,6,9
,2011,161200030,,,,3,2,5
HND-014671,2011,161200031,,,,1,4,5
HND-014678,2011,161200039,,,,3,3,6
HND-014679,2011,161200040,,,,5,3,8
HND-014691,2011,161200054,,,,13,11,24
HND-014697,2011,161200062,,,,21,13,34
HND-014698,2011,161200063,,,,0,1,1
HND-014699,2011,161200064,,,,3,3,6
HND-014702,2011,161200068,,,,5,6,11
HND-014704,2011,161200081,,,,4,2,6
,2011,161200084,,,,1,2,3
HND-014707,2011,161200085,,,,3,6,9
,2011,161200107,,,,5,9,14
,2011,161200158,,,,2,2,4
HND-014642,2011,161200001,,,,3,0,3
HND-014643,2011,161200002,,,,45,23,68
HND-014647,2011,161200006,,,,3,4,7
HND-014650,2011,161200009,,,,8,3,11
HND-014651,2011,161200010,,,,5,2,7
HND-014652,2011,161200011,,,,16,10,26
HND-014653,2011,161200012,,,,4,7,11
HND-014655,2011,161200014,,,,31,39,70
HND-014657,2011,161200016,,,,15,11,26
HND-014669,2011,161200028,,,,3,6,9
HND-014670,2011,161200029,,,,9,5,14
,2011,161200035,,,,3,0,3
HND-014677,2011,161200038,,,,1,0,1
HND-014678,2011,161200039,,,,4,1,5
HND-014679,2011,161200040,,,,5,1,6
HND-014695,2011,161200059,,,,3,2,5
HND-014696,2011,161200061,,,,4,5,9
HND-014697,2011,161200062,,,,18,19,37
HND-014698,2011,161200063,,,,2,6,8
HND-014704,2011,161200081,,,,0,7,7
,2011,161200084,,,,0,4,4
,2011,161200107,,,,11,15,26
,2011,161200158,,,,2,4,6
HND-014644,2011,161200003,,,,7,4,11
HND-014645,2011,161200004,,,,7,12,19
,2011,161200005,,,,10,17,27
HND-014648,2011,161200007,,,,1,0,1
HND-014649,2011,161200008,,,,5,4,9
HND-014654,2011,161200013,,,,13,13,26
HND-014656,2011,161200015,,,,22,10,32
HND-014658,2011,161200017,,,,39,40,79
HND-014659,2011,161200018,,,,54,46,100
HND-014660,2011,161200019,,,,5,6,11
HND-014661,2011,161200020,,,,28,13,41
HND-014662,2011,161200021,,,,1,1,2
,2011,161200022,,,,10,14,24
HND-014664,2011,161200023,,,,0,4,4
HND-014665,2011,161200024,,,,6,5,11
HND-014666,2011,161200025,,,,5,7,12
HND-014667,2011,161200026,,,,30,21,51
,2011,161200027,,,,7,4,11
,2011,161200030,,,,2,4,6
HND-014671,2011,161200031,,,,2,1,3
,2011,161200032,,,,3,5,8
,2011,161200033,,,,6,2,8
HND-014673,2011,161200034,,,,1,4,5
HND-014675,2011,161200036,,,,3,5,8
HND-014676,2011,161200037,,,,0,1,1
HND-014691,2011,161200054,,,,10,6,16
HND-014700,2011,161200065,,,,4,2,6
HND-014702,2011,161200068,,,,5,3,8
HND-014707,2011,161200085,,,,6,2,8
,2011,161200102,,,,8,1,9
HND-014719,2011,161200126,,,,10,15,25
HND-014667,2011,161200026,,,,14,17,31
,2011,161200050,,,,62,75,137
HND-014689,2011,161200052,,,,53,58,111
HND-014690,2011,161200053,,,,66,70,136
HND-014697,2011,161200062,,,,17,15,32
,2011,161200101,,,,4,3,7
HND-014652,2011,161200011,,,,20,18,38
,2011,161200104,,,,3,2,5
HND-014667,2011,161200026,,,,19,17,36
,2011,161200050,,,,44,65,109
HND-014690,2011,161200053,,,,50,55,105
,2011,161200101,,,,2,1,3
HND-014652,2011,161200011,,,,9,14,23
HND-014689,2011,161200052,,,,30,61,91
HND-014697,2011,161200062,,,,4,13,17
HND-014652,2011,161200011,,,,12,14,26
HND-014667,2011,161200026,,,,4,12,16
HND-014697,2011,161200062,,,,9,12,21
,2011,161200104,,,,3,3,6
,2011,161200050,,,,38,53,91
HND-014689,2011,161200052,,,,42,37,79
HND-014690,2011,161200053,,,,35,42,77
,2011,161200101,,,,5,3,8
,2011,161200050,,,,27,35,62
HND-014688,2011,161200051,,,,111,1,112
HND-014689,2011,161200052,,,,18,29,47
HND-014690,2011,161200053,,,,25,29,54
,2011,161200104,,,,6,12,18
,2011,161200050,,,,17,27,44
HND-014688,2011,161200051,,,,109,3,112
HND-014689,2011,161200052,,,,9,19,28
HND-014690,2011,161200053,,,,7,24,31
,2011,161200101,,,,6,7,13
,2011,161200104,,,,9,16,25
,2011,161200104,,,,2,4,6
,2011,161200050,,,,25,26,51
HND-014688,2011,161200051,,,,90,4,94
HND-014689,2011,161200052,,,,12,19,31
HND-014690,2011,161200053,,,,9,15,24
,2011,161200101,,,,3,3,6
HND-014771,2011,161300045,,,,6,10,16
,2011,161300047,,,,6,9,15
HND-014773,2011,161300049,,,,9,9,18
HND-014775,2011,161300093,,,,6,6,12
HND-014776,2011,161300095,,,,9,2,11
HND-014778,2011,161300100,,,,2,4,6
HND-014779,2011,161300101,,,,3,6,9
HND-014780,2011,161300102,,,,7,5,12
,2011,161300103,,,,2,4,6
,2011,161300109,,,,9,7,16
,2011,161300111,,,,3,4,7
HND-014770,2011,161300044,,,,5,5,10
HND-014772,2011,161300046,,,,7,8,15
,2011,161300096,,,,4,4,8
,2011,161300104,,,,9,3,12
HND-014781,2011,161300105,,,,3,7,10
,2011,161300106,,,,8,12,20
,2011,161300107,,,,7,1,8
,2011,161300108,,,,4,5,9
HND-014782,2011,161300110,,,,10,13,23
HND-014755,2011,161300024,,,,1,2,3
,2011,161300023,,,,0,3,3
HND-014753,2011,161300021,,,,8,12,20
,2011,161300023,,,,5,3,8
HND-014755,2011,161300024,,,,6,4,10
HND-014762,2011,161300034,,,,5,4,9
HND-014773,2011,161300049,,,,4,5,9
HND-014753,2011,161300021,,,,30,27,57
,2011,161300023,,,,8,2,10
HND-014755,2011,161300024,,,,5,3,8
HND-014762,2011,161300034,,,,5,9,14
HND-014773,2011,161300049,,,,1,5,6
HND-014733,2011,161300001,,,,25,29,54
HND-014735,2011,161300003,,,,5,9,14
HND-014737,2011,161300005,,,,10,9,19
HND-014739,2011,161300007,,,,2,3,5
HND-014740,2011,161300008,,,,11,9,20
HND-014741,2011,161300009,,,,2,2,4
HND-014742,2011,161300010,,,,28,32,60
HND-014745,2011,161300013,,,,7,1,8
HND-014747,2011,161300015,,,,6,8,14
HND-014749,2011,161300017,,,,2,4,6
HND-014750,2011,161300018,,,,4,4,8
HND-014752,2011,161300020,,,,0,2,2
HND-014757,2011,161300027,,,,11,9,20
HND-014759,2011,161300031,,,,6,6,12
HND-014763,2011,161300036,,,,2,3,5
HND-014765,2011,161300038,,,,6,3,9
HND-014768,2011,161300041,,,,7,3,10
HND-014774,2011,161300091,,,,2,0,2
HND-014734,2011,161300002,,,,3,2,5
HND-014736,2011,161300004,,,,5,8,13
HND-014738,2011,161300006,,,,3,2,5
HND-014743,2011,161300011,,,,10,8,18
HND-014744,2011,161300012,,,,7,6,13
HND-014746,2011,161300014,,,,1,1,2
HND-014748,2011,161300016,,,,3,5,8
HND-014751,2011,161300019,,,,5,5,10
HND-014756,2011,161300025,,,,7,3,10
HND-014758,2011,161300028,,,,3,6,9
HND-014760,2011,161300032,,,,5,5,10
HND-014761,2011,161300033,,,,14,8,22
HND-014764,2011,161300037,,,,2,1,3
HND-014766,2011,161300039,,,,6,16,22
HND-014767,2011,161300040,,,,2,4,6
HND-014769,2011,161300042,,,,9,3,12
HND-014777,2011,161300098,,,,2,4,6
HND-014733,2011,161300001,,,,45,18,63
HND-014734,2011,161300002,,,,5,3,8
HND-014735,2011,161300003,,,,11,9,20
HND-014736,2011,161300004,,,,9,9,18
HND-014737,2011,161300005,,,,12,9,21
HND-014739,2011,161300007,,,,2,6,8
HND-014742,2011,161300010,,,,21,31,52
HND-014743,2011,161300011,,,,24,4,28
HND-014744,2011,161300012,,,,5,6,11
HND-014745,2011,161300013,,,,5,2,7
HND-014746,2011,161300014,,,,2,1,3
HND-014747,2011,161300015,,,,6,3,9
HND-014748,2011,161300016,,,,4,0,4
HND-014749,2011,161300017,,,,2,3,5
HND-014752,2011,161300020,,,,3,3,6
HND-014761,2011,161300033,,,,13,12,25
HND-014764,2011,161300037,,,,4,0,4
HND-014765,2011,161300038,,,,3,2,5
HND-014767,2011,161300040,,,,2,3,5
HND-014768,2011,161300041,,,,5,5,10
HND-014774,2011,161300091,,,,1,1,2
HND-014738,2011,161300006,,,,3,1,4
HND-014740,2011,161300008,,,,11,3,14
HND-014741,2011,161300009,,,,5,2,7
HND-014750,2011,161300018,,,,4,2,6
HND-014751,2011,161300019,,,,13,3,16
HND-014756,2011,161300025,,,,2,5,7
HND-014757,2011,161300027,,,,7,3,10
HND-014758,2011,161300028,,,,4,3,7
HND-014759,2011,161300031,,,,2,4,6
HND-014760,2011,161300032,,,,6,4,10
HND-014763,2011,161300036,,,,1,1,2
HND-014769,2011,161300042,,,,3,4,7
HND-014777,2011,161300098,,,,2,4,6
HND-014734,2011,161300002,,,,5,7,12
HND-014735,2011,161300003,,,,5,7,12
HND-014736,2011,161300004,,,,7,4,11
HND-014738,2011,161300006,,,,0,3,3
HND-014743,2011,161300011,,,,7,8,15
HND-014744,2011,161300012,,,,6,2,8
HND-014746,2011,161300014,,,,2,0,2
HND-014748,2011,161300016,,,,1,2,3
HND-014758,2011,161300028,,,,8,2,10
HND-014760,2011,161300032,,,,11,1,12
HND-014761,2011,161300033,,,,10,8,18
HND-014764,2011,161300037,,,,1,3,4
HND-014765,2011,161300038,,,,3,2,5
HND-014767,2011,161300040,,,,4,1,5
HND-014769,2011,161300042,,,,2,0,2
HND-014777,2011,161300098,,,,7,3,10
HND-014733,2011,161300001,,,,28,23,51
HND-014737,2011,161300005,,,,8,20,28
HND-014739,2011,161300007,,,,2,2,4
HND-014740,2011,161300008,,,,8,5,13
HND-014741,2011,161300009,,,,2,2,4
HND-014742,2011,161300010,,,,20,22,42
HND-014745,2011,161300013,,,,9,5,14
HND-014747,2011,161300015,,,,6,7,13
HND-014749,2011,161300017,,,,7,9,16
HND-014750,2011,161300018,,,,1,1,2
HND-014751,2011,161300019,,,,6,4,10
HND-014752,2011,161300020,,,,1,1,2
HND-014756,2011,161300025,,,,2,1,3
HND-014757,2011,161300027,,,,4,5,9
HND-014759,2011,161300031,,,,5,6,11
HND-014763,2011,161300036,,,,2,4,6
HND-014768,2011,161300041,,,,5,3,8
HND-014774,2011,161300091,,,,2,1,3
HND-014733,2011,161300001,,,,30,28,58
HND-014734,2011,161300002,,,,4,3,7
HND-014735,2011,161300003,,,,7,7,14
HND-014736,2011,161300004,,,,4,4,8
HND-014737,2011,161300005,,,,9,11,20
HND-014739,2011,161300007,,,,8,6,14
HND-014740,2011,161300008,,,,1,2,3
HND-014742,2011,161300010,,,,17,32,49
HND-014744,2011,161300012,,,,5,5,10
HND-014745,2011,161300013,,,,5,8,13
HND-014746,2011,161300014,,,,1,2,3
HND-014747,2011,161300015,,,,7,5,12
HND-014749,2011,161300017,,,,4,3,7
HND-014750,2011,161300018,,,,3,0,3
HND-014752,2011,161300020,,,,3,1,4
HND-014765,2011,161300038,,,,2,2,4
HND-014768,2011,161300041,,,,4,3,7
HND-014774,2011,161300091,,,,1,2,3
HND-014738,2011,161300006,,,,1,0,1
HND-014741,2011,161300009,,,,3,5,8
HND-014743,2011,161300011,,,,5,8,13
HND-014748,2011,161300016,,,,1,1,2
HND-014751,2011,161300019,,,,11,12,23
HND-014756,2011,161300025,,,,1,2,3
HND-014757,2011,161300027,,,,2,4,6
HND-014758,2011,161300028,,,,10,8,18
HND-014759,2011,161300031,,,,0,7,7
HND-014760,2011,161300032,,,,3,8,11
HND-014761,2011,161300033,,,,5,10,15
HND-014763,2011,161300036,,,,1,1,2
HND-014764,2011,161300037,,,,3,2,5
HND-014767,2011,161300040,,,,1,2,3
HND-014769,2011,161300042,,,,3,4,7
HND-014777,2011,161300098,,,,7,10,17
HND-014733,2011,161300001,,,,27,20,47
HND-014735,2011,161300003,,,,3,8,11
HND-014737,2011,161300005,,,,7,7,14
HND-014739,2011,161300007,,,,4,5,9
HND-014740,2011,161300008,,,,0,5,5
HND-014742,2011,161300010,,,,32,38,70
HND-014744,2011,161300012,,,,1,1,2
HND-014745,2011,161300013,,,,2,1,3
HND-014746,2011,161300014,,,,3,1,4
HND-014747,2011,161300015,,,,8,9,17
HND-014749,2011,161300017,,,,0,5,5
HND-014750,2011,161300018,,,,2,1,3
HND-014752,2011,161300020,,,,2,1,3
HND-014765,2011,161300038,,,,3,2,5
HND-014768,2011,161300041,,,,4,4,8
HND-014774,2011,161300091,,,,4,2,6
HND-014734,2011,161300002,,,,1,6,7
HND-014736,2011,161300004,,,,2,5,7
HND-014738,2011,161300006,,,,1,0,1
HND-014741,2011,161300009,,,,0,1,1
HND-014743,2011,161300011,,,,2,3,5
HND-014748,2011,161300016,,,,3,2,5
HND-014751,2011,161300019,,,,5,7,12
HND-014756,2011,161300025,,,,0,1,1
HND-014757,2011,161300027,,,,0,4,4
HND-014758,2011,161300028,,,,6,5,11
HND-014759,2011,161300031,,,,3,4,7
HND-014760,2011,161300032,,,,6,8,14
HND-014761,2011,161300033,,,,2,3,5
HND-014763,2011,161300036,,,,1,6,7
HND-014767,2011,161300040,,,,0,5,5
HND-014769,2011,161300042,,,,2,4,6
HND-014777,2011,161300098,,,,2,2,4
HND-014738,2011,161300006,,,,1,3,4
HND-014740,2011,161300008,,,,7,1,8
HND-014741,2011,161300009,,,,0,2,2
HND-014750,2011,161300018,,,,2,1,3
HND-014751,2011,161300019,,,,2,6,8
HND-014756,2011,161300025,,,,0,1,1
HND-014757,2011,161300027,,,,0,1,1
HND-014758,2011,161300028,,,,6,2,8
HND-014759,2011,161300031,,,,3,3,6
HND-014760,2011,161300032,,,,4,10,14
HND-014763,2011,161300036,,,,1,5,6
HND-014777,2011,161300098,,,,3,1,4
HND-014733,2011,161300001,,,,26,33,59
HND-014734,2011,161300002,,,,1,4,5
HND-014735,2011,161300003,,,,6,13,19
HND-014736,2011,161300004,,,,1,3,4
HND-014737,2011,161300005,,,,5,9,14
HND-014739,2011,161300007,,,,4,2,6
HND-014742,2011,161300010,,,,31,35,66
HND-014743,2011,161300011,,,,0,4,4
HND-014745,2011,161300013,,,,1,4,5
HND-014746,2011,161300014,,,,0,2,2
HND-014747,2011,161300015,,,,5,6,11
HND-014748,2011,161300016,,,,2,0,2
HND-014749,2011,161300017,,,,1,0,1
HND-014752,2011,161300020,,,,2,0,2
HND-014761,2011,161300033,,,,5,9,14
HND-014764,2011,161300037,,,,1,2,3
HND-014765,2011,161300038,,,,1,2,3
HND-014767,2011,161300040,,,,3,4,7
HND-014768,2011,161300041,,,,3,3,6
HND-014774,2011,161300091,,,,1,1,2
HND-014754,2011,161300022,,,,60,44,104
HND-014751,2011,161300019,,,,8,13,21
HND-014751,2011,161300019,,,,18,8,26
HND-014754,2011,161300022,,,,15,50,65
HND-014754,2011,161300022,,,,29,40,69
HND-014751,2011,161300019,,,,6,14,20
HND-014754,2011,161300022,,,,22,28,50
HND-014754,2011,161300022,,,,21,31,52
HND-014754,2011,161300022,,,,13,32,45
HND-014799,2011,161400019,,,,2,3,5
,2011,161400043,,,,2,6,8
,2011,161400044,,,,2,4,6
HND-014809,2011,161400045,,,,4,1,5
HND-014811,2011,161400048,,,,7,2,9
HND-014813,2011,161400050,,,,4,1,5
HND-014814,2011,161400051,,,,13,9,22
HND-014815,2011,161400052,,,,8,7,15
HND-014816,2011,161400053,,,,2,3,5
HND-014801,2011,161400023,,,,10,5,15
HND-014802,2011,161400025,,,,5,11,16
HND-014803,2011,161400026,,,,6,7,13
HND-014804,2011,161400027,,,,6,9,15
HND-014808,2011,161400041,,,,5,4,9
HND-014812,2011,161400049,,,,4,4,8
HND-014810,2011,161400046,,,,5,2,7
HND-014798,2011,161400018,,,,14,11,25
HND-014794,2011,161400013,,,,10,10,20
HND-014810,2011,161400046,,,,2,8,10
HND-014794,2011,161400013,,,,11,11,22
HND-014795,2011,161400014,,,,7,15,22
HND-014798,2011,161400018,,,,12,22,34
HND-014810,2011,161400046,,,,1,9,10
HND-014784,2011,161400003,,,,9,15,24
HND-014785,2011,161400004,,,,4,10,14
HND-014786,2011,161400005,,,,15,18,33
HND-014788,2011,161400007,,,,6,2,8
HND-014789,2011,161400008,,,,12,6,18
HND-014791,2011,161400010,,,,2,3,5
HND-014792,2011,161400011,,,,3,0,3
HND-014793,2011,161400012,,,,4,3,7
HND-014796,2011,161400016,,,,0,1,1
HND-014797,2011,161400017,,,,4,2,6
HND-014800,2011,161400021,,,,0,3,3
HND-014805,2011,161400036,,,,1,3,4
HND-014783,2011,161400002,,,,15,22,37
HND-014787,2011,161400006,,,,1,2,3
HND-014790,2011,161400009,,,,3,7,10
HND-014806,2011,161400037,,,,3,1,4
HND-014807,2011,161400038,,,,1,2,3
HND-014785,2011,161400004,,,,5,9,14
HND-014787,2011,161400006,,,,4,1,5
HND-014791,2011,161400010,,,,2,4,6
HND-014792,2011,161400011,,,,1,2,3
HND-014796,2011,161400016,,,,3,4,7
HND-014805,2011,161400036,,,,0,2,2
HND-014783,2011,161400002,,,,26,11,37
HND-014784,2011,161400003,,,,13,15,28
HND-014786,2011,161400005,,,,17,10,27
HND-014788,2011,161400007,,,,4,3,7
HND-014789,2011,161400008,,,,5,3,8
HND-014790,2011,161400009,,,,9,6,15
HND-014797,2011,161400017,,,,7,5,12
HND-014800,2011,161400021,,,,1,2,3
HND-014806,2011,161400037,,,,1,0,1
HND-014807,2011,161400038,,,,0,3,3
HND-014787,2011,161400006,,,,3,3,6
HND-014790,2011,161400009,,,,0,11,11
HND-014796,2011,161400016,,,,2,2,4
HND-014783,2011,161400002,,,,20,14,34
HND-014784,2011,161400003,,,,12,20,32
HND-014785,2011,161400004,,,,3,3,6
HND-014786,2011,161400005,,,,14,15,29
HND-014788,2011,161400007,,,,7,2,9
HND-014789,2011,161400008,,,,3,9,12
HND-014791,2011,161400010,,,,4,5,9
HND-014792,2011,161400011,,,,3,4,7
HND-014793,2011,161400012,,,,3,5,8
HND-014797,2011,161400017,,,,9,3,12
HND-014800,2011,161400021,,,,2,3,5
HND-014806,2011,161400037,,,,1,0,1
HND-014807,2011,161400038,,,,0,1,1
HND-014784,2011,161400003,,,,14,22,36
HND-014785,2011,161400004,,,,6,1,7
HND-014787,2011,161400006,,,,2,1,3
HND-014788,2011,161400007,,,,6,7,13
HND-014791,2011,161400010,,,,6,2,8
HND-014796,2011,161400016,,,,2,0,2
HND-014800,2011,161400021,,,,3,0,3
HND-014805,2011,161400036,,,,4,0,4
HND-014806,2011,161400037,,,,3,1,4
HND-014783,2011,161400002,,,,13,20,33
HND-014786,2011,161400005,,,,16,22,38
HND-014789,2011,161400008,,,,4,5,9
HND-014790,2011,161400009,,,,3,5,8
HND-014797,2011,161400017,,,,5,7,12
HND-014807,2011,161400038,,,,2,3,5
HND-014784,2011,161400003,,,,11,14,25
HND-014785,2011,161400004,,,,6,7,13
HND-014786,2011,161400005,,,,26,34,60
HND-014788,2011,161400007,,,,5,2,7
HND-014791,2011,161400010,,,,10,3,13
HND-014792,2011,161400011,,,,2,1,3
HND-014793,2011,161400012,,,,3,0,3
HND-014796,2011,161400016,,,,4,3,7
HND-014797,2011,161400017,,,,1,4,5
HND-014800,2011,161400021,,,,2,1,3
HND-014805,2011,161400036,,,,0,3,3
HND-014806,2011,161400037,,,,2,0,2
HND-014783,2011,161400002,,,,19,18,37
HND-014787,2011,161400006,,,,0,2,2
HND-014789,2011,161400008,,,,3,6,9
HND-014790,2011,161400009,,,,5,5,10
HND-014807,2011,161400038,,,,4,4,8
HND-014783,2011,161400002,,,,19,15,34
HND-014784,2011,161400003,,,,9,11,20
HND-014786,2011,161400005,,,,24,16,40
HND-014788,2011,161400007,,,,5,6,11
HND-014789,2011,161400008,,,,6,6,12
HND-014790,2011,161400009,,,,5,3,8
HND-014793,2011,161400012,,,,2,5,7
HND-014797,2011,161400017,,,,3,1,4
HND-014800,2011,161400021,,,,5,1,6
HND-014806,2011,161400037,,,,1,0,1
HND-014807,2011,161400038,,,,1,0,1
HND-014785,2011,161400004,,,,11,5,16
HND-014791,2011,161400010,,,,4,3,7
HND-014792,2011,161400011,,,,3,2,5
HND-014796,2011,161400016,,,,0,2,2
HND-014805,2011,161400036,,,,0,4,4
HND-014786,2011,161400005,,,,25,11,36
HND-014783,2011,161400002,,,,27,28,55
HND-014783,2011,161400002,,,,12,15,27
HND-014786,2011,161400005,,,,14,21,35
HND-014783,2011,161400002,,,,14,13,27
HND-014786,2011,161400005,,,,13,14,27
HND-014783,2011,161400002,,,,6,4,10
HND-014783,2011,161400002,,,,2,6,8
HND-014783,2011,161400002,,,,3,4,7
HND-014845,2011,161500031,,,,9,12,21
,2011,161500049,,,,7,4,11
,2011,161500051,,,,4,10,14
,2011,161500052,,,,3,7,10
,2011,161500054,,,,6,2,8
HND-014842,2011,161500027,,,,5,10,15
HND-014850,2011,161500039,,,,10,7,17
,2011,161500044,,,,4,9,13
,2011,161500053,,,,3,5,8
,2011,161500055,,,,3,9,12
,2011,161500057,,,,7,11,18
,2011,161500042,,,,1,1,2
,2011,161500056,,,,1,4,5
,2011,161500038,,,,4,2,6
HND-014841,2011,161500025,,,,3,0,3
,2011,161500038,,,,1,0,1
HND-014852,2011,161500041,,,,0,2,2
,2011,161500042,,,,4,2,6
HND-014853,2011,161500043,,,,3,2,5
HND-014840,2011,161500024,,,,9,10,19
HND-014843,2011,161500029,,,,6,1,7
HND-014846,2011,161500032,,,,2,0,2
,2011,161500056,,,,5,2,7
HND-014840,2011,161500024,,,,15,26,41
HND-014843,2011,161500029,,,,18,16,34
,2011,161500038,,,,7,3,10
HND-014852,2011,161500041,,,,4,6,10
,2011,161500042,,,,4,3,7
HND-014853,2011,161500043,,,,1,1,2
HND-014841,2011,161500025,,,,5,9,14
HND-014844,2011,161500030,,,,7,11,18
HND-014846,2011,161500032,,,,6,6,12
,2011,161500056,,,,0,6,6
HND-014819,2011,161500002,,,,1,1,2
HND-014823,2011,161500006,,,,10,5,15
HND-014825,2011,161500008,,,,5,6,11
HND-014826,2011,161500009,,,,5,1,6
HND-014827,2011,161500010,,,,2,5,7
HND-014828,2011,161500011,,,,2,5,7
HND-014829,2011,161500012,,,,5,5,10
HND-014831,2011,161500014,,,,14,7,21
HND-014838,2011,161500022,,,,21,19,40
HND-014839,2011,161500023,,,,5,6,11
HND-014847,2011,161500035,,,,2,3,5
,2011,161500037,,,,2,1,3
,2011,161500053,,,,2,1,3
HND-014820,2011,161500003,,,,4,1,5
HND-014821,2011,161500004,,,,9,8,17
HND-014822,2011,161500005,,,,12,10,22
HND-014824,2011,161500007,,,,10,12,22
HND-014830,2011,161500013,,,,14,6,20
,2011,161500015,,,,44,34,78
HND-014833,2011,161500017,,,,8,11,19
HND-014834,2011,161500018,,,,4,6,10
HND-014835,2011,161500019,,,,5,11,16
HND-014836,2011,161500020,,,,11,4,15
HND-014837,2011,161500021,,,,5,4,9
,2011,161500056,,,,8,4,12
HND-014819,2011,161500002,,,,2,0,2
HND-014820,2011,161500003,,,,1,5,6
HND-014822,2011,161500005,,,,6,9,15
HND-014824,2011,161500007,,,,8,10,18
HND-014825,2011,161500008,,,,10,10,20
HND-014835,2011,161500019,,,,9,5,14
HND-014836,2011,161500020,,,,2,7,9
HND-014837,2011,161500021,,,,8,6,14
HND-014839,2011,161500023,,,,11,4,15
,2011,161500040,,,,1,6,7
,2011,161500053,,,,1,3,4
HND-014821,2011,161500004,,,,9,3,12
HND-014823,2011,161500006,,,,14,13,27
HND-014826,2011,161500009,,,,6,7,13
HND-014827,2011,161500010,,,,4,3,7
HND-014828,2011,161500011,,,,6,3,9
HND-014829,2011,161500012,,,,1,1,2
HND-014830,2011,161500013,,,,16,16,32
HND-014831,2011,161500014,,,,10,8,18
,2011,161500015,,,,44,30,74
HND-014833,2011,161500017,,,,10,6,16
HND-014838,2011,161500022,,,,12,18,30
HND-014847,2011,161500035,,,,1,6,7
,2011,161500037,,,,3,2,5
,2011,161500056,,,,4,1,5
HND-014820,2011,161500003,,,,2,2,4
HND-014821,2011,161500004,,,,7,4,11
HND-014822,2011,161500005,,,,4,9,13
HND-014824,2011,161500007,,,,4,4,8
HND-014825,2011,161500008,,,,9,16,25
HND-014830,2011,161500013,,,,10,20,30
,2011,161500015,,,,17,33,50
HND-014833,2011,161500017,,,,8,8,16
HND-014834,2011,161500018,,,,4,5,9
HND-014835,2011,161500019,,,,6,3,9
HND-014836,2011,161500020,,,,9,4,13
HND-014837,2011,161500021,,,,4,2,6
HND-014847,2011,161500035,,,,4,2,6
,2011,161500037,,,,2,3,5
,2011,161500040,,,,0,1,1
,2011,161500053,,,,1,2,3
HND-014819,2011,161500002,,,,0,1,1
HND-014823,2011,161500006,,,,13,10,23
HND-014826,2011,161500009,,,,6,5,11
HND-014827,2011,161500010,,,,9,5,14
HND-014828,2011,161500011,,,,2,6,8
HND-014829,2011,161500012,,,,9,4,13
HND-014831,2011,161500014,,,,11,13,24
HND-014838,2011,161500022,,,,16,24,40
HND-014839,2011,161500023,,,,5,4,9
HND-014822,2011,161500005,,,,5,11,16
HND-014825,2011,161500008,,,,4,8,12
HND-014826,2011,161500009,,,,10,5,15
HND-014827,2011,161500010,,,,5,5,10
HND-014828,2011,161500011,,,,6,12,18
HND-014835,2011,161500019,,,,3,6,9
HND-014839,2011,161500023,,,,3,6,9
HND-014820,2011,161500003,,,,2,5,7
HND-014821,2011,161500004,,,,6,3,9
HND-014823,2011,161500006,,,,10,11,21
HND-014824,2011,161500007,,,,4,10,14
HND-014829,2011,161500012,,,,7,3,10
HND-014830,2011,161500013,,,,12,13,25
HND-014831,2011,161500014,,,,15,14,29
,2011,161500015,,,,30,27,57
HND-014833,2011,161500017,,,,13,11,24
HND-014834,2011,161500018,,,,4,5,9
HND-014836,2011,161500020,,,,7,2,9
HND-014837,2011,161500021,,,,2,3,5
HND-014838,2011,161500022,,,,16,14,30
HND-014847,2011,161500035,,,,7,3,10
,2011,161500037,,,,3,4,7
,2011,161500040,,,,2,1,3
,2011,161500053,,,,3,2,5
HND-014819,2011,161500002,,,,1,1,2
HND-014825,2011,161500008,,,,6,2,8
HND-014826,2011,161500009,,,,5,3,8
HND-014827,2011,161500010,,,,2,7,9
HND-014828,2011,161500011,,,,6,5,11
HND-014829,2011,161500012,,,,4,5,9
HND-014831,2011,161500014,,,,9,9,18
HND-014835,2011,161500019,,,,7,6,13
HND-014838,2011,161500022,,,,15,20,35
HND-014839,2011,161500023,,,,9,4,13
HND-014820,2011,161500003,,,,3,4,7
HND-014821,2011,161500004,,,,6,6,12
HND-014822,2011,161500005,,,,2,7,9
HND-014823,2011,161500006,,,,10,13,23
HND-014824,2011,161500007,,,,4,9,13
HND-014830,2011,161500013,,,,11,6,17
,2011,161500015,,,,36,43,79
HND-014833,2011,161500017,,,,9,15,24
HND-014834,2011,161500018,,,,1,6,7
HND-014836,2011,161500020,,,,6,4,10
HND-014837,2011,161500021,,,,6,7,13
HND-014847,2011,161500035,,,,2,4,6
,2011,161500037,,,,4,2,6
,2011,161500040,,,,4,2,6
,2011,161500053,,,,0,1,1
HND-014821,2011,161500004,,,,6,4,10
HND-014823,2011,161500006,,,,10,7,17
HND-014826,2011,161500009,,,,5,4,9
HND-014827,2011,161500010,,,,3,6,9
HND-014828,2011,161500011,,,,11,9,20
HND-014829,2011,161500012,,,,3,1,4
HND-014830,2011,161500013,,,,9,10,19
HND-014831,2011,161500014,,,,15,11,26
,2011,161500015,,,,38,30,68
HND-014833,2011,161500017,,,,9,12,21
HND-014838,2011,161500022,,,,19,20,39
HND-014847,2011,161500035,,,,4,2,6
,2011,161500037,,,,1,1,2
HND-014820,2011,161500003,,,,3,2,5
HND-014822,2011,161500005,,,,11,2,13
HND-014824,2011,161500007,,,,9,5,14
HND-014825,2011,161500008,,,,4,4,8
HND-014835,2011,161500019,,,,7,3,10
HND-014836,2011,161500020,,,,6,5,11
HND-014837,2011,161500021,,,,3,3,6
HND-014839,2011,161500023,,,,5,7,12
,2011,161500040,,,,0,2,2
HND-014823,2011,161500006,,,,39,31,70
HND-014825,2011,161500008,,,,4,2,6
HND-014818,2011,161500001,,,,94,78,172
HND-014825,2011,161500008,,,,11,10,21
HND-014818,2011,161500001,,,,65,50,115
HND-014823,2011,161500006,,,,16,15,31
HND-014818,2011,161500001,,,,59,46,105
HND-014823,2011,161500006,,,,9,13,22
HND-014818,2011,161500001,,,,32,43,75
HND-014818,2011,161500001,,,,19,28,47
HND-014818,2011,161500001,,,,15,22,37
HND-014880,2011,161600028,,,,4,5,9
HND-014882,2011,161600033,,,,6,7,13
HND-014883,2011,161600034,,,,11,8,19
HND-014884,2011,161600035,,,,7,11,18
,2011,161600055,,,,5,5,10
HND-014898,2011,161600057,,,,10,5,15
,2011,161600100,,,,6,5,11
,2011,161600101,,,,8,6,14
,2011,161600102,,,,6,8,14
HND-014902,2011,161600103,,,,3,4,7
,2011,161600104,,,,8,4,12
,2011,161600109,,,,7,3,10
,2011,161600111,,,,5,5,10
,2011,161600112,,,,4,5,9
,2011,161600115,,,,5,4,9
,2011,161600036,,,,5,4,9
HND-014894,2011,161600048,,,,6,6,12
HND-014900,2011,161600090,,,,6,7,13
,2011,161600106,,,,3,6,9
HND-014904,2011,161600107,,,,2,8,10
,2011,161600108,,,,5,5,10
,2011,161600110,,,,7,6,13
,2011,161600117,,,,8,5,13
,2011,161600039,,,,0,1,1
HND-014896,2011,161600053,,,,1,3,4
HND-014897,2011,161600054,,,,0,2,2
HND-014907,2011,161600116,,,,1,1,2
HND-014877,2011,161600024,,,,2,9,11
HND-014877,2011,161600024,,,,13,23,36
,2011,161600025,,,,4,3,7
HND-014896,2011,161600053,,,,5,5,10
HND-014897,2011,161600054,,,,3,7,10
HND-014878,2011,161600026,,,,15,3,18
HND-014881,2011,161600031,,,,3,2,5
,2011,161600039,,,,6,3,9
HND-014907,2011,161600116,,,,2,6,8
,2011,161600025,,,,12,12,24
HND-014878,2011,161600026,,,,10,7,17
HND-014896,2011,161600053,,,,5,4,9
HND-014897,2011,161600054,,,,9,10,19
HND-014907,2011,161600116,,,,0,2,2
HND-014877,2011,161600024,,,,34,29,63
HND-014881,2011,161600031,,,,19,10,29
,2011,161600039,,,,5,4,9
HND-014854,2011,161600001,,,,35,36,71
HND-014855,2011,161600002,,,,8,6,14
HND-014856,2011,161600003,,,,4,4,8
HND-014857,2011,161600004,,,,12,8,20
HND-014858,2011,161600005,,,,2,2,4
HND-014859,2011,161600006,,,,16,21,37
HND-014860,2011,161600007,,,,17,10,27
HND-014866,2011,161600013,,,,13,7,20
HND-014868,2011,161600015,,,,18,8,26
HND-014870,2011,161600017,,,,3,9,12
HND-014871,2011,161600018,,,,3,2,5
HND-014872,2011,161600019,,,,3,1,4
HND-014876,2011,161600023,,,,0,1,1
HND-014886,2011,161600040,,,,2,1,3
HND-014888,2011,161600042,,,,3,4,7
HND-014890,2011,161600044,,,,6,7,13
HND-014892,2011,161600046,,,,11,6,17
HND-014895,2011,161600050,,,,6,4,10
HND-014901,2011,161600099,,,,5,7,12
HND-014908,2011,161600118,,,,5,5,10
HND-014861,2011,161600008,,,,3,2,5
HND-014862,2011,161600009,,,,9,8,17
HND-014863,2011,161600010,,,,3,3,6
HND-014864,2011,161600011,,,,13,9,22
HND-014865,2011,161600012,,,,8,10,18
HND-014867,2011,161600014,,,,7,8,15
HND-014869,2011,161600016,,,,9,6,15
HND-014873,2011,161600020,,,,8,5,13
HND-014874,2011,161600021,,,,2,1,3
HND-014875,2011,161600022,,,,1,3,4
HND-014889,2011,161600043,,,,15,13,28
HND-014891,2011,161600045,,,,8,5,13
HND-014893,2011,161600047,,,,3,3,6
HND-014903,2011,161600105,,,,3,5,8
HND-014905,2011,161600113,,,,2,3,5
,2011,161600114,,,,7,6,13
HND-014859,2011,161600006,,,,16,12,28
HND-014862,2011,161600009,,,,4,6,10
HND-014863,2011,161600010,,,,5,7,12
HND-014864,2011,161600011,,,,15,14,29
HND-014865,2011,161600012,,,,9,5,14
HND-014866,2011,161600013,,,,1,5,6
HND-014867,2011,161600014,,,,14,6,20
HND-014868,2011,161600015,,,,15,15,30
HND-014870,2011,161600017,,,,13,11,24
HND-014873,2011,161600020,,,,14,4,18
HND-014874,2011,161600021,,,,1,1,2
HND-014875,2011,161600022,,,,2,3,5
HND-014876,2011,161600023,,,,4,5,9
HND-014888,2011,161600042,,,,0,3,3
HND-014889,2011,161600043,,,,16,13,29
HND-014890,2011,161600044,,,,4,6,10
HND-014891,2011,161600045,,,,3,4,7
HND-014893,2011,161600047,,,,4,1,5
HND-014903,2011,161600105,,,,3,9,12
HND-014905,2011,161600113,,,,11,5,16
,2011,161600114,,,,10,5,15
HND-014854,2011,161600001,,,,28,34,62
HND-014855,2011,161600002,,,,5,1,6
HND-014856,2011,161600003,,,,8,8,16
HND-014857,2011,161600004,,,,8,10,18
HND-014858,2011,161600005,,,,5,5,10
HND-014860,2011,161600007,,,,15,10,25
HND-014861,2011,161600008,,,,4,3,7
HND-014869,2011,161600016,,,,9,6,15
HND-014871,2011,161600018,,,,12,9,21
HND-014872,2011,161600019,,,,4,5,9
HND-014886,2011,161600040,,,,4,1,5
HND-014892,2011,161600046,,,,3,3,6
HND-014895,2011,161600050,,,,3,2,5
HND-014901,2011,161600099,,,,3,3,6
HND-014908,2011,161600118,,,,1,0,1
HND-014861,2011,161600008,,,,2,4,6
HND-014862,2011,161600009,,,,6,7,13
HND-014863,2011,161600010,,,,4,3,7
HND-014864,2011,161600011,,,,8,12,20
HND-014865,2011,161600012,,,,11,6,17
HND-014867,2011,161600014,,,,11,4,15
HND-014869,2011,161600016,,,,3,4,7
HND-014873,2011,161600020,,,,7,3,10
HND-014874,2011,161600021,,,,4,1,5
HND-014875,2011,161600022,,,,3,2,5
HND-014886,2011,161600040,,,,1,0,1
HND-014888,2011,161600042,,,,0,3,3
HND-014889,2011,161600043,,,,9,12,21
HND-014890,2011,161600044,,,,8,5,13
HND-014892,2011,161600046,,,,6,3,9
HND-014893,2011,161600047,,,,1,5,6
HND-014895,2011,161600050,,,,4,7,11
HND-014901,2011,161600099,,,,3,2,5
HND-014903,2011,161600105,,,,8,5,13
,2011,161600114,,,,3,6,9
HND-014854,2011,161600001,,,,52,38,90
HND-014855,2011,161600002,,,,4,4,8
HND-014856,2011,161600003,,,,8,7,15
HND-014857,2011,161600004,,,,6,5,11
HND-014858,2011,161600005,,,,6,2,8
HND-014859,2011,161600006,,,,12,20,32
HND-014860,2011,161600007,,,,8,8,16
HND-014866,2011,161600013,,,,7,5,12
HND-014868,2011,161600015,,,,18,14,32
HND-014870,2011,161600017,,,,11,12,23
HND-014871,2011,161600018,,,,6,3,9
HND-014872,2011,161600019,,,,2,7,9
HND-014876,2011,161600023,,,,2,4,6
HND-014891,2011,161600045,,,,1,2,3
HND-014908,2011,161600118,,,,2,3,5
HND-014855,2011,161600002,,,,0,4,4
HND-014857,2011,161600004,,,,4,6,10
HND-014859,2011,161600006,,,,12,16,28
HND-014862,2011,161600009,,,,4,7,11
HND-014865,2011,161600012,,,,10,5,15
HND-014866,2011,161600013,,,,7,4,11
HND-014867,2011,161600014,,,,9,6,15
HND-014868,2011,161600015,,,,13,9,22
HND-014870,2011,161600017,,,,9,10,19
HND-014871,2011,161600018,,,,6,2,8
HND-014875,2011,161600022,,,,7,5,12
HND-014876,2011,161600023,,,,4,8,12
HND-014888,2011,161600042,,,,3,1,4
HND-014889,2011,161600043,,,,16,10,26
HND-014890,2011,161600044,,,,6,6,12
HND-014891,2011,161600045,,,,3,1,4
HND-014893,2011,161600047,,,,4,2,6
HND-014903,2011,161600105,,,,2,4,6
HND-014854,2011,161600001,,,,31,40,71
HND-014856,2011,161600003,,,,5,8,13
HND-014858,2011,161600005,,,,5,3,8
HND-014860,2011,161600007,,,,9,9,18
HND-014861,2011,161600008,,,,1,0,1
HND-014863,2011,161600010,,,,0,5,5
HND-014864,2011,161600011,,,,20,17,37
HND-014869,2011,161600016,,,,5,9,14
HND-014872,2011,161600019,,,,4,4,8
HND-014873,2011,161600020,,,,7,4,11
HND-014874,2011,161600021,,,,5,2,7
HND-014886,2011,161600040,,,,3,0,3
HND-014892,2011,161600046,,,,4,3,7
HND-014895,2011,161600050,,,,2,0,2
HND-014901,2011,161600099,,,,1,3,4
HND-014905,2011,161600113,,,,1,3,4
HND-014908,2011,161600118,,,,1,2,3
HND-014855,2011,161600002,,,,3,1,4
HND-014856,2011,161600003,,,,4,5,9
HND-014857,2011,161600004,,,,6,5,11
HND-014859,2011,161600006,,,,10,16,26
HND-014860,2011,161600007,,,,4,11,15
HND-014865,2011,161600012,,,,7,14,21
HND-014866,2011,161600013,,,,1,6,7
HND-014868,2011,161600015,,,,13,11,24
HND-014870,2011,161600017,,,,7,4,11
HND-014871,2011,161600018,,,,3,2,5
HND-014875,2011,161600022,,,,5,0,5
HND-014876,2011,161600023,,,,5,4,9
HND-014889,2011,161600043,,,,11,11,22
HND-014891,2011,161600045,,,,2,0,2
HND-014893,2011,161600047,,,,2,1,3
,2011,161600114,,,,2,5,7
HND-014908,2011,161600118,,,,0,1,1
HND-014854,2011,161600001,,,,34,35,69
HND-014858,2011,161600005,,,,2,8,10
HND-014861,2011,161600008,,,,1,2,3
HND-014862,2011,161600009,,,,6,5,11
HND-014863,2011,161600010,,,,3,3,6
HND-014864,2011,161600011,,,,6,9,15
HND-014867,2011,161600014,,,,10,8,18
HND-014869,2011,161600016,,,,6,6,12
HND-014872,2011,161600019,,,,1,4,5
HND-014873,2011,161600020,,,,8,6,14
HND-014874,2011,161600021,,,,4,1,5
HND-014886,2011,161600040,,,,2,0,2
HND-014888,2011,161600042,,,,1,2,3
HND-014890,2011,161600044,,,,9,4,13
HND-014892,2011,161600046,,,,3,5,8
HND-014895,2011,161600050,,,,1,6,7
HND-014901,2011,161600099,,,,2,5,7
HND-014903,2011,161600105,,,,4,1,5
HND-014905,2011,161600113,,,,1,2,3
HND-014854,2011,161600001,,,,43,35,78
HND-014855,2011,161600002,,,,5,0,5
HND-014856,2011,161600003,,,,3,4,7
HND-014857,2011,161600004,,,,5,3,8
HND-014858,2011,161600005,,,,9,1,10
HND-014860,2011,161600007,,,,7,8,15
HND-014861,2011,161600008,,,,1,2,3
HND-014869,2011,161600016,,,,2,7,9
HND-014871,2011,161600018,,,,3,3,6
HND-014872,2011,161600019,,,,2,1,3
HND-014886,2011,161600040,,,,1,0,1
HND-014892,2011,161600046,,,,3,2,5
HND-014895,2011,161600050,,,,3,2,5
HND-014901,2011,161600099,,,,4,2,6
HND-014908,2011,161600118,,,,1,2,3
HND-014859,2011,161600006,,,,14,16,30
HND-014862,2011,161600009,,,,4,6,10
HND-014863,2011,161600010,,,,4,5,9
HND-014864,2011,161600011,,,,6,7,13
HND-014865,2011,161600012,,,,6,7,13
HND-014866,2011,161600013,,,,3,5,8
HND-014867,2011,161600014,,,,7,6,13
HND-014868,2011,161600015,,,,9,10,19
HND-014870,2011,161600017,,,,4,5,9
HND-014873,2011,161600020,,,,2,7,9
HND-014874,2011,161600021,,,,1,4,5
HND-014875,2011,161600022,,,,1,3,4
HND-014876,2011,161600023,,,,4,3,7
HND-014888,2011,161600042,,,,1,1,2
HND-014889,2011,161600043,,,,9,9,18
HND-014890,2011,161600044,,,,9,4,13
HND-014891,2011,161600045,,,,0,1,1
HND-014893,2011,161600047,,,,3,1,4
HND-014903,2011,161600105,,,,2,3,5
HND-014905,2011,161600113,,,,1,1,2
,2011,161600114,,,,3,4,7
HND-014860,2011,161600007,,,,10,21,31
HND-014879,2011,161600027,,,,19,25,44
HND-014879,2011,161600027,,,,18,20,38
HND-014860,2011,161600007,,,,13,15,28
HND-014879,2011,161600027,,,,14,26,40
HND-014860,2011,161600007,,,,15,23,38
HND-014879,2011,161600027,,,,9,8,17
HND-014879,2011,161600027,,,,9,4,13
HND-014879,2011,161600027,,,,7,11,18
,2011,161700138,,,,14,12,26
HND-015005,2011,161700148,,,,6,5,11
HND-015006,2011,161700151,,,,5,6,11
HND-015007,2011,161700152,,,,8,5,13
,2011,161700158,,,,18,14,32
,2011,161700160,,,,3,4,7
,2011,161700161,,,,4,6,10
HND-015011,2011,161700162,,,,7,3,10
,2011,161700169,,,,9,11,20
,2011,161700170,,,,3,7,10
,2011,161700136,,,,10,5,15
,2011,161700137,,,,16,8,24
,2011,161700139,,,,8,4,12
,2011,161700145,,,,5,5,10
HND-015004,2011,161700146,,,,3,7,10
,2011,161700147,,,,8,5,13
,2011,161700149,,,,3,7,10
,2011,161700150,,,,10,8,18
HND-015008,2011,161700153,,,,16,25,41
,2011,161700154,,,,4,6,10
HND-015009,2011,161700155,,,,5,5,10
,2011,161700156,,,,7,4,11
,2011,161700157,,,,7,6,13
,2011,161700159,,,,7,12,19
,2011,161700163,,,,5,9,14
HND-015013,2011,161700165,,,,5,5,10
,2011,161700166,,,,6,4,10
,2011,161700167,,,,12,10,22
,2011,161700171,,,,4,8,12
,2011,161700068,,,,2,2,4
,2011,161700126,,,,1,0,1
HND-015002,2011,161700141,,,,6,2,8
,2011,161700048,,,,0,5,5
,2011,161700053,,,,3,11,14
HND-014962,2011,161700054,,,,6,9,15
HND-014972,2011,161700066,,,,2,2,4
,2011,161700068,,,,2,4,6
HND-014978,2011,161700075,,,,4,10,14
,2011,161700095,,,,3,8,11
HND-014990,2011,161700097,,,,4,2,6
HND-015003,2011,161700143,,,,3,7,10
,2011,161700144,,,,12,7,19
HND-014973,2011,161700067,,,,7,9,16
HND-014991,2011,161700098,,,,8,6,14
,2011,161700126,,,,3,3,6
HND-015002,2011,161700141,,,,4,3,7
HND-014953,2011,161700045,,,,32,32,64
,2011,161700048,,,,10,12,22
HND-014957,2011,161700049,,,,15,7,22
,2011,161700053,,,,17,9,26
HND-014962,2011,161700054,,,,9,16,25
HND-014973,2011,161700067,,,,28,35,63
,2011,161700068,,,,3,7,10
HND-014978,2011,161700075,,,,16,10,26
,2011,161700095,,,,9,6,15
HND-014990,2011,161700097,,,,7,7,14
HND-014991,2011,161700098,,,,9,7,16
HND-015002,2011,161700141,,,,5,0,5
HND-015003,2011,161700143,,,,7,7,14
HND-014954,2011,161700046,,,,11,14,25
HND-014955,2011,161700047,,,,9,6,15
HND-014972,2011,161700066,,,,7,13,20
HND-014979,2011,161700076,,,,15,7,22
,2011,161700126,,,,7,5,12
HND-014909,2011,161700001,,,,70,71,141
HND-014910,2011,161700002,,,,31,10,41
HND-014911,2011,161700003,,,,68,62,130
HND-014912,2011,161700004,,,,5,4,9
HND-014913,2011,161700005,,,,2,3,5
HND-014915,2011,161700008,,,,3,5,8
HND-014917,2011,161700010,,,,14,4,18
HND-014918,2011,161700011,,,,1,2,3
HND-014921,2011,161700014,,,,13,14,27
HND-014922,2011,161700015,,,,2,1,3
HND-014923,2011,161700016,,,,3,4,7
HND-014927,2011,161700019,,,,25,17,42
HND-014926,2011,161700019,,,,25,17,42
HND-014933,2011,161700025,,,,7,7,14
HND-014934,2011,161700026,,,,5,9,14
HND-014936,2011,161700028,,,,31,10,41
HND-014937,2011,161700029,,,,2,4,6
HND-014938,2011,161700030,,,,7,10,17
HND-014939,2011,161700031,,,,8,4,12
HND-014942,2011,161700034,,,,9,12,21
HND-014944,2011,161700036,,,,2,1,3
HND-014950,2011,161700042,,,,1,2,3
HND-014951,2011,161700043,,,,3,0,3
HND-014952,2011,161700044,,,,17,17,34
HND-014960,2011,161700052,,,,9,9,18
HND-014961,2011,161700052,,,,9,9,18
HND-014963,2011,161700055,,,,3,5,8
HND-014964,2011,161700056,,,,5,8,13
HND-014965,2011,161700057,,,,19,19,38
HND-014974,2011,161700069,,,,3,1,4
HND-014976,2011,161700072,,,,3,3,6
HND-014977,2011,161700074,,,,4,3,7
HND-014980,2011,161700078,,,,4,7,11
HND-014981,2011,161700080,,,,5,9,14
HND-014984,2011,161700084,,,,3,0,3
HND-014985,2011,161700089,,,,6,1,7
HND-014986,2011,161700090,,,,5,5,10
HND-014988,2011,161700093,,,,7,5,12
HND-014989,2011,161700094,,,,7,0,7
HND-014993,2011,161700100,,,,7,4,11
HND-014995,2011,161700102,,,,11,7,18
HND-014996,2011,161700108,,,,4,2,6
HND-014997,2011,161700109,,,,6,5,11
HND-014999,2011,161700130,,,,11,7,18
HND-015000,2011,161700131,,,,7,1,8
HND-015012,2011,161700164,,,,4,2,6
HND-014914,2011,161700006,,,,3,3,6
HND-014916,2011,161700009,,,,9,12,21
HND-014919,2011,161700012,,,,10,6,16
HND-014920,2011,161700013,,,,15,15,30
HND-014924,2011,161700017,,,,6,5,11
HND-014925,2011,161700018,,,,7,3,10
HND-014928,2011,161700020,,,,17,15,32
HND-014929,2011,161700021,,,,11,8,19
HND-014930,2011,161700022,,,,15,18,33
HND-014931,2011,161700023,,,,15,8,23
HND-014932,2011,161700024,,,,10,16,26
HND-014935,2011,161700027,,,,8,8,16
HND-014941,2011,161700033,,,,11,2,13
HND-014943,2011,161700035,,,,8,8,16
HND-014945,2011,161700037,,,,13,18,31
HND-014946,2011,161700038,,,,2,4,6
HND-014947,2011,161700039,,,,2,4,6
HND-014948,2011,161700040,,,,17,7,24
HND-014949,2011,161700041,,,,16,20,36
HND-014966,2011,161700058,,,,5,4,9
HND-014967,2011,161700059,,,,5,3,8
HND-014968,2011,161700060,,,,14,8,22
HND-014969,2011,161700061,,,,3,8,11
HND-014970,2011,161700062,,,,18,15,33
,2011,161700063,,,,32,22,54
HND-014971,2011,161700064,,,,12,6,18
HND-014975,2011,161700071,,,,5,9,14
HND-014982,2011,161700082,,,,7,6,13
HND-014987,2011,161700092,,,,1,0,1
HND-014992,2011,161700099,,,,8,4,12
HND-014994,2011,161700101,,,,6,4,10
,2011,161700107,,,,5,5,10
,2011,161700126,,,,4,9,13
HND-014998,2011,161700128,,,,5,1,6
HND-015001,2011,161700140,,,,4,0,4
,2011,161700168,,,,5,5,10
HND-014910,2011,161700002,,,,28,21,49
HND-014911,2011,161700003,,,,60,65,125
HND-014912,2011,161700004,,,,2,5,7
HND-014914,2011,161700006,,,,4,6,10
HND-014922,2011,161700015,,,,2,2,4
HND-014925,2011,161700018,,,,3,4,7
HND-014927,2011,161700019,,,,14,10,24
HND-014926,2011,161700019,,,,14,10,24
HND-014930,2011,161700022,,,,14,14,28
HND-014931,2011,161700023,,,,13,7,20
HND-014932,2011,161700024,,,,7,10,17
HND-014933,2011,161700025,,,,8,9,17
HND-014934,2011,161700026,,,,11,5,16
HND-014935,2011,161700027,,,,12,6,18
HND-014936,2011,161700028,,,,28,21,49
HND-014940,2011,161700032,,,,2,4,6
HND-014941,2011,161700033,,,,6,6,12
HND-014942,2011,161700034,,,,4,7,11
HND-014943,2011,161700035,,,,7,7,14
HND-014945,2011,161700037,,,,13,21,34
HND-014960,2011,161700052,,,,10,7,17
HND-014961,2011,161700052,,,,10,7,17
HND-014963,2011,161700055,,,,4,5,9
HND-014965,2011,161700057,,,,16,19,35
HND-014966,2011,161700058,,,,2,3,5
HND-014970,2011,161700062,,,,20,13,33
,2011,161700063,,,,27,19,46
HND-014971,2011,161700064,,,,4,0,4
HND-014980,2011,161700078,,,,2,5,7
HND-014981,2011,161700080,,,,3,4,7
HND-014983,2011,161700083,,,,1,1,2
HND-014984,2011,161700084,,,,3,1,4
HND-014985,2011,161700089,,,,3,2,5
HND-014988,2011,161700093,,,,9,7,16
HND-014989,2011,161700094,,,,0,2,2
HND-014993,2011,161700100,,,,4,5,9
HND-014994,2011,161700101,,,,3,2,5
,2011,161700107,,,,3,4,7
HND-015000,2011,161700131,,,,8,11,19
HND-015001,2011,161700140,,,,1,4,5
HND-015012,2011,161700164,,,,0,3,3
,2011,161700168,,,,3,4,7
HND-014909,2011,161700001,,,,74,63,137
HND-014913,2011,161700005,,,,3,1,4
HND-014915,2011,161700008,,,,2,2,4
HND-014916,2011,161700009,,,,12,10,22
HND-014917,2011,161700010,,,,8,8,16
HND-014918,2011,161700011,,,,0,2,2
HND-014919,2011,161700012,,,,6,4,10
HND-014920,2011,161700013,,,,8,13,21
HND-014921,2011,161700014,,,,11,5,16
HND-014923,2011,161700016,,,,3,8,11
HND-014924,2011,161700017,,,,3,9,12
HND-014928,2011,161700020,,,,22,17,39
HND-014929,2011,161700021,,,,15,8,23
HND-014937,2011,161700029,,,,6,3,9
HND-014938,2011,161700030,,,,6,3,9
HND-014939,2011,161700031,,,,11,9,20
HND-014944,2011,161700036,,,,0,4,4
HND-014946,2011,161700038,,,,3,3,6
HND-014947,2011,161700039,,,,1,0,1
HND-014948,2011,161700040,,,,5,7,12
HND-014949,2011,161700041,,,,13,19,32
HND-014950,2011,161700042,,,,3,1,4
HND-014951,2011,161700043,,,,3,5,8
HND-014952,2011,161700044,,,,18,19,37
HND-014964,2011,161700056,,,,7,1,8
HND-014967,2011,161700059,,,,8,0,8
HND-014968,2011,161700060,,,,7,3,10
HND-014969,2011,161700061,,,,9,14,23
HND-014974,2011,161700069,,,,2,3,5
HND-014975,2011,161700071,,,,5,3,8
HND-014976,2011,161700072,,,,1,3,4
HND-014977,2011,161700074,,,,4,2,6
HND-014982,2011,161700082,,,,4,3,7
HND-014986,2011,161700090,,,,0,4,4
HND-014987,2011,161700092,,,,3,0,3
HND-014992,2011,161700099,,,,6,3,9
HND-014995,2011,161700102,,,,5,1,6
HND-014996,2011,161700108,,,,0,1,1
HND-014997,2011,161700109,,,,4,2,6
,2011,161700126,,,,2,7,9
HND-014998,2011,161700128,,,,2,0,2
HND-014999,2011,161700130,,,,10,10,20
HND-014914,2011,161700006,,,,7,2,9
HND-014916,2011,161700009,,,,6,17,23
HND-014920,2011,161700013,,,,7,3,10
HND-014924,2011,161700017,,,,6,11,17
HND-014925,2011,161700018,,,,5,7,12
HND-014928,2011,161700020,,,,17,16,33
HND-014929,2011,161700021,,,,5,9,14
HND-014930,2011,161700022,,,,21,16,37
HND-014931,2011,161700023,,,,9,4,13
HND-014932,2011,161700024,,,,10,9,19
HND-014934,2011,161700026,,,,6,14,20
HND-014935,2011,161700027,,,,6,14,20
HND-014943,2011,161700035,,,,6,7,13
HND-014947,2011,161700039,,,,2,3,5
HND-014948,2011,161700040,,,,1,6,7
HND-014949,2011,161700041,,,,20,18,38
HND-014952,2011,161700044,,,,17,10,27
HND-014966,2011,161700058,,,,3,0,3
HND-014967,2011,161700059,,,,5,7,12
HND-014968,2011,161700060,,,,3,6,9
HND-014969,2011,161700061,,,,9,9,18
HND-014970,2011,161700062,,,,16,18,34
,2011,161700063,,,,14,22,36
HND-014971,2011,161700064,,,,4,2,6
HND-014975,2011,161700071,,,,3,4,7
HND-014982,2011,161700082,,,,9,3,12
HND-014983,2011,161700083,,,,2,0,2
HND-014987,2011,161700092,,,,1,4,5
HND-014992,2011,161700099,,,,3,1,4
HND-014993,2011,161700100,,,,2,3,5
,2011,161700107,,,,2,0,2
,2011,161700126,,,,2,3,5
HND-014998,2011,161700128,,,,0,3,3
HND-015000,2011,161700131,,,,4,5,9
HND-015001,2011,161700140,,,,3,1,4
,2011,161700168,,,,2,0,2
HND-014909,2011,161700001,,,,71,76,147
HND-014910,2011,161700002,,,,35,26,61
HND-014911,2011,161700003,,,,59,56,115
HND-014912,2011,161700004,,,,0,4,4
HND-014913,2011,161700005,,,,1,2,3
HND-014915,2011,161700008,,,,2,2,4
HND-014917,2011,161700010,,,,6,11,17
HND-014918,2011,161700011,,,,1,1,2
HND-014919,2011,161700012,,,,14,4,18
HND-014921,2011,161700014,,,,6,11,17
HND-014922,2011,161700015,,,,0,3,3
HND-014923,2011,161700016,,,,3,3,6
HND-014927,2011,161700019,,,,19,12,31
HND-014926,2011,161700019,,,,19,12,31
HND-014933,2011,161700025,,,,8,7,15
HND-014936,2011,161700028,,,,35,26,61
HND-014937,2011,161700029,,,,3,1,4
HND-014938,2011,161700030,,,,5,2,7
HND-014939,2011,161700031,,,,3,7,10
HND-014940,2011,161700032,,,,8,0,8
HND-014941,2011,161700033,,,,2,3,5
HND-014942,2011,161700034,,,,10,2,12
HND-014944,2011,161700036,,,,2,1,3
HND-014945,2011,161700037,,,,14,13,27
HND-014950,2011,161700042,,,,3,3,6
HND-014951,2011,161700043,,,,4,1,5
HND-014960,2011,161700052,,,,11,11,22
HND-014961,2011,161700052,,,,11,11,22
HND-014963,2011,161700055,,,,6,1,7
HND-014964,2011,161700056,,,,4,5,9
HND-014965,2011,161700057,,,,22,13,35
HND-014974,2011,161700069,,,,1,3,4
HND-014976,2011,161700072,,,,4,2,6
HND-014977,2011,161700074,,,,1,5,6
HND-014980,2011,161700078,,,,3,3,6
HND-014981,2011,161700080,,,,4,6,10
HND-014984,2011,161700084,,,,2,1,3
HND-014985,2011,161700089,,,,3,0,3
HND-014986,2011,161700090,,,,3,3,6
HND-014988,2011,161700093,,,,11,7,18
HND-014989,2011,161700094,,,,2,1,3
HND-014994,2011,161700101,,,,0,1,1
HND-014995,2011,161700102,,,,2,2,4
HND-014996,2011,161700108,,,,0,1,1
HND-014997,2011,161700109,,,,8,0,8
HND-014999,2011,161700130,,,,4,12,16
HND-015012,2011,161700164,,,,2,1,3
HND-014909,2011,161700001,,,,71,84,155
HND-014910,2011,161700002,,,,39,34,73
HND-014911,2011,161700003,,,,80,66,146
HND-014912,2011,161700004,,,,4,4,8
HND-014914,2011,161700006,,,,6,3,9
HND-014917,2011,161700010,,,,15,10,25
HND-014918,2011,161700011,,,,1,2,3
HND-014922,2011,161700015,,,,2,2,4
HND-014923,2011,161700016,,,,9,2,11
HND-014925,2011,161700018,,,,4,3,7
HND-014927,2011,161700019,,,,22,16,38
HND-014926,2011,161700019,,,,22,16,38
HND-014930,2011,161700022,,,,18,20,38
HND-014931,2011,161700023,,,,5,5,10
HND-014932,2011,161700024,,,,11,5,16
HND-014933,2011,161700025,,,,3,8,11
HND-014934,2011,161700026,,,,3,11,14
HND-014935,2011,161700027,,,,4,7,11
HND-014936,2011,161700028,,,,39,34,73
HND-014941,2011,161700033,,,,5,2,7
HND-014942,2011,161700034,,,,6,4,10
HND-014943,2011,161700035,,,,3,7,10
HND-014945,2011,161700037,,,,18,9,27
HND-014946,2011,161700038,,,,4,6,10
HND-014963,2011,161700055,,,,3,3,6
HND-014965,2011,161700057,,,,17,12,29
HND-014966,2011,161700058,,,,5,1,6
HND-014967,2011,161700059,,,,4,4,8
,2011,161700063,,,,28,25,53
HND-014980,2011,161700078,,,,2,4,6
HND-014983,2011,161700083,,,,4,2,6
HND-014984,2011,161700084,,,,1,1,2
HND-014985,2011,161700089,,,,2,2,4
HND-014987,2011,161700092,,,,1,3,4
HND-014988,2011,161700093,,,,6,5,11
HND-014993,2011,161700100,,,,2,4,6
HND-014994,2011,161700101,,,,1,1,2
HND-014995,2011,161700102,,,,2,3,5
,2011,161700107,,,,3,2,5
HND-014996,2011,161700108,,,,2,2,4
HND-015000,2011,161700131,,,,3,2,5
HND-015012,2011,161700164,,,,1,3,4
HND-014915,2011,161700008,,,,2,3,5
HND-014916,2011,161700009,,,,17,6,23
HND-014919,2011,161700012,,,,6,14,20
HND-014920,2011,161700013,,,,6,2,8
HND-014921,2011,161700014,,,,7,3,10
HND-014924,2011,161700017,,,,6,10,16
HND-014928,2011,161700020,,,,30,13,43
HND-014929,2011,161700021,,,,7,7,14
HND-014937,2011,161700029,,,,0,4,4
HND-014938,2011,161700030,,,,5,11,16
HND-014939,2011,161700031,,,,4,1,5
HND-014944,2011,161700036,,,,4,2,6
HND-014947,2011,161700039,,,,2,0,2
HND-014948,2011,161700040,,,,0,4,4
HND-014949,2011,161700041,,,,20,17,37
HND-014950,2011,161700042,,,,2,0,2
HND-014952,2011,161700044,,,,18,14,32
HND-014960,2011,161700052,,,,10,11,21
HND-014961,2011,161700052,,,,10,11,21
HND-014964,2011,161700056,,,,5,2,7
HND-014968,2011,161700060,,,,4,5,9
HND-014969,2011,161700061,,,,9,9,18
HND-014970,2011,161700062,,,,12,19,31
HND-014971,2011,161700064,,,,3,6,9
HND-014974,2011,161700069,,,,1,1,2
HND-014975,2011,161700071,,,,2,5,7
HND-014976,2011,161700072,,,,1,2,3
HND-014977,2011,161700074,,,,4,2,6
HND-014981,2011,161700080,,,,3,4,7
HND-014982,2011,161700082,,,,5,4,9
HND-014986,2011,161700090,,,,2,5,7
HND-014989,2011,161700094,,,,6,4,10
HND-014992,2011,161700099,,,,2,2,4
,2011,161700126,,,,4,1,5
HND-014998,2011,161700128,,,,0,1,1
HND-014999,2011,161700130,,,,6,11,17
HND-015001,2011,161700140,,,,1,3,4
,2011,161700168,,,,3,2,5
HND-014909,2011,161700001,,,,78,86,164
HND-014910,2011,161700002,,,,34,29,63
HND-014911,2011,161700003,,,,61,74,135
HND-014912,2011,161700004,,,,3,3,6
HND-014913,2011,161700005,,,,0,1,1
HND-014915,2011,161700008,,,,5,1,6
HND-014917,2011,161700010,,,,5,6,11
HND-014918,2011,161700011,,,,2,4,6
HND-014922,2011,161700015,,,,4,2,6
HND-014923,2011,161700016,,,,6,8,14
HND-014927,2011,161700019,,,,14,19,33
HND-014926,2011,161700019,,,,14,19,33
HND-014931,2011,161700023,,,,0,8,8
HND-014933,2011,161700025,,,,14,5,19
HND-014934,2011,161700026,,,,5,7,12
HND-014935,2011,161700027,,,,9,4,13
HND-014936,2011,161700028,,,,34,29,63
HND-014937,2011,161700029,,,,1,1,2
HND-014941,2011,161700033,,,,0,5,5
HND-014943,2011,161700035,,,,5,2,7
HND-014945,2011,161700037,,,,22,11,33
HND-014946,2011,161700038,,,,5,2,7
HND-014948,2011,161700040,,,,2,4,6
HND-014949,2011,161700041,,,,17,20,37
HND-014963,2011,161700055,,,,1,3,4
HND-014966,2011,161700058,,,,1,2,3
HND-014967,2011,161700059,,,,2,6,8
HND-014974,2011,161700069,,,,1,4,5
HND-014980,2011,161700078,,,,2,2,4
HND-014982,2011,161700082,,,,1,1,2
HND-014983,2011,161700083,,,,5,2,7
HND-014985,2011,161700089,,,,5,0,5
HND-014987,2011,161700092,,,,4,2,6
HND-014988,2011,161700093,,,,9,10,19
HND-014992,2011,161700099,,,,2,4,6
HND-014994,2011,161700101,,,,1,2,3
HND-014995,2011,161700102,,,,4,3,7
,2011,161700107,,,,1,1,2
HND-014996,2011,161700108,,,,1,3,4
HND-014999,2011,161700130,,,,7,5,12
HND-015000,2011,161700131,,,,4,3,7
HND-014914,2011,161700006,,,,7,6,13
HND-014916,2011,161700009,,,,3,12,15
HND-014919,2011,161700012,,,,6,12,18
HND-014920,2011,161700013,,,,2,3,5
HND-014921,2011,161700014,,,,6,11,17
HND-014924,2011,161700017,,,,5,5,10
HND-014925,2011,161700018,,,,13,7,20
HND-014928,2011,161700020,,,,28,33,61
HND-014929,2011,161700021,,,,8,4,12
HND-014930,2011,161700022,,,,22,8,30
HND-014932,2011,161700024,,,,10,8,18
HND-014938,2011,161700030,,,,6,6,12
HND-014939,2011,161700031,,,,2,4,6
HND-014942,2011,161700034,,,,5,1,6
HND-014944,2011,161700036,,,,1,2,3
HND-014947,2011,161700039,,,,5,5,10
HND-014950,2011,161700042,,,,0,1,1
HND-014951,2011,161700043,,,,4,7,11
HND-014952,2011,161700044,,,,16,16,32
HND-014960,2011,161700052,,,,7,10,17
HND-014961,2011,161700052,,,,7,10,17
HND-014964,2011,161700056,,,,2,4,6
HND-014965,2011,161700057,,,,17,16,33
HND-014968,2011,161700060,,,,6,10,16
HND-014969,2011,161700061,,,,10,13,23
HND-014970,2011,161700062,,,,13,12,25
,2011,161700063,,,,14,16,30
HND-014971,2011,161700064,,,,5,2,7
HND-014975,2011,161700071,,,,3,2,5
HND-014976,2011,161700072,,,,2,2,4
HND-014977,2011,161700074,,,,3,0,3
HND-014981,2011,161700080,,,,3,3,6
HND-014984,2011,161700084,,,,1,4,5
HND-014986,2011,161700090,,,,0,3,3
HND-014989,2011,161700094,,,,5,2,7
HND-014993,2011,161700100,,,,3,2,5
HND-014997,2011,161700109,,,,4,3,7
,2011,161700126,,,,3,0,3
HND-014998,2011,161700128,,,,2,3,5
HND-015001,2011,161700140,,,,7,0,7
,2011,161700168,,,,1,1,2
HND-014909,2011,161700001,,,,68,77,145
HND-014913,2011,161700005,,,,3,1,4
HND-014915,2011,161700008,,,,2,1,3
HND-014916,2011,161700009,,,,10,7,17
HND-014917,2011,161700010,,,,16,10,26
HND-014918,2011,161700011,,,,5,1,6
HND-014919,2011,161700012,,,,9,10,19
HND-014920,2011,161700013,,,,1,1,2
HND-014921,2011,161700014,,,,2,3,5
HND-014923,2011,161700016,,,,3,8,11
HND-014924,2011,161700017,,,,5,6,11
HND-014928,2011,161700020,,,,22,16,38
HND-014929,2011,161700021,,,,7,8,15
HND-014937,2011,161700029,,,,3,3,6
HND-014938,2011,161700030,,,,4,6,10
HND-014939,2011,161700031,,,,4,2,6
HND-014944,2011,161700036,,,,1,1,2
HND-014946,2011,161700038,,,,3,4,7
HND-014947,2011,161700039,,,,5,3,8
HND-014948,2011,161700040,,,,3,6,9
HND-014949,2011,161700041,,,,22,17,39
HND-014950,2011,161700042,,,,1,3,4
HND-014951,2011,161700043,,,,5,6,11
HND-014952,2011,161700044,,,,11,13,24
HND-014964,2011,161700056,,,,2,6,8
HND-014967,2011,161700059,,,,8,3,11
HND-014968,2011,161700060,,,,4,9,13
HND-014969,2011,161700061,,,,10,12,22
HND-014974,2011,161700069,,,,3,0,3
HND-014975,2011,161700071,,,,3,2,5
HND-014976,2011,161700072,,,,2,2,4
HND-014977,2011,161700074,,,,1,2,3
HND-014982,2011,161700082,,,,8,9,17
HND-014986,2011,161700090,,,,1,2,3
HND-014987,2011,161700092,,,,2,3,5
HND-014992,2011,161700099,,,,2,2,4
HND-014996,2011,161700108,,,,3,5,8
HND-014997,2011,161700109,,,,2,3,5
,2011,161700126,,,,0,3,3
HND-014998,2011,161700128,,,,1,0,1
HND-014999,2011,161700130,,,,6,9,15
HND-014910,2011,161700002,,,,22,25,47
HND-014911,2011,161700003,,,,68,45,113
HND-014912,2011,161700004,,,,3,3,6
HND-014914,2011,161700006,,,,1,3,4
HND-014922,2011,161700015,,,,5,4,9
HND-014925,2011,161700018,,,,8,5,13
HND-014927,2011,161700019,,,,23,14,37
HND-014926,2011,161700019,,,,23,14,37
HND-014930,2011,161700022,,,,11,17,28
HND-014931,2011,161700023,,,,4,10,14
HND-014932,2011,161700024,,,,2,10,12
HND-014933,2011,161700025,,,,6,3,9
HND-014934,2011,161700026,,,,13,9,22
HND-014935,2011,161700027,,,,6,6,12
HND-014936,2011,161700028,,,,22,25,47
HND-014940,2011,161700032,,,,3,0,3
HND-014941,2011,161700033,,,,4,8,12
HND-014942,2011,161700034,,,,8,6,14
HND-014943,2011,161700035,,,,2,2,4
HND-014945,2011,161700037,,,,18,10,28
HND-014960,2011,161700052,,,,16,11,27
HND-014961,2011,161700052,,,,16,11,27
HND-014963,2011,161700055,,,,5,2,7
HND-014965,2011,161700057,,,,32,14,46
HND-014966,2011,161700058,,,,6,6,12
HND-014970,2011,161700062,,,,12,15,27
,2011,161700063,,,,19,14,33
HND-014971,2011,161700064,,,,3,1,4
HND-014980,2011,161700078,,,,4,5,9
HND-014981,2011,161700080,,,,3,8,11
HND-014983,2011,161700083,,,,1,2,3
HND-014984,2011,161700084,,,,1,2,3
HND-014985,2011,161700089,,,,2,0,2
HND-014988,2011,161700093,,,,6,9,15
HND-014989,2011,161700094,,,,1,6,7
HND-014993,2011,161700100,,,,2,3,5
HND-014994,2011,161700101,,,,2,2,4
,2011,161700107,,,,1,0,1
HND-015000,2011,161700131,,,,2,2,4
HND-015001,2011,161700140,,,,0,1,1
HND-015012,2011,161700164,,,,1,1,2
,2011,161700168,,,,1,0,1
HND-014917,2011,161700010,,,,11,16,27
HND-014934,2011,161700026,,,,14,10,24
HND-014935,2011,161700027,,,,4,7,11
HND-014958,2011,161700050,,,,100,123,223
HND-014965,2011,161700057,,,,20,29,49
,2011,161700103,,,,9,10,19
HND-014928,2011,161700020,,,,13,10,23
HND-014959,2011,161700051,,,,74,75,149
HND-014934,2011,161700026,,,,2,8,10
HND-014935,2011,161700027,,,,6,6,12
HND-014958,2011,161700050,,,,72,97,169
HND-014959,2011,161700051,,,,43,49,92
HND-014965,2011,161700057,,,,10,16,26
HND-014917,2011,161700010,,,,5,8,13
HND-014928,2011,161700020,,,,10,9,19
,2011,161700103,,,,19,11,30
HND-014934,2011,161700026,,,,3,9,12
HND-014935,2011,161700027,,,,3,3,6
HND-014958,2011,161700050,,,,46,62,108
HND-014917,2011,161700010,,,,4,5,9
HND-014928,2011,161700020,,,,10,14,24
HND-014959,2011,161700051,,,,50,42,92
,2011,161700103,,,,20,19,39
HND-014959,2011,161700051,,,,25,50,75
,2011,161700103,,,,50,67,117
HND-014958,2011,161700050,,,,28,47,75
HND-014959,2011,161700051,,,,22,34,56
HND-014958,2011,161700050,,,,14,46,60
,2011,161700103,,,,22,46,68
HND-014958,2011,161700050,,,,27,30,57
HND-014959,2011,161700051,,,,21,15,36
,2011,161700103,,,,21,30,51
HND-015027,2011,161800014,,,,3,3,6
HND-015029,2011,161800016,,,,12,5,17
HND-015030,2011,161800017,,,,2,6,8
HND-015036,2011,161800024,,,,3,5,8
HND-015043,2011,161800036,,,,7,5,12
HND-015047,2011,161800041,,,,4,3,7
HND-015048,2011,161800042,,,,7,3,10
HND-015028,2011,161800015,,,,11,6,17
,2011,161800023,,,,3,3,6
HND-015044,2011,161800038,,,,3,3,6
HND-015053,2011,161800069,,,,5,4,9
HND-015033,2011,161800020,,,,3,3,6
HND-015034,2011,161800021,,,,7,2,9
HND-015037,2011,161800026,,,,1,1,2
HND-015045,2011,161800039,,,,2,2,4
HND-015042,2011,161800034,,,,7,7,14
,2011,161800037,,,,2,2,4
HND-015050,2011,161800065,,,,2,1,3
HND-015034,2011,161800021,,,,4,8,12
HND-015037,2011,161800026,,,,6,9,15
HND-015041,2011,161800033,,,,3,5,8
,2011,161800037,,,,1,2,3
HND-015045,2011,161800039,,,,1,1,2
HND-015033,2011,161800020,,,,9,8,17
,2011,161800027,,,,6,2,8
HND-015042,2011,161800034,,,,1,2,3
HND-015050,2011,161800065,,,,5,2,7
HND-015033,2011,161800020,,,,12,5,17
,2011,161800027,,,,3,1,4
HND-015045,2011,161800039,,,,7,9,16
HND-015050,2011,161800065,,,,1,2,3
HND-015034,2011,161800021,,,,6,15,21
HND-015037,2011,161800026,,,,5,3,8
HND-015041,2011,161800033,,,,4,1,5
HND-015042,2011,161800034,,,,5,5,10
,2011,161800037,,,,2,3,5
HND-015014,2011,161800001,,,,19,14,33
HND-015015,2011,161800002,,,,14,14,28
HND-015019,2011,161800006,,,,1,3,4
HND-015021,2011,161800008,,,,3,4,7
HND-015022,2011,161800009,,,,6,9,15
HND-015023,2011,161800010,,,,1,0,1
HND-015024,2011,161800011,,,,13,1,14
HND-015032,2011,161800019,,,,6,13,19
HND-015038,2011,161800028,,,,4,4,8
HND-015039,2011,161800029,,,,13,7,20
HND-015046,2011,161800040,,,,1,1,2
HND-015052,2011,161800068,,,,6,2,8
HND-015016,2011,161800003,,,,7,3,10
HND-015017,2011,161800004,,,,0,2,2
HND-015018,2011,161800005,,,,6,8,14
HND-015020,2011,161800007,,,,1,4,5
HND-015026,2011,161800013,,,,6,4,10
HND-015031,2011,161800018,,,,3,4,7
HND-015035,2011,161800022,,,,5,4,9
HND-015040,2011,161800030,,,,1,3,4
HND-015049,2011,161800043,,,,5,2,7
,2011,161800066,,,,1,0,1
HND-015051,2011,161800067,,,,5,4,9
HND-015015,2011,161800002,,,,13,11,24
HND-015016,2011,161800003,,,,6,3,9
HND-015018,2011,161800005,,,,9,8,17
HND-015020,2011,161800007,,,,7,3,10
HND-015021,2011,161800008,,,,1,0,1
HND-015031,2011,161800018,,,,6,3,9
HND-015032,2011,161800019,,,,15,5,20
HND-015039,2011,161800029,,,,6,3,9
,2011,161800066,,,,0,1,1
HND-015052,2011,161800068,,,,5,1,6
HND-015014,2011,161800001,,,,21,10,31
HND-015017,2011,161800004,,,,2,3,5
HND-015019,2011,161800006,,,,2,3,5
HND-015022,2011,161800009,,,,4,7,11
HND-015023,2011,161800010,,,,0,1,1
HND-015024,2011,161800011,,,,5,6,11
HND-015026,2011,161800013,,,,8,7,15
HND-015035,2011,161800022,,,,6,3,9
HND-015038,2011,161800028,,,,3,3,6
HND-015040,2011,161800030,,,,1,5,6
HND-015049,2011,161800043,,,,3,4,7
HND-015051,2011,161800067,,,,9,10,19
HND-015016,2011,161800003,,,,5,2,7
HND-015017,2011,161800004,,,,4,2,6
HND-015018,2011,161800005,,,,5,10,15
HND-015020,2011,161800007,,,,0,7,7
HND-015021,2011,161800008,,,,3,3,6
HND-015026,2011,161800013,,,,5,5,10
HND-015031,2011,161800018,,,,2,1,3
HND-015035,2011,161800022,,,,4,3,7
HND-015046,2011,161800040,,,,5,3,8
,2011,161800066,,,,1,1,2
HND-015051,2011,161800067,,,,8,3,11
HND-015014,2011,161800001,,,,13,21,34
HND-015015,2011,161800002,,,,17,11,28
HND-015019,2011,161800006,,,,3,2,5
HND-015022,2011,161800009,,,,5,3,8
HND-015023,2011,161800010,,,,1,0,1
HND-015024,2011,161800011,,,,5,6,11
HND-015032,2011,161800019,,,,7,6,13
HND-015038,2011,161800028,,,,3,1,4
HND-015039,2011,161800029,,,,4,8,12
HND-015040,2011,161800030,,,,2,2,4
HND-015049,2011,161800043,,,,4,2,6
HND-015052,2011,161800068,,,,5,0,5
HND-015015,2011,161800002,,,,16,4,20
HND-015018,2011,161800005,,,,4,10,14
HND-015021,2011,161800008,,,,5,7,12
HND-015022,2011,161800009,,,,2,5,7
HND-015023,2011,161800010,,,,0,2,2
HND-015024,2011,161800011,,,,1,4,5
HND-015031,2011,161800018,,,,1,3,4
HND-015032,2011,161800019,,,,10,10,20
HND-015038,2011,161800028,,,,3,1,4
HND-015039,2011,161800029,,,,3,3,6
HND-015046,2011,161800040,,,,2,3,5
HND-015049,2011,161800043,,,,6,2,8
,2011,161800066,,,,3,0,3
HND-015052,2011,161800068,,,,0,1,1
HND-015014,2011,161800001,,,,14,17,31
HND-015016,2011,161800003,,,,8,2,10
HND-015017,2011,161800004,,,,5,2,7
HND-015019,2011,161800006,,,,3,0,3
HND-015020,2011,161800007,,,,8,5,13
HND-015026,2011,161800013,,,,4,3,7
HND-015035,2011,161800022,,,,5,4,9
HND-015040,2011,161800030,,,,4,2,6
HND-015051,2011,161800067,,,,7,1,8
HND-015015,2011,161800002,,,,13,17,30
HND-015022,2011,161800009,,,,3,4,7
HND-015023,2011,161800010,,,,3,2,5
HND-015024,2011,161800011,,,,1,4,5
HND-015032,2011,161800019,,,,20,30,50
HND-015038,2011,161800028,,,,7,5,12
HND-015039,2011,161800029,,,,0,1,1
HND-015040,2011,161800030,,,,2,2,4
HND-015046,2011,161800040,,,,0,8,8
HND-015049,2011,161800043,,,,5,2,7
,2011,161800066,,,,1,0,1
HND-015052,2011,161800068,,,,1,2,3
HND-015014,2011,161800001,,,,18,8,26
HND-015017,2011,161800004,,,,5,5,10
HND-015018,2011,161800005,,,,10,14,24
HND-015019,2011,161800006,,,,2,2,4
HND-015020,2011,161800007,,,,5,5,10
HND-015026,2011,161800013,,,,4,6,10
HND-015031,2011,161800018,,,,1,1,2
HND-015035,2011,161800022,,,,5,2,7
HND-015051,2011,161800067,,,,6,2,8
HND-015014,2011,161800001,,,,8,12,20
HND-015017,2011,161800004,,,,3,4,7
HND-015019,2011,161800006,,,,3,1,4
HND-015022,2011,161800009,,,,5,1,6
HND-015023,2011,161800010,,,,2,1,3
HND-015024,2011,161800011,,,,3,3,6
HND-015026,2011,161800013,,,,8,5,13
HND-015035,2011,161800022,,,,2,5,7
HND-015038,2011,161800028,,,,3,5,8
HND-015040,2011,161800030,,,,4,1,5
HND-015049,2011,161800043,,,,1,4,5
HND-015051,2011,161800067,,,,5,0,5
HND-015015,2011,161800002,,,,21,13,34
HND-015018,2011,161800005,,,,5,12,17
HND-015020,2011,161800007,,,,3,5,8
HND-015031,2011,161800018,,,,2,3,5
HND-015032,2011,161800019,,,,26,11,37
HND-015039,2011,161800029,,,,0,2,2
HND-015046,2011,161800040,,,,1,1,2
,2011,161800066,,,,2,1,3
HND-015052,2011,161800068,,,,5,0,5
HND-015025,2011,161800012,,,,38,22,60
HND-015014,2011,161800001,,,,6,18,24
HND-015014,2011,161800001,,,,22,9,31
HND-015025,2011,161800012,,,,23,16,39
HND-015014,2011,161800001,,,,6,7,13
HND-015025,2011,161800012,,,,14,16,30
HND-015025,2011,161800012,,,,9,11,20
HND-015025,2011,161800012,,,,4,5,9
HND-015025,2011,161800012,,,,1,5,6
HND-015096,2011,161900045,,,,5,2,7
HND-015100,2011,161900050,,,,8,7,15
HND-015102,2011,161900052,,,,3,8,11
,2011,161900054,,,,9,17,26
HND-015107,2011,161900060,,,,10,7,17
HND-015108,2011,161900062,,,,3,9,12
HND-015110,2011,161900065,,,,3,7,10
HND-015112,2011,161900067,,,,10,8,18
HND-015113,2011,161900068,,,,7,12,19
,2011,161900069,,,,5,4,9
HND-015118,2011,161900104,,,,4,8,12
HND-015120,2011,161900109,,,,10,5,15
,2011,161900112,,,,8,4,12
,2011,161900047,,,,3,4,7
HND-015098,2011,161900048,,,,13,9,22
HND-015099,2011,161900049,,,,11,6,17
HND-015101,2011,161900051,,,,8,16,24
HND-015104,2011,161900055,,,,5,6,11
HND-015105,2011,161900056,,,,5,6,11
,2011,161900059,,,,8,7,15
,2011,161900063,,,,10,8,18
,2011,161900078,,,,10,4,14
HND-015119,2011,161900105,,,,7,3,10
,2011,161900106,,,,8,6,14
,2011,161900108,,,,4,5,9
,2011,161900041,,,,3,2,5
,2011,161900046,,,,0,2,2
HND-015111,2011,161900066,,,,2,0,2
HND-015072,2011,161900019,,,,15,21,36
,2011,161900041,,,,4,0,4
HND-015095,2011,161900044,,,,5,4,9
,2011,161900046,,,,5,6,11
HND-015106,2011,161900058,,,,6,3,9
HND-015111,2011,161900066,,,,2,4,6
HND-015116,2011,161900072,,,,8,7,15
HND-015072,2011,161900019,,,,20,25,45
,2011,161900046,,,,8,8,16
,2011,161900041,,,,3,4,7
HND-015095,2011,161900044,,,,7,9,16
HND-015106,2011,161900058,,,,17,6,23
HND-015111,2011,161900066,,,,8,2,10
HND-015116,2011,161900072,,,,4,7,11
HND-015055,2011,161900001,,,,18,22,40
HND-015057,2011,161900003,,,,3,4,7
HND-015059,2011,161900005,,,,6,0,6
HND-015061,2011,161900007,,,,10,8,18
HND-015063,2011,161900009,,,,7,2,9
HND-015064,2011,161900010,,,,6,8,14
HND-015065,2011,161900011,,,,8,5,13
HND-015066,2011,161900012,,,,3,2,5
HND-015067,2011,161900013,,,,12,12,24
HND-015069,2011,161900016,,,,2,8,10
HND-015070,2011,161900017,,,,5,8,13
HND-015078,2011,161900025,,,,12,7,19
,2011,161900027,,,,5,2,7
,2011,161900028,,,,8,4,12
HND-015081,2011,161900029,,,,9,6,15
,2011,161900030,,,,11,9,20
,2011,161900031,,,,6,2,8
HND-015091,2011,161900039,,,,1,3,4
HND-015114,2011,161900070,,,,7,3,10
HND-015115,2011,161900071,,,,5,5,10
HND-015117,2011,161900102,,,,3,1,4
,2011,161900107,,,,3,7,10
HND-015122,2011,161900111,,,,0,1,1
HND-015056,2011,161900002,,,,9,0,9
,2011,161900004,,,,2,3,5
HND-015060,2011,161900006,,,,8,5,13
HND-015062,2011,161900008,,,,22,15,37
HND-015068,2011,161900015,,,,5,1,6
,2011,161900018,,,,9,0,9
HND-015072,2011,161900019,,,,3,1,4
HND-015073,2011,161900020,,,,6,6,12
HND-015074,2011,161900021,,,,2,3,5
HND-015075,2011,161900022,,,,4,11,15
HND-015076,2011,161900023,,,,12,20,32
HND-015077,2011,161900024,,,,10,10,20
HND-015079,2011,161900026,,,,2,4,6
HND-015084,2011,161900032,,,,6,13,19
HND-015085,2011,161900033,,,,3,1,4
HND-015087,2011,161900035,,,,3,0,3
HND-015088,2011,161900036,,,,8,3,11
HND-015089,2011,161900037,,,,3,1,4
HND-015090,2011,161900038,,,,5,2,7
HND-015094,2011,161900043,,,,5,8,13
HND-015060,2011,161900006,,,,4,8,12
HND-015062,2011,161900008,,,,16,12,28
HND-015063,2011,161900009,,,,2,5,7
HND-015066,2011,161900012,,,,6,2,8
HND-015067,2011,161900013,,,,11,8,19
HND-015068,2011,161900015,,,,2,1,3
HND-015070,2011,161900017,,,,3,1,4
,2011,161900018,,,,4,2,6
HND-015073,2011,161900020,,,,3,3,6
HND-015074,2011,161900021,,,,6,8,14
HND-015079,2011,161900026,,,,4,7,11
,2011,161900028,,,,6,5,11
HND-015081,2011,161900029,,,,5,3,8
HND-015087,2011,161900035,,,,1,1,2
HND-015088,2011,161900036,,,,0,3,3
HND-015090,2011,161900038,,,,1,1,2
HND-015091,2011,161900039,,,,0,3,3
HND-015122,2011,161900111,,,,1,4,5
HND-015055,2011,161900001,,,,15,14,29
HND-015056,2011,161900002,,,,13,9,22
HND-015057,2011,161900003,,,,1,1,2
,2011,161900004,,,,2,1,3
HND-015059,2011,161900005,,,,3,1,4
HND-015061,2011,161900007,,,,13,8,21
HND-015064,2011,161900010,,,,8,6,14
HND-015065,2011,161900011,,,,4,8,12
HND-015069,2011,161900016,,,,2,5,7
HND-015072,2011,161900019,,,,3,4,7
HND-015075,2011,161900022,,,,8,10,18
HND-015076,2011,161900023,,,,12,13,25
HND-015077,2011,161900024,,,,12,8,20
HND-015078,2011,161900025,,,,6,3,9
,2011,161900027,,,,4,3,7
,2011,161900030,,,,8,2,10
,2011,161900031,,,,8,5,13
HND-015084,2011,161900032,,,,3,4,7
HND-015085,2011,161900033,,,,0,1,1
,2011,161900034,,,,5,3,8
HND-015089,2011,161900037,,,,3,1,4
HND-015094,2011,161900043,,,,3,4,7
HND-015114,2011,161900070,,,,1,3,4
HND-015115,2011,161900071,,,,3,4,7
HND-015117,2011,161900102,,,,1,0,1
HND-015055,2011,161900001,,,,26,16,42
HND-015059,2011,161900005,,,,1,3,4
HND-015061,2011,161900007,,,,10,9,19
HND-015063,2011,161900009,,,,7,7,14
HND-015064,2011,161900010,,,,5,4,9
HND-015065,2011,161900011,,,,7,3,10
HND-015066,2011,161900012,,,,5,5,10
HND-015067,2011,161900013,,,,8,5,13
HND-015069,2011,161900016,,,,6,1,7
HND-015070,2011,161900017,,,,5,4,9
HND-015078,2011,161900025,,,,5,1,6
,2011,161900028,,,,3,3,6
HND-015081,2011,161900029,,,,4,4,8
HND-015084,2011,161900032,,,,6,3,9
HND-015085,2011,161900033,,,,0,1,1
,2011,161900034,,,,2,2,4
HND-015087,2011,161900035,,,,1,1,2
HND-015088,2011,161900036,,,,2,5,7
HND-015089,2011,161900037,,,,0,2,2
HND-015090,2011,161900038,,,,1,2,3
HND-015056,2011,161900002,,,,7,15,22
,2011,161900004,,,,4,1,5
HND-015060,2011,161900006,,,,5,2,7
HND-015062,2011,161900008,,,,23,24,47
HND-015068,2011,161900015,,,,1,2,3
,2011,161900018,,,,3,2,5
HND-015072,2011,161900019,,,,3,4,7
HND-015073,2011,161900020,,,,6,5,11
HND-015074,2011,161900021,,,,4,5,9
HND-015075,2011,161900022,,,,9,2,11
HND-015076,2011,161900023,,,,15,13,28
HND-015077,2011,161900024,,,,6,6,12
HND-015079,2011,161900026,,,,2,3,5
,2011,161900027,,,,4,6,10
,2011,161900030,,,,7,4,11
,2011,161900031,,,,6,3,9
HND-015091,2011,161900039,,,,3,2,5
HND-015094,2011,161900043,,,,4,3,7
HND-015114,2011,161900070,,,,3,2,5
HND-015115,2011,161900071,,,,7,2,9
HND-015117,2011,161900102,,,,4,5,9
HND-015122,2011,161900111,,,,8,4,12
HND-015060,2011,161900006,,,,6,2,8
HND-015062,2011,161900008,,,,18,19,37
HND-015063,2011,161900009,,,,2,4,6
HND-015066,2011,161900012,,,,6,3,9
HND-015067,2011,161900013,,,,12,9,21
HND-015068,2011,161900015,,,,0,2,2
HND-015070,2011,161900017,,,,3,1,4
,2011,161900018,,,,1,1,2
HND-015073,2011,161900020,,,,3,4,7
HND-015074,2011,161900021,,,,3,2,5
HND-015079,2011,161900026,,,,9,5,14
HND-015081,2011,161900029,,,,3,8,11
HND-015088,2011,161900036,,,,3,4,7
HND-015090,2011,161900038,,,,0,1,1
HND-015091,2011,161900039,,,,1,0,1
HND-015122,2011,161900111,,,,1,0,1
HND-015055,2011,161900001,,,,24,19,43
HND-015056,2011,161900002,,,,6,4,10
HND-015057,2011,161900003,,,,1,1,2
,2011,161900004,,,,2,5,7
HND-015059,2011,161900005,,,,3,3,6
HND-015061,2011,161900007,,,,9,11,20
HND-015064,2011,161900010,,,,4,2,6
HND-015065,2011,161900011,,,,7,4,11
HND-015069,2011,161900016,,,,3,3,6
HND-015072,2011,161900019,,,,2,2,4
HND-015075,2011,161900022,,,,7,10,17
HND-015076,2011,161900023,,,,15,11,26
HND-015077,2011,161900024,,,,10,7,17
HND-015078,2011,161900025,,,,2,3,5
,2011,161900027,,,,2,3,5
,2011,161900028,,,,3,4,7
,2011,161900030,,,,18,10,28
,2011,161900031,,,,4,2,6
HND-015084,2011,161900032,,,,7,4,11
HND-015085,2011,161900033,,,,4,3,7
,2011,161900034,,,,1,2,3
HND-015087,2011,161900035,,,,3,0,3
HND-015089,2011,161900037,,,,3,3,6
HND-015094,2011,161900043,,,,5,8,13
HND-015114,2011,161900070,,,,6,5,11
HND-015115,2011,161900071,,,,8,6,14
HND-015117,2011,161900102,,,,1,2,3
,2011,161900110,,,,4,2,6
HND-015056,2011,161900002,,,,8,3,11
,2011,161900004,,,,4,3,7
HND-015060,2011,161900006,,,,4,2,6
HND-015062,2011,161900008,,,,25,31,56
HND-015063,2011,161900009,,,,3,4,7
HND-015067,2011,161900013,,,,10,13,23
HND-015068,2011,161900015,,,,4,1,5
HND-015070,2011,161900017,,,,4,2,6
,2011,161900018,,,,2,3,5
HND-015072,2011,161900019,,,,3,3,6
HND-015073,2011,161900020,,,,6,3,9
HND-015074,2011,161900021,,,,3,10,13
HND-015075,2011,161900022,,,,3,10,13
HND-015077,2011,161900024,,,,8,16,24
HND-015079,2011,161900026,,,,5,5,10
,2011,161900030,,,,7,10,17
,2011,161900031,,,,5,5,10
HND-015091,2011,161900039,,,,5,1,6
HND-015117,2011,161900102,,,,6,3,9
HND-015055,2011,161900001,,,,22,22,44
HND-015057,2011,161900003,,,,3,2,5
HND-015059,2011,161900005,,,,1,3,4
HND-015061,2011,161900007,,,,20,10,30
HND-015064,2011,161900010,,,,2,2,4
HND-015065,2011,161900011,,,,9,7,16
HND-015066,2011,161900012,,,,2,3,5
HND-015069,2011,161900016,,,,2,3,5
HND-015076,2011,161900023,,,,24,12,36
HND-015078,2011,161900025,,,,6,3,9
,2011,161900027,,,,3,1,4
,2011,161900028,,,,6,1,7
HND-015081,2011,161900029,,,,2,8,10
HND-015084,2011,161900032,,,,6,11,17
HND-015085,2011,161900033,,,,2,0,2
,2011,161900034,,,,1,2,3
HND-015087,2011,161900035,,,,2,1,3
HND-015088,2011,161900036,,,,3,2,5
HND-015089,2011,161900037,,,,0,2,2
HND-015090,2011,161900038,,,,0,2,2
HND-015094,2011,161900043,,,,6,8,14
HND-015114,2011,161900070,,,,3,3,6
HND-015115,2011,161900071,,,,4,4,8
,2011,161900110,,,,3,0,3
HND-015055,2011,161900001,,,,19,21,40
HND-015056,2011,161900002,,,,6,6,12
HND-015057,2011,161900003,,,,2,2,4
,2011,161900004,,,,2,1,3
HND-015059,2011,161900005,,,,2,10,12
HND-015061,2011,161900007,,,,11,11,22
HND-015064,2011,161900010,,,,2,1,3
HND-015065,2011,161900011,,,,6,4,10
HND-015069,2011,161900016,,,,2,5,7
HND-015072,2011,161900019,,,,5,2,7
HND-015075,2011,161900022,,,,4,5,9
HND-015076,2011,161900023,,,,18,10,28
HND-015077,2011,161900024,,,,2,4,6
HND-015078,2011,161900025,,,,0,3,3
,2011,161900027,,,,2,3,5
,2011,161900030,,,,8,12,20
,2011,161900031,,,,2,2,4
HND-015084,2011,161900032,,,,6,6,12
,2011,161900034,,,,0,3,3
HND-015089,2011,161900037,,,,3,2,5
HND-015094,2011,161900043,,,,6,5,11
HND-015114,2011,161900070,,,,3,6,9
HND-015115,2011,161900071,,,,2,3,5
HND-015117,2011,161900102,,,,3,0,3
,2011,161900110,,,,0,3,3
HND-015060,2011,161900006,,,,4,4,8
HND-015062,2011,161900008,,,,18,26,44
HND-015063,2011,161900009,,,,5,6,11
HND-015066,2011,161900012,,,,2,3,5
HND-015067,2011,161900013,,,,6,5,11
HND-015068,2011,161900015,,,,2,2,4
HND-015070,2011,161900017,,,,2,2,4
,2011,161900018,,,,5,1,6
HND-015073,2011,161900020,,,,6,7,13
HND-015074,2011,161900021,,,,6,4,10
HND-015079,2011,161900026,,,,3,5,8
,2011,161900028,,,,3,3,6
HND-015081,2011,161900029,,,,8,7,15
HND-015087,2011,161900035,,,,1,0,1
HND-015088,2011,161900036,,,,2,6,8
HND-015091,2011,161900039,,,,5,3,8
HND-015061,2011,161900007,,,,9,7,16
HND-015063,2011,161900009,,,,13,15,28
HND-015067,2011,161900013,,,,9,13,22
,2011,161900030,,,,12,10,22
HND-015093,2011,161900042,,,,84,45,129
,2011,161900107,,,,7,8,15
HND-015060,2011,161900006,,,,9,5,14
HND-015065,2011,161900011,,,,15,7,22
HND-015066,2011,161900012,,,,21,7,28
HND-015060,2011,161900006,,,,11,10,21
HND-015063,2011,161900009,,,,8,5,13
HND-015066,2011,161900012,,,,18,7,25
HND-015067,2011,161900013,,,,9,8,17
,2011,161900107,,,,13,12,25
HND-015061,2011,161900007,,,,5,5,10
HND-015065,2011,161900011,,,,9,12,21
,2011,161900030,,,,16,21,37
HND-015093,2011,161900042,,,,42,41,83
HND-015060,2011,161900006,,,,8,4,12
HND-015063,2011,161900009,,,,7,7,14
HND-015066,2011,161900012,,,,10,10,20
HND-015067,2011,161900013,,,,8,3,11
HND-015061,2011,161900007,,,,6,7,13
HND-015065,2011,161900011,,,,11,6,17
,2011,161900030,,,,10,9,19
HND-015093,2011,161900042,,,,29,39,68
,2011,161900107,,,,11,11,22
,2011,161900107,,,,4,9,13
HND-015093,2011,161900042,,,,74,62,136
HND-015093,2011,161900042,,,,53,55,108
,2011,161900107,,,,7,8,15
HND-015093,2011,161900042,,,,40,51,91
HND-015169,2011,162000047,,,,11,7,18
HND-015171,2011,162000049,,,,9,2,11
,2011,162000065,,,,9,3,12
HND-015178,2011,162000074,,,,7,6,13
,2011,162000075,,,,2,9,11
HND-015179,2011,162000076,,,,4,4,8
HND-015180,2011,162000077,,,,7,8,15
HND-015182,2011,162000084,,,,5,8,13
,2011,162000085,,,,6,8,14
HND-015194,2011,162000109,,,,9,11,20
,2011,162000113,,,,9,6,15
,2011,162000119,,,,2,7,9
,2011,162000121,,,,10,9,19
HND-015197,2011,162000123,,,,6,6,12
,2011,162000124,,,,8,2,10
,2011,162000130,,,,5,3,8
,2011,162000131,,,,5,5,10
,2011,162000137,,,,5,9,14
,2011,162000160,,,,9,6,15
HND-015207,2011,162000185,,,,11,2,13
,2011,162000198,,,,4,4,8
HND-015170,2011,162000048,,,,8,7,15
,2011,162000051,,,,5,11,16
HND-015174,2011,162000053,,,,11,9,20
HND-015176,2011,162000064,,,,4,3,7
,2011,162000067,,,,3,5,8
,2011,162000069,,,,4,4,8
HND-015177,2011,162000072,,,,6,6,12
,2011,162000073,,,,7,5,12
,2011,162000079,,,,3,4,7
,2011,162000080,,,,5,9,14
HND-015181,2011,162000082,,,,8,8,16
,2011,162000103,,,,11,6,17
HND-015192,2011,162000105,,,,2,8,10
HND-015193,2011,162000108,,,,12,6,18
,2011,162000112,,,,1,7,8
HND-015195,2011,162000114,,,,4,7,11
,2011,162000115,,,,9,8,17
,2011,162000117,,,,7,5,12
,2011,162000122,,,,5,4,9
,2011,162000132,,,,9,9,18
,2011,162000143,,,,5,5,10
HND-015201,2011,162000151,,,,9,3,12
,2011,162000162,,,,7,8,15
HND-015202,2011,162000170,,,,4,11,15
HND-015208,2011,162000190,,,,6,2,8
,2011,162000191,,,,4,5,9
,2011,162000192,,,,5,7,12
,2011,162000194,,,,5,3,8
,2011,162000195,,,,7,5,12
HND-015210,2011,162000196,,,,7,2,9
HND-015211,2011,162000197,,,,5,6,11
,2011,162000201,,,,2,4,6
HND-015209,2011,162000193,,,,3,6,9
HND-015165,2011,162000042,,,,27,17,44
HND-015166,2011,162000043,,,,1,3,4
HND-015172,2011,162000050,,,,1,4,5
HND-015173,2011,162000052,,,,4,1,5
HND-015165,2011,162000042,,,,26,44,70
HND-015166,2011,162000043,,,,7,10,17
HND-015173,2011,162000052,,,,11,6,17
HND-015172,2011,162000050,,,,10,6,16
HND-015209,2011,162000193,,,,8,5,13
HND-015124,2011,162000001,,,,40,45,85
HND-015125,2011,162000002,,,,3,3,6
HND-015128,2011,162000005,,,,6,8,14
HND-015131,2011,162000008,,,,18,15,33
HND-015133,2011,162000010,,,,9,7,16
HND-015134,2011,162000011,,,,5,4,9
HND-015137,2011,162000014,,,,13,11,24
HND-015138,2011,162000015,,,,12,9,21
HND-015139,2011,162000016,,,,8,6,14
HND-015140,2011,162000017,,,,9,8,17
HND-015144,2011,162000021,,,,8,1,9
HND-015145,2011,162000022,,,,9,8,17
HND-015146,2011,162000023,,,,3,6,9
HND-015152,2011,162000029,,,,2,4,6
HND-015155,2011,162000032,,,,10,7,17
HND-015156,2011,162000033,,,,5,2,7
HND-015161,2011,162000038,,,,6,9,15
HND-015162,2011,162000039,,,,3,2,5
HND-015163,2011,162000040,,,,8,9,17
HND-015175,2011,162000055,,,,13,16,29
HND-015184,2011,162000091,,,,0,1,1
HND-015187,2011,162000094,,,,5,3,8
HND-015188,2011,162000095,,,,1,0,1
HND-015189,2011,162000096,,,,6,4,10
HND-015191,2011,162000102,,,,11,6,17
HND-015195,2011,162000114,,,,4,4,8
HND-015199,2011,162000127,,,,4,2,6
HND-015200,2011,162000128,,,,1,1,2
HND-015206,2011,162000184,,,,8,5,13
,2011,162000187,,,,3,7,10
,2011,162000200,,,,5,3,8
HND-015126,2011,162000003,,,,3,6,9
HND-015127,2011,162000004,,,,4,7,11
HND-015129,2011,162000006,,,,26,9,35
HND-015130,2011,162000007,,,,10,5,15
,2011,162000009,,,,23,22,45
HND-015135,2011,162000012,,,,15,9,24
HND-015136,2011,162000013,,,,10,8,18
HND-015141,2011,162000018,,,,5,2,7
HND-015142,2011,162000019,,,,8,7,15
HND-015143,2011,162000020,,,,5,2,7
HND-015147,2011,162000024,,,,3,4,7
HND-015148,2011,162000025,,,,11,10,21
HND-015149,2011,162000026,,,,6,8,14
HND-015150,2011,162000027,,,,13,7,20
HND-015151,2011,162000028,,,,14,11,25
HND-015153,2011,162000030,,,,4,7,11
HND-015154,2011,162000031,,,,3,2,5
HND-015157,2011,162000034,,,,2,3,5
HND-015158,2011,162000035,,,,5,1,6
HND-015159,2011,162000036,,,,7,5,12
HND-015160,2011,162000037,,,,7,3,10
HND-015164,2011,162000041,,,,4,2,6
,2011,162000045,,,,9,5,14
HND-015168,2011,162000046,,,,4,7,11
HND-015183,2011,162000090,,,,6,4,10
HND-015185,2011,162000092,,,,8,8,16
HND-015186,2011,162000093,,,,6,7,13
HND-015190,2011,162000098,,,,4,4,8
HND-015198,2011,162000125,,,,1,4,5
HND-015203,2011,162000181,,,,3,3,6
HND-015204,2011,162000182,,,,6,1,7
HND-015205,2011,162000183,,,,1,0,1
,2011,162000199,,,,1,0,1
HND-015124,2011,162000001,,,,35,35,70
HND-015127,2011,162000004,,,,8,7,15
HND-015128,2011,162000005,,,,7,6,13
HND-015129,2011,162000006,,,,22,15,37
HND-015130,2011,162000007,,,,1,4,5
HND-015133,2011,162000010,,,,4,9,13
HND-015134,2011,162000011,,,,8,5,13
HND-015136,2011,162000013,,,,8,12,20
HND-015137,2011,162000014,,,,14,17,31
HND-015139,2011,162000016,,,,4,6,10
HND-015142,2011,162000019,,,,6,4,10
HND-015145,2011,162000022,,,,8,7,15
HND-015148,2011,162000025,,,,8,9,17
HND-015151,2011,162000028,,,,10,11,21
HND-015155,2011,162000032,,,,9,10,19
HND-015160,2011,162000037,,,,10,9,19
HND-015161,2011,162000038,,,,11,2,13
HND-015163,2011,162000040,,,,8,4,12
HND-015164,2011,162000041,,,,1,1,2
HND-015168,2011,162000046,,,,4,10,14
HND-015184,2011,162000091,,,,2,4,6
HND-015186,2011,162000093,,,,5,2,7
HND-015187,2011,162000094,,,,0,3,3
HND-015189,2011,162000096,,,,5,3,8
HND-015191,2011,162000102,,,,12,5,17
HND-015198,2011,162000125,,,,1,3,4
HND-015204,2011,162000182,,,,2,1,3
HND-015206,2011,162000184,,,,7,3,10
,2011,162000187,,,,4,6,10
,2011,162000200,,,,6,10,16
HND-015125,2011,162000002,,,,5,4,9
HND-015126,2011,162000003,,,,0,4,4
HND-015131,2011,162000008,,,,12,20,32
,2011,162000009,,,,24,13,37
HND-015135,2011,162000012,,,,4,7,11
HND-015138,2011,162000015,,,,9,10,19
HND-015140,2011,162000017,,,,4,8,12
HND-015141,2011,162000018,,,,4,1,5
HND-015143,2011,162000020,,,,6,0,6
HND-015144,2011,162000021,,,,1,3,4
HND-015146,2011,162000023,,,,10,4,14
HND-015147,2011,162000024,,,,3,0,3
HND-015149,2011,162000026,,,,10,5,15
HND-015150,2011,162000027,,,,10,11,21
HND-015152,2011,162000029,,,,0,4,4
HND-015153,2011,162000030,,,,4,0,4
HND-015154,2011,162000031,,,,2,4,6
HND-015156,2011,162000033,,,,7,2,9
HND-015157,2011,162000034,,,,1,2,3
HND-015158,2011,162000035,,,,2,2,4
HND-015159,2011,162000036,,,,6,7,13
HND-015162,2011,162000039,,,,1,1,2
,2011,162000045,,,,6,4,10
HND-015175,2011,162000055,,,,20,11,31
HND-015183,2011,162000090,,,,6,7,13
HND-015185,2011,162000092,,,,5,9,14
HND-015188,2011,162000095,,,,4,3,7
HND-015190,2011,162000098,,,,2,5,7
HND-015195,2011,162000114,,,,7,4,11
HND-015199,2011,162000127,,,,2,0,2
HND-015200,2011,162000128,,,,3,4,7
HND-015203,2011,162000181,,,,2,1,3
HND-015205,2011,162000183,,,,4,3,7
,2011,162000199,,,,4,4,8
HND-015126,2011,162000003,,,,4,0,4
HND-015127,2011,162000004,,,,5,6,11
HND-015129,2011,162000006,,,,21,10,31
HND-015130,2011,162000007,,,,4,2,6
,2011,162000009,,,,24,20,44
HND-015135,2011,162000012,,,,5,5,10
HND-015136,2011,162000013,,,,4,4,8
HND-015141,2011,162000018,,,,1,2,3
HND-015142,2011,162000019,,,,4,2,6
HND-015143,2011,162000020,,,,2,4,6
HND-015147,2011,162000024,,,,1,0,1
HND-015148,2011,162000025,,,,12,12,24
HND-015149,2011,162000026,,,,8,7,15
HND-015150,2011,162000027,,,,7,6,13
HND-015151,2011,162000028,,,,8,11,19
HND-015153,2011,162000030,,,,3,1,4
HND-015157,2011,162000034,,,,1,4,5
HND-015158,2011,162000035,,,,2,2,4
HND-015159,2011,162000036,,,,3,5,8
HND-015160,2011,162000037,,,,9,4,13
HND-015161,2011,162000038,,,,1,5,6
HND-015164,2011,162000041,,,,1,0,1
,2011,162000045,,,,3,3,6
HND-015168,2011,162000046,,,,3,6,9
HND-015183,2011,162000090,,,,3,2,5
HND-015184,2011,162000091,,,,1,3,4
HND-015185,2011,162000092,,,,11,6,17
HND-015186,2011,162000093,,,,1,5,6
HND-015198,2011,162000125,,,,1,3,4
HND-015203,2011,162000181,,,,1,1,2
HND-015204,2011,162000182,,,,2,2,4
HND-015205,2011,162000183,,,,0,2,2
,2011,162000199,,,,1,1,2
HND-015124,2011,162000001,,,,27,43,70
HND-015125,2011,162000002,,,,5,5,10
HND-015128,2011,162000005,,,,5,6,11
HND-015131,2011,162000008,,,,8,17,25
HND-015133,2011,162000010,,,,9,4,13
HND-015134,2011,162000011,,,,7,1,8
HND-015137,2011,162000014,,,,11,4,15
HND-015138,2011,162000015,,,,6,2,8
HND-015139,2011,162000016,,,,1,7,8
HND-015140,2011,162000017,,,,3,7,10
HND-015144,2011,162000021,,,,3,4,7
HND-015145,2011,162000022,,,,3,4,7
HND-015146,2011,162000023,,,,5,2,7
HND-015152,2011,162000029,,,,0,1,1
HND-015154,2011,162000031,,,,3,4,7
HND-015155,2011,162000032,,,,2,5,7
HND-015156,2011,162000033,,,,2,0,2
HND-015162,2011,162000039,,,,2,0,2
HND-015163,2011,162000040,,,,6,3,9
HND-015175,2011,162000055,,,,10,15,25
HND-015187,2011,162000094,,,,1,2,3
HND-015188,2011,162000095,,,,2,1,3
HND-015189,2011,162000096,,,,6,1,7
HND-015190,2011,162000098,,,,4,3,7
HND-015191,2011,162000102,,,,4,9,13
HND-015195,2011,162000114,,,,6,3,9
HND-015199,2011,162000127,,,,2,1,3
HND-015200,2011,162000128,,,,2,1,3
HND-015206,2011,162000184,,,,4,2,6
,2011,162000187,,,,7,5,12
HND-015124,2011,162000001,,,,52,46,98
HND-015127,2011,162000004,,,,8,2,10
HND-015128,2011,162000005,,,,6,6,12
HND-015129,2011,162000006,,,,22,18,40
HND-015130,2011,162000007,,,,5,8,13
HND-015131,2011,162000008,,,,13,8,21
HND-015133,2011,162000010,,,,2,5,7
HND-015134,2011,162000011,,,,6,7,13
HND-015136,2011,162000013,,,,6,12,18
HND-015137,2011,162000014,,,,9,9,18
HND-015139,2011,162000016,,,,5,7,12
HND-015140,2011,162000017,,,,3,5,8
HND-015142,2011,162000019,,,,2,4,6
HND-015145,2011,162000022,,,,2,4,6
HND-015146,2011,162000023,,,,4,1,5
HND-015148,2011,162000025,,,,5,11,16
HND-015151,2011,162000028,,,,10,11,21
HND-015155,2011,162000032,,,,4,5,9
HND-015161,2011,162000038,,,,5,4,9
HND-015163,2011,162000040,,,,10,8,18
HND-015164,2011,162000041,,,,4,4,8
HND-015168,2011,162000046,,,,6,3,9
HND-015175,2011,162000055,,,,8,14,22
HND-015184,2011,162000091,,,,1,0,1
HND-015186,2011,162000093,,,,5,5,10
HND-015187,2011,162000094,,,,4,0,4
HND-015189,2011,162000096,,,,4,1,5
HND-015200,2011,162000128,,,,1,1,2
HND-015204,2011,162000182,,,,1,1,2
,2011,162000187,,,,10,10,20
,2011,162000200,,,,0,3,3
HND-015125,2011,162000002,,,,4,4,8
HND-015126,2011,162000003,,,,1,5,6
,2011,162000009,,,,6,8,14
HND-015135,2011,162000012,,,,2,1,3
HND-015138,2011,162000015,,,,5,8,13
HND-015141,2011,162000018,,,,5,4,9
HND-015143,2011,162000020,,,,0,6,6
HND-015144,2011,162000021,,,,4,0,4
HND-015147,2011,162000024,,,,1,0,1
HND-015149,2011,162000026,,,,6,1,7
HND-015150,2011,162000027,,,,5,6,11
HND-015152,2011,162000029,,,,0,1,1
HND-015153,2011,162000030,,,,4,1,5
HND-015154,2011,162000031,,,,6,4,10
HND-015156,2011,162000033,,,,3,4,7
HND-015157,2011,162000034,,,,2,0,2
HND-015158,2011,162000035,,,,3,1,4
HND-015159,2011,162000036,,,,2,2,4
HND-015160,2011,162000037,,,,1,6,7
HND-015162,2011,162000039,,,,3,1,4
,2011,162000045,,,,5,8,13
HND-015183,2011,162000090,,,,4,5,9
HND-015185,2011,162000092,,,,5,6,11
HND-015188,2011,162000095,,,,2,1,3
HND-015190,2011,162000098,,,,7,5,12
HND-015191,2011,162000102,,,,5,1,6
HND-015195,2011,162000114,,,,3,2,5
HND-015198,2011,162000125,,,,4,1,5
HND-015199,2011,162000127,,,,3,2,5
HND-015203,2011,162000181,,,,0,3,3
HND-015205,2011,162000183,,,,3,3,6
,2011,162000199,,,,1,5,6
HND-015124,2011,162000001,,,,46,59,105
HND-015125,2011,162000002,,,,3,5,8
HND-015128,2011,162000005,,,,6,1,7
HND-015130,2011,162000007,,,,3,5,8
HND-015131,2011,162000008,,,,24,16,40
HND-015133,2011,162000010,,,,4,4,8
HND-015134,2011,162000011,,,,9,2,11
HND-015137,2011,162000014,,,,7,10,17
HND-015139,2011,162000016,,,,7,5,12
HND-015140,2011,162000017,,,,1,3,4
HND-015145,2011,162000022,,,,6,5,11
HND-015146,2011,162000023,,,,1,5,6
HND-015151,2011,162000028,,,,13,16,29
HND-015152,2011,162000029,,,,1,0,1
HND-015153,2011,162000030,,,,1,6,7
HND-015154,2011,162000031,,,,4,2,6
HND-015157,2011,162000034,,,,2,1,3
HND-015158,2011,162000035,,,,2,1,3
HND-015159,2011,162000036,,,,4,1,5
HND-015160,2011,162000037,,,,1,2,3
HND-015164,2011,162000041,,,,2,0,2
,2011,162000045,,,,3,7,10
HND-015183,2011,162000090,,,,6,1,7
HND-015185,2011,162000092,,,,1,5,6
HND-015186,2011,162000093,,,,1,2,3
HND-015190,2011,162000098,,,,6,2,8
HND-015198,2011,162000125,,,,1,0,1
HND-015200,2011,162000128,,,,0,1,1
HND-015204,2011,162000182,,,,1,3,4
,2011,162000187,,,,5,4,9
,2011,162000200,,,,2,0,2
HND-015126,2011,162000003,,,,2,3,5
HND-015127,2011,162000004,,,,1,11,12
HND-015129,2011,162000006,,,,13,16,29
,2011,162000009,,,,1,2,3
HND-015135,2011,162000012,,,,4,4,8
HND-015136,2011,162000013,,,,5,10,15
HND-015138,2011,162000015,,,,3,4,7
HND-015141,2011,162000018,,,,1,2,3
HND-015142,2011,162000019,,,,5,2,7
HND-015143,2011,162000020,,,,1,3,4
HND-015144,2011,162000021,,,,2,2,4
HND-015147,2011,162000024,,,,5,3,8
HND-015148,2011,162000025,,,,7,10,17
HND-015149,2011,162000026,,,,3,9,12
HND-015150,2011,162000027,,,,1,3,4
HND-015155,2011,162000032,,,,2,6,8
HND-015156,2011,162000033,,,,0,2,2
HND-015161,2011,162000038,,,,6,5,11
HND-015162,2011,162000039,,,,2,1,3
HND-015163,2011,162000040,,,,7,9,16
HND-015168,2011,162000046,,,,6,8,14
HND-015175,2011,162000055,,,,12,12,24
HND-015184,2011,162000091,,,,1,4,5
HND-015187,2011,162000094,,,,2,3,5
HND-015188,2011,162000095,,,,1,3,4
HND-015189,2011,162000096,,,,3,1,4
HND-015191,2011,162000102,,,,4,4,8
HND-015195,2011,162000114,,,,5,1,6
HND-015199,2011,162000127,,,,1,1,2
HND-015203,2011,162000181,,,,0,3,3
HND-015205,2011,162000183,,,,6,4,10
,2011,162000199,,,,1,1,2
HND-015125,2011,162000002,,,,4,1,5
HND-015126,2011,162000003,,,,2,0,2
HND-015131,2011,162000008,,,,13,18,31
,2011,162000009,,,,3,3,6
HND-015135,2011,162000012,,,,7,2,9
HND-015138,2011,162000015,,,,6,7,13
HND-015140,2011,162000017,,,,2,2,4
HND-015141,2011,162000018,,,,2,1,3
HND-015143,2011,162000020,,,,1,2,3
HND-015144,2011,162000021,,,,1,2,3
HND-015146,2011,162000023,,,,5,5,10
HND-015147,2011,162000024,,,,0,1,1
HND-015149,2011,162000026,,,,2,3,5
HND-015152,2011,162000029,,,,2,0,2
HND-015155,2011,162000032,,,,1,0,1
HND-015160,2011,162000037,,,,5,4,9
HND-015161,2011,162000038,,,,7,5,12
HND-015163,2011,162000040,,,,4,8,12
HND-015164,2011,162000041,,,,4,2,6
HND-015168,2011,162000046,,,,1,5,6
HND-015184,2011,162000091,,,,2,1,3
HND-015186,2011,162000093,,,,5,1,6
HND-015187,2011,162000094,,,,2,1,3
HND-015189,2011,162000096,,,,5,3,8
HND-015191,2011,162000102,,,,3,5,8
HND-015198,2011,162000125,,,,2,0,2
HND-015203,2011,162000181,,,,1,2,3
HND-015205,2011,162000183,,,,2,1,3
,2011,162000199,,,,3,0,3
HND-015124,2011,162000001,,,,56,42,98
HND-015127,2011,162000004,,,,6,6,12
HND-015128,2011,162000005,,,,2,4,6
HND-015129,2011,162000006,,,,11,12,23
HND-015130,2011,162000007,,,,3,5,8
HND-015133,2011,162000010,,,,11,3,14
HND-015134,2011,162000011,,,,2,7,9
HND-015136,2011,162000013,,,,3,7,10
HND-015137,2011,162000014,,,,2,13,15
HND-015139,2011,162000016,,,,4,3,7
HND-015142,2011,162000019,,,,3,3,6
HND-015145,2011,162000022,,,,0,4,4
HND-015148,2011,162000025,,,,7,5,12
HND-015151,2011,162000028,,,,18,9,27
HND-015153,2011,162000030,,,,3,2,5
HND-015154,2011,162000031,,,,3,2,5
HND-015156,2011,162000033,,,,1,2,3
HND-015157,2011,162000034,,,,2,1,3
HND-015159,2011,162000036,,,,6,0,6
HND-015162,2011,162000039,,,,1,1,2
,2011,162000045,,,,4,3,7
HND-015175,2011,162000055,,,,10,12,22
HND-015183,2011,162000090,,,,3,4,7
HND-015185,2011,162000092,,,,3,4,7
HND-015188,2011,162000095,,,,2,0,2
HND-015190,2011,162000098,,,,4,2,6
HND-015195,2011,162000114,,,,1,4,5
HND-015199,2011,162000127,,,,1,1,2
HND-015200,2011,162000128,,,,5,1,6
HND-015204,2011,162000182,,,,2,0,2
,2011,162000187,,,,3,10,13
HND-015134,2011,162000011,,,,8,9,17
HND-015137,2011,162000014,,,,15,9,24
HND-015167,2011,162000044,,,,76,74,150
,2011,162000045,,,,6,4,10
HND-015212,2011,162000202,,,,37,36,73
HND-015129,2011,162000006,,,,15,12,27
HND-015136,2011,162000013,,,,16,13,29
HND-015153,2011,162000030,,,,9,7,16
,2011,162000187,,,,1,7,8
HND-015129,2011,162000006,,,,9,14,23
HND-015134,2011,162000011,,,,6,6,12
HND-015136,2011,162000013,,,,18,6,24
HND-015137,2011,162000014,,,,10,16,26
HND-015153,2011,162000030,,,,0,3,3
HND-015167,2011,162000044,,,,64,74,138
,2011,162000187,,,,2,8,10
HND-015212,2011,162000202,,,,31,50,81
,2011,162000045,,,,3,2,5
HND-015129,2011,162000006,,,,13,4,17
HND-015134,2011,162000011,,,,2,1,3
HND-015136,2011,162000013,,,,7,4,11
HND-015137,2011,162000014,,,,15,17,32
HND-015167,2011,162000044,,,,55,59,114
,2011,162000045,,,,2,8,10
HND-015153,2011,162000030,,,,1,2,3
,2011,162000187,,,,1,1,2
HND-015212,2011,162000202,,,,29,25,54
HND-015212,2011,162000202,,,,33,21,54
HND-015167,2011,162000044,,,,69,53,122
,2011,162000045,,,,3,9,12
HND-015212,2011,162000202,,,,21,34,55
HND-015167,2011,162000044,,,,51,33,84
,2011,162000045,,,,8,3,11
HND-015167,2011,162000044,,,,32,46,78
HND-015222,2011,162100010,,,,8,5,13
HND-015242,2011,162100063,,,,6,5,11
,2011,162100068,,,,6,7,13
HND-015245,2011,162100069,,,,4,7,11
,2011,162100072,,,,12,9,21
,2011,162100073,,,,4,7,11
,2011,162100075,,,,5,4,9
HND-015246,2011,162100078,,,,9,8,17
HND-015241,2011,162100048,,,,10,10,20
,2011,162100071,,,,4,4,8
,2011,162100074,,,,13,4,17
,2011,162100076,,,,1,4,5
,2011,162100077,,,,1,3,4
HND-015247,2011,162100079,,,,5,10,15
,2011,162100080,,,,7,3,10
,2011,162100083,,,,13,12,25
,2011,162100029,,,,1,3,4
,2011,162100026,,,,1,0,1
,2011,162100030,,,,5,3,8
HND-015236,2011,162100027,,,,13,7,20
HND-015243,2011,162100065,,,,8,10,18
HND-015231,2011,162100021,,,,4,5,9
,2011,162100026,,,,3,2,5
,2011,162100029,,,,4,4,8
,2011,162100030,,,,1,2,3
HND-015248,2011,162100081,,,,5,5,10
HND-015231,2011,162100021,,,,10,11,21
,2011,162100026,,,,1,3,4
,2011,162100029,,,,2,7,9
,2011,162100030,,,,4,2,6
HND-015244,2011,162100066,,,,30,8,38
HND-015248,2011,162100081,,,,12,11,23
HND-015236,2011,162100027,,,,34,34,68
HND-015214,2011,162100002,,,,34,22,56
HND-015216,2011,162100004,,,,15,14,29
HND-015217,2011,162100005,,,,7,8,15
HND-015218,2011,162100006,,,,5,0,5
HND-015219,2011,162100007,,,,7,9,16
HND-015222,2011,162100010,,,,7,13,20
HND-015223,2011,162100011,,,,19,11,30
,2011,162100014,,,,7,7,14
HND-015227,2011,162100015,,,,6,2,8
HND-015228,2011,162100016,,,,6,4,10
HND-015229,2011,162100017,,,,6,3,9
HND-015235,2011,162100025,,,,7,7,14
HND-015239,2011,162100032,,,,1,3,4
HND-015240,2011,162100033,,,,4,4,8
HND-015249,2011,162100082,,,,3,1,4
HND-015213,2011,162100001,,,,42,38,80
HND-015215,2011,162100003,,,,25,15,40
HND-015220,2011,162100008,,,,8,4,12
HND-015221,2011,162100009,,,,6,2,8
HND-015224,2011,162100012,,,,4,3,7
HND-015225,2011,162100013,,,,10,6,16
HND-015230,2011,162100018,,,,4,6,10
HND-015233,2011,162100023,,,,5,6,11
,2011,162100024,,,,1,3,4
HND-015238,2011,162100031,,,,2,2,4
HND-015214,2011,162100002,,,,27,24,51
HND-015215,2011,162100003,,,,18,7,25
HND-015216,2011,162100004,,,,28,20,48
HND-015218,2011,162100006,,,,1,4,5
HND-015221,2011,162100009,,,,10,5,15
HND-015223,2011,162100011,,,,11,6,17
HND-015225,2011,162100013,,,,9,8,17
,2011,162100014,,,,6,15,21
HND-015228,2011,162100016,,,,3,4,7
,2011,162100024,,,,5,3,8
HND-015238,2011,162100031,,,,5,3,8
HND-015239,2011,162100032,,,,2,3,5
HND-015240,2011,162100033,,,,1,7,8
HND-015213,2011,162100001,,,,40,33,73
HND-015217,2011,162100005,,,,3,5,8
HND-015219,2011,162100007,,,,3,2,5
HND-015220,2011,162100008,,,,4,5,9
HND-015222,2011,162100010,,,,11,5,16
HND-015224,2011,162100012,,,,3,8,11
HND-015227,2011,162100015,,,,4,4,8
HND-015229,2011,162100017,,,,3,4,7
HND-015230,2011,162100018,,,,2,0,2
HND-015233,2011,162100023,,,,9,3,12
HND-015235,2011,162100025,,,,4,2,6
HND-015237,2011,162100028,,,,2,0,2
HND-015249,2011,162100082,,,,5,1,6
HND-015213,2011,162100001,,,,40,38,78
HND-015214,2011,162100002,,,,24,30,54
HND-015215,2011,162100003,,,,33,20,53
HND-015220,2011,162100008,,,,5,6,11
HND-015221,2011,162100009,,,,5,12,17
HND-015224,2011,162100012,,,,4,2,6
HND-015225,2011,162100013,,,,4,9,13
HND-015230,2011,162100018,,,,2,4,6
HND-015233,2011,162100023,,,,3,6,9
,2011,162100024,,,,1,3,4
HND-015238,2011,162100031,,,,2,4,6
HND-015239,2011,162100032,,,,6,5,11
HND-015216,2011,162100004,,,,11,12,23
HND-015217,2011,162100005,,,,3,4,7
HND-015218,2011,162100006,,,,0,2,2
HND-015219,2011,162100007,,,,4,1,5
HND-015222,2011,162100010,,,,14,7,21
HND-015223,2011,162100011,,,,12,10,22
,2011,162100014,,,,16,9,25
HND-015227,2011,162100015,,,,2,2,4
HND-015228,2011,162100016,,,,4,4,8
HND-015229,2011,162100017,,,,4,9,13
HND-015235,2011,162100025,,,,2,6,8
HND-015237,2011,162100028,,,,2,3,5
HND-015240,2011,162100033,,,,6,2,8
HND-015249,2011,162100082,,,,2,4,6
HND-015214,2011,162100002,,,,38,26,64
HND-015215,2011,162100003,,,,18,20,38
HND-015216,2011,162100004,,,,19,14,33
HND-015218,2011,162100006,,,,3,3,6
HND-015219,2011,162100007,,,,6,0,6
HND-015221,2011,162100009,,,,9,9,18
HND-015222,2011,162100010,,,,4,3,7
HND-015223,2011,162100011,,,,5,12,17
HND-015225,2011,162100013,,,,10,6,16
,2011,162100014,,,,15,6,21
HND-015228,2011,162100016,,,,11,1,12
HND-015229,2011,162100017,,,,6,2,8
,2011,162100024,,,,4,3,7
HND-015235,2011,162100025,,,,2,5,7
HND-015249,2011,162100082,,,,2,2,4
HND-015213,2011,162100001,,,,42,38,80
HND-015217,2011,162100005,,,,3,1,4
HND-015220,2011,162100008,,,,2,1,3
HND-015224,2011,162100012,,,,8,3,11
HND-015227,2011,162100015,,,,2,4,6
HND-015230,2011,162100018,,,,3,2,5
HND-015233,2011,162100023,,,,4,3,7
HND-015237,2011,162100028,,,,0,2,2
HND-015238,2011,162100031,,,,4,2,6
HND-015239,2011,162100032,,,,6,6,12
HND-015240,2011,162100033,,,,4,4,8
HND-015214,2011,162100002,,,,24,30,54
HND-015216,2011,162100004,,,,7,23,30
HND-015218,2011,162100006,,,,1,3,4
HND-015219,2011,162100007,,,,9,5,14
HND-015222,2011,162100010,,,,6,6,12
HND-015223,2011,162100011,,,,8,7,15
,2011,162100014,,,,12,6,18
HND-015228,2011,162100016,,,,5,3,8
HND-015229,2011,162100017,,,,2,4,6
,2011,162100024,,,,5,3,8
HND-015235,2011,162100025,,,,3,4,7
HND-015237,2011,162100028,,,,0,1,1
HND-015238,2011,162100031,,,,4,4,8
HND-015213,2011,162100001,,,,38,40,78
HND-015215,2011,162100003,,,,17,23,40
HND-015217,2011,162100005,,,,0,1,1
HND-015220,2011,162100008,,,,6,5,11
HND-015221,2011,162100009,,,,4,5,9
HND-015224,2011,162100012,,,,7,4,11
HND-015225,2011,162100013,,,,7,7,14
HND-015227,2011,162100015,,,,6,5,11
HND-015230,2011,162100018,,,,5,2,7
HND-015233,2011,162100023,,,,3,4,7
HND-015239,2011,162100032,,,,0,2,2
HND-015240,2011,162100033,,,,2,3,5
HND-015249,2011,162100082,,,,2,3,5
HND-015213,2011,162100001,,,,46,36,82
HND-015217,2011,162100005,,,,3,0,3
HND-015219,2011,162100007,,,,5,1,6
HND-015220,2011,162100008,,,,5,5,10
HND-015222,2011,162100010,,,,6,3,9
HND-015224,2011,162100012,,,,2,2,4
HND-015227,2011,162100015,,,,3,4,7
HND-015229,2011,162100017,,,,3,2,5
HND-015230,2011,162100018,,,,4,2,6
HND-015235,2011,162100025,,,,8,4,12
HND-015237,2011,162100028,,,,3,3,6
HND-015238,2011,162100031,,,,4,3,7
HND-015239,2011,162100032,,,,1,4,5
HND-015240,2011,162100033,,,,5,4,9
HND-015214,2011,162100002,,,,28,30,58
HND-015215,2011,162100003,,,,12,19,31
HND-015216,2011,162100004,,,,9,14,23
HND-015218,2011,162100006,,,,3,0,3
HND-015221,2011,162100009,,,,8,5,13
HND-015223,2011,162100011,,,,10,9,19
HND-015225,2011,162100013,,,,8,4,12
,2011,162100014,,,,5,13,18
HND-015228,2011,162100016,,,,4,5,9
HND-015233,2011,162100023,,,,5,6,11
,2011,162100024,,,,1,2,3
HND-015249,2011,162100082,,,,2,0,2
HND-015216,2011,162100004,,,,24,18,42
HND-015232,2011,162100022,,,,85,67,152
HND-015215,2011,162100003,,,,7,6,13
HND-015215,2011,162100003,,,,10,9,19
HND-015216,2011,162100004,,,,12,16,28
HND-015232,2011,162100022,,,,55,46,101
HND-015215,2011,162100003,,,,6,9,15
HND-015216,2011,162100004,,,,11,20,31
HND-015232,2011,162100022,,,,64,65,129
HND-015216,2011,162100004,,,,6,11,17
HND-015232,2011,162100022,,,,24,41,65
HND-015216,2011,162100004,,,,8,4,12
HND-015232,2011,162100022,,,,14,24,38
HND-015216,2011,162100004,,,,6,7,13
HND-015232,2011,162100022,,,,20,27,47
,2011,162200034,,,,4,6,10
,2011,162200052,,,,8,9,17
,2011,162200072,,,,6,6,12
HND-015272,2011,162200023,,,,11,7,18
,2011,162200035,,,,4,7,11
,2011,162200037,,,,7,8,15
,2011,162200065,,,,1,5,6
,2011,162200068,,,,12,14,26
HND-015281,2011,162200074,,,,4,4,8
HND-015289,2011,162200115,,,,5,3,8
HND-015287,2011,162200113,,,,2,3,5
HND-015271,2011,162200022,,,,1,0,1
HND-015278,2011,162200032,,,,3,3,6
HND-015284,2011,162200110,,,,3,3,6
HND-015285,2011,162200111,,,,1,3,4
,2011,162200117,,,,1,2,3
HND-015271,2011,162200022,,,,11,2,13
HND-015276,2011,162200029,,,,4,3,7
HND-015279,2011,162200033,,,,6,3,9
,2011,162200117,,,,3,3,6
,2011,162200118,,,,5,1,6
HND-015269,2011,162200019,,,,13,14,27
HND-015273,2011,162200025,,,,4,3,7
HND-015274,2011,162200027,,,,9,11,20
HND-015275,2011,162200028,,,,6,5,11
HND-015278,2011,162200032,,,,4,3,7
HND-015282,2011,162200108,,,,6,3,9
HND-015284,2011,162200110,,,,1,3,4
HND-015285,2011,162200111,,,,3,3,6
HND-015287,2011,162200113,,,,3,0,3
HND-015269,2011,162200019,,,,18,28,46
HND-015271,2011,162200022,,,,4,9,13
HND-015274,2011,162200027,,,,27,21,48
HND-015276,2011,162200029,,,,11,16,27
HND-015278,2011,162200032,,,,6,4,10
HND-015282,2011,162200108,,,,6,5,11
HND-015284,2011,162200110,,,,1,7,8
HND-015285,2011,162200111,,,,2,3,5
HND-015287,2011,162200113,,,,7,7,14
HND-015273,2011,162200025,,,,8,6,14
HND-015275,2011,162200028,,,,5,6,11
HND-015279,2011,162200033,,,,5,8,13
,2011,162200117,,,,7,6,13
HND-015252,2011,162200001,,,,19,17,36
HND-015253,2011,162200002,,,,2,1,3
HND-015259,2011,162200008,,,,10,5,15
HND-015260,2011,162200009,,,,15,7,22
HND-015262,2011,162200011,,,,4,4,8
HND-015263,2011,162200013,,,,11,2,13
HND-015266,2011,162200016,,,,3,1,4
HND-015283,2011,162200109,,,,5,3,8
,2011,162200118,,,,0,5,5
HND-015254,2011,162200003,,,,45,52,97
HND-015255,2011,162200004,,,,8,9,17
HND-015256,2011,162200005,,,,7,6,13
HND-015257,2011,162200006,,,,5,5,10
HND-015258,2011,162200007,,,,5,1,6
HND-015261,2011,162200010,,,,4,3,7
,2011,162200012,,,,5,3,8
HND-015264,2011,162200014,,,,5,3,8
HND-015265,2011,162200015,,,,9,8,17
HND-015267,2011,162200017,,,,9,4,13
,2011,162200018,,,,1,2,3
HND-015280,2011,162200038,,,,1,0,1
HND-015286,2011,162200112,,,,0,1,1
HND-015288,2011,162200114,,,,2,5,7
HND-015252,2011,162200001,,,,16,24,40
HND-015255,2011,162200004,,,,9,7,16
HND-015257,2011,162200006,,,,14,6,20
HND-015260,2011,162200009,,,,8,9,17
HND-015261,2011,162200010,,,,5,3,8
HND-015262,2011,162200011,,,,1,3,4
HND-015263,2011,162200013,,,,4,10,14
HND-015264,2011,162200014,,,,10,5,15
HND-015266,2011,162200016,,,,3,3,6
HND-015267,2011,162200017,,,,7,5,12
HND-015280,2011,162200038,,,,3,1,4
HND-015286,2011,162200112,,,,3,5,8
HND-015288,2011,162200114,,,,2,3,5
HND-015253,2011,162200002,,,,3,4,7
HND-015254,2011,162200003,,,,43,34,77
HND-015256,2011,162200005,,,,13,7,20
HND-015258,2011,162200007,,,,3,11,14
HND-015259,2011,162200008,,,,11,8,19
,2011,162200012,,,,4,5,9
HND-015265,2011,162200015,,,,5,7,12
,2011,162200018,,,,5,2,7
HND-015277,2011,162200030,,,,4,2,6
HND-015283,2011,162200109,,,,1,5,6
HND-015252,2011,162200001,,,,20,24,44
HND-015253,2011,162200002,,,,0,5,5
HND-015260,2011,162200009,,,,10,9,19
HND-015262,2011,162200011,,,,6,4,10
HND-015263,2011,162200013,,,,15,9,24
HND-015264,2011,162200014,,,,2,2,4
HND-015266,2011,162200016,,,,6,1,7
HND-015277,2011,162200030,,,,1,2,3
HND-015280,2011,162200038,,,,3,0,3
HND-015286,2011,162200112,,,,0,1,1
HND-015288,2011,162200114,,,,4,1,5
,2011,162200118,,,,2,0,2
HND-015254,2011,162200003,,,,36,39,75
HND-015255,2011,162200004,,,,7,9,16
HND-015256,2011,162200005,,,,12,4,16
HND-015257,2011,162200006,,,,7,10,17
HND-015258,2011,162200007,,,,8,6,14
HND-015259,2011,162200008,,,,7,7,14
HND-015261,2011,162200010,,,,1,2,3
,2011,162200012,,,,6,6,12
HND-015265,2011,162200015,,,,6,10,16
HND-015267,2011,162200017,,,,5,5,10
,2011,162200018,,,,1,2,3
HND-015283,2011,162200109,,,,2,2,4
HND-015252,2011,162200001,,,,21,13,34
HND-015254,2011,162200003,,,,63,49,112
HND-015255,2011,162200004,,,,8,8,16
HND-015257,2011,162200006,,,,11,6,17
HND-015258,2011,162200007,,,,7,6,13
HND-015260,2011,162200009,,,,11,10,21
HND-015261,2011,162200010,,,,3,0,3
HND-015262,2011,162200011,,,,2,1,3
HND-015264,2011,162200014,,,,6,3,9
HND-015265,2011,162200015,,,,6,11,17
HND-015266,2011,162200016,,,,1,4,5
HND-015267,2011,162200017,,,,5,5,10
HND-015283,2011,162200109,,,,1,2,3
HND-015286,2011,162200112,,,,0,1,1
,2011,162200118,,,,0,2,2
HND-015253,2011,162200002,,,,1,4,5
HND-015256,2011,162200005,,,,4,9,13
HND-015259,2011,162200008,,,,6,8,14
,2011,162200012,,,,6,4,10
HND-015263,2011,162200013,,,,9,10,19
,2011,162200018,,,,4,3,7
HND-015277,2011,162200030,,,,3,1,4
HND-015288,2011,162200114,,,,1,1,2
HND-015252,2011,162200001,,,,19,26,45
HND-015254,2011,162200003,,,,45,52,97
HND-015255,2011,162200004,,,,11,11,22
HND-015256,2011,162200005,,,,9,9,18
HND-015257,2011,162200006,,,,13,11,24
HND-015258,2011,162200007,,,,8,10,18
HND-015261,2011,162200010,,,,4,5,9
HND-015264,2011,162200014,,,,2,7,9
HND-015265,2011,162200015,,,,8,8,16
HND-015266,2011,162200016,,,,1,5,6
HND-015267,2011,162200017,,,,8,3,11
HND-015280,2011,162200038,,,,0,2,2
HND-015283,2011,162200109,,,,1,2,3
,2011,162200118,,,,1,0,1
HND-015259,2011,162200008,,,,6,12,18
HND-015260,2011,162200009,,,,11,11,22
HND-015262,2011,162200011,,,,0,2,2
,2011,162200012,,,,9,4,13
HND-015263,2011,162200013,,,,11,8,19
HND-015277,2011,162200030,,,,3,2,5
HND-015286,2011,162200112,,,,3,2,5
HND-015288,2011,162200114,,,,6,2,8
HND-015254,2011,162200003,,,,60,62,122
HND-015256,2011,162200005,,,,9,9,18
HND-015258,2011,162200007,,,,9,6,15
HND-015259,2011,162200008,,,,2,7,9
,2011,162200012,,,,6,9,15
HND-015265,2011,162200015,,,,10,6,16
HND-015283,2011,162200109,,,,4,1,5
HND-015252,2011,162200001,,,,19,19,38
HND-015255,2011,162200004,,,,5,8,13
HND-015257,2011,162200006,,,,10,5,15
HND-015260,2011,162200009,,,,8,3,11
HND-015263,2011,162200013,,,,19,19,38
HND-015264,2011,162200014,,,,2,1,3
HND-015266,2011,162200016,,,,0,3,3
HND-015267,2011,162200017,,,,7,7,14
HND-015280,2011,162200038,,,,3,1,4
HND-015286,2011,162200112,,,,4,3,7
HND-015288,2011,162200114,,,,4,3,7
HND-015252,2011,162200001,,,,29,23,52
HND-015256,2011,162200005,,,,19,18,37
HND-015258,2011,162200007,,,,18,10,28
HND-015263,2011,162200013,,,,11,6,17
HND-015270,2011,162200020,,,,90,67,157
HND-015252,2011,162200001,,,,21,14,35
HND-015263,2011,162200013,,,,5,13,18
HND-015256,2011,162200005,,,,6,16,22
HND-015258,2011,162200007,,,,12,12,24
HND-015270,2011,162200020,,,,73,70,143
HND-015252,2011,162200001,,,,15,14,29
HND-015258,2011,162200007,,,,10,7,17
HND-015256,2011,162200005,,,,13,6,19
HND-015263,2011,162200013,,,,9,11,20
HND-015270,2011,162200020,,,,76,59,135
HND-015270,2011,162200020,,,,67,82,149
HND-015270,2011,162200020,,,,60,48,108
HND-015270,2011,162200020,,,,40,53,93
HND-015318,2011,162300029,,,,22,18,40
HND-015319,2011,162300030,,,,4,4,8
,2011,162300074,,,,4,4,8
HND-015334,2011,162300075,,,,3,3,6
HND-015335,2011,162300076,,,,3,4,7
,2011,162300077,,,,6,3,9
HND-015312,2011,162300023,,,,3,2,5
HND-015321,2011,162300032,,,,11,1,12
HND-015322,2011,162300034,,,,5,7,12
HND-015323,2011,162300035,,,,8,5,13
HND-015333,2011,162300072,,,,4,5,9
,2011,162300079,,,,4,5,9
,2011,162300080,,,,6,0,6
HND-015311,2011,162300021,,,,3,5,8
,2011,162300022,,,,2,1,3
HND-015324,2011,162300036,,,,0,2,2
,2011,162300040,,,,5,4,9
HND-015310,2011,162300020,,,,3,5,8
HND-015313,2011,162300024,,,,3,3,6
HND-015316,2011,162300027,,,,0,1,1
HND-015317,2011,162300028,,,,1,0,1
,2011,162300043,,,,3,2,5
HND-015311,2011,162300021,,,,8,7,15
,2011,162300022,,,,6,6,12
HND-015313,2011,162300024,,,,7,10,17
HND-015316,2011,162300027,,,,7,4,11
HND-015320,2011,162300031,,,,15,13,28
HND-015324,2011,162300036,,,,3,2,5
HND-015325,2011,162300037,,,,6,7,13
,2011,162300040,,,,0,2,2
,2011,162300043,,,,3,3,6
HND-015310,2011,162300020,,,,7,6,13
HND-015314,2011,162300025,,,,3,7,10
HND-015317,2011,162300028,,,,5,6,11
HND-015332,2011,162300069,,,,6,6,12
HND-015310,2011,162300020,,,,8,6,14
,2011,162300022,,,,9,4,13
HND-015317,2011,162300028,,,,5,9,14
,2011,162300043,,,,5,1,6
HND-015332,2011,162300069,,,,9,11,20
HND-015311,2011,162300021,,,,10,8,18
HND-015313,2011,162300024,,,,6,13,19
HND-015314,2011,162300025,,,,12,8,20
HND-015316,2011,162300027,,,,4,6,10
HND-015320,2011,162300031,,,,22,16,38
HND-015324,2011,162300036,,,,4,3,7
HND-015325,2011,162300037,,,,3,4,7
,2011,162300040,,,,2,1,3
HND-015293,2011,162300002,,,,8,12,20
HND-015295,2011,162300004,,,,5,10,15
HND-015296,2011,162300005,,,,5,6,11
HND-015297,2011,162300006,,,,7,4,11
HND-015298,2011,162300007,,,,5,5,10
HND-015302,2011,162300011,,,,6,9,15
HND-015305,2011,162300014,,,,10,4,14
HND-015306,2011,162300015,,,,4,4,8
HND-015307,2011,162300016,,,,7,7,14
HND-015308,2011,162300018,,,,6,7,13
HND-015326,2011,162300039,,,,1,2,3
HND-015329,2011,162300044,,,,1,4,5
HND-015292,2011,162300001,,,,2,4,6
HND-015294,2011,162300003,,,,12,13,25
HND-015299,2011,162300008,,,,16,18,34
HND-015300,2011,162300009,,,,5,2,7
HND-015301,2011,162300010,,,,5,3,8
HND-015303,2011,162300012,,,,16,9,25
HND-015304,2011,162300013,,,,3,1,4
HND-015309,2011,162300019,,,,3,2,5
HND-015328,2011,162300042,,,,2,4,6
HND-015292,2011,162300001,,,,5,2,7
HND-015293,2011,162300002,,,,9,9,18
HND-015294,2011,162300003,,,,11,25,36
HND-015295,2011,162300004,,,,14,4,18
HND-015297,2011,162300006,,,,6,5,11
HND-015300,2011,162300009,,,,9,3,12
HND-015301,2011,162300010,,,,9,8,17
HND-015302,2011,162300011,,,,7,10,17
HND-015304,2011,162300013,,,,3,7,10
HND-015305,2011,162300014,,,,2,2,4
HND-015309,2011,162300019,,,,2,4,6
HND-015326,2011,162300039,,,,6,5,11
HND-015328,2011,162300042,,,,3,3,6
HND-015330,2011,162300045,,,,1,2,3
HND-015296,2011,162300005,,,,5,2,7
HND-015298,2011,162300007,,,,4,7,11
HND-015299,2011,162300008,,,,14,12,26
HND-015303,2011,162300012,,,,12,9,21
HND-015306,2011,162300015,,,,6,11,17
HND-015307,2011,162300016,,,,8,5,13
HND-015308,2011,162300018,,,,1,2,3
HND-015329,2011,162300044,,,,3,2,5
HND-015293,2011,162300002,,,,15,9,24
HND-015294,2011,162300003,,,,29,18,47
HND-015299,2011,162300008,,,,10,10,20
HND-015300,2011,162300009,,,,5,1,6
HND-015302,2011,162300011,,,,7,9,16
HND-015303,2011,162300012,,,,12,9,21
HND-015304,2011,162300013,,,,5,1,6
HND-015309,2011,162300019,,,,5,10,15
HND-015328,2011,162300042,,,,1,6,7
HND-015330,2011,162300045,,,,0,1,1
HND-015292,2011,162300001,,,,5,2,7
HND-015295,2011,162300004,,,,7,8,15
HND-015296,2011,162300005,,,,4,5,9
HND-015297,2011,162300006,,,,5,7,12
HND-015298,2011,162300007,,,,7,11,18
HND-015301,2011,162300010,,,,7,4,11
HND-015305,2011,162300014,,,,5,0,5
HND-015306,2011,162300015,,,,5,3,8
HND-015307,2011,162300016,,,,6,7,13
HND-015308,2011,162300018,,,,0,3,3
HND-015326,2011,162300039,,,,3,5,8
HND-015329,2011,162300044,,,,2,3,5
HND-015292,2011,162300001,,,,2,4,6
HND-015293,2011,162300002,,,,6,12,18
HND-015294,2011,162300003,,,,25,15,40
HND-015295,2011,162300004,,,,7,15,22
HND-015297,2011,162300006,,,,4,3,7
HND-015298,2011,162300007,,,,3,4,7
HND-015300,2011,162300009,,,,5,2,7
HND-015301,2011,162300010,,,,6,9,15
HND-015302,2011,162300011,,,,10,6,16
HND-015305,2011,162300014,,,,5,4,9
HND-015307,2011,162300016,,,,13,11,24
HND-015309,2011,162300019,,,,4,3,7
HND-015326,2011,162300039,,,,6,3,9
HND-015328,2011,162300042,,,,1,1,2
HND-015296,2011,162300005,,,,7,10,17
HND-015299,2011,162300008,,,,7,14,21
HND-015303,2011,162300012,,,,13,8,21
HND-015304,2011,162300013,,,,5,2,7
HND-015306,2011,162300015,,,,8,7,15
HND-015308,2011,162300018,,,,5,5,10
HND-015329,2011,162300044,,,,2,3,5
HND-015293,2011,162300002,,,,12,15,27
HND-015295,2011,162300004,,,,15,17,32
HND-015297,2011,162300006,,,,9,6,15
HND-015298,2011,162300007,,,,13,8,21
HND-015300,2011,162300009,,,,4,4,8
HND-015301,2011,162300010,,,,10,8,18
HND-015302,2011,162300011,,,,6,9,15
HND-015305,2011,162300014,,,,6,3,9
HND-015306,2011,162300015,,,,2,7,9
HND-015307,2011,162300016,,,,15,8,23
HND-015326,2011,162300039,,,,3,2,5
HND-015328,2011,162300042,,,,0,3,3
HND-015294,2011,162300003,,,,26,31,57
HND-015296,2011,162300005,,,,7,9,16
HND-015299,2011,162300008,,,,13,7,20
HND-015303,2011,162300012,,,,15,12,27
HND-015304,2011,162300013,,,,4,2,6
HND-015308,2011,162300018,,,,3,2,5
HND-015309,2011,162300019,,,,6,0,6
HND-015329,2011,162300044,,,,0,5,5
HND-015330,2011,162300045,,,,1,3,4
HND-015296,2011,162300005,,,,5,11,16
HND-015298,2011,162300007,,,,8,5,13
HND-015299,2011,162300008,,,,15,21,36
HND-015303,2011,162300012,,,,17,23,40
HND-015306,2011,162300015,,,,10,7,17
HND-015307,2011,162300016,,,,11,12,23
HND-015308,2011,162300018,,,,3,4,7
HND-015329,2011,162300044,,,,3,7,10
HND-015293,2011,162300002,,,,17,13,30
HND-015294,2011,162300003,,,,32,22,54
HND-015295,2011,162300004,,,,10,12,22
HND-015297,2011,162300006,,,,4,8,12
HND-015300,2011,162300009,,,,6,6,12
HND-015301,2011,162300010,,,,9,12,21
HND-015302,2011,162300011,,,,11,12,23
HND-015304,2011,162300013,,,,5,3,8
HND-015305,2011,162300014,,,,8,4,12
HND-015309,2011,162300019,,,,0,5,5
HND-015326,2011,162300039,,,,2,5,7
HND-015328,2011,162300042,,,,0,5,5
HND-015330,2011,162300045,,,,3,0,3
HND-015295,2011,162300004,,,,8,13,21
HND-015315,2011,162300026,,,,81,74,155
HND-015294,2011,162300003,,,,21,25,46
HND-015299,2011,162300008,,,,11,9,20
HND-015331,2011,162300046,,,,49,58,107
HND-015294,2011,162300003,,,,15,17,32
HND-015295,2011,162300004,,,,6,9,15
HND-015331,2011,162300046,,,,30,28,58
HND-015299,2011,162300008,,,,9,10,19
HND-015315,2011,162300026,,,,63,57,120
HND-015294,2011,162300003,,,,20,14,34
HND-015295,2011,162300004,,,,7,2,9
HND-015315,2011,162300026,,,,34,56,90
HND-015331,2011,162300046,,,,28,25,53
HND-015299,2011,162300008,,,,11,13,24
HND-015315,2011,162300026,,,,22,23,45
HND-015331,2011,162300046,,,,28,49,77
HND-015315,2011,162300026,,,,20,21,41
HND-015331,2011,162300046,,,,29,35,64
HND-015331,2011,162300046,,,,39,38,77
HND-015343,2011,162400012,,,,7,5,12
HND-015342,2011,162400011,,,,4,8,12
HND-015339,2011,162400006,,,,2,2,4
HND-015341,2011,162400009,,,,1,3,4
HND-015338,2011,162400005,,,,7,6,13
HND-015341,2011,162400009,,,,5,1,6
HND-015337,2011,162400004,,,,5,5,10
HND-015339,2011,162400006,,,,2,1,3
HND-015337,2011,162400004,,,,18,19,37
HND-015338,2011,162400005,,,,7,5,12
HND-015339,2011,162400006,,,,4,3,7
HND-015341,2011,162400009,,,,6,2,8
HND-015340,2011,162400008,,,,3,2,5
HND-015336,2011,162400001,,,,52,45,97
HND-015336,2011,162400001,,,,38,22,60
HND-015340,2011,162400008,,,,4,3,7
HND-015336,2011,162400001,,,,40,28,68
HND-015340,2011,162400008,,,,0,3,3
HND-015340,2011,162400008,,,,0,1,1
HND-015336,2011,162400001,,,,32,40,72
HND-015336,2011,162400001,,,,35,39,74
HND-015336,2011,162400001,,,,52,40,92
HND-015336,2011,162400001,,,,50,49,99
HND-015336,2011,162400001,,,,24,22,46
HND-015336,2011,162400001,,,,17,14,31
,2011,162500011,,,,11,9,20
HND-015354,2011,162500014,,,,4,6,10
,2011,162500032,,,,9,5,14
HND-015358,2011,162500042,,,,8,6,14
,2011,162500043,,,,4,3,7
HND-015359,2011,162500044,,,,4,7,11
HND-015360,2011,162500045,,,,3,8,11
HND-015352,2011,162500009,,,,9,10,19
,2011,162500013,,,,8,6,14
HND-015357,2011,162500041,,,,3,6,9
,2011,162500013,,,,1,2,3
HND-015358,2011,162500042,,,,2,0,2
HND-015345,2011,162500001,,,,2,9,11
HND-015353,2011,162500012,,,,6,7,13
HND-015358,2011,162500042,,,,4,3,7
,2011,162500013,,,,0,2,2
HND-015345,2011,162500001,,,,14,13,27
HND-015353,2011,162500012,,,,5,10,15
,2011,162500013,,,,6,7,13
HND-015358,2011,162500042,,,,2,3,5
HND-015346,2011,162500002,,,,25,27,52
HND-015347,2011,162500003,,,,7,7,14
HND-015348,2011,162500004,,,,10,10,20
HND-015350,2011,162500006,,,,19,11,30
HND-015355,2011,162500015,,,,4,4,8
HND-015349,2011,162500005,,,,9,3,12
HND-015351,2011,162500008,,,,2,1,3
HND-015356,2011,162500033,,,,1,0,1
HND-015348,2011,162500004,,,,9,6,15
HND-015349,2011,162500005,,,,6,2,8
HND-015350,2011,162500006,,,,13,7,20
HND-015351,2011,162500008,,,,0,4,4
HND-015356,2011,162500033,,,,1,0,1
HND-015346,2011,162500002,,,,31,27,58
HND-015347,2011,162500003,,,,10,5,15
HND-015355,2011,162500015,,,,1,6,7
HND-015346,2011,162500002,,,,23,30,53
HND-015348,2011,162500004,,,,13,6,19
HND-015350,2011,162500006,,,,10,14,24
HND-015355,2011,162500015,,,,7,3,10
HND-015356,2011,162500033,,,,0,1,1
HND-015347,2011,162500003,,,,8,9,17
HND-015349,2011,162500005,,,,2,6,8
HND-015351,2011,162500008,,,,5,3,8
HND-015349,2011,162500005,,,,3,2,5
HND-015351,2011,162500008,,,,0,4,4
HND-015346,2011,162500002,,,,24,27,51
HND-015347,2011,162500003,,,,11,6,17
HND-015348,2011,162500004,,,,2,9,11
HND-015350,2011,162500006,,,,11,5,16
HND-015355,2011,162500015,,,,2,5,7
HND-015356,2011,162500033,,,,2,0,2
HND-015349,2011,162500005,,,,5,6,11
HND-015351,2011,162500008,,,,5,3,8
HND-015346,2011,162500002,,,,38,29,67
HND-015347,2011,162500003,,,,10,2,12
HND-015348,2011,162500004,,,,5,6,11
HND-015350,2011,162500006,,,,7,8,15
HND-015355,2011,162500015,,,,1,6,7
HND-015356,2011,162500033,,,,0,3,3
HND-015346,2011,162500002,,,,22,18,40
HND-015347,2011,162500003,,,,7,5,12
HND-015355,2011,162500015,,,,7,3,10
HND-015348,2011,162500004,,,,15,4,19
HND-015349,2011,162500005,,,,0,5,5
HND-015350,2011,162500006,,,,9,7,16
HND-015351,2011,162500008,,,,2,1,3
HND-015346,2011,162500002,,,,14,29,43
HND-015346,2011,162500002,,,,11,19,30
HND-015346,2011,162500002,,,,11,13,24
,2011,162600035,,,,6,6,12
,2011,162600037,,,,7,5,12
HND-015400,2011,162600046,,,,11,15,26
HND-015401,2011,162600048,,,,5,6,11
,2011,162600049,,,,10,14,24
,2011,162600060,,,,5,4,9
,2011,162600095,,,,4,6,10
HND-015409,2011,162600097,,,,7,0,7
,2011,162600098,,,,14,7,21
,2011,162600040,,,,10,7,17
HND-015398,2011,162600043,,,,16,11,27
HND-015399,2011,162600044,,,,2,8,10
,2011,162600045,,,,7,10,17
,2011,162600047,,,,2,7,9
,2011,162600053,,,,10,10,20
,2011,162600054,,,,6,7,13
HND-015403,2011,162600057,,,,15,5,20
,2011,162600062,,,,3,7,10
,2011,162600066,,,,2,10,12
HND-015393,2011,162600031,,,,3,4,7
HND-015393,2011,162600031,,,,15,18,33
HND-015394,2011,162600032,,,,9,5,14
HND-015397,2011,162600036,,,,5,3,8
HND-015407,2011,162600070,,,,4,8,12
,2011,162600094,,,,5,6,11
HND-015393,2011,162600031,,,,29,33,62
HND-015397,2011,162600036,,,,7,5,12
HND-015407,2011,162600070,,,,12,8,20
,2011,162600094,,,,2,5,7
HND-015394,2011,162600032,,,,8,22,30
HND-015395,2011,162600033,,,,5,20,25
HND-015364,2011,162600002,,,,16,15,31
HND-015365,2011,162600003,,,,1,3,4
HND-015366,2011,162600004,,,,8,3,11
HND-015368,2011,162600006,,,,4,6,10
HND-015371,2011,162600009,,,,6,8,14
HND-015373,2011,162600011,,,,8,6,14
HND-015374,2011,162600012,,,,4,5,9
HND-015375,2011,162600013,,,,17,15,32
HND-015377,2011,162600015,,,,30,26,56
HND-015381,2011,162600019,,,,6,2,8
HND-015382,2011,162600020,,,,6,6,12
HND-015383,2011,162600021,,,,3,5,8
HND-015387,2011,162600025,,,,3,5,8
HND-015388,2011,162600026,,,,0,1,1
,2011,162600027,,,,11,6,17
,2011,162600067,,,,6,2,8
HND-015406,2011,162600068,,,,3,2,5
HND-015367,2011,162600005,,,,15,18,33
HND-015369,2011,162600007,,,,1,1,2
HND-015370,2011,162600008,,,,7,7,14
HND-015372,2011,162600010,,,,11,10,21
HND-015376,2011,162600014,,,,18,17,35
HND-015378,2011,162600016,,,,3,4,7
,2011,162600017,,,,3,6,9
HND-015380,2011,162600018,,,,14,13,27
HND-015384,2011,162600022,,,,4,3,7
HND-015385,2011,162600023,,,,5,7,12
HND-015390,2011,162600028,,,,3,6,9
HND-015391,2011,162600029,,,,5,9,14
HND-015392,2011,162600030,,,,10,3,13
HND-015395,2011,162600033,,,,17,15,32
HND-015402,2011,162600050,,,,3,3,6
HND-015404,2011,162600063,,,,20,9,29
HND-015407,2011,162600070,,,,3,0,3
,2011,162600094,,,,10,5,15
HND-015364,2011,162600002,,,,17,12,29
HND-015366,2011,162600004,,,,5,3,8
HND-015368,2011,162600006,,,,3,3,6
HND-015369,2011,162600007,,,,2,4,6
HND-015371,2011,162600009,,,,3,5,8
HND-015372,2011,162600010,,,,7,7,14
HND-015373,2011,162600011,,,,6,7,13
HND-015375,2011,162600013,,,,8,14,22
HND-015376,2011,162600014,,,,12,20,32
HND-015377,2011,162600015,,,,37,29,66
HND-015378,2011,162600016,,,,2,1,3
,2011,162600017,,,,2,3,5
HND-015381,2011,162600019,,,,0,1,1
HND-015382,2011,162600020,,,,11,1,12
HND-015383,2011,162600021,,,,7,3,10
HND-015384,2011,162600022,,,,6,4,10
HND-015387,2011,162600025,,,,4,2,6
,2011,162600027,,,,2,5,7
HND-015390,2011,162600028,,,,3,0,3
HND-015392,2011,162600030,,,,12,5,17
HND-015402,2011,162600050,,,,2,1,3
HND-015406,2011,162600068,,,,3,2,5
HND-015407,2011,162600070,,,,1,1,2
,2011,162600094,,,,4,5,9
HND-015367,2011,162600005,,,,14,11,25
HND-015370,2011,162600008,,,,8,1,9
HND-015374,2011,162600012,,,,7,9,16
HND-015380,2011,162600018,,,,17,12,29
HND-015385,2011,162600023,,,,6,6,12
,2011,162600024,,,,3,2,5
HND-015388,2011,162600026,,,,1,2,3
HND-015391,2011,162600029,,,,1,2,3
HND-015395,2011,162600033,,,,14,11,25
HND-015404,2011,162600063,,,,7,5,12
,2011,162600067,,,,3,1,4
HND-015364,2011,162600002,,,,16,21,37
HND-015365,2011,162600003,,,,0,2,2
HND-015366,2011,162600004,,,,4,6,10
HND-015368,2011,162600006,,,,0,1,1
HND-015371,2011,162600009,,,,8,5,13
HND-015373,2011,162600011,,,,5,7,12
HND-015374,2011,162600012,,,,6,11,17
HND-015375,2011,162600013,,,,14,9,23
HND-015377,2011,162600015,,,,28,32,60
HND-015378,2011,162600016,,,,2,2,4
HND-015381,2011,162600019,,,,3,3,6
HND-015382,2011,162600020,,,,6,3,9
HND-015383,2011,162600021,,,,6,7,13
,2011,162600024,,,,4,1,5
HND-015387,2011,162600025,,,,3,3,6
HND-015388,2011,162600026,,,,1,5,6
,2011,162600027,,,,8,5,13
HND-015392,2011,162600030,,,,4,11,15
HND-015395,2011,162600033,,,,12,10,22
,2011,162600067,,,,1,1,2
HND-015406,2011,162600068,,,,2,3,5
HND-015407,2011,162600070,,,,2,2,4
,2011,162600094,,,,6,6,12
HND-015367,2011,162600005,,,,20,23,43
HND-015369,2011,162600007,,,,4,1,5
HND-015370,2011,162600008,,,,5,3,8
HND-015372,2011,162600010,,,,11,9,20
HND-015376,2011,162600014,,,,21,19,40
,2011,162600017,,,,3,4,7
HND-015380,2011,162600018,,,,14,8,22
HND-015384,2011,162600022,,,,4,6,10
HND-015385,2011,162600023,,,,8,4,12
HND-015390,2011,162600028,,,,3,8,11
HND-015391,2011,162600029,,,,2,2,4
HND-015404,2011,162600063,,,,5,6,11
HND-015366,2011,162600004,,,,5,4,9
HND-015367,2011,162600005,,,,15,13,28
HND-015368,2011,162600006,,,,2,1,3
HND-015369,2011,162600007,,,,4,1,5
HND-015372,2011,162600010,,,,9,5,14
HND-015373,2011,162600011,,,,4,6,10
HND-015376,2011,162600014,,,,20,20,40
HND-015378,2011,162600016,,,,0,4,4
,2011,162600017,,,,6,1,7
HND-015381,2011,162600019,,,,1,5,6
HND-015383,2011,162600021,,,,4,1,5
HND-015384,2011,162600022,,,,3,8,11
HND-015387,2011,162600025,,,,3,0,3
HND-015390,2011,162600028,,,,1,1,2
HND-015392,2011,162600030,,,,3,9,12
HND-015402,2011,162600050,,,,3,0,3
HND-015404,2011,162600063,,,,4,2,6
HND-015406,2011,162600068,,,,5,2,7
,2011,162600094,,,,2,6,8
HND-015364,2011,162600002,,,,22,18,40
HND-015365,2011,162600003,,,,1,2,3
HND-015370,2011,162600008,,,,2,3,5
HND-015371,2011,162600009,,,,7,6,13
HND-015374,2011,162600012,,,,7,6,13
HND-015375,2011,162600013,,,,7,17,24
HND-015377,2011,162600015,,,,24,24,48
HND-015380,2011,162600018,,,,22,3,25
HND-015382,2011,162600020,,,,5,4,9
HND-015385,2011,162600023,,,,4,5,9
,2011,162600024,,,,3,2,5
HND-015388,2011,162600026,,,,0,1,1
,2011,162600027,,,,2,6,8
HND-015395,2011,162600033,,,,7,14,21
,2011,162600067,,,,3,0,3
HND-015407,2011,162600070,,,,3,0,3
HND-015366,2011,162600004,,,,2,6,8
HND-015367,2011,162600005,,,,16,12,28
HND-015369,2011,162600007,,,,3,2,5
HND-015370,2011,162600008,,,,3,7,10
HND-015372,2011,162600010,,,,10,13,23
HND-015373,2011,162600011,,,,5,1,6
HND-015376,2011,162600014,,,,15,15,30
HND-015378,2011,162600016,,,,2,2,4
,2011,162600017,,,,4,1,5
HND-015383,2011,162600021,,,,2,5,7
HND-015384,2011,162600022,,,,4,2,6
HND-015385,2011,162600023,,,,1,6,7
HND-015387,2011,162600025,,,,2,4,6
HND-015390,2011,162600028,,,,1,11,12
HND-015392,2011,162600030,,,,8,4,12
HND-015404,2011,162600063,,,,3,2,5
HND-015364,2011,162600002,,,,21,14,35
HND-015365,2011,162600003,,,,0,3,3
HND-015368,2011,162600006,,,,6,3,9
HND-015371,2011,162600009,,,,5,10,15
HND-015374,2011,162600012,,,,7,6,13
HND-015375,2011,162600013,,,,10,12,22
HND-015377,2011,162600015,,,,28,40,68
HND-015380,2011,162600018,,,,7,13,20
HND-015381,2011,162600019,,,,2,4,6
HND-015382,2011,162600020,,,,5,11,16
,2011,162600024,,,,5,2,7
HND-015388,2011,162600026,,,,5,2,7
,2011,162600027,,,,5,2,7
HND-015391,2011,162600029,,,,4,1,5
HND-015395,2011,162600033,,,,17,17,34
HND-015402,2011,162600050,,,,1,0,1
,2011,162600067,,,,3,3,6
HND-015406,2011,162600068,,,,5,5,10
HND-015407,2011,162600070,,,,3,4,7
,2011,162600094,,,,4,2,6
HND-015365,2011,162600003,,,,2,1,3
HND-015367,2011,162600005,,,,12,11,23
HND-015370,2011,162600008,,,,1,4,5
HND-015374,2011,162600012,,,,5,3,8
HND-015380,2011,162600018,,,,6,9,15
HND-015385,2011,162600023,,,,4,4,8
,2011,162600024,,,,3,4,7
HND-015388,2011,162600026,,,,3,2,5
HND-015391,2011,162600029,,,,0,1,1
HND-015395,2011,162600033,,,,17,16,33
HND-015404,2011,162600063,,,,2,1,3
,2011,162600067,,,,1,2,3
HND-015364,2011,162600002,,,,20,18,38
HND-015366,2011,162600004,,,,2,2,4
HND-015368,2011,162600006,,,,3,1,4
HND-015369,2011,162600007,,,,5,2,7
HND-015371,2011,162600009,,,,6,4,10
HND-015372,2011,162600010,,,,9,8,17
HND-015373,2011,162600011,,,,6,3,9
HND-015375,2011,162600013,,,,11,9,20
HND-015376,2011,162600014,,,,15,11,26
HND-015377,2011,162600015,,,,32,40,72
HND-015378,2011,162600016,,,,2,3,5
,2011,162600017,,,,3,5,8
HND-015381,2011,162600019,,,,3,2,5
HND-015382,2011,162600020,,,,9,4,13
HND-015383,2011,162600021,,,,2,5,7
HND-015384,2011,162600022,,,,5,7,12
HND-015387,2011,162600025,,,,1,2,3
,2011,162600027,,,,6,1,7
HND-015390,2011,162600028,,,,8,2,10
HND-015392,2011,162600030,,,,6,4,10
HND-015402,2011,162600050,,,,0,3,3
HND-015406,2011,162600068,,,,5,2,7
HND-015363,2011,162600001,,,,43,33,76
HND-015376,2011,162600014,,,,10,18,28
HND-015395,2011,162600033,,,,8,6,14
HND-015396,2011,162600034,,,,105,111,216
HND-015363,2011,162600001,,,,27,16,43
HND-015376,2011,162600014,,,,14,13,27
HND-015396,2011,162600034,,,,112,101,213
HND-015395,2011,162600033,,,,8,10,18
HND-015376,2011,162600014,,,,8,17,25
HND-015396,2011,162600034,,,,68,97,165
HND-015363,2011,162600001,,,,28,14,42
HND-015395,2011,162600033,,,,10,12,22
HND-015396,2011,162600034,,,,110,128,238
HND-015363,2011,162600001,,,,34,33,67
HND-015363,2011,162600001,,,,29,19,48
HND-015396,2011,162600034,,,,102,105,207
HND-015363,2011,162600001,,,,21,36,57
HND-015396,2011,162600034,,,,43,60,103
HND-015439,2011,162700035,,,,18,13,31
,2011,162700045,,,,7,14,21
,2011,162700047,,,,4,5,9
,2011,162700052,,,,7,6,13
,2011,162700094,,,,6,12,18
HND-015448,2011,162700095,,,,5,2,7
HND-015449,2011,162700097,,,,5,4,9
HND-015447,2011,162700051,,,,11,13,24
,2011,162700096,,,,4,3,7
,2011,162700098,,,,5,5,10
,2011,162700048,,,,0,1,1
,2011,162700055,,,,0,1,1
HND-015441,2011,162700037,,,,0,3,3
,2011,162700039,,,,0,1,1
,2011,162700046,,,,1,1,2
,2011,162700024,,,,3,0,3
,2011,162700033,,,,0,1,1
HND-015440,2011,162700036,,,,6,3,9
HND-015441,2011,162700037,,,,3,2,5
HND-015443,2011,162700042,,,,2,2,4
,2011,162700046,,,,3,7,10
,2011,162700055,,,,1,2,3
,2011,162700099,,,,0,4,4
HND-015437,2011,162700032,,,,2,2,4
HND-015444,2011,162700043,,,,2,3,5
HND-015445,2011,162700044,,,,6,7,13
,2011,162700048,,,,4,3,7
HND-015437,2011,162700032,,,,17,12,29
HND-015440,2011,162700036,,,,11,7,18
HND-015441,2011,162700037,,,,5,3,8
HND-015443,2011,162700042,,,,12,12,24
,2011,162700046,,,,8,15,23
,2011,162700055,,,,8,6,14
,2011,162700099,,,,2,5,7
,2011,162700024,,,,7,4,11
HND-015432,2011,162700026,,,,35,34,69
,2011,162700033,,,,6,6,12
HND-015438,2011,162700034,,,,11,4,15
,2011,162700039,,,,7,9,16
HND-015444,2011,162700043,,,,17,14,31
HND-015445,2011,162700044,,,,7,9,16
,2011,162700048,,,,2,5,7
HND-015411,2011,162700001,,,,54,54,108
HND-015415,2011,162700005,,,,18,14,32
HND-015418,2011,162700008,,,,13,10,23
HND-015423,2011,162700014,,,,5,7,12
HND-015424,2011,162700015,,,,7,6,13
HND-015425,2011,162700016,,,,5,8,13
HND-015426,2011,162700017,,,,2,1,3
HND-015427,2011,162700018,,,,2,2,4
HND-015429,2011,162700020,,,,43,35,78
HND-015435,2011,162700029,,,,4,4,8
HND-015436,2011,162700031,,,,5,3,8
HND-015442,2011,162700040,,,,1,1,2
HND-015446,2011,162700049,,,,0,6,6
,2011,162700099,,,,1,0,1
HND-015412,2011,162700002,,,,39,33,72
HND-015413,2011,162700003,,,,3,2,5
HND-015414,2011,162700004,,,,10,15,25
HND-015416,2011,162700006,,,,11,11,22
HND-015417,2011,162700007,,,,17,16,33
HND-015419,2011,162700009,,,,5,10,15
HND-015420,2011,162700011,,,,9,10,19
HND-015421,2011,162700012,,,,14,11,25
HND-015422,2011,162700013,,,,5,2,7
HND-015428,2011,162700019,,,,30,15,45
HND-015430,2011,162700022,,,,6,3,9
HND-015431,2011,162700023,,,,5,2,7
,2011,162700024,,,,7,7,14
HND-015411,2011,162700001,,,,67,53,120
HND-015414,2011,162700004,,,,25,13,38
HND-015415,2011,162700005,,,,8,12,20
HND-015416,2011,162700006,,,,1,2,3
HND-015417,2011,162700007,,,,21,19,40
HND-015418,2011,162700008,,,,15,12,27
HND-015420,2011,162700011,,,,5,8,13
HND-015422,2011,162700013,,,,5,1,6
HND-015423,2011,162700014,,,,8,7,15
HND-015425,2011,162700016,,,,7,3,10
HND-015426,2011,162700017,,,,4,2,6
HND-015428,2011,162700019,,,,13,14,27
HND-015430,2011,162700022,,,,3,6,9
HND-015431,2011,162700023,,,,0,1,1
HND-015435,2011,162700029,,,,2,4,6
,2011,162700099,,,,1,2,3
HND-015412,2011,162700002,,,,32,26,58
HND-015413,2011,162700003,,,,3,4,7
HND-015419,2011,162700009,,,,8,5,13
HND-015421,2011,162700012,,,,4,6,10
HND-015424,2011,162700015,,,,15,10,25
HND-015427,2011,162700018,,,,2,4,6
HND-015429,2011,162700020,,,,22,42,64
,2011,162700024,,,,7,4,11
HND-015436,2011,162700031,,,,7,3,10
HND-015442,2011,162700040,,,,3,0,3
HND-015446,2011,162700049,,,,2,3,5
HND-015412,2011,162700002,,,,35,38,73
HND-015414,2011,162700004,,,,9,17,26
HND-015416,2011,162700006,,,,0,5,5
HND-015417,2011,162700007,,,,11,12,23
HND-015419,2011,162700009,,,,6,7,13
HND-015420,2011,162700011,,,,6,7,13
HND-015421,2011,162700012,,,,6,6,12
HND-015422,2011,162700013,,,,2,3,5
HND-015428,2011,162700019,,,,18,21,39
HND-015430,2011,162700022,,,,3,3,6
HND-015431,2011,162700023,,,,2,2,4
HND-015436,2011,162700031,,,,11,8,19
HND-015442,2011,162700040,,,,1,1,2
HND-015446,2011,162700049,,,,6,0,6
HND-015411,2011,162700001,,,,61,59,120
HND-015413,2011,162700003,,,,1,8,9
HND-015415,2011,162700005,,,,6,11,17
HND-015418,2011,162700008,,,,9,9,18
HND-015423,2011,162700014,,,,2,7,9
HND-015424,2011,162700015,,,,13,13,26
HND-015425,2011,162700016,,,,1,3,4
HND-015426,2011,162700017,,,,4,2,6
HND-015427,2011,162700018,,,,1,5,6
HND-015429,2011,162700020,,,,27,27,54
,2011,162700024,,,,7,3,10
HND-015435,2011,162700029,,,,2,3,5
HND-015411,2011,162700001,,,,71,73,144
HND-015415,2011,162700005,,,,7,6,13
HND-015417,2011,162700007,,,,4,6,10
HND-015418,2011,162700008,,,,9,6,15
HND-015420,2011,162700011,,,,5,10,15
HND-015423,2011,162700014,,,,4,7,11
HND-015425,2011,162700016,,,,5,2,7
HND-015426,2011,162700017,,,,4,4,8
HND-015428,2011,162700019,,,,20,11,31
HND-015429,2011,162700020,,,,33,26,59
HND-015431,2011,162700023,,,,1,1,2
HND-015435,2011,162700029,,,,3,5,8
HND-015412,2011,162700002,,,,32,41,73
HND-015413,2011,162700003,,,,4,8,12
HND-015414,2011,162700004,,,,14,16,30
HND-015416,2011,162700006,,,,2,4,6
HND-015419,2011,162700009,,,,4,7,11
HND-015421,2011,162700012,,,,15,11,26
HND-015422,2011,162700013,,,,1,2,3
HND-015424,2011,162700015,,,,13,9,22
HND-015427,2011,162700018,,,,3,5,8
HND-015430,2011,162700022,,,,5,9,14
,2011,162700024,,,,3,5,8
HND-015436,2011,162700031,,,,3,8,11
HND-015442,2011,162700040,,,,1,3,4
HND-015446,2011,162700049,,,,6,1,7
HND-015411,2011,162700001,,,,59,65,124
HND-015415,2011,162700005,,,,13,13,26
HND-015418,2011,162700008,,,,12,10,22
HND-015420,2011,162700011,,,,9,8,17
HND-015423,2011,162700014,,,,2,4,6
HND-015424,2011,162700015,,,,13,9,22
HND-015425,2011,162700016,,,,4,5,9
HND-015426,2011,162700017,,,,1,2,3
HND-015429,2011,162700020,,,,45,30,75
HND-015431,2011,162700023,,,,1,0,1
HND-015412,2011,162700002,,,,35,42,77
HND-015414,2011,162700004,,,,14,12,26
HND-015416,2011,162700006,,,,3,4,7
HND-015417,2011,162700007,,,,5,10,15
HND-015419,2011,162700009,,,,7,13,20
HND-015421,2011,162700012,,,,11,11,22
HND-015422,2011,162700013,,,,4,3,7
HND-015427,2011,162700018,,,,6,2,8
HND-015428,2011,162700019,,,,23,17,40
HND-015430,2011,162700022,,,,4,6,10
,2011,162700024,,,,10,6,16
HND-015436,2011,162700031,,,,6,4,10
HND-015442,2011,162700040,,,,1,2,3
HND-015412,2011,162700002,,,,42,48,90
HND-015413,2011,162700003,,,,4,3,7
HND-015419,2011,162700009,,,,5,7,12
HND-015421,2011,162700012,,,,2,8,10
HND-015424,2011,162700015,,,,4,9,13
HND-015427,2011,162700018,,,,0,2,2
HND-015429,2011,162700020,,,,30,30,60
,2011,162700024,,,,5,3,8
HND-015436,2011,162700031,,,,3,6,9
HND-015442,2011,162700040,,,,1,0,1
HND-015446,2011,162700049,,,,1,5,6
HND-015411,2011,162700001,,,,71,67,138
HND-015414,2011,162700004,,,,13,12,25
HND-015415,2011,162700005,,,,15,14,29
HND-015416,2011,162700006,,,,1,3,4
HND-015417,2011,162700007,,,,2,4,6
HND-015418,2011,162700008,,,,12,11,23
HND-015420,2011,162700011,,,,7,9,16
HND-015423,2011,162700014,,,,5,6,11
HND-015425,2011,162700016,,,,4,3,7
HND-015426,2011,162700017,,,,6,2,8
HND-015428,2011,162700019,,,,20,18,38
HND-015430,2011,162700022,,,,8,1,9
HND-015431,2011,162700023,,,,1,3,4
HND-015418,2011,162700008,,,,14,7,21
HND-015429,2011,162700020,,,,31,35,66
HND-015433,2011,162700027,,,,162,146,308
HND-015414,2011,162700004,,,,7,23,30
HND-015414,2011,162700004,,,,3,16,19
HND-015418,2011,162700008,,,,9,9,18
HND-015429,2011,162700020,,,,11,12,23
HND-015433,2011,162700027,,,,122,100,222
HND-015414,2011,162700004,,,,15,12,27
HND-015418,2011,162700008,,,,12,8,20
HND-015429,2011,162700020,,,,14,9,23
HND-015433,2011,162700027,,,,105,124,229
,2011,162700100,,,,63,99,162
HND-015433,2011,162700027,,,,90,116,206
HND-015433,2011,162700027,,,,71,104,175
HND-015433,2011,162700027,,,,41,80,121
HND-015462,2011,162800012,,,,6,4,10
,2011,162800037,,,,8,2,10
,2011,162800059,,,,8,8,16
HND-015499,2011,162800068,,,,7,2,9
,2011,162800072,,,,5,7,12
HND-015507,2011,162800081,,,,5,4,9
HND-015508,2011,162800084,,,,8,1,9
,2011,162800086,,,,5,4,9
HND-015510,2011,162800089,,,,8,7,15
HND-015515,2011,162800095,,,,5,3,8
HND-015497,2011,162800066,,,,4,5,9
HND-015498,2011,162800067,,,,7,3,10
,2011,162800069,,,,6,5,11
HND-015501,2011,162800074,,,,8,7,15
HND-015502,2011,162800075,,,,5,6,11
HND-015504,2011,162800078,,,,7,6,13
,2011,162800082,,,,6,3,9
,2011,162800083,,,,4,0,4
,2011,162800085,,,,5,3,8
HND-015509,2011,162800087,,,,6,7,13
HND-015511,2011,162800090,,,,8,5,13
,2011,162800091,,,,8,4,12
HND-015512,2011,162800092,,,,5,4,9
HND-015513,2011,162800093,,,,11,6,17
HND-015484,2011,162800036,,,,3,3,6
HND-015506,2011,162800080,,,,3,1,4
HND-015461,2011,162800011,,,,2,2,4
HND-015485,2011,162800038,,,,2,1,3
HND-015484,2011,162800036,,,,1,3,4
HND-015491,2011,162800045,,,,4,4,8
HND-015492,2011,162800047,,,,0,4,4
HND-015506,2011,162800080,,,,4,2,6
HND-015461,2011,162800011,,,,3,4,7
HND-015485,2011,162800038,,,,1,2,3
HND-015461,2011,162800011,,,,1,2,3
HND-015465,2011,162800016,,,,15,12,27
,2011,162800019,,,,10,13,23
HND-015470,2011,162800022,,,,13,13,26
HND-015483,2011,162800035,,,,10,8,18
HND-015485,2011,162800038,,,,4,5,9
HND-015487,2011,162800040,,,,6,9,15
HND-015492,2011,162800047,,,,3,7,10
HND-015466,2011,162800017,,,,17,22,39
HND-015467,2011,162800018,,,,9,12,21
HND-015482,2011,162800034,,,,9,11,20
HND-015484,2011,162800036,,,,3,2,5
HND-015491,2011,162800045,,,,7,3,10
HND-015506,2011,162800080,,,,3,2,5
HND-015451,2011,162800001,,,,10,4,14
HND-015452,2011,162800002,,,,3,2,5
HND-015453,2011,162800003,,,,41,45,86
HND-015459,2011,162800009,,,,3,5,8
HND-015460,2011,162800010,,,,11,8,19
HND-015461,2011,162800011,,,,9,9,18
HND-015464,2011,162800014,,,,4,4,8
HND-015471,2011,162800023,,,,14,4,18
HND-015476,2011,162800028,,,,8,7,15
HND-015477,2011,162800029,,,,18,17,35
HND-015479,2011,162800031,,,,2,3,5
HND-015480,2011,162800032,,,,0,3,3
HND-015481,2011,162800033,,,,3,4,7
HND-015489,2011,162800043,,,,6,5,11
HND-015490,2011,162800044,,,,0,4,4
HND-015493,2011,162800057,,,,0,2,2
HND-015494,2011,162800062,,,,1,0,1
HND-015496,2011,162800065,,,,9,4,13
HND-015503,2011,162800076,,,,2,0,2
HND-015505,2011,162800079,,,,1,2,3
,2011,162800094,,,,4,1,5
HND-015516,2011,162800096,,,,6,0,6
HND-015454,2011,162800004,,,,12,19,31
HND-015455,2011,162800005,,,,17,21,38
HND-015456,2011,162800006,,,,13,13,26
HND-015457,2011,162800007,,,,11,12,23
HND-015458,2011,162800008,,,,11,17,28
HND-015462,2011,162800012,,,,11,4,15
HND-015463,2011,162800013,,,,3,2,5
HND-015469,2011,162800021,,,,10,6,16
HND-015472,2011,162800024,,,,4,5,9
HND-015474,2011,162800026,,,,1,8,9
HND-015475,2011,162800027,,,,3,0,3
HND-015478,2011,162800030,,,,11,5,16
HND-015488,2011,162800042,,,,6,5,11
HND-015495,2011,162800064,,,,5,4,9
HND-015452,2011,162800002,,,,3,4,7
HND-015455,2011,162800005,,,,20,22,42
HND-015457,2011,162800007,,,,12,15,27
HND-015458,2011,162800008,,,,11,6,17
HND-015460,2011,162800010,,,,9,7,16
HND-015461,2011,162800011,,,,3,1,4
HND-015463,2011,162800013,,,,3,2,5
HND-015464,2011,162800014,,,,2,0,2
HND-015472,2011,162800024,,,,6,4,10
HND-015475,2011,162800027,,,,3,2,5
HND-015476,2011,162800028,,,,1,1,2
HND-015480,2011,162800032,,,,3,3,6
HND-015490,2011,162800044,,,,0,3,3
HND-015494,2011,162800062,,,,0,2,2
HND-015495,2011,162800064,,,,2,1,3
HND-015505,2011,162800079,,,,2,1,3
HND-015451,2011,162800001,,,,6,9,15
HND-015453,2011,162800003,,,,53,52,105
HND-015454,2011,162800004,,,,16,12,28
HND-015456,2011,162800006,,,,8,3,11
HND-015459,2011,162800009,,,,3,5,8
HND-015462,2011,162800012,,,,5,10,15
HND-015469,2011,162800021,,,,5,5,10
HND-015471,2011,162800023,,,,11,14,25
HND-015474,2011,162800026,,,,3,2,5
HND-015477,2011,162800029,,,,30,26,56
HND-015478,2011,162800030,,,,11,8,19
HND-015479,2011,162800031,,,,4,3,7
HND-015481,2011,162800033,,,,2,4,6
HND-015486,2011,162800039,,,,4,1,5
HND-015488,2011,162800042,,,,0,4,4
HND-015489,2011,162800043,,,,4,1,5
HND-015493,2011,162800057,,,,1,4,5
HND-015496,2011,162800065,,,,3,1,4
HND-015503,2011,162800076,,,,3,2,5
,2011,162800094,,,,2,2,4
HND-015516,2011,162800096,,,,2,1,3
HND-015454,2011,162800004,,,,11,18,29
HND-015455,2011,162800005,,,,21,21,42
HND-015456,2011,162800006,,,,2,5,7
HND-015457,2011,162800007,,,,16,7,23
HND-015458,2011,162800008,,,,10,11,21
HND-015461,2011,162800011,,,,7,6,13
HND-015462,2011,162800012,,,,6,5,11
HND-015469,2011,162800021,,,,8,6,14
HND-015472,2011,162800024,,,,8,11,19
HND-015474,2011,162800026,,,,2,5,7
HND-015475,2011,162800027,,,,1,1,2
HND-015478,2011,162800030,,,,6,5,11
HND-015480,2011,162800032,,,,0,2,2
HND-015488,2011,162800042,,,,0,1,1
HND-015495,2011,162800064,,,,1,2,3
HND-015451,2011,162800001,,,,5,5,10
HND-015452,2011,162800002,,,,4,1,5
HND-015453,2011,162800003,,,,44,43,87
HND-015459,2011,162800009,,,,3,2,5
HND-015460,2011,162800010,,,,0,5,5
HND-015464,2011,162800014,,,,4,1,5
HND-015471,2011,162800023,,,,7,9,16
HND-015476,2011,162800028,,,,2,4,6
HND-015477,2011,162800029,,,,22,11,33
HND-015479,2011,162800031,,,,3,3,6
HND-015481,2011,162800033,,,,5,1,6
HND-015486,2011,162800039,,,,1,0,1
HND-015489,2011,162800043,,,,1,3,4
HND-015490,2011,162800044,,,,1,0,1
HND-015493,2011,162800057,,,,3,0,3
HND-015494,2011,162800062,,,,1,0,1
HND-015496,2011,162800065,,,,4,3,7
HND-015505,2011,162800079,,,,3,1,4
,2011,162800094,,,,1,2,3
HND-015516,2011,162800096,,,,1,1,2
HND-015452,2011,162800002,,,,2,2,4
HND-015453,2011,162800003,,,,35,43,78
HND-015455,2011,162800005,,,,17,17,34
HND-015458,2011,162800008,,,,7,10,17
HND-015460,2011,162800010,,,,6,3,9
HND-015461,2011,162800011,,,,6,5,11
HND-015463,2011,162800013,,,,1,3,4
HND-015464,2011,162800014,,,,6,1,7
HND-015476,2011,162800028,,,,2,7,9
HND-015480,2011,162800032,,,,1,1,2
HND-015481,2011,162800033,,,,1,3,4
HND-015489,2011,162800043,,,,1,2,3
HND-015490,2011,162800044,,,,3,1,4
HND-015494,2011,162800062,,,,0,1,1
HND-015495,2011,162800064,,,,3,1,4
HND-015496,2011,162800065,,,,3,2,5
,2011,162800094,,,,2,0,2
HND-015516,2011,162800096,,,,3,5,8
HND-015451,2011,162800001,,,,8,2,10
HND-015454,2011,162800004,,,,11,21,32
HND-015456,2011,162800006,,,,4,5,9
HND-015457,2011,162800007,,,,9,4,13
HND-015459,2011,162800009,,,,3,4,7
HND-015462,2011,162800012,,,,5,2,7
HND-015469,2011,162800021,,,,3,4,7
HND-015471,2011,162800023,,,,10,11,21
HND-015472,2011,162800024,,,,8,3,11
HND-015474,2011,162800026,,,,3,3,6
HND-015475,2011,162800027,,,,1,2,3
HND-015477,2011,162800029,,,,15,20,35
HND-015478,2011,162800030,,,,1,3,4
HND-015479,2011,162800031,,,,2,1,3
HND-015486,2011,162800039,,,,2,0,2
HND-015488,2011,162800042,,,,0,1,1
HND-015503,2011,162800076,,,,2,1,3
HND-015452,2011,162800002,,,,3,1,4
HND-015453,2011,162800003,,,,45,42,87
HND-015458,2011,162800008,,,,6,7,13
HND-015459,2011,162800009,,,,0,4,4
HND-015460,2011,162800010,,,,3,3,6
HND-015461,2011,162800011,,,,7,0,7
HND-015464,2011,162800014,,,,3,0,3
HND-015476,2011,162800028,,,,2,3,5
HND-015478,2011,162800030,,,,7,5,12
HND-015488,2011,162800042,,,,0,1,1
HND-015493,2011,162800057,,,,2,2,4
HND-015495,2011,162800064,,,,1,1,2
HND-015496,2011,162800065,,,,0,3,3
HND-015451,2011,162800001,,,,5,5,10
HND-015454,2011,162800004,,,,19,13,32
HND-015455,2011,162800005,,,,14,14,28
HND-015456,2011,162800006,,,,5,4,9
HND-015457,2011,162800007,,,,7,12,19
HND-015462,2011,162800012,,,,2,4,6
HND-015463,2011,162800013,,,,3,0,3
HND-015469,2011,162800021,,,,7,5,12
HND-015471,2011,162800023,,,,5,13,18
HND-015472,2011,162800024,,,,3,6,9
HND-015474,2011,162800026,,,,0,4,4
HND-015475,2011,162800027,,,,2,4,6
HND-015477,2011,162800029,,,,20,23,43
HND-015479,2011,162800031,,,,5,3,8
HND-015480,2011,162800032,,,,3,0,3
HND-015481,2011,162800033,,,,5,2,7
HND-015486,2011,162800039,,,,4,3,7
HND-015489,2011,162800043,,,,0,1,1
HND-015490,2011,162800044,,,,4,1,5
HND-015503,2011,162800076,,,,2,4,6
,2011,162800094,,,,2,0,2
HND-015516,2011,162800096,,,,2,3,5
HND-015451,2011,162800001,,,,7,10,17
HND-015453,2011,162800003,,,,39,42,81
HND-015454,2011,162800004,,,,11,12,23
HND-015456,2011,162800006,,,,3,12,15
HND-015462,2011,162800012,,,,2,1,3
HND-015469,2011,162800021,,,,3,7,10
HND-015471,2011,162800023,,,,7,9,16
HND-015474,2011,162800026,,,,0,4,4
HND-015477,2011,162800029,,,,27,29,56
HND-015480,2011,162800032,,,,0,1,1
HND-015490,2011,162800044,,,,2,0,2
HND-015496,2011,162800065,,,,2,6,8
HND-015452,2011,162800002,,,,7,0,7
HND-015455,2011,162800005,,,,9,13,22
HND-015457,2011,162800007,,,,7,9,16
HND-015458,2011,162800008,,,,4,8,12
HND-015460,2011,162800010,,,,3,5,8
HND-015461,2011,162800011,,,,3,2,5
HND-015463,2011,162800013,,,,2,5,7
HND-015464,2011,162800014,,,,1,2,3
HND-015472,2011,162800024,,,,8,5,13
HND-015475,2011,162800027,,,,1,0,1
HND-015476,2011,162800028,,,,1,3,4
HND-015478,2011,162800030,,,,3,8,11
HND-015479,2011,162800031,,,,3,3,6
HND-015481,2011,162800033,,,,1,2,3
HND-015486,2011,162800039,,,,1,2,3
HND-015488,2011,162800042,,,,2,2,4
HND-015489,2011,162800043,,,,0,3,3
HND-015493,2011,162800057,,,,0,5,5
HND-015494,2011,162800062,,,,2,1,3
HND-015495,2011,162800064,,,,0,2,2
HND-015503,2011,162800076,,,,2,0,2
,2011,162800094,,,,1,1,2
HND-015455,2011,162800005,,,,15,17,32
HND-015473,2011,162800025,,,,30,54,84
HND-015477,2011,162800029,,,,13,23,36
HND-015455,2011,162800005,,,,16,16,32
HND-015473,2011,162800025,,,,25,32,57
HND-015477,2011,162800029,,,,15,20,35
HND-015455,2011,162800005,,,,6,12,18
HND-015473,2011,162800025,,,,23,27,50
HND-015477,2011,162800029,,,,10,16,26
HND-015473,2011,162800025,,,,30,13,43
HND-015473,2011,162800025,,,,7,10,17
HND-015473,2011,162800025,,,,12,14,26
HND-015525,2011,170100009,,,,4,2,6
HND-015540,2011,170100024,,,,2,1,3
HND-015545,2011,170100032,,,,2,0,2
HND-015555,2011,170100042,,,,2,8,10
HND-015584,2011,170100072,,,,2,3,5
,2011,170100173,,,,6,5,11
HND-015644,2011,170100191,,,,0,5,5
,2011,170100213,,,,0,5,5
,2011,170100216,,,,2,4,6
,2011,170100242,,,,2,5,7
,2011,170100245,,,,4,4,8
,2011,170100251,,,,4,5,9
HND-015654,2011,170100252,,,,4,6,10
HND-015655,2011,170100253,,,,4,5,9
,2011,170100254,,,,6,1,7
HND-015658,2011,170100258,,,,4,1,5
HND-015659,2011,170100259,,,,8,2,10
HND-015661,2011,170100262,,,,3,3,6
,2011,170100265,,,,0,6,6
,2011,170100268,,,,4,4,8
HND-015663,2011,170100270,,,,2,3,5
,2011,170100271,,,,3,4,7
HND-015524,2011,170100008,,,,5,1,6
HND-015541,2011,170100025,,,,2,3,5
HND-015542,2011,170100026,,,,3,7,10
HND-015563,2011,170100050,,,,2,3,5
HND-015573,2011,170100060,,,,7,8,15
HND-015631,2011,170100143,,,,2,3,5
,2011,170100145,,,,4,0,4
,2011,170100154,,,,3,2,5
HND-015642,2011,170100181,,,,9,4,13
HND-015643,2011,170100187,,,,1,9,10
,2011,170100190,,,,5,5,10
,2011,170100192,,,,6,2,8
HND-015645,2011,170100214,,,,3,4,7
HND-015646,2011,170100220,,,,4,2,6
HND-015647,2011,170100224,,,,7,4,11
HND-015650,2011,170100243,,,,9,0,9
HND-015651,2011,170100244,,,,4,2,6
HND-015652,2011,170100246,,,,4,2,6
,2011,170100247,,,,2,4,6
,2011,170100248,,,,2,3,5
HND-015656,2011,170100255,,,,3,2,5
HND-015657,2011,170100256,,,,3,5,8
HND-015660,2011,170100260,,,,3,2,5
,2011,170100261,,,,4,5,9
,2011,170100263,,,,2,3,5
,2011,170100264,,,,1,4,5
HND-015662,2011,170100266,,,,7,2,9
,2011,170100267,,,,4,5,9
,2011,170100269,,,,1,4,5
HND-015594,2011,170100082,,,,1,1,2
HND-015605,2011,170100096,,,,1,1,2
HND-015608,2011,170100101,,,,2,4,6
HND-015611,2011,170100106,,,,2,0,2
HND-015612,2011,170100107,,,,0,2,2
,2011,170100110,,,,1,3,4
HND-015615,2011,170100112,,,,1,3,4
HND-015616,2011,170100113,,,,0,3,3
,2011,170100116,,,,2,1,3
,2011,170100118,,,,0,1,1
HND-015620,2011,170100124,,,,4,4,8
HND-015628,2011,170100134,,,,0,2,2
,2011,170100135,,,,0,1,1
HND-015635,2011,170100152,,,,1,1,2
HND-015648,2011,170100225,,,,1,2,3
HND-015649,2011,170100226,,,,11,7,18
,2011,170100250,,,,2,0,2
HND-015523,2011,170100007,,,,0,2,2
HND-015574,2011,170100061,,,,1,0,1
HND-015590,2011,170100078,,,,2,1,3
HND-015592,2011,170100080,,,,5,1,6
HND-015593,2011,170100081,,,,1,0,1
HND-015595,2011,170100083,,,,1,2,3
HND-015603,2011,170100094,,,,8,8,16
HND-015609,2011,170100102,,,,2,3,5
,2011,170100103,,,,2,1,3
HND-015610,2011,170100104,,,,3,5,8
,2011,170100105,,,,3,1,4
,2011,170100109,,,,3,2,5
,2011,170100121,,,,3,4,7
HND-015621,2011,170100125,,,,2,0,2
HND-015622,2011,170100126,,,,0,3,3
HND-015623,2011,170100127,,,,1,0,1
HND-015624,2011,170100128,,,,2,5,7
HND-015632,2011,170100144,,,,0,2,2
HND-015636,2011,170100162,,,,0,3,3
HND-015574,2011,170100061,,,,3,3,6
HND-015590,2011,170100078,,,,2,5,7
HND-015592,2011,170100080,,,,2,1,3
HND-015594,2011,170100082,,,,5,5,10
HND-015602,2011,170100093,,,,9,4,13
HND-015603,2011,170100094,,,,15,19,34
HND-015607,2011,170100099,,,,9,12,21
HND-015608,2011,170100101,,,,5,4,9
,2011,170100103,,,,6,7,13
HND-015610,2011,170100104,,,,8,11,19
,2011,170100105,,,,6,5,11
HND-015612,2011,170100107,,,,5,10,15
,2011,170100109,,,,4,5,9
HND-015614,2011,170100111,,,,4,6,10
HND-015615,2011,170100112,,,,3,6,9
,2011,170100119,,,,5,5,10
,2011,170100121,,,,5,4,9
HND-015619,2011,170100122,,,,3,2,5
HND-015623,2011,170100127,,,,3,4,7
HND-015624,2011,170100128,,,,8,10,18
HND-015628,2011,170100134,,,,4,1,5
HND-015629,2011,170100138,,,,12,7,19
,2011,170100149,,,,5,2,7
HND-015635,2011,170100152,,,,2,4,6
,2011,170100161,,,,2,2,4
,2011,170100170,,,,5,5,10
HND-015648,2011,170100225,,,,3,1,4
,2011,170100250,,,,0,3,3
HND-015523,2011,170100007,,,,3,3,6
HND-015593,2011,170100081,,,,6,2,8
HND-015595,2011,170100083,,,,0,5,5
HND-015601,2011,170100091,,,,30,21,51
,2011,170100092,,,,4,6,10
HND-015604,2011,170100095,,,,7,8,15
HND-015605,2011,170100096,,,,4,10,14
HND-015606,2011,170100098,,,,2,3,5
HND-015609,2011,170100102,,,,6,4,10
HND-015611,2011,170100106,,,,8,2,10
HND-015613,2011,170100108,,,,3,3,6
,2011,170100110,,,,7,7,14
HND-015616,2011,170100113,,,,6,8,14
,2011,170100114,,,,4,1,5
,2011,170100115,,,,4,2,6
,2011,170100116,,,,4,8,12
,2011,170100118,,,,2,6,8
,2011,170100123,,,,2,3,5
HND-015620,2011,170100124,,,,3,6,9
HND-015621,2011,170100125,,,,0,2,2
HND-015622,2011,170100126,,,,5,15,20
,2011,170100135,,,,7,7,14
HND-015632,2011,170100144,,,,1,3,4
HND-015633,2011,170100147,,,,1,7,8
HND-015636,2011,170100162,,,,2,2,4
HND-015637,2011,170100163,,,,1,5,6
,2011,170100164,,,,0,4,4
,2011,170100166,,,,4,3,7
HND-015640,2011,170100175,,,,12,13,25
HND-015649,2011,170100226,,,,1,6,7
HND-015653,2011,170100249,,,,5,8,13
HND-015523,2011,170100007,,,,7,10,17
HND-015574,2011,170100061,,,,11,4,15
HND-015590,2011,170100078,,,,1,2,3
HND-015592,2011,170100080,,,,3,0,3
HND-015594,2011,170100082,,,,10,5,15
HND-015602,2011,170100093,,,,9,12,21
HND-015607,2011,170100099,,,,9,9,18
HND-015609,2011,170100102,,,,6,3,9
,2011,170100103,,,,4,2,6
,2011,170100105,,,,5,7,12
HND-015611,2011,170100106,,,,2,4,6
HND-015613,2011,170100108,,,,9,13,22
,2011,170100110,,,,7,13,20
HND-015616,2011,170100113,,,,14,7,21
,2011,170100114,,,,5,3,8
,2011,170100115,,,,4,5,9
HND-015618,2011,170100117,,,,6,2,8
,2011,170100118,,,,1,0,1
,2011,170100119,,,,14,5,19
,2011,170100123,,,,4,6,10
HND-015620,2011,170100124,,,,2,9,11
HND-015621,2011,170100125,,,,7,1,8
HND-015622,2011,170100126,,,,8,10,18
,2011,170100135,,,,14,11,25
HND-015632,2011,170100144,,,,2,2,4
HND-015633,2011,170100147,,,,4,4,8
HND-015636,2011,170100162,,,,3,3,6
HND-015637,2011,170100163,,,,5,1,6
,2011,170100164,,,,6,5,11
,2011,170100166,,,,6,5,11
HND-015649,2011,170100226,,,,8,8,16
HND-015653,2011,170100249,,,,9,3,12
HND-015593,2011,170100081,,,,4,6,10
HND-015595,2011,170100083,,,,4,3,7
HND-015601,2011,170100091,,,,47,42,89
,2011,170100092,,,,7,8,15
HND-015603,2011,170100094,,,,26,30,56
HND-015604,2011,170100095,,,,15,17,32
HND-015605,2011,170100096,,,,9,13,22
HND-015606,2011,170100098,,,,7,8,15
HND-015608,2011,170100101,,,,7,7,14
HND-015610,2011,170100104,,,,14,7,21
HND-015612,2011,170100107,,,,18,12,30
,2011,170100109,,,,6,6,12
HND-015614,2011,170100111,,,,9,3,12
HND-015615,2011,170100112,,,,4,2,6
,2011,170100116,,,,2,2,4
HND-015619,2011,170100122,,,,6,5,11
HND-015623,2011,170100127,,,,7,3,10
HND-015624,2011,170100128,,,,9,14,23
HND-015628,2011,170100134,,,,9,3,12
HND-015629,2011,170100138,,,,24,12,36
,2011,170100149,,,,3,2,5
HND-015635,2011,170100152,,,,2,3,5
,2011,170100161,,,,4,5,9
,2011,170100170,,,,1,1,2
HND-015640,2011,170100175,,,,10,10,20
HND-015648,2011,170100225,,,,5,4,9
,2011,170100250,,,,2,1,3
HND-015519,2011,170100002,,,,1,0,1
,2011,170100004,,,,6,8,14
HND-015521,2011,170100005,,,,6,3,9
HND-015524,2011,170100008,,,,5,2,7
HND-015526,2011,170100010,,,,4,3,7
HND-015528,2011,170100012,,,,3,2,5
HND-015530,2011,170100014,,,,4,3,7
HND-015531,2011,170100015,,,,19,8,27
HND-015534,2011,170100018,,,,7,10,17
HND-015537,2011,170100021,,,,4,7,11
,2011,170100023,,,,12,7,19
HND-015542,2011,170100026,,,,10,9,19
HND-015544,2011,170100031,,,,5,6,11
HND-015545,2011,170100032,,,,0,1,1
HND-015547,2011,170100034,,,,4,8,12
HND-015551,2011,170100038,,,,6,7,13
HND-015553,2011,170100040,,,,6,4,10
HND-015555,2011,170100042,,,,9,8,17
HND-015557,2011,170100044,,,,9,21,30
HND-015558,2011,170100045,,,,5,7,12
HND-015561,2011,170100048,,,,14,15,29
HND-015563,2011,170100050,,,,1,4,5
HND-015565,2011,170100052,,,,11,7,18
HND-015567,2011,170100054,,,,9,4,13
HND-015568,2011,170100055,,,,1,0,1
HND-015571,2011,170100058,,,,9,10,19
HND-015574,2011,170100061,,,,16,24,40
HND-015575,2011,170100062,,,,7,3,10
HND-015578,2011,170100065,,,,4,2,6
HND-015582,2011,170100069,,,,1,3,4
,2011,170100070,,,,4,8,12
HND-015583,2011,170100071,,,,20,17,37
HND-015584,2011,170100072,,,,5,3,8
HND-015586,2011,170100074,,,,7,5,12
HND-015587,2011,170100075,,,,3,6,9
HND-015589,2011,170100077,,,,37,36,73
HND-015590,2011,170100078,,,,3,1,4
HND-015592,2011,170100080,,,,2,7,9
HND-015593,2011,170100081,,,,6,3,9
HND-015594,2011,170100082,,,,10,2,12
HND-015596,2011,170100084,,,,7,1,8
HND-015598,2011,170100086,,,,8,16,24
,2011,170100103,,,,15,14,29
HND-015638,2011,170100165,,,,12,6,18
HND-015639,2011,170100174,,,,1,2,3
HND-015641,2011,170100180,,,,2,3,5
HND-015645,2011,170100214,,,,11,8,19
HND-015518,2011,170100001,,,,3,7,10
HND-015522,2011,170100006,,,,8,17,25
HND-015523,2011,170100007,,,,14,8,22
HND-015525,2011,170100009,,,,2,2,4
HND-015527,2011,170100011,,,,4,8,12
HND-015529,2011,170100013,,,,3,1,4
HND-015532,2011,170100016,,,,20,25,45
HND-015533,2011,170100017,,,,50,46,96
HND-015535,2011,170100019,,,,51,46,97
HND-015538,2011,170100022,,,,1,2,3
HND-015540,2011,170100024,,,,6,5,11
HND-015541,2011,170100025,,,,2,0,2
HND-015543,2011,170100029,,,,7,7,14
HND-015546,2011,170100033,,,,3,1,4
HND-015548,2011,170100035,,,,5,6,11
HND-015549,2011,170100036,,,,5,4,9
HND-015550,2011,170100037,,,,5,11,16
HND-015552,2011,170100039,,,,11,20,31
HND-015554,2011,170100041,,,,23,22,45
HND-015556,2011,170100043,,,,5,5,10
HND-015559,2011,170100046,,,,1,6,7
HND-015560,2011,170100047,,,,3,5,8
HND-015562,2011,170100049,,,,3,3,6
HND-015564,2011,170100051,,,,6,6,12
,2011,170100053,,,,4,4,8
HND-015569,2011,170100056,,,,1,1,2
HND-015570,2011,170100057,,,,6,7,13
HND-015572,2011,170100059,,,,2,7,9
HND-015573,2011,170100060,,,,1,5,6
HND-015576,2011,170100063,,,,0,3,3
HND-015577,2011,170100064,,,,2,3,5
HND-015579,2011,170100066,,,,2,1,3
HND-015580,2011,170100067,,,,11,4,15
HND-015581,2011,170100068,,,,0,4,4
HND-015585,2011,170100073,,,,10,8,18
HND-015588,2011,170100076,,,,1,6,7
HND-015591,2011,170100079,,,,1,2,3
HND-015595,2011,170100083,,,,4,2,6
HND-015597,2011,170100085,,,,46,50,96
HND-015599,2011,170100088,,,,5,7,12
HND-015600,2011,170100089,,,,3,7,10
HND-015630,2011,170100139,,,,7,8,15
HND-015634,2011,170100148,,,,12,1,13
HND-015635,2011,170100152,,,,11,3,14
HND-015518,2011,170100001,,,,3,5,8
,2011,170100004,,,,4,9,13
HND-015523,2011,170100007,,,,10,18,28
HND-015524,2011,170100008,,,,5,4,9
HND-015526,2011,170100010,,,,1,1,2
HND-015527,2011,170100011,,,,6,4,10
HND-015529,2011,170100013,,,,1,1,2
HND-015530,2011,170100014,,,,1,1,2
HND-015533,2011,170100017,,,,40,35,75
HND-015534,2011,170100018,,,,5,9,14
HND-015535,2011,170100019,,,,49,38,87
HND-015541,2011,170100025,,,,0,1,1
HND-015542,2011,170100026,,,,11,8,19
HND-015543,2011,170100029,,,,2,3,5
HND-015545,2011,170100032,,,,3,0,3
HND-015547,2011,170100034,,,,6,2,8
HND-015548,2011,170100035,,,,4,8,12
HND-015551,2011,170100038,,,,6,5,11
HND-015552,2011,170100039,,,,13,20,33
HND-015555,2011,170100042,,,,9,6,15
HND-015558,2011,170100045,,,,1,5,6
HND-015562,2011,170100049,,,,6,6,12
HND-015565,2011,170100052,,,,9,7,16
HND-015568,2011,170100055,,,,4,3,7
HND-015572,2011,170100059,,,,5,3,8
HND-015573,2011,170100060,,,,6,2,8
HND-015574,2011,170100061,,,,24,24,48
HND-015575,2011,170100062,,,,5,3,8
HND-015577,2011,170100064,,,,5,2,7
HND-015581,2011,170100068,,,,8,4,12
HND-015583,2011,170100071,,,,14,7,21
HND-015584,2011,170100072,,,,3,3,6
HND-015587,2011,170100075,,,,4,2,6
HND-015589,2011,170100077,,,,40,38,78
HND-015590,2011,170100078,,,,5,3,8
HND-015591,2011,170100079,,,,1,1,2
HND-015592,2011,170100080,,,,2,2,4
HND-015594,2011,170100082,,,,4,3,7
HND-015596,2011,170100084,,,,8,3,11
HND-015598,2011,170100086,,,,13,12,25
HND-015599,2011,170100088,,,,4,6,10
HND-015600,2011,170100089,,,,8,4,12
,2011,170100103,,,,10,19,29
HND-015630,2011,170100139,,,,9,11,20
HND-015634,2011,170100148,,,,3,3,6
HND-015641,2011,170100180,,,,6,2,8
HND-015645,2011,170100214,,,,14,7,21
HND-015519,2011,170100002,,,,2,2,4
HND-015521,2011,170100005,,,,11,1,12
HND-015522,2011,170100006,,,,6,9,15
HND-015528,2011,170100012,,,,4,5,9
HND-015531,2011,170100015,,,,14,8,22
HND-015532,2011,170100016,,,,30,19,49
HND-015536,2011,170100020,,,,0,2,2
HND-015537,2011,170100021,,,,5,4,9
HND-015538,2011,170100022,,,,2,3,5
,2011,170100023,,,,12,12,24
HND-015540,2011,170100024,,,,4,2,6
HND-015544,2011,170100031,,,,7,7,14
HND-015546,2011,170100033,,,,0,1,1
HND-015549,2011,170100036,,,,1,2,3
HND-015550,2011,170100037,,,,7,5,12
HND-015553,2011,170100040,,,,4,3,7
HND-015554,2011,170100041,,,,15,17,32
HND-015556,2011,170100043,,,,4,4,8
HND-015557,2011,170100044,,,,13,8,21
HND-015559,2011,170100046,,,,3,6,9
HND-015560,2011,170100047,,,,5,3,8
HND-015561,2011,170100048,,,,17,14,31
HND-015563,2011,170100050,,,,2,2,4
HND-015564,2011,170100051,,,,7,5,12
,2011,170100053,,,,4,2,6
HND-015567,2011,170100054,,,,7,5,12
HND-015569,2011,170100056,,,,2,3,5
HND-015570,2011,170100057,,,,2,6,8
HND-015571,2011,170100058,,,,6,3,9
HND-015576,2011,170100063,,,,1,2,3
HND-015579,2011,170100066,,,,3,3,6
HND-015580,2011,170100067,,,,7,5,12
HND-015582,2011,170100069,,,,1,4,5
,2011,170100070,,,,2,7,9
HND-015585,2011,170100073,,,,12,6,18
HND-015586,2011,170100074,,,,2,4,6
HND-015588,2011,170100076,,,,2,2,4
HND-015593,2011,170100081,,,,10,9,19
HND-015595,2011,170100083,,,,4,6,10
HND-015597,2011,170100085,,,,26,38,64
HND-015635,2011,170100152,,,,2,4,6
HND-015638,2011,170100165,,,,13,8,21
HND-015639,2011,170100174,,,,0,2,2
HND-015518,2011,170100001,,,,6,0,6
HND-015522,2011,170100006,,,,10,10,20
HND-015523,2011,170100007,,,,8,11,19
HND-015527,2011,170100011,,,,7,6,13
HND-015529,2011,170100013,,,,2,0,2
HND-015532,2011,170100016,,,,24,23,47
HND-015533,2011,170100017,,,,42,40,82
HND-015535,2011,170100019,,,,52,30,82
HND-015536,2011,170100020,,,,0,1,1
HND-015538,2011,170100022,,,,5,6,11
HND-015540,2011,170100024,,,,4,12,16
HND-015541,2011,170100025,,,,2,3,5
HND-015543,2011,170100029,,,,7,4,11
HND-015544,2011,170100031,,,,5,4,9
HND-015545,2011,170100032,,,,1,3,4
HND-015547,2011,170100034,,,,5,3,8
HND-015548,2011,170100035,,,,14,5,19
HND-015551,2011,170100038,,,,5,1,6
HND-015552,2011,170100039,,,,14,18,32
HND-015553,2011,170100040,,,,5,3,8
HND-015555,2011,170100042,,,,2,4,6
HND-015557,2011,170100044,,,,9,13,22
HND-015558,2011,170100045,,,,3,7,10
HND-015561,2011,170100048,,,,16,16,32
HND-015562,2011,170100049,,,,10,0,10
HND-015563,2011,170100050,,,,2,1,3
HND-015565,2011,170100052,,,,13,6,19
HND-015567,2011,170100054,,,,7,5,12
HND-015568,2011,170100055,,,,2,4,6
HND-015571,2011,170100058,,,,4,2,6
HND-015572,2011,170100059,,,,10,4,14
HND-015573,2011,170100060,,,,8,4,12
HND-015576,2011,170100063,,,,2,3,5
HND-015577,2011,170100064,,,,5,3,8
HND-015579,2011,170100066,,,,1,3,4
HND-015580,2011,170100067,,,,5,11,16
HND-015581,2011,170100068,,,,3,5,8
,2011,170100070,,,,0,1,1
HND-015583,2011,170100071,,,,13,10,23
HND-015584,2011,170100072,,,,5,3,8
HND-015586,2011,170100074,,,,4,6,10
HND-015587,2011,170100075,,,,3,4,7
HND-015589,2011,170100077,,,,35,36,71
HND-015590,2011,170100078,,,,4,7,11
HND-015591,2011,170100079,,,,1,2,3
HND-015592,2011,170100080,,,,4,5,9
HND-015593,2011,170100081,,,,10,8,18
HND-015594,2011,170100082,,,,7,5,12
HND-015596,2011,170100084,,,,7,2,9
HND-015598,2011,170100086,,,,9,13,22
HND-015600,2011,170100089,,,,7,6,13
HND-015630,2011,170100139,,,,10,7,17
HND-015634,2011,170100148,,,,4,8,12
HND-015635,2011,170100152,,,,6,5,11
HND-015519,2011,170100002,,,,4,4,8
,2011,170100004,,,,3,5,8
HND-015521,2011,170100005,,,,4,3,7
HND-015524,2011,170100008,,,,4,2,6
HND-015525,2011,170100009,,,,2,4,6
HND-015526,2011,170100010,,,,2,4,6
HND-015528,2011,170100012,,,,1,1,2
HND-015530,2011,170100014,,,,1,1,2
HND-015531,2011,170100015,,,,13,10,23
HND-015534,2011,170100018,,,,4,8,12
HND-015537,2011,170100021,,,,3,0,3
,2011,170100023,,,,15,14,29
HND-015542,2011,170100026,,,,9,8,17
HND-015546,2011,170100033,,,,2,2,4
HND-015549,2011,170100036,,,,0,2,2
HND-015550,2011,170100037,,,,10,4,14
HND-015554,2011,170100041,,,,21,16,37
HND-015556,2011,170100043,,,,5,2,7
HND-015559,2011,170100046,,,,5,1,6
HND-015560,2011,170100047,,,,4,12,16
HND-015564,2011,170100051,,,,3,4,7
,2011,170100053,,,,2,2,4
HND-015569,2011,170100056,,,,2,0,2
HND-015570,2011,170100057,,,,5,3,8
HND-015574,2011,170100061,,,,14,12,26
HND-015575,2011,170100062,,,,6,12,18
HND-015578,2011,170100065,,,,0,1,1
HND-015582,2011,170100069,,,,1,2,3
HND-015585,2011,170100073,,,,6,2,8
HND-015588,2011,170100076,,,,4,3,7
HND-015595,2011,170100083,,,,6,6,12
HND-015597,2011,170100085,,,,45,62,107
HND-015599,2011,170100088,,,,5,2,7
,2011,170100103,,,,15,7,22
HND-015638,2011,170100165,,,,6,9,15
HND-015639,2011,170100174,,,,1,3,4
HND-015641,2011,170100180,,,,6,3,9
HND-015645,2011,170100214,,,,9,7,16
HND-015518,2011,170100001,,,,5,4,9
HND-015519,2011,170100002,,,,4,3,7
,2011,170100004,,,,7,7,14
HND-015523,2011,170100007,,,,6,7,13
HND-015524,2011,170100008,,,,5,3,8
HND-015526,2011,170100010,,,,3,2,5
HND-015527,2011,170100011,,,,4,3,7
HND-015528,2011,170100012,,,,0,3,3
HND-015530,2011,170100014,,,,2,1,3
HND-015533,2011,170100017,,,,33,41,74
HND-015534,2011,170100018,,,,6,6,12
HND-015535,2011,170100019,,,,48,42,90
,2011,170100023,,,,17,12,29
HND-015542,2011,170100026,,,,13,7,20
HND-015543,2011,170100029,,,,8,7,15
HND-015545,2011,170100032,,,,0,2,2
HND-015548,2011,170100035,,,,6,6,12
HND-015552,2011,170100039,,,,16,19,35
HND-015556,2011,170100043,,,,3,3,6
HND-015558,2011,170100045,,,,6,11,17
HND-015559,2011,170100046,,,,0,3,3
HND-015562,2011,170100049,,,,3,3,6
,2011,170100053,,,,1,3,4
HND-015568,2011,170100055,,,,1,1,2
HND-015569,2011,170100056,,,,1,2,3
HND-015572,2011,170100059,,,,2,4,6
HND-015573,2011,170100060,,,,6,5,11
HND-015574,2011,170100061,,,,12,11,23
HND-015575,2011,170100062,,,,3,5,8
HND-015577,2011,170100064,,,,4,6,10
HND-015578,2011,170100065,,,,2,0,2
HND-015581,2011,170100068,,,,3,5,8
HND-015583,2011,170100071,,,,9,13,22
HND-015587,2011,170100075,,,,10,5,15
HND-015588,2011,170100076,,,,2,0,2
HND-015591,2011,170100079,,,,2,0,2
HND-015594,2011,170100082,,,,4,4,8
HND-015599,2011,170100088,,,,9,2,11
HND-015600,2011,170100089,,,,6,7,13
,2011,170100103,,,,6,6,12
HND-015630,2011,170100139,,,,12,10,22
HND-015634,2011,170100148,,,,4,6,10
HND-015641,2011,170100180,,,,5,4,9
HND-015645,2011,170100214,,,,8,8,16
HND-015521,2011,170100005,,,,3,6,9
HND-015522,2011,170100006,,,,11,10,21
HND-015525,2011,170100009,,,,2,3,5
HND-015531,2011,170100015,,,,14,13,27
HND-015532,2011,170100016,,,,18,18,36
HND-015536,2011,170100020,,,,1,0,1
HND-015537,2011,170100021,,,,8,1,9
HND-015538,2011,170100022,,,,2,1,3
HND-015540,2011,170100024,,,,6,5,11
HND-015541,2011,170100025,,,,2,2,4
HND-015544,2011,170100031,,,,8,8,16
HND-015546,2011,170100033,,,,3,1,4
HND-015547,2011,170100034,,,,2,1,3
HND-015549,2011,170100036,,,,1,7,8
HND-015550,2011,170100037,,,,10,1,11
HND-015551,2011,170100038,,,,8,7,15
HND-015553,2011,170100040,,,,1,4,5
HND-015554,2011,170100041,,,,19,27,46
HND-015555,2011,170100042,,,,3,3,6
HND-015557,2011,170100044,,,,9,19,28
HND-015560,2011,170100047,,,,3,5,8
HND-015561,2011,170100048,,,,10,13,23
HND-015564,2011,170100051,,,,2,9,11
HND-015565,2011,170100052,,,,10,11,21
HND-015567,2011,170100054,,,,8,4,12
HND-015570,2011,170100057,,,,7,3,10
HND-015571,2011,170100058,,,,11,6,17
HND-015576,2011,170100063,,,,2,3,5
HND-015579,2011,170100066,,,,2,2,4
HND-015580,2011,170100067,,,,9,6,15
HND-015582,2011,170100069,,,,5,0,5
,2011,170100070,,,,8,3,11
HND-015584,2011,170100072,,,,6,1,7
HND-015585,2011,170100073,,,,4,14,18
HND-015586,2011,170100074,,,,2,0,2
HND-015589,2011,170100077,,,,40,25,65
HND-015590,2011,170100078,,,,1,2,3
HND-015592,2011,170100080,,,,0,2,2
HND-015593,2011,170100081,,,,5,7,12
HND-015595,2011,170100083,,,,4,7,11
HND-015596,2011,170100084,,,,8,1,9
HND-015597,2011,170100085,,,,37,54,91
HND-015598,2011,170100086,,,,14,9,23
HND-015635,2011,170100152,,,,5,2,7
HND-015638,2011,170100165,,,,9,12,21
HND-015639,2011,170100174,,,,3,3,6
HND-015518,2011,170100001,,,,3,7,10
HND-015519,2011,170100002,,,,1,5,6
,2011,170100004,,,,4,3,7
HND-015521,2011,170100005,,,,5,11,16
HND-015524,2011,170100008,,,,1,4,5
HND-015526,2011,170100010,,,,5,2,7
HND-015527,2011,170100011,,,,6,10,16
HND-015528,2011,170100012,,,,3,0,3
HND-015530,2011,170100014,,,,3,1,4
HND-015531,2011,170100015,,,,11,18,29
HND-015534,2011,170100018,,,,3,11,14
HND-015537,2011,170100021,,,,2,3,5
,2011,170100023,,,,16,17,33
HND-015542,2011,170100026,,,,11,6,17
HND-015543,2011,170100029,,,,4,5,9
HND-015548,2011,170100035,,,,7,5,12
HND-015549,2011,170100036,,,,0,2,2
HND-015552,2011,170100039,,,,16,11,27
HND-015556,2011,170100043,,,,3,4,7
HND-015559,2011,170100046,,,,2,1,3
HND-015560,2011,170100047,,,,4,2,6
HND-015562,2011,170100049,,,,4,6,10
,2011,170100053,,,,3,6,9
HND-015569,2011,170100056,,,,3,4,7
HND-015570,2011,170100057,,,,3,6,9
HND-015572,2011,170100059,,,,11,5,16
HND-015573,2011,170100060,,,,2,3,5
HND-015574,2011,170100061,,,,18,15,33
HND-015575,2011,170100062,,,,2,5,7
HND-015578,2011,170100065,,,,3,0,3
HND-015581,2011,170100068,,,,3,7,10
HND-015582,2011,170100069,,,,8,0,8
HND-015585,2011,170100073,,,,8,10,18
HND-015587,2011,170100075,,,,3,5,8
HND-015588,2011,170100076,,,,1,2,3
HND-015591,2011,170100079,,,,5,0,5
HND-015597,2011,170100085,,,,49,42,91
HND-015599,2011,170100088,,,,4,9,13
HND-015600,2011,170100089,,,,6,6,12
HND-015634,2011,170100148,,,,8,7,15
HND-015639,2011,170100174,,,,4,5,9
HND-015641,2011,170100180,,,,4,4,8
HND-015645,2011,170100214,,,,9,10,19
HND-015522,2011,170100006,,,,13,5,18
HND-015523,2011,170100007,,,,10,11,21
HND-015525,2011,170100009,,,,1,1,2
HND-015532,2011,170100016,,,,19,18,37
HND-015533,2011,170100017,,,,39,29,68
HND-015535,2011,170100019,,,,43,44,87
HND-015536,2011,170100020,,,,3,1,4
HND-015538,2011,170100022,,,,7,2,9
HND-015540,2011,170100024,,,,5,3,8
HND-015541,2011,170100025,,,,0,2,2
HND-015544,2011,170100031,,,,10,4,14
HND-015545,2011,170100032,,,,4,2,6
HND-015547,2011,170100034,,,,3,4,7
HND-015550,2011,170100037,,,,8,8,16
HND-015551,2011,170100038,,,,8,4,12
HND-015553,2011,170100040,,,,5,4,9
HND-015554,2011,170100041,,,,14,17,31
HND-015555,2011,170100042,,,,4,2,6
HND-015557,2011,170100044,,,,7,12,19
HND-015558,2011,170100045,,,,7,9,16
HND-015561,2011,170100048,,,,9,15,24
HND-015563,2011,170100050,,,,4,2,6
HND-015564,2011,170100051,,,,13,8,21
HND-015565,2011,170100052,,,,8,8,16
HND-015567,2011,170100054,,,,9,4,13
HND-015568,2011,170100055,,,,5,1,6
HND-015571,2011,170100058,,,,3,7,10
HND-015576,2011,170100063,,,,2,1,3
HND-015577,2011,170100064,,,,1,4,5
HND-015579,2011,170100066,,,,3,2,5
HND-015580,2011,170100067,,,,6,10,16
,2011,170100070,,,,9,1,10
HND-015583,2011,170100071,,,,11,11,22
HND-015584,2011,170100072,,,,0,3,3
HND-015586,2011,170100074,,,,4,2,6
HND-015589,2011,170100077,,,,49,36,85
HND-015590,2011,170100078,,,,4,4,8
HND-015592,2011,170100080,,,,2,2,4
HND-015593,2011,170100081,,,,7,8,15
HND-015594,2011,170100082,,,,6,3,9
HND-015595,2011,170100083,,,,5,7,12
HND-015596,2011,170100084,,,,6,8,14
HND-015598,2011,170100086,,,,10,12,22
,2011,170100103,,,,11,15,26
HND-015630,2011,170100139,,,,14,12,26
HND-015635,2011,170100152,,,,2,7,9
HND-015638,2011,170100165,,,,11,11,22
HND-015519,2011,170100002,,,,2,2,4
HND-015521,2011,170100005,,,,11,6,17
HND-015522,2011,170100006,,,,11,15,26
HND-015525,2011,170100009,,,,2,1,3
HND-015528,2011,170100012,,,,3,2,5
HND-015531,2011,170100015,,,,8,15,23
HND-015532,2011,170100016,,,,23,26,49
HND-015537,2011,170100021,,,,3,2,5
HND-015538,2011,170100022,,,,2,4,6
,2011,170100023,,,,10,9,19
HND-015540,2011,170100024,,,,2,6,8
HND-015544,2011,170100031,,,,10,11,21
HND-015546,2011,170100033,,,,3,1,4
HND-015549,2011,170100036,,,,6,3,9
HND-015550,2011,170100037,,,,6,4,10
HND-015553,2011,170100040,,,,6,3,9
HND-015554,2011,170100041,,,,20,15,35
HND-015556,2011,170100043,,,,3,4,7
HND-015557,2011,170100044,,,,14,19,33
HND-015559,2011,170100046,,,,6,3,9
HND-015560,2011,170100047,,,,9,8,17
HND-015561,2011,170100048,,,,18,12,30
HND-015564,2011,170100051,,,,10,14,24
,2011,170100053,,,,4,2,6
HND-015567,2011,170100054,,,,3,4,7
HND-015569,2011,170100056,,,,2,1,3
HND-015570,2011,170100057,,,,3,6,9
HND-015571,2011,170100058,,,,8,5,13
HND-015579,2011,170100066,,,,2,1,3
HND-015580,2011,170100067,,,,5,1,6
HND-015582,2011,170100069,,,,3,5,8
,2011,170100070,,,,4,6,10
HND-015585,2011,170100073,,,,15,8,23
HND-015586,2011,170100074,,,,2,4,6
HND-015588,2011,170100076,,,,2,0,2
HND-015593,2011,170100081,,,,4,5,9
HND-015595,2011,170100083,,,,3,8,11
HND-015597,2011,170100085,,,,41,50,91
,2011,170100103,,,,4,5,9
HND-015635,2011,170100152,,,,5,3,8
HND-015639,2011,170100174,,,,7,1,8
HND-015518,2011,170100001,,,,2,4,6
,2011,170100004,,,,4,7,11
HND-015523,2011,170100007,,,,8,11,19
HND-015524,2011,170100008,,,,1,5,6
HND-015526,2011,170100010,,,,3,7,10
HND-015527,2011,170100011,,,,2,6,8
HND-015529,2011,170100013,,,,2,1,3
HND-015530,2011,170100014,,,,1,1,2
HND-015533,2011,170100017,,,,43,45,88
HND-015534,2011,170100018,,,,11,8,19
HND-015535,2011,170100019,,,,34,41,75
HND-015541,2011,170100025,,,,2,1,3
HND-015542,2011,170100026,,,,2,10,12
HND-015543,2011,170100029,,,,4,6,10
HND-015545,2011,170100032,,,,2,1,3
HND-015547,2011,170100034,,,,2,5,7
HND-015548,2011,170100035,,,,8,6,14
HND-015551,2011,170100038,,,,6,5,11
HND-015552,2011,170100039,,,,14,14,28
HND-015555,2011,170100042,,,,4,5,9
HND-015558,2011,170100045,,,,8,5,13
HND-015562,2011,170100049,,,,8,5,13
HND-015565,2011,170100052,,,,7,12,19
HND-015572,2011,170100059,,,,3,3,6
HND-015573,2011,170100060,,,,2,2,4
HND-015574,2011,170100061,,,,14,20,34
HND-015575,2011,170100062,,,,3,5,8
HND-015577,2011,170100064,,,,3,2,5
HND-015578,2011,170100065,,,,2,0,2
HND-015581,2011,170100068,,,,0,4,4
HND-015583,2011,170100071,,,,14,17,31
HND-015584,2011,170100072,,,,2,3,5
HND-015587,2011,170100075,,,,7,6,13
HND-015589,2011,170100077,,,,63,59,122
HND-015590,2011,170100078,,,,4,3,7
HND-015591,2011,170100079,,,,2,2,4
HND-015592,2011,170100080,,,,4,0,4
HND-015594,2011,170100082,,,,5,8,13
HND-015596,2011,170100084,,,,1,3,4
HND-015598,2011,170100086,,,,15,5,20
HND-015599,2011,170100088,,,,4,7,11
HND-015600,2011,170100089,,,,6,8,14
HND-015630,2011,170100139,,,,5,10,15
HND-015634,2011,170100148,,,,10,5,15
HND-015638,2011,170100165,,,,16,13,29
HND-015641,2011,170100180,,,,2,7,9
HND-015645,2011,170100214,,,,4,8,12
HND-015526,2011,170100010,,,,20,10,30
,2011,170100030,,,,42,37,79
HND-015561,2011,170100048,,,,15,17,32
HND-015564,2011,170100051,,,,7,14,21
HND-015565,2011,170100052,,,,9,13,22
HND-015567,2011,170100054,,,,13,14,27
HND-015625,2011,170100130,,,,212,187,399
,2011,170100153,,,,8,3,11
,2011,170100176,,,,28,15,43
HND-015522,2011,170100006,,,,9,11,20
HND-015532,2011,170100016,,,,13,14,27
HND-015552,2011,170100039,,,,21,27,48
HND-015554,2011,170100041,,,,18,23,41
HND-015560,2011,170100047,,,,13,12,25
HND-015600,2011,170100089,,,,14,25,39
,2011,170100131,,,,2,0,2
HND-015627,2011,170100133,,,,60,41,101
HND-015630,2011,170100139,,,,13,27,40
HND-015526,2011,170100010,,,,7,6,13
,2011,170100030,,,,43,43,86
HND-015552,2011,170100039,,,,17,15,32
HND-015565,2011,170100052,,,,16,21,37
HND-015600,2011,170100089,,,,6,9,15
,2011,170100131,,,,0,1,1
HND-015630,2011,170100139,,,,11,16,27
,2011,170100153,,,,6,4,10
HND-015522,2011,170100006,,,,14,9,23
HND-015532,2011,170100016,,,,15,15,30
HND-015554,2011,170100041,,,,19,28,47
HND-015560,2011,170100047,,,,16,10,26
HND-015561,2011,170100048,,,,20,14,34
HND-015564,2011,170100051,,,,6,9,15
HND-015567,2011,170100054,,,,11,14,25
HND-015625,2011,170100130,,,,125,151,276
HND-015627,2011,170100133,,,,45,48,93
,2011,170100176,,,,11,26,37
HND-015526,2011,170100010,,,,4,9,13
,2011,170100030,,,,24,43,67
HND-015552,2011,170100039,,,,12,21,33
HND-015600,2011,170100089,,,,10,4,14
,2011,170100131,,,,2,1,3
HND-015627,2011,170100133,,,,35,47,82
HND-015630,2011,170100139,,,,20,20,40
,2011,170100176,,,,22,23,45
HND-015522,2011,170100006,,,,7,9,16
HND-015532,2011,170100016,,,,16,9,25
HND-015554,2011,170100041,,,,29,15,44
HND-015560,2011,170100047,,,,13,13,26
HND-015561,2011,170100048,,,,11,9,20
HND-015564,2011,170100051,,,,4,11,15
HND-015565,2011,170100052,,,,20,10,30
HND-015567,2011,170100054,,,,10,9,19
HND-015625,2011,170100130,,,,159,172,331
,2011,170100153,,,,2,2,4
,2011,170100030,,,,32,35,67
HND-015625,2011,170100130,,,,185,269,454
HND-015627,2011,170100133,,,,37,32,69
,2011,170100176,,,,16,24,40
,2011,170100131,,,,2,4,6
HND-015626,2011,170100132,,,,128,17,145
,2011,170100153,,,,7,23,30
,2011,170100030,,,,40,24,64
HND-015625,2011,170100130,,,,164,151,315
,2011,170100131,,,,6,9,15
HND-015626,2011,170100132,,,,112,3,115
,2011,170100153,,,,7,14,21
HND-015627,2011,170100133,,,,16,27,43
,2011,170100176,,,,17,19,36
HND-015627,2011,170100133,,,,30,35,65
,2011,170100030,,,,23,45,68
HND-015625,2011,170100130,,,,91,141,232
,2011,170100131,,,,4,9,13
HND-015626,2011,170100132,,,,82,4,86
,2011,170100153,,,,2,11,13
,2011,170200250,,,,7,4,11
HND-015690,2011,170200251,,,,6,5,11
HND-015691,2011,170200252,,,,3,2,5
,2011,170200254,,,,9,7,16
HND-015677,2011,170200013,,,,2,3,5
,2011,170200249,,,,4,1,5
,2011,170200253,,,,3,4,7
HND-015682,2011,170200018,,,,3,3,6
HND-015680,2011,170200016,,,,2,1,3
HND-015681,2011,170200017,,,,1,0,1
HND-015683,2011,170200019,,,,4,3,7
HND-015684,2011,170200020,,,,2,4,6
HND-015685,2011,170200021,,,,0,4,4
HND-015687,2011,170200023,,,,3,0,3
HND-015688,2011,170200024,,,,1,3,4
HND-015681,2011,170200017,,,,4,3,7
HND-015682,2011,170200018,,,,7,7,14
HND-015684,2011,170200020,,,,3,13,16
HND-015688,2011,170200024,,,,3,1,4
HND-015679,2011,170200015,,,,0,3,3
HND-015680,2011,170200016,,,,6,4,10
HND-015683,2011,170200019,,,,6,14,20
HND-015685,2011,170200021,,,,3,2,5
HND-015687,2011,170200023,,,,3,1,4
HND-015679,2011,170200015,,,,5,1,6
HND-015680,2011,170200016,,,,7,10,17
HND-015681,2011,170200017,,,,0,8,8
HND-015683,2011,170200019,,,,5,9,14
HND-015685,2011,170200021,,,,1,4,5
HND-015687,2011,170200023,,,,3,3,6
HND-015684,2011,170200020,,,,7,8,15
HND-015666,2011,170200001,,,,1,3,4
HND-015667,2011,170200002,,,,7,7,14
HND-015668,2011,170200003,,,,0,2,2
HND-015669,2011,170200004,,,,4,1,5
HND-015671,2011,170200006,,,,0,2,2
HND-015672,2011,170200007,,,,6,12,18
HND-015675,2011,170200010,,,,16,14,30
HND-015677,2011,170200013,,,,0,2,2
HND-015678,2011,170200014,,,,1,2,3
HND-015670,2011,170200005,,,,24,21,45
HND-015673,2011,170200008,,,,11,10,21
HND-015674,2011,170200009,,,,3,3,6
HND-015689,2011,170200026,,,,4,1,5
HND-015667,2011,170200002,,,,4,9,13
HND-015668,2011,170200003,,,,3,0,3
HND-015670,2011,170200005,,,,25,15,40
HND-015671,2011,170200006,,,,5,3,8
HND-015674,2011,170200009,,,,1,3,4
HND-015677,2011,170200013,,,,1,2,3
HND-015689,2011,170200026,,,,7,8,15
HND-015666,2011,170200001,,,,1,1,2
HND-015669,2011,170200004,,,,3,1,4
HND-015672,2011,170200007,,,,9,4,13
HND-015673,2011,170200008,,,,9,10,19
HND-015675,2011,170200010,,,,9,7,16
HND-015676,2011,170200012,,,,0,2,2
HND-015678,2011,170200014,,,,1,0,1
HND-015667,2011,170200002,,,,6,6,12
HND-015670,2011,170200005,,,,19,17,36
HND-015673,2011,170200008,,,,6,11,17
HND-015674,2011,170200009,,,,1,0,1
HND-015676,2011,170200012,,,,4,1,5
HND-015689,2011,170200026,,,,8,6,14
HND-015666,2011,170200001,,,,0,1,1
HND-015668,2011,170200003,,,,3,2,5
HND-015669,2011,170200004,,,,8,1,9
HND-015671,2011,170200006,,,,1,2,3
HND-015672,2011,170200007,,,,10,9,19
HND-015675,2011,170200010,,,,15,15,30
HND-015677,2011,170200013,,,,1,3,4
HND-015667,2011,170200002,,,,4,10,14
HND-015668,2011,170200003,,,,2,3,5
HND-015671,2011,170200006,,,,8,3,11
HND-015672,2011,170200007,,,,9,7,16
HND-015674,2011,170200009,,,,2,1,3
HND-015677,2011,170200013,,,,2,2,4
HND-015689,2011,170200026,,,,6,3,9
HND-015666,2011,170200001,,,,1,0,1
HND-015669,2011,170200004,,,,8,4,12
HND-015670,2011,170200005,,,,15,14,29
HND-015673,2011,170200008,,,,15,5,20
HND-015675,2011,170200010,,,,7,14,21
HND-015678,2011,170200014,,,,1,0,1
HND-015667,2011,170200002,,,,11,10,21
HND-015671,2011,170200006,,,,4,2,6
HND-015672,2011,170200007,,,,13,8,21
HND-015677,2011,170200013,,,,2,1,3
HND-015669,2011,170200004,,,,3,4,7
HND-015670,2011,170200005,,,,15,24,39
HND-015673,2011,170200008,,,,14,8,22
HND-015674,2011,170200009,,,,3,2,5
HND-015675,2011,170200010,,,,12,22,34
HND-015676,2011,170200012,,,,0,1,1
HND-015689,2011,170200026,,,,6,8,14
HND-015669,2011,170200004,,,,5,7,12
HND-015672,2011,170200007,,,,7,6,13
HND-015673,2011,170200008,,,,9,12,21
HND-015675,2011,170200010,,,,14,11,25
HND-015676,2011,170200012,,,,2,0,2
HND-015678,2011,170200014,,,,1,2,3
HND-015667,2011,170200002,,,,4,11,15
HND-015668,2011,170200003,,,,1,2,3
HND-015670,2011,170200005,,,,28,33,61
HND-015671,2011,170200006,,,,4,3,7
HND-015674,2011,170200009,,,,4,3,7
HND-015677,2011,170200013,,,,1,1,2
HND-015689,2011,170200026,,,,8,6,14
HND-015675,2011,170200010,,,,21,21,42
HND-015686,2011,170200022,,,,65,55,120
HND-015670,2011,170200005,,,,14,24,38
HND-015670,2011,170200005,,,,9,11,20
HND-015675,2011,170200010,,,,27,20,47
HND-015686,2011,170200022,,,,44,53,97
HND-015670,2011,170200005,,,,13,15,28
HND-015675,2011,170200010,,,,12,12,24
HND-015686,2011,170200022,,,,41,49,90
HND-015686,2011,170200022,,,,43,24,67
HND-015686,2011,170200022,,,,31,37,68
HND-015686,2011,170200022,,,,26,34,60
HND-015724,2011,170300042,,,,6,3,9
HND-015725,2011,170300043,,,,8,5,13
HND-015726,2011,170300044,,,,9,6,15
,2011,170300052,,,,3,5,8
HND-015728,2011,170300054,,,,4,8,12
,2011,170300055,,,,7,6,13
,2011,170300066,,,,3,2,5
HND-015732,2011,170300069,,,,4,10,14
HND-015717,2011,170300030,,,,2,9,11
HND-015727,2011,170300045,,,,3,6,9
,2011,170300053,,,,6,9,15
HND-015729,2011,170300056,,,,8,11,19
,2011,170300063,,,,4,6,10
,2011,170300064,,,,2,1,3
,2011,170300065,,,,3,4,7
,2011,170300067,,,,5,6,11
HND-015731,2011,170300068,,,,6,8,14
HND-015713,2011,170300023,,,,4,4,8
HND-015720,2011,170300034,,,,8,8,16
HND-015721,2011,170300035,,,,5,4,9
HND-015722,2011,170300038,,,,5,4,9
HND-015707,2011,170300017,,,,6,3,9
HND-015712,2011,170300022,,,,17,16,33
HND-015714,2011,170300024,,,,8,12,20
HND-015715,2011,170300025,,,,2,7,9
,2011,170300033,,,,9,3,12
HND-015713,2011,170300023,,,,6,6,12
HND-015707,2011,170300017,,,,4,3,7
HND-015712,2011,170300022,,,,9,11,20
HND-015714,2011,170300024,,,,13,9,22
HND-015715,2011,170300025,,,,10,8,18
HND-015720,2011,170300034,,,,6,6,12
HND-015721,2011,170300035,,,,10,5,15
HND-015722,2011,170300038,,,,0,4,4
HND-015692,2011,170300001,,,,21,15,36
HND-015693,2011,170300002,,,,3,1,4
HND-015696,2011,170300005,,,,3,4,7
HND-015697,2011,170300006,,,,7,5,12
HND-015700,2011,170300009,,,,6,10,16
HND-015701,2011,170300010,,,,7,5,12
HND-015702,2011,170300011,,,,2,3,5
HND-015704,2011,170300014,,,,10,6,16
HND-015705,2011,170300015,,,,4,5,9
HND-015708,2011,170300018,,,,6,6,12
HND-015722,2011,170300038,,,,3,1,4
HND-015723,2011,170300041,,,,2,3,5
HND-015694,2011,170300003,,,,8,2,10
HND-015695,2011,170300004,,,,6,4,10
HND-015698,2011,170300007,,,,5,3,8
HND-015699,2011,170300008,,,,7,12,19
,2011,170300012,,,,16,11,27
,2011,170300013,,,,3,4,7
HND-015706,2011,170300016,,,,18,18,36
HND-015707,2011,170300017,,,,12,13,25
HND-015709,2011,170300019,,,,8,6,14
HND-015710,2011,170300020,,,,3,3,6
HND-015711,2011,170300021,,,,2,5,7
HND-015730,2011,170300058,,,,6,4,10
HND-015694,2011,170300003,,,,5,5,10
HND-015697,2011,170300006,,,,6,5,11
HND-015698,2011,170300007,,,,5,4,9
HND-015700,2011,170300009,,,,7,4,11
HND-015701,2011,170300010,,,,10,15,25
HND-015704,2011,170300014,,,,10,11,21
HND-015705,2011,170300015,,,,5,4,9
HND-015708,2011,170300018,,,,6,5,11
HND-015709,2011,170300019,,,,9,5,14
HND-015711,2011,170300021,,,,4,1,5
HND-015730,2011,170300058,,,,6,2,8
HND-015692,2011,170300001,,,,14,14,28
HND-015693,2011,170300002,,,,5,4,9
HND-015695,2011,170300004,,,,4,2,6
HND-015696,2011,170300005,,,,5,4,9
HND-015699,2011,170300008,,,,10,7,17
HND-015702,2011,170300011,,,,5,4,9
,2011,170300012,,,,5,14,19
,2011,170300013,,,,3,4,7
HND-015706,2011,170300016,,,,8,13,21
HND-015707,2011,170300017,,,,22,11,33
HND-015710,2011,170300020,,,,5,3,8
HND-015722,2011,170300038,,,,2,3,5
HND-015723,2011,170300041,,,,3,1,4
HND-015692,2011,170300001,,,,16,18,34
HND-015696,2011,170300005,,,,3,5,8
HND-015697,2011,170300006,,,,8,2,10
HND-015700,2011,170300009,,,,4,6,10
HND-015701,2011,170300010,,,,15,10,25
HND-015702,2011,170300011,,,,1,2,3
HND-015704,2011,170300014,,,,8,11,19
HND-015705,2011,170300015,,,,3,8,11
HND-015708,2011,170300018,,,,7,6,13
HND-015730,2011,170300058,,,,8,7,15
HND-015693,2011,170300002,,,,2,2,4
HND-015694,2011,170300003,,,,12,8,20
HND-015695,2011,170300004,,,,7,7,14
HND-015698,2011,170300007,,,,4,5,9
HND-015699,2011,170300008,,,,9,9,18
,2011,170300012,,,,19,8,27
,2011,170300013,,,,4,3,7
HND-015706,2011,170300016,,,,9,18,27
HND-015707,2011,170300017,,,,12,16,28
HND-015709,2011,170300019,,,,5,3,8
HND-015710,2011,170300020,,,,5,3,8
HND-015711,2011,170300021,,,,3,10,13
HND-015722,2011,170300038,,,,1,2,3
HND-015723,2011,170300041,,,,2,2,4
HND-015694,2011,170300003,,,,13,6,19
HND-015697,2011,170300006,,,,3,2,5
HND-015698,2011,170300007,,,,5,2,7
,2011,170300012,,,,7,10,17
HND-015705,2011,170300015,,,,2,1,3
HND-015709,2011,170300019,,,,4,3,7
HND-015711,2011,170300021,,,,4,4,8
HND-015692,2011,170300001,,,,15,16,31
HND-015693,2011,170300002,,,,3,5,8
HND-015695,2011,170300004,,,,3,7,10
HND-015696,2011,170300005,,,,8,2,10
HND-015699,2011,170300008,,,,9,9,18
HND-015700,2011,170300009,,,,11,4,15
HND-015701,2011,170300010,,,,6,5,11
HND-015702,2011,170300011,,,,5,2,7
,2011,170300013,,,,2,4,6
HND-015704,2011,170300014,,,,11,9,20
HND-015706,2011,170300016,,,,7,14,21
HND-015707,2011,170300017,,,,9,15,24
HND-015708,2011,170300018,,,,7,4,11
HND-015710,2011,170300020,,,,5,3,8
HND-015722,2011,170300038,,,,2,3,5
HND-015723,2011,170300041,,,,0,2,2
HND-015730,2011,170300058,,,,3,4,7
HND-015694,2011,170300003,,,,9,8,17
HND-015695,2011,170300004,,,,5,7,12
HND-015697,2011,170300006,,,,4,5,9
HND-015698,2011,170300007,,,,6,6,12
HND-015699,2011,170300008,,,,12,8,20
,2011,170300012,,,,13,11,24
,2011,170300013,,,,4,0,4
HND-015705,2011,170300015,,,,2,5,7
HND-015706,2011,170300016,,,,23,10,33
HND-015709,2011,170300019,,,,5,6,11
HND-015710,2011,170300020,,,,5,1,6
HND-015711,2011,170300021,,,,5,2,7
HND-015722,2011,170300038,,,,2,3,5
HND-015723,2011,170300041,,,,2,3,5
HND-015692,2011,170300001,,,,22,15,37
HND-015693,2011,170300002,,,,2,2,4
HND-015696,2011,170300005,,,,7,4,11
HND-015700,2011,170300009,,,,6,10,16
HND-015701,2011,170300010,,,,5,12,17
HND-015702,2011,170300011,,,,2,2,4
HND-015704,2011,170300014,,,,7,13,20
HND-015707,2011,170300017,,,,19,11,30
HND-015708,2011,170300018,,,,7,5,12
HND-015730,2011,170300058,,,,1,8,9
HND-015692,2011,170300001,,,,7,9,16
HND-015693,2011,170300002,,,,1,0,1
HND-015695,2011,170300004,,,,5,5,10
HND-015696,2011,170300005,,,,4,5,9
HND-015699,2011,170300008,,,,12,10,22
HND-015702,2011,170300011,,,,3,7,10
,2011,170300012,,,,8,8,16
,2011,170300013,,,,3,5,8
HND-015706,2011,170300016,,,,11,9,20
HND-015707,2011,170300017,,,,11,9,20
HND-015710,2011,170300020,,,,2,5,7
HND-015722,2011,170300038,,,,2,0,2
HND-015723,2011,170300041,,,,0,1,1
HND-015694,2011,170300003,,,,7,4,11
HND-015697,2011,170300006,,,,1,6,7
HND-015698,2011,170300007,,,,6,6,12
HND-015700,2011,170300009,,,,4,5,9
HND-015701,2011,170300010,,,,9,15,24
HND-015704,2011,170300014,,,,7,10,17
HND-015705,2011,170300015,,,,3,1,4
HND-015708,2011,170300018,,,,5,8,13
HND-015709,2011,170300019,,,,6,3,9
HND-015711,2011,170300021,,,,5,5,10
HND-015730,2011,170300058,,,,1,2,3
,2011,170300026,,,,54,52,106
HND-015718,2011,170300032,,,,7,6,13
HND-015701,2011,170300010,,,,11,12,23
HND-015701,2011,170300010,,,,5,14,19
,2011,170300026,,,,42,45,87
HND-015718,2011,170300032,,,,5,10,15
,2011,170300026,,,,37,69,106
HND-015718,2011,170300032,,,,7,8,15
HND-015701,2011,170300010,,,,6,19,25
,2011,170300026,,,,43,46,89
HND-015718,2011,170300032,,,,13,18,31
,2011,170300026,,,,31,44,75
HND-015718,2011,170300032,,,,4,12,16
,2011,170300026,,,,20,34,54
HND-015763,2011,170400048,,,,4,5,9
,2011,170400051,,,,4,7,11
,2011,170400054,,,,4,8,12
,2011,170400061,,,,7,4,11
,2011,170400063,,,,4,3,7
HND-015741,2011,170400009,,,,11,9,20
HND-015749,2011,170400017,,,,2,6,8
HND-015762,2011,170400034,,,,5,2,7
HND-015764,2011,170400053,,,,8,6,14
HND-015760,2011,170400028,,,,0,2,2
HND-015759,2011,170400027,,,,4,3,7
HND-015754,2011,170400022,,,,0,1,1
HND-015755,2011,170400023,,,,12,9,21
HND-015756,2011,170400024,,,,3,15,18
HND-015757,2011,170400025,,,,11,13,24
HND-015760,2011,170400028,,,,7,3,10
HND-015761,2011,170400029,,,,3,1,4
HND-015754,2011,170400022,,,,5,0,5
HND-015755,2011,170400023,,,,18,13,31
HND-015761,2011,170400029,,,,4,9,13
HND-015756,2011,170400024,,,,5,12,17
HND-015759,2011,170400027,,,,6,7,13
HND-015760,2011,170400028,,,,4,1,5
HND-015737,2011,170400005,,,,7,5,12
HND-015738,2011,170400006,,,,3,2,5
HND-015741,2011,170400009,,,,5,5,10
HND-015743,2011,170400011,,,,0,2,2
HND-015745,2011,170400013,,,,4,4,8
HND-015748,2011,170400016,,,,3,0,3
HND-015749,2011,170400017,,,,3,2,5
HND-015752,2011,170400020,,,,2,2,4
HND-015753,2011,170400021,,,,2,0,2
HND-015765,2011,170400055,,,,2,4,6
HND-015733,2011,170400001,,,,19,9,28
HND-015734,2011,170400002,,,,5,1,6
HND-015735,2011,170400003,,,,15,7,22
HND-015736,2011,170400004,,,,7,2,9
HND-015739,2011,170400007,,,,3,2,5
HND-015740,2011,170400008,,,,8,4,12
HND-015742,2011,170400010,,,,0,2,2
HND-015744,2011,170400012,,,,1,1,2
,2011,170400014,,,,1,0,1
HND-015750,2011,170400018,,,,6,2,8
HND-015751,2011,170400019,,,,1,4,5
HND-015754,2011,170400022,,,,4,6,10
HND-015734,2011,170400002,,,,4,3,7
HND-015736,2011,170400004,,,,5,9,14
HND-015737,2011,170400005,,,,7,4,11
HND-015740,2011,170400008,,,,6,3,9
HND-015747,2011,170400015,,,,4,1,5
HND-015748,2011,170400016,,,,2,1,3
HND-015751,2011,170400019,,,,4,4,8
HND-015752,2011,170400020,,,,2,3,5
HND-015754,2011,170400022,,,,4,1,5
HND-015733,2011,170400001,,,,10,18,28
HND-015735,2011,170400003,,,,8,4,12
HND-015738,2011,170400006,,,,3,4,7
HND-015739,2011,170400007,,,,2,4,6
HND-015741,2011,170400009,,,,5,7,12
HND-015742,2011,170400010,,,,1,0,1
HND-015743,2011,170400011,,,,0,3,3
HND-015744,2011,170400012,,,,5,3,8
HND-015745,2011,170400013,,,,3,3,6
,2011,170400014,,,,1,1,2
HND-015749,2011,170400017,,,,1,3,4
HND-015750,2011,170400018,,,,1,3,4
HND-015753,2011,170400021,,,,3,0,3
HND-015765,2011,170400055,,,,4,0,4
HND-015733,2011,170400001,,,,15,9,24
HND-015734,2011,170400002,,,,3,3,6
HND-015735,2011,170400003,,,,7,7,14
HND-015736,2011,170400004,,,,11,12,23
HND-015739,2011,170400007,,,,7,0,7
HND-015740,2011,170400008,,,,4,10,14
HND-015742,2011,170400010,,,,1,4,5
HND-015744,2011,170400012,,,,2,4,6
,2011,170400014,,,,2,2,4
HND-015747,2011,170400015,,,,1,5,6
HND-015750,2011,170400018,,,,2,3,5
HND-015751,2011,170400019,,,,2,2,4
HND-015754,2011,170400022,,,,5,0,5
HND-015737,2011,170400005,,,,2,4,6
HND-015738,2011,170400006,,,,2,4,6
HND-015741,2011,170400009,,,,10,6,16
HND-015743,2011,170400011,,,,2,1,3
HND-015745,2011,170400013,,,,5,2,7
HND-015748,2011,170400016,,,,2,1,3
HND-015749,2011,170400017,,,,4,2,6
HND-015752,2011,170400020,,,,1,1,2
HND-015753,2011,170400021,,,,1,1,2
HND-015765,2011,170400055,,,,5,2,7
HND-015734,2011,170400002,,,,6,2,8
HND-015736,2011,170400004,,,,11,8,19
HND-015737,2011,170400005,,,,5,1,6
HND-015740,2011,170400008,,,,4,3,7
HND-015741,2011,170400009,,,,4,5,9
HND-015745,2011,170400013,,,,8,6,14
HND-015748,2011,170400016,,,,0,2,2
HND-015749,2011,170400017,,,,3,2,5
HND-015751,2011,170400019,,,,0,3,3
HND-015752,2011,170400020,,,,5,0,5
HND-015733,2011,170400001,,,,17,13,30
HND-015735,2011,170400003,,,,2,5,7
HND-015738,2011,170400006,,,,5,5,10
HND-015739,2011,170400007,,,,0,5,5
HND-015742,2011,170400010,,,,2,3,5
HND-015743,2011,170400011,,,,1,1,2
HND-015744,2011,170400012,,,,3,5,8
,2011,170400014,,,,0,3,3
HND-015750,2011,170400018,,,,1,1,2
HND-015753,2011,170400021,,,,0,2,2
HND-015754,2011,170400022,,,,1,4,5
HND-015765,2011,170400055,,,,4,5,9
HND-015734,2011,170400002,,,,2,1,3
HND-015737,2011,170400005,,,,1,3,4
HND-015741,2011,170400009,,,,7,5,12
HND-015743,2011,170400011,,,,0,2,2
HND-015745,2011,170400013,,,,5,4,9
HND-015748,2011,170400016,,,,1,0,1
HND-015749,2011,170400017,,,,2,1,3
HND-015751,2011,170400019,,,,3,4,7
HND-015752,2011,170400020,,,,2,3,5
HND-015733,2011,170400001,,,,15,12,27
HND-015735,2011,170400003,,,,4,5,9
HND-015736,2011,170400004,,,,14,7,21
HND-015738,2011,170400006,,,,1,6,7
HND-015739,2011,170400007,,,,1,6,7
HND-015740,2011,170400008,,,,7,2,9
HND-015742,2011,170400010,,,,1,3,4
HND-015744,2011,170400012,,,,5,3,8
HND-015747,2011,170400015,,,,6,1,7
HND-015750,2011,170400018,,,,6,4,10
HND-015753,2011,170400021,,,,3,0,3
HND-015754,2011,170400022,,,,4,4,8
HND-015765,2011,170400055,,,,1,2,3
HND-015733,2011,170400001,,,,21,14,35
HND-015735,2011,170400003,,,,7,2,9
HND-015738,2011,170400006,,,,6,6,12
HND-015739,2011,170400007,,,,5,2,7
HND-015741,2011,170400009,,,,3,5,8
HND-015742,2011,170400010,,,,1,2,3
HND-015743,2011,170400011,,,,3,1,4
HND-015744,2011,170400012,,,,1,2,3
HND-015745,2011,170400013,,,,5,3,8
,2011,170400014,,,,1,1,2
HND-015749,2011,170400017,,,,1,2,3
HND-015750,2011,170400018,,,,1,6,7
HND-015753,2011,170400021,,,,5,4,9
HND-015765,2011,170400055,,,,3,1,4
HND-015734,2011,170400002,,,,2,8,10
HND-015736,2011,170400004,,,,7,9,16
HND-015737,2011,170400005,,,,1,3,4
HND-015740,2011,170400008,,,,4,6,10
HND-015747,2011,170400015,,,,3,0,3
HND-015748,2011,170400016,,,,1,0,1
HND-015752,2011,170400020,,,,5,2,7
HND-015754,2011,170400022,,,,1,4,5
HND-015758,2011,170400026,,,,39,32,71
HND-015758,2011,170400026,,,,24,53,77
HND-015758,2011,170400026,,,,29,35,64
HND-015758,2011,170400026,,,,11,18,29
HND-015758,2011,170400026,,,,6,12,18
HND-015777,2011,170500012,,,,13,11,24
HND-015778,2011,170500013,,,,4,1,5
HND-015782,2011,170500017,,,,4,4,8
HND-015783,2011,170500019,,,,3,3,6
HND-015779,2011,170500014,,,,4,4,8
HND-015780,2011,170500015,,,,3,4,7
HND-015779,2011,170500014,,,,1,3,4
HND-015780,2011,170500015,,,,3,4,7
HND-015783,2011,170500019,,,,5,4,9
HND-015777,2011,170500012,,,,14,8,22
HND-015778,2011,170500013,,,,3,1,4
HND-015782,2011,170500017,,,,7,4,11
HND-015768,2011,170500003,,,,2,0,2
HND-015769,2011,170500004,,,,5,3,8
HND-015772,2011,170500007,,,,2,1,3
HND-015773,2011,170500008,,,,3,2,5
HND-015766,2011,170500001,,,,20,23,43
HND-015767,2011,170500002,,,,2,4,6
HND-015770,2011,170500005,,,,5,2,7
HND-015771,2011,170500006,,,,7,4,11
HND-015774,2011,170500009,,,,0,5,5
HND-015775,2011,170500010,,,,4,3,7
HND-015776,2011,170500011,,,,5,8,13
HND-015768,2011,170500003,,,,0,1,1
HND-015771,2011,170500006,,,,3,1,4
HND-015772,2011,170500007,,,,6,4,10
HND-015774,2011,170500009,,,,4,1,5
HND-015775,2011,170500010,,,,3,1,4
HND-015766,2011,170500001,,,,10,16,26
HND-015767,2011,170500002,,,,3,0,3
HND-015769,2011,170500004,,,,6,8,14
HND-015770,2011,170500005,,,,4,2,6
HND-015773,2011,170500008,,,,4,3,7
HND-015776,2011,170500011,,,,6,2,8
HND-015766,2011,170500001,,,,15,12,27
HND-015770,2011,170500005,,,,3,3,6
HND-015771,2011,170500006,,,,9,1,10
HND-015774,2011,170500009,,,,4,1,5
HND-015775,2011,170500010,,,,2,0,2
HND-015776,2011,170500011,,,,5,6,11
HND-015767,2011,170500002,,,,2,3,5
HND-015768,2011,170500003,,,,2,4,6
HND-015769,2011,170500004,,,,9,5,14
HND-015772,2011,170500007,,,,3,5,8
HND-015773,2011,170500008,,,,4,4,8
HND-015768,2011,170500003,,,,3,0,3
HND-015771,2011,170500006,,,,5,4,9
HND-015772,2011,170500007,,,,3,5,8
HND-015766,2011,170500001,,,,15,18,33
HND-015767,2011,170500002,,,,3,3,6
HND-015769,2011,170500004,,,,7,7,14
HND-015770,2011,170500005,,,,3,4,7
HND-015773,2011,170500008,,,,3,8,11
HND-015774,2011,170500009,,,,3,2,5
HND-015775,2011,170500010,,,,2,0,2
HND-015776,2011,170500011,,,,5,6,11
HND-015766,2011,170500001,,,,10,19,29
HND-015767,2011,170500002,,,,1,4,5
HND-015770,2011,170500005,,,,4,5,9
HND-015773,2011,170500008,,,,1,4,5
HND-015774,2011,170500009,,,,2,2,4
HND-015775,2011,170500010,,,,3,0,3
HND-015776,2011,170500011,,,,6,3,9
HND-015768,2011,170500003,,,,4,2,6
HND-015769,2011,170500004,,,,6,6,12
HND-015771,2011,170500006,,,,6,3,9
HND-015772,2011,170500007,,,,6,5,11
HND-015768,2011,170500003,,,,2,1,3
HND-015771,2011,170500006,,,,4,7,11
HND-015772,2011,170500007,,,,3,4,7
HND-015774,2011,170500009,,,,6,1,7
HND-015775,2011,170500010,,,,1,0,1
HND-015766,2011,170500001,,,,22,21,43
HND-015767,2011,170500002,,,,4,2,6
HND-015769,2011,170500004,,,,6,7,13
HND-015770,2011,170500005,,,,3,2,5
HND-015773,2011,170500008,,,,3,4,7
HND-015776,2011,170500011,,,,4,7,11
HND-015781,2011,170500016,,,,19,30,49
HND-015781,2011,170500016,,,,29,29,58
HND-015781,2011,170500016,,,,24,34,58
HND-015781,2011,170500016,,,,6,19,25
HND-015781,2011,170500016,,,,10,13,23
HND-015781,2011,170500016,,,,3,16,19
HND-015800,2011,170600018,,,,3,3,6
,2011,170600048,,,,5,6,11
HND-015825,2011,170600049,,,,7,3,10
,2011,170600056,,,,6,8,14
HND-015827,2011,170600059,,,,3,2,5
HND-015828,2011,170600064,,,,9,6,15
,2011,170600073,,,,1,3,4
,2011,170600075,,,,0,3,3
,2011,170600076,,,,7,4,11
HND-015806,2011,170600024,,,,0,4,4
HND-015811,2011,170600029,,,,1,3,4
,2011,170600046,,,,6,4,10
,2011,170600047,,,,4,4,8
HND-015826,2011,170600050,,,,7,3,10
,2011,170600051,,,,3,2,5
,2011,170600057,,,,2,3,5
HND-015829,2011,170600071,,,,4,5,9
HND-015830,2011,170600077,,,,6,4,10
,2011,170600078,,,,5,3,8
HND-015816,2011,170600034,,,,12,14,26
HND-015817,2011,170600035,,,,1,1,2
,2011,170600038,,,,2,2,4
HND-015814,2011,170600032,,,,5,5,10
HND-015815,2011,170600033,,,,1,2,3
HND-015820,2011,170600039,,,,2,1,3
HND-015813,2011,170600031,,,,3,7,10
HND-015815,2011,170600033,,,,4,6,10
HND-015816,2011,170600034,,,,8,11,19
HND-015819,2011,170600037,,,,5,6,11
,2011,170600038,,,,10,5,15
HND-015821,2011,170600040,,,,10,6,16
HND-015814,2011,170600032,,,,13,16,29
HND-015817,2011,170600035,,,,5,5,10
HND-015818,2011,170600036,,,,3,4,7
HND-015820,2011,170600039,,,,7,3,10
HND-015822,2011,170600041,,,,4,5,9
HND-015824,2011,170600043,,,,2,6,8
HND-015814,2011,170600032,,,,12,14,26
HND-015815,2011,170600033,,,,9,7,16
HND-015817,2011,170600035,,,,7,7,14
HND-015818,2011,170600036,,,,3,9,12
HND-015820,2011,170600039,,,,11,7,18
HND-015822,2011,170600041,,,,4,7,11
HND-015824,2011,170600043,,,,8,5,13
HND-015813,2011,170600031,,,,6,4,10
HND-015816,2011,170600034,,,,5,11,16
HND-015819,2011,170600037,,,,5,5,10
,2011,170600038,,,,7,5,12
HND-015821,2011,170600040,,,,5,7,12
HND-015786,2011,170600003,,,,3,2,5
HND-015787,2011,170600004,,,,1,4,5
HND-015789,2011,170600006,,,,6,2,8
HND-015790,2011,170600007,,,,10,10,20
HND-015793,2011,170600010,,,,4,12,16
HND-015794,2011,170600011,,,,5,7,12
HND-015795,2011,170600012,,,,2,0,2
HND-015797,2011,170600015,,,,1,3,4
HND-015800,2011,170600018,,,,3,4,7
HND-015805,2011,170600023,,,,10,12,22
HND-015808,2011,170600026,,,,3,4,7
HND-015809,2011,170600027,,,,1,4,5
HND-015811,2011,170600029,,,,1,1,2
HND-015813,2011,170600031,,,,3,3,6
HND-015784,2011,170600001,,,,26,22,48
HND-015785,2011,170600002,,,,3,2,5
HND-015788,2011,170600005,,,,1,4,5
HND-015791,2011,170600008,,,,1,5,6
HND-015792,2011,170600009,,,,9,12,21
HND-015796,2011,170600013,,,,4,6,10
HND-015798,2011,170600016,,,,3,5,8
HND-015799,2011,170600017,,,,2,4,6
HND-015801,2011,170600019,,,,2,3,5
HND-015802,2011,170600020,,,,10,5,15
HND-015803,2011,170600021,,,,1,3,4
HND-015804,2011,170600022,,,,7,5,12
HND-015806,2011,170600024,,,,1,4,5
HND-015807,2011,170600025,,,,18,18,36
HND-015810,2011,170600028,,,,6,3,9
HND-015812,2011,170600030,,,,10,7,17
HND-015830,2011,170600077,,,,7,6,13
HND-015784,2011,170600001,,,,18,16,34
HND-015786,2011,170600003,,,,3,3,6
HND-015788,2011,170600005,,,,5,4,9
HND-015789,2011,170600006,,,,5,7,12
HND-015792,2011,170600009,,,,14,10,24
HND-015793,2011,170600010,,,,9,4,13
HND-015794,2011,170600011,,,,6,3,9
HND-015796,2011,170600013,,,,1,2,3
HND-015798,2011,170600016,,,,3,3,6
HND-015799,2011,170600017,,,,0,1,1
HND-015802,2011,170600020,,,,5,10,15
HND-015804,2011,170600022,,,,6,9,15
HND-015807,2011,170600025,,,,12,17,29
HND-015810,2011,170600028,,,,4,2,6
HND-015811,2011,170600029,,,,1,4,5
HND-015830,2011,170600077,,,,6,3,9
HND-015785,2011,170600002,,,,1,0,1
HND-015787,2011,170600004,,,,6,2,8
HND-015790,2011,170600007,,,,10,8,18
HND-015791,2011,170600008,,,,1,2,3
HND-015795,2011,170600012,,,,1,1,2
HND-015797,2011,170600015,,,,6,4,10
HND-015800,2011,170600018,,,,2,3,5
HND-015801,2011,170600019,,,,1,3,4
HND-015803,2011,170600021,,,,1,0,1
HND-015805,2011,170600023,,,,12,11,23
HND-015806,2011,170600024,,,,2,2,4
HND-015808,2011,170600026,,,,5,7,12
HND-015809,2011,170600027,,,,4,5,9
HND-015812,2011,170600030,,,,7,7,14
HND-015813,2011,170600031,,,,4,2,6
HND-015784,2011,170600001,,,,18,18,36
HND-015785,2011,170600002,,,,2,2,4
HND-015788,2011,170600005,,,,6,6,12
HND-015791,2011,170600008,,,,1,2,3
HND-015792,2011,170600009,,,,12,12,24
HND-015794,2011,170600011,,,,5,5,10
HND-015796,2011,170600013,,,,2,0,2
HND-015798,2011,170600016,,,,3,4,7
HND-015799,2011,170600017,,,,3,1,4
HND-015801,2011,170600019,,,,1,2,3
HND-015802,2011,170600020,,,,4,8,12
HND-015803,2011,170600021,,,,3,0,3
HND-015804,2011,170600022,,,,4,11,15
HND-015806,2011,170600024,,,,2,1,3
HND-015807,2011,170600025,,,,14,17,31
HND-015810,2011,170600028,,,,1,1,2
HND-015830,2011,170600077,,,,6,4,10
HND-015786,2011,170600003,,,,1,1,2
HND-015787,2011,170600004,,,,4,2,6
HND-015789,2011,170600006,,,,8,4,12
HND-015790,2011,170600007,,,,12,6,18
HND-015793,2011,170600010,,,,5,5,10
HND-015795,2011,170600012,,,,2,2,4
HND-015797,2011,170600015,,,,3,3,6
HND-015800,2011,170600018,,,,1,3,4
HND-015805,2011,170600023,,,,10,15,25
HND-015808,2011,170600026,,,,12,5,17
HND-015809,2011,170600027,,,,9,9,18
HND-015811,2011,170600029,,,,1,2,3
HND-015812,2011,170600030,,,,9,9,18
HND-015813,2011,170600031,,,,3,4,7
HND-015786,2011,170600003,,,,0,3,3
HND-015789,2011,170600006,,,,6,1,7
HND-015790,2011,170600007,,,,10,9,19
HND-015792,2011,170600009,,,,8,14,22
HND-015793,2011,170600010,,,,8,9,17
HND-015794,2011,170600011,,,,7,9,16
HND-015795,2011,170600012,,,,1,1,2
HND-015796,2011,170600013,,,,3,7,10
HND-015799,2011,170600017,,,,3,2,5
HND-015800,2011,170600018,,,,4,2,6
HND-015804,2011,170600022,,,,9,12,21
HND-015807,2011,170600025,,,,15,13,28
HND-015808,2011,170600026,,,,6,5,11
HND-015811,2011,170600029,,,,2,1,3
HND-015784,2011,170600001,,,,17,20,37
HND-015785,2011,170600002,,,,2,2,4
HND-015787,2011,170600004,,,,2,3,5
HND-015788,2011,170600005,,,,2,3,5
HND-015791,2011,170600008,,,,6,5,11
HND-015797,2011,170600015,,,,4,5,9
HND-015798,2011,170600016,,,,0,3,3
HND-015801,2011,170600019,,,,4,2,6
HND-015802,2011,170600020,,,,10,10,20
HND-015803,2011,170600021,,,,2,1,3
HND-015805,2011,170600023,,,,6,16,22
HND-015806,2011,170600024,,,,2,3,5
HND-015809,2011,170600027,,,,7,6,13
HND-015810,2011,170600028,,,,3,3,6
HND-015812,2011,170600030,,,,7,15,22
HND-015813,2011,170600031,,,,4,2,6
HND-015830,2011,170600077,,,,5,6,11
HND-015786,2011,170600003,,,,1,1,2
HND-015789,2011,170600006,,,,6,6,12
HND-015790,2011,170600007,,,,13,14,27
HND-015793,2011,170600010,,,,8,10,18
HND-015794,2011,170600011,,,,6,8,14
HND-015795,2011,170600012,,,,3,3,6
HND-015799,2011,170600017,,,,4,3,7
HND-015800,2011,170600018,,,,1,1,2
HND-015805,2011,170600023,,,,8,11,19
HND-015807,2011,170600025,,,,11,19,30
HND-015808,2011,170600026,,,,8,5,13
HND-015811,2011,170600029,,,,2,0,2
HND-015812,2011,170600030,,,,11,10,21
HND-015830,2011,170600077,,,,7,0,7
HND-015784,2011,170600001,,,,21,25,46
HND-015785,2011,170600002,,,,4,3,7
HND-015787,2011,170600004,,,,7,1,8
HND-015788,2011,170600005,,,,4,4,8
HND-015791,2011,170600008,,,,5,4,9
HND-015792,2011,170600009,,,,15,8,23
HND-015796,2011,170600013,,,,2,2,4
HND-015797,2011,170600015,,,,1,4,5
HND-015798,2011,170600016,,,,4,1,5
HND-015801,2011,170600019,,,,0,4,4
HND-015802,2011,170600020,,,,11,12,23
HND-015803,2011,170600021,,,,2,3,5
HND-015804,2011,170600022,,,,7,5,12
HND-015806,2011,170600024,,,,2,2,4
HND-015809,2011,170600027,,,,7,5,12
HND-015810,2011,170600028,,,,4,4,8
HND-015813,2011,170600031,,,,2,2,4
HND-015785,2011,170600002,,,,6,1,7
HND-015787,2011,170600004,,,,3,4,7
HND-015790,2011,170600007,,,,10,11,21
HND-015791,2011,170600008,,,,2,2,4
HND-015795,2011,170600012,,,,4,1,5
HND-015797,2011,170600015,,,,3,4,7
HND-015800,2011,170600018,,,,2,3,5
HND-015801,2011,170600019,,,,4,2,6
HND-015803,2011,170600021,,,,1,0,1
HND-015805,2011,170600023,,,,15,8,23
HND-015806,2011,170600024,,,,2,1,3
HND-015808,2011,170600026,,,,7,8,15
HND-015809,2011,170600027,,,,9,10,19
HND-015830,2011,170600077,,,,8,3,11
HND-015784,2011,170600001,,,,15,21,36
HND-015786,2011,170600003,,,,2,1,3
HND-015788,2011,170600005,,,,5,8,13
HND-015789,2011,170600006,,,,6,5,11
HND-015792,2011,170600009,,,,8,10,18
HND-015793,2011,170600010,,,,12,5,17
HND-015794,2011,170600011,,,,7,8,15
HND-015796,2011,170600013,,,,5,6,11
HND-015798,2011,170600016,,,,3,5,8
HND-015799,2011,170600017,,,,5,2,7
HND-015802,2011,170600020,,,,11,15,26
HND-015804,2011,170600022,,,,9,7,16
HND-015807,2011,170600025,,,,19,12,31
HND-015810,2011,170600028,,,,2,3,5
HND-015811,2011,170600029,,,,0,1,1
HND-015812,2011,170600030,,,,5,3,8
HND-015813,2011,170600031,,,,1,1,2
HND-015790,2011,170600007,,,,16,8,24
HND-015793,2011,170600010,,,,6,10,16
HND-015805,2011,170600023,,,,15,14,29
HND-015808,2011,170600026,,,,10,3,13
HND-015809,2011,170600027,,,,7,4,11
HND-015823,2011,170600042,,,,78,70,148
HND-015802,2011,170600020,,,,14,8,22
HND-015793,2011,170600010,,,,10,11,21
HND-015802,2011,170600020,,,,17,17,34
HND-015790,2011,170600007,,,,11,15,26
HND-015805,2011,170600023,,,,23,17,40
HND-015808,2011,170600026,,,,8,5,13
HND-015809,2011,170600027,,,,5,3,8
HND-015823,2011,170600042,,,,56,61,117
HND-015790,2011,170600007,,,,7,5,12
HND-015802,2011,170600020,,,,11,9,20
HND-015805,2011,170600023,,,,13,11,24
HND-015808,2011,170600026,,,,3,11,14
HND-015809,2011,170600027,,,,8,7,15
HND-015823,2011,170600042,,,,62,76,138
HND-015823,2011,170600042,,,,61,87,148
HND-015823,2011,170600042,,,,68,69,137
HND-015823,2011,170600042,,,,42,77,119
HND-015840,2011,170700010,,,,2,4,6
,2011,170700014,,,,4,5,9
,2011,170700023,,,,7,3,10
,2011,170700024,,,,7,2,9
,2011,170700077,,,,4,3,7
,2011,170700083,,,,7,8,15
HND-015892,2011,170700085,,,,12,4,16
HND-015895,2011,170700099,,,,5,4,9
,2011,170700100,,,,8,4,12
HND-015898,2011,170700105,,,,13,7,20
HND-015833,2011,170700003,,,,3,3,6
HND-015837,2011,170700007,,,,7,4,11
HND-015847,2011,170700017,,,,5,8,13
HND-015855,2011,170700025,,,,4,2,6
HND-015861,2011,170700031,,,,4,5,9
,2011,170700032,,,,4,2,6
HND-015862,2011,170700033,,,,6,2,8
HND-015866,2011,170700037,,,,6,3,9
HND-015887,2011,170700068,,,,1,7,8
HND-015889,2011,170700079,,,,4,4,8
HND-015890,2011,170700080,,,,3,3,6
,2011,170700081,,,,3,4,7
HND-015891,2011,170700082,,,,6,4,10
,2011,170700084,,,,5,4,9
,2011,170700090,,,,5,8,13
,2011,170700092,,,,8,7,15
HND-015894,2011,170700098,,,,4,5,9
,2011,170700101,,,,1,5,6
HND-015896,2011,170700102,,,,6,5,11
HND-015868,2011,170700039,,,,0,3,3
,2011,170700104,,,,0,2,2
HND-015869,2011,170700040,,,,4,2,6
,2011,170700060,,,,5,2,7
HND-015868,2011,170700039,,,,6,3,9
HND-015870,2011,170700041,,,,25,28,53
,2011,170700043,,,,5,5,10
HND-015871,2011,170700045,,,,8,5,13
HND-015872,2011,170700046,,,,3,4,7
,2011,170700049,,,,3,10,13
HND-015878,2011,170700053,,,,16,8,24
HND-015880,2011,170700055,,,,4,5,9
HND-015881,2011,170700056,,,,12,8,20
,2011,170700060,,,,4,2,6
HND-015884,2011,170700062,,,,5,5,10
HND-015885,2011,170700064,,,,7,8,15
HND-015888,2011,170700076,,,,3,5,8
,2011,170700104,,,,4,4,8
HND-015869,2011,170700040,,,,1,1,2
,2011,170700042,,,,7,7,14
,2011,170700044,,,,13,8,21
HND-015873,2011,170700047,,,,1,4,5
HND-015874,2011,170700048,,,,2,4,6
HND-015875,2011,170700050,,,,2,4,6
HND-015876,2011,170700051,,,,10,8,18
HND-015877,2011,170700052,,,,4,2,6
HND-015879,2011,170700054,,,,2,7,9
,2011,170700063,,,,11,5,16
HND-015886,2011,170700065,,,,5,4,9
HND-015869,2011,170700040,,,,6,2,8
HND-015870,2011,170700041,,,,35,53,88
,2011,170700042,,,,3,5,8
HND-015871,2011,170700045,,,,11,7,18
HND-015874,2011,170700048,,,,8,8,16
HND-015875,2011,170700050,,,,7,7,14
HND-015877,2011,170700052,,,,9,8,17
HND-015879,2011,170700054,,,,3,4,7
HND-015880,2011,170700055,,,,10,13,23
HND-015888,2011,170700076,,,,2,3,5
HND-015868,2011,170700039,,,,7,4,11
,2011,170700043,,,,1,3,4
HND-015872,2011,170700046,,,,4,3,7
HND-015873,2011,170700047,,,,7,7,14
,2011,170700049,,,,4,4,8
HND-015876,2011,170700051,,,,9,8,17
HND-015878,2011,170700053,,,,6,7,13
HND-015881,2011,170700056,,,,13,14,27
,2011,170700060,,,,3,3,6
HND-015884,2011,170700062,,,,4,3,7
HND-015885,2011,170700064,,,,6,2,8
HND-015886,2011,170700065,,,,6,2,8
,2011,170700104,,,,2,4,6
HND-015832,2011,170700002,,,,5,6,11
HND-015834,2011,170700004,,,,15,16,31
HND-015835,2011,170700005,,,,5,5,10
,2011,170700008,,,,9,7,16
HND-015840,2011,170700010,,,,1,2,3
HND-015841,2011,170700011,,,,10,10,20
HND-015842,2011,170700012,,,,9,7,16
,2011,170700014,,,,5,3,8
HND-015845,2011,170700015,,,,8,9,17
,2011,170700018,,,,1,3,4
HND-015851,2011,170700021,,,,6,8,14
,2011,170700023,,,,5,4,9
,2011,170700024,,,,1,0,1
HND-015856,2011,170700026,,,,12,13,25
HND-015857,2011,170700027,,,,9,8,17
HND-015860,2011,170700030,,,,12,15,27
,2011,170700032,,,,2,2,4
HND-015864,2011,170700035,,,,7,5,12
HND-015867,2011,170700038,,,,9,4,13
HND-015868,2011,170700039,,,,11,3,14
HND-015897,2011,170700103,,,,1,2,3
HND-015833,2011,170700003,,,,3,2,5
HND-015836,2011,170700006,,,,1,2,3
HND-015837,2011,170700007,,,,2,2,4
HND-015839,2011,170700009,,,,12,13,25
HND-015843,2011,170700013,,,,5,6,11
HND-015846,2011,170700016,,,,22,15,37
HND-015847,2011,170700017,,,,5,5,10
HND-015849,2011,170700019,,,,13,13,26
HND-015850,2011,170700020,,,,20,5,25
HND-015852,2011,170700022,,,,8,9,17
HND-015855,2011,170700025,,,,2,3,5
HND-015858,2011,170700028,,,,4,1,5
HND-015859,2011,170700029,,,,3,7,10
HND-015861,2011,170700031,,,,3,0,3
HND-015862,2011,170700033,,,,4,3,7
HND-015863,2011,170700034,,,,4,3,7
HND-015865,2011,170700036,,,,6,6,12
HND-015866,2011,170700037,,,,2,1,3
HND-015869,2011,170700040,,,,7,2,9
HND-015883,2011,170700058,,,,44,40,84
HND-015886,2011,170700065,,,,6,3,9
HND-015888,2011,170700076,,,,2,4,6
,2011,170700104,,,,2,4,6
HND-015833,2011,170700003,,,,2,2,4
HND-015834,2011,170700004,,,,11,9,20
HND-015836,2011,170700006,,,,1,1,2
HND-015837,2011,170700007,,,,0,3,3
HND-015841,2011,170700011,,,,17,9,26
HND-015843,2011,170700013,,,,4,8,12
,2011,170700014,,,,4,1,5
HND-015846,2011,170700016,,,,15,15,30
HND-015847,2011,170700017,,,,3,3,6
,2011,170700023,,,,8,3,11
HND-015855,2011,170700025,,,,2,2,4
HND-015856,2011,170700026,,,,13,10,23
HND-015859,2011,170700029,,,,6,2,8
HND-015860,2011,170700030,,,,10,5,15
HND-015861,2011,170700031,,,,7,3,10
,2011,170700032,,,,2,3,5
HND-015862,2011,170700033,,,,4,5,9
HND-015863,2011,170700034,,,,4,4,8
HND-015866,2011,170700037,,,,3,3,6
HND-015867,2011,170700038,,,,4,3,7
HND-015869,2011,170700040,,,,4,1,5
HND-015883,2011,170700058,,,,48,43,91
HND-015832,2011,170700002,,,,12,4,16
HND-015835,2011,170700005,,,,6,5,11
,2011,170700008,,,,6,6,12
HND-015839,2011,170700009,,,,11,2,13
HND-015840,2011,170700010,,,,4,2,6
HND-015842,2011,170700012,,,,6,11,17
HND-015845,2011,170700015,,,,6,6,12
,2011,170700018,,,,2,5,7
HND-015849,2011,170700019,,,,6,7,13
HND-015850,2011,170700020,,,,13,12,25
HND-015851,2011,170700021,,,,8,6,14
HND-015852,2011,170700022,,,,5,4,9
,2011,170700024,,,,2,5,7
HND-015857,2011,170700027,,,,11,11,22
HND-015858,2011,170700028,,,,3,1,4
HND-015864,2011,170700035,,,,5,5,10
HND-015865,2011,170700036,,,,5,8,13
HND-015868,2011,170700039,,,,5,5,10
HND-015886,2011,170700065,,,,4,4,8
HND-015888,2011,170700076,,,,2,2,4
HND-015897,2011,170700103,,,,5,0,5
,2011,170700104,,,,1,2,3
HND-015833,2011,170700003,,,,2,1,3
HND-015836,2011,170700006,,,,4,5,9
HND-015837,2011,170700007,,,,3,2,5
HND-015839,2011,170700009,,,,11,13,24
HND-015843,2011,170700013,,,,6,5,11
HND-015846,2011,170700016,,,,17,20,37
HND-015847,2011,170700017,,,,5,8,13
HND-015849,2011,170700019,,,,12,15,27
HND-015852,2011,170700022,,,,10,14,24
HND-015855,2011,170700025,,,,2,3,5
HND-015858,2011,170700028,,,,5,4,9
HND-015859,2011,170700029,,,,0,3,3
HND-015860,2011,170700030,,,,13,15,28
HND-015861,2011,170700031,,,,2,0,2
HND-015862,2011,170700033,,,,7,3,10
HND-015863,2011,170700034,,,,4,2,6
HND-015865,2011,170700036,,,,4,5,9
HND-015866,2011,170700037,,,,5,3,8
HND-015869,2011,170700040,,,,8,4,12
HND-015883,2011,170700058,,,,40,43,83
HND-015886,2011,170700065,,,,4,5,9
HND-015888,2011,170700076,,,,3,4,7
,2011,170700104,,,,0,2,2
HND-015832,2011,170700002,,,,12,5,17
HND-015834,2011,170700004,,,,22,14,36
HND-015835,2011,170700005,,,,9,7,16
,2011,170700008,,,,12,9,21
HND-015840,2011,170700010,,,,3,1,4
HND-015841,2011,170700011,,,,6,7,13
HND-015842,2011,170700012,,,,13,4,17
,2011,170700014,,,,3,4,7
HND-015845,2011,170700015,,,,6,6,12
,2011,170700018,,,,2,0,2
HND-015850,2011,170700020,,,,21,24,45
HND-015851,2011,170700021,,,,6,4,10
,2011,170700023,,,,7,5,12
,2011,170700024,,,,3,2,5
HND-015856,2011,170700026,,,,13,16,29
HND-015857,2011,170700027,,,,14,10,24
HND-015864,2011,170700035,,,,5,6,11
HND-015867,2011,170700038,,,,8,5,13
HND-015868,2011,170700039,,,,4,3,7
HND-015897,2011,170700103,,,,3,5,8
HND-015832,2011,170700002,,,,4,8,12
HND-015833,2011,170700003,,,,4,1,5
HND-015834,2011,170700004,,,,8,11,19
HND-015837,2011,170700007,,,,1,2,3
,2011,170700008,,,,7,6,13
HND-015840,2011,170700010,,,,3,4,7
HND-015841,2011,170700011,,,,7,7,14
HND-015843,2011,170700013,,,,9,5,14
,2011,170700014,,,,4,4,8
HND-015847,2011,170700017,,,,9,2,11
,2011,170700018,,,,1,3,4
,2011,170700023,,,,6,7,13
HND-015856,2011,170700026,,,,8,17,25
HND-015857,2011,170700027,,,,10,9,19
HND-015859,2011,170700029,,,,6,3,9
HND-015860,2011,170700030,,,,23,6,29
HND-015861,2011,170700031,,,,2,2,4
,2011,170700032,,,,1,2,3
HND-015863,2011,170700034,,,,5,2,7
HND-015864,2011,170700035,,,,4,5,9
HND-015867,2011,170700038,,,,9,7,16
HND-015869,2011,170700040,,,,2,1,3
HND-015883,2011,170700058,,,,32,30,62
HND-015835,2011,170700005,,,,3,5,8
HND-015836,2011,170700006,,,,0,2,2
HND-015839,2011,170700009,,,,13,9,22
HND-015842,2011,170700012,,,,14,9,23
HND-015845,2011,170700015,,,,5,11,16
HND-015846,2011,170700016,,,,16,17,33
HND-015849,2011,170700019,,,,8,7,15
HND-015850,2011,170700020,,,,17,22,39
HND-015851,2011,170700021,,,,6,5,11
HND-015852,2011,170700022,,,,11,10,21
,2011,170700024,,,,6,6,12
HND-015855,2011,170700025,,,,1,3,4
HND-015858,2011,170700028,,,,1,0,1
HND-015862,2011,170700033,,,,4,3,7
HND-015865,2011,170700036,,,,13,2,15
HND-015866,2011,170700037,,,,0,4,4
HND-015868,2011,170700039,,,,10,7,17
HND-015886,2011,170700065,,,,3,2,5
HND-015888,2011,170700076,,,,8,2,10
HND-015897,2011,170700103,,,,7,7,14
,2011,170700104,,,,2,2,4
HND-015833,2011,170700003,,,,1,1,2
HND-015835,2011,170700005,,,,8,2,10
HND-015836,2011,170700006,,,,2,3,5
HND-015839,2011,170700009,,,,7,9,16
HND-015843,2011,170700013,,,,7,10,17
HND-015845,2011,170700015,,,,17,6,23
HND-015846,2011,170700016,,,,16,9,25
HND-015849,2011,170700019,,,,11,13,24
HND-015850,2011,170700020,,,,18,14,32
HND-015852,2011,170700022,,,,15,9,24
,2011,170700024,,,,5,2,7
HND-015855,2011,170700025,,,,3,2,5
HND-015858,2011,170700028,,,,3,2,5
HND-015860,2011,170700030,,,,10,12,22
,2011,170700032,,,,2,0,2
HND-015863,2011,170700034,,,,6,12,18
HND-015864,2011,170700035,,,,6,4,10
HND-015867,2011,170700038,,,,7,3,10
HND-015886,2011,170700065,,,,9,1,10
HND-015897,2011,170700103,,,,0,2,2
HND-015832,2011,170700002,,,,8,7,15
HND-015834,2011,170700004,,,,23,20,43
HND-015837,2011,170700007,,,,3,1,4
,2011,170700008,,,,10,5,15
HND-015840,2011,170700010,,,,5,3,8
HND-015841,2011,170700011,,,,13,9,22
HND-015842,2011,170700012,,,,6,13,19
,2011,170700014,,,,7,4,11
HND-015847,2011,170700017,,,,6,6,12
,2011,170700018,,,,4,2,6
HND-015851,2011,170700021,,,,6,10,16
,2011,170700023,,,,7,7,14
HND-015856,2011,170700026,,,,12,11,23
HND-015857,2011,170700027,,,,13,13,26
HND-015859,2011,170700029,,,,0,5,5
HND-015861,2011,170700031,,,,1,2,3
HND-015862,2011,170700033,,,,8,3,11
HND-015865,2011,170700036,,,,7,2,9
HND-015866,2011,170700037,,,,3,2,5
HND-015868,2011,170700039,,,,4,3,7
HND-015869,2011,170700040,,,,1,4,5
HND-015883,2011,170700058,,,,55,58,113
HND-015888,2011,170700076,,,,1,3,4
,2011,170700104,,,,1,2,3
HND-015833,2011,170700003,,,,5,6,11
HND-015834,2011,170700004,,,,4,10,14
HND-015836,2011,170700006,,,,9,4,13
HND-015837,2011,170700007,,,,5,0,5
HND-015841,2011,170700011,,,,5,14,19
HND-015843,2011,170700013,,,,8,8,16
,2011,170700014,,,,3,4,7
HND-015846,2011,170700016,,,,11,17,28
HND-015847,2011,170700017,,,,6,6,12
,2011,170700023,,,,3,4,7
HND-015855,2011,170700025,,,,2,2,4
HND-015856,2011,170700026,,,,11,15,26
HND-015859,2011,170700029,,,,4,4,8
HND-015864,2011,170700035,,,,7,3,10
HND-015865,2011,170700036,,,,5,6,11
HND-015868,2011,170700039,,,,11,6,17
HND-015888,2011,170700076,,,,3,1,4
HND-015897,2011,170700103,,,,4,0,4
,2011,170700104,,,,0,2,2
HND-015832,2011,170700002,,,,9,5,14
HND-015835,2011,170700005,,,,5,5,10
,2011,170700008,,,,10,14,24
HND-015839,2011,170700009,,,,16,6,22
HND-015840,2011,170700010,,,,6,2,8
HND-015842,2011,170700012,,,,6,9,15
HND-015845,2011,170700015,,,,3,6,9
,2011,170700018,,,,5,2,7
HND-015849,2011,170700019,,,,12,10,22
HND-015850,2011,170700020,,,,20,11,31
HND-015851,2011,170700021,,,,5,8,13
HND-015852,2011,170700022,,,,10,9,19
,2011,170700024,,,,7,4,11
HND-015857,2011,170700027,,,,7,10,17
HND-015858,2011,170700028,,,,1,2,3
HND-015860,2011,170700030,,,,13,10,23
HND-015861,2011,170700031,,,,5,3,8
,2011,170700032,,,,2,1,3
HND-015862,2011,170700033,,,,1,5,6
HND-015863,2011,170700034,,,,4,9,13
HND-015866,2011,170700037,,,,5,3,8
HND-015867,2011,170700038,,,,6,9,15
HND-015869,2011,170700040,,,,0,2,2
HND-015883,2011,170700058,,,,55,48,103
HND-015886,2011,170700065,,,,1,1,2
HND-015834,2011,170700004,,,,17,13,30
HND-015835,2011,170700005,,,,6,6,12
,2011,170700008,,,,12,11,23
HND-015857,2011,170700027,,,,15,9,24
HND-015882,2011,170700057,,,,139,134,273
HND-015837,2011,170700007,,,,5,7,12
HND-015843,2011,170700013,,,,5,8,13
HND-015846,2011,170700016,,,,9,5,14
HND-015850,2011,170700020,,,,28,26,54
HND-015852,2011,170700022,,,,11,10,21
HND-015835,2011,170700005,,,,7,4,11
,2011,170700008,,,,17,12,29
HND-015850,2011,170700020,,,,37,26,63
HND-015852,2011,170700022,,,,8,3,11
HND-015857,2011,170700027,,,,9,12,21
HND-015882,2011,170700057,,,,104,152,256
HND-015834,2011,170700004,,,,8,8,16
HND-015837,2011,170700007,,,,11,4,15
HND-015843,2011,170700013,,,,9,4,13
HND-015846,2011,170700016,,,,3,11,14
HND-015834,2011,170700004,,,,11,10,21
HND-015837,2011,170700007,,,,6,5,11
,2011,170700008,,,,8,11,19
HND-015843,2011,170700013,,,,6,3,9
HND-015846,2011,170700016,,,,8,7,15
HND-015857,2011,170700027,,,,16,13,29
HND-015835,2011,170700005,,,,6,7,13
HND-015850,2011,170700020,,,,24,23,47
HND-015852,2011,170700022,,,,7,6,13
HND-015882,2011,170700057,,,,117,149,266
HND-015882,2011,170700057,,,,159,136,295
HND-015882,2011,170700057,,,,107,129,236
HND-015882,2011,170700057,,,,130,122,252
,2011,170800107,,,,5,8,13
,2011,170800115,,,,15,5,20
HND-015932,2011,170800148,,,,0,1,1
HND-015933,2011,170800149,,,,3,2,5
,2011,170800150,,,,3,4,7
,2011,170800152,,,,4,1,5
,2011,170800153,,,,6,8,14
HND-015935,2011,170800154,,,,4,2,6
,2011,170800036,,,,7,5,12
HND-015924,2011,170800037,,,,5,0,5
,2011,170800040,,,,7,8,15
,2011,170800112,,,,1,10,11
,2011,170800143,,,,5,6,11
,2011,170800144,,,,2,5,7
HND-015929,2011,170800145,,,,4,6,10
HND-015930,2011,170800146,,,,7,3,10
HND-015931,2011,170800147,,,,3,5,8
HND-015934,2011,170800151,,,,6,1,7
HND-015936,2011,170800155,,,,2,3,5
HND-015919,2011,170800025,,,,1,1,2
,2011,170800028,,,,0,1,1
HND-015927,2011,170800119,,,,0,2,2
HND-015917,2011,170800020,,,,2,2,4
,2011,170800029,,,,2,2,4
HND-015919,2011,170800025,,,,8,3,11
,2011,170800026,,,,2,1,3
,2011,170800027,,,,1,2,3
,2011,170800029,,,,1,3,4
HND-015922,2011,170800035,,,,2,3,5
HND-015925,2011,170800038,,,,7,8,15
HND-015917,2011,170800020,,,,4,6,10
,2011,170800028,,,,1,0,1
HND-015921,2011,170800034,,,,3,3,6
HND-015927,2011,170800119,,,,7,7,14
HND-015909,2011,170800012,,,,8,11,19
HND-015917,2011,170800020,,,,10,8,18
,2011,170800028,,,,4,0,4
,2011,170800029,,,,5,6,11
HND-015922,2011,170800035,,,,6,3,9
HND-015927,2011,170800119,,,,8,9,17
HND-015919,2011,170800025,,,,20,10,30
,2011,170800026,,,,3,5,8
,2011,170800027,,,,6,3,9
HND-015921,2011,170800034,,,,7,3,10
HND-015899,2011,170800002,,,,3,6,9
HND-015905,2011,170800008,,,,1,2,3
HND-015906,2011,170800009,,,,10,10,20
HND-015909,2011,170800012,,,,7,8,15
HND-015912,2011,170800015,,,,5,2,7
HND-015913,2011,170800016,,,,6,7,13
HND-015916,2011,170800019,,,,4,7,11
HND-015922,2011,170800035,,,,7,3,10
HND-015925,2011,170800038,,,,6,14,20
,2011,170800116,,,,2,7,9
HND-015928,2011,170800120,,,,0,3,3
HND-015900,2011,170800003,,,,5,10,15
HND-015901,2011,170800004,,,,0,1,1
HND-015902,2011,170800005,,,,17,11,28
HND-015903,2011,170800006,,,,1,2,3
HND-015904,2011,170800007,,,,3,5,8
,2011,170800010,,,,1,2,3
HND-015908,2011,170800011,,,,1,3,4
HND-015910,2011,170800013,,,,3,7,10
HND-015911,2011,170800014,,,,12,12,24
HND-015914,2011,170800017,,,,8,3,11
HND-015915,2011,170800018,,,,8,8,16
HND-015917,2011,170800020,,,,3,8,11
HND-015918,2011,170800021,,,,1,1,2
HND-015899,2011,170800002,,,,6,1,7
HND-015901,2011,170800004,,,,0,2,2
HND-015904,2011,170800007,,,,6,4,10
HND-015905,2011,170800008,,,,3,0,3
,2011,170800010,,,,1,5,6
HND-015908,2011,170800011,,,,3,2,5
HND-015909,2011,170800012,,,,6,7,13
HND-015911,2011,170800014,,,,11,8,19
HND-015912,2011,170800015,,,,2,4,6
HND-015915,2011,170800018,,,,7,2,9
HND-015917,2011,170800020,,,,15,9,24
HND-015922,2011,170800035,,,,7,2,9
,2011,170800116,,,,5,1,6
HND-015900,2011,170800003,,,,9,5,14
HND-015902,2011,170800005,,,,16,16,32
HND-015903,2011,170800006,,,,3,3,6
HND-015906,2011,170800009,,,,11,10,21
HND-015910,2011,170800013,,,,7,6,13
HND-015913,2011,170800016,,,,2,5,7
HND-015914,2011,170800017,,,,2,3,5
HND-015916,2011,170800019,,,,4,3,7
HND-015918,2011,170800021,,,,1,0,1
HND-015925,2011,170800038,,,,9,5,14
HND-015928,2011,170800120,,,,2,0,2
HND-015900,2011,170800003,,,,5,4,9
HND-015901,2011,170800004,,,,3,1,4
HND-015902,2011,170800005,,,,16,11,27
HND-015904,2011,170800007,,,,4,4,8
HND-015905,2011,170800008,,,,3,3,6
,2011,170800010,,,,2,2,4
HND-015908,2011,170800011,,,,10,2,12
HND-015909,2011,170800012,,,,10,5,15
HND-015910,2011,170800013,,,,5,8,13
HND-015911,2011,170800014,,,,14,7,21
HND-015914,2011,170800017,,,,1,1,2
HND-015915,2011,170800018,,,,6,2,8
HND-015917,2011,170800020,,,,12,3,15
HND-015918,2011,170800021,,,,1,1,2
HND-015922,2011,170800035,,,,7,4,11
,2011,170800116,,,,5,8,13
HND-015928,2011,170800120,,,,1,1,2
HND-015899,2011,170800002,,,,6,4,10
HND-015906,2011,170800009,,,,15,12,27
HND-015912,2011,170800015,,,,5,0,5
HND-015913,2011,170800016,,,,4,5,9
HND-015916,2011,170800019,,,,3,4,7
HND-015925,2011,170800038,,,,4,11,15
HND-015899,2011,170800002,,,,4,11,15
HND-015901,2011,170800004,,,,2,4,6
HND-015905,2011,170800008,,,,1,3,4
,2011,170800010,,,,3,1,4
HND-015909,2011,170800012,,,,11,11,22
HND-015911,2011,170800014,,,,7,8,15
HND-015912,2011,170800015,,,,7,2,9
HND-015915,2011,170800018,,,,7,4,11
HND-015916,2011,170800019,,,,8,5,13
HND-015922,2011,170800035,,,,12,8,20
,2011,170800116,,,,1,7,8
HND-015900,2011,170800003,,,,10,5,15
HND-015902,2011,170800005,,,,12,17,29
HND-015903,2011,170800006,,,,4,2,6
HND-015904,2011,170800007,,,,4,3,7
HND-015906,2011,170800009,,,,13,19,32
HND-015908,2011,170800011,,,,3,4,7
HND-015910,2011,170800013,,,,8,6,14
HND-015913,2011,170800016,,,,4,6,10
HND-015914,2011,170800017,,,,7,6,13
HND-015917,2011,170800020,,,,8,6,14
HND-015918,2011,170800021,,,,1,1,2
HND-015925,2011,170800038,,,,11,8,19
HND-015928,2011,170800120,,,,1,2,3
HND-015899,2011,170800002,,,,2,6,8
HND-015901,2011,170800004,,,,3,0,3
HND-015905,2011,170800008,,,,0,1,1
HND-015906,2011,170800009,,,,21,11,32
HND-015909,2011,170800012,,,,12,8,20
HND-015912,2011,170800015,,,,3,3,6
HND-015916,2011,170800019,,,,4,3,7
HND-015900,2011,170800003,,,,3,8,11
HND-015902,2011,170800005,,,,30,19,49
HND-015903,2011,170800006,,,,4,0,4
HND-015904,2011,170800007,,,,6,7,13
,2011,170800010,,,,1,5,6
HND-015908,2011,170800011,,,,4,2,6
HND-015910,2011,170800013,,,,8,6,14
HND-015911,2011,170800014,,,,7,4,11
HND-015913,2011,170800016,,,,6,7,13
HND-015914,2011,170800017,,,,4,5,9
HND-015915,2011,170800018,,,,6,8,14
HND-015917,2011,170800020,,,,9,12,21
HND-015918,2011,170800021,,,,0,2,2
HND-015922,2011,170800035,,,,12,9,21
HND-015925,2011,170800038,,,,11,10,21
,2011,170800116,,,,4,6,10
HND-015928,2011,170800120,,,,1,1,2
HND-015900,2011,170800003,,,,6,5,11
HND-015902,2011,170800005,,,,11,14,25
HND-015903,2011,170800006,,,,3,1,4
HND-015906,2011,170800009,,,,12,9,21
HND-015910,2011,170800013,,,,17,2,19
HND-015913,2011,170800016,,,,7,6,13
HND-015914,2011,170800017,,,,11,10,21
HND-015916,2011,170800019,,,,3,3,6
HND-015918,2011,170800021,,,,2,1,3
HND-015925,2011,170800038,,,,9,6,15
HND-015928,2011,170800120,,,,2,0,2
HND-015899,2011,170800002,,,,6,2,8
HND-015901,2011,170800004,,,,1,2,3
HND-015904,2011,170800007,,,,6,7,13
HND-015905,2011,170800008,,,,0,2,2
,2011,170800010,,,,3,3,6
HND-015908,2011,170800011,,,,9,2,11
HND-015909,2011,170800012,,,,14,11,25
HND-015911,2011,170800014,,,,4,4,8
HND-015912,2011,170800015,,,,6,3,9
HND-015915,2011,170800018,,,,8,7,15
HND-015917,2011,170800020,,,,3,4,7
HND-015922,2011,170800035,,,,13,8,21
,2011,170800116,,,,5,4,9
HND-015906,2011,170800009,,,,33,26,59
HND-015920,2011,170800030,,,,31,35,66
HND-015900,2011,170800003,,,,7,6,13
HND-015900,2011,170800003,,,,13,12,25
HND-015906,2011,170800009,,,,26,7,33
HND-015920,2011,170800030,,,,21,30,51
HND-015920,2011,170800030,,,,31,33,64
HND-015900,2011,170800003,,,,6,6,12
HND-015906,2011,170800009,,,,23,32,55
HND-015920,2011,170800030,,,,27,21,48
HND-015920,2011,170800030,,,,14,28,42
HND-015920,2011,170800030,,,,15,19,34
,2011,170900059,,,,6,7,13
,2011,170900072,,,,4,4,8
,2011,170900084,,,,0,6,6
,2011,170900088,,,,5,4,9
HND-015985,2011,170900060,,,,4,3,7
,2011,170900061,,,,11,5,16
,2011,170900062,,,,3,6,9
,2011,170900071,,,,4,3,7
,2011,170900073,,,,6,5,11
,2011,170900076,,,,7,2,9
,2011,170900086,,,,7,1,8
,2011,170900087,,,,1,4,5
HND-015992,2011,170900089,,,,3,3,6
HND-015982,2011,170900056,,,,5,2,7
HND-015984,2011,170900058,,,,2,1,3
HND-015988,2011,170900065,,,,8,0,8
,2011,170900074,,,,1,0,1
HND-015991,2011,170900078,,,,12,6,18
,2011,170900022,,,,2,2,4
,2011,170900037,,,,2,0,2
HND-015976,2011,170900047,,,,1,2,3
HND-015983,2011,170900057,,,,2,0,2
,2011,170900022,,,,3,1,4
HND-015966,2011,170900031,,,,6,3,9
HND-015967,2011,170900033,,,,20,35,55
HND-015968,2011,170900034,,,,21,11,32
,2011,170900035,,,,15,16,31
,2011,170900037,,,,4,2,6
HND-015970,2011,170900038,,,,13,9,22
,2011,170900039,,,,2,2,4
HND-015971,2011,170900040,,,,3,5,8
HND-015972,2011,170900042,,,,8,7,15
HND-015973,2011,170900044,,,,2,3,5
HND-015974,2011,170900045,,,,5,7,12
HND-015976,2011,170900047,,,,10,7,17
HND-015977,2011,170900048,,,,10,9,19
,2011,170900050,,,,5,8,13
HND-015982,2011,170900056,,,,7,3,10
,2011,170900075,,,,4,1,5
HND-015969,2011,170900036,,,,4,3,7
,2011,170900041,,,,3,3,6
,2011,170900043,,,,3,8,11
HND-015975,2011,170900046,,,,6,6,12
HND-015978,2011,170900049,,,,14,17,31
HND-015983,2011,170900057,,,,2,2,4
HND-015984,2011,170900058,,,,7,7,14
HND-015987,2011,170900064,,,,3,6,9
HND-015988,2011,170900065,,,,15,0,15
,2011,170900074,,,,6,4,10
HND-015991,2011,170900078,,,,11,4,15
,2011,170900022,,,,7,5,12
HND-015966,2011,170900031,,,,14,17,31
HND-015967,2011,170900033,,,,46,46,92
HND-015968,2011,170900034,,,,38,19,57
,2011,170900035,,,,11,10,21
,2011,170900039,,,,7,20,27
HND-015972,2011,170900042,,,,11,18,29
HND-015974,2011,170900045,,,,21,9,30
HND-015976,2011,170900047,,,,9,11,20
HND-015977,2011,170900048,,,,12,10,22
HND-015982,2011,170900056,,,,15,9,24
HND-015987,2011,170900064,,,,14,8,22
HND-015988,2011,170900065,,,,16,0,16
,2011,170900075,,,,4,5,9
HND-015991,2011,170900078,,,,18,23,41
HND-015969,2011,170900036,,,,13,11,24
,2011,170900037,,,,1,1,2
HND-015970,2011,170900038,,,,31,28,59
HND-015971,2011,170900040,,,,11,4,15
,2011,170900041,,,,12,3,15
,2011,170900043,,,,6,8,14
HND-015973,2011,170900044,,,,8,7,15
HND-015975,2011,170900046,,,,11,7,18
HND-015978,2011,170900049,,,,17,17,34
,2011,170900050,,,,24,20,44
HND-015983,2011,170900057,,,,6,7,13
HND-015984,2011,170900058,,,,10,9,19
,2011,170900074,,,,0,5,5
HND-015944,2011,170900006,,,,10,10,20
HND-015945,2011,170900007,,,,2,0,2
HND-015950,2011,170900012,,,,5,16,21
HND-015953,2011,170900015,,,,16,26,42
HND-015956,2011,170900018,,,,10,12,22
HND-015957,2011,170900019,,,,12,15,27
,2011,170900022,,,,13,8,21
HND-015961,2011,170900025,,,,23,26,49
HND-015962,2011,170900026,,,,10,15,25
HND-015965,2011,170900030,,,,1,2,3
HND-015966,2011,170900031,,,,36,27,63
HND-015981,2011,170900055,,,,26,25,51
,2011,170900068,,,,1,5,6
,2011,170900079,,,,4,7,11
HND-015941,2011,170900001,,,,39,35,74
HND-015942,2011,170900003,,,,72,66,138
,2011,170900004,,,,1,5,6
HND-015943,2011,170900005,,,,4,4,8
HND-015946,2011,170900008,,,,16,21,37
,2011,170900009,,,,12,16,28
HND-015948,2011,170900010,,,,13,14,27
HND-015949,2011,170900011,,,,14,7,21
HND-015951,2011,170900013,,,,2,6,8
HND-015952,2011,170900014,,,,26,36,62
HND-015954,2011,170900016,,,,31,40,71
HND-015955,2011,170900017,,,,10,15,25
HND-015958,2011,170900020,,,,3,1,4
,2011,170900021,,,,10,11,21
,2011,170900023,,,,5,2,7
HND-015963,2011,170900027,,,,11,8,19
HND-015964,2011,170900028,,,,4,1,5
HND-015989,2011,170900069,,,,23,17,40
,2011,170900070,,,,5,3,8
HND-015941,2011,170900001,,,,44,21,65
,2011,170900004,,,,5,6,11
HND-015943,2011,170900005,,,,0,3,3
HND-015944,2011,170900006,,,,11,10,21
,2011,170900009,,,,12,14,26
HND-015948,2011,170900010,,,,25,19,44
HND-015949,2011,170900011,,,,7,9,16
HND-015950,2011,170900012,,,,5,9,14
HND-015952,2011,170900014,,,,28,32,60
HND-015954,2011,170900016,,,,28,46,74
HND-015955,2011,170900017,,,,12,14,26
HND-015956,2011,170900018,,,,15,10,25
HND-015958,2011,170900020,,,,1,1,2
,2011,170900022,,,,11,13,24
HND-015961,2011,170900025,,,,26,29,55
HND-015964,2011,170900028,,,,3,7,10
HND-015966,2011,170900031,,,,26,29,55
HND-015989,2011,170900069,,,,17,25,42
,2011,170900079,,,,10,7,17
HND-015942,2011,170900003,,,,65,60,125
HND-015945,2011,170900007,,,,2,2,4
HND-015946,2011,170900008,,,,15,12,27
HND-015951,2011,170900013,,,,2,2,4
HND-015953,2011,170900015,,,,18,16,34
HND-015957,2011,170900019,,,,14,12,26
,2011,170900021,,,,6,11,17
,2011,170900023,,,,5,3,8
HND-015962,2011,170900026,,,,16,11,27
HND-015963,2011,170900027,,,,10,8,18
HND-015965,2011,170900030,,,,0,1,1
HND-015981,2011,170900055,,,,26,35,61
,2011,170900068,,,,5,6,11
,2011,170900070,,,,5,11,16
HND-015941,2011,170900001,,,,43,45,88
HND-015942,2011,170900003,,,,56,47,103
,2011,170900004,,,,8,1,9
HND-015943,2011,170900005,,,,3,3,6
HND-015946,2011,170900008,,,,15,12,27
,2011,170900009,,,,5,8,13
HND-015948,2011,170900010,,,,12,19,31
HND-015949,2011,170900011,,,,7,6,13
HND-015951,2011,170900013,,,,3,4,7
HND-015952,2011,170900014,,,,33,30,63
HND-015954,2011,170900016,,,,49,40,89
HND-015955,2011,170900017,,,,10,13,23
HND-015956,2011,170900018,,,,13,18,31
HND-015958,2011,170900020,,,,1,2,3
,2011,170900021,,,,14,11,25
HND-015963,2011,170900027,,,,12,12,24
HND-015964,2011,170900028,,,,11,7,18
HND-015965,2011,170900030,,,,3,0,3
HND-015966,2011,170900031,,,,30,28,58
HND-015989,2011,170900069,,,,29,23,52
,2011,170900079,,,,5,6,11
HND-015944,2011,170900006,,,,15,5,20
HND-015945,2011,170900007,,,,1,0,1
HND-015950,2011,170900012,,,,15,12,27
HND-015953,2011,170900015,,,,18,8,26
HND-015957,2011,170900019,,,,15,13,28
,2011,170900022,,,,11,13,24
,2011,170900023,,,,6,6,12
HND-015961,2011,170900025,,,,17,16,33
HND-015962,2011,170900026,,,,19,7,26
HND-015981,2011,170900055,,,,18,34,52
,2011,170900068,,,,8,1,9
,2011,170900070,,,,14,11,25
HND-015944,2011,170900006,,,,9,5,14
HND-015945,2011,170900007,,,,1,4,5
,2011,170900009,,,,12,4,16
HND-015948,2011,170900010,,,,23,17,40
HND-015949,2011,170900011,,,,5,4,9
HND-015950,2011,170900012,,,,12,12,24
HND-015952,2011,170900014,,,,28,37,65
HND-015953,2011,170900015,,,,13,15,28
HND-015954,2011,170900016,,,,41,44,85
HND-015956,2011,170900018,,,,17,21,38
HND-015958,2011,170900020,,,,0,1,1
,2011,170900022,,,,8,11,19
HND-015961,2011,170900025,,,,17,31,48
HND-015964,2011,170900028,,,,8,7,15
HND-015966,2011,170900031,,,,22,32,54
,2011,170900068,,,,4,4,8
,2011,170900070,,,,5,11,16
,2011,170900079,,,,6,10,16
HND-015941,2011,170900001,,,,33,30,63
HND-015942,2011,170900003,,,,53,57,110
,2011,170900004,,,,4,4,8
HND-015943,2011,170900005,,,,1,3,4
HND-015946,2011,170900008,,,,15,16,31
HND-015951,2011,170900013,,,,5,10,15
HND-015955,2011,170900017,,,,14,7,21
HND-015957,2011,170900019,,,,15,19,34
,2011,170900021,,,,14,8,22
,2011,170900023,,,,12,6,18
HND-015962,2011,170900026,,,,14,12,26
HND-015963,2011,170900027,,,,4,9,13
HND-015965,2011,170900030,,,,2,0,2
HND-015981,2011,170900055,,,,14,19,33
HND-015989,2011,170900069,,,,25,26,51
HND-015944,2011,170900006,,,,9,9,18
HND-015945,2011,170900007,,,,2,1,3
HND-015948,2011,170900010,,,,30,13,43
HND-015950,2011,170900012,,,,13,14,27
HND-015952,2011,170900014,,,,26,26,52
HND-015953,2011,170900015,,,,8,19,27
HND-015954,2011,170900016,,,,27,50,77
HND-015956,2011,170900018,,,,18,17,35
HND-015957,2011,170900019,,,,19,8,27
,2011,170900022,,,,17,9,26
HND-015961,2011,170900025,,,,29,21,50
,2011,170900068,,,,4,9,13
,2011,170900070,,,,17,8,25
,2011,170900079,,,,13,9,22
HND-015941,2011,170900001,,,,45,34,79
HND-015942,2011,170900003,,,,59,55,114
,2011,170900004,,,,4,9,13
HND-015943,2011,170900005,,,,6,0,6
HND-015946,2011,170900008,,,,21,26,47
,2011,170900009,,,,12,7,19
HND-015949,2011,170900011,,,,11,9,20
HND-015951,2011,170900013,,,,5,3,8
HND-015955,2011,170900017,,,,18,14,32
HND-015958,2011,170900020,,,,2,3,5
,2011,170900021,,,,12,11,23
,2011,170900023,,,,6,5,11
HND-015962,2011,170900026,,,,14,13,27
HND-015963,2011,170900027,,,,13,12,25
HND-015964,2011,170900028,,,,8,5,13
HND-015965,2011,170900030,,,,0,1,1
HND-015966,2011,170900031,,,,34,31,65
HND-015981,2011,170900055,,,,24,29,53
HND-015989,2011,170900069,,,,19,17,36
HND-015942,2011,170900003,,,,65,53,118
HND-015945,2011,170900007,,,,2,2,4
HND-015946,2011,170900008,,,,30,22,52
HND-015951,2011,170900013,,,,4,7,11
HND-015953,2011,170900015,,,,17,18,35
HND-015957,2011,170900019,,,,12,13,25
,2011,170900021,,,,5,1,6
,2011,170900023,,,,4,6,10
HND-015962,2011,170900026,,,,11,14,25
HND-015963,2011,170900027,,,,10,15,25
HND-015965,2011,170900030,,,,1,1,2
HND-015981,2011,170900055,,,,22,30,52
,2011,170900068,,,,4,5,9
,2011,170900070,,,,4,5,9
HND-015941,2011,170900001,,,,44,32,76
,2011,170900004,,,,4,5,9
HND-015943,2011,170900005,,,,3,3,6
HND-015944,2011,170900006,,,,12,11,23
,2011,170900009,,,,12,8,20
HND-015948,2011,170900010,,,,19,16,35
HND-015949,2011,170900011,,,,4,4,8
HND-015950,2011,170900012,,,,10,17,27
HND-015952,2011,170900014,,,,22,29,51
HND-015954,2011,170900016,,,,45,39,84
HND-015955,2011,170900017,,,,14,6,20
HND-015956,2011,170900018,,,,18,11,29
HND-015958,2011,170900020,,,,1,3,4
,2011,170900022,,,,18,14,32
HND-015961,2011,170900025,,,,14,26,40
HND-015964,2011,170900028,,,,10,6,16
HND-015966,2011,170900031,,,,32,35,67
HND-015989,2011,170900069,,,,20,19,39
,2011,170900079,,,,5,9,14
HND-015948,2011,170900010,,,,11,11,22
HND-015953,2011,170900015,,,,16,14,30
HND-015941,2011,170900001,,,,56,46,102
HND-015946,2011,170900008,,,,21,18,39
,2011,170900009,,,,10,7,17
HND-015954,2011,170900016,,,,2,16,18
HND-015955,2011,170900017,,,,18,14,32
HND-015979,2011,170900051,,,,257,260,517
HND-015980,2011,170900052,,,,25,7,32
,2011,170900054,,,,4,1,5
HND-015981,2011,170900055,,,,14,20,34
,2011,170900068,,,,12,21,33
HND-015941,2011,170900001,,,,35,44,79
,2011,170900009,,,,4,6,10
HND-015948,2011,170900010,,,,6,12,18
HND-015954,2011,170900016,,,,5,8,13
HND-015955,2011,170900017,,,,22,11,33
HND-015980,2011,170900052,,,,8,9,17
,2011,170900054,,,,4,2,6
,2011,170900068,,,,8,15,23
HND-015946,2011,170900008,,,,19,17,36
HND-015953,2011,170900015,,,,11,20,31
HND-015979,2011,170900051,,,,222,266,488
HND-015981,2011,170900055,,,,11,15,26
,2011,170900009,,,,8,9,17
HND-015948,2011,170900010,,,,12,10,22
HND-015953,2011,170900015,,,,8,7,15
HND-015954,2011,170900016,,,,5,4,9
,2011,170900054,,,,4,5,9
,2011,170900068,,,,14,7,21
HND-015941,2011,170900001,,,,24,55,79
HND-015946,2011,170900008,,,,12,16,28
HND-015955,2011,170900017,,,,13,13,26
HND-015979,2011,170900051,,,,201,244,445
HND-015980,2011,170900052,,,,6,3,9
HND-015981,2011,170900055,,,,15,17,32
HND-015948,2011,170900010,,,,6,10,16
HND-015979,2011,170900051,,,,260,298,558
,2011,170900068,,,,5,16,21
HND-015941,2011,170900001,,,,20,30,50
,2011,170900054,,,,22,7,29
HND-015948,2011,170900010,,,,15,13,28
HND-015979,2011,170900051,,,,208,300,508
,2011,170900068,,,,17,12,29
HND-015941,2011,170900001,,,,18,19,37
,2011,170900054,,,,19,7,26
HND-015941,2011,170900001,,,,8,13,21
,2011,170900054,,,,13,11,24
HND-015979,2011,170900051,,,,151,245,396
,2011,170900068,,,,2,2,4
HND-015994,2011,180100003,,,,5,6,11
HND-016003,2011,180100012,,,,7,12,19
HND-016018,2011,180100027,,,,5,7,12
HND-016022,2011,180100031,,,,7,10,17
HND-016028,2011,180100037,,,,6,11,17
HND-016100,2011,180100125,,,,4,6,10
HND-016120,2011,180100159,,,,11,8,19
HND-016136,2011,180100184,,,,6,4,10
,2011,180100188,,,,0,1,1
HND-016152,2011,180100216,,,,6,4,10
HND-016170,2011,180100236,,,,6,1,7
HND-016176,2011,180100242,,,,4,5,9
,2011,180100272,,,,9,5,14
,2011,180100274,,,,3,7,10
HND-016191,2011,180100285,,,,6,5,11
,2011,180100288,,,,6,4,10
,2011,180100322,,,,3,7,10
,2011,180100353,,,,6,3,9
HND-016197,2011,180100354,,,,7,10,17
,2011,180100360,,,,6,7,13
,2011,180100361,,,,7,9,16
,2011,180100364,,,,10,10,20
HND-016199,2011,180100365,,,,6,9,15
HND-016208,2011,180100380,,,,7,3,10
HND-016216,2011,180100394,,,,8,5,13
,2011,180100399,,,,8,3,11
,2011,180100400,,,,6,4,10
,2011,180100403,,,,3,4,7
,2011,180100405,,,,5,14,19
,2011,180100410,,,,0,1,1
HND-016223,2011,180100412,,,,13,3,16
,2011,180100413,,,,8,4,12
HND-016225,2011,180100417,,,,5,7,12
,2011,180100418,,,,6,8,14
HND-016229,2011,180100425,,,,8,2,10
,2011,180100427,,,,6,4,10
HND-016231,2011,180100431,,,,7,8,15
,2011,180100439,,,,10,5,15
HND-016237,2011,180100441,,,,8,12,20
HND-016238,2011,180100444,,,,3,5,8
,2011,180100450,,,,3,8,11
,2011,180100458,,,,8,3,11
HND-016244,2011,180100461,,,,6,3,9
,2011,180100462,,,,5,6,11
,2011,180100465,,,,6,3,9
HND-016247,2011,180100467,,,,9,5,14
,2011,180100471,,,,13,7,20
,2011,180100472,,,,5,6,11
HND-016250,2011,180100474,,,,9,6,15
,2011,180100482,,,,8,6,14
HND-016253,2011,180100487,,,,7,6,13
HND-016254,2011,180100490,,,,10,14,24
,2011,180100493,,,,8,12,20
HND-016006,2011,180100015,,,,10,7,17
HND-016013,2011,180100022,,,,8,2,10
HND-016019,2011,180100028,,,,9,9,18
HND-016035,2011,180100045,,,,5,3,8
HND-016038,2011,180100049,,,,6,4,10
HND-016057,2011,180100071,,,,5,5,10
HND-016070,2011,180100085,,,,8,7,15
HND-016071,2011,180100086,,,,6,5,11
HND-016121,2011,180100160,,,,5,3,8
HND-016125,2011,180100165,,,,4,12,16
HND-016151,2011,180100215,,,,6,4,10
,2011,180100277,,,,4,6,10
HND-016190,2011,180100281,,,,6,5,11
,2011,180100286,,,,11,8,19
HND-016192,2011,180100289,,,,11,7,18
,2011,180100290,,,,6,10,16
,2011,180100297,,,,4,11,15
HND-016195,2011,180100349,,,,5,5,10
,2011,180100351,,,,5,4,9
HND-016196,2011,180100352,,,,10,4,14
,2011,180100355,,,,5,7,12
,2011,180100358,,,,5,3,8
,2011,180100362,,,,8,2,10
HND-016200,2011,180100368,,,,7,5,12
HND-016207,2011,180100378,,,,5,9,14
HND-016220,2011,180100401,,,,4,5,9
,2011,180100402,,,,9,3,12
,2011,180100404,,,,15,11,26
,2011,180100406,,,,4,12,16
,2011,180100407,,,,3,5,8
HND-016222,2011,180100411,,,,5,8,13
,2011,180100414,,,,4,7,11
HND-016224,2011,180100415,,,,7,3,10
,2011,180100416,,,,5,5,10
HND-016226,2011,180100419,,,,7,6,13
,2011,180100420,,,,5,9,14
HND-016228,2011,180100423,,,,11,10,21
,2011,180100424,,,,5,6,11
HND-016230,2011,180100426,,,,6,7,13
,2011,180100428,,,,12,10,22
,2011,180100430,,,,6,7,13
HND-016233,2011,180100434,,,,9,9,18
,2011,180100436,,,,2,9,11
HND-016236,2011,180100438,,,,7,8,15
,2011,180100442,,,,6,1,7
,2011,180100443,,,,8,1,9
,2011,180100451,,,,10,5,15
,2011,180100452,,,,6,6,12
,2011,180100459,,,,11,6,17
HND-016243,2011,180100460,,,,7,3,10
HND-016245,2011,180100463,,,,4,11,15
,2011,180100464,,,,10,10,20
HND-016246,2011,180100466,,,,5,7,12
,2011,180100470,,,,9,6,15
,2011,180100473,,,,10,10,20
,2011,180100476,,,,11,9,20
,2011,180100486,,,,9,3,12
,2011,180100489,,,,7,4,11
,2011,180100494,,,,5,3,8
,2011,180100495,,,,6,4,10
HND-016029,2011,180100038,,,,1,2,3
HND-016108,2011,180100143,,,,3,1,4
,2011,180100243,,,,0,2,2
,2011,180100244,,,,1,4,5
HND-016204,2011,180100373,,,,4,1,5
,2011,180100384,,,,0,1,1
HND-016217,2011,180100396,,,,2,1,3
,2011,180100440,,,,2,0,2
HND-016107,2011,180100140,,,,21,20,41
HND-016131,2011,180100173,,,,8,11,19
HND-016209,2011,180100387,,,,2,2,4
HND-016005,2011,180100014,,,,2,2,4
HND-016029,2011,180100038,,,,4,5,9
HND-016032,2011,180100041,,,,6,4,10
HND-016069,2011,180100084,,,,1,5,6
HND-016089,2011,180100107,,,,14,29,43
HND-016090,2011,180100108,,,,12,26,38
,2011,180100110,,,,1,1,2
HND-016098,2011,180100120,,,,13,10,23
,2011,180100123,,,,6,9,15
,2011,180100128,,,,7,2,9
,2011,180100130,,,,1,4,5
,2011,180100132,,,,5,12,17
,2011,180100133,,,,8,3,11
,2011,180100134,,,,6,9,15
,2011,180100137,,,,8,2,10
HND-016107,2011,180100140,,,,26,17,43
HND-016108,2011,180100143,,,,1,4,5
,2011,180100144,,,,1,2,3
HND-016110,2011,180100146,,,,1,2,3
,2011,180100158,,,,3,7,10
HND-016131,2011,180100173,,,,7,5,12
HND-016134,2011,180100178,,,,0,5,5
,2011,180100179,,,,1,1,2
HND-016146,2011,180100203,,,,3,5,8
HND-016152,2011,180100216,,,,6,5,11
HND-016153,2011,180100217,,,,2,5,7
HND-016161,2011,180100226,,,,5,4,9
HND-016171,2011,180100237,,,,1,1,2
,2011,180100244,,,,1,1,2
,2011,180100251,,,,0,2,2
,2011,180100280,,,,4,2,6
,2011,180100369,,,,1,4,5
HND-016204,2011,180100373,,,,1,4,5
HND-016214,2011,180100392,,,,4,0,4
HND-016217,2011,180100396,,,,3,0,3
HND-016227,2011,180100422,,,,3,3,6
HND-016251,2011,180100475,,,,0,5,5
,2011,180100477,,,,6,3,9
,2011,180100479,,,,1,7,8
,2011,180100483,,,,5,4,9
HND-016252,2011,180100484,,,,10,5,15
HND-015999,2011,180100008,,,,6,11,17
HND-016027,2011,180100036,,,,3,2,5
HND-016034,2011,180100044,,,,2,5,7
HND-016085,2011,180100103,,,,6,6,12
HND-016086,2011,180100104,,,,8,8,16
,2011,180100112,,,,7,0,7
HND-016092,2011,180100114,,,,7,8,15
HND-016097,2011,180100119,,,,10,12,22
HND-016102,2011,180100129,,,,5,3,8
HND-016103,2011,180100135,,,,2,2,4
HND-016104,2011,180100136,,,,7,7,14
HND-016105,2011,180100138,,,,8,10,18
,2011,180100171,,,,6,8,14
HND-016132,2011,180100174,,,,8,2,10
HND-016133,2011,180100176,,,,3,7,10
,2011,180100180,,,,6,5,11
HND-016143,2011,180100194,,,,5,9,14
,2011,180100243,,,,1,2,3
,2011,180100246,,,,4,5,9
HND-016182,2011,180100255,,,,4,2,6
HND-016189,2011,180100273,,,,6,3,9
,2011,180100384,,,,2,0,2
HND-016209,2011,180100387,,,,3,3,6
HND-016221,2011,180100409,,,,4,7,11
,2011,180100432,,,,5,4,9
,2011,180100440,,,,2,3,5
HND-016242,2011,180100457,,,,4,4,8
,2011,180100478,,,,1,1,2
,2011,180100480,,,,0,5,5
,2011,180100481,,,,4,2,6
HND-016011,2011,180100020,,,,6,5,11
HND-016029,2011,180100038,,,,5,2,7
HND-016032,2011,180100041,,,,9,9,18
HND-016034,2011,180100044,,,,5,10,15
HND-016069,2011,180100084,,,,4,8,12
HND-016085,2011,180100103,,,,9,9,18
HND-016086,2011,180100104,,,,36,33,69
,2011,180100112,,,,13,17,30
HND-016092,2011,180100114,,,,46,45,91
HND-016097,2011,180100119,,,,12,17,29
HND-016104,2011,180100136,,,,15,9,24
HND-016105,2011,180100138,,,,19,11,30
HND-016131,2011,180100173,,,,5,4,9
HND-016132,2011,180100174,,,,9,9,18
HND-016133,2011,180100176,,,,4,6,10
HND-016134,2011,180100178,,,,2,5,7
HND-016143,2011,180100194,,,,9,11,20
,2011,180100243,,,,4,6,10
,2011,180100246,,,,4,2,6
HND-016178,2011,180100250,,,,8,7,15
HND-016182,2011,180100255,,,,5,6,11
HND-016189,2011,180100273,,,,4,5,9
,2011,180100369,,,,3,8,11
,2011,180100384,,,,8,3,11
HND-016209,2011,180100387,,,,2,3,5
HND-016214,2011,180100392,,,,1,7,8
,2011,180100440,,,,4,5,9
,2011,180100478,,,,9,4,13
,2011,180100480,,,,2,5,7
,2011,180100481,,,,6,3,9
HND-015999,2011,180100008,,,,10,10,20
HND-016005,2011,180100014,,,,22,18,40
HND-016027,2011,180100036,,,,5,10,15
HND-016071,2011,180100086,,,,7,6,13
HND-016089,2011,180100107,,,,38,38,76
HND-016090,2011,180100108,,,,37,47,84
,2011,180100109,,,,15,13,28
,2011,180100110,,,,7,5,12
HND-016098,2011,180100120,,,,10,7,17
,2011,180100128,,,,4,7,11
HND-016102,2011,180100129,,,,7,5,12
,2011,180100130,,,,15,9,24
,2011,180100132,,,,19,28,47
,2011,180100134,,,,16,11,27
HND-016103,2011,180100135,,,,10,6,16
,2011,180100137,,,,8,4,12
HND-016107,2011,180100140,,,,34,24,58
HND-016108,2011,180100143,,,,3,3,6
,2011,180100144,,,,9,3,12
HND-016110,2011,180100146,,,,7,10,17
,2011,180100158,,,,4,6,10
,2011,180100179,,,,11,5,16
,2011,180100180,,,,6,8,14
HND-016146,2011,180100203,,,,3,5,8
HND-016152,2011,180100216,,,,5,4,9
HND-016153,2011,180100217,,,,11,14,25
HND-016161,2011,180100226,,,,6,6,12
HND-016171,2011,180100237,,,,1,1,2
,2011,180100244,,,,6,5,11
,2011,180100251,,,,7,6,13
,2011,180100280,,,,5,6,11
HND-016204,2011,180100373,,,,5,4,9
HND-016217,2011,180100396,,,,5,10,15
HND-016227,2011,180100422,,,,11,7,18
,2011,180100432,,,,6,5,11
HND-016242,2011,180100457,,,,4,6,10
HND-016251,2011,180100475,,,,2,5,7
,2011,180100477,,,,4,2,6
,2011,180100479,,,,6,10,16
,2011,180100483,,,,5,5,10
HND-016252,2011,180100484,,,,9,8,17
HND-015994,2011,180100003,,,,7,8,15
HND-015998,2011,180100007,,,,20,16,36
HND-016000,2011,180100009,,,,26,18,44
HND-016002,2011,180100011,,,,3,7,10
HND-016004,2011,180100013,,,,3,6,9
HND-016005,2011,180100014,,,,36,31,67
HND-016007,2011,180100016,,,,34,34,68
HND-016008,2011,180100017,,,,20,12,32
HND-016014,2011,180100023,,,,1,1,2
HND-016016,2011,180100025,,,,6,4,10
HND-016017,2011,180100026,,,,5,8,13
HND-016020,2011,180100029,,,,8,10,18
HND-016022,2011,180100031,,,,11,10,21
HND-016024,2011,180100033,,,,5,0,5
HND-016025,2011,180100034,,,,6,4,10
HND-016027,2011,180100036,,,,12,10,22
HND-016028,2011,180100037,,,,13,7,20
HND-016036,2011,180100046,,,,2,4,6
,2011,180100047,,,,6,2,8
HND-016038,2011,180100049,,,,4,5,9
HND-016039,2011,180100050,,,,16,9,25
HND-016042,2011,180100053,,,,22,8,30
HND-016045,2011,180100057,,,,6,2,8
HND-016046,2011,180100058,,,,7,6,13
HND-016048,2011,180100060,,,,5,7,12
,2011,180100062,,,,11,7,18
HND-016050,2011,180100064,,,,9,2,11
HND-016051,2011,180100065,,,,12,16,28
HND-016054,2011,180100068,,,,5,3,8
HND-016056,2011,180100070,,,,10,12,22
HND-016058,2011,180100072,,,,27,12,39
,2011,180100074,,,,2,4,6
HND-016060,2011,180100075,,,,3,2,5
HND-016063,2011,180100078,,,,6,2,8
HND-016064,2011,180100079,,,,13,6,19
HND-016066,2011,180100081,,,,10,4,14
HND-016068,2011,180100083,,,,14,13,27
HND-016071,2011,180100086,,,,8,11,19
HND-016072,2011,180100087,,,,5,13,18
HND-016075,2011,180100090,,,,5,3,8
HND-016076,2011,180100091,,,,6,4,10
,2011,180100093,,,,4,7,11
HND-016077,2011,180100094,,,,4,5,9
HND-016078,2011,180100096,,,,26,33,59
HND-016079,2011,180100097,,,,6,3,9
HND-016080,2011,180100098,,,,13,2,15
HND-016083,2011,180100101,,,,54,52,106
HND-016087,2011,180100105,,,,6,5,11
,2011,180100110,,,,2,14,16
HND-016093,2011,180100115,,,,4,5,9
HND-016095,2011,180100117,,,,6,3,9
HND-016096,2011,180100118,,,,9,7,16
HND-016099,2011,180100122,,,,2,5,7
HND-016100,2011,180100125,,,,6,2,8
HND-016101,2011,180100126,,,,15,9,24
HND-016108,2011,180100143,,,,6,6,12
HND-016111,2011,180100147,,,,16,13,29
HND-016112,2011,180100148,,,,6,2,8
HND-016115,2011,180100151,,,,7,7,14
HND-016119,2011,180100157,,,,2,3,5
HND-016120,2011,180100159,,,,10,8,18
,2011,180100161,,,,2,2,4
HND-016125,2011,180100165,,,,5,1,6
HND-016129,2011,180100169,,,,14,9,23
HND-016130,2011,180100170,,,,22,8,30
HND-016133,2011,180100176,,,,14,10,24
HND-016134,2011,180100178,,,,3,3,6
HND-016138,2011,180100189,,,,12,6,18
HND-016139,2011,180100190,,,,9,11,20
HND-016142,2011,180100193,,,,10,9,19
HND-016143,2011,180100194,,,,2,4,6
,2011,180100195,,,,13,8,21
HND-016145,2011,180100197,,,,3,3,6
HND-016147,2011,180100204,,,,7,6,13
HND-016152,2011,180100216,,,,4,3,7
HND-016155,2011,180100219,,,,7,7,14
HND-016158,2011,180100222,,,,23,13,36
HND-016160,2011,180100225,,,,14,8,22
HND-016161,2011,180100226,,,,15,15,30
HND-016167,2011,180100233,,,,2,1,3
HND-016170,2011,180100236,,,,13,4,17
HND-016171,2011,180100237,,,,5,3,8
HND-016173,2011,180100239,,,,8,10,18
HND-016174,2011,180100240,,,,5,3,8
HND-016176,2011,180100242,,,,6,7,13
HND-016177,2011,180100245,,,,4,7,11
HND-016180,2011,180100253,,,,8,6,14
HND-016182,2011,180100255,,,,7,12,19
HND-016184,2011,180100259,,,,5,11,16
,2011,180100262,,,,6,6,12
HND-016185,2011,180100264,,,,21,41,62
HND-016186,2011,180100268,,,,2,2,4
HND-016188,2011,180100270,,,,6,3,9
HND-016193,2011,180100292,,,,13,14,27
HND-016194,2011,180100326,,,,2,3,5
HND-016202,2011,180100371,,,,12,7,19
HND-016203,2011,180100372,,,,10,5,15
HND-016204,2011,180100373,,,,1,2,3
HND-016210,2011,180100388,,,,3,1,4
HND-016215,2011,180100393,,,,3,1,4
HND-016233,2011,180100434,,,,16,12,28
HND-016234,2011,180100435,,,,5,4,9
HND-016240,2011,180100455,,,,10,14,24
HND-016249,2011,180100469,,,,2,3,5
,2011,180100485,,,,6,6,12
,2011,180100001,,,,4,6,10
HND-015993,2011,180100002,,,,10,7,17
HND-015995,2011,180100004,,,,8,7,15
HND-015996,2011,180100005,,,,7,12,19
HND-015997,2011,180100006,,,,66,59,125
HND-015999,2011,180100008,,,,22,15,37
HND-016001,2011,180100010,,,,48,39,87
HND-016006,2011,180100015,,,,9,4,13
HND-016009,2011,180100018,,,,6,0,6
HND-016010,2011,180100019,,,,11,3,14
HND-016011,2011,180100020,,,,11,5,16
HND-016012,2011,180100021,,,,7,9,16
HND-016013,2011,180100022,,,,4,4,8
HND-016015,2011,180100024,,,,2,2,4
HND-016018,2011,180100027,,,,5,4,9
HND-016019,2011,180100028,,,,10,7,17
HND-016021,2011,180100030,,,,5,2,7
HND-016023,2011,180100032,,,,13,7,20
HND-016026,2011,180100035,,,,4,2,6
HND-016029,2011,180100038,,,,6,6,12
HND-016030,2011,180100039,,,,15,19,34
HND-016031,2011,180100040,,,,15,13,28
HND-016032,2011,180100041,,,,17,10,27
HND-016033,2011,180100042,,,,6,1,7
HND-016034,2011,180100044,,,,11,15,26
HND-016035,2011,180100045,,,,2,4,6
HND-016037,2011,180100048,,,,3,2,5
HND-016040,2011,180100051,,,,30,21,51
HND-016041,2011,180100052,,,,11,7,18
HND-016043,2011,180100055,,,,7,5,12
HND-016044,2011,180100056,,,,7,9,16
HND-016047,2011,180100059,,,,3,4,7
HND-016052,2011,180100066,,,,8,1,9
HND-016053,2011,180100067,,,,6,2,8
HND-016055,2011,180100069,,,,15,9,24
HND-016057,2011,180100071,,,,3,6,9
HND-016059,2011,180100073,,,,9,8,17
HND-016061,2011,180100076,,,,2,7,9
HND-016062,2011,180100077,,,,1,2,3
HND-016065,2011,180100080,,,,6,5,11
HND-016067,2011,180100082,,,,4,4,8
HND-016069,2011,180100084,,,,3,7,10
HND-016070,2011,180100085,,,,5,5,10
HND-016073,2011,180100088,,,,4,4,8
HND-016074,2011,180100089,,,,3,8,11
,2011,180100092,,,,1,1,2
HND-016081,2011,180100099,,,,7,14,21
HND-016082,2011,180100100,,,,13,13,26
HND-016084,2011,180100102,,,,7,6,13
HND-016085,2011,180100103,,,,16,16,32
HND-016086,2011,180100104,,,,71,70,141
HND-016088,2011,180100106,,,,5,8,13
HND-016094,2011,180100116,,,,7,3,10
HND-016102,2011,180100129,,,,5,4,9
HND-016106,2011,180100139,,,,14,12,26
,2011,180100141,,,,3,2,5
HND-016109,2011,180100145,,,,9,4,13
HND-016113,2011,180100149,,,,32,30,62
HND-016114,2011,180100150,,,,2,6,8
HND-016116,2011,180100152,,,,13,14,27
HND-016117,2011,180100153,,,,1,6,7
HND-016118,2011,180100154,,,,12,7,19
HND-016121,2011,180100160,,,,10,11,21
HND-016122,2011,180100162,,,,13,10,23
HND-016123,2011,180100163,,,,8,4,12
HND-016124,2011,180100164,,,,8,5,13
HND-016126,2011,180100166,,,,9,12,21
HND-016127,2011,180100167,,,,4,4,8
HND-016128,2011,180100168,,,,2,5,7
,2011,180100171,,,,9,10,19
HND-016135,2011,180100183,,,,6,1,7
HND-016136,2011,180100184,,,,5,6,11
HND-016137,2011,180100186,,,,3,4,7
,2011,180100188,,,,4,5,9
HND-016140,2011,180100191,,,,6,5,11
HND-016141,2011,180100192,,,,21,13,34
HND-016144,2011,180100196,,,,9,10,19
HND-016148,2011,180100207,,,,8,12,20
HND-016149,2011,180100211,,,,13,11,24
HND-016150,2011,180100214,,,,8,5,13
HND-016151,2011,180100215,,,,8,4,12
HND-016154,2011,180100218,,,,1,3,4
HND-016156,2011,180100220,,,,13,13,26
HND-016157,2011,180100221,,,,8,8,16
HND-016159,2011,180100223,,,,9,3,12
,2011,180100224,,,,14,9,23
HND-016162,2011,180100227,,,,15,13,28
HND-016163,2011,180100229,,,,9,4,13
HND-016164,2011,180100230,,,,13,11,24
HND-016165,2011,180100231,,,,4,3,7
HND-016166,2011,180100232,,,,18,10,28
HND-016168,2011,180100234,,,,5,3,8
HND-016169,2011,180100235,,,,8,3,11
HND-016172,2011,180100238,,,,6,7,13
HND-016175,2011,180100241,,,,3,1,4
HND-016179,2011,180100252,,,,10,13,23
HND-016181,2011,180100254,,,,11,3,14
HND-016183,2011,180100257,,,,9,7,16
,2011,180100258,,,,6,4,10
HND-016187,2011,180100269,,,,2,2,4
HND-016205,2011,180100374,,,,4,5,9
HND-016206,2011,180100375,,,,5,4,9
HND-016211,2011,180100389,,,,14,4,18
HND-016212,2011,180100390,,,,13,10,23
HND-016213,2011,180100391,,,,2,3,5
HND-016214,2011,180100392,,,,4,6,10
HND-016218,2011,180100397,,,,7,6,13
HND-016219,2011,180100398,,,,24,9,33
HND-016232,2011,180100433,,,,2,1,3
,2011,180100453,,,,4,4,8
HND-016239,2011,180100454,,,,6,4,10
HND-016241,2011,180100456,,,,5,6,11
HND-016242,2011,180100457,,,,13,12,25
HND-016248,2011,180100468,,,,6,2,8
HND-016255,2011,180100491,,,,3,3,6
,2011,180100492,,,,6,10,16
HND-015993,2011,180100002,,,,4,5,9
HND-015996,2011,180100005,,,,3,7,10
HND-016000,2011,180100009,,,,12,15,27
HND-016001,2011,180100010,,,,45,44,89
HND-016004,2011,180100013,,,,6,8,14
HND-016006,2011,180100015,,,,4,5,9
HND-016007,2011,180100016,,,,38,35,73
HND-016010,2011,180100019,,,,3,6,9
HND-016011,2011,180100020,,,,3,8,11
HND-016013,2011,180100022,,,,3,0,3
HND-016015,2011,180100024,,,,3,5,8
HND-016019,2011,180100028,,,,6,4,10
HND-016020,2011,180100029,,,,6,10,16
HND-016021,2011,180100030,,,,4,7,11
HND-016022,2011,180100031,,,,7,3,10
HND-016023,2011,180100032,,,,4,5,9
HND-016025,2011,180100034,,,,2,7,9
HND-016028,2011,180100037,,,,11,7,18
HND-016029,2011,180100038,,,,5,3,8
HND-016032,2011,180100041,,,,9,14,23
HND-016034,2011,180100044,,,,15,14,29
HND-016036,2011,180100046,,,,6,3,9
,2011,180100047,,,,5,0,5
HND-016039,2011,180100050,,,,5,7,12
HND-016040,2011,180100051,,,,28,29,57
HND-016041,2011,180100052,,,,21,6,27
HND-016046,2011,180100058,,,,9,4,13
HND-016048,2011,180100060,,,,8,3,11
HND-016049,2011,180100061,,,,5,6,11
HND-016050,2011,180100064,,,,3,3,6
HND-016052,2011,180100066,,,,3,1,4
HND-016053,2011,180100067,,,,3,2,5
HND-016054,2011,180100068,,,,3,4,7
HND-016060,2011,180100075,,,,5,4,9
HND-016061,2011,180100076,,,,9,6,15
HND-016064,2011,180100079,,,,6,8,14
HND-016065,2011,180100080,,,,2,5,7
HND-016066,2011,180100081,,,,3,12,15
HND-016067,2011,180100082,,,,1,4,5
HND-016068,2011,180100083,,,,13,3,16
HND-016069,2011,180100084,,,,9,2,11
HND-016072,2011,180100087,,,,6,8,14
HND-016073,2011,180100088,,,,3,3,6
HND-016075,2011,180100090,,,,0,1,1
HND-016076,2011,180100091,,,,5,6,11
,2011,180100092,,,,6,1,7
HND-016077,2011,180100094,,,,1,3,4
HND-016080,2011,180100098,,,,10,3,13
HND-016082,2011,180100100,,,,12,9,21
HND-016085,2011,180100103,,,,7,12,19
HND-016086,2011,180100104,,,,62,57,119
HND-016087,2011,180100105,,,,6,5,11
HND-016088,2011,180100106,,,,7,5,12
HND-016094,2011,180100116,,,,1,2,3
HND-016095,2011,180100117,,,,3,1,4
HND-016096,2011,180100118,,,,4,3,7
HND-016099,2011,180100122,,,,3,4,7
HND-016101,2011,180100126,,,,12,16,28
HND-016106,2011,180100139,,,,9,8,17
,2011,180100141,,,,6,10,16
HND-016113,2011,180100149,,,,24,22,46
HND-016114,2011,180100150,,,,4,1,5
HND-016116,2011,180100152,,,,5,9,14
HND-016117,2011,180100153,,,,7,5,12
HND-016118,2011,180100154,,,,8,4,12
HND-016119,2011,180100157,,,,1,0,1
HND-016121,2011,180100160,,,,3,4,7
HND-016123,2011,180100163,,,,4,1,5
HND-016124,2011,180100164,,,,3,2,5
HND-016125,2011,180100165,,,,7,6,13
HND-016126,2011,180100166,,,,4,12,16
HND-016127,2011,180100167,,,,2,1,3
HND-016128,2011,180100168,,,,5,10,15
HND-016130,2011,180100170,,,,22,17,39
,2011,180100171,,,,6,3,9
HND-016133,2011,180100176,,,,2,6,8
HND-016134,2011,180100178,,,,2,3,5
HND-016138,2011,180100189,,,,6,7,13
HND-016139,2011,180100190,,,,5,3,8
HND-016141,2011,180100192,,,,18,7,25
HND-016142,2011,180100193,,,,14,9,23
HND-016143,2011,180100194,,,,7,3,10
HND-016144,2011,180100196,,,,13,8,21
HND-016145,2011,180100197,,,,3,4,7
HND-016147,2011,180100204,,,,3,4,7
HND-016151,2011,180100215,,,,1,0,1
HND-016154,2011,180100218,,,,5,8,13
HND-016156,2011,180100220,,,,2,2,4
HND-016157,2011,180100221,,,,5,7,12
HND-016158,2011,180100222,,,,0,5,5
,2011,180100224,,,,8,9,17
HND-016160,2011,180100225,,,,6,4,10
HND-016166,2011,180100232,,,,9,6,15
HND-016169,2011,180100235,,,,4,5,9
HND-016172,2011,180100238,,,,3,7,10
HND-016173,2011,180100239,,,,10,4,14
HND-016174,2011,180100240,,,,3,5,8
HND-016175,2011,180100241,,,,2,2,4
HND-016181,2011,180100254,,,,5,13,18
HND-016182,2011,180100255,,,,9,5,14
,2011,180100258,,,,1,1,2
HND-016184,2011,180100259,,,,2,3,5
,2011,180100262,,,,5,1,6
HND-016186,2011,180100268,,,,5,2,7
HND-016194,2011,180100326,,,,2,3,5
HND-016202,2011,180100371,,,,10,17,27
HND-016203,2011,180100372,,,,3,7,10
HND-016206,2011,180100375,,,,2,3,5
HND-016210,2011,180100388,,,,0,1,1
HND-016212,2011,180100390,,,,5,7,12
HND-016213,2011,180100391,,,,1,0,1
HND-016214,2011,180100392,,,,3,3,6
HND-016215,2011,180100393,,,,3,1,4
HND-016219,2011,180100398,,,,9,4,13
HND-016232,2011,180100433,,,,6,2,8
HND-016233,2011,180100434,,,,3,1,4
HND-016239,2011,180100454,,,,4,6,10
HND-016240,2011,180100455,,,,7,1,8
HND-016241,2011,180100456,,,,5,4,9
HND-016242,2011,180100457,,,,16,9,25
HND-016248,2011,180100468,,,,3,5,8
,2011,180100485,,,,0,2,2
HND-016255,2011,180100491,,,,2,4,6
,2011,180100492,,,,1,0,1
,2011,180100001,,,,3,5,8
HND-015994,2011,180100003,,,,3,3,6
HND-015995,2011,180100004,,,,3,3,6
HND-015997,2011,180100006,,,,52,43,95
HND-015998,2011,180100007,,,,12,14,26
HND-015999,2011,180100008,,,,22,20,42
HND-016002,2011,180100011,,,,0,6,6
HND-016003,2011,180100012,,,,4,2,6
HND-016005,2011,180100014,,,,21,21,42
HND-016008,2011,180100017,,,,13,15,28
HND-016009,2011,180100018,,,,4,3,7
HND-016012,2011,180100021,,,,3,6,9
HND-016017,2011,180100026,,,,9,10,19
HND-016018,2011,180100027,,,,1,0,1
HND-016024,2011,180100033,,,,3,1,4
HND-016026,2011,180100035,,,,2,3,5
HND-016027,2011,180100036,,,,12,8,20
HND-016030,2011,180100039,,,,4,8,12
HND-016031,2011,180100040,,,,17,7,24
HND-016033,2011,180100042,,,,2,7,9
HND-016035,2011,180100045,,,,2,2,4
HND-016037,2011,180100048,,,,4,1,5
HND-016038,2011,180100049,,,,5,3,8
HND-016042,2011,180100053,,,,22,17,39
HND-016044,2011,180100056,,,,4,5,9
HND-016045,2011,180100057,,,,4,8,12
HND-016047,2011,180100059,,,,2,2,4
,2011,180100062,,,,3,5,8
HND-016051,2011,180100065,,,,6,9,15
HND-016055,2011,180100069,,,,12,14,26
HND-016056,2011,180100070,,,,8,3,11
HND-016057,2011,180100071,,,,5,3,8
HND-016058,2011,180100072,,,,25,30,55
HND-016059,2011,180100073,,,,5,2,7
,2011,180100074,,,,3,2,5
HND-016062,2011,180100077,,,,3,0,3
HND-016063,2011,180100078,,,,5,6,11
HND-016070,2011,180100085,,,,3,4,7
HND-016071,2011,180100086,,,,5,5,10
HND-016074,2011,180100089,,,,10,4,14
,2011,180100093,,,,5,2,7
HND-016078,2011,180100096,,,,27,16,43
HND-016079,2011,180100097,,,,7,2,9
HND-016081,2011,180100099,,,,6,4,10
HND-016083,2011,180100101,,,,63,59,122
HND-016084,2011,180100102,,,,4,3,7
,2011,180100110,,,,9,13,22
HND-016093,2011,180100115,,,,3,3,6
HND-016100,2011,180100125,,,,4,5,9
HND-016102,2011,180100129,,,,4,8,12
HND-016108,2011,180100143,,,,9,5,14
HND-016109,2011,180100145,,,,4,5,9
HND-016111,2011,180100147,,,,2,4,6
HND-016112,2011,180100148,,,,5,0,5
HND-016115,2011,180100151,,,,10,6,16
HND-016120,2011,180100159,,,,11,7,18
,2011,180100161,,,,0,7,7
HND-016122,2011,180100162,,,,7,2,9
HND-016129,2011,180100169,,,,4,6,10
HND-016135,2011,180100183,,,,2,1,3
HND-016136,2011,180100184,,,,5,4,9
HND-016137,2011,180100186,,,,5,0,5
,2011,180100188,,,,8,5,13
HND-016140,2011,180100191,,,,8,5,13
,2011,180100195,,,,8,9,17
HND-016148,2011,180100207,,,,4,6,10
HND-016149,2011,180100211,,,,9,0,9
HND-016150,2011,180100214,,,,14,7,21
HND-016152,2011,180100216,,,,3,2,5
HND-016155,2011,180100219,,,,0,3,3
HND-016159,2011,180100223,,,,14,0,14
HND-016161,2011,180100226,,,,5,3,8
HND-016162,2011,180100227,,,,17,8,25
HND-016163,2011,180100229,,,,7,5,12
HND-016164,2011,180100230,,,,13,14,27
HND-016165,2011,180100231,,,,2,1,3
HND-016167,2011,180100233,,,,1,1,2
HND-016168,2011,180100234,,,,4,4,8
HND-016170,2011,180100236,,,,5,2,7
HND-016171,2011,180100237,,,,10,1,11
HND-016176,2011,180100242,,,,7,1,8
HND-016177,2011,180100245,,,,3,2,5
HND-016180,2011,180100253,,,,5,1,6
HND-016183,2011,180100257,,,,3,7,10
HND-016185,2011,180100264,,,,19,23,42
HND-016187,2011,180100269,,,,7,6,13
HND-016188,2011,180100270,,,,1,6,7
HND-016193,2011,180100292,,,,2,6,8
HND-016204,2011,180100373,,,,6,1,7
HND-016205,2011,180100374,,,,2,0,2
HND-016211,2011,180100389,,,,3,0,3
HND-016218,2011,180100397,,,,4,1,5
HND-016234,2011,180100435,,,,3,3,6
,2011,180100453,,,,2,2,4
HND-016249,2011,180100469,,,,3,6,9
HND-015993,2011,180100002,,,,9,8,17
HND-015995,2011,180100004,,,,11,6,17
HND-015996,2011,180100005,,,,10,12,22
HND-015997,2011,180100006,,,,73,58,131
HND-015999,2011,180100008,,,,22,22,44
HND-016001,2011,180100010,,,,56,39,95
HND-016003,2011,180100012,,,,7,1,8
HND-016006,2011,180100015,,,,4,3,7
HND-016010,2011,180100019,,,,1,3,4
HND-016011,2011,180100020,,,,8,10,18
HND-016012,2011,180100021,,,,4,4,8
HND-016013,2011,180100022,,,,3,0,3
HND-016015,2011,180100024,,,,1,7,8
HND-016018,2011,180100027,,,,10,3,13
HND-016019,2011,180100028,,,,7,7,14
HND-016021,2011,180100030,,,,7,1,8
HND-016022,2011,180100031,,,,9,6,15
HND-016024,2011,180100033,,,,1,1,2
HND-016025,2011,180100034,,,,5,3,8
HND-016027,2011,180100036,,,,10,12,22
HND-016028,2011,180100037,,,,7,6,13
HND-016036,2011,180100046,,,,2,5,7
HND-016038,2011,180100049,,,,5,1,6
HND-016039,2011,180100050,,,,5,5,10
HND-016041,2011,180100052,,,,8,9,17
HND-016042,2011,180100053,,,,5,7,12
HND-016045,2011,180100057,,,,7,4,11
HND-016046,2011,180100058,,,,3,8,11
HND-016049,2011,180100061,,,,1,4,5
HND-016052,2011,180100066,,,,0,7,7
HND-016053,2011,180100067,,,,2,1,3
HND-016055,2011,180100069,,,,6,4,10
HND-016056,2011,180100070,,,,4,5,9
HND-016058,2011,180100072,,,,19,15,34
HND-016060,2011,180100075,,,,3,4,7
HND-016063,2011,180100078,,,,4,3,7
HND-016064,2011,180100079,,,,4,8,12
HND-016066,2011,180100081,,,,0,7,7
HND-016068,2011,180100083,,,,10,3,13
HND-016069,2011,180100084,,,,5,12,17
HND-016071,2011,180100086,,,,5,4,9
HND-016072,2011,180100087,,,,6,4,10
HND-016075,2011,180100090,,,,0,1,1
HND-016076,2011,180100091,,,,1,4,5
,2011,180100093,,,,4,2,6
HND-016077,2011,180100094,,,,2,0,2
HND-016079,2011,180100097,,,,3,1,4
HND-016080,2011,180100098,,,,8,9,17
HND-016082,2011,180100100,,,,6,4,10
HND-016084,2011,180100102,,,,5,2,7
HND-016085,2011,180100103,,,,15,9,24
HND-016086,2011,180100104,,,,57,57,114
HND-016088,2011,180100106,,,,5,6,11
HND-016094,2011,180100116,,,,19,8,27
HND-016099,2011,180100122,,,,5,3,8
HND-016102,2011,180100129,,,,5,3,8
HND-016106,2011,180100139,,,,6,4,10
,2011,180100141,,,,4,1,5
HND-016109,2011,180100145,,,,3,3,6
HND-016113,2011,180100149,,,,29,20,49
HND-016114,2011,180100150,,,,3,5,8
HND-016116,2011,180100152,,,,2,6,8
HND-016117,2011,180100153,,,,7,12,19
HND-016118,2011,180100154,,,,2,2,4
HND-016119,2011,180100157,,,,0,2,2
HND-016121,2011,180100160,,,,6,9,15
HND-016122,2011,180100162,,,,6,2,8
HND-016123,2011,180100163,,,,3,3,6
HND-016124,2011,180100164,,,,5,6,11
HND-016126,2011,180100166,,,,9,3,12
HND-016127,2011,180100167,,,,2,3,5
HND-016128,2011,180100168,,,,6,4,10
,2011,180100171,,,,7,5,12
HND-016135,2011,180100183,,,,1,3,4
HND-016136,2011,180100184,,,,3,3,6
HND-016137,2011,180100186,,,,3,9,12
,2011,180100188,,,,4,1,5
HND-016139,2011,180100190,,,,2,5,7
HND-016141,2011,180100192,,,,24,17,41
HND-016143,2011,180100194,,,,5,3,8
HND-016144,2011,180100196,,,,7,3,10
HND-016148,2011,180100207,,,,1,9,10
HND-016149,2011,180100211,,,,5,5,10
HND-016150,2011,180100214,,,,10,7,17
HND-016151,2011,180100215,,,,1,1,2
HND-016154,2011,180100218,,,,4,7,11
HND-016156,2011,180100220,,,,4,3,7
HND-016157,2011,180100221,,,,4,4,8
HND-016158,2011,180100222,,,,5,5,10
HND-016159,2011,180100223,,,,13,5,18
,2011,180100224,,,,7,3,10
HND-016162,2011,180100227,,,,8,8,16
HND-016163,2011,180100229,,,,2,5,7
HND-016164,2011,180100230,,,,7,9,16
HND-016166,2011,180100232,,,,6,12,18
HND-016168,2011,180100234,,,,3,3,6
HND-016169,2011,180100235,,,,5,6,11
HND-016172,2011,180100238,,,,3,2,5
HND-016175,2011,180100241,,,,3,2,5
HND-016181,2011,180100254,,,,2,3,5
HND-016182,2011,180100255,,,,13,7,20
,2011,180100258,,,,2,4,6
HND-016186,2011,180100268,,,,2,3,5
HND-016187,2011,180100269,,,,3,2,5
HND-016194,2011,180100326,,,,3,1,4
HND-016202,2011,180100371,,,,7,7,14
HND-016205,2011,180100374,,,,3,0,3
HND-016206,2011,180100375,,,,5,1,6
HND-016212,2011,180100390,,,,1,3,4
HND-016213,2011,180100391,,,,1,3,4
HND-016214,2011,180100392,,,,5,4,9
HND-016218,2011,180100397,,,,5,8,13
HND-016219,2011,180100398,,,,5,3,8
HND-016232,2011,180100433,,,,2,1,3
,2011,180100453,,,,5,4,9
HND-016239,2011,180100454,,,,6,1,7
HND-016241,2011,180100456,,,,10,3,13
HND-016242,2011,180100457,,,,6,13,19
HND-016248,2011,180100468,,,,6,3,9
HND-016255,2011,180100491,,,,1,3,4
,2011,180100492,,,,2,2,4
,2011,180100001,,,,5,3,8
HND-015994,2011,180100003,,,,4,2,6
HND-015998,2011,180100007,,,,10,16,26
HND-016000,2011,180100009,,,,19,9,28
HND-016002,2011,180100011,,,,2,1,3
HND-016004,2011,180100013,,,,5,8,13
HND-016005,2011,180100014,,,,25,25,50
HND-016007,2011,180100016,,,,34,37,71
HND-016008,2011,180100017,,,,17,16,33
HND-016009,2011,180100018,,,,3,3,6
HND-016014,2011,180100023,,,,2,1,3
HND-016016,2011,180100025,,,,4,3,7
HND-016017,2011,180100026,,,,9,3,12
HND-016020,2011,180100029,,,,3,2,5
HND-016023,2011,180100032,,,,4,1,5
HND-016026,2011,180100035,,,,2,8,10
HND-016029,2011,180100038,,,,5,2,7
HND-016030,2011,180100039,,,,2,6,8
HND-016031,2011,180100040,,,,12,6,18
HND-016032,2011,180100041,,,,5,8,13
HND-016033,2011,180100042,,,,6,1,7
HND-016034,2011,180100044,,,,14,14,28
HND-016035,2011,180100045,,,,1,6,7
HND-016037,2011,180100048,,,,5,4,9
HND-016040,2011,180100051,,,,38,33,71
HND-016043,2011,180100055,,,,4,8,12
HND-016044,2011,180100056,,,,3,4,7
HND-016047,2011,180100059,,,,3,2,5
HND-016048,2011,180100060,,,,3,4,7
,2011,180100062,,,,2,6,8
HND-016050,2011,180100064,,,,1,1,2
HND-016051,2011,180100065,,,,4,4,8
HND-016054,2011,180100068,,,,4,1,5
HND-016057,2011,180100071,,,,2,1,3
HND-016059,2011,180100073,,,,2,7,9
,2011,180100074,,,,6,3,9
HND-016061,2011,180100076,,,,2,5,7
HND-016062,2011,180100077,,,,0,4,4
HND-016065,2011,180100080,,,,4,3,7
HND-016067,2011,180100082,,,,4,1,5
HND-016070,2011,180100085,,,,3,0,3
HND-016073,2011,180100088,,,,0,1,1
HND-016074,2011,180100089,,,,4,4,8
,2011,180100092,,,,7,3,10
HND-016078,2011,180100096,,,,25,19,44
HND-016081,2011,180100099,,,,4,6,10
HND-016083,2011,180100101,,,,49,48,97
HND-016087,2011,180100105,,,,5,9,14
,2011,180100110,,,,7,12,19
HND-016093,2011,180100115,,,,2,1,3
HND-016096,2011,180100118,,,,3,7,10
HND-016100,2011,180100125,,,,5,7,12
HND-016101,2011,180100126,,,,10,14,24
HND-016108,2011,180100143,,,,1,1,2
HND-016111,2011,180100147,,,,4,4,8
HND-016112,2011,180100148,,,,2,1,3
HND-016115,2011,180100151,,,,3,4,7
HND-016120,2011,180100159,,,,8,4,12
,2011,180100161,,,,3,4,7
HND-016125,2011,180100165,,,,4,5,9
HND-016129,2011,180100169,,,,4,3,7
HND-016130,2011,180100170,,,,5,7,12
HND-016133,2011,180100176,,,,3,10,13
HND-016134,2011,180100178,,,,4,2,6
HND-016138,2011,180100189,,,,1,8,9
HND-016140,2011,180100191,,,,5,5,10
HND-016142,2011,180100193,,,,14,7,21
,2011,180100195,,,,13,8,21
HND-016145,2011,180100197,,,,2,1,3
HND-016147,2011,180100204,,,,3,6,9
HND-016152,2011,180100216,,,,6,2,8
HND-016155,2011,180100219,,,,1,1,2
HND-016160,2011,180100225,,,,3,3,6
HND-016161,2011,180100226,,,,1,0,1
HND-016165,2011,180100231,,,,0,2,2
HND-016167,2011,180100233,,,,1,1,2
HND-016170,2011,180100236,,,,3,2,5
HND-016171,2011,180100237,,,,7,2,9
HND-016173,2011,180100239,,,,8,5,13
HND-016174,2011,180100240,,,,3,5,8
HND-016176,2011,180100242,,,,5,3,8
HND-016177,2011,180100245,,,,1,3,4
HND-016180,2011,180100253,,,,8,6,14
HND-016183,2011,180100257,,,,4,5,9
HND-016184,2011,180100259,,,,3,3,6
,2011,180100262,,,,1,2,3
HND-016185,2011,180100264,,,,16,14,30
HND-016188,2011,180100270,,,,9,4,13
HND-016193,2011,180100292,,,,2,7,9
HND-016203,2011,180100372,,,,4,5,9
HND-016204,2011,180100373,,,,1,2,3
HND-016211,2011,180100389,,,,1,5,6
HND-016215,2011,180100393,,,,1,2,3
HND-016233,2011,180100434,,,,7,7,14
HND-016234,2011,180100435,,,,9,1,10
HND-016240,2011,180100455,,,,7,2,9
HND-016249,2011,180100469,,,,2,2,4
,2011,180100485,,,,3,1,4
HND-015996,2011,180100005,,,,6,17,23
HND-016000,2011,180100009,,,,22,7,29
HND-016001,2011,180100010,,,,43,37,80
HND-016002,2011,180100011,,,,0,3,3
HND-016004,2011,180100013,,,,4,4,8
HND-016007,2011,180100016,,,,23,47,70
HND-016008,2011,180100017,,,,10,8,18
HND-016010,2011,180100019,,,,4,3,7
HND-016013,2011,180100022,,,,1,1,2
HND-016016,2011,180100025,,,,1,2,3
HND-016020,2011,180100029,,,,1,4,5
HND-016021,2011,180100030,,,,4,0,4
HND-016022,2011,180100031,,,,5,5,10
HND-016025,2011,180100034,,,,2,4,6
HND-016026,2011,180100035,,,,3,4,7
HND-016029,2011,180100038,,,,4,4,8
HND-016031,2011,180100040,,,,3,3,6
HND-016032,2011,180100041,,,,11,12,23
HND-016034,2011,180100044,,,,12,15,27
,2011,180100047,,,,3,1,4
HND-016037,2011,180100048,,,,6,4,10
HND-016039,2011,180100050,,,,1,3,4
HND-016040,2011,180100051,,,,35,41,76
HND-016041,2011,180100052,,,,9,10,19
HND-016043,2011,180100055,,,,4,7,11
HND-016046,2011,180100058,,,,5,5,10
HND-016047,2011,180100059,,,,2,3,5
HND-016048,2011,180100060,,,,3,2,5
HND-016049,2011,180100061,,,,3,4,7
,2011,180100062,,,,2,5,7
HND-016053,2011,180100067,,,,2,4,6
HND-016054,2011,180100068,,,,2,4,6
HND-016059,2011,180100073,,,,5,2,7
HND-016061,2011,180100076,,,,1,2,3
HND-016064,2011,180100079,,,,5,0,5
HND-016065,2011,180100080,,,,7,4,11
HND-016066,2011,180100081,,,,3,6,9
HND-016067,2011,180100082,,,,4,6,10
HND-016069,2011,180100084,,,,5,3,8
HND-016070,2011,180100085,,,,1,1,2
HND-016073,2011,180100088,,,,0,1,1
HND-016075,2011,180100090,,,,1,3,4
,2011,180100092,,,,1,3,4
HND-016077,2011,180100094,,,,1,1,2
HND-016080,2011,180100098,,,,10,6,16
HND-016082,2011,180100100,,,,3,6,9
HND-016085,2011,180100103,,,,15,7,22
HND-016086,2011,180100104,,,,57,61,118
HND-016087,2011,180100105,,,,2,3,5
,2011,180100110,,,,11,7,18
HND-016093,2011,180100115,,,,2,3,5
HND-016094,2011,180100116,,,,1,0,1
HND-016095,2011,180100117,,,,1,3,4
HND-016096,2011,180100118,,,,2,5,7
HND-016099,2011,180100122,,,,5,3,8
HND-016101,2011,180100126,,,,23,10,33
HND-016106,2011,180100139,,,,2,16,18
,2011,180100141,,,,8,9,17
HND-016114,2011,180100150,,,,2,6,8
HND-016117,2011,180100153,,,,3,5,8
HND-016118,2011,180100154,,,,1,0,1
HND-016119,2011,180100157,,,,1,2,3
,2011,180100161,,,,2,4,6
HND-016125,2011,180100165,,,,6,2,8
HND-016127,2011,180100167,,,,2,9,11
HND-016128,2011,180100168,,,,4,8,12
HND-016129,2011,180100169,,,,5,6,11
HND-016130,2011,180100170,,,,7,8,15
,2011,180100171,,,,8,7,15
HND-016133,2011,180100176,,,,7,4,11
HND-016134,2011,180100178,,,,1,3,4
HND-016138,2011,180100189,,,,6,6,12
HND-016139,2011,180100190,,,,2,6,8
HND-016142,2011,180100193,,,,5,13,18
HND-016143,2011,180100194,,,,4,5,9
,2011,180100195,,,,6,3,9
HND-016144,2011,180100196,,,,9,6,15
HND-016145,2011,180100197,,,,0,2,2
HND-016147,2011,180100204,,,,1,2,3
HND-016152,2011,180100216,,,,2,2,4
HND-016156,2011,180100220,,,,2,1,3
HND-016158,2011,180100222,,,,2,2,4
,2011,180100224,,,,2,3,5
HND-016160,2011,180100225,,,,4,0,4
HND-016169,2011,180100235,,,,4,4,8
HND-016170,2011,180100236,,,,2,1,3
HND-016173,2011,180100239,,,,8,5,13
HND-016174,2011,180100240,,,,2,2,4
HND-016175,2011,180100241,,,,6,5,11
HND-016176,2011,180100242,,,,0,2,2
HND-016182,2011,180100255,,,,9,6,15
HND-016184,2011,180100259,,,,2,0,2
,2011,180100262,,,,0,2,2
HND-016185,2011,180100264,,,,17,17,34
HND-016186,2011,180100268,,,,2,1,3
HND-016193,2011,180100292,,,,5,8,13
HND-016194,2011,180100326,,,,5,0,5
HND-016202,2011,180100371,,,,8,5,13
HND-016203,2011,180100372,,,,6,4,10
HND-016206,2011,180100375,,,,6,5,11
HND-016210,2011,180100388,,,,1,2,3
HND-016212,2011,180100390,,,,1,3,4
HND-016214,2011,180100392,,,,4,6,10
HND-016215,2011,180100393,,,,1,1,2
HND-016219,2011,180100398,,,,1,2,3
HND-016232,2011,180100433,,,,4,1,5
HND-016233,2011,180100434,,,,1,7,8
HND-016239,2011,180100454,,,,1,3,4
HND-016240,2011,180100455,,,,5,10,15
HND-016241,2011,180100456,,,,9,2,11
HND-016248,2011,180100468,,,,6,5,11
HND-016249,2011,180100469,,,,3,2,5
HND-016255,2011,180100491,,,,3,1,4
,2011,180100001,,,,6,0,6
HND-015993,2011,180100002,,,,6,6,12
HND-015994,2011,180100003,,,,2,1,3
HND-015995,2011,180100004,,,,3,4,7
HND-015997,2011,180100006,,,,53,65,118
HND-015998,2011,180100007,,,,9,16,25
HND-015999,2011,180100008,,,,23,17,40
HND-016003,2011,180100012,,,,11,1,12
HND-016005,2011,180100014,,,,40,34,74
HND-016006,2011,180100015,,,,10,10,20
HND-016009,2011,180100018,,,,5,5,10
HND-016011,2011,180100020,,,,4,11,15
HND-016012,2011,180100021,,,,5,3,8
HND-016014,2011,180100023,,,,1,7,8
HND-016015,2011,180100024,,,,6,2,8
HND-016017,2011,180100026,,,,8,6,14
HND-016018,2011,180100027,,,,2,4,6
HND-016019,2011,180100028,,,,4,0,4
HND-016024,2011,180100033,,,,3,3,6
HND-016027,2011,180100036,,,,8,10,18
HND-016028,2011,180100037,,,,3,4,7
HND-016030,2011,180100039,,,,2,6,8
HND-016033,2011,180100042,,,,2,2,4
HND-016036,2011,180100046,,,,3,5,8
HND-016038,2011,180100049,,,,4,4,8
HND-016042,2011,180100053,,,,7,8,15
HND-016044,2011,180100056,,,,5,5,10
HND-016045,2011,180100057,,,,0,2,2
HND-016051,2011,180100065,,,,4,7,11
HND-016052,2011,180100066,,,,4,6,10
HND-016055,2011,180100069,,,,5,4,9
HND-016056,2011,180100070,,,,9,6,15
HND-016057,2011,180100071,,,,2,0,2
HND-016058,2011,180100072,,,,9,4,13
,2011,180100074,,,,3,3,6
HND-016060,2011,180100075,,,,1,4,5
HND-016063,2011,180100078,,,,2,0,2
HND-016068,2011,180100083,,,,2,8,10
HND-016071,2011,180100086,,,,6,2,8
HND-016072,2011,180100087,,,,2,2,4
HND-016074,2011,180100089,,,,2,4,6
HND-016076,2011,180100091,,,,1,2,3
,2011,180100093,,,,0,3,3
HND-016078,2011,180100096,,,,42,34,76
HND-016079,2011,180100097,,,,1,3,4
HND-016081,2011,180100099,,,,1,3,4
HND-016083,2011,180100101,,,,60,68,128
HND-016084,2011,180100102,,,,2,2,4
HND-016088,2011,180100106,,,,2,4,6
HND-016100,2011,180100125,,,,3,7,10
HND-016102,2011,180100129,,,,3,5,8
HND-016108,2011,180100143,,,,4,3,7
HND-016109,2011,180100145,,,,10,10,20
HND-016111,2011,180100147,,,,1,4,5
HND-016112,2011,180100148,,,,2,0,2
HND-016113,2011,180100149,,,,25,24,49
HND-016115,2011,180100151,,,,4,4,8
HND-016116,2011,180100152,,,,2,6,8
HND-016120,2011,180100159,,,,6,3,9
HND-016121,2011,180100160,,,,10,7,17
HND-016122,2011,180100162,,,,5,6,11
HND-016123,2011,180100163,,,,3,4,7
HND-016124,2011,180100164,,,,1,2,3
HND-016126,2011,180100166,,,,4,9,13
HND-016135,2011,180100183,,,,1,4,5
HND-016136,2011,180100184,,,,5,7,12
HND-016137,2011,180100186,,,,2,5,7
,2011,180100188,,,,5,7,12
HND-016140,2011,180100191,,,,4,5,9
HND-016141,2011,180100192,,,,15,10,25
HND-016148,2011,180100207,,,,2,8,10
HND-016149,2011,180100211,,,,3,4,7
HND-016150,2011,180100214,,,,7,11,18
HND-016151,2011,180100215,,,,0,1,1
HND-016154,2011,180100218,,,,2,3,5
HND-016155,2011,180100219,,,,2,1,3
HND-016157,2011,180100221,,,,2,6,8
HND-016159,2011,180100223,,,,3,8,11
HND-016161,2011,180100226,,,,3,2,5
HND-016162,2011,180100227,,,,3,8,11
HND-016163,2011,180100229,,,,10,5,15
HND-016164,2011,180100230,,,,14,18,32
HND-016165,2011,180100231,,,,0,1,1
HND-016166,2011,180100232,,,,8,3,11
HND-016167,2011,180100233,,,,2,3,5
HND-016168,2011,180100234,,,,5,1,6
HND-016171,2011,180100237,,,,3,9,12
HND-016172,2011,180100238,,,,6,5,11
HND-016177,2011,180100245,,,,2,0,2
HND-016180,2011,180100253,,,,4,3,7
HND-016181,2011,180100254,,,,3,4,7
HND-016183,2011,180100257,,,,2,2,4
,2011,180100258,,,,2,2,4
HND-016187,2011,180100269,,,,5,7,12
HND-016188,2011,180100270,,,,3,2,5
HND-016204,2011,180100373,,,,2,2,4
HND-016205,2011,180100374,,,,1,2,3
HND-016211,2011,180100389,,,,3,2,5
HND-016213,2011,180100391,,,,1,3,4
HND-016218,2011,180100397,,,,2,6,8
HND-016234,2011,180100435,,,,4,3,7
HND-016242,2011,180100457,,,,7,3,10
,2011,180100492,,,,0,1,1
HND-015996,2011,180100005,,,,14,13,27
HND-015998,2011,180100007,,,,11,11,22
HND-016000,2011,180100009,,,,9,8,17
HND-016002,2011,180100011,,,,1,3,4
HND-016004,2011,180100013,,,,8,7,15
HND-016007,2011,180100016,,,,33,28,61
HND-016008,2011,180100017,,,,9,9,18
HND-016016,2011,180100025,,,,0,5,5
HND-016017,2011,180100026,,,,10,4,14
HND-016021,2011,180100030,,,,0,2,2
HND-016023,2011,180100032,,,,0,4,4
HND-016025,2011,180100034,,,,5,6,11
HND-016026,2011,180100035,,,,3,4,7
HND-016029,2011,180100038,,,,4,5,9
HND-016031,2011,180100040,,,,1,6,7
HND-016032,2011,180100041,,,,11,9,20
HND-016033,2011,180100042,,,,2,2,4
HND-016034,2011,180100044,,,,7,15,22
,2011,180100047,,,,3,1,4
HND-016037,2011,180100048,,,,4,2,6
HND-016040,2011,180100051,,,,35,26,61
HND-016041,2011,180100052,,,,4,9,13
HND-016043,2011,180100055,,,,6,6,12
HND-016047,2011,180100059,,,,2,4,6
HND-016048,2011,180100060,,,,1,3,4
HND-016049,2011,180100061,,,,2,0,2
,2011,180100062,,,,11,5,16
HND-016050,2011,180100064,,,,1,0,1
HND-016051,2011,180100065,,,,7,0,7
HND-016054,2011,180100068,,,,0,4,4
HND-016057,2011,180100071,,,,2,3,5
HND-016059,2011,180100073,,,,1,0,1
HND-016061,2011,180100076,,,,3,0,3
HND-016062,2011,180100077,,,,3,3,6
HND-016065,2011,180100080,,,,0,5,5
HND-016067,2011,180100082,,,,0,2,2
HND-016069,2011,180100084,,,,9,5,14
HND-016073,2011,180100088,,,,7,5,12
,2011,180100092,,,,1,2,3
HND-016080,2011,180100098,,,,11,7,18
HND-016081,2011,180100099,,,,3,2,5
HND-016083,2011,180100101,,,,56,49,105
HND-016087,2011,180100105,,,,7,5,12
,2011,180100110,,,,11,7,18
HND-016093,2011,180100115,,,,2,3,5
HND-016094,2011,180100116,,,,1,1,2
HND-016095,2011,180100117,,,,3,3,6
HND-016096,2011,180100118,,,,1,2,3
HND-016099,2011,180100122,,,,2,1,3
HND-016101,2011,180100126,,,,22,23,45
HND-016108,2011,180100143,,,,3,11,14
HND-016112,2011,180100148,,,,4,2,6
HND-016117,2011,180100153,,,,1,1,2
HND-016119,2011,180100157,,,,0,3,3
HND-016120,2011,180100159,,,,5,4,9
,2011,180100161,,,,3,3,6
HND-016125,2011,180100165,,,,2,4,6
HND-016129,2011,180100169,,,,10,4,14
HND-016130,2011,180100170,,,,8,5,13
HND-016133,2011,180100176,,,,3,11,14
HND-016134,2011,180100178,,,,1,4,5
HND-016138,2011,180100189,,,,5,7,12
HND-016139,2011,180100190,,,,6,1,7
HND-016142,2011,180100193,,,,10,7,17
HND-016143,2011,180100194,,,,5,5,10
,2011,180100195,,,,5,2,7
HND-016144,2011,180100196,,,,8,5,13
HND-016145,2011,180100197,,,,1,2,3
HND-016147,2011,180100204,,,,6,4,10
HND-016152,2011,180100216,,,,0,3,3
HND-016155,2011,180100219,,,,0,5,5
HND-016158,2011,180100222,,,,4,2,6
HND-016160,2011,180100225,,,,2,3,5
HND-016164,2011,180100230,,,,11,14,25
HND-016165,2011,180100231,,,,0,1,1
HND-016166,2011,180100232,,,,5,7,12
HND-016168,2011,180100234,,,,3,2,5
HND-016171,2011,180100237,,,,1,5,6
HND-016172,2011,180100238,,,,4,1,5
HND-016180,2011,180100253,,,,2,3,5
HND-016181,2011,180100254,,,,1,2,3
HND-016183,2011,180100257,,,,6,5,11
,2011,180100258,,,,0,4,4
HND-016184,2011,180100259,,,,1,2,3
,2011,180100262,,,,1,1,2
HND-016185,2011,180100264,,,,13,18,31
HND-016186,2011,180100268,,,,1,3,4
HND-016194,2011,180100326,,,,0,3,3
HND-016202,2011,180100371,,,,3,2,5
HND-016205,2011,180100374,,,,0,2,2
HND-016211,2011,180100389,,,,1,1,2
HND-016212,2011,180100390,,,,2,5,7
HND-016218,2011,180100397,,,,4,3,7
HND-016219,2011,180100398,,,,2,3,5
HND-016233,2011,180100434,,,,1,6,7
HND-016240,2011,180100455,,,,4,6,10
HND-016249,2011,180100469,,,,1,2,3
,2011,180100001,,,,2,0,2
HND-015993,2011,180100002,,,,6,10,16
HND-015995,2011,180100004,,,,10,3,13
HND-015997,2011,180100006,,,,81,62,143
HND-015999,2011,180100008,,,,15,25,40
HND-016001,2011,180100010,,,,46,46,92
HND-016003,2011,180100012,,,,3,6,9
HND-016005,2011,180100014,,,,24,23,47
HND-016006,2011,180100015,,,,5,5,10
HND-016009,2011,180100018,,,,3,4,7
HND-016011,2011,180100020,,,,5,7,12
HND-016012,2011,180100021,,,,6,5,11
HND-016015,2011,180100024,,,,1,5,6
HND-016019,2011,180100028,,,,6,2,8
HND-016022,2011,180100031,,,,4,6,10
HND-016024,2011,180100033,,,,0,1,1
HND-016027,2011,180100036,,,,6,12,18
HND-016028,2011,180100037,,,,5,5,10
HND-016030,2011,180100039,,,,6,9,15
HND-016038,2011,180100049,,,,4,3,7
HND-016039,2011,180100050,,,,4,4,8
HND-016042,2011,180100053,,,,8,5,13
HND-016044,2011,180100056,,,,3,4,7
HND-016045,2011,180100057,,,,0,3,3
HND-016046,2011,180100058,,,,3,5,8
HND-016052,2011,180100066,,,,2,1,3
HND-016053,2011,180100067,,,,1,2,3
HND-016055,2011,180100069,,,,10,3,13
HND-016056,2011,180100070,,,,3,9,12
HND-016058,2011,180100072,,,,3,6,9
,2011,180100074,,,,3,3,6
HND-016060,2011,180100075,,,,4,6,10
HND-016063,2011,180100078,,,,2,1,3
HND-016066,2011,180100081,,,,8,3,11
HND-016068,2011,180100083,,,,2,9,11
HND-016071,2011,180100086,,,,1,1,2
HND-016072,2011,180100087,,,,9,4,13
HND-016075,2011,180100090,,,,4,2,6
HND-016076,2011,180100091,,,,0,1,1
,2011,180100093,,,,3,2,5
HND-016077,2011,180100094,,,,3,1,4
HND-016078,2011,180100096,,,,27,29,56
HND-016079,2011,180100097,,,,6,2,8
HND-016082,2011,180100100,,,,6,11,17
HND-016084,2011,180100102,,,,1,2,3
HND-016085,2011,180100103,,,,11,6,17
HND-016086,2011,180100104,,,,52,70,122
HND-016088,2011,180100106,,,,4,4,8
HND-016100,2011,180100125,,,,7,6,13
HND-016102,2011,180100129,,,,7,4,11
HND-016106,2011,180100139,,,,2,1,3
,2011,180100141,,,,3,4,7
HND-016109,2011,180100145,,,,5,5,10
HND-016113,2011,180100149,,,,28,24,52
HND-016114,2011,180100150,,,,2,8,10
HND-016115,2011,180100151,,,,3,3,6
HND-016116,2011,180100152,,,,3,1,4
HND-016118,2011,180100154,,,,0,2,2
HND-016121,2011,180100160,,,,3,5,8
HND-016122,2011,180100162,,,,2,1,3
HND-016123,2011,180100163,,,,6,4,10
HND-016124,2011,180100164,,,,7,3,10
HND-016126,2011,180100166,,,,3,3,6
HND-016127,2011,180100167,,,,2,2,4
HND-016128,2011,180100168,,,,2,4,6
,2011,180100171,,,,3,0,3
HND-016135,2011,180100183,,,,1,3,4
HND-016136,2011,180100184,,,,6,10,16
HND-016137,2011,180100186,,,,3,3,6
,2011,180100188,,,,2,2,4
HND-016140,2011,180100191,,,,2,7,9
HND-016141,2011,180100192,,,,13,11,24
HND-016148,2011,180100207,,,,2,2,4
HND-016149,2011,180100211,,,,2,3,5
HND-016150,2011,180100214,,,,4,1,5
HND-016151,2011,180100215,,,,4,1,5
HND-016154,2011,180100218,,,,5,3,8
HND-016156,2011,180100220,,,,5,0,5
HND-016157,2011,180100221,,,,4,0,4
HND-016159,2011,180100223,,,,6,6,12
,2011,180100224,,,,1,3,4
HND-016161,2011,180100226,,,,0,1,1
HND-016162,2011,180100227,,,,9,10,19
HND-016163,2011,180100229,,,,5,4,9
HND-016167,2011,180100233,,,,4,1,5
HND-016169,2011,180100235,,,,2,3,5
HND-016170,2011,180100236,,,,3,3,6
HND-016173,2011,180100239,,,,4,5,9
HND-016174,2011,180100240,,,,0,5,5
HND-016175,2011,180100241,,,,4,3,7
HND-016176,2011,180100242,,,,1,3,4
HND-016177,2011,180100245,,,,0,6,6
HND-016182,2011,180100255,,,,5,10,15
HND-016187,2011,180100269,,,,3,4,7
HND-016188,2011,180100270,,,,2,5,7
HND-016193,2011,180100292,,,,8,4,12
HND-016203,2011,180100372,,,,6,2,8
HND-016204,2011,180100373,,,,3,1,4
HND-016206,2011,180100375,,,,5,2,7
HND-016210,2011,180100388,,,,0,1,1
HND-016213,2011,180100391,,,,3,1,4
HND-016214,2011,180100392,,,,5,3,8
HND-016215,2011,180100393,,,,5,2,7
HND-016234,2011,180100435,,,,6,5,11
,2011,180100453,,,,1,3,4
HND-016239,2011,180100454,,,,2,0,2
HND-016241,2011,180100456,,,,6,2,8
HND-016248,2011,180100468,,,,3,1,4
,2011,180100492,,,,1,3,4
,2011,180100001,,,,0,4,4
HND-015994,2011,180100003,,,,1,1,2
HND-015995,2011,180100004,,,,2,4,6
HND-015997,2011,180100006,,,,45,48,93
HND-015998,2011,180100007,,,,13,10,23
HND-015999,2011,180100008,,,,17,24,41
HND-016002,2011,180100011,,,,4,1,5
HND-016003,2011,180100012,,,,0,3,3
HND-016005,2011,180100014,,,,28,34,62
HND-016008,2011,180100017,,,,9,12,21
HND-016009,2011,180100018,,,,4,1,5
HND-016012,2011,180100021,,,,5,2,7
HND-016014,2011,180100023,,,,1,1,2
HND-016017,2011,180100026,,,,10,8,18
HND-016020,2011,180100029,,,,2,0,2
HND-016026,2011,180100035,,,,7,6,13
HND-016027,2011,180100036,,,,6,4,10
HND-016030,2011,180100039,,,,2,3,5
HND-016031,2011,180100040,,,,5,8,13
HND-016033,2011,180100042,,,,2,0,2
HND-016037,2011,180100048,,,,1,3,4
HND-016042,2011,180100053,,,,8,8,16
HND-016044,2011,180100056,,,,4,2,6
,2011,180100062,,,,1,4,5
HND-016051,2011,180100065,,,,3,3,6
HND-016055,2011,180100069,,,,8,3,11
HND-016056,2011,180100070,,,,6,4,10
HND-016058,2011,180100072,,,,2,4,6
HND-016059,2011,180100073,,,,2,2,4
,2011,180100074,,,,3,2,5
HND-016063,2011,180100078,,,,2,3,5
HND-016071,2011,180100086,,,,0,2,2
HND-016074,2011,180100089,,,,5,4,9
,2011,180100093,,,,2,1,3
HND-016078,2011,180100096,,,,21,24,45
HND-016079,2011,180100097,,,,1,1,2
HND-016081,2011,180100099,,,,1,1,2
HND-016083,2011,180100101,,,,41,52,93
HND-016084,2011,180100102,,,,2,2,4
,2011,180100110,,,,8,8,16
HND-016093,2011,180100115,,,,2,3,5
HND-016100,2011,180100125,,,,6,4,10
HND-016102,2011,180100129,,,,4,0,4
HND-016106,2011,180100139,,,,2,3,5
,2011,180100141,,,,1,0,1
HND-016113,2011,180100149,,,,23,29,52
HND-016114,2011,180100150,,,,1,1,2
HND-016116,2011,180100152,,,,5,2,7
HND-016117,2011,180100153,,,,1,1,2
,2011,180100161,,,,0,4,4
HND-016122,2011,180100162,,,,1,3,4
HND-016129,2011,180100169,,,,7,9,16
HND-016130,2011,180100170,,,,8,8,16
,2011,180100171,,,,7,9,16
HND-016133,2011,180100176,,,,5,1,6
HND-016134,2011,180100178,,,,0,1,1
HND-016138,2011,180100189,,,,5,2,7
HND-016139,2011,180100190,,,,2,1,3
HND-016141,2011,180100192,,,,5,8,13
HND-016142,2011,180100193,,,,9,11,20
HND-016143,2011,180100194,,,,5,6,11
HND-016144,2011,180100196,,,,1,3,4
HND-016145,2011,180100197,,,,2,3,5
HND-016148,2011,180100207,,,,4,4,8
HND-016149,2011,180100211,,,,2,5,7
HND-016150,2011,180100214,,,,1,2,3
HND-016152,2011,180100216,,,,2,3,5
HND-016155,2011,180100219,,,,1,2,3
HND-016159,2011,180100223,,,,9,5,14
HND-016161,2011,180100226,,,,2,1,3
HND-016162,2011,180100227,,,,3,2,5
HND-016163,2011,180100229,,,,6,7,13
HND-016166,2011,180100232,,,,3,8,11
HND-016169,2011,180100235,,,,2,4,6
HND-016174,2011,180100240,,,,2,0,2
HND-016175,2011,180100241,,,,1,2,3
HND-016181,2011,180100254,,,,1,0,1
HND-016182,2011,180100255,,,,0,7,7
,2011,180100258,,,,1,0,1
HND-016185,2011,180100264,,,,11,9,20
HND-016187,2011,180100269,,,,3,2,5
HND-016203,2011,180100372,,,,9,8,17
HND-016206,2011,180100375,,,,1,3,4
HND-016210,2011,180100388,,,,0,3,3
HND-016214,2011,180100392,,,,2,2,4
HND-016215,2011,180100393,,,,1,1,2
HND-016234,2011,180100435,,,,4,8,12
,2011,180100453,,,,1,1,2
HND-015993,2011,180100002,,,,5,8,13
HND-015996,2011,180100005,,,,10,12,22
HND-016000,2011,180100009,,,,16,11,27
HND-016001,2011,180100010,,,,41,40,81
HND-016004,2011,180100013,,,,3,5,8
HND-016006,2011,180100015,,,,3,6,9
HND-016007,2011,180100016,,,,32,34,66
HND-016010,2011,180100019,,,,3,3,6
HND-016011,2011,180100020,,,,6,5,11
HND-016013,2011,180100022,,,,2,2,4
HND-016019,2011,180100028,,,,2,0,2
HND-016021,2011,180100030,,,,2,3,5
HND-016022,2011,180100031,,,,3,4,7
HND-016024,2011,180100033,,,,2,0,2
HND-016025,2011,180100034,,,,2,2,4
HND-016028,2011,180100037,,,,0,2,2
HND-016029,2011,180100038,,,,2,6,8
HND-016032,2011,180100041,,,,6,7,13
HND-016034,2011,180100044,,,,11,17,28
HND-016036,2011,180100046,,,,12,15,27
,2011,180100047,,,,2,2,4
HND-016039,2011,180100050,,,,3,2,5
HND-016040,2011,180100051,,,,29,26,55
HND-016041,2011,180100052,,,,6,5,11
HND-016043,2011,180100055,,,,4,4,8
HND-016046,2011,180100058,,,,5,3,8
HND-016048,2011,180100060,,,,1,2,3
HND-016050,2011,180100064,,,,2,3,5
HND-016052,2011,180100066,,,,2,6,8
HND-016053,2011,180100067,,,,0,1,1
HND-016054,2011,180100068,,,,2,4,6
HND-016060,2011,180100075,,,,4,0,4
HND-016064,2011,180100079,,,,3,3,6
HND-016065,2011,180100080,,,,6,6,12
HND-016066,2011,180100081,,,,2,4,6
HND-016067,2011,180100082,,,,0,2,2
HND-016068,2011,180100083,,,,5,4,9
HND-016069,2011,180100084,,,,6,4,10
HND-016072,2011,180100087,,,,2,3,5
HND-016073,2011,180100088,,,,0,1,1
HND-016075,2011,180100090,,,,1,2,3
HND-016076,2011,180100091,,,,1,1,2
HND-016080,2011,180100098,,,,7,1,8
HND-016082,2011,180100100,,,,1,6,7
HND-016085,2011,180100103,,,,16,11,27
HND-016086,2011,180100104,,,,44,49,93
HND-016087,2011,180100105,,,,2,2,4
HND-016088,2011,180100106,,,,1,0,1
HND-016094,2011,180100116,,,,11,8,19
HND-016095,2011,180100117,,,,2,0,2
HND-016096,2011,180100118,,,,2,2,4
HND-016101,2011,180100126,,,,16,11,27
HND-016108,2011,180100143,,,,2,1,3
HND-016109,2011,180100145,,,,4,6,10
HND-016111,2011,180100147,,,,1,1,2
HND-016115,2011,180100151,,,,2,1,3
HND-016120,2011,180100159,,,,3,3,6
HND-016121,2011,180100160,,,,3,1,4
HND-016123,2011,180100163,,,,3,4,7
HND-016124,2011,180100164,,,,3,0,3
HND-016125,2011,180100165,,,,4,0,4
HND-016126,2011,180100166,,,,3,2,5
HND-016127,2011,180100167,,,,6,2,8
HND-016128,2011,180100168,,,,1,3,4
HND-016135,2011,180100183,,,,1,2,3
HND-016136,2011,180100184,,,,2,8,10
HND-016137,2011,180100186,,,,3,1,4
,2011,180100188,,,,2,3,5
HND-016140,2011,180100191,,,,4,3,7
,2011,180100195,,,,4,3,7
HND-016147,2011,180100204,,,,2,4,6
HND-016151,2011,180100215,,,,0,1,1
HND-016154,2011,180100218,,,,4,0,4
HND-016156,2011,180100220,,,,4,1,5
HND-016157,2011,180100221,,,,3,4,7
HND-016158,2011,180100222,,,,2,3,5
,2011,180100224,,,,0,1,1
HND-016160,2011,180100225,,,,1,1,2
HND-016164,2011,180100230,,,,9,14,23
HND-016165,2011,180100231,,,,2,1,3
HND-016167,2011,180100233,,,,1,2,3
HND-016170,2011,180100236,,,,4,2,6
HND-016171,2011,180100237,,,,1,2,3
HND-016173,2011,180100239,,,,4,7,11
HND-016176,2011,180100242,,,,0,2,2
HND-016177,2011,180100245,,,,4,3,7
HND-016180,2011,180100253,,,,2,4,6
HND-016183,2011,180100257,,,,1,0,1
HND-016184,2011,180100259,,,,2,0,2
HND-016186,2011,180100268,,,,0,5,5
HND-016188,2011,180100270,,,,2,1,3
HND-016193,2011,180100292,,,,2,2,4
HND-016194,2011,180100326,,,,2,2,4
HND-016202,2011,180100371,,,,1,3,4
HND-016204,2011,180100373,,,,0,1,1
HND-016205,2011,180100374,,,,0,1,1
HND-016212,2011,180100390,,,,0,2,2
HND-016213,2011,180100391,,,,1,0,1
HND-016218,2011,180100397,,,,0,2,2
HND-016232,2011,180100433,,,,2,0,2
HND-016233,2011,180100434,,,,2,3,5
HND-016239,2011,180100454,,,,2,0,2
HND-016240,2011,180100455,,,,2,5,7
HND-016248,2011,180100468,,,,5,1,6
,2011,180100485,,,,0,1,1
HND-016255,2011,180100491,,,,2,0,2
HND-016004,2011,180100013,,,,8,10,18
HND-016005,2011,180100014,,,,24,18,42
HND-016007,2011,180100016,,,,37,26,63
HND-016027,2011,180100036,,,,6,8,14
HND-016078,2011,180100096,,,,35,47,82
HND-016091,2011,180100111,,,,382,432,814
HND-016101,2011,180100126,,,,9,25,34
,2011,180100171,,,,11,12,23
HND-016142,2011,180100193,,,,13,13,26
,2011,180100291,,,,15,17,32
HND-015999,2011,180100008,,,,20,25,45
HND-016034,2011,180100044,,,,12,9,21
HND-016037,2011,180100048,,,,7,5,12
HND-016085,2011,180100103,,,,20,18,38
HND-016113,2011,180100149,,,,30,30,60
HND-016128,2011,180100168,,,,5,2,7
HND-016164,2011,180100230,,,,14,10,24
HND-016004,2011,180100013,,,,6,8,14
HND-016007,2011,180100016,,,,19,31,50
HND-016034,2011,180100044,,,,10,9,19
HND-016085,2011,180100103,,,,24,21,45
HND-016101,2011,180100126,,,,14,19,33
HND-016113,2011,180100149,,,,19,24,43
HND-016128,2011,180100168,,,,6,2,8
HND-016142,2011,180100193,,,,6,8,14
HND-016164,2011,180100230,,,,9,9,18
,2011,180100291,,,,16,17,33
HND-015999,2011,180100008,,,,22,19,41
HND-016005,2011,180100014,,,,11,17,28
HND-016027,2011,180100036,,,,6,6,12
HND-016037,2011,180100048,,,,4,3,7
HND-016078,2011,180100096,,,,28,47,75
HND-016091,2011,180100111,,,,257,355,612
,2011,180100171,,,,4,5,9
HND-016004,2011,180100013,,,,6,4,10
HND-016007,2011,180100016,,,,21,32,53
HND-016037,2011,180100048,,,,7,6,13
HND-016085,2011,180100103,,,,16,13,29
HND-016091,2011,180100111,,,,284,342,626
HND-016101,2011,180100126,,,,12,8,20
HND-016113,2011,180100149,,,,25,31,56
HND-016128,2011,180100168,,,,2,2,4
HND-016142,2011,180100193,,,,8,7,15
HND-015999,2011,180100008,,,,18,19,37
HND-016005,2011,180100014,,,,15,17,32
HND-016027,2011,180100036,,,,5,5,10
HND-016078,2011,180100096,,,,34,47,81
,2011,180100171,,,,3,7,10
HND-016164,2011,180100230,,,,3,11,14
,2011,180100291,,,,17,24,41
,2011,180100291,,,,12,9,21
HND-016201,2011,180100370,,,,17,2,19
HND-016091,2011,180100111,,,,246,366,612
,2011,180100369,,,,18,28,46
HND-016091,2011,180100111,,,,181,280,461
,2011,180100291,,,,9,11,20
,2011,180100369,,,,19,30,49
HND-016201,2011,180100370,,,,7,24,31
HND-016091,2011,180100111,,,,133,228,361
,2011,180100291,,,,5,9,14
,2011,180100369,,,,10,25,35
HND-016201,2011,180100370,,,,10,20,30
,2011,180100291,,,,22,24,46
,2011,180200015,,,,3,9,12
HND-016268,2011,180200016,,,,2,6,8
,2011,180200032,,,,7,5,12
HND-016270,2011,180200034,,,,10,11,21
,2011,180200037,,,,6,4,10
,2011,180200038,,,,3,4,7
HND-016272,2011,180200040,,,,5,3,8
,2011,180200041,,,,3,5,8
,2011,180200045,,,,6,4,10
,2011,180200048,,,,8,5,13
HND-016267,2011,180200014,,,,6,5,11
HND-016269,2011,180200017,,,,7,6,13
,2011,180200033,,,,4,4,8
,2011,180200035,,,,5,2,7
,2011,180200036,,,,7,8,15
HND-016271,2011,180200039,,,,4,7,11
,2011,180200042,,,,6,4,10
,2011,180200043,,,,4,3,7
,2011,180200046,,,,4,6,10
HND-016273,2011,180200047,,,,5,4,9
HND-016274,2011,180200049,,,,4,6,10
HND-016259,2011,180200004,,,,10,12,22
HND-016265,2011,180200010,,,,1,1,2
,2011,180200011,,,,12,12,24
HND-016263,2011,180200008,,,,36,39,75
,2011,180200012,,,,2,0,2
HND-016263,2011,180200008,,,,20,22,42
,2011,180200012,,,,4,2,6
HND-016259,2011,180200004,,,,7,7,14
HND-016265,2011,180200010,,,,6,2,8
,2011,180200011,,,,7,7,14
HND-016256,2011,180200001,,,,12,8,20
HND-016258,2011,180200003,,,,10,20,30
HND-016261,2011,180200006,,,,12,7,19
HND-016262,2011,180200007,,,,2,6,8
HND-016257,2011,180200002,,,,2,1,3
HND-016259,2011,180200004,,,,21,11,32
HND-016260,2011,180200005,,,,3,5,8
HND-016266,2011,180200013,,,,44,44,88
HND-016260,2011,180200005,,,,3,3,6
HND-016261,2011,180200006,,,,11,5,16
HND-016256,2011,180200001,,,,14,12,26
HND-016257,2011,180200002,,,,2,1,3
HND-016258,2011,180200003,,,,18,20,38
HND-016259,2011,180200004,,,,15,12,27
HND-016262,2011,180200007,,,,4,8,12
HND-016266,2011,180200013,,,,31,32,63
HND-016257,2011,180200002,,,,1,4,5
HND-016260,2011,180200005,,,,3,3,6
HND-016266,2011,180200013,,,,22,28,50
HND-016256,2011,180200001,,,,11,10,21
HND-016258,2011,180200003,,,,13,10,23
HND-016259,2011,180200004,,,,25,18,43
HND-016261,2011,180200006,,,,1,2,3
HND-016262,2011,180200007,,,,6,7,13
HND-016258,2011,180200003,,,,12,18,30
HND-016261,2011,180200006,,,,1,6,7
HND-016262,2011,180200007,,,,3,1,4
HND-016256,2011,180200001,,,,13,9,22
HND-016257,2011,180200002,,,,3,0,3
HND-016259,2011,180200004,,,,11,13,24
HND-016260,2011,180200005,,,,6,2,8
HND-016266,2011,180200013,,,,39,27,66
HND-016256,2011,180200001,,,,22,9,31
HND-016258,2011,180200003,,,,19,24,43
HND-016261,2011,180200006,,,,5,7,12
HND-016262,2011,180200007,,,,2,2,4
HND-016257,2011,180200002,,,,2,4,6
HND-016259,2011,180200004,,,,14,18,32
HND-016266,2011,180200013,,,,30,30,60
HND-016256,2011,180200001,,,,14,9,23
HND-016257,2011,180200002,,,,3,3,6
HND-016258,2011,180200003,,,,7,12,19
HND-016259,2011,180200004,,,,18,16,34
HND-016262,2011,180200007,,,,4,0,4
HND-016266,2011,180200013,,,,28,28,56
HND-016260,2011,180200005,,,,8,1,9
HND-016261,2011,180200006,,,,0,3,3
HND-016259,2011,180200004,,,,19,14,33
HND-016264,2011,180200009,,,,41,56,97
HND-016264,2011,180200009,,,,41,39,80
HND-016259,2011,180200004,,,,11,20,31
HND-016264,2011,180200009,,,,24,36,60
HND-016259,2011,180200004,,,,8,14,22
HND-016264,2011,180200009,,,,13,3,16
HND-016264,2011,180200009,,,,3,4,7
HND-016264,2011,180200009,,,,3,1,4
HND-016279,2011,180300005,,,,11,11,22
HND-016300,2011,180300028,,,,4,12,16
HND-016304,2011,180300032,,,,3,4,7
,2011,180300126,,,,4,8,12
HND-016365,2011,180300131,,,,17,23,40
,2011,180300141,,,,4,9,13
,2011,180300142,,,,8,6,14
HND-016370,2011,180300144,,,,3,4,7
,2011,180300146,,,,6,10,16
,2011,180300154,,,,5,6,11
,2011,180300156,,,,6,13,19
HND-016297,2011,180300025,,,,6,4,10
HND-016308,2011,180300036,,,,3,8,11
HND-016318,2011,180300046,,,,5,15,20
HND-016324,2011,180300052,,,,8,2,10
,2011,180300099,,,,4,6,10
,2011,180300120,,,,0,1,1
HND-016363,2011,180300124,,,,6,13,19
HND-016364,2011,180300125,,,,7,6,13
,2011,180300137,,,,8,7,15
,2011,180300138,,,,7,6,13
HND-016369,2011,180300140,,,,7,8,15
,2011,180300145,,,,5,4,9
,2011,180300157,,,,5,4,9
HND-016362,2011,180300105,,,,1,1,2
HND-016336,2011,180300064,,,,0,1,1
HND-016345,2011,180300075,,,,4,0,4
,2011,180300086,,,,9,3,12
,2011,180300133,,,,0,1,1
HND-016334,2011,180300062,,,,18,12,30
HND-016335,2011,180300063,,,,11,8,19
HND-016338,2011,180300066,,,,2,4,6
HND-016339,2011,180300067,,,,1,0,1
HND-016340,2011,180300068,,,,8,6,14
HND-016341,2011,180300069,,,,4,5,9
HND-016344,2011,180300072,,,,2,2,4
HND-016345,2011,180300075,,,,5,1,6
HND-016353,2011,180300085,,,,0,1,1
HND-016362,2011,180300105,,,,4,8,12
HND-016291,2011,180300018,,,,4,8,12
HND-016304,2011,180300032,,,,2,6,8
HND-016336,2011,180300064,,,,0,6,6
HND-016342,2011,180300070,,,,5,1,6
HND-016351,2011,180300083,,,,4,4,8
HND-016352,2011,180300084,,,,4,8,12
,2011,180300086,,,,8,8,16
,2011,180300087,,,,10,8,18
HND-016354,2011,180300088,,,,4,6,10
HND-016358,2011,180300098,,,,13,16,29
HND-016361,2011,180300104,,,,3,3,6
,2011,180300133,,,,2,0,2
HND-016291,2011,180300018,,,,8,5,13
HND-016336,2011,180300064,,,,4,6,10
HND-016342,2011,180300070,,,,16,7,23
HND-016345,2011,180300075,,,,2,12,14
HND-016351,2011,180300083,,,,9,10,19
HND-016352,2011,180300084,,,,6,5,11
,2011,180300087,,,,6,6,12
HND-016354,2011,180300088,,,,9,5,14
HND-016361,2011,180300104,,,,5,5,10
HND-016282,2011,180300008,,,,20,18,38
HND-016302,2011,180300030,,,,11,13,24
HND-016304,2011,180300032,,,,6,8,14
HND-016334,2011,180300062,,,,23,31,54
HND-016335,2011,180300063,,,,24,30,54
HND-016338,2011,180300066,,,,4,5,9
HND-016339,2011,180300067,,,,16,17,33
HND-016340,2011,180300068,,,,15,22,37
HND-016341,2011,180300069,,,,22,25,47
HND-016344,2011,180300072,,,,9,9,18
HND-016353,2011,180300085,,,,6,4,10
,2011,180300086,,,,13,13,26
HND-016358,2011,180300098,,,,16,10,26
HND-016362,2011,180300105,,,,7,9,16
,2011,180300133,,,,3,5,8
HND-016275,2011,180300001,,,,17,6,23
HND-016276,2011,180300002,,,,4,3,7
HND-016278,2011,180300004,,,,5,2,7
HND-016279,2011,180300005,,,,18,12,30
HND-016282,2011,180300008,,,,44,40,84
HND-016287,2011,180300013,,,,2,2,4
HND-016288,2011,180300015,,,,7,5,12
HND-016289,2011,180300016,,,,13,15,28
HND-016293,2011,180300020,,,,5,3,8
HND-016294,2011,180300021,,,,10,15,25
HND-016295,2011,180300023,,,,15,5,20
HND-016296,2011,180300024,,,,20,14,34
HND-016298,2011,180300026,,,,12,5,17
HND-016299,2011,180300027,,,,7,5,12
HND-016300,2011,180300028,,,,9,19,28
HND-016303,2011,180300031,,,,56,48,104
HND-016305,2011,180300033,,,,11,8,19
HND-016306,2011,180300034,,,,42,43,85
HND-016309,2011,180300037,,,,20,20,40
HND-016312,2011,180300040,,,,4,7,11
HND-016314,2011,180300042,,,,5,7,12
HND-016315,2011,180300043,,,,48,41,89
HND-016317,2011,180300045,,,,11,2,13
HND-016320,2011,180300048,,,,6,7,13
HND-016325,2011,180300053,,,,4,3,7
HND-016327,2011,180300055,,,,5,7,12
HND-016328,2011,180300056,,,,8,2,10
HND-016348,2011,180300080,,,,2,1,3
HND-016350,2011,180300082,,,,8,7,15
HND-016357,2011,180300097,,,,4,2,6
,2011,180300133,,,,2,5,7
HND-016367,2011,180300135,,,,9,3,12
HND-016277,2011,180300003,,,,11,12,23
HND-016280,2011,180300006,,,,9,3,12
HND-016281,2011,180300007,,,,17,19,36
HND-016283,2011,180300009,,,,17,16,33
HND-016284,2011,180300010,,,,49,52,101
HND-016285,2011,180300011,,,,0,68,68
HND-016286,2011,180300012,,,,4,3,7
HND-016290,2011,180300017,,,,4,3,7
HND-016291,2011,180300018,,,,23,14,37
HND-016292,2011,180300019,,,,9,11,20
HND-016297,2011,180300025,,,,11,11,22
HND-016301,2011,180300029,,,,8,4,12
HND-016302,2011,180300030,,,,12,21,33
HND-016304,2011,180300032,,,,5,6,11
HND-016307,2011,180300035,,,,21,15,36
HND-016310,2011,180300038,,,,6,7,13
HND-016311,2011,180300039,,,,11,5,16
HND-016313,2011,180300041,,,,9,11,20
HND-016318,2011,180300046,,,,26,11,37
,2011,180300047,,,,0,1,1
HND-016321,2011,180300049,,,,6,10,16
HND-016322,2011,180300050,,,,18,17,35
HND-016323,2011,180300051,,,,2,2,4
HND-016324,2011,180300052,,,,8,5,13
HND-016326,2011,180300054,,,,3,3,6
HND-016329,2011,180300057,,,,10,10,20
HND-016330,2011,180300058,,,,39,22,61
HND-016331,2011,180300059,,,,57,0,57
HND-016332,2011,180300060,,,,15,14,29
HND-016333,2011,180300061,,,,3,5,8
HND-016346,2011,180300077,,,,1,4,5
HND-016347,2011,180300078,,,,18,19,37
HND-016349,2011,180300081,,,,11,7,18
HND-016355,2011,180300092,,,,5,10,15
HND-016359,2011,180300100,,,,1,0,1
HND-016360,2011,180300102,,,,21,16,37
HND-016366,2011,180300134,,,,2,1,3
HND-016368,2011,180300136,,,,2,2,4
HND-016371,2011,180300155,,,,4,3,7
HND-016275,2011,180300001,,,,6,5,11
HND-016277,2011,180300003,,,,4,7,11
HND-016278,2011,180300004,,,,2,1,3
HND-016280,2011,180300006,,,,7,7,14
HND-016281,2011,180300007,,,,14,11,25
HND-016284,2011,180300010,,,,56,48,104
HND-016285,2011,180300011,,,,0,45,45
HND-016286,2011,180300012,,,,5,4,9
,2011,180300014,,,,0,2,2
HND-016288,2011,180300015,,,,4,3,7
HND-016291,2011,180300018,,,,18,11,29
HND-016295,2011,180300023,,,,8,8,16
HND-016297,2011,180300025,,,,8,7,15
HND-016298,2011,180300026,,,,6,2,8
HND-016299,2011,180300027,,,,1,0,1
HND-016301,2011,180300029,,,,7,14,21
HND-016307,2011,180300035,,,,11,8,19
HND-016311,2011,180300039,,,,8,3,11
HND-016312,2011,180300040,,,,6,8,14
HND-016313,2011,180300041,,,,9,5,14
HND-016315,2011,180300043,,,,25,25,50
HND-016320,2011,180300048,,,,8,4,12
HND-016322,2011,180300050,,,,12,11,23
HND-016324,2011,180300052,,,,9,8,17
HND-016326,2011,180300054,,,,5,2,7
HND-016327,2011,180300055,,,,5,6,11
HND-016329,2011,180300057,,,,3,6,9
HND-016330,2011,180300058,,,,21,14,35
HND-016332,2011,180300060,,,,5,3,8
HND-016347,2011,180300078,,,,16,25,41
HND-016348,2011,180300080,,,,1,1,2
HND-016349,2011,180300081,,,,3,2,5
HND-016350,2011,180300082,,,,6,4,10
HND-016355,2011,180300092,,,,5,3,8
HND-016359,2011,180300100,,,,1,0,1
HND-016276,2011,180300002,,,,5,4,9
HND-016279,2011,180300005,,,,5,10,15
HND-016282,2011,180300008,,,,48,54,102
HND-016283,2011,180300009,,,,15,10,25
HND-016287,2011,180300013,,,,2,0,2
HND-016289,2011,180300016,,,,15,15,30
HND-016290,2011,180300017,,,,2,1,3
HND-016292,2011,180300019,,,,5,4,9
HND-016293,2011,180300020,,,,5,5,10
HND-016294,2011,180300021,,,,13,14,27
HND-016296,2011,180300024,,,,16,13,29
HND-016300,2011,180300028,,,,12,5,17
HND-016302,2011,180300030,,,,10,15,25
HND-016303,2011,180300031,,,,47,41,88
HND-016304,2011,180300032,,,,7,6,13
HND-016305,2011,180300033,,,,9,3,12
HND-016306,2011,180300034,,,,43,32,75
HND-016309,2011,180300037,,,,18,16,34
HND-016310,2011,180300038,,,,6,5,11
HND-016314,2011,180300042,,,,3,2,5
HND-016317,2011,180300045,,,,6,5,11
HND-016318,2011,180300046,,,,18,12,30
HND-016321,2011,180300049,,,,10,12,22
HND-016323,2011,180300051,,,,2,7,9
HND-016325,2011,180300053,,,,3,2,5
HND-016328,2011,180300056,,,,3,2,5
HND-016331,2011,180300059,,,,74,0,74
HND-016333,2011,180300061,,,,2,3,5
HND-016346,2011,180300077,,,,0,7,7
HND-016357,2011,180300097,,,,6,3,9
HND-016360,2011,180300102,,,,9,11,20
,2011,180300133,,,,6,2,8
HND-016366,2011,180300134,,,,2,1,3
HND-016367,2011,180300135,,,,2,6,8
HND-016368,2011,180300136,,,,1,3,4
HND-016275,2011,180300001,,,,10,4,14
HND-016277,2011,180300003,,,,6,8,14
HND-016280,2011,180300006,,,,6,8,14
HND-016281,2011,180300007,,,,8,16,24
HND-016283,2011,180300009,,,,13,11,24
HND-016284,2011,180300010,,,,62,54,116
HND-016285,2011,180300011,,,,0,65,65
HND-016286,2011,180300012,,,,7,2,9
HND-016291,2011,180300018,,,,21,13,34
HND-016292,2011,180300019,,,,6,8,14
HND-016297,2011,180300025,,,,0,5,5
HND-016301,2011,180300029,,,,11,11,22
HND-016304,2011,180300032,,,,6,2,8
HND-016307,2011,180300035,,,,13,15,28
HND-016310,2011,180300038,,,,4,5,9
HND-016311,2011,180300039,,,,4,6,10
HND-016313,2011,180300041,,,,6,6,12
HND-016318,2011,180300046,,,,16,14,30
,2011,180300047,,,,2,0,2
HND-016322,2011,180300050,,,,8,13,21
HND-016323,2011,180300051,,,,2,3,5
HND-016324,2011,180300052,,,,9,7,16
HND-016326,2011,180300054,,,,1,1,2
HND-016327,2011,180300055,,,,5,4,9
HND-016329,2011,180300057,,,,5,4,9
HND-016330,2011,180300058,,,,20,18,38
HND-016331,2011,180300059,,,,52,0,52
HND-016332,2011,180300060,,,,4,3,7
HND-016333,2011,180300061,,,,2,3,5
HND-016346,2011,180300077,,,,5,0,5
HND-016347,2011,180300078,,,,15,20,35
HND-016348,2011,180300080,,,,1,1,2
HND-016349,2011,180300081,,,,0,4,4
HND-016355,2011,180300092,,,,3,4,7
HND-016359,2011,180300100,,,,0,3,3
,2011,180300133,,,,2,3,5
HND-016367,2011,180300135,,,,1,9,10
HND-016276,2011,180300002,,,,10,7,17
HND-016278,2011,180300004,,,,5,3,8
HND-016279,2011,180300005,,,,13,10,23
HND-016282,2011,180300008,,,,33,31,64
HND-016287,2011,180300013,,,,0,1,1
HND-016288,2011,180300015,,,,3,3,6
HND-016289,2011,180300016,,,,17,16,33
HND-016290,2011,180300017,,,,2,3,5
HND-016293,2011,180300020,,,,9,2,11
HND-016294,2011,180300021,,,,6,5,11
HND-016295,2011,180300023,,,,3,6,9
HND-016296,2011,180300024,,,,17,16,33
HND-016298,2011,180300026,,,,2,10,12
HND-016299,2011,180300027,,,,0,3,3
HND-016300,2011,180300028,,,,10,11,21
HND-016302,2011,180300030,,,,10,13,23
HND-016303,2011,180300031,,,,31,36,67
HND-016305,2011,180300033,,,,6,8,14
HND-016306,2011,180300034,,,,31,34,65
HND-016309,2011,180300037,,,,15,16,31
HND-016312,2011,180300040,,,,9,4,13
HND-016314,2011,180300042,,,,2,7,9
HND-016315,2011,180300043,,,,18,17,35
HND-016317,2011,180300045,,,,4,1,5
HND-016320,2011,180300048,,,,5,9,14
HND-016321,2011,180300049,,,,3,3,6
HND-016325,2011,180300053,,,,3,0,3
HND-016328,2011,180300056,,,,1,3,4
HND-016350,2011,180300082,,,,5,4,9
HND-016357,2011,180300097,,,,3,0,3
HND-016360,2011,180300102,,,,14,13,27
HND-016366,2011,180300134,,,,1,1,2
HND-016368,2011,180300136,,,,3,1,4
HND-016371,2011,180300155,,,,2,0,2
HND-016275,2011,180300001,,,,9,8,17
HND-016276,2011,180300002,,,,3,3,6
HND-016277,2011,180300003,,,,6,6,12
HND-016278,2011,180300004,,,,1,0,1
HND-016281,2011,180300007,,,,10,12,22
HND-016282,2011,180300008,,,,39,41,80
HND-016285,2011,180300011,,,,0,46,46
HND-016286,2011,180300012,,,,3,3,6
HND-016288,2011,180300015,,,,5,4,9
HND-016294,2011,180300021,,,,8,5,13
HND-016295,2011,180300023,,,,4,8,12
HND-016298,2011,180300026,,,,4,4,8
HND-016299,2011,180300027,,,,2,3,5
HND-016301,2011,180300029,,,,7,12,19
HND-016305,2011,180300033,,,,7,9,16
HND-016309,2011,180300037,,,,18,19,37
HND-016311,2011,180300039,,,,6,5,11
HND-016312,2011,180300040,,,,2,6,8
HND-016313,2011,180300041,,,,5,1,6
HND-016314,2011,180300042,,,,4,10,14
HND-016315,2011,180300043,,,,31,29,60
,2011,180300047,,,,3,3,6
HND-016320,2011,180300048,,,,3,5,8
HND-016324,2011,180300052,,,,7,2,9
HND-016327,2011,180300055,,,,5,6,11
HND-016329,2011,180300057,,,,2,0,2
HND-016332,2011,180300060,,,,2,3,5
HND-016347,2011,180300078,,,,17,17,34
HND-016348,2011,180300080,,,,2,2,4
HND-016349,2011,180300081,,,,0,6,6
HND-016350,2011,180300082,,,,6,5,11
HND-016366,2011,180300134,,,,5,2,7
HND-016368,2011,180300136,,,,2,0,2
HND-016279,2011,180300005,,,,8,13,21
HND-016280,2011,180300006,,,,5,2,7
HND-016283,2011,180300009,,,,15,16,31
HND-016284,2011,180300010,,,,42,42,84
HND-016287,2011,180300013,,,,2,0,2
HND-016289,2011,180300016,,,,7,7,14
HND-016290,2011,180300017,,,,2,0,2
HND-016291,2011,180300018,,,,12,11,23
HND-016292,2011,180300019,,,,4,2,6
HND-016293,2011,180300020,,,,4,1,5
HND-016296,2011,180300024,,,,10,16,26
HND-016297,2011,180300025,,,,0,3,3
HND-016300,2011,180300028,,,,10,9,19
HND-016302,2011,180300030,,,,17,12,29
HND-016303,2011,180300031,,,,37,50,87
HND-016304,2011,180300032,,,,8,4,12
HND-016306,2011,180300034,,,,36,36,72
HND-016307,2011,180300035,,,,8,14,22
HND-016310,2011,180300038,,,,2,8,10
HND-016317,2011,180300045,,,,3,6,9
HND-016318,2011,180300046,,,,9,8,17
HND-016321,2011,180300049,,,,6,7,13
HND-016322,2011,180300050,,,,12,10,22
HND-016325,2011,180300053,,,,1,0,1
HND-016326,2011,180300054,,,,0,5,5
HND-016328,2011,180300056,,,,3,1,4
HND-016330,2011,180300058,,,,21,20,41
HND-016331,2011,180300059,,,,53,0,53
HND-016333,2011,180300061,,,,6,4,10
HND-016346,2011,180300077,,,,2,2,4
HND-016355,2011,180300092,,,,4,4,8
HND-016357,2011,180300097,,,,2,2,4
HND-016359,2011,180300100,,,,5,1,6
HND-016360,2011,180300102,,,,12,11,23
,2011,180300133,,,,1,3,4
HND-016367,2011,180300135,,,,4,5,9
HND-016371,2011,180300155,,,,1,1,2
HND-016275,2011,180300001,,,,6,5,11
HND-016276,2011,180300002,,,,3,3,6
HND-016278,2011,180300004,,,,1,2,3
HND-016281,2011,180300007,,,,14,9,23
HND-016282,2011,180300008,,,,40,37,77
HND-016285,2011,180300011,,,,0,55,55
HND-016288,2011,180300015,,,,3,4,7
HND-016289,2011,180300016,,,,13,11,24
HND-016294,2011,180300021,,,,6,7,13
HND-016295,2011,180300023,,,,9,6,15
HND-016298,2011,180300026,,,,5,6,11
HND-016299,2011,180300027,,,,2,2,4
HND-016303,2011,180300031,,,,34,32,66
HND-016305,2011,180300033,,,,7,6,13
HND-016309,2011,180300037,,,,24,16,40
HND-016311,2011,180300039,,,,2,1,3
HND-016312,2011,180300040,,,,7,5,12
HND-016313,2011,180300041,,,,3,4,7
HND-016314,2011,180300042,,,,1,4,5
HND-016315,2011,180300043,,,,26,26,52
HND-016317,2011,180300045,,,,5,4,9
HND-016320,2011,180300048,,,,4,5,9
HND-016327,2011,180300055,,,,4,2,6
HND-016328,2011,180300056,,,,3,2,5
HND-016329,2011,180300057,,,,1,1,2
HND-016347,2011,180300078,,,,5,11,16
HND-016348,2011,180300080,,,,0,1,1
HND-016350,2011,180300082,,,,1,9,10
HND-016357,2011,180300097,,,,1,2,3
HND-016366,2011,180300134,,,,2,4,6
HND-016368,2011,180300136,,,,1,1,2
HND-016371,2011,180300155,,,,2,1,3
HND-016277,2011,180300003,,,,5,3,8
HND-016279,2011,180300005,,,,9,9,18
HND-016280,2011,180300006,,,,7,2,9
HND-016283,2011,180300009,,,,20,19,39
HND-016284,2011,180300010,,,,45,46,91
HND-016286,2011,180300012,,,,3,3,6
HND-016287,2011,180300013,,,,7,2,9
,2011,180300014,,,,0,1,1
HND-016290,2011,180300017,,,,3,1,4
HND-016291,2011,180300018,,,,12,12,24
HND-016292,2011,180300019,,,,4,2,6
HND-016293,2011,180300020,,,,2,0,2
HND-016296,2011,180300024,,,,23,15,38
HND-016300,2011,180300028,,,,8,9,17
HND-016301,2011,180300029,,,,14,11,25
HND-016302,2011,180300030,,,,17,13,30
HND-016304,2011,180300032,,,,7,10,17
HND-016306,2011,180300034,,,,33,43,76
HND-016307,2011,180300035,,,,8,10,18
HND-016310,2011,180300038,,,,1,5,6
HND-016318,2011,180300046,,,,9,3,12
HND-016321,2011,180300049,,,,8,5,13
HND-016322,2011,180300050,,,,6,7,13
HND-016323,2011,180300051,,,,0,3,3
HND-016324,2011,180300052,,,,4,2,6
HND-016325,2011,180300053,,,,1,2,3
HND-016326,2011,180300054,,,,1,0,1
HND-016330,2011,180300058,,,,25,16,41
HND-016331,2011,180300059,,,,63,0,63
HND-016332,2011,180300060,,,,3,4,7
HND-016333,2011,180300061,,,,2,3,5
HND-016346,2011,180300077,,,,2,2,4
HND-016349,2011,180300081,,,,1,4,5
HND-016355,2011,180300092,,,,5,6,11
HND-016359,2011,180300100,,,,2,1,3
HND-016360,2011,180300102,,,,11,14,25
HND-016367,2011,180300135,,,,2,3,5
HND-016276,2011,180300002,,,,0,5,5
HND-016279,2011,180300005,,,,3,8,11
HND-016282,2011,180300008,,,,30,42,72
HND-016283,2011,180300009,,,,8,14,22
HND-016287,2011,180300013,,,,2,3,5
HND-016289,2011,180300016,,,,7,7,14
HND-016290,2011,180300017,,,,2,1,3
HND-016292,2011,180300019,,,,4,5,9
HND-016294,2011,180300021,,,,8,8,16
HND-016296,2011,180300024,,,,16,13,29
HND-016299,2011,180300027,,,,2,1,3
HND-016300,2011,180300028,,,,13,8,21
HND-016302,2011,180300030,,,,14,19,33
HND-016303,2011,180300031,,,,26,27,53
HND-016304,2011,180300032,,,,8,9,17
HND-016305,2011,180300033,,,,6,9,15
HND-016306,2011,180300034,,,,27,35,62
HND-016309,2011,180300037,,,,19,10,29
HND-016310,2011,180300038,,,,0,3,3
HND-016314,2011,180300042,,,,2,0,2
HND-016317,2011,180300045,,,,6,6,12
HND-016318,2011,180300046,,,,3,11,14
HND-016321,2011,180300049,,,,2,4,6
HND-016323,2011,180300051,,,,1,2,3
HND-016325,2011,180300053,,,,3,0,3
HND-016328,2011,180300056,,,,4,1,5
HND-016331,2011,180300059,,,,35,0,35
HND-016333,2011,180300061,,,,4,3,7
HND-016346,2011,180300077,,,,2,2,4
HND-016357,2011,180300097,,,,1,2,3
HND-016360,2011,180300102,,,,8,10,18
HND-016367,2011,180300135,,,,4,2,6
HND-016368,2011,180300136,,,,3,1,4
HND-016371,2011,180300155,,,,2,2,4
HND-016275,2011,180300001,,,,1,0,1
HND-016277,2011,180300003,,,,7,9,16
HND-016278,2011,180300004,,,,1,4,5
HND-016280,2011,180300006,,,,3,5,8
HND-016281,2011,180300007,,,,12,15,27
HND-016284,2011,180300010,,,,63,59,122
HND-016285,2011,180300011,,,,0,67,67
HND-016286,2011,180300012,,,,0,5,5
,2011,180300014,,,,2,2,4
HND-016288,2011,180300015,,,,2,3,5
HND-016291,2011,180300018,,,,14,11,25
HND-016295,2011,180300023,,,,7,8,15
HND-016298,2011,180300026,,,,4,4,8
HND-016301,2011,180300029,,,,14,8,22
HND-016307,2011,180300035,,,,6,9,15
HND-016312,2011,180300040,,,,2,2,4
HND-016313,2011,180300041,,,,6,7,13
HND-016315,2011,180300043,,,,11,15,26
HND-016320,2011,180300048,,,,4,5,9
HND-016322,2011,180300050,,,,7,10,17
HND-016324,2011,180300052,,,,5,4,9
HND-016326,2011,180300054,,,,2,0,2
HND-016327,2011,180300055,,,,2,4,6
HND-016329,2011,180300057,,,,1,1,2
HND-016330,2011,180300058,,,,13,15,28
HND-016332,2011,180300060,,,,2,3,5
HND-016347,2011,180300078,,,,14,16,30
HND-016348,2011,180300080,,,,3,0,3
HND-016349,2011,180300081,,,,5,3,8
HND-016350,2011,180300082,,,,3,3,6
HND-016355,2011,180300092,,,,0,1,1
HND-016359,2011,180300100,,,,2,2,4
HND-016282,2011,180300008,,,,38,42,80
HND-016289,2011,180300016,,,,14,14,28
HND-016309,2011,180300037,,,,36,21,57
,2011,180300091,,,,42,31,73
HND-016291,2011,180300018,,,,18,17,35
HND-016306,2011,180300034,,,,33,31,64
HND-016330,2011,180300058,,,,33,21,54
HND-016343,2011,180300071,,,,125,132,257
,2011,180300089,,,,76,38,114
HND-016360,2011,180300102,,,,9,16,25
HND-016291,2011,180300018,,,,6,12,18
HND-016330,2011,180300058,,,,19,25,44
HND-016343,2011,180300071,,,,85,100,185
,2011,180300089,,,,60,29,89
HND-016282,2011,180300008,,,,23,22,45
HND-016289,2011,180300016,,,,19,10,29
HND-016306,2011,180300034,,,,17,28,45
HND-016309,2011,180300037,,,,29,19,48
,2011,180300091,,,,32,19,51
HND-016360,2011,180300102,,,,6,6,12
HND-016282,2011,180300008,,,,14,23,37
HND-016291,2011,180300018,,,,9,9,18
HND-016309,2011,180300037,,,,18,23,41
,2011,180300089,,,,51,33,84
HND-016289,2011,180300016,,,,6,4,10
HND-016306,2011,180300034,,,,13,22,35
HND-016330,2011,180300058,,,,10,23,33
HND-016343,2011,180300071,,,,66,104,170
,2011,180300091,,,,25,12,37
HND-016360,2011,180300102,,,,3,3,6
HND-016343,2011,180300071,,,,29,38,67
,2011,180300089,,,,3,18,21
,2011,180300091,,,,2,5,7
HND-016343,2011,180300071,,,,26,25,51
HND-016343,2011,180300071,,,,16,37,53
,2011,180300089,,,,3,12,15
HND-016382,2011,180400012,,,,4,6,10
,2011,180400106,,,,19,12,31
,2011,180400112,,,,10,8,18
,2011,180400117,,,,9,5,14
HND-016456,2011,180400120,,,,15,20,35
,2011,180400123,,,,16,6,22
HND-016458,2011,180400124,,,,13,10,23
,2011,180400143,,,,8,4,12
,2011,180400146,,,,9,13,22
HND-016471,2011,180400147,,,,10,17,27
,2011,180400148,,,,17,10,27
,2011,180400152,,,,6,6,12
HND-016476,2011,180400158,,,,4,5,9
HND-016477,2011,180400159,,,,5,15,20
HND-016478,2011,180400160,,,,8,7,15
,2011,180400161,,,,12,18,30
,2011,180400164,,,,6,12,18
HND-016484,2011,180400178,,,,7,7,14
,2011,180400218,,,,6,6,12
HND-016498,2011,180400221,,,,6,6,12
HND-016501,2011,180400250,,,,4,3,7
HND-016504,2011,180400259,,,,14,8,22
,2011,180400263,,,,9,10,19
HND-016507,2011,180400265,,,,14,14,28
,2011,180400266,,,,4,9,13
HND-016508,2011,180400267,,,,33,19,52
HND-016510,2011,180400273,,,,13,11,24
,2011,180400276,,,,4,2,6
,2011,180400277,,,,16,9,25
HND-016512,2011,180400283,,,,17,4,21
,2011,180400298,,,,9,6,15
HND-016517,2011,180400302,,,,8,8,16
HND-016522,2011,180400314,,,,12,17,29
,2011,180400324,,,,5,4,9
,2011,180400327,,,,9,5,14
HND-016529,2011,180400328,,,,7,7,14
HND-016379,2011,180400009,,,,13,12,25
HND-016404,2011,180400035,,,,7,9,16
,2011,180400086,,,,8,10,18
HND-016444,2011,180400089,,,,9,13,22
,2011,180400091,,,,1,2,3
,2011,180400104,,,,14,13,27
,2011,180400108,,,,10,19,29
,2011,180400109,,,,17,10,27
,2011,180400111,,,,11,5,16
,2011,180400113,,,,10,8,18
,2011,180400114,,,,14,6,20
,2011,180400119,,,,4,3,7
HND-016457,2011,180400121,,,,7,10,17
,2011,180400122,,,,6,6,12
,2011,180400126,,,,5,5,10
HND-016461,2011,180400129,,,,8,11,19
HND-016472,2011,180400149,,,,14,8,22
,2011,180400151,,,,5,4,9
,2011,180400153,,,,13,10,23
HND-016475,2011,180400156,,,,9,8,17
,2011,180400162,,,,8,7,15
HND-016480,2011,180400165,,,,11,10,21
HND-016482,2011,180400173,,,,8,7,15
HND-016492,2011,180400207,,,,5,5,10
,2011,180400209,,,,9,10,19
HND-016494,2011,180400210,,,,6,8,14
HND-016496,2011,180400215,,,,12,5,17
HND-016497,2011,180400219,,,,6,8,14
,2011,180400220,,,,10,5,15
HND-016499,2011,180400222,,,,9,8,17
,2011,180400248,,,,14,12,26
,2011,180400256,,,,7,9,16
HND-016505,2011,180400260,,,,7,7,14
HND-016506,2011,180400264,,,,6,4,10
,2011,180400268,,,,6,5,11
,2011,180400270,,,,6,5,11
HND-016509,2011,180400271,,,,6,5,11
HND-016511,2011,180400274,,,,11,9,20
,2011,180400275,,,,7,13,20
,2011,180400279,,,,4,6,10
,2011,180400300,,,,7,13,20
HND-016516,2011,180400301,,,,6,4,10
HND-016518,2011,180400303,,,,8,7,15
,2011,180400311,,,,6,4,10
,2011,180400313,,,,7,9,16
,2011,180400315,,,,6,9,15
,2011,180400316,,,,3,7,10
HND-016523,2011,180400317,,,,12,10,22
,2011,180400326,,,,10,6,16
,2011,180400334,,,,11,9,20
HND-016530,2011,180400336,,,,7,6,13
,2011,180400337,,,,7,13,20
HND-016531,2011,180400338,,,,6,2,8
,2011,180400172,,,,4,3,7
,2011,180400191,,,,0,1,1
,2011,180400243,,,,5,3,8
,2011,180400252,,,,6,5,11
,2011,180400141,,,,13,9,22
,2011,180400168,,,,2,1,3
,2011,180400171,,,,2,3,5
,2011,180400184,,,,0,1,1
,2011,180400192,,,,0,1,1
HND-016489,2011,180400193,,,,9,6,15
,2011,180400251,,,,3,2,5
HND-016503,2011,180400257,,,,4,3,7
,2011,180400047,,,,7,6,13
,2011,180400060,,,,2,1,3
HND-016449,2011,180400100,,,,4,2,6
,2011,180400125,,,,2,2,4
,2011,180400168,,,,1,3,4
,2011,180400171,,,,3,2,5
,2011,180400172,,,,9,10,19
,2011,180400181,,,,2,3,5
,2011,180400183,,,,4,3,7
HND-016489,2011,180400193,,,,9,5,14
,2011,180400194,,,,1,1,2
,2011,180400211,,,,1,0,1
,2011,180400230,,,,2,2,4
,2011,180400238,,,,1,2,3
,2011,180400243,,,,19,7,26
,2011,180400251,,,,8,6,14
,2011,180400252,,,,21,24,45
HND-016513,2011,180400285,,,,1,1,2
,2011,180400286,,,,2,2,4
,2011,180400290,,,,1,5,6
HND-016525,2011,180400319,,,,8,2,10
,2011,180400325,,,,7,0,7
,2011,180400331,,,,3,3,6
,2011,180400335,,,,2,5,7
HND-016403,2011,180400034,,,,0,2,2
HND-016425,2011,180400057,,,,25,12,37
HND-016440,2011,180400076,,,,9,8,17
HND-016441,2011,180400077,,,,10,15,25
,2011,180400079,,,,0,2,2
,2011,180400105,,,,0,2,2
HND-016460,2011,180400128,,,,1,3,4
,2011,180400130,,,,5,9,14
HND-016464,2011,180400133,,,,10,10,20
,2011,180400141,,,,12,10,22
,2011,180400157,,,,8,3,11
,2011,180400175,,,,3,3,6
,2011,180400180,,,,1,6,7
,2011,180400182,,,,3,9,12
,2011,180400184,,,,4,4,8
HND-016488,2011,180400189,,,,10,8,18
,2011,180400191,,,,8,12,20
,2011,180400192,,,,4,4,8
,2011,180400212,,,,7,5,12
,2011,180400216,,,,3,3,6
,2011,180400253,,,,1,3,4
HND-016503,2011,180400257,,,,2,5,7
HND-016503,2011,180400257,,,,11,4,15
,2011,180400262,,,,11,4,15
HND-016378,2011,180400008,,,,7,11,18
HND-016386,2011,180400016,,,,24,17,41
HND-016399,2011,180400029,,,,19,11,30
HND-016403,2011,180400034,,,,7,3,10
HND-016407,2011,180400038,,,,37,23,60
HND-016411,2011,180400042,,,,16,18,34
HND-016412,2011,180400043,,,,8,13,21
,2011,180400060,,,,7,12,19
HND-016440,2011,180400076,,,,17,31,48
HND-016441,2011,180400077,,,,44,51,95
,2011,180400082,,,,21,15,36
,2011,180400083,,,,11,8,19
,2011,180400084,,,,29,28,57
,2011,180400093,,,,35,32,67
,2011,180400094,,,,31,31,62
HND-016446,2011,180400095,,,,14,8,22
,2011,180400105,,,,11,14,25
HND-016459,2011,180400127,,,,13,13,26
HND-016460,2011,180400128,,,,27,32,59
HND-016462,2011,180400131,,,,83,79,162
,2011,180400141,,,,15,11,26
,2011,180400157,,,,10,8,18
,2011,180400171,,,,10,12,22
,2011,180400175,,,,15,13,28
,2011,180400180,,,,3,9,12
,2011,180400182,,,,2,6,8
,2011,180400183,,,,8,8,16
,2011,180400184,,,,14,13,27
HND-016488,2011,180400189,,,,14,6,20
,2011,180400192,,,,4,8,12
,2011,180400194,,,,1,1,2
HND-016493,2011,180400208,,,,16,21,37
,2011,180400211,,,,3,1,4
,2011,180400212,,,,7,7,14
,2011,180400213,,,,11,8,19
HND-016500,2011,180400249,,,,27,33,60
,2011,180400253,,,,0,2,2
HND-016503,2011,180400257,,,,13,12,25
,2011,180400262,,,,13,12,25
HND-016525,2011,180400319,,,,10,5,15
,2011,180400335,,,,14,11,25
HND-016405,2011,180400036,,,,4,5,9
HND-016408,2011,180400039,,,,11,13,24
,2011,180400047,,,,19,15,34
HND-016424,2011,180400056,,,,43,25,68
HND-016431,2011,180400065,,,,5,14,19
HND-016439,2011,180400074,,,,19,11,30
,2011,180400079,,,,4,2,6
HND-016443,2011,180400081,,,,15,7,22
HND-016445,2011,180400090,,,,27,33,60
,2011,180400096,,,,9,6,15
HND-016449,2011,180400100,,,,9,11,20
,2011,180400125,,,,2,1,3
,2011,180400130,,,,16,21,37
HND-016464,2011,180400133,,,,9,14,23
,2011,180400168,,,,4,2,6
,2011,180400172,,,,13,21,34
,2011,180400176,,,,7,7,14
,2011,180400181,,,,12,12,24
HND-016489,2011,180400193,,,,6,5,11
,2011,180400216,,,,6,3,9
,2011,180400230,,,,2,1,3
,2011,180400238,,,,4,6,10
,2011,180400243,,,,17,12,29
,2011,180400251,,,,10,5,15
,2011,180400252,,,,26,29,55
HND-016503,2011,180400257,,,,4,4,8
HND-016513,2011,180400285,,,,10,10,20
,2011,180400286,,,,5,4,9
,2011,180400290,,,,7,7,14
,2011,180400297,,,,13,11,24
,2011,180400306,,,,12,5,17
,2011,180400325,,,,7,7,14
,2011,180400331,,,,4,4,8
HND-016372,2011,180400002,,,,32,26,58
HND-016373,2011,180400003,,,,53,46,99
HND-016374,2011,180400004,,,,10,8,18
HND-016375,2011,180400005,,,,39,35,74
HND-016376,2011,180400006,,,,7,5,12
HND-016377,2011,180400007,,,,5,5,10
HND-016381,2011,180400011,,,,7,5,12
HND-016383,2011,180400013,,,,6,4,10
HND-016386,2011,180400016,,,,11,11,22
HND-016387,2011,180400017,,,,19,10,29
HND-016392,2011,180400022,,,,54,48,102
HND-016393,2011,180400023,,,,8,7,15
HND-016394,2011,180400024,,,,13,9,22
HND-016395,2011,180400025,,,,93,93,186
HND-016396,2011,180400026,,,,23,22,45
HND-016397,2011,180400027,,,,12,9,21
HND-016399,2011,180400029,,,,20,22,42
HND-016404,2011,180400035,,,,28,17,45
HND-016405,2011,180400036,,,,20,11,31
HND-016409,2011,180400040,,,,63,51,114
HND-016412,2011,180400043,,,,27,31,58
HND-016413,2011,180400044,,,,11,15,26
HND-016415,2011,180400046,,,,73,53,126
,2011,180400047,,,,26,23,49
HND-016417,2011,180400049,,,,28,30,58
,2011,180400052,,,,14,15,29
HND-016424,2011,180400056,,,,66,61,127
,2011,180400059,,,,5,2,7
,2011,180400060,,,,20,17,37
HND-016428,2011,180400062,,,,84,76,160
HND-016430,2011,180400064,,,,42,49,91
HND-016433,2011,180400067,,,,27,25,52
HND-016435,2011,180400070,,,,15,13,28
HND-016436,2011,180400071,,,,51,42,93
HND-016437,2011,180400072,,,,24,25,49
HND-016439,2011,180400074,,,,37,39,76
HND-016448,2011,180400099,,,,1,2,3
HND-016450,2011,180400101,,,,5,7,12
HND-016451,2011,180400102,,,,24,32,56
HND-016455,2011,180400118,,,,4,6,10
HND-016462,2011,180400131,,,,140,120,260
HND-016463,2011,180400132,,,,10,11,21
,2011,180400137,,,,3,2,5
HND-016466,2011,180400138,,,,48,59,107
,2011,180400143,,,,11,9,20
,2011,180400144,,,,1,1,2
HND-016472,2011,180400149,,,,29,25,54
,2011,180400171,,,,11,8,19
,2011,180400172,,,,28,13,41
HND-016484,2011,180400178,,,,16,14,30
,2011,180400179,,,,3,4,7
,2011,180400180,,,,6,7,13
,2011,180400183,,,,8,10,18
,2011,180400184,,,,16,11,27
HND-016485,2011,180400185,,,,16,15,31
HND-016486,2011,180400186,,,,20,17,37
HND-016487,2011,180400187,,,,3,6,9
HND-016488,2011,180400189,,,,19,23,42
,2011,180400211,,,,4,8,12
,2011,180400212,,,,11,9,20
,2011,180400213,,,,16,12,28
HND-016495,2011,180400214,,,,9,4,13
,2011,180400251,,,,17,14,31
,2011,180400253,,,,2,4,6
,2011,180400254,,,,4,3,7
HND-016502,2011,180400255,,,,4,3,7
HND-016513,2011,180400285,,,,16,9,25
,2011,180400286,,,,4,2,6
,2011,180400306,,,,15,19,34
,2011,180400307,,,,4,2,6
,2011,180400312,,,,14,7,21
HND-016524,2011,180400318,,,,58,26,84
HND-016525,2011,180400319,,,,34,23,57
HND-016526,2011,180400320,,,,4,7,11
HND-016527,2011,180400321,,,,37,29,66
HND-016528,2011,180400322,,,,35,22,57
,2011,180400325,,,,11,8,19
,2011,180400330,,,,2,3,5
,2011,180400331,,,,5,3,8
HND-016532,2011,180400339,,,,17,8,25
HND-016533,2011,180400340,,,,6,3,9
HND-016378,2011,180400008,,,,23,25,48
HND-016379,2011,180400009,,,,25,23,48
HND-016380,2011,180400010,,,,19,12,31
HND-016382,2011,180400012,,,,5,5,10
HND-016384,2011,180400014,,,,11,11,22
HND-016385,2011,180400015,,,,1,2,3
,2011,180400018,,,,2,4,6
HND-016389,2011,180400019,,,,15,15,30
,2011,180400020,,,,13,16,29
HND-016391,2011,180400021,,,,18,16,34
HND-016398,2011,180400028,,,,15,12,27
HND-016400,2011,180400030,,,,8,3,11
HND-016401,2011,180400031,,,,37,45,82
HND-016402,2011,180400032,,,,15,12,27
HND-016403,2011,180400034,,,,27,23,50
HND-016406,2011,180400037,,,,24,20,44
HND-016407,2011,180400038,,,,45,45,90
HND-016408,2011,180400039,,,,32,26,58
HND-016410,2011,180400041,,,,39,36,75
HND-016411,2011,180400042,,,,41,24,65
HND-016414,2011,180400045,,,,77,60,137
,2011,180400048,,,,58,41,99
HND-016418,2011,180400050,,,,7,12,19
,2011,180400051,,,,15,10,25
HND-016421,2011,180400053,,,,6,9,15
,2011,180400054,,,,10,13,23
HND-016423,2011,180400055,,,,28,30,58
HND-016425,2011,180400057,,,,31,22,53
,2011,180400058,,,,6,6,12
,2011,180400061,,,,5,6,11
HND-016429,2011,180400063,,,,22,20,42
HND-016431,2011,180400065,,,,39,37,76
HND-016432,2011,180400066,,,,45,43,88
HND-016434,2011,180400068,,,,13,14,27
HND-016438,2011,180400073,,,,25,27,52
,2011,180400079,,,,2,6,8
HND-016452,2011,180400103,,,,7,3,10
HND-016453,2011,180400110,,,,15,15,30
HND-016454,2011,180400116,,,,7,3,10
HND-016467,2011,180400140,,,,45,32,77
HND-016468,2011,180400142,,,,5,11,16
,2011,180400157,,,,18,12,30
HND-016479,2011,180400163,,,,6,14,20
,2011,180400175,,,,24,15,39
,2011,180400176,,,,10,9,19
HND-016483,2011,180400177,,,,52,46,98
,2011,180400181,,,,10,8,18
,2011,180400192,,,,7,6,13
HND-016490,2011,180400196,,,,3,4,7
HND-016491,2011,180400205,,,,34,42,76
,2011,180400238,,,,9,4,13
,2011,180400243,,,,18,22,40
,2011,180400252,,,,26,27,53
HND-016503,2011,180400257,,,,19,11,30
,2011,180400266,,,,16,13,29
HND-016519,2011,180400305,,,,36,36,72
,2011,180400308,,,,2,1,3
HND-016372,2011,180400002,,,,27,27,54
HND-016373,2011,180400003,,,,53,39,92
HND-016375,2011,180400005,,,,25,27,52
HND-016376,2011,180400006,,,,5,4,9
HND-016378,2011,180400008,,,,24,13,37
HND-016379,2011,180400009,,,,23,22,45
HND-016385,2011,180400015,,,,1,1,2
HND-016386,2011,180400016,,,,11,6,17
HND-016389,2011,180400019,,,,19,13,32
,2011,180400020,,,,9,13,22
HND-016394,2011,180400024,,,,14,12,26
HND-016398,2011,180400028,,,,11,13,24
HND-016399,2011,180400029,,,,16,13,29
HND-016400,2011,180400030,,,,4,6,10
HND-016402,2011,180400032,,,,16,17,33
HND-016403,2011,180400034,,,,27,21,48
HND-016404,2011,180400035,,,,26,15,41
HND-016407,2011,180400038,,,,33,31,64
HND-016411,2011,180400042,,,,32,19,51
HND-016412,2011,180400043,,,,32,38,70
,2011,180400048,,,,55,54,109
HND-016417,2011,180400049,,,,28,38,66
HND-016418,2011,180400050,,,,9,5,14
,2011,180400051,,,,9,10,19
,2011,180400052,,,,12,11,23
,2011,180400054,,,,8,6,14
,2011,180400058,,,,7,4,11
,2011,180400060,,,,22,30,52
,2011,180400061,,,,4,3,7
HND-016428,2011,180400062,,,,85,80,165
HND-016429,2011,180400063,,,,18,15,33
HND-016432,2011,180400066,,,,40,36,76
HND-016433,2011,180400067,,,,23,20,43
HND-016434,2011,180400068,,,,12,7,19
HND-016436,2011,180400071,,,,33,51,84
HND-016448,2011,180400099,,,,0,2,2
HND-016450,2011,180400101,,,,9,6,15
HND-016455,2011,180400118,,,,5,3,8
HND-016462,2011,180400131,,,,129,107,236
HND-016463,2011,180400132,,,,5,7,12
HND-016468,2011,180400142,,,,7,6,13
,2011,180400143,,,,6,6,12
HND-016472,2011,180400149,,,,13,15,28
,2011,180400157,,,,10,12,22
,2011,180400171,,,,10,12,22
,2011,180400175,,,,21,18,39
HND-016483,2011,180400177,,,,47,40,87
,2011,180400179,,,,10,7,17
,2011,180400180,,,,2,2,4
,2011,180400183,,,,12,11,23
,2011,180400184,,,,4,11,15
HND-016485,2011,180400185,,,,16,12,28
HND-016486,2011,180400186,,,,19,13,32
,2011,180400192,,,,3,4,7
HND-016490,2011,180400196,,,,1,5,6
HND-016491,2011,180400205,,,,39,45,84
,2011,180400211,,,,3,3,6
,2011,180400212,,,,10,17,27
HND-016495,2011,180400214,,,,7,4,11
,2011,180400253,,,,2,2,4
HND-016503,2011,180400257,,,,16,17,33
,2011,180400306,,,,14,18,32
,2011,180400307,,,,5,2,7
,2011,180400308,,,,2,1,3
HND-016524,2011,180400318,,,,44,34,78
HND-016525,2011,180400319,,,,17,32,49
HND-016527,2011,180400321,,,,21,24,45
,2011,180400330,,,,1,1,2
HND-016532,2011,180400339,,,,8,7,15
HND-016533,2011,180400340,,,,3,4,7
HND-016374,2011,180400004,,,,7,17,24
HND-016377,2011,180400007,,,,3,5,8
HND-016380,2011,180400010,,,,12,12,24
HND-016381,2011,180400011,,,,5,2,7
HND-016382,2011,180400012,,,,3,9,12
HND-016383,2011,180400013,,,,3,3,6
HND-016384,2011,180400014,,,,10,9,19
HND-016387,2011,180400017,,,,9,7,16
,2011,180400018,,,,2,4,6
HND-016391,2011,180400021,,,,16,19,35
HND-016392,2011,180400022,,,,38,40,78
HND-016393,2011,180400023,,,,12,10,22
HND-016395,2011,180400025,,,,91,76,167
HND-016396,2011,180400026,,,,15,10,25
HND-016397,2011,180400027,,,,3,7,10
HND-016401,2011,180400031,,,,44,33,77
HND-016405,2011,180400036,,,,25,16,41
HND-016406,2011,180400037,,,,25,28,53
HND-016408,2011,180400039,,,,25,27,52
HND-016409,2011,180400040,,,,49,47,96
HND-016410,2011,180400041,,,,41,32,73
HND-016413,2011,180400044,,,,12,14,26
HND-016414,2011,180400045,,,,57,55,112
HND-016415,2011,180400046,,,,47,41,88
,2011,180400047,,,,21,20,41
HND-016421,2011,180400053,,,,8,8,16
HND-016423,2011,180400055,,,,38,52,90
HND-016424,2011,180400056,,,,47,48,95
HND-016425,2011,180400057,,,,30,23,53
,2011,180400059,,,,1,1,2
HND-016430,2011,180400064,,,,35,47,82
HND-016431,2011,180400065,,,,34,20,54
HND-016435,2011,180400070,,,,7,5,12
HND-016437,2011,180400072,,,,23,26,49
HND-016438,2011,180400073,,,,27,20,47
HND-016439,2011,180400074,,,,42,32,74
,2011,180400079,,,,3,3,6
HND-016447,2011,180400098,,,,2,0,2
HND-016451,2011,180400102,,,,27,27,54
HND-016452,2011,180400103,,,,4,3,7
HND-016453,2011,180400110,,,,14,13,27
HND-016454,2011,180400116,,,,4,1,5
,2011,180400137,,,,3,2,5
HND-016466,2011,180400138,,,,41,36,77
HND-016467,2011,180400140,,,,52,37,89
,2011,180400144,,,,0,3,3
HND-016479,2011,180400163,,,,13,11,24
,2011,180400172,,,,17,18,35
,2011,180400176,,,,8,11,19
HND-016484,2011,180400178,,,,13,7,20
,2011,180400181,,,,7,5,12
HND-016487,2011,180400187,,,,3,7,10
HND-016488,2011,180400189,,,,20,25,45
,2011,180400213,,,,11,7,18
,2011,180400238,,,,7,10,17
,2011,180400243,,,,14,11,25
,2011,180400251,,,,15,5,20
,2011,180400252,,,,21,26,47
,2011,180400254,,,,3,0,3
HND-016502,2011,180400255,,,,10,5,15
,2011,180400266,,,,6,12,18
HND-016513,2011,180400285,,,,23,10,33
,2011,180400286,,,,8,3,11
HND-016519,2011,180400305,,,,13,19,32
,2011,180400312,,,,10,15,25
HND-016526,2011,180400320,,,,3,3,6
HND-016528,2011,180400322,,,,27,11,38
,2011,180400325,,,,11,5,16
,2011,180400331,,,,3,6,9
HND-016372,2011,180400002,,,,30,39,69
HND-016378,2011,180400008,,,,22,24,46
HND-016379,2011,180400009,,,,21,17,38
HND-016380,2011,180400010,,,,17,17,34
HND-016382,2011,180400012,,,,5,3,8
HND-016385,2011,180400015,,,,3,2,5
,2011,180400018,,,,5,4,9
HND-016389,2011,180400019,,,,16,18,34
,2011,180400020,,,,2,5,7
HND-016391,2011,180400021,,,,16,16,32
HND-016398,2011,180400028,,,,15,9,24
HND-016400,2011,180400030,,,,4,3,7
HND-016401,2011,180400031,,,,30,29,59
HND-016402,2011,180400032,,,,10,17,27
HND-016403,2011,180400034,,,,16,24,40
HND-016406,2011,180400037,,,,20,18,38
HND-016407,2011,180400038,,,,26,33,59
HND-016408,2011,180400039,,,,33,41,74
HND-016410,2011,180400041,,,,50,56,106
HND-016411,2011,180400042,,,,33,31,64
HND-016414,2011,180400045,,,,55,55,110
,2011,180400048,,,,48,36,84
HND-016418,2011,180400050,,,,5,8,13
,2011,180400051,,,,10,13,23
,2011,180400052,,,,9,13,22
HND-016421,2011,180400053,,,,6,8,14
,2011,180400054,,,,5,6,11
HND-016425,2011,180400057,,,,26,37,63
,2011,180400058,,,,0,6,6
,2011,180400061,,,,5,3,8
HND-016428,2011,180400062,,,,93,83,176
HND-016429,2011,180400063,,,,17,18,35
HND-016432,2011,180400066,,,,54,31,85
HND-016433,2011,180400067,,,,23,17,40
HND-016434,2011,180400068,,,,16,14,30
HND-016438,2011,180400073,,,,23,20,43
,2011,180400079,,,,1,2,3
HND-016447,2011,180400098,,,,3,3,6
HND-016450,2011,180400101,,,,3,9,12
HND-016455,2011,180400118,,,,6,2,8
HND-016467,2011,180400140,,,,55,51,106
HND-016468,2011,180400142,,,,2,3,5
,2011,180400157,,,,8,10,18
,2011,180400175,,,,18,17,35
,2011,180400176,,,,6,7,13
HND-016483,2011,180400177,,,,25,24,49
,2011,180400181,,,,3,9,12
,2011,180400192,,,,7,5,12
HND-016490,2011,180400196,,,,9,6,15
HND-016491,2011,180400205,,,,17,20,37
,2011,180400238,,,,4,4,8
,2011,180400243,,,,10,10,20
,2011,180400252,,,,34,17,51
HND-016503,2011,180400257,,,,22,21,43
HND-016519,2011,180400305,,,,17,27,44
,2011,180400308,,,,1,1,2
,2011,180400330,,,,0,1,1
HND-016532,2011,180400339,,,,16,6,22
HND-016373,2011,180400003,,,,41,45,86
HND-016374,2011,180400004,,,,9,7,16
HND-016375,2011,180400005,,,,34,40,74
HND-016376,2011,180400006,,,,2,4,6
HND-016377,2011,180400007,,,,0,1,1
HND-016381,2011,180400011,,,,5,6,11
HND-016383,2011,180400013,,,,2,2,4
HND-016384,2011,180400014,,,,10,3,13
HND-016386,2011,180400016,,,,3,12,15
HND-016387,2011,180400017,,,,15,19,34
HND-016392,2011,180400022,,,,46,39,85
HND-016393,2011,180400023,,,,8,7,15
HND-016394,2011,180400024,,,,16,9,25
HND-016395,2011,180400025,,,,82,70,152
HND-016396,2011,180400026,,,,19,16,35
HND-016397,2011,180400027,,,,3,12,15
HND-016399,2011,180400029,,,,17,21,38
HND-016404,2011,180400035,,,,17,23,40
HND-016405,2011,180400036,,,,14,13,27
HND-016409,2011,180400040,,,,65,53,118
HND-016412,2011,180400043,,,,33,34,67
HND-016415,2011,180400046,,,,38,46,84
,2011,180400047,,,,32,23,55
HND-016417,2011,180400049,,,,32,30,62
HND-016423,2011,180400055,,,,40,27,67
HND-016424,2011,180400056,,,,62,68,130
,2011,180400059,,,,3,1,4
,2011,180400060,,,,24,21,45
HND-016430,2011,180400064,,,,37,35,72
HND-016431,2011,180400065,,,,39,22,61
HND-016435,2011,180400070,,,,8,7,15
HND-016436,2011,180400071,,,,40,36,76
HND-016437,2011,180400072,,,,25,20,45
HND-016439,2011,180400074,,,,39,30,69
HND-016448,2011,180400099,,,,2,4,6
HND-016451,2011,180400102,,,,27,21,48
HND-016452,2011,180400103,,,,3,4,7
HND-016453,2011,180400110,,,,12,14,26
HND-016454,2011,180400116,,,,4,6,10
HND-016462,2011,180400131,,,,102,98,200
HND-016463,2011,180400132,,,,8,9,17
,2011,180400137,,,,2,1,3
HND-016466,2011,180400138,,,,29,36,65
,2011,180400143,,,,3,14,17
,2011,180400144,,,,2,0,2
HND-016472,2011,180400149,,,,22,10,32
HND-016479,2011,180400163,,,,6,9,15
,2011,180400171,,,,14,7,21
,2011,180400172,,,,11,16,27
HND-016484,2011,180400178,,,,19,9,28
,2011,180400179,,,,2,3,5
,2011,180400180,,,,4,4,8
,2011,180400183,,,,6,12,18
,2011,180400184,,,,7,11,18
HND-016485,2011,180400185,,,,11,10,21
HND-016486,2011,180400186,,,,12,17,29
HND-016487,2011,180400187,,,,5,4,9
HND-016488,2011,180400189,,,,25,20,45
,2011,180400211,,,,4,3,7
,2011,180400212,,,,16,14,30
,2011,180400213,,,,11,10,21
HND-016495,2011,180400214,,,,1,6,7
,2011,180400251,,,,4,5,9
,2011,180400253,,,,3,4,7
,2011,180400254,,,,2,2,4
HND-016502,2011,180400255,,,,4,7,11
,2011,180400266,,,,19,7,26
HND-016513,2011,180400285,,,,8,2,10
,2011,180400286,,,,5,3,8
,2011,180400306,,,,22,20,42
,2011,180400307,,,,2,2,4
,2011,180400312,,,,23,27,50
HND-016524,2011,180400318,,,,36,36,72
HND-016525,2011,180400319,,,,14,10,24
HND-016526,2011,180400320,,,,3,0,3
HND-016527,2011,180400321,,,,24,25,49
HND-016528,2011,180400322,,,,43,35,78
,2011,180400325,,,,15,20,35
,2011,180400331,,,,0,1,1
HND-016533,2011,180400340,,,,2,2,4
HND-016372,2011,180400002,,,,10,31,41
HND-016373,2011,180400003,,,,38,37,75
HND-016375,2011,180400005,,,,30,31,61
HND-016376,2011,180400006,,,,6,2,8
HND-016377,2011,180400007,,,,1,2,3
HND-016378,2011,180400008,,,,18,20,38
HND-016379,2011,180400009,,,,25,21,46
HND-016383,2011,180400013,,,,2,1,3
HND-016386,2011,180400016,,,,8,7,15
HND-016387,2011,180400017,,,,1,7,8
HND-016389,2011,180400019,,,,15,20,35
HND-016392,2011,180400022,,,,40,31,71
HND-016394,2011,180400024,,,,8,10,18
HND-016399,2011,180400029,,,,19,8,27
HND-016400,2011,180400030,,,,7,3,10
HND-016402,2011,180400032,,,,18,12,30
HND-016403,2011,180400034,,,,31,21,52
HND-016404,2011,180400035,,,,19,21,40
HND-016407,2011,180400038,,,,47,60,107
HND-016411,2011,180400042,,,,26,30,56
HND-016412,2011,180400043,,,,33,32,65
HND-016417,2011,180400049,,,,34,31,65
HND-016418,2011,180400050,,,,9,3,12
,2011,180400052,,,,8,12,20
,2011,180400054,,,,8,7,15
,2011,180400058,,,,8,6,14
,2011,180400059,,,,2,0,2
,2011,180400060,,,,17,21,38
HND-016428,2011,180400062,,,,107,70,177
HND-016429,2011,180400063,,,,18,15,33
HND-016430,2011,180400064,,,,41,34,75
HND-016432,2011,180400066,,,,30,36,66
HND-016433,2011,180400067,,,,25,25,50
HND-016434,2011,180400068,,,,13,15,28
HND-016436,2011,180400071,,,,49,45,94
HND-016448,2011,180400099,,,,3,1,4
HND-016450,2011,180400101,,,,18,4,22
HND-016454,2011,180400116,,,,8,4,12
HND-016462,2011,180400131,,,,139,134,273
HND-016463,2011,180400132,,,,7,7,14
HND-016468,2011,180400142,,,,4,2,6
,2011,180400143,,,,10,9,19
HND-016472,2011,180400149,,,,19,14,33
,2011,180400157,,,,6,6,12
HND-016479,2011,180400163,,,,10,12,22
,2011,180400171,,,,5,7,12
,2011,180400175,,,,24,27,51
HND-016483,2011,180400177,,,,53,46,99
,2011,180400179,,,,1,7,8
,2011,180400180,,,,5,4,9
,2011,180400183,,,,10,14,24
,2011,180400184,,,,12,4,16
HND-016485,2011,180400185,,,,15,18,33
HND-016486,2011,180400186,,,,7,16,23
HND-016488,2011,180400189,,,,20,20,40
,2011,180400192,,,,6,6,12
HND-016490,2011,180400196,,,,4,3,7
HND-016491,2011,180400205,,,,41,39,80
,2011,180400211,,,,3,4,7
,2011,180400212,,,,15,12,27
,2011,180400213,,,,7,10,17
HND-016495,2011,180400214,,,,8,3,11
,2011,180400251,,,,1,0,1
,2011,180400253,,,,4,5,9
HND-016503,2011,180400257,,,,22,19,41
HND-016513,2011,180400285,,,,10,6,16
,2011,180400306,,,,11,14,25
,2011,180400307,,,,0,2,2
,2011,180400312,,,,15,8,23
HND-016524,2011,180400318,,,,38,29,67
HND-016525,2011,180400319,,,,34,19,53
HND-016526,2011,180400320,,,,5,5,10
HND-016527,2011,180400321,,,,26,25,51
HND-016528,2011,180400322,,,,10,18,28
HND-016532,2011,180400339,,,,5,2,7
HND-016533,2011,180400340,,,,2,1,3
HND-016374,2011,180400004,,,,9,12,21
HND-016380,2011,180400010,,,,11,9,20
HND-016381,2011,180400011,,,,7,4,11
HND-016382,2011,180400012,,,,7,2,9
HND-016384,2011,180400014,,,,6,8,14
HND-016385,2011,180400015,,,,0,4,4
,2011,180400018,,,,8,2,10
,2011,180400020,,,,3,5,8
HND-016391,2011,180400021,,,,14,16,30
HND-016393,2011,180400023,,,,8,12,20
HND-016395,2011,180400025,,,,89,93,182
HND-016396,2011,180400026,,,,18,22,40
HND-016397,2011,180400027,,,,5,5,10
HND-016398,2011,180400028,,,,8,4,12
HND-016401,2011,180400031,,,,34,23,57
HND-016405,2011,180400036,,,,20,11,31
HND-016406,2011,180400037,,,,27,26,53
HND-016408,2011,180400039,,,,12,29,41
HND-016409,2011,180400040,,,,46,29,75
HND-016410,2011,180400041,,,,41,32,73
HND-016414,2011,180400045,,,,58,64,122
HND-016415,2011,180400046,,,,59,47,106
,2011,180400047,,,,34,30,64
,2011,180400048,,,,46,43,89
,2011,180400051,,,,14,17,31
HND-016421,2011,180400053,,,,10,7,17
HND-016423,2011,180400055,,,,25,33,58
HND-016424,2011,180400056,,,,61,47,108
HND-016425,2011,180400057,,,,35,26,61
,2011,180400061,,,,6,5,11
HND-016431,2011,180400065,,,,24,24,48
HND-016435,2011,180400070,,,,9,9,18
HND-016437,2011,180400072,,,,30,29,59
HND-016438,2011,180400073,,,,25,23,48
HND-016439,2011,180400074,,,,36,36,72
,2011,180400079,,,,2,0,2
HND-016447,2011,180400098,,,,0,1,1
HND-016451,2011,180400102,,,,36,30,66
HND-016452,2011,180400103,,,,5,3,8
HND-016453,2011,180400110,,,,16,17,33
HND-016455,2011,180400118,,,,5,7,12
,2011,180400137,,,,2,3,5
HND-016466,2011,180400138,,,,36,36,72
HND-016467,2011,180400140,,,,43,47,90
,2011,180400144,,,,1,0,1
,2011,180400172,,,,15,17,32
,2011,180400176,,,,10,14,24
HND-016484,2011,180400178,,,,12,7,19
,2011,180400181,,,,5,3,8
HND-016487,2011,180400187,,,,3,2,5
,2011,180400238,,,,4,6,10
,2011,180400243,,,,12,11,23
,2011,180400252,,,,24,16,40
,2011,180400254,,,,3,2,5
HND-016502,2011,180400255,,,,9,3,12
,2011,180400266,,,,8,4,12
,2011,180400286,,,,1,2,3
HND-016519,2011,180400305,,,,13,30,43
,2011,180400308,,,,4,6,10
,2011,180400325,,,,17,11,28
HND-016372,2011,180400002,,,,37,21,58
HND-016373,2011,180400003,,,,48,57,105
HND-016375,2011,180400005,,,,23,35,58
HND-016376,2011,180400006,,,,5,3,8
HND-016377,2011,180400007,,,,2,1,3
HND-016381,2011,180400011,,,,2,4,6
HND-016383,2011,180400013,,,,2,2,4
HND-016386,2011,180400016,,,,3,5,8
HND-016387,2011,180400017,,,,13,12,25
HND-016389,2011,180400019,,,,14,11,25
HND-016392,2011,180400022,,,,45,20,65
HND-016393,2011,180400023,,,,7,4,11
HND-016394,2011,180400024,,,,4,7,11
HND-016395,2011,180400025,,,,90,107,197
HND-016396,2011,180400026,,,,14,16,30
HND-016399,2011,180400029,,,,14,23,37
HND-016402,2011,180400032,,,,16,14,30
HND-016404,2011,180400035,,,,24,15,39
HND-016409,2011,180400040,,,,54,54,108
HND-016412,2011,180400043,,,,30,40,70
HND-016415,2011,180400046,,,,43,54,97
,2011,180400047,,,,27,27,54
HND-016417,2011,180400049,,,,29,39,68
,2011,180400052,,,,8,7,15
,2011,180400059,,,,0,3,3
,2011,180400060,,,,24,27,51
HND-016428,2011,180400062,,,,104,79,183
HND-016429,2011,180400063,,,,12,20,32
HND-016430,2011,180400064,,,,48,45,93
HND-016433,2011,180400067,,,,18,25,43
HND-016435,2011,180400070,,,,6,5,11
HND-016436,2011,180400071,,,,56,43,99
HND-016439,2011,180400074,,,,38,45,83
HND-016448,2011,180400099,,,,1,2,3
HND-016452,2011,180400103,,,,1,8,9
HND-016453,2011,180400110,,,,18,12,30
HND-016454,2011,180400116,,,,3,12,15
HND-016462,2011,180400131,,,,116,114,230
HND-016463,2011,180400132,,,,9,10,19
,2011,180400137,,,,4,0,4
HND-016466,2011,180400138,,,,46,53,99
HND-016468,2011,180400142,,,,3,3,6
,2011,180400143,,,,7,7,14
,2011,180400144,,,,4,2,6
HND-016472,2011,180400149,,,,15,22,37
,2011,180400157,,,,3,8,11
HND-016479,2011,180400163,,,,8,10,18
,2011,180400171,,,,6,7,13
,2011,180400175,,,,18,22,40
,2011,180400179,,,,5,4,9
,2011,180400180,,,,0,1,1
,2011,180400183,,,,11,13,24
,2011,180400184,,,,11,11,22
HND-016485,2011,180400185,,,,20,12,32
HND-016486,2011,180400186,,,,9,8,17
HND-016487,2011,180400187,,,,4,5,9
HND-016488,2011,180400189,,,,14,32,46
,2011,180400192,,,,7,7,14
HND-016491,2011,180400205,,,,27,40,67
,2011,180400211,,,,3,2,5
,2011,180400212,,,,14,13,27
,2011,180400213,,,,8,10,18
HND-016495,2011,180400214,,,,5,3,8
,2011,180400254,,,,3,2,5
HND-016503,2011,180400257,,,,15,15,30
HND-016513,2011,180400285,,,,10,6,16
,2011,180400286,,,,1,3,4
,2011,180400306,,,,13,18,31
HND-016524,2011,180400318,,,,43,34,77
HND-016525,2011,180400319,,,,14,13,27
HND-016526,2011,180400320,,,,5,2,7
HND-016527,2011,180400321,,,,17,19,36
HND-016528,2011,180400322,,,,13,23,36
,2011,180400325,,,,13,13,26
HND-016533,2011,180400340,,,,1,4,5
HND-016374,2011,180400004,,,,14,20,34
HND-016378,2011,180400008,,,,35,28,63
HND-016379,2011,180400009,,,,17,25,42
HND-016380,2011,180400010,,,,12,10,22
HND-016382,2011,180400012,,,,5,4,9
HND-016384,2011,180400014,,,,7,10,17
HND-016385,2011,180400015,,,,8,2,10
,2011,180400018,,,,8,7,15
,2011,180400020,,,,2,5,7
HND-016391,2011,180400021,,,,22,9,31
HND-016397,2011,180400027,,,,4,6,10
HND-016398,2011,180400028,,,,13,11,24
HND-016400,2011,180400030,,,,2,4,6
HND-016401,2011,180400031,,,,18,25,43
HND-016403,2011,180400034,,,,20,20,40
HND-016405,2011,180400036,,,,12,16,28
HND-016406,2011,180400037,,,,29,31,60
HND-016407,2011,180400038,,,,43,43,86
HND-016408,2011,180400039,,,,33,21,54
HND-016410,2011,180400041,,,,13,11,24
HND-016411,2011,180400042,,,,43,34,77
HND-016414,2011,180400045,,,,45,55,100
,2011,180400048,,,,39,56,95
HND-016418,2011,180400050,,,,8,2,10
,2011,180400051,,,,11,9,20
HND-016421,2011,180400053,,,,8,15,23
,2011,180400054,,,,8,9,17
HND-016423,2011,180400055,,,,23,30,53
HND-016424,2011,180400056,,,,62,39,101
HND-016425,2011,180400057,,,,36,30,66
,2011,180400058,,,,4,8,12
,2011,180400061,,,,1,6,7
HND-016431,2011,180400065,,,,33,33,66
HND-016432,2011,180400066,,,,39,27,66
HND-016434,2011,180400068,,,,13,8,21
HND-016437,2011,180400072,,,,22,28,50
HND-016438,2011,180400073,,,,25,15,40
,2011,180400079,,,,1,1,2
HND-016447,2011,180400098,,,,1,2,3
HND-016450,2011,180400101,,,,4,6,10
HND-016451,2011,180400102,,,,34,30,64
HND-016455,2011,180400118,,,,2,6,8
HND-016467,2011,180400140,,,,56,42,98
,2011,180400172,,,,11,17,28
,2011,180400176,,,,12,14,26
HND-016483,2011,180400177,,,,30,28,58
HND-016484,2011,180400178,,,,9,15,24
,2011,180400181,,,,4,5,9
HND-016490,2011,180400196,,,,2,0,2
,2011,180400238,,,,10,9,19
,2011,180400243,,,,6,10,16
,2011,180400252,,,,14,19,33
HND-016502,2011,180400255,,,,9,6,15
,2011,180400266,,,,1,3,4
HND-016519,2011,180400305,,,,21,17,38
,2011,180400308,,,,1,0,1
HND-016532,2011,180400339,,,,5,3,8
HND-016374,2011,180400004,,,,10,10,20
HND-016377,2011,180400007,,,,2,3,5
HND-016380,2011,180400010,,,,13,11,24
HND-016381,2011,180400011,,,,4,1,5
HND-016382,2011,180400012,,,,3,5,8
HND-016383,2011,180400013,,,,1,2,3
HND-016384,2011,180400014,,,,8,4,12
HND-016387,2011,180400017,,,,5,7,12
,2011,180400018,,,,5,4,9
HND-016391,2011,180400021,,,,12,17,29
HND-016392,2011,180400022,,,,41,26,67
HND-016393,2011,180400023,,,,6,12,18
HND-016395,2011,180400025,,,,73,80,153
HND-016396,2011,180400026,,,,11,11,22
HND-016397,2011,180400027,,,,4,4,8
HND-016405,2011,180400036,,,,8,11,19
HND-016406,2011,180400037,,,,7,22,29
HND-016408,2011,180400039,,,,10,11,21
HND-016409,2011,180400040,,,,54,68,122
HND-016410,2011,180400041,,,,17,25,42
HND-016414,2011,180400045,,,,54,59,113
HND-016415,2011,180400046,,,,43,50,93
,2011,180400047,,,,30,26,56
HND-016421,2011,180400053,,,,3,5,8
HND-016423,2011,180400055,,,,28,44,72
HND-016424,2011,180400056,,,,40,47,87
HND-016425,2011,180400057,,,,24,33,57
,2011,180400059,,,,3,1,4
HND-016430,2011,180400064,,,,42,45,87
HND-016431,2011,180400065,,,,29,20,49
HND-016435,2011,180400070,,,,15,13,28
HND-016437,2011,180400072,,,,18,28,46
HND-016438,2011,180400073,,,,21,24,45
HND-016439,2011,180400074,,,,28,33,61
,2011,180400079,,,,0,1,1
HND-016447,2011,180400098,,,,2,1,3
HND-016451,2011,180400102,,,,43,26,69
HND-016452,2011,180400103,,,,5,5,10
HND-016453,2011,180400110,,,,11,19,30
HND-016454,2011,180400116,,,,3,6,9
,2011,180400137,,,,3,1,4
HND-016466,2011,180400138,,,,24,36,60
HND-016467,2011,180400140,,,,51,54,105
,2011,180400144,,,,1,1,2
HND-016479,2011,180400163,,,,7,7,14
,2011,180400172,,,,13,12,25
,2011,180400176,,,,10,20,30
HND-016484,2011,180400178,,,,12,8,20
,2011,180400181,,,,2,3,5
HND-016487,2011,180400187,,,,1,5,6
HND-016488,2011,180400189,,,,9,11,20
,2011,180400213,,,,9,8,17
,2011,180400238,,,,5,8,13
,2011,180400243,,,,3,15,18
,2011,180400252,,,,8,12,20
,2011,180400254,,,,2,1,3
HND-016502,2011,180400255,,,,2,4,6
,2011,180400266,,,,6,3,9
HND-016513,2011,180400285,,,,12,14,26
,2011,180400286,,,,1,3,4
HND-016519,2011,180400305,,,,21,19,40
,2011,180400312,,,,13,23,36
HND-016526,2011,180400320,,,,5,6,11
HND-016528,2011,180400322,,,,7,18,25
,2011,180400325,,,,7,10,17
HND-016372,2011,180400002,,,,10,11,21
HND-016373,2011,180400003,,,,41,53,94
HND-016375,2011,180400005,,,,41,33,74
HND-016376,2011,180400006,,,,6,1,7
HND-016378,2011,180400008,,,,15,16,31
HND-016379,2011,180400009,,,,18,15,33
HND-016385,2011,180400015,,,,1,1,2
HND-016386,2011,180400016,,,,1,5,6
HND-016389,2011,180400019,,,,14,17,31
,2011,180400020,,,,0,1,1
HND-016394,2011,180400024,,,,3,3,6
HND-016398,2011,180400028,,,,6,4,10
HND-016399,2011,180400029,,,,18,12,30
HND-016400,2011,180400030,,,,3,4,7
HND-016401,2011,180400031,,,,18,12,30
HND-016402,2011,180400032,,,,11,11,22
HND-016403,2011,180400034,,,,22,12,34
HND-016404,2011,180400035,,,,17,15,32
HND-016407,2011,180400038,,,,27,35,62
HND-016411,2011,180400042,,,,38,32,70
HND-016412,2011,180400043,,,,29,43,72
,2011,180400048,,,,38,42,80
HND-016417,2011,180400049,,,,23,38,61
,2011,180400051,,,,12,11,23
,2011,180400052,,,,4,5,9
,2011,180400054,,,,10,4,14
,2011,180400058,,,,5,5,10
,2011,180400060,,,,20,17,37
,2011,180400061,,,,5,3,8
HND-016428,2011,180400062,,,,84,102,186
HND-016429,2011,180400063,,,,12,10,22
HND-016432,2011,180400066,,,,42,43,85
HND-016433,2011,180400067,,,,17,18,35
HND-016434,2011,180400068,,,,8,7,15
HND-016436,2011,180400071,,,,46,53,99
HND-016448,2011,180400099,,,,2,2,4
HND-016450,2011,180400101,,,,7,15,22
HND-016455,2011,180400118,,,,6,5,11
HND-016462,2011,180400131,,,,126,113,239
HND-016463,2011,180400132,,,,4,5,9
HND-016468,2011,180400142,,,,5,3,8
,2011,180400143,,,,5,10,15
HND-016472,2011,180400149,,,,10,9,19
,2011,180400157,,,,5,4,9
,2011,180400171,,,,7,2,9
,2011,180400175,,,,19,17,36
HND-016483,2011,180400177,,,,19,26,45
,2011,180400179,,,,5,4,9
,2011,180400183,,,,19,15,34
,2011,180400184,,,,12,8,20
HND-016485,2011,180400185,,,,18,15,33
HND-016486,2011,180400186,,,,8,9,17
,2011,180400192,,,,3,7,10
HND-016490,2011,180400196,,,,6,4,10
HND-016491,2011,180400205,,,,29,54,83
,2011,180400211,,,,1,3,4
,2011,180400212,,,,21,19,40
HND-016495,2011,180400214,,,,4,5,9
HND-016503,2011,180400257,,,,6,7,13
,2011,180400306,,,,21,28,49
,2011,180400308,,,,1,1,2
HND-016524,2011,180400318,,,,20,18,38
HND-016525,2011,180400319,,,,11,13,24
HND-016527,2011,180400321,,,,11,13,24
HND-016532,2011,180400339,,,,1,2,3
HND-016533,2011,180400340,,,,1,3,4
HND-016399,2011,180400029,,,,35,28,63
HND-016409,2011,180400040,,,,41,34,75
,2011,180400080,,,,503,529,1032
HND-016466,2011,180400138,,,,41,66,107
HND-016470,2011,180400145,,,,420,408,828
HND-016474,2011,180400155,,,,153,134,287
,2011,180400157,,,,27,48,75
HND-016481,2011,180400167,,,,115,40,155
,2011,180400170,,,,5,14,19
,2011,180400176,,,,5,9,14
,2011,180400184,,,,6,9,15
,2011,180400192,,,,8,11,19
,2011,180400323,,,,7,16,23
HND-016391,2011,180400021,,,,33,27,60
HND-016401,2011,180400031,,,,18,17,35
HND-016407,2011,180400038,,,,35,47,82
,2011,180400047,,,,60,63,123
HND-016424,2011,180400056,,,,37,37,74
,2011,180400060,,,,14,14,28
HND-016465,2011,180400135,,,,148,155,303
HND-016467,2011,180400140,,,,28,48,76
,2011,180400144,,,,3,2,5
,2011,180400166,,,,23,37,60
,2011,180400168,,,,88,85,173
,2011,180400171,,,,4,10,14
,2011,180400172,,,,8,6,14
,2011,180400176,,,,5,9,14
,2011,180400183,,,,20,34,54
,2011,180400184,,,,6,9,15
,2011,180400192,,,,5,0,5
,2011,180400202,,,,23,37,60
,2011,180400212,,,,32,31,63
,2011,180400243,,,,3,6,9
,2011,180400243,,,,3,6,9
,2011,180400247,,,,2,4,6
,2011,180400251,,,,34,35,69
,2011,180400252,,,,4,10,14
,2011,180400253,,,,2,1,3
,2011,180400266,,,,16,17,33
,2011,180400306,,,,20,17,37
,2011,180400310,,,,169,86,255
,2011,180400332,,,,16,16,32
HND-016399,2011,180400029,,,,20,32,52
HND-016407,2011,180400038,,,,27,23,50
,2011,180400047,,,,76,53,129
,2011,180400060,,,,16,18,34
,2011,180400144,,,,0,1,1
,2011,180400157,,,,44,33,77
,2011,180400166,,,,26,42,68
,2011,180400171,,,,2,3,5
,2011,180400172,,,,10,7,17
,2011,180400183,,,,22,31,53
,2011,180400184,,,,7,7,14
,2011,180400184,,,,7,7,14
,2011,180400202,,,,26,42,68
,2011,180400212,,,,20,32,52
,2011,180400247,,,,3,2,5
,2011,180400251,,,,32,33,65
,2011,180400253,,,,3,1,4
,2011,180400253,,,,1,0,1
,2011,180400306,,,,10,14,24
,2011,180400310,,,,35,66,101
HND-016391,2011,180400021,,,,17,23,40
HND-016401,2011,180400031,,,,5,7,12
HND-016409,2011,180400040,,,,26,33,59
HND-016424,2011,180400056,,,,24,45,69
,2011,180400080,,,,395,494,889
HND-016465,2011,180400135,,,,98,102,200
HND-016466,2011,180400138,,,,26,40,66
HND-016467,2011,180400140,,,,24,28,52
HND-016470,2011,180400145,,,,308,286,594
HND-016474,2011,180400155,,,,94,63,157
HND-016481,2011,180400167,,,,42,19,61
,2011,180400168,,,,48,67,115
,2011,180400170,,,,4,7,11
,2011,180400176,,,,9,20,29
,2011,180400176,,,,9,20,29
,2011,180400192,,,,3,4,7
,2011,180400243,,,,6,6,12
,2011,180400243,,,,6,6,12
,2011,180400252,,,,8,9,17
,2011,180400266,,,,9,5,14
,2011,180400323,,,,3,8,11
HND-016399,2011,180400029,,,,10,16,26
HND-016407,2011,180400038,,,,12,21,33
,2011,180400080,,,,403,413,816
HND-016465,2011,180400135,,,,62,82,144
,2011,180400144,,,,1,1,2
,2011,180400170,,,,5,6,11
,2011,180400172,,,,10,3,13
,2011,180400176,,,,11,14,25
,2011,180400184,,,,4,4,8
,2011,180400212,,,,17,10,27
,2011,180400243,,,,6,5,11
,2011,180400247,,,,3,2,5
,2011,180400251,,,,19,24,43
,2011,180400306,,,,10,7,17
,2011,180400310,,,,32,56,88
,2011,180400329,,,,1,2,3
HND-016391,2011,180400021,,,,26,15,41
HND-016401,2011,180400031,,,,7,8,15
HND-016409,2011,180400040,,,,19,29,48
,2011,180400047,,,,49,53,102
HND-016424,2011,180400056,,,,27,29,56
,2011,180400060,,,,11,10,21
HND-016466,2011,180400138,,,,13,21,34
HND-016467,2011,180400140,,,,21,24,45
HND-016470,2011,180400145,,,,236,257,493
HND-016474,2011,180400155,,,,52,89,141
,2011,180400157,,,,33,40,73
,2011,180400166,,,,34,37,71
HND-016481,2011,180400167,,,,30,30,60
,2011,180400168,,,,81,95,176
,2011,180400171,,,,7,7,14
,2011,180400176,,,,11,14,25
,2011,180400183,,,,30,24,54
,2011,180400184,,,,4,3,7
,2011,180400192,,,,5,7,12
,2011,180400202,,,,34,37,71
,2011,180400243,,,,6,5,11
,2011,180400253,,,,2,3,5
,2011,180400266,,,,8,10,18
,2011,180400323,,,,2,1,3
,2011,180400047,,,,79,54,133
,2011,180400060,,,,8,13,21
,2011,180400080,,,,390,529,919
HND-016474,2011,180400155,,,,53,79,132
,2011,180400157,,,,61,82,143
,2011,180400166,,,,32,54,86
,2011,180400168,,,,96,150,246
,2011,180400171,,,,6,2,8
,2011,180400183,,,,29,27,56
,2011,180400184,,,,2,2,4
,2011,180400192,,,,2,7,9
,2011,180400247,,,,2,1,3
,2011,180400251,,,,26,27,53
,2011,180400306,,,,9,9,18
,2011,180400333,,,,53,70,123
HND-016465,2011,180400135,,,,62,75,137
HND-016470,2011,180400145,,,,205,328,533
,2011,180400170,,,,5,5,10
,2011,180400172,,,,7,2,9
,2011,180400176,,,,5,12,17
,2011,180400202,,,,32,54,86
,2011,180400212,,,,28,27,55
,2011,180400243,,,,2,3,5
,2011,180400310,,,,27,61,88
,2011,180400323,,,,5,2,7
,2011,180400329,,,,5,14,19
HND-016470,2011,180400145,,,,161,325,486
HND-016474,2011,180400155,,,,35,78,113
,2011,180400157,,,,64,71,135
,2011,180400171,,,,4,3,7
,2011,180400183,,,,32,34,66
,2011,180400184,,,,1,4,5
,2011,180400192,,,,8,4,12
,2011,180400202,,,,19,50,69
,2011,180400306,,,,5,4,9
,2011,180400310,,,,27,34,61
,2011,180400323,,,,2,4,6
,2011,180400047,,,,36,35,71
,2011,180400080,,,,300,458,758
HND-016465,2011,180400135,,,,31,48,79
,2011,180400144,,,,3,2,5
,2011,180400166,,,,20,49,69
,2011,180400168,,,,62,91,153
,2011,180400170,,,,1,6,7
,2011,180400176,,,,11,15,26
,2011,180400247,,,,0,4,4
,2011,180400251,,,,15,13,28
,2011,180400329,,,,5,13,18
HND-016465,2011,180400135,,,,14,29,43
,2011,180400144,,,,0,4,4
HND-016470,2011,180400145,,,,77,225,302
,2011,180400176,,,,1,3,4
,2011,180400202,,,,12,26,38
,2011,180400323,,,,3,3,6
,2011,180400329,,,,3,3,6
,2011,180400047,,,,11,6,17
,2011,180400080,,,,212,361,573
HND-016474,2011,180400155,,,,37,55,92
,2011,180400157,,,,38,65,103
,2011,180400166,,,,12,26,38
,2011,180400168,,,,64,102,166
,2011,180400183,,,,17,25,42
,2011,180400247,,,,2,2,4
,2011,180400251,,,,4,15,19
,2011,180400306,,,,6,2,8
HND-016535,2011,180500002,,,,6,8,14
,2011,180500034,,,,4,8,12
,2011,180500043,,,,5,5,10
,2011,180500044,,,,6,6,12
,2011,180500045,,,,7,8,15
HND-016572,2011,180500047,,,,5,3,8
HND-016573,2011,180500050,,,,7,6,13
HND-016576,2011,180500067,,,,10,9,19
HND-016577,2011,180500070,,,,2,5,7
,2011,180500071,,,,4,4,8
,2011,180500072,,,,4,3,7
,2011,180500074,,,,6,6,12
,2011,180500078,,,,6,4,10
,2011,180500081,,,,8,4,12
,2011,180500083,,,,5,3,8
,2011,180500084,,,,8,12,20
HND-016580,2011,180500085,,,,3,7,10
,2011,180500097,,,,8,7,15
HND-016542,2011,180500009,,,,6,9,15
,2011,180500049,,,,5,3,8
,2011,180500068,,,,5,5,10
,2011,180500076,,,,6,6,12
HND-016578,2011,180500079,,,,8,6,14
,2011,180500086,,,,7,5,12
,2011,180500088,,,,9,6,15
,2011,180500090,,,,9,14,23
,2011,180500091,,,,8,7,15
,2011,180500092,,,,4,2,6
,2011,180500095,,,,3,5,8
HND-016559,2011,180500026,,,,8,3,11
HND-016561,2011,180500030,,,,4,5,9
HND-016569,2011,180500040,,,,1,0,1
HND-016575,2011,180500065,,,,2,3,5
,2011,180500093,,,,1,1,2
,2011,180500027,,,,2,2,4
HND-016569,2011,180500040,,,,3,6,9
HND-016579,2011,180500082,,,,3,4,7
,2011,180500094,,,,3,8,11
,2011,180500095,,,,4,1,5
HND-016534,2011,180500001,,,,1,1,2
HND-016535,2011,180500002,,,,1,2,3
HND-016539,2011,180500006,,,,1,2,3
HND-016548,2011,180500015,,,,6,6,12
HND-016561,2011,180500030,,,,6,4,10
HND-016575,2011,180500065,,,,3,3,6
,2011,180500093,,,,1,4,5
HND-016534,2011,180500001,,,,4,4,8
HND-016539,2011,180500006,,,,5,6,11
HND-016548,2011,180500015,,,,14,14,28
HND-016557,2011,180500024,,,,16,17,33
HND-016574,2011,180500061,,,,6,6,12
HND-016575,2011,180500065,,,,4,2,6
,2011,180500094,,,,4,3,7
,2011,180500095,,,,1,1,2
HND-016535,2011,180500002,,,,5,6,11
HND-016554,2011,180500021,,,,8,9,17
,2011,180500027,,,,3,2,5
HND-016561,2011,180500030,,,,10,11,21
HND-016569,2011,180500040,,,,4,1,5
HND-016579,2011,180500082,,,,4,5,9
,2011,180500093,,,,6,3,9
HND-016536,2011,180500003,,,,9,6,15
HND-016539,2011,180500006,,,,8,9,17
HND-016540,2011,180500007,,,,6,5,11
HND-016546,2011,180500013,,,,7,9,16
HND-016549,2011,180500016,,,,5,5,10
HND-016550,2011,180500017,,,,8,4,12
HND-016552,2011,180500019,,,,2,1,3
HND-016556,2011,180500023,,,,5,4,9
HND-016560,2011,180500029,,,,3,3,6
HND-016562,2011,180500031,,,,2,3,5
HND-016566,2011,180500037,,,,12,6,18
HND-016570,2011,180500041,,,,1,3,4
HND-016571,2011,180500042,,,,2,6,8
HND-016574,2011,180500061,,,,7,9,16
HND-016575,2011,180500065,,,,6,2,8
HND-016579,2011,180500082,,,,0,2,2
HND-016581,2011,180500089,,,,5,4,9
,2011,180500090,,,,2,1,3
HND-016534,2011,180500001,,,,36,31,67
HND-016535,2011,180500002,,,,14,4,18
HND-016537,2011,180500004,,,,6,2,8
HND-016538,2011,180500005,,,,6,6,12
HND-016541,2011,180500008,,,,4,3,7
HND-016542,2011,180500009,,,,5,7,12
HND-016543,2011,180500010,,,,7,4,11
HND-016544,2011,180500011,,,,8,12,20
HND-016545,2011,180500012,,,,5,1,6
HND-016547,2011,180500014,,,,16,9,25
HND-016548,2011,180500015,,,,19,16,35
HND-016551,2011,180500018,,,,3,2,5
HND-016553,2011,180500020,,,,14,4,18
HND-016554,2011,180500021,,,,6,3,9
HND-016555,2011,180500022,,,,4,6,10
HND-016563,2011,180500032,,,,1,2,3
HND-016564,2011,180500035,,,,3,2,5
HND-016567,2011,180500038,,,,3,4,7
HND-016568,2011,180500039,,,,2,1,3
HND-016569,2011,180500040,,,,8,10,18
HND-016582,2011,180500096,,,,2,1,3
HND-016534,2011,180500001,,,,33,34,67
HND-016538,2011,180500005,,,,10,10,20
HND-016539,2011,180500006,,,,8,7,15
HND-016542,2011,180500009,,,,3,3,6
HND-016545,2011,180500012,,,,5,1,6
HND-016548,2011,180500015,,,,11,16,27
HND-016551,2011,180500018,,,,0,5,5
HND-016552,2011,180500019,,,,2,1,3
HND-016555,2011,180500022,,,,5,1,6
HND-016560,2011,180500029,,,,1,0,1
HND-016562,2011,180500031,,,,1,3,4
HND-016563,2011,180500032,,,,4,4,8
HND-016566,2011,180500037,,,,7,5,12
HND-016567,2011,180500038,,,,4,5,9
HND-016569,2011,180500040,,,,12,13,25
HND-016571,2011,180500042,,,,8,10,18
HND-016574,2011,180500061,,,,8,7,15
HND-016581,2011,180500089,,,,4,5,9
,2011,180500090,,,,2,2,4
HND-016535,2011,180500002,,,,13,6,19
HND-016536,2011,180500003,,,,11,7,18
HND-016537,2011,180500004,,,,2,3,5
HND-016540,2011,180500007,,,,6,8,14
HND-016541,2011,180500008,,,,7,4,11
HND-016543,2011,180500010,,,,13,8,21
HND-016544,2011,180500011,,,,6,7,13
HND-016546,2011,180500013,,,,8,4,12
HND-016547,2011,180500014,,,,6,2,8
HND-016549,2011,180500016,,,,3,3,6
HND-016550,2011,180500017,,,,6,7,13
HND-016553,2011,180500020,,,,2,10,12
HND-016554,2011,180500021,,,,5,7,12
HND-016556,2011,180500023,,,,2,3,5
HND-016564,2011,180500035,,,,2,2,4
HND-016568,2011,180500039,,,,2,3,5
HND-016570,2011,180500041,,,,1,0,1
HND-016575,2011,180500065,,,,4,6,10
HND-016582,2011,180500096,,,,2,0,2
HND-016534,2011,180500001,,,,29,36,65
HND-016535,2011,180500002,,,,8,9,17
HND-016538,2011,180500005,,,,6,8,14
HND-016541,2011,180500008,,,,10,9,19
HND-016542,2011,180500009,,,,7,3,10
HND-016543,2011,180500010,,,,11,3,14
HND-016545,2011,180500012,,,,5,3,8
HND-016547,2011,180500014,,,,11,7,18
HND-016548,2011,180500015,,,,20,14,34
HND-016551,2011,180500018,,,,5,6,11
HND-016553,2011,180500020,,,,5,3,8
HND-016555,2011,180500022,,,,6,4,10
HND-016562,2011,180500031,,,,2,2,4
HND-016566,2011,180500037,,,,8,4,12
HND-016571,2011,180500042,,,,5,1,6
HND-016579,2011,180500082,,,,1,1,2
HND-016581,2011,180500089,,,,8,8,16
,2011,180500090,,,,0,2,2
HND-016536,2011,180500003,,,,4,2,6
HND-016537,2011,180500004,,,,2,1,3
HND-016539,2011,180500006,,,,8,4,12
HND-016540,2011,180500007,,,,6,8,14
HND-016544,2011,180500011,,,,5,4,9
HND-016546,2011,180500013,,,,6,7,13
HND-016549,2011,180500016,,,,9,4,13
HND-016550,2011,180500017,,,,8,6,14
HND-016552,2011,180500019,,,,2,0,2
HND-016554,2011,180500021,,,,10,10,20
HND-016556,2011,180500023,,,,3,2,5
HND-016560,2011,180500029,,,,0,1,1
HND-016563,2011,180500032,,,,4,6,10
HND-016564,2011,180500035,,,,2,4,6
HND-016567,2011,180500038,,,,3,3,6
HND-016568,2011,180500039,,,,0,2,2
HND-016569,2011,180500040,,,,8,10,18
HND-016570,2011,180500041,,,,1,0,1
HND-016574,2011,180500061,,,,7,3,10
HND-016575,2011,180500065,,,,6,5,11
HND-016582,2011,180500096,,,,2,2,4
HND-016536,2011,180500003,,,,12,6,18
HND-016539,2011,180500006,,,,7,7,14
HND-016540,2011,180500007,,,,3,3,6
HND-016542,2011,180500009,,,,1,2,3
HND-016548,2011,180500015,,,,27,24,51
HND-016549,2011,180500016,,,,7,9,16
HND-016552,2011,180500019,,,,3,0,3
HND-016560,2011,180500029,,,,0,1,1
HND-016562,2011,180500031,,,,1,1,2
HND-016563,2011,180500032,,,,1,2,3
HND-016564,2011,180500035,,,,2,3,5
HND-016567,2011,180500038,,,,3,2,5
HND-016569,2011,180500040,,,,9,5,14
HND-016574,2011,180500061,,,,9,8,17
HND-016581,2011,180500089,,,,3,4,7
HND-016534,2011,180500001,,,,25,31,56
HND-016535,2011,180500002,,,,9,4,13
HND-016537,2011,180500004,,,,1,4,5
HND-016538,2011,180500005,,,,4,7,11
HND-016541,2011,180500008,,,,6,8,14
HND-016543,2011,180500010,,,,3,7,10
HND-016544,2011,180500011,,,,7,9,16
HND-016545,2011,180500012,,,,2,2,4
HND-016546,2011,180500013,,,,4,1,5
HND-016547,2011,180500014,,,,11,4,15
HND-016550,2011,180500017,,,,9,6,15
HND-016551,2011,180500018,,,,2,3,5
HND-016553,2011,180500020,,,,4,1,5
HND-016554,2011,180500021,,,,12,8,20
HND-016555,2011,180500022,,,,6,2,8
HND-016566,2011,180500037,,,,8,3,11
HND-016568,2011,180500039,,,,0,2,2
HND-016570,2011,180500041,,,,0,3,3
HND-016571,2011,180500042,,,,2,5,7
HND-016575,2011,180500065,,,,4,5,9
HND-016579,2011,180500082,,,,2,1,3
,2011,180500090,,,,0,2,2
HND-016582,2011,180500096,,,,1,3,4
HND-016536,2011,180500003,,,,4,3,7
HND-016539,2011,180500006,,,,3,3,6
HND-016540,2011,180500007,,,,6,0,6
HND-016542,2011,180500009,,,,4,1,5
HND-016546,2011,180500013,,,,7,3,10
HND-016548,2011,180500015,,,,19,15,34
HND-016549,2011,180500016,,,,7,7,14
HND-016552,2011,180500019,,,,1,2,3
HND-016563,2011,180500032,,,,3,2,5
HND-016564,2011,180500035,,,,5,6,11
HND-016567,2011,180500038,,,,1,5,6
HND-016569,2011,180500040,,,,6,10,16
HND-016574,2011,180500061,,,,3,3,6
HND-016575,2011,180500065,,,,4,3,7
HND-016581,2011,180500089,,,,2,0,2
HND-016582,2011,180500096,,,,2,0,2
HND-016534,2011,180500001,,,,34,42,76
HND-016535,2011,180500002,,,,5,11,16
HND-016537,2011,180500004,,,,0,1,1
HND-016538,2011,180500005,,,,3,4,7
HND-016541,2011,180500008,,,,7,4,11
HND-016543,2011,180500010,,,,0,4,4
HND-016544,2011,180500011,,,,3,1,4
HND-016545,2011,180500012,,,,5,1,6
HND-016547,2011,180500014,,,,6,3,9
HND-016550,2011,180500017,,,,10,7,17
HND-016551,2011,180500018,,,,0,1,1
HND-016553,2011,180500020,,,,4,0,4
HND-016554,2011,180500021,,,,7,7,14
HND-016555,2011,180500022,,,,8,4,12
HND-016562,2011,180500031,,,,3,2,5
HND-016566,2011,180500037,,,,2,1,3
HND-016568,2011,180500039,,,,1,0,1
HND-016570,2011,180500041,,,,0,3,3
HND-016571,2011,180500042,,,,2,2,4
HND-016579,2011,180500082,,,,2,2,4
,2011,180500090,,,,2,0,2
HND-016535,2011,180500002,,,,4,4,8
HND-016536,2011,180500003,,,,7,1,8
HND-016537,2011,180500004,,,,3,5,8
HND-016541,2011,180500008,,,,5,3,8
HND-016543,2011,180500010,,,,2,4,6
HND-016544,2011,180500011,,,,2,5,7
HND-016546,2011,180500013,,,,2,4,6
HND-016547,2011,180500014,,,,6,5,11
HND-016549,2011,180500016,,,,9,4,13
HND-016550,2011,180500017,,,,5,3,8
HND-016553,2011,180500020,,,,0,1,1
HND-016554,2011,180500021,,,,6,7,13
HND-016564,2011,180500035,,,,6,8,14
HND-016568,2011,180500039,,,,1,0,1
HND-016570,2011,180500041,,,,2,1,3
HND-016575,2011,180500065,,,,1,2,3
HND-016579,2011,180500082,,,,0,1,1
HND-016582,2011,180500096,,,,4,8,12
HND-016534,2011,180500001,,,,32,24,56
HND-016538,2011,180500005,,,,1,5,6
HND-016539,2011,180500006,,,,5,2,7
HND-016542,2011,180500009,,,,5,1,6
HND-016545,2011,180500012,,,,2,2,4
HND-016548,2011,180500015,,,,18,12,30
HND-016552,2011,180500019,,,,1,4,5
HND-016555,2011,180500022,,,,4,4,8
HND-016562,2011,180500031,,,,1,1,2
HND-016566,2011,180500037,,,,1,2,3
HND-016567,2011,180500038,,,,1,4,5
HND-016569,2011,180500040,,,,3,6,9
HND-016571,2011,180500042,,,,1,1,2
HND-016574,2011,180500061,,,,4,2,6
HND-016581,2011,180500089,,,,3,5,8
HND-016548,2011,180500015,,,,24,20,44
HND-016558,2011,180500025,,,,82,76,158
HND-016548,2011,180500015,,,,11,28,39
HND-016558,2011,180500025,,,,47,53,100
HND-016558,2011,180500025,,,,50,39,89
HND-016558,2011,180500025,,,,35,37,72
HND-016558,2011,180500025,,,,26,31,57
HND-016558,2011,180500025,,,,28,28,56
HND-016584,2011,180600002,,,,9,2,11
HND-016587,2011,180600005,,,,5,4,9
HND-016605,2011,180600025,,,,9,2,11
HND-016625,2011,180600047,,,,4,5,9
HND-016636,2011,180600058,,,,0,1,1
HND-016647,2011,180600073,,,,3,3,6
HND-016655,2011,180600082,,,,4,8,12
HND-016656,2011,180600083,,,,6,5,11
,2011,180600098,,,,7,6,13
HND-016670,2011,180600115,,,,9,6,15
,2011,180600126,,,,5,4,9
,2011,180600131,,,,11,9,20
,2011,180600145,,,,6,3,9
,2011,180600146,,,,7,7,14
,2011,180600147,,,,5,6,11
HND-016676,2011,180600148,,,,7,2,9
HND-016682,2011,180600156,,,,8,8,16
HND-016684,2011,180600159,,,,3,3,6
HND-016588,2011,180600006,,,,7,4,11
HND-016590,2011,180600009,,,,6,4,10
HND-016598,2011,180600018,,,,7,3,10
HND-016600,2011,180600020,,,,0,1,1
HND-016619,2011,180600039,,,,4,1,5
HND-016621,2011,180600041,,,,5,5,10
HND-016623,2011,180600045,,,,3,10,13
HND-016629,2011,180600051,,,,1,8,9
,2011,180600060,,,,7,5,12
,2011,180600075,,,,4,3,7
HND-016652,2011,180600079,,,,3,3,6
HND-016666,2011,180600101,,,,3,6,9
,2011,180600110,,,,5,7,12
,2011,180600112,,,,6,9,15
,2011,180600113,,,,3,9,12
,2011,180600114,,,,7,3,10
,2011,180600135,,,,2,7,9
HND-016672,2011,180600138,,,,12,6,18
,2011,180600142,,,,2,4,6
HND-016677,2011,180600149,,,,5,7,12
HND-016681,2011,180600153,,,,8,9,17
,2011,180600154,,,,2,5,7
,2011,180600155,,,,9,10,19
,2011,180600157,,,,5,5,10
,2011,180600162,,,,4,6,10
,2011,180600067,,,,8,18,26
HND-016640,2011,180600063,,,,1,1,2
HND-016660,2011,180600091,,,,10,8,18
,2011,180600143,,,,4,7,11
HND-016674,2011,180600144,,,,4,5,9
,2011,180600067,,,,8,5,13
HND-016644,2011,180600069,,,,14,26,40
,2011,180600074,,,,4,2,6
HND-016657,2011,180600084,,,,1,4,5
,2011,180600100,,,,2,1,3
,2011,180600109,,,,4,4,8
,2011,180600044,,,,9,9,18
HND-016634,2011,180600056,,,,21,30,51
HND-016640,2011,180600063,,,,10,11,21
HND-016644,2011,180600069,,,,32,24,56
,2011,180600074,,,,3,3,6
,2011,180600089,,,,10,13,23
HND-016662,2011,180600093,,,,13,17,30
HND-016663,2011,180600094,,,,12,18,30
,2011,180600103,,,,4,4,8
,2011,180600109,,,,8,6,14
HND-016601,2011,180600021,,,,16,9,25
HND-016604,2011,180600024,,,,11,14,25
HND-016630,2011,180600052,,,,5,6,11
HND-016639,2011,180600062,,,,20,9,29
,2011,180600067,,,,11,13,24
HND-016645,2011,180600070,,,,15,23,38
HND-016646,2011,180600071,,,,10,4,14
HND-016657,2011,180600084,,,,8,5,13
HND-016658,2011,180600085,,,,8,10,18
,2011,180600090,,,,13,8,21
,2011,180600100,,,,1,6,7
,2011,180600143,,,,5,12,17
HND-016674,2011,180600144,,,,5,4,9
HND-016583,2011,180600001,,,,6,6,12
,2011,180600003,,,,14,11,25
HND-016589,2011,180600008,,,,8,3,11
HND-016591,2011,180600010,,,,12,9,21
HND-016593,2011,180600012,,,,28,18,46
HND-016595,2011,180600014,,,,13,8,21
HND-016598,2011,180600018,,,,3,3,6
HND-016599,2011,180600019,,,,12,9,21
HND-016600,2011,180600020,,,,10,5,15
HND-016602,2011,180600022,,,,8,12,20
HND-016604,2011,180600024,,,,21,19,40
HND-016605,2011,180600025,,,,1,4,5
HND-016608,2011,180600028,,,,31,32,63
HND-016609,2011,180600029,,,,38,30,68
HND-016615,2011,180600035,,,,24,15,39
HND-016616,2011,180600036,,,,16,20,36
HND-016619,2011,180600039,,,,14,6,20
HND-016623,2011,180600045,,,,11,5,16
HND-016626,2011,180600048,,,,34,26,60
HND-016627,2011,180600049,,,,4,2,6
,2011,180600050,,,,23,11,34
HND-016629,2011,180600051,,,,5,3,8
HND-016630,2011,180600052,,,,11,7,18
HND-016632,2011,180600054,,,,3,1,4
HND-016633,2011,180600055,,,,3,5,8
HND-016636,2011,180600058,,,,8,3,11
,2011,180600060,,,,7,5,12
HND-016642,2011,180600065,,,,21,19,40
HND-016647,2011,180600073,,,,7,3,10
HND-016649,2011,180600076,,,,4,6,10
HND-016650,2011,180600077,,,,11,10,21
HND-016655,2011,180600082,,,,15,6,21
HND-016656,2011,180600083,,,,6,3,9
,2011,180600097,,,,13,10,23
,2011,180600098,,,,6,3,9
HND-016668,2011,180600106,,,,4,2,6
HND-016674,2011,180600144,,,,11,9,20
,2011,180600147,,,,20,5,25
HND-016679,2011,180600151,,,,2,7,9
HND-016683,2011,180600158,,,,4,4,8
,2011,180600160,,,,5,1,6
HND-016584,2011,180600002,,,,3,4,7
HND-016586,2011,180600004,,,,47,57,104
HND-016587,2011,180600005,,,,7,9,16
HND-016588,2011,180600006,,,,8,8,16
HND-016590,2011,180600009,,,,7,10,17
,2011,180600011,,,,5,4,9
,2011,180600013,,,,7,9,16
HND-016596,2011,180600016,,,,23,8,31
HND-016597,2011,180600017,,,,5,0,5
HND-016601,2011,180600021,,,,17,11,28
HND-016603,2011,180600023,,,,4,4,8
HND-016606,2011,180600026,,,,8,7,15
HND-016607,2011,180600027,,,,3,2,5
HND-016610,2011,180600030,,,,30,19,49
HND-016611,2011,180600031,,,,1,4,5
HND-016612,2011,180600032,,,,11,7,18
HND-016613,2011,180600033,,,,49,44,93
HND-016614,2011,180600034,,,,7,6,13
HND-016617,2011,180600037,,,,21,25,46
,2011,180600038,,,,15,15,30
HND-016620,2011,180600040,,,,4,3,7
HND-016621,2011,180600041,,,,15,7,22
,2011,180600044,,,,6,5,11
HND-016624,2011,180600046,,,,32,36,68
HND-016625,2011,180600047,,,,3,3,6
HND-016631,2011,180600053,,,,8,5,13
HND-016637,2011,180600059,,,,2,2,4
HND-016641,2011,180600064,,,,12,12,24
,2011,180600074,,,,8,9,17
,2011,180600075,,,,9,4,13
HND-016651,2011,180600078,,,,3,1,4
HND-016653,2011,180600080,,,,5,4,9
HND-016654,2011,180600081,,,,16,13,29
HND-016661,2011,180600092,,,,5,5,10
HND-016665,2011,180600099,,,,2,0,2
,2011,180600100,,,,6,4,10
HND-016666,2011,180600101,,,,9,4,13
HND-016667,2011,180600102,,,,2,3,5
,2011,180600103,,,,0,2,2
HND-016678,2011,180600150,,,,3,4,7
,2011,180600152,,,,5,5,10
HND-016583,2011,180600001,,,,5,5,10
HND-016584,2011,180600002,,,,5,3,8
HND-016587,2011,180600005,,,,9,9,18
HND-016589,2011,180600008,,,,6,4,10
HND-016596,2011,180600016,,,,14,16,30
HND-016599,2011,180600019,,,,9,7,16
HND-016605,2011,180600025,,,,0,1,1
HND-016606,2011,180600026,,,,18,6,24
HND-016609,2011,180600029,,,,36,34,70
HND-016610,2011,180600030,,,,30,30,60
HND-016612,2011,180600032,,,,11,10,21
HND-016613,2011,180600033,,,,45,52,97
HND-016614,2011,180600034,,,,5,4,9
HND-016615,2011,180600035,,,,13,7,20
,2011,180600038,,,,15,12,27
HND-016619,2011,180600039,,,,3,1,4
HND-016620,2011,180600040,,,,8,2,10
,2011,180600044,,,,4,7,11
HND-016623,2011,180600045,,,,10,8,18
HND-016624,2011,180600046,,,,35,26,61
HND-016629,2011,180600051,,,,1,2,3
HND-016631,2011,180600053,,,,5,5,10
HND-016632,2011,180600054,,,,2,3,5
,2011,180600074,,,,6,8,14
,2011,180600075,,,,2,7,9
HND-016649,2011,180600076,,,,8,6,14
HND-016652,2011,180600079,,,,2,8,10
HND-016655,2011,180600082,,,,15,12,27
,2011,180600097,,,,6,1,7
HND-016665,2011,180600099,,,,6,3,9
HND-016666,2011,180600101,,,,1,2,3
HND-016667,2011,180600102,,,,2,1,3
,2011,180600103,,,,3,1,4
HND-016678,2011,180600150,,,,0,1,1
HND-016685,2011,180600161,,,,4,0,4
,2011,180600003,,,,11,10,21
HND-016586,2011,180600004,,,,55,45,100
HND-016588,2011,180600006,,,,5,3,8
HND-016590,2011,180600009,,,,4,3,7
HND-016591,2011,180600010,,,,7,3,10
,2011,180600011,,,,7,4,11
HND-016593,2011,180600012,,,,20,19,39
,2011,180600013,,,,6,4,10
HND-016595,2011,180600014,,,,7,16,23
HND-016597,2011,180600017,,,,6,3,9
HND-016598,2011,180600018,,,,8,2,10
HND-016600,2011,180600020,,,,7,11,18
HND-016601,2011,180600021,,,,14,13,27
HND-016602,2011,180600022,,,,13,6,19
HND-016603,2011,180600023,,,,6,5,11
HND-016604,2011,180600024,,,,18,20,38
HND-016607,2011,180600027,,,,2,2,4
HND-016608,2011,180600028,,,,25,28,53
HND-016611,2011,180600031,,,,7,7,14
HND-016616,2011,180600036,,,,16,10,26
HND-016617,2011,180600037,,,,23,29,52
HND-016621,2011,180600041,,,,8,7,15
HND-016625,2011,180600047,,,,3,1,4
HND-016626,2011,180600048,,,,14,20,34
HND-016627,2011,180600049,,,,2,1,3
,2011,180600050,,,,13,7,20
HND-016630,2011,180600052,,,,7,8,15
HND-016633,2011,180600055,,,,5,3,8
HND-016636,2011,180600058,,,,4,1,5
HND-016637,2011,180600059,,,,3,0,3
,2011,180600060,,,,5,3,8
HND-016641,2011,180600064,,,,6,6,12
HND-016642,2011,180600065,,,,18,20,38
,2011,180600067,,,,9,18,27
HND-016647,2011,180600073,,,,4,5,9
HND-016650,2011,180600077,,,,2,4,6
HND-016651,2011,180600078,,,,2,2,4
HND-016653,2011,180600080,,,,6,2,8
HND-016654,2011,180600081,,,,14,9,23
HND-016656,2011,180600083,,,,4,3,7
HND-016661,2011,180600092,,,,2,4,6
,2011,180600098,,,,4,6,10
,2011,180600100,,,,4,6,10
HND-016668,2011,180600106,,,,2,5,7
HND-016674,2011,180600144,,,,7,7,14
,2011,180600147,,,,5,7,12
HND-016679,2011,180600151,,,,3,4,7
,2011,180600152,,,,4,4,8
HND-016683,2011,180600158,,,,1,1,2
,2011,180600160,,,,3,0,3
HND-016583,2011,180600001,,,,5,4,9
HND-016584,2011,180600002,,,,4,2,6
,2011,180600003,,,,6,9,15
HND-016589,2011,180600008,,,,1,5,6
HND-016591,2011,180600010,,,,2,7,9
HND-016593,2011,180600012,,,,13,15,28
HND-016598,2011,180600018,,,,1,3,4
HND-016599,2011,180600019,,,,3,7,10
HND-016600,2011,180600020,,,,7,5,12
HND-016602,2011,180600022,,,,6,7,13
HND-016604,2011,180600024,,,,17,16,33
HND-016605,2011,180600025,,,,1,3,4
HND-016608,2011,180600028,,,,22,36,58
HND-016609,2011,180600029,,,,33,32,65
HND-016610,2011,180600030,,,,15,18,33
HND-016611,2011,180600031,,,,5,4,9
HND-016612,2011,180600032,,,,6,8,14
HND-016613,2011,180600033,,,,53,41,94
HND-016614,2011,180600034,,,,6,4,10
HND-016615,2011,180600035,,,,6,9,15
,2011,180600038,,,,12,13,25
HND-016620,2011,180600040,,,,2,6,8
HND-016621,2011,180600041,,,,10,10,20
,2011,180600044,,,,3,1,4
HND-016624,2011,180600046,,,,36,36,72
HND-016625,2011,180600047,,,,1,1,2
HND-016631,2011,180600053,,,,4,5,9
HND-016637,2011,180600059,,,,2,2,4
,2011,180600060,,,,2,2,4
HND-016642,2011,180600065,,,,17,16,33
,2011,180600074,,,,5,6,11
,2011,180600075,,,,4,8,12
HND-016651,2011,180600078,,,,1,2,3
HND-016652,2011,180600079,,,,5,4,9
HND-016653,2011,180600080,,,,2,2,4
HND-016654,2011,180600081,,,,12,10,22
HND-016665,2011,180600099,,,,1,2,3
,2011,180600100,,,,2,4,6
HND-016666,2011,180600101,,,,0,5,5
HND-016667,2011,180600102,,,,3,3,6
,2011,180600103,,,,3,4,7
HND-016678,2011,180600150,,,,2,0,2
,2011,180600152,,,,1,1,2
HND-016685,2011,180600161,,,,1,0,1
HND-016586,2011,180600004,,,,55,46,101
HND-016587,2011,180600005,,,,6,15,21
HND-016588,2011,180600006,,,,6,1,7
HND-016590,2011,180600009,,,,6,10,16
,2011,180600011,,,,3,2,5
,2011,180600013,,,,2,3,5
HND-016595,2011,180600014,,,,13,10,23
HND-016596,2011,180600016,,,,12,16,28
HND-016597,2011,180600017,,,,4,4,8
HND-016601,2011,180600021,,,,12,11,23
HND-016603,2011,180600023,,,,4,7,11
HND-016606,2011,180600026,,,,9,9,18
HND-016607,2011,180600027,,,,1,1,2
HND-016616,2011,180600036,,,,18,14,32
HND-016617,2011,180600037,,,,10,15,25
HND-016619,2011,180600039,,,,3,4,7
HND-016623,2011,180600045,,,,11,7,18
HND-016626,2011,180600048,,,,25,13,38
HND-016627,2011,180600049,,,,1,1,2
,2011,180600050,,,,12,6,18
HND-016629,2011,180600051,,,,2,4,6
HND-016630,2011,180600052,,,,8,1,9
HND-016632,2011,180600054,,,,1,1,2
HND-016633,2011,180600055,,,,2,3,5
HND-016636,2011,180600058,,,,7,10,17
HND-016641,2011,180600064,,,,10,5,15
HND-016647,2011,180600073,,,,5,4,9
HND-016649,2011,180600076,,,,4,6,10
HND-016650,2011,180600077,,,,4,3,7
HND-016655,2011,180600082,,,,7,7,14
HND-016656,2011,180600083,,,,5,3,8
HND-016661,2011,180600092,,,,5,4,9
,2011,180600097,,,,8,6,14
,2011,180600098,,,,1,3,4
HND-016668,2011,180600106,,,,3,2,5
HND-016674,2011,180600144,,,,8,2,10
,2011,180600147,,,,5,9,14
HND-016679,2011,180600151,,,,5,6,11
HND-016683,2011,180600158,,,,4,1,5
,2011,180600160,,,,3,0,3
HND-016584,2011,180600002,,,,1,1,2
HND-016586,2011,180600004,,,,56,49,105
HND-016587,2011,180600005,,,,6,3,9
HND-016589,2011,180600008,,,,3,3,6
HND-016590,2011,180600009,,,,0,2,2
,2011,180600013,,,,3,6,9
HND-016596,2011,180600016,,,,12,15,27
HND-016597,2011,180600017,,,,1,4,5
HND-016599,2011,180600019,,,,6,9,15
HND-016603,2011,180600023,,,,3,7,10
HND-016605,2011,180600025,,,,7,5,12
HND-016606,2011,180600026,,,,7,13,20
HND-016607,2011,180600027,,,,3,3,6
HND-016609,2011,180600029,,,,35,26,61
HND-016612,2011,180600032,,,,4,7,11
HND-016615,2011,180600035,,,,20,12,32
HND-016619,2011,180600039,,,,4,4,8
,2011,180600044,,,,4,3,7
HND-016623,2011,180600045,,,,1,1,2
HND-016624,2011,180600046,,,,33,29,62
HND-016626,2011,180600048,,,,13,16,29
HND-016627,2011,180600049,,,,1,0,1
,2011,180600050,,,,12,10,22
HND-016629,2011,180600051,,,,2,2,4
HND-016631,2011,180600053,,,,4,6,10
HND-016632,2011,180600054,,,,1,2,3
HND-016636,2011,180600058,,,,7,3,10
HND-016647,2011,180600073,,,,1,4,5
HND-016649,2011,180600076,,,,5,3,8
HND-016650,2011,180600077,,,,3,3,6
HND-016652,2011,180600079,,,,3,2,5
HND-016655,2011,180600082,,,,10,5,15
,2011,180600097,,,,6,1,7
HND-016666,2011,180600101,,,,0,3,3
HND-016674,2011,180600144,,,,13,5,18
HND-016678,2011,180600150,,,,2,4,6
,2011,180600160,,,,2,1,3
HND-016583,2011,180600001,,,,5,4,9
,2011,180600003,,,,11,6,17
HND-016588,2011,180600006,,,,3,6,9
HND-016591,2011,180600010,,,,8,7,15
,2011,180600011,,,,1,2,3
HND-016593,2011,180600012,,,,14,21,35
HND-016595,2011,180600014,,,,17,8,25
HND-016598,2011,180600018,,,,6,4,10
HND-016600,2011,180600020,,,,6,3,9
HND-016601,2011,180600021,,,,14,16,30
HND-016602,2011,180600022,,,,11,13,24
HND-016604,2011,180600024,,,,22,24,46
HND-016608,2011,180600028,,,,26,29,55
HND-016610,2011,180600030,,,,40,30,70
HND-016611,2011,180600031,,,,7,6,13
HND-016613,2011,180600033,,,,50,41,91
HND-016614,2011,180600034,,,,2,3,5
HND-016616,2011,180600036,,,,19,12,31
HND-016617,2011,180600037,,,,23,15,38
,2011,180600038,,,,18,12,30
HND-016621,2011,180600041,,,,6,7,13
HND-016625,2011,180600047,,,,8,6,14
HND-016630,2011,180600052,,,,5,4,9
HND-016633,2011,180600055,,,,1,2,3
HND-016637,2011,180600059,,,,3,0,3
,2011,180600060,,,,4,3,7
HND-016641,2011,180600064,,,,10,11,21
HND-016642,2011,180600065,,,,22,24,46
,2011,180600067,,,,10,8,18
,2011,180600074,,,,12,5,17
,2011,180600075,,,,2,2,4
HND-016651,2011,180600078,,,,5,1,6
HND-016653,2011,180600080,,,,5,4,9
HND-016654,2011,180600081,,,,9,9,18
HND-016656,2011,180600083,,,,0,2,2
HND-016661,2011,180600092,,,,4,4,8
,2011,180600098,,,,4,3,7
HND-016665,2011,180600099,,,,1,3,4
,2011,180600100,,,,5,8,13
HND-016667,2011,180600102,,,,0,1,1
,2011,180600103,,,,3,1,4
HND-016668,2011,180600106,,,,1,2,3
,2011,180600147,,,,4,9,13
HND-016679,2011,180600151,,,,1,5,6
,2011,180600152,,,,2,3,5
HND-016683,2011,180600158,,,,5,0,5
HND-016685,2011,180600161,,,,3,3,6
HND-016584,2011,180600002,,,,3,2,5
HND-016586,2011,180600004,,,,44,45,89
HND-016587,2011,180600005,,,,1,9,10
HND-016589,2011,180600008,,,,3,3,6
HND-016590,2011,180600009,,,,3,5,8
,2011,180600011,,,,4,0,4
,2011,180600013,,,,5,1,6
HND-016596,2011,180600016,,,,6,14,20
HND-016597,2011,180600017,,,,1,2,3
HND-016599,2011,180600019,,,,9,10,19
HND-016601,2011,180600021,,,,8,12,20
HND-016603,2011,180600023,,,,4,6,10
HND-016606,2011,180600026,,,,14,15,29
HND-016607,2011,180600027,,,,1,1,2
HND-016609,2011,180600029,,,,31,35,66
HND-016615,2011,180600035,,,,13,9,22
HND-016616,2011,180600036,,,,19,16,35
HND-016619,2011,180600039,,,,2,3,5
HND-016623,2011,180600045,,,,3,5,8
HND-016626,2011,180600048,,,,15,28,43
HND-016627,2011,180600049,,,,1,4,5
,2011,180600050,,,,5,7,12
HND-016629,2011,180600051,,,,0,2,2
HND-016630,2011,180600052,,,,5,0,5
HND-016632,2011,180600054,,,,0,1,1
HND-016636,2011,180600058,,,,9,17,26
HND-016641,2011,180600064,,,,7,7,14
HND-016647,2011,180600073,,,,6,6,12
HND-016649,2011,180600076,,,,3,2,5
HND-016650,2011,180600077,,,,2,1,3
HND-016652,2011,180600079,,,,5,1,6
HND-016655,2011,180600082,,,,6,5,11
HND-016656,2011,180600083,,,,2,4,6
,2011,180600097,,,,2,1,3
,2011,180600098,,,,5,1,6
HND-016666,2011,180600101,,,,2,4,6
HND-016668,2011,180600106,,,,2,2,4
HND-016674,2011,180600144,,,,9,10,19
,2011,180600147,,,,1,1,2
HND-016679,2011,180600151,,,,3,4,7
HND-016683,2011,180600158,,,,0,3,3
,2011,180600160,,,,1,1,2
HND-016583,2011,180600001,,,,4,4,8
,2011,180600003,,,,10,3,13
HND-016588,2011,180600006,,,,1,2,3
HND-016591,2011,180600010,,,,7,3,10
HND-016593,2011,180600012,,,,11,11,22
HND-016595,2011,180600014,,,,6,5,11
HND-016598,2011,180600018,,,,3,2,5
HND-016600,2011,180600020,,,,4,8,12
HND-016602,2011,180600022,,,,8,5,13
HND-016604,2011,180600024,,,,16,11,27
HND-016605,2011,180600025,,,,2,1,3
HND-016608,2011,180600028,,,,29,27,56
HND-016610,2011,180600030,,,,19,30,49
HND-016611,2011,180600031,,,,8,3,11
HND-016612,2011,180600032,,,,6,4,10
HND-016613,2011,180600033,,,,50,56,106
HND-016614,2011,180600034,,,,4,2,6
HND-016617,2011,180600037,,,,40,31,71
,2011,180600038,,,,13,15,28
HND-016621,2011,180600041,,,,7,5,12
,2011,180600044,,,,1,1,2
HND-016624,2011,180600046,,,,14,14,28
HND-016625,2011,180600047,,,,0,2,2
HND-016631,2011,180600053,,,,5,5,10
HND-016633,2011,180600055,,,,2,3,5
HND-016637,2011,180600059,,,,3,0,3
,2011,180600060,,,,1,4,5
HND-016642,2011,180600065,,,,16,11,27
,2011,180600074,,,,3,11,14
,2011,180600075,,,,1,6,7
HND-016653,2011,180600080,,,,3,3,6
HND-016654,2011,180600081,,,,8,12,20
HND-016661,2011,180600092,,,,4,0,4
HND-016665,2011,180600099,,,,3,2,5
,2011,180600100,,,,2,5,7
HND-016667,2011,180600102,,,,1,2,3
,2011,180600103,,,,4,1,5
HND-016685,2011,180600161,,,,1,3,4
,2011,180600003,,,,6,9,15
HND-016586,2011,180600004,,,,53,44,97
HND-016588,2011,180600006,,,,0,3,3
HND-016590,2011,180600009,,,,1,3,4
HND-016591,2011,180600010,,,,5,6,11
HND-016593,2011,180600012,,,,7,7,14
,2011,180600013,,,,7,3,10
HND-016595,2011,180600014,,,,4,6,10
HND-016597,2011,180600017,,,,1,0,1
HND-016598,2011,180600018,,,,7,2,9
HND-016600,2011,180600020,,,,5,5,10
HND-016601,2011,180600021,,,,9,17,26
HND-016602,2011,180600022,,,,7,12,19
HND-016603,2011,180600023,,,,6,5,11
HND-016604,2011,180600024,,,,22,16,38
HND-016607,2011,180600027,,,,2,2,4
HND-016608,2011,180600028,,,,30,30,60
HND-016611,2011,180600031,,,,3,1,4
HND-016616,2011,180600036,,,,14,10,24
HND-016617,2011,180600037,,,,26,30,56
HND-016621,2011,180600041,,,,6,7,13
HND-016626,2011,180600048,,,,12,12,24
HND-016627,2011,180600049,,,,5,0,5
,2011,180600050,,,,1,5,6
HND-016630,2011,180600052,,,,2,4,6
HND-016633,2011,180600055,,,,2,2,4
HND-016636,2011,180600058,,,,5,8,13
HND-016637,2011,180600059,,,,1,1,2
,2011,180600060,,,,2,1,3
HND-016641,2011,180600064,,,,7,8,15
HND-016642,2011,180600065,,,,22,16,38
,2011,180600067,,,,11,13,24
HND-016647,2011,180600073,,,,2,0,2
HND-016650,2011,180600077,,,,1,2,3
HND-016653,2011,180600080,,,,3,2,5
HND-016654,2011,180600081,,,,3,12,15
HND-016656,2011,180600083,,,,1,4,5
HND-016661,2011,180600092,,,,7,4,11
,2011,180600098,,,,2,1,3
HND-016674,2011,180600144,,,,11,7,18
HND-016679,2011,180600151,,,,2,0,2
HND-016583,2011,180600001,,,,7,3,10
HND-016584,2011,180600002,,,,2,1,3
HND-016587,2011,180600005,,,,0,4,4
HND-016596,2011,180600016,,,,15,5,20
HND-016599,2011,180600019,,,,2,4,6
HND-016605,2011,180600025,,,,3,1,4
HND-016606,2011,180600026,,,,11,14,25
HND-016609,2011,180600029,,,,30,36,66
HND-016610,2011,180600030,,,,18,22,40
HND-016612,2011,180600032,,,,6,12,18
HND-016613,2011,180600033,,,,63,54,117
HND-016614,2011,180600034,,,,1,2,3
HND-016615,2011,180600035,,,,5,5,10
,2011,180600038,,,,8,6,14
HND-016619,2011,180600039,,,,2,0,2
,2011,180600044,,,,0,2,2
HND-016623,2011,180600045,,,,5,2,7
HND-016624,2011,180600046,,,,25,25,50
HND-016631,2011,180600053,,,,3,6,9
,2011,180600074,,,,6,5,11
,2011,180600075,,,,1,2,3
HND-016649,2011,180600076,,,,2,2,4
HND-016652,2011,180600079,,,,3,7,10
HND-016655,2011,180600082,,,,8,10,18
,2011,180600097,,,,0,2,2
HND-016665,2011,180600099,,,,6,1,7
,2011,180600100,,,,4,4,8
HND-016666,2011,180600101,,,,0,1,1
,2011,180600103,,,,2,5,7
HND-016678,2011,180600150,,,,3,3,6
,2011,180600160,,,,3,0,3
HND-016685,2011,180600161,,,,1,0,1
HND-016593,2011,180600012,,,,12,16,28
HND-016604,2011,180600024,,,,11,12,23
HND-016608,2011,180600028,,,,23,18,41
HND-016642,2011,180600065,,,,11,12,23
HND-016643,2011,180600066,,,,21,19,40
,2011,180600074,,,,4,6,10
,2011,180600100,,,,3,3,6
,2011,180600107,,,,23,25,48
HND-016596,2011,180600016,,,,12,12,24
HND-016601,2011,180600021,,,,10,21,31
HND-016609,2011,180600029,,,,26,30,56
HND-016610,2011,180600030,,,,12,24,36
HND-016617,2011,180600037,,,,23,25,48
HND-016635,2011,180600057,,,,316,217,533
HND-016641,2011,180600064,,,,11,11,22
,2011,180600067,,,,152,197,349
HND-016596,2011,180600016,,,,6,8,14
HND-016609,2011,180600029,,,,13,18,31
HND-016610,2011,180600030,,,,10,15,25
HND-016635,2011,180600057,,,,125,167,292
HND-016593,2011,180600012,,,,4,8,12
HND-016601,2011,180600021,,,,6,6,12
HND-016604,2011,180600024,,,,14,6,20
HND-016608,2011,180600028,,,,13,14,27
HND-016617,2011,180600037,,,,17,30,47
HND-016641,2011,180600064,,,,9,10,19
HND-016642,2011,180600065,,,,14,6,20
HND-016643,2011,180600066,,,,16,12,28
,2011,180600067,,,,119,146,265
,2011,180600074,,,,2,8,10
,2011,180600100,,,,1,6,7
,2011,180600107,,,,15,29,44
HND-016596,2011,180600016,,,,9,5,14
HND-016609,2011,180600029,,,,12,16,28
HND-016635,2011,180600057,,,,102,114,216
HND-016643,2011,180600066,,,,18,17,35
HND-016593,2011,180600012,,,,6,7,13
HND-016601,2011,180600021,,,,7,9,16
HND-016604,2011,180600024,,,,2,7,9
HND-016608,2011,180600028,,,,13,19,32
HND-016610,2011,180600030,,,,6,6,12
HND-016617,2011,180600037,,,,9,8,17
HND-016641,2011,180600064,,,,6,11,17
HND-016642,2011,180600065,,,,2,7,9
,2011,180600067,,,,73,106,179
,2011,180600100,,,,0,2,2
,2011,180600107,,,,25,26,51
HND-016635,2011,180600057,,,,68,220,288
,2011,180600067,,,,37,65,102
HND-016609,2011,180600029,,,,17,28,45
HND-016643,2011,180600066,,,,11,11,22
,2011,180600107,,,,18,7,25
,2011,180600067,,,,24,53,77
,2011,180600107,,,,14,17,31
HND-016609,2011,180600029,,,,12,10,22
HND-016635,2011,180600057,,,,68,177,245
HND-016643,2011,180600066,,,,9,10,19
HND-016609,2011,180600029,,,,2,3,5
HND-016635,2011,180600057,,,,92,149,241
HND-016643,2011,180600066,,,,10,15,25
,2011,180600107,,,,11,16,27
HND-016733,2011,180700057,,,,5,5,10
,2011,180700090,,,,7,12,19
HND-016816,2011,180700171,,,,13,8,21
,2011,180700173,,,,11,4,15
HND-016842,2011,180700271,,,,7,3,10
,2011,180700277,,,,4,7,11
,2011,180700278,,,,5,6,11
,2011,180700283,,,,7,6,13
HND-016848,2011,180700303,,,,12,7,19
HND-016851,2011,180700309,,,,6,4,10
HND-016853,2011,180700312,,,,4,5,9
,2011,180700313,,,,4,9,13
,2011,180700315,,,,8,7,15
HND-016856,2011,180700325,,,,7,6,13
,2011,180700326,,,,3,6,9
HND-016858,2011,180700328,,,,6,5,11
,2011,180700332,,,,8,14,22
,2011,180700335,,,,7,4,11
,2011,180700337,,,,6,5,11
,2011,180700338,,,,10,4,14
,2011,180700341,,,,7,8,15
,2011,180700342,,,,6,10,16
HND-016862,2011,180700343,,,,7,6,13
,2011,180700346,,,,5,10,15
,2011,180700347,,,,7,5,12
HND-016863,2011,180700348,,,,4,8,12
,2011,180700349,,,,5,8,13
HND-016864,2011,180700350,,,,5,6,11
,2011,180700352,,,,6,8,14
,2011,180700355,,,,6,4,10
HND-016867,2011,180700359,,,,4,12,16
,2011,180700360,,,,5,5,10
,2011,180700361,,,,7,6,13
,2011,180700370,,,,5,6,11
,2011,180700371,,,,4,7,11
,2011,180700385,,,,6,8,14
HND-016881,2011,180700386,,,,5,9,14
HND-016883,2011,180700390,,,,7,3,10
,2011,180700395,,,,7,8,15
HND-016781,2011,180700112,,,,8,7,15
,2011,180700144,,,,6,6,12
,2011,180700146,,,,6,8,14
HND-016806,2011,180700147,,,,6,4,10
,2011,180700151,,,,6,4,10
,2011,180700163,,,,12,14,26
,2011,180700166,,,,9,3,12
HND-016841,2011,180700214,,,,5,10,15
,2011,180700275,,,,6,5,11
,2011,180700282,,,,8,8,16
HND-016843,2011,180700287,,,,10,6,16
HND-016844,2011,180700288,,,,7,8,15
,2011,180700290,,,,8,10,18
,2011,180700292,,,,7,3,10
,2011,180700293,,,,10,11,21
HND-016846,2011,180700295,,,,3,8,11
,2011,180700301,,,,4,6,10
,2011,180700306,,,,7,8,15
,2011,180700319,,,,4,9,13
,2011,180700322,,,,7,9,16
HND-016857,2011,180700327,,,,5,12,17
,2011,180700329,,,,5,5,10
HND-016859,2011,180700330,,,,5,5,10
HND-016860,2011,180700333,,,,9,4,13
,2011,180700334,,,,5,8,13
,2011,180700336,,,,6,6,12
,2011,180700340,,,,5,10,15
,2011,180700344,,,,8,11,19
,2011,180700345,,,,5,7,12
,2011,180700351,,,,7,8,15
HND-016865,2011,180700353,,,,6,12,18
,2011,180700354,,,,7,7,14
HND-016866,2011,180700356,,,,7,9,16
,2011,180700357,,,,6,5,11
,2011,180700358,,,,6,7,13
,2011,180700363,,,,12,16,28
HND-016868,2011,180700366,,,,9,10,19
HND-016869,2011,180700367,,,,7,11,18
,2011,180700368,,,,5,6,11
,2011,180700372,,,,5,5,10
HND-016870,2011,180700373,,,,4,9,13
,2011,180700387,,,,8,7,15
HND-016882,2011,180700388,,,,4,9,13
,2011,180700389,,,,16,8,24
,2011,180700392,,,,6,7,13
HND-016884,2011,180700396,,,,8,6,14
HND-016751,2011,180700075,,,,9,6,15
HND-016785,2011,180700116,,,,14,11,25
HND-016833,2011,180700199,,,,1,1,2
,2011,180700105,,,,0,1,1
,2011,180700122,,,,0,1,1
,2011,180700204,,,,6,10,16
,2011,180700391,,,,3,0,3
,2011,180700019,,,,3,6,9
HND-016715,2011,180700036,,,,8,6,14
HND-016742,2011,180700066,,,,12,5,17
HND-016750,2011,180700074,,,,0,3,3
HND-016751,2011,180700075,,,,8,16,24
,2011,180700105,,,,4,4,8
HND-016783,2011,180700114,,,,30,38,68
HND-016784,2011,180700115,,,,9,5,14
HND-016785,2011,180700116,,,,23,27,50
HND-016789,2011,180700123,,,,9,13,22
HND-016791,2011,180700125,,,,3,7,10
HND-016810,2011,180700155,,,,3,0,3
HND-016814,2011,180700169,,,,5,11,16
HND-016819,2011,180700179,,,,8,11,19
HND-016820,2011,180700180,,,,7,5,12
HND-016833,2011,180700199,,,,8,5,13
HND-016834,2011,180700200,,,,5,5,10
,2011,180700204,,,,13,17,30
,2011,180700273,,,,6,5,11
,2011,180700286,,,,14,5,19
HND-016845,2011,180700289,,,,2,2,4
,2011,180700304,,,,10,11,21
HND-016850,2011,180700308,,,,3,6,9
HND-016861,2011,180700339,,,,3,4,7
,2011,180700375,,,,4,2,6
HND-016877,2011,180700381,,,,2,4,6
HND-016692,2011,180700008,,,,2,2,4
HND-016701,2011,180700017,,,,3,2,5
,2011,180700095,,,,5,6,11
,2011,180700099,,,,3,6,9
HND-016787,2011,180700119,,,,13,14,27
HND-016788,2011,180700121,,,,10,12,22
,2011,180700122,,,,2,6,8
HND-016790,2011,180700124,,,,6,7,13
HND-016792,2011,180700126,,,,5,5,10
,2011,180700129,,,,1,4,5
HND-016803,2011,180700142,,,,8,7,15
HND-016804,2011,180700143,,,,10,10,20
HND-016807,2011,180700148,,,,2,5,7
HND-016808,2011,180700150,,,,0,2,2
HND-016811,2011,180700156,,,,12,4,16
HND-016812,2011,180700160,,,,1,4,5
HND-016831,2011,180700197,,,,9,8,17
HND-016837,2011,180700203,,,,3,4,7
HND-016838,2011,180700205,,,,20,19,39
HND-016840,2011,180700209,,,,8,8,16
,2011,180700213,,,,6,9,15
,2011,180700297,,,,9,0,9
,2011,180700362,,,,1,3,4
HND-016875,2011,180700379,,,,16,8,24
HND-016878,2011,180700382,,,,2,0,2
,2011,180700391,,,,4,2,6
HND-016692,2011,180700008,,,,2,6,8
HND-016701,2011,180700017,,,,5,2,7
,2011,180700099,,,,10,11,21
HND-016786,2011,180700118,,,,27,24,51
HND-016787,2011,180700119,,,,16,17,33
HND-016788,2011,180700121,,,,38,25,63
,2011,180700122,,,,6,7,13
HND-016790,2011,180700124,,,,12,23,35
HND-016792,2011,180700126,,,,11,13,24
HND-016803,2011,180700142,,,,8,12,20
HND-016804,2011,180700143,,,,23,19,42
HND-016807,2011,180700148,,,,16,16,32
HND-016808,2011,180700150,,,,6,4,10
HND-016811,2011,180700156,,,,12,15,27
HND-016812,2011,180700160,,,,7,7,14
HND-016814,2011,180700169,,,,6,8,14
HND-016831,2011,180700197,,,,2,6,8
HND-016837,2011,180700203,,,,14,16,30
HND-016838,2011,180700205,,,,18,20,38
HND-016840,2011,180700209,,,,7,7,14
,2011,180700213,,,,9,7,16
,2011,180700297,,,,10,5,15
,2011,180700304,,,,21,23,44
HND-016850,2011,180700308,,,,10,11,21
HND-016875,2011,180700379,,,,8,10,18
HND-016877,2011,180700381,,,,2,4,6
HND-016878,2011,180700382,,,,11,9,20
,2011,180700391,,,,2,5,7
,2011,180700019,,,,10,11,21
HND-016715,2011,180700036,,,,9,5,14
HND-016742,2011,180700066,,,,10,9,19
HND-016750,2011,180700074,,,,5,5,10
,2011,180700095,,,,6,5,11
,2011,180700105,,,,3,2,5
HND-016783,2011,180700114,,,,56,58,114
HND-016784,2011,180700115,,,,7,9,16
HND-016785,2011,180700116,,,,45,35,80
HND-016789,2011,180700123,,,,11,12,23
HND-016791,2011,180700125,,,,12,8,20
,2011,180700129,,,,17,17,34
HND-016810,2011,180700155,,,,19,10,29
HND-016819,2011,180700179,,,,12,10,22
HND-016820,2011,180700180,,,,10,8,18
HND-016833,2011,180700199,,,,1,4,5
HND-016834,2011,180700200,,,,5,6,11
,2011,180700204,,,,15,16,31
,2011,180700273,,,,8,5,13
,2011,180700286,,,,2,4,6
HND-016845,2011,180700289,,,,8,6,14
,2011,180700300,,,,14,12,26
HND-016861,2011,180700339,,,,6,4,10
,2011,180700362,,,,9,4,13
,2011,180700375,,,,2,4,6
HND-016688,2011,180700004,,,,97,16,113
,2011,180700005,,,,4,10,14
HND-016692,2011,180700008,,,,8,10,18
HND-016694,2011,180700010,,,,14,11,25
HND-016695,2011,180700011,,,,8,3,11
HND-016696,2011,180700012,,,,16,11,27
HND-016704,2011,180700023,,,,1,8,9
HND-016707,2011,180700026,,,,1,5,6
HND-016709,2011,180700029,,,,27,25,52
HND-016713,2011,180700033,,,,8,6,14
HND-016715,2011,180700036,,,,9,14,23
HND-016716,2011,180700037,,,,23,25,48
HND-016718,2011,180700039,,,,3,7,10
HND-016721,2011,180700042,,,,26,25,51
HND-016726,2011,180700049,,,,1,0,1
HND-016728,2011,180700051,,,,5,3,8
HND-016730,2011,180700053,,,,2,2,4
HND-016732,2011,180700056,,,,7,3,10
HND-016733,2011,180700057,,,,10,14,24
HND-016735,2011,180700059,,,,15,20,35
HND-016738,2011,180700062,,,,12,7,19
HND-016741,2011,180700065,,,,15,9,24
HND-016744,2011,180700068,,,,13,14,27
HND-016745,2011,180700069,,,,10,17,27
HND-016746,2011,180700070,,,,2,1,3
HND-016747,2011,180700071,,,,8,11,19
HND-016748,2011,180700072,,,,16,11,27
HND-016749,2011,180700073,,,,67,35,102
HND-016750,2011,180700074,,,,13,6,19
HND-016753,2011,180700077,,,,4,3,7
HND-016754,2011,180700078,,,,2,1,3
HND-016758,2011,180700082,,,,13,12,25
HND-016761,2011,180700085,,,,20,12,32
HND-016764,2011,180700089,,,,2,4,6
,2011,180700090,,,,2,3,5
HND-016766,2011,180700091,,,,12,14,26
HND-016769,2011,180700098,,,,3,0,3
HND-016770,2011,180700100,,,,31,32,63
HND-016773,2011,180700103,,,,72,64,136
HND-016774,2011,180700104,,,,95,70,165
HND-016775,2011,180700106,,,,8,6,14
HND-016776,2011,180700107,,,,8,5,13
HND-016777,2011,180700108,,,,42,29,71
HND-016778,2011,180700109,,,,10,13,23
HND-016793,2011,180700127,,,,1,1,2
,2011,180700128,,,,9,14,23
HND-016809,2011,180700154,,,,9,11,20
HND-016817,2011,180700177,,,,1,4,5
HND-016821,2011,180700182,,,,33,42,75
HND-016823,2011,180700184,,,,2,1,3
,2011,180700187,,,,5,2,7
HND-016824,2011,180700188,,,,3,5,8
HND-016827,2011,180700191,,,,29,29,58
HND-016828,2011,180700193,,,,7,6,13
HND-016829,2011,180700194,,,,1,7,8
HND-016830,2011,180700195,,,,6,6,12
HND-016831,2011,180700197,,,,3,4,7
HND-016832,2011,180700198,,,,3,3,6
HND-016834,2011,180700200,,,,1,4,5
HND-016835,2011,180700201,,,,9,15,24
HND-016836,2011,180700202,,,,3,3,6
HND-016840,2011,180700209,,,,2,5,7
,2011,180700298,,,,4,1,5
HND-016855,2011,180700324,,,,13,6,19
HND-016860,2011,180700333,,,,10,4,14
HND-016874,2011,180700378,,,,2,3,5
HND-016875,2011,180700379,,,,3,5,8
HND-016876,2011,180700380,,,,10,10,20
HND-016877,2011,180700381,,,,4,10,14
HND-016686,2011,180700001,,,,17,16,33
HND-016687,2011,180700003,,,,12,10,22
HND-016690,2011,180700006,,,,41,25,66
HND-016691,2011,180700007,,,,3,2,5
HND-016697,2011,180700013,,,,6,8,14
HND-016698,2011,180700014,,,,44,54,98
HND-016699,2011,180700015,,,,59,29,88
HND-016700,2011,180700016,,,,19,15,34
HND-016701,2011,180700017,,,,5,7,12
HND-016702,2011,180700018,,,,0,70,70
HND-016703,2011,180700022,,,,5,2,7
HND-016705,2011,180700024,,,,32,26,58
HND-016706,2011,180700025,,,,5,12,17
,2011,180700028,,,,21,17,38
HND-016710,2011,180700030,,,,45,40,85
HND-016711,2011,180700031,,,,37,34,71
HND-016712,2011,180700032,,,,6,5,11
HND-016717,2011,180700038,,,,19,6,25
HND-016719,2011,180700040,,,,9,7,16
HND-016720,2011,180700041,,,,3,2,5
HND-016722,2011,180700044,,,,52,39,91
HND-016723,2011,180700046,,,,4,7,11
HND-016724,2011,180700047,,,,12,14,26
HND-016725,2011,180700048,,,,2,3,5
HND-016727,2011,180700050,,,,25,23,48
HND-016729,2011,180700052,,,,0,3,3
HND-016731,2011,180700055,,,,6,3,9
HND-016734,2011,180700058,,,,4,5,9
HND-016736,2011,180700060,,,,11,15,26
HND-016737,2011,180700061,,,,10,15,25
HND-016739,2011,180700063,,,,49,55,104
HND-016740,2011,180700064,,,,6,9,15
HND-016742,2011,180700066,,,,7,4,11
HND-016743,2011,180700067,,,,6,10,16
HND-016751,2011,180700075,,,,19,18,37
HND-016752,2011,180700076,,,,14,16,30
,2011,180700079,,,,47,37,84
HND-016756,2011,180700080,,,,2,1,3
HND-016757,2011,180700081,,,,7,4,11
,2011,180700083,,,,2,0,2
HND-016760,2011,180700084,,,,12,13,25
HND-016762,2011,180700086,,,,8,12,20
HND-016763,2011,180700088,,,,2,6,8
HND-016767,2011,180700092,,,,6,4,10
,2011,180700095,,,,7,6,13
HND-016768,2011,180700097,,,,9,11,20
,2011,180700099,,,,14,12,26
HND-016771,2011,180700101,,,,25,15,40
HND-016772,2011,180700102,,,,6,5,11
,2011,180700105,,,,6,9,15
HND-016779,2011,180700110,,,,3,3,6
HND-016780,2011,180700111,,,,7,8,15
HND-016781,2011,180700112,,,,7,2,9
,2011,180700129,,,,17,19,36
HND-016805,2011,180700145,,,,36,23,59
HND-016812,2011,180700160,,,,6,4,10
HND-016815,2011,180700170,,,,50,40,90
HND-016818,2011,180700178,,,,3,7,10
HND-016825,2011,180700189,,,,1,3,4
HND-016826,2011,180700190,,,,5,4,9
,2011,180700196,,,,4,7,11
HND-016833,2011,180700199,,,,1,1,2
,2011,180700204,,,,11,11,22
,2011,180700207,,,,9,7,16
HND-016839,2011,180700208,,,,4,3,7
,2011,180700297,,,,15,13,28
HND-016850,2011,180700308,,,,18,18,36
HND-016852,2011,180700310,,,,16,18,34
HND-016854,2011,180700316,,,,3,4,7
,2011,180700335,,,,10,5,15
,2011,180700362,,,,5,9,14
HND-016872,2011,180700376,,,,10,10,20
HND-016873,2011,180700377,,,,1,0,1
HND-016879,2011,180700383,,,,3,3,6
HND-016880,2011,180700384,,,,6,4,10
HND-016686,2011,180700001,,,,26,24,50
HND-016687,2011,180700003,,,,14,12,26
HND-016691,2011,180700007,,,,0,4,4
HND-016692,2011,180700008,,,,6,6,12
HND-016694,2011,180700010,,,,18,12,30
HND-016695,2011,180700011,,,,9,3,12
HND-016697,2011,180700013,,,,11,7,18
HND-016699,2011,180700015,,,,40,33,73
HND-016700,2011,180700016,,,,19,12,31
HND-016701,2011,180700017,,,,7,5,12
HND-016703,2011,180700022,,,,7,4,11
HND-016706,2011,180700025,,,,10,10,20
,2011,180700028,,,,13,16,29
HND-016709,2011,180700029,,,,19,12,31
HND-016710,2011,180700030,,,,27,31,58
HND-016712,2011,180700032,,,,2,0,2
HND-016717,2011,180700038,,,,10,11,21
HND-016718,2011,180700039,,,,3,4,7
HND-016719,2011,180700040,,,,13,7,20
HND-016720,2011,180700041,,,,7,3,10
HND-016721,2011,180700042,,,,42,20,62
HND-016722,2011,180700044,,,,37,23,60
HND-016725,2011,180700048,,,,3,4,7
HND-016729,2011,180700052,,,,5,1,6
HND-016731,2011,180700055,,,,3,2,5
HND-016732,2011,180700056,,,,2,2,4
HND-016735,2011,180700059,,,,13,10,23
HND-016736,2011,180700060,,,,21,9,30
HND-016737,2011,180700061,,,,9,12,21
HND-016738,2011,180700062,,,,15,10,25
HND-016740,2011,180700064,,,,9,8,17
HND-016743,2011,180700067,,,,8,8,16
HND-016744,2011,180700068,,,,20,17,37
HND-016747,2011,180700071,,,,8,4,12
HND-016749,2011,180700073,,,,41,34,75
HND-016752,2011,180700076,,,,16,14,30
HND-016753,2011,180700077,,,,2,4,6
,2011,180700079,,,,34,36,70
HND-016756,2011,180700080,,,,2,3,5
HND-016757,2011,180700081,,,,10,4,14
HND-016758,2011,180700082,,,,8,8,16
HND-016760,2011,180700084,,,,6,10,16
HND-016761,2011,180700085,,,,11,16,27
HND-016763,2011,180700088,,,,4,7,11
,2011,180700090,,,,2,3,5
HND-016766,2011,180700091,,,,6,2,8
HND-016767,2011,180700092,,,,2,1,3
,2011,180700095,,,,15,11,26
HND-016768,2011,180700097,,,,7,3,10
,2011,180700099,,,,12,16,28
HND-016770,2011,180700100,,,,29,44,73
HND-016772,2011,180700102,,,,3,3,6
HND-016775,2011,180700106,,,,5,6,11
HND-016776,2011,180700107,,,,3,4,7
HND-016777,2011,180700108,,,,23,20,43
HND-016779,2011,180700110,,,,4,6,10
HND-016781,2011,180700112,,,,10,6,16
HND-016793,2011,180700127,,,,1,0,1
,2011,180700128,,,,15,16,31
,2011,180700129,,,,29,19,48
HND-016805,2011,180700145,,,,11,16,27
HND-016809,2011,180700154,,,,8,12,20
HND-016812,2011,180700160,,,,8,9,17
HND-016815,2011,180700170,,,,53,32,85
HND-016818,2011,180700178,,,,7,3,10
HND-016821,2011,180700182,,,,34,30,64
,2011,180700185,,,,0,2,2
HND-016825,2011,180700189,,,,3,1,4
HND-016826,2011,180700190,,,,3,3,6
HND-016828,2011,180700193,,,,2,3,5
,2011,180700196,,,,6,5,11
HND-016831,2011,180700197,,,,5,1,6
HND-016832,2011,180700198,,,,2,3,5
,2011,180700207,,,,4,2,6
HND-016840,2011,180700209,,,,3,2,5
,2011,180700297,,,,9,8,17
,2011,180700298,,,,2,3,5
HND-016852,2011,180700310,,,,17,16,33
HND-016854,2011,180700316,,,,6,7,13
HND-016860,2011,180700333,,,,8,9,17
HND-016872,2011,180700376,,,,9,7,16
HND-016875,2011,180700379,,,,3,3,6
HND-016877,2011,180700381,,,,11,5,16
HND-016688,2011,180700004,,,,57,9,66
,2011,180700005,,,,4,4,8
HND-016690,2011,180700006,,,,23,15,38
HND-016696,2011,180700012,,,,11,10,21
HND-016698,2011,180700014,,,,41,37,78
HND-016702,2011,180700018,,,,0,61,61
HND-016704,2011,180700023,,,,6,2,8
HND-016705,2011,180700024,,,,27,24,51
HND-016707,2011,180700026,,,,1,3,4
HND-016711,2011,180700031,,,,32,21,53
HND-016713,2011,180700033,,,,8,2,10
HND-016715,2011,180700036,,,,15,16,31
HND-016716,2011,180700037,,,,7,10,17
HND-016723,2011,180700046,,,,4,13,17
HND-016724,2011,180700047,,,,14,15,29
HND-016726,2011,180700049,,,,4,3,7
HND-016727,2011,180700050,,,,38,26,64
HND-016728,2011,180700051,,,,2,2,4
HND-016730,2011,180700053,,,,3,4,7
HND-016733,2011,180700057,,,,9,10,19
HND-016734,2011,180700058,,,,1,2,3
HND-016739,2011,180700063,,,,38,34,72
HND-016741,2011,180700065,,,,9,11,20
HND-016742,2011,180700066,,,,10,6,16
HND-016745,2011,180700069,,,,20,14,34
HND-016746,2011,180700070,,,,4,2,6
HND-016748,2011,180700072,,,,12,11,23
HND-016750,2011,180700074,,,,8,6,14
HND-016751,2011,180700075,,,,21,15,36
HND-016754,2011,180700078,,,,4,1,5
,2011,180700083,,,,1,0,1
HND-016762,2011,180700086,,,,7,3,10
HND-016764,2011,180700089,,,,2,3,5
HND-016769,2011,180700098,,,,0,1,1
HND-016771,2011,180700101,,,,14,10,24
HND-016773,2011,180700103,,,,50,41,91
HND-016774,2011,180700104,,,,74,51,125
,2011,180700105,,,,13,8,21
HND-016778,2011,180700109,,,,7,4,11
HND-016780,2011,180700111,,,,7,5,12
HND-016817,2011,180700177,,,,2,2,4
HND-016823,2011,180700184,,,,1,4,5
,2011,180700187,,,,1,2,3
HND-016824,2011,180700188,,,,3,5,8
HND-016827,2011,180700191,,,,22,22,44
HND-016829,2011,180700194,,,,2,7,9
HND-016830,2011,180700195,,,,2,3,5
HND-016833,2011,180700199,,,,1,2,3
HND-016834,2011,180700200,,,,5,4,9
HND-016835,2011,180700201,,,,1,5,6
HND-016836,2011,180700202,,,,5,2,7
,2011,180700204,,,,16,11,27
HND-016839,2011,180700208,,,,1,2,3
HND-016850,2011,180700308,,,,18,9,27
HND-016855,2011,180700324,,,,7,9,16
,2011,180700335,,,,7,5,12
,2011,180700362,,,,14,4,18
HND-016873,2011,180700377,,,,1,0,1
HND-016874,2011,180700378,,,,2,4,6
HND-016876,2011,180700380,,,,6,6,12
HND-016879,2011,180700383,,,,3,4,7
HND-016880,2011,180700384,,,,11,9,20
HND-016686,2011,180700001,,,,36,18,54
HND-016687,2011,180700003,,,,3,5,8
HND-016690,2011,180700006,,,,35,17,52
HND-016691,2011,180700007,,,,4,3,7
HND-016695,2011,180700011,,,,4,12,16
HND-016697,2011,180700013,,,,13,12,25
HND-016698,2011,180700014,,,,43,34,77
HND-016699,2011,180700015,,,,47,48,95
HND-016700,2011,180700016,,,,14,14,28
HND-016701,2011,180700017,,,,4,4,8
HND-016702,2011,180700018,,,,0,75,75
HND-016703,2011,180700022,,,,8,6,14
HND-016705,2011,180700024,,,,30,28,58
HND-016706,2011,180700025,,,,10,9,19
,2011,180700028,,,,22,14,36
HND-016710,2011,180700030,,,,38,37,75
HND-016711,2011,180700031,,,,46,32,78
HND-016712,2011,180700032,,,,3,6,9
HND-016717,2011,180700038,,,,12,17,29
HND-016719,2011,180700040,,,,8,8,16
HND-016720,2011,180700041,,,,5,4,9
HND-016722,2011,180700044,,,,28,29,57
HND-016724,2011,180700047,,,,21,17,38
HND-016727,2011,180700050,,,,28,36,64
HND-016729,2011,180700052,,,,7,1,8
HND-016731,2011,180700055,,,,3,3,6
HND-016734,2011,180700058,,,,7,2,9
HND-016735,2011,180700059,,,,15,9,24
HND-016736,2011,180700060,,,,18,17,35
HND-016737,2011,180700061,,,,20,12,32
HND-016739,2011,180700063,,,,54,37,91
HND-016740,2011,180700064,,,,6,7,13
HND-016742,2011,180700066,,,,12,11,23
HND-016743,2011,180700067,,,,1,6,7
HND-016744,2011,180700068,,,,10,10,20
HND-016751,2011,180700075,,,,12,13,25
HND-016752,2011,180700076,,,,14,16,30
,2011,180700079,,,,33,19,52
HND-016756,2011,180700080,,,,5,5,10
HND-016757,2011,180700081,,,,11,10,21
,2011,180700083,,,,5,5,10
HND-016760,2011,180700084,,,,5,8,13
HND-016763,2011,180700088,,,,5,2,7
HND-016767,2011,180700092,,,,7,6,13
,2011,180700095,,,,12,16,28
HND-016768,2011,180700097,,,,5,3,8
,2011,180700099,,,,22,8,30
HND-016771,2011,180700101,,,,10,12,22
HND-016772,2011,180700102,,,,6,3,9
,2011,180700105,,,,13,5,18
HND-016775,2011,180700106,,,,5,2,7
HND-016779,2011,180700110,,,,5,3,8
HND-016781,2011,180700112,,,,4,4,8
,2011,180700129,,,,18,21,39
HND-016805,2011,180700145,,,,6,4,10
HND-016809,2011,180700154,,,,9,11,20
HND-016812,2011,180700160,,,,10,12,22
HND-016815,2011,180700170,,,,28,17,45
HND-016818,2011,180700178,,,,6,5,11
,2011,180700185,,,,1,2,3
HND-016825,2011,180700189,,,,4,4,8
HND-016826,2011,180700190,,,,1,2,3
HND-016828,2011,180700193,,,,5,7,12
,2011,180700196,,,,4,4,8
HND-016832,2011,180700198,,,,2,1,3
HND-016833,2011,180700199,,,,4,3,7
,2011,180700204,,,,5,8,13
,2011,180700207,,,,4,3,7
HND-016839,2011,180700208,,,,3,2,5
,2011,180700297,,,,8,12,20
HND-016850,2011,180700308,,,,12,12,24
HND-016852,2011,180700310,,,,11,14,25
HND-016854,2011,180700316,,,,6,10,16
HND-016860,2011,180700333,,,,3,4,7
,2011,180700362,,,,6,5,11
HND-016874,2011,180700378,,,,6,4,10
HND-016875,2011,180700379,,,,4,1,5
HND-016688,2011,180700004,,,,73,6,79
,2011,180700005,,,,6,8,14
HND-016692,2011,180700008,,,,1,6,7
HND-016694,2011,180700010,,,,8,13,21
HND-016696,2011,180700012,,,,13,12,25
HND-016704,2011,180700023,,,,1,1,2
HND-016707,2011,180700026,,,,1,1,2
HND-016709,2011,180700029,,,,24,19,43
HND-016713,2011,180700033,,,,8,5,13
HND-016715,2011,180700036,,,,16,10,26
HND-016716,2011,180700037,,,,10,12,22
HND-016718,2011,180700039,,,,3,1,4
HND-016721,2011,180700042,,,,39,19,58
HND-016723,2011,180700046,,,,3,2,5
HND-016726,2011,180700049,,,,4,4,8
HND-016728,2011,180700051,,,,5,5,10
HND-016730,2011,180700053,,,,5,1,6
HND-016732,2011,180700056,,,,6,3,9
HND-016733,2011,180700057,,,,7,13,20
HND-016738,2011,180700062,,,,10,10,20
HND-016741,2011,180700065,,,,17,10,27
HND-016745,2011,180700069,,,,16,8,24
HND-016746,2011,180700070,,,,0,2,2
HND-016747,2011,180700071,,,,12,11,23
HND-016748,2011,180700072,,,,10,9,19
HND-016749,2011,180700073,,,,34,48,82
HND-016750,2011,180700074,,,,14,12,26
HND-016753,2011,180700077,,,,7,7,14
HND-016754,2011,180700078,,,,1,5,6
HND-016758,2011,180700082,,,,17,14,31
HND-016761,2011,180700085,,,,7,10,17
HND-016762,2011,180700086,,,,2,3,5
HND-016764,2011,180700089,,,,0,1,1
,2011,180700090,,,,2,3,5
HND-016766,2011,180700091,,,,2,2,4
HND-016769,2011,180700098,,,,3,1,4
HND-016770,2011,180700100,,,,25,24,49
HND-016773,2011,180700103,,,,44,53,97
HND-016774,2011,180700104,,,,58,66,124
HND-016776,2011,180700107,,,,7,4,11
HND-016777,2011,180700108,,,,21,41,62
HND-016778,2011,180700109,,,,3,1,4
HND-016780,2011,180700111,,,,7,6,13
HND-016793,2011,180700127,,,,2,2,4
,2011,180700128,,,,16,10,26
HND-016817,2011,180700177,,,,0,2,2
HND-016821,2011,180700182,,,,37,23,60
HND-016823,2011,180700184,,,,0,4,4
,2011,180700187,,,,1,0,1
HND-016824,2011,180700188,,,,4,6,10
HND-016827,2011,180700191,,,,40,35,75
HND-016829,2011,180700194,,,,5,4,9
HND-016830,2011,180700195,,,,1,2,3
HND-016831,2011,180700197,,,,2,2,4
HND-016834,2011,180700200,,,,3,2,5
HND-016835,2011,180700201,,,,2,2,4
HND-016836,2011,180700202,,,,1,7,8
HND-016840,2011,180700209,,,,1,1,2
,2011,180700298,,,,4,5,9
HND-016855,2011,180700324,,,,4,1,5
,2011,180700335,,,,7,4,11
HND-016872,2011,180700376,,,,6,5,11
HND-016873,2011,180700377,,,,2,1,3
HND-016876,2011,180700380,,,,5,6,11
HND-016877,2011,180700381,,,,6,2,8
HND-016879,2011,180700383,,,,1,6,7
HND-016880,2011,180700384,,,,1,1,2
HND-016686,2011,180700001,,,,23,20,43
,2011,180700005,,,,7,8,15
HND-016692,2011,180700008,,,,7,3,10
HND-016694,2011,180700010,,,,9,16,25
HND-016695,2011,180700011,,,,3,5,8
HND-016696,2011,180700012,,,,6,12,18
HND-016697,2011,180700013,,,,3,9,12
HND-016701,2011,180700017,,,,13,4,17
HND-016706,2011,180700025,,,,8,13,21
HND-016707,2011,180700026,,,,1,1,2
HND-016709,2011,180700029,,,,30,26,56
HND-016712,2011,180700032,,,,2,0,2
HND-016715,2011,180700036,,,,15,15,30
HND-016718,2011,180700039,,,,0,2,2
HND-016719,2011,180700040,,,,9,6,15
HND-016721,2011,180700042,,,,25,18,43
HND-016722,2011,180700044,,,,24,27,51
HND-016725,2011,180700048,,,,2,1,3
HND-016730,2011,180700053,,,,2,2,4
HND-016732,2011,180700056,,,,5,3,8
HND-016735,2011,180700059,,,,12,13,25
HND-016736,2011,180700060,,,,13,13,26
HND-016738,2011,180700062,,,,10,10,20
HND-016740,2011,180700064,,,,3,7,10
HND-016741,2011,180700065,,,,8,10,18
HND-016744,2011,180700068,,,,8,12,20
HND-016747,2011,180700071,,,,8,8,16
HND-016749,2011,180700073,,,,42,39,81
HND-016750,2011,180700074,,,,6,8,14
HND-016752,2011,180700076,,,,18,12,30
HND-016753,2011,180700077,,,,6,3,9
HND-016756,2011,180700080,,,,4,4,8
HND-016758,2011,180700082,,,,11,14,25
HND-016760,2011,180700084,,,,12,10,22
HND-016761,2011,180700085,,,,7,3,10
HND-016763,2011,180700088,,,,5,3,8
,2011,180700090,,,,3,4,7
HND-016766,2011,180700091,,,,6,1,7
HND-016769,2011,180700098,,,,3,0,3
,2011,180700099,,,,8,16,24
HND-016770,2011,180700100,,,,10,22,32
HND-016772,2011,180700102,,,,6,2,8
HND-016775,2011,180700106,,,,9,5,14
HND-016776,2011,180700107,,,,1,2,3
HND-016777,2011,180700108,,,,30,31,61
HND-016779,2011,180700110,,,,4,6,10
HND-016793,2011,180700127,,,,2,1,3
,2011,180700128,,,,15,15,30
HND-016809,2011,180700154,,,,14,8,22
HND-016815,2011,180700170,,,,26,24,50
HND-016818,2011,180700178,,,,5,8,13
HND-016821,2011,180700182,,,,31,28,59
HND-016823,2011,180700184,,,,0,3,3
HND-016828,2011,180700193,,,,1,1,2
HND-016830,2011,180700195,,,,5,3,8
,2011,180700196,,,,6,2,8
HND-016831,2011,180700197,,,,3,5,8
HND-016832,2011,180700198,,,,1,2,3
HND-016835,2011,180700201,,,,2,6,8
,2011,180700207,,,,11,8,19
HND-016840,2011,180700209,,,,1,2,3
,2011,180700298,,,,3,1,4
HND-016852,2011,180700310,,,,13,15,28
HND-016854,2011,180700316,,,,1,3,4
HND-016860,2011,180700333,,,,4,4,8
,2011,180700335,,,,3,9,12
HND-016872,2011,180700376,,,,6,2,8
HND-016873,2011,180700377,,,,4,0,4
HND-016875,2011,180700379,,,,4,5,9
HND-016877,2011,180700381,,,,10,4,14
HND-016687,2011,180700003,,,,6,5,11
HND-016688,2011,180700004,,,,63,7,70
HND-016690,2011,180700006,,,,26,23,49
HND-016691,2011,180700007,,,,4,1,5
HND-016698,2011,180700014,,,,41,44,85
HND-016699,2011,180700015,,,,38,34,72
HND-016700,2011,180700016,,,,9,18,27
HND-016702,2011,180700018,,,,0,90,90
HND-016703,2011,180700022,,,,4,4,8
HND-016704,2011,180700023,,,,3,3,6
HND-016705,2011,180700024,,,,25,19,44
,2011,180700028,,,,12,14,26
HND-016710,2011,180700030,,,,36,32,68
HND-016711,2011,180700031,,,,42,26,68
HND-016713,2011,180700033,,,,3,5,8
HND-016716,2011,180700037,,,,18,5,23
HND-016717,2011,180700038,,,,18,12,30
HND-016720,2011,180700041,,,,4,1,5
HND-016723,2011,180700046,,,,8,2,10
HND-016724,2011,180700047,,,,13,14,27
HND-016726,2011,180700049,,,,1,1,2
HND-016727,2011,180700050,,,,14,21,35
HND-016728,2011,180700051,,,,2,2,4
HND-016729,2011,180700052,,,,2,2,4
HND-016733,2011,180700057,,,,11,7,18
HND-016734,2011,180700058,,,,3,2,5
HND-016737,2011,180700061,,,,19,7,26
HND-016739,2011,180700063,,,,43,36,79
HND-016742,2011,180700066,,,,13,11,24
HND-016743,2011,180700067,,,,8,6,14
HND-016745,2011,180700069,,,,10,5,15
HND-016748,2011,180700072,,,,3,12,15
HND-016751,2011,180700075,,,,24,24,48
HND-016754,2011,180700078,,,,1,1,2
,2011,180700079,,,,31,29,60
HND-016757,2011,180700081,,,,8,11,19
,2011,180700083,,,,2,3,5
HND-016762,2011,180700086,,,,2,10,12
HND-016764,2011,180700089,,,,1,1,2
HND-016767,2011,180700092,,,,3,5,8
,2011,180700095,,,,1,2,3
HND-016771,2011,180700101,,,,6,10,16
HND-016773,2011,180700103,,,,49,39,88
HND-016774,2011,180700104,,,,77,78,155
,2011,180700105,,,,2,4,6
HND-016778,2011,180700109,,,,3,8,11
HND-016780,2011,180700111,,,,6,9,15
HND-016781,2011,180700112,,,,9,6,15
,2011,180700129,,,,23,14,37
HND-016812,2011,180700160,,,,5,2,7
HND-016817,2011,180700177,,,,3,4,7
,2011,180700185,,,,2,2,4
,2011,180700187,,,,0,2,2
HND-016824,2011,180700188,,,,3,5,8
HND-016825,2011,180700189,,,,0,3,3
HND-016827,2011,180700191,,,,20,25,45
HND-016829,2011,180700194,,,,7,4,11
HND-016833,2011,180700199,,,,5,3,8
HND-016834,2011,180700200,,,,4,1,5
HND-016836,2011,180700202,,,,3,1,4
,2011,180700204,,,,7,4,11
HND-016839,2011,180700208,,,,1,1,2
,2011,180700297,,,,8,10,18
HND-016850,2011,180700308,,,,18,11,29
,2011,180700362,,,,5,4,9
HND-016874,2011,180700378,,,,4,6,10
HND-016876,2011,180700380,,,,11,2,13
HND-016879,2011,180700383,,,,7,3,10
HND-016880,2011,180700384,,,,5,9,14
HND-016688,2011,180700004,,,,67,5,72
,2011,180700005,,,,6,5,11
HND-016692,2011,180700008,,,,6,7,13
HND-016694,2011,180700010,,,,9,11,20
HND-016695,2011,180700011,,,,4,4,8
HND-016696,2011,180700012,,,,15,9,24
HND-016701,2011,180700017,,,,5,5,10
HND-016704,2011,180700023,,,,0,3,3
HND-016706,2011,180700025,,,,6,8,14
HND-016707,2011,180700026,,,,0,3,3
HND-016709,2011,180700029,,,,33,30,63
HND-016713,2011,180700033,,,,5,6,11
HND-016715,2011,180700036,,,,12,17,29
HND-016718,2011,180700039,,,,3,4,7
HND-016721,2011,180700042,,,,12,18,30
HND-016725,2011,180700048,,,,2,3,5
HND-016726,2011,180700049,,,,1,1,2
HND-016730,2011,180700053,,,,2,3,5
HND-016732,2011,180700056,,,,1,4,5
HND-016733,2011,180700057,,,,7,6,13
HND-016735,2011,180700059,,,,12,9,21
HND-016736,2011,180700060,,,,25,23,48
HND-016738,2011,180700062,,,,8,9,17
HND-016740,2011,180700064,,,,7,2,9
HND-016741,2011,180700065,,,,11,11,22
HND-016744,2011,180700068,,,,17,8,25
HND-016745,2011,180700069,,,,15,16,31
HND-016747,2011,180700071,,,,9,10,19
HND-016749,2011,180700073,,,,44,47,91
HND-016750,2011,180700074,,,,9,5,14
HND-016752,2011,180700076,,,,25,15,40
HND-016753,2011,180700077,,,,5,8,13
HND-016754,2011,180700078,,,,0,1,1
HND-016756,2011,180700080,,,,4,3,7
HND-016758,2011,180700082,,,,17,20,37
HND-016761,2011,180700085,,,,4,9,13
HND-016763,2011,180700088,,,,3,2,5
HND-016764,2011,180700089,,,,2,1,3
,2011,180700090,,,,2,4,6
HND-016766,2011,180700091,,,,4,4,8
HND-016769,2011,180700098,,,,1,3,4
HND-016770,2011,180700100,,,,11,19,30
HND-016775,2011,180700106,,,,4,3,7
HND-016776,2011,180700107,,,,3,6,9
HND-016777,2011,180700108,,,,17,20,37
HND-016779,2011,180700110,,,,6,4,10
HND-016793,2011,180700127,,,,1,2,3
,2011,180700128,,,,12,17,29
HND-016809,2011,180700154,,,,9,3,12
HND-016817,2011,180700177,,,,6,2,8
HND-016818,2011,180700178,,,,5,5,10
HND-016821,2011,180700182,,,,33,36,69
HND-016823,2011,180700184,,,,3,2,5
,2011,180700187,,,,1,1,2
HND-016824,2011,180700188,,,,4,4,8
HND-016826,2011,180700190,,,,5,5,10
HND-016828,2011,180700193,,,,3,1,4
HND-016830,2011,180700195,,,,2,0,2
HND-016831,2011,180700197,,,,4,1,5
HND-016832,2011,180700198,,,,1,3,4
HND-016834,2011,180700200,,,,1,0,1
HND-016835,2011,180700201,,,,2,1,3
,2011,180700207,,,,6,3,9
HND-016840,2011,180700209,,,,3,2,5
,2011,180700298,,,,3,2,5
HND-016855,2011,180700324,,,,3,0,3
HND-016860,2011,180700333,,,,4,5,9
,2011,180700335,,,,6,7,13
HND-016872,2011,180700376,,,,1,2,3
HND-016873,2011,180700377,,,,1,2,3
HND-016875,2011,180700379,,,,3,3,6
HND-016876,2011,180700380,,,,13,7,20
HND-016877,2011,180700381,,,,2,3,5
HND-016880,2011,180700384,,,,3,4,7
HND-016686,2011,180700001,,,,14,11,25
HND-016687,2011,180700003,,,,12,9,21
HND-016690,2011,180700006,,,,23,22,45
HND-016691,2011,180700007,,,,1,1,2
HND-016697,2011,180700013,,,,9,9,18
HND-016698,2011,180700014,,,,46,31,77
HND-016699,2011,180700015,,,,43,41,84
HND-016700,2011,180700016,,,,9,16,25
HND-016702,2011,180700018,,,,0,74,74
HND-016703,2011,180700022,,,,2,0,2
HND-016705,2011,180700024,,,,33,21,54
,2011,180700028,,,,11,9,20
HND-016710,2011,180700030,,,,18,18,36
HND-016711,2011,180700031,,,,25,32,57
HND-016712,2011,180700032,,,,9,4,13
HND-016716,2011,180700037,,,,8,10,18
HND-016717,2011,180700038,,,,13,13,26
HND-016719,2011,180700040,,,,6,6,12
HND-016722,2011,180700044,,,,21,19,40
HND-016723,2011,180700046,,,,10,4,14
HND-016724,2011,180700047,,,,14,15,29
HND-016727,2011,180700050,,,,16,21,37
HND-016728,2011,180700051,,,,0,2,2
HND-016729,2011,180700052,,,,0,4,4
HND-016734,2011,180700058,,,,2,2,4
HND-016737,2011,180700061,,,,10,11,21
HND-016739,2011,180700063,,,,43,40,83
HND-016742,2011,180700066,,,,9,22,31
HND-016743,2011,180700067,,,,7,5,12
HND-016748,2011,180700072,,,,4,2,6
HND-016751,2011,180700075,,,,17,18,35
,2011,180700079,,,,24,19,43
HND-016757,2011,180700081,,,,6,8,14
,2011,180700083,,,,3,2,5
HND-016760,2011,180700084,,,,7,8,15
HND-016767,2011,180700092,,,,1,4,5
,2011,180700095,,,,12,9,21
,2011,180700099,,,,20,21,41
HND-016771,2011,180700101,,,,7,13,20
HND-016772,2011,180700102,,,,1,3,4
HND-016773,2011,180700103,,,,42,40,82
HND-016774,2011,180700104,,,,79,83,162
,2011,180700105,,,,12,9,21
HND-016778,2011,180700109,,,,3,3,6
HND-016780,2011,180700111,,,,9,5,14
HND-016781,2011,180700112,,,,3,9,12
,2011,180700129,,,,14,24,38
HND-016812,2011,180700160,,,,4,4,8
HND-016815,2011,180700170,,,,23,21,44
,2011,180700185,,,,0,6,6
HND-016825,2011,180700189,,,,2,3,5
HND-016827,2011,180700191,,,,20,25,45
HND-016829,2011,180700194,,,,8,3,11
,2011,180700196,,,,3,6,9
HND-016833,2011,180700199,,,,0,2,2
HND-016836,2011,180700202,,,,0,5,5
,2011,180700204,,,,5,9,14
HND-016839,2011,180700208,,,,2,1,3
,2011,180700297,,,,10,16,26
HND-016850,2011,180700308,,,,11,10,21
HND-016852,2011,180700310,,,,12,7,19
HND-016854,2011,180700316,,,,3,3,6
,2011,180700362,,,,6,1,7
HND-016874,2011,180700378,,,,4,2,6
HND-016879,2011,180700383,,,,4,4,8
HND-016688,2011,180700004,,,,68,7,75
,2011,180700005,,,,3,1,4
HND-016690,2011,180700006,,,,25,28,53
HND-016696,2011,180700012,,,,4,1,5
HND-016698,2011,180700014,,,,66,25,91
HND-016702,2011,180700018,,,,0,102,102
HND-016704,2011,180700023,,,,5,2,7
HND-016705,2011,180700024,,,,21,22,43
HND-016707,2011,180700026,,,,3,1,4
HND-016711,2011,180700031,,,,18,6,24
HND-016713,2011,180700033,,,,5,1,6
HND-016715,2011,180700036,,,,8,12,20
HND-016716,2011,180700037,,,,11,11,22
HND-016723,2011,180700046,,,,5,5,10
HND-016724,2011,180700047,,,,8,14,22
HND-016726,2011,180700049,,,,4,2,6
HND-016727,2011,180700050,,,,23,29,52
HND-016730,2011,180700053,,,,6,5,11
HND-016733,2011,180700057,,,,12,5,17
HND-016734,2011,180700058,,,,0,2,2
HND-016739,2011,180700063,,,,41,34,75
HND-016741,2011,180700065,,,,7,12,19
HND-016742,2011,180700066,,,,20,17,37
HND-016745,2011,180700069,,,,12,9,21
HND-016748,2011,180700072,,,,4,0,4
HND-016750,2011,180700074,,,,3,3,6
HND-016751,2011,180700075,,,,14,15,29
HND-016754,2011,180700078,,,,2,3,5
,2011,180700083,,,,2,1,3
HND-016762,2011,180700086,,,,0,1,1
HND-016764,2011,180700089,,,,0,1,1
,2011,180700090,,,,2,0,2
HND-016771,2011,180700101,,,,9,8,17
HND-016773,2011,180700103,,,,38,34,72
HND-016774,2011,180700104,,,,63,70,133
,2011,180700105,,,,10,12,22
HND-016778,2011,180700109,,,,1,5,6
HND-016780,2011,180700111,,,,2,6,8
HND-016817,2011,180700177,,,,2,5,7
HND-016823,2011,180700184,,,,0,3,3
,2011,180700187,,,,0,1,1
HND-016824,2011,180700188,,,,3,4,7
HND-016827,2011,180700191,,,,15,19,34
HND-016829,2011,180700194,,,,1,3,4
HND-016830,2011,180700195,,,,0,1,1
HND-016833,2011,180700199,,,,2,3,5
HND-016834,2011,180700200,,,,4,1,5
HND-016835,2011,180700201,,,,1,1,2
HND-016836,2011,180700202,,,,1,1,2
,2011,180700204,,,,9,5,14
HND-016839,2011,180700208,,,,2,2,4
HND-016850,2011,180700308,,,,5,13,18
,2011,180700335,,,,4,5,9
,2011,180700362,,,,5,1,6
HND-016873,2011,180700377,,,,0,1,1
HND-016874,2011,180700378,,,,7,2,9
HND-016877,2011,180700381,,,,3,2,5
HND-016879,2011,180700383,,,,3,1,4
HND-016686,2011,180700001,,,,12,8,20
HND-016687,2011,180700003,,,,8,5,13
HND-016691,2011,180700007,,,,3,2,5
HND-016692,2011,180700008,,,,4,3,7
HND-016694,2011,180700010,,,,9,13,22
HND-016695,2011,180700011,,,,7,6,13
HND-016697,2011,180700013,,,,12,4,16
HND-016699,2011,180700015,,,,39,49,88
HND-016700,2011,180700016,,,,10,10,20
HND-016701,2011,180700017,,,,2,3,5
HND-016703,2011,180700022,,,,2,2,4
HND-016706,2011,180700025,,,,5,6,11
,2011,180700028,,,,17,25,42
HND-016709,2011,180700029,,,,28,35,63
HND-016710,2011,180700030,,,,25,15,40
HND-016712,2011,180700032,,,,2,2,4
HND-016717,2011,180700038,,,,19,10,29
HND-016718,2011,180700039,,,,5,5,10
HND-016719,2011,180700040,,,,3,7,10
HND-016721,2011,180700042,,,,27,26,53
HND-016722,2011,180700044,,,,19,26,45
HND-016729,2011,180700052,,,,2,3,5
HND-016732,2011,180700056,,,,3,8,11
HND-016735,2011,180700059,,,,8,8,16
HND-016736,2011,180700060,,,,20,20,40
HND-016737,2011,180700061,,,,10,3,13
HND-016738,2011,180700062,,,,7,4,11
HND-016740,2011,180700064,,,,2,4,6
HND-016743,2011,180700067,,,,3,5,8
HND-016744,2011,180700068,,,,8,8,16
HND-016747,2011,180700071,,,,11,10,21
HND-016749,2011,180700073,,,,37,28,65
HND-016752,2011,180700076,,,,15,18,33
HND-016753,2011,180700077,,,,7,5,12
,2011,180700079,,,,16,26,42
HND-016756,2011,180700080,,,,2,2,4
HND-016757,2011,180700081,,,,15,6,21
HND-016758,2011,180700082,,,,9,8,17
HND-016760,2011,180700084,,,,6,12,18
HND-016761,2011,180700085,,,,2,5,7
HND-016763,2011,180700088,,,,3,1,4
HND-016766,2011,180700091,,,,2,5,7
HND-016767,2011,180700092,,,,9,1,10
,2011,180700095,,,,10,8,18
,2011,180700099,,,,20,10,30
HND-016770,2011,180700100,,,,18,34,52
HND-016772,2011,180700102,,,,4,5,9
HND-016775,2011,180700106,,,,5,2,7
HND-016776,2011,180700107,,,,1,1,2
HND-016777,2011,180700108,,,,22,17,39
HND-016779,2011,180700110,,,,2,4,6
HND-016781,2011,180700112,,,,6,9,15
,2011,180700128,,,,8,12,20
,2011,180700129,,,,26,19,45
HND-016809,2011,180700154,,,,4,2,6
HND-016812,2011,180700160,,,,7,0,7
HND-016815,2011,180700170,,,,19,21,40
HND-016818,2011,180700178,,,,1,3,4
HND-016821,2011,180700182,,,,21,30,51
HND-016825,2011,180700189,,,,2,1,3
HND-016826,2011,180700190,,,,0,1,1
HND-016828,2011,180700193,,,,2,0,2
,2011,180700196,,,,0,3,3
HND-016831,2011,180700197,,,,3,5,8
,2011,180700207,,,,4,5,9
,2011,180700297,,,,19,13,32
HND-016852,2011,180700310,,,,7,5,12
HND-016854,2011,180700316,,,,3,6,9
HND-016860,2011,180700333,,,,3,1,4
HND-016872,2011,180700376,,,,3,0,3
HND-016875,2011,180700379,,,,5,3,8
HND-016876,2011,180700380,,,,4,1,5
HND-016694,2011,180700010,,,,18,18,36
HND-016749,2011,180700073,,,,16,16,32
HND-016753,2011,180700077,,,,15,15,30
,2011,180700099,,,,8,11,19
,2011,180700129,,,,23,18,41
HND-016795,2011,180700131,,,,200,146,346
,2011,180700132,,,,50,54,104
,2011,180700133,,,,37,38,75
HND-016800,2011,180700137,,,,115,81,196
HND-016801,2011,180700138,,,,26,30,56
HND-016802,2011,180700141,,,,87,124,211
,2011,180700158,,,,18,14,32
HND-016821,2011,180700182,,,,10,23,33
HND-016822,2011,180700183,,,,42,44,86
,2011,180700297,,,,22,12,34
HND-016686,2011,180700001,,,,24,17,41
,2011,180700002,,,,53,38,91
HND-016693,2011,180700009,,,,48,37,85
HND-016737,2011,180700061,,,,7,10,17
HND-016742,2011,180700066,,,,17,23,40
HND-016751,2011,180700075,,,,18,27,45
HND-016752,2011,180700076,,,,31,16,47
,2011,180700105,,,,12,13,25
HND-016798,2011,180700135,,,,66,34,100
,2011,180700136,,,,165,168,333
,2011,180700204,,,,1,6,7
,2011,180700365,,,,4,4,8
HND-016686,2011,180700001,,,,5,19,24
,2011,180700002,,,,49,65,114
HND-016693,2011,180700009,,,,29,28,57
HND-016694,2011,180700010,,,,4,10,14
HND-016737,2011,180700061,,,,4,7,11
HND-016749,2011,180700073,,,,16,25,41
HND-016752,2011,180700076,,,,7,21,28
HND-016753,2011,180700077,,,,20,18,38
,2011,180700133,,,,19,22,41
HND-016798,2011,180700135,,,,22,30,52
,2011,180700136,,,,143,147,290
HND-016800,2011,180700137,,,,123,57,180
HND-016801,2011,180700138,,,,26,26,52
,2011,180700158,,,,19,23,42
HND-016821,2011,180700182,,,,8,16,24
HND-016742,2011,180700066,,,,13,20,33
HND-016751,2011,180700075,,,,16,22,38
,2011,180700099,,,,9,21,30
,2011,180700105,,,,7,17,24
,2011,180700129,,,,9,22,31
HND-016795,2011,180700131,,,,141,106,247
,2011,180700132,,,,30,33,63
HND-016802,2011,180700141,,,,77,112,189
HND-016822,2011,180700183,,,,25,27,52
,2011,180700204,,,,0,2,2
,2011,180700297,,,,4,8,12
,2011,180700365,,,,13,19,32
HND-016686,2011,180700001,,,,6,13,19
HND-016694,2011,180700010,,,,3,12,15
HND-016737,2011,180700061,,,,10,6,16
HND-016749,2011,180700073,,,,7,14,21
HND-016752,2011,180700076,,,,8,10,18
HND-016753,2011,180700077,,,,14,17,31
,2011,180700129,,,,18,22,40
HND-016798,2011,180700135,,,,19,21,40
,2011,180700136,,,,133,156,289
HND-016821,2011,180700182,,,,14,10,24
,2011,180700365,,,,9,22,31
,2011,180700002,,,,48,84,132
HND-016693,2011,180700009,,,,34,31,65
HND-016742,2011,180700066,,,,20,17,37
HND-016751,2011,180700075,,,,13,17,30
,2011,180700099,,,,19,22,41
,2011,180700105,,,,14,15,29
HND-016795,2011,180700131,,,,124,134,258
,2011,180700132,,,,26,27,53
,2011,180700133,,,,25,14,39
HND-016800,2011,180700137,,,,131,38,169
HND-016801,2011,180700138,,,,23,30,53
HND-016802,2011,180700141,,,,79,93,172
,2011,180700158,,,,10,16,26
HND-016822,2011,180700183,,,,14,24,38
,2011,180700002,,,,82,128,210
HND-016693,2011,180700009,,,,7,13,20
,2011,180700099,,,,8,23,31
,2011,180700105,,,,12,19,31
,2011,180700129,,,,4,12,16
,2011,180700133,,,,15,13,28
HND-016798,2011,180700135,,,,23,34,57
,2011,180700136,,,,166,220,386
HND-016800,2011,180700137,,,,79,64,143
HND-016801,2011,180700138,,,,12,15,27
HND-016802,2011,180700141,,,,49,87,136
,2011,180700158,,,,12,16,28
HND-016795,2011,180700131,,,,134,142,276
,2011,180700132,,,,15,29,44
HND-016822,2011,180700183,,,,13,27,40
,2011,180700365,,,,87,92,179
,2011,180700099,,,,13,21,34
HND-016795,2011,180700131,,,,69,76,145
,2011,180700133,,,,16,9,25
HND-016798,2011,180700135,,,,14,16,30
HND-016800,2011,180700137,,,,74,64,138
HND-016801,2011,180700138,,,,18,14,32
HND-016802,2011,180700141,,,,42,63,105
,2011,180700158,,,,8,10,18
,2011,180700002,,,,52,116,168
HND-016693,2011,180700009,,,,1,7,8
,2011,180700105,,,,10,11,21
,2011,180700129,,,,3,11,14
,2011,180700132,,,,7,18,25
,2011,180700136,,,,111,172,283
HND-016822,2011,180700183,,,,8,25,33
,2011,180700365,,,,10,27,37
,2011,180700132,,,,5,18,23
HND-016822,2011,180700183,,,,4,17,21
,2011,180700365,,,,2,7,9
,2011,180700002,,,,37,78,115
HND-016693,2011,180700009,,,,5,5,10
,2011,180700129,,,,4,2,6
HND-016795,2011,180700131,,,,32,43,75
,2011,180700133,,,,11,8,19
HND-016798,2011,180700135,,,,10,8,18
,2011,180700136,,,,60,103,163
HND-016800,2011,180700137,,,,52,60,112
HND-016801,2011,180700138,,,,12,7,19
HND-016802,2011,180700141,,,,19,71,90
,2011,180700158,,,,5,14,19
,2011,180700129,,,,4,6,10
HND-016894,2011,180800009,,,,5,2,7
HND-016897,2011,180800012,,,,4,3,7
HND-016900,2011,180800015,,,,6,4,10
,2011,180800029,,,,1,6,7
,2011,180800039,,,,4,5,9
HND-016917,2011,180800040,,,,5,8,13
,2011,180800055,,,,6,4,10
HND-016920,2011,180800058,,,,5,10,15
HND-016921,2011,180800059,,,,10,5,15
,2011,180800060,,,,8,4,12
,2011,180800061,,,,6,1,7
,2011,180800063,,,,5,10,15
,2011,180800066,,,,6,3,9
,2011,180800069,,,,9,2,11
,2011,180800073,,,,4,4,8
HND-016890,2011,180800005,,,,8,6,14
HND-016901,2011,180800016,,,,5,2,7
,2011,180800035,,,,3,6,9
,2011,180800048,,,,5,5,10
,2011,180800056,,,,3,5,8
,2011,180800057,,,,2,4,6
,2011,180800062,,,,2,5,7
HND-016924,2011,180800067,,,,5,5,10
HND-016925,2011,180800068,,,,6,3,9
,2011,180800070,,,,2,5,7
HND-016926,2011,180800071,,,,6,14,20
HND-016919,2011,180800053,,,,2,5,7
HND-016914,2011,180800032,,,,8,4,12
,2011,180800054,,,,2,1,3
HND-016898,2011,180800013,,,,2,3,5
HND-016906,2011,180800021,,,,11,12,23
HND-016907,2011,180800022,,,,0,1,1
HND-016914,2011,180800032,,,,12,4,16
HND-016918,2011,180800050,,,,3,3,6
HND-016919,2011,180800053,,,,5,8,13
,2011,180800054,,,,11,8,19
,2011,180800065,,,,8,5,13
HND-016888,2011,180800003,,,,0,4,4
HND-016893,2011,180800008,,,,1,2,3
HND-016896,2011,180800011,,,,1,1,2
HND-016888,2011,180800003,,,,0,46,46
HND-016893,2011,180800008,,,,8,9,17
HND-016896,2011,180800011,,,,5,11,16
HND-016899,2011,180800014,,,,9,7,16
HND-016887,2011,180800002,,,,48,0,48
HND-016895,2011,180800010,,,,3,8,11
HND-016898,2011,180800013,,,,25,20,45
HND-016902,2011,180800017,,,,12,6,18
HND-016906,2011,180800021,,,,21,17,38
HND-016907,2011,180800022,,,,8,9,17
HND-016913,2011,180800031,,,,9,10,19
HND-016914,2011,180800032,,,,6,9,15
,2011,180800041,,,,3,4,7
HND-016918,2011,180800050,,,,9,6,15
HND-016919,2011,180800053,,,,8,8,16
,2011,180800054,,,,2,6,8
,2011,180800065,,,,12,12,24
HND-016887,2011,180800002,,,,75,0,75
HND-016889,2011,180800004,,,,18,18,36
HND-016890,2011,180800005,,,,5,8,13
HND-016891,2011,180800006,,,,3,3,6
HND-016894,2011,180800009,,,,9,13,22
HND-016895,2011,180800010,,,,4,8,12
HND-016896,2011,180800011,,,,24,18,42
HND-016897,2011,180800012,,,,7,2,9
HND-016898,2011,180800013,,,,35,36,71
HND-016899,2011,180800014,,,,5,6,11
HND-016900,2011,180800015,,,,5,5,10
HND-016905,2011,180800020,,,,4,4,8
HND-016909,2011,180800025,,,,5,4,9
HND-016910,2011,180800027,,,,1,0,1
HND-016911,2011,180800028,,,,4,4,8
HND-016913,2011,180800031,,,,12,16,28
,2011,180800041,,,,10,3,13
,2011,180800054,,,,5,6,11
,2011,180800060,,,,3,3,6
HND-016886,2011,180800001,,,,7,12,19
HND-016888,2011,180800003,,,,0,108,108
HND-016892,2011,180800007,,,,6,3,9
HND-016893,2011,180800008,,,,6,4,10
HND-016901,2011,180800016,,,,7,4,11
HND-016902,2011,180800017,,,,17,16,33
HND-016903,2011,180800018,,,,34,19,53
HND-016904,2011,180800019,,,,5,5,10
HND-016912,2011,180800030,,,,1,0,1
HND-016915,2011,180800037,,,,2,5,7
HND-016916,2011,180800038,,,,3,1,4
,2011,180800049,,,,2,1,3
HND-016918,2011,180800050,,,,11,9,20
HND-016923,2011,180800064,,,,2,1,3
HND-016927,2011,180800072,,,,2,6,8
HND-016888,2011,180800003,,,,0,75,75
HND-016889,2011,180800004,,,,15,13,28
HND-016890,2011,180800005,,,,11,7,18
HND-016893,2011,180800008,,,,4,6,10
HND-016894,2011,180800009,,,,4,5,9
HND-016896,2011,180800011,,,,11,21,32
HND-016899,2011,180800014,,,,5,7,12
HND-016901,2011,180800016,,,,2,2,4
HND-016902,2011,180800017,,,,20,20,40
HND-016905,2011,180800020,,,,1,3,4
HND-016912,2011,180800030,,,,1,0,1
HND-016913,2011,180800031,,,,8,9,17
HND-016916,2011,180800038,,,,4,0,4
,2011,180800049,,,,3,1,4
HND-016923,2011,180800064,,,,3,3,6
HND-016927,2011,180800072,,,,5,1,6
HND-016886,2011,180800001,,,,4,3,7
HND-016887,2011,180800002,,,,72,0,72
HND-016891,2011,180800006,,,,3,6,9
HND-016892,2011,180800007,,,,3,6,9
HND-016895,2011,180800010,,,,6,5,11
HND-016897,2011,180800012,,,,3,3,6
HND-016898,2011,180800013,,,,34,24,58
HND-016900,2011,180800015,,,,10,8,18
HND-016903,2011,180800018,,,,26,24,50
HND-016904,2011,180800019,,,,5,2,7
HND-016909,2011,180800025,,,,5,3,8
HND-016911,2011,180800028,,,,2,3,5
HND-016915,2011,180800037,,,,4,6,10
,2011,180800041,,,,8,12,20
HND-016918,2011,180800050,,,,6,5,11
,2011,180800054,,,,5,4,9
,2011,180800060,,,,5,4,9
HND-016886,2011,180800001,,,,6,9,15
HND-016888,2011,180800003,,,,0,77,77
HND-016890,2011,180800005,,,,11,5,16
HND-016893,2011,180800008,,,,7,4,11
HND-016901,2011,180800016,,,,2,0,2
HND-016902,2011,180800017,,,,21,21,42
HND-016903,2011,180800018,,,,25,24,49
HND-016904,2011,180800019,,,,0,1,1
HND-016912,2011,180800030,,,,4,2,6
HND-016915,2011,180800037,,,,2,3,5
HND-016916,2011,180800038,,,,2,6,8
,2011,180800049,,,,1,1,2
HND-016918,2011,180800050,,,,7,7,14
HND-016923,2011,180800064,,,,3,4,7
HND-016927,2011,180800072,,,,1,2,3
HND-016887,2011,180800002,,,,83,0,83
HND-016889,2011,180800004,,,,18,15,33
HND-016891,2011,180800006,,,,2,1,3
HND-016892,2011,180800007,,,,4,3,7
HND-016894,2011,180800009,,,,7,7,14
HND-016895,2011,180800010,,,,7,5,12
HND-016896,2011,180800011,,,,17,16,33
HND-016897,2011,180800012,,,,5,6,11
HND-016898,2011,180800013,,,,27,40,67
HND-016899,2011,180800014,,,,4,5,9
HND-016900,2011,180800015,,,,4,6,10
HND-016905,2011,180800020,,,,0,7,7
HND-016909,2011,180800025,,,,6,7,13
HND-016910,2011,180800027,,,,0,3,3
HND-016911,2011,180800028,,,,3,2,5
HND-016913,2011,180800031,,,,11,5,16
,2011,180800041,,,,14,11,25
,2011,180800054,,,,4,4,8
,2011,180800060,,,,2,1,3
HND-016887,2011,180800002,,,,69,0,69
HND-016888,2011,180800003,,,,0,99,99
HND-016889,2011,180800004,,,,25,18,43
HND-016890,2011,180800005,,,,6,6,12
HND-016894,2011,180800009,,,,4,8,12
HND-016895,2011,180800010,,,,10,2,12
HND-016896,2011,180800011,,,,16,13,29
HND-016898,2011,180800013,,,,31,32,63
HND-016899,2011,180800014,,,,3,10,13
HND-016902,2011,180800017,,,,14,20,34
HND-016905,2011,180800020,,,,1,4,5
HND-016911,2011,180800028,,,,2,5,7
HND-016912,2011,180800030,,,,1,1,2
HND-016913,2011,180800031,,,,9,12,21
HND-016916,2011,180800038,,,,3,3,6
,2011,180800049,,,,2,4,6
HND-016923,2011,180800064,,,,3,8,11
HND-016927,2011,180800072,,,,0,4,4
HND-016886,2011,180800001,,,,5,6,11
HND-016891,2011,180800006,,,,2,1,3
HND-016892,2011,180800007,,,,5,2,7
HND-016893,2011,180800008,,,,3,4,7
HND-016897,2011,180800012,,,,2,8,10
HND-016900,2011,180800015,,,,6,8,14
HND-016903,2011,180800018,,,,27,19,46
HND-016909,2011,180800025,,,,6,9,15
HND-016910,2011,180800027,,,,2,2,4
HND-016915,2011,180800037,,,,1,3,4
,2011,180800041,,,,7,5,12
HND-016918,2011,180800050,,,,8,7,15
,2011,180800054,,,,1,3,4
,2011,180800060,,,,2,1,3
HND-016887,2011,180800002,,,,130,0,130
HND-016889,2011,180800004,,,,13,20,33
HND-016890,2011,180800005,,,,7,12,19
HND-016891,2011,180800006,,,,4,1,5
HND-016894,2011,180800009,,,,9,11,20
HND-016895,2011,180800010,,,,8,8,16
HND-016896,2011,180800011,,,,6,3,9
HND-016897,2011,180800012,,,,4,2,6
HND-016898,2011,180800013,,,,35,29,64
HND-016899,2011,180800014,,,,13,11,24
HND-016902,2011,180800017,,,,12,12,24
HND-016905,2011,180800020,,,,4,2,6
HND-016911,2011,180800028,,,,2,1,3
HND-016913,2011,180800031,,,,7,12,19
,2011,180800041,,,,8,6,14
,2011,180800049,,,,1,3,4
,2011,180800054,,,,3,2,5
,2011,180800060,,,,4,1,5
HND-016923,2011,180800064,,,,1,4,5
HND-016927,2011,180800072,,,,0,1,1
HND-016886,2011,180800001,,,,5,1,6
HND-016888,2011,180800003,,,,0,97,97
HND-016892,2011,180800007,,,,1,1,2
HND-016893,2011,180800008,,,,10,1,11
HND-016900,2011,180800015,,,,5,7,12
HND-016901,2011,180800016,,,,3,3,6
HND-016903,2011,180800018,,,,37,26,63
HND-016909,2011,180800025,,,,1,4,5
HND-016912,2011,180800030,,,,1,2,3
HND-016915,2011,180800037,,,,5,2,7
HND-016916,2011,180800038,,,,1,2,3
HND-016918,2011,180800050,,,,5,11,16
HND-016886,2011,180800001,,,,4,4,8
HND-016887,2011,180800002,,,,71,0,71
HND-016891,2011,180800006,,,,3,2,5
HND-016892,2011,180800007,,,,3,1,4
HND-016895,2011,180800010,,,,6,5,11
HND-016897,2011,180800012,,,,2,3,5
HND-016898,2011,180800013,,,,37,40,77
HND-016900,2011,180800015,,,,1,3,4
HND-016903,2011,180800018,,,,24,17,41
HND-016904,2011,180800019,,,,4,6,10
HND-016909,2011,180800025,,,,1,7,8
HND-016910,2011,180800027,,,,3,5,8
HND-016911,2011,180800028,,,,4,4,8
HND-016915,2011,180800037,,,,2,0,2
,2011,180800041,,,,6,5,11
HND-016918,2011,180800050,,,,5,1,6
,2011,180800060,,,,5,0,5
HND-016888,2011,180800003,,,,0,97,97
HND-016889,2011,180800004,,,,21,10,31
HND-016890,2011,180800005,,,,3,8,11
HND-016893,2011,180800008,,,,3,3,6
HND-016894,2011,180800009,,,,3,8,11
HND-016896,2011,180800011,,,,17,12,29
HND-016899,2011,180800014,,,,6,5,11
HND-016901,2011,180800016,,,,1,4,5
HND-016902,2011,180800017,,,,17,21,38
HND-016905,2011,180800020,,,,6,1,7
HND-016912,2011,180800030,,,,1,2,3
HND-016913,2011,180800031,,,,10,15,25
HND-016916,2011,180800038,,,,3,3,6
,2011,180800049,,,,1,1,2
HND-016923,2011,180800064,,,,1,2,3
HND-016927,2011,180800072,,,,1,2,3
HND-016896,2011,180800011,,,,12,17,29
HND-016899,2011,180800014,,,,17,13,30
HND-016893,2011,180800008,,,,5,11,16
,2011,180800023,,,,6,11,17
HND-016908,2011,180800024,,,,243,240,483
HND-016893,2011,180800008,,,,4,2,6
HND-016896,2011,180800011,,,,9,20,29
HND-016899,2011,180800014,,,,2,12,14
,2011,180800023,,,,7,12,19
HND-016908,2011,180800024,,,,166,176,342
HND-016893,2011,180800008,,,,2,7,9
HND-016896,2011,180800011,,,,17,19,36
HND-016899,2011,180800014,,,,1,3,4
HND-016908,2011,180800024,,,,112,164,276
,2011,180800023,,,,6,8,14
,2011,180800023,,,,13,19,32
HND-016908,2011,180800024,,,,122,190,312
,2011,180800023,,,,8,4,12
HND-016908,2011,180800024,,,,66,162,228
HND-016908,2011,180800024,,,,63,98,161
,2011,180800023,,,,3,4,7
HND-016970,2011,180900049,,,,5,6,11
HND-016980,2011,180900094,,,,6,7,13
,2011,180900098,,,,4,3,7
HND-016982,2011,180900100,,,,2,7,9
,2011,180900106,,,,7,3,10
HND-016985,2011,180900108,,,,5,9,14
HND-016986,2011,180900110,,,,6,9,15
,2011,180900114,,,,3,6,9
,2011,180900115,,,,2,7,9
HND-016988,2011,180900116,,,,5,6,11
HND-016990,2011,180900118,,,,5,1,6
HND-016991,2011,180900119,,,,4,7,11
,2011,180900121,,,,4,5,9
HND-016973,2011,180900052,,,,7,6,13
HND-016978,2011,180900059,,,,14,9,23
HND-016979,2011,180900062,,,,1,7,8
HND-016981,2011,180900096,,,,5,5,10
,2011,180900099,,,,8,3,11
,2011,180900101,,,,9,4,13
HND-016984,2011,180900105,,,,7,2,9
,2011,180900109,,,,7,7,14
,2011,180900120,,,,2,2,4
HND-016956,2011,180900030,,,,4,3,7
,2011,180900041,,,,0,3,3
HND-016960,2011,180900034,,,,13,14,27
,2011,180900035,,,,11,7,18
HND-016961,2011,180900036,,,,13,5,18
HND-016965,2011,180900042,,,,5,5,10
,2011,180900044,,,,4,7,11
HND-016967,2011,180900046,,,,19,12,31
HND-016969,2011,180900048,,,,4,7,11
HND-016972,2011,180900051,,,,8,2,10
HND-016974,2011,180900053,,,,2,2,4
,2011,180900057,,,,8,3,11
HND-016956,2011,180900030,,,,0,3,3
HND-016959,2011,180900033,,,,8,14,22
,2011,180900037,,,,11,8,19
,2011,180900041,,,,4,1,5
HND-016966,2011,180900043,,,,7,6,13
HND-016968,2011,180900047,,,,8,5,13
,2011,180900058,,,,6,6,12
,2011,180900112,,,,1,0,1
HND-016956,2011,180900030,,,,2,4,6
HND-016959,2011,180900033,,,,9,6,15
,2011,180900035,,,,11,15,26
,2011,180900041,,,,3,3,6
HND-016966,2011,180900043,,,,9,6,15
HND-016968,2011,180900047,,,,8,10,18
,2011,180900112,,,,3,1,4
HND-016960,2011,180900034,,,,17,15,32
HND-016961,2011,180900036,,,,12,6,18
,2011,180900037,,,,6,5,11
HND-016965,2011,180900042,,,,6,5,11
,2011,180900044,,,,12,7,19
HND-016967,2011,180900046,,,,19,11,30
HND-016969,2011,180900048,,,,11,9,20
HND-016972,2011,180900051,,,,10,10,20
HND-016974,2011,180900053,,,,10,9,19
,2011,180900057,,,,6,7,13
,2011,180900058,,,,5,7,12
HND-016928,2011,180900001,,,,35,40,75
HND-016929,2011,180900002,,,,12,4,16
HND-016931,2011,180900004,,,,15,16,31
HND-016932,2011,180900005,,,,8,7,15
HND-016935,2011,180900008,,,,7,1,8
HND-016939,2011,180900012,,,,20,8,28
HND-016942,2011,180900015,,,,8,6,14
HND-016946,2011,180900019,,,,6,1,7
HND-016950,2011,180900023,,,,11,8,19
HND-016953,2011,180900026,,,,6,1,7
HND-016954,2011,180900027,,,,2,3,5
HND-016955,2011,180900029,,,,4,1,5
HND-016958,2011,180900032,,,,2,3,5
HND-016963,2011,180900039,,,,3,8,11
,2011,180900057,,,,4,4,8
,2011,180900111,,,,4,3,7
HND-016987,2011,180900113,,,,3,5,8
HND-016989,2011,180900117,,,,2,0,2
HND-016930,2011,180900003,,,,0,5,5
HND-016933,2011,180900006,,,,12,7,19
HND-016934,2011,180900007,,,,10,2,12
HND-016936,2011,180900009,,,,1,1,2
HND-016937,2011,180900010,,,,2,0,2
HND-016938,2011,180900011,,,,11,5,16
HND-016940,2011,180900013,,,,8,3,11
HND-016941,2011,180900014,,,,10,10,20
HND-016943,2011,180900016,,,,4,2,6
HND-016944,2011,180900017,,,,4,3,7
HND-016945,2011,180900018,,,,14,7,21
HND-016947,2011,180900020,,,,3,8,11
HND-016948,2011,180900021,,,,8,7,15
HND-016949,2011,180900022,,,,12,19,31
HND-016951,2011,180900024,,,,2,4,6
HND-016952,2011,180900025,,,,9,3,12
HND-016956,2011,180900030,,,,4,4,8
HND-016957,2011,180900031,,,,1,5,6
HND-016962,2011,180900038,,,,11,10,21
HND-016970,2011,180900049,,,,6,3,9
HND-016971,2011,180900050,,,,2,5,7
HND-016973,2011,180900052,,,,16,5,21
,2011,180900054,,,,3,2,5
HND-016976,2011,180900056,,,,32,13,45
,2011,180900112,,,,2,0,2
HND-016930,2011,180900003,,,,3,1,4
HND-016931,2011,180900004,,,,24,21,45
HND-016933,2011,180900006,,,,6,5,11
HND-016934,2011,180900007,,,,11,9,20
HND-016937,2011,180900010,,,,1,1,2
HND-016938,2011,180900011,,,,8,2,10
HND-016939,2011,180900012,,,,15,14,29
HND-016941,2011,180900014,,,,12,5,17
HND-016942,2011,180900015,,,,2,6,8
HND-016945,2011,180900018,,,,9,13,22
HND-016947,2011,180900020,,,,7,4,11
HND-016949,2011,180900022,,,,12,11,23
HND-016952,2011,180900025,,,,6,2,8
HND-016955,2011,180900029,,,,5,7,12
HND-016956,2011,180900030,,,,3,2,5
HND-016957,2011,180900031,,,,2,0,2
HND-016958,2011,180900032,,,,5,2,7
HND-016962,2011,180900038,,,,4,4,8
HND-016973,2011,180900052,,,,7,8,15
,2011,180900111,,,,1,3,4
,2011,180900112,,,,1,3,4
HND-016928,2011,180900001,,,,37,34,71
HND-016929,2011,180900002,,,,15,5,20
HND-016932,2011,180900005,,,,4,5,9
HND-016935,2011,180900008,,,,4,4,8
HND-016936,2011,180900009,,,,2,1,3
HND-016940,2011,180900013,,,,6,1,7
HND-016943,2011,180900016,,,,7,2,9
HND-016944,2011,180900017,,,,7,2,9
HND-016946,2011,180900019,,,,3,3,6
HND-016948,2011,180900021,,,,11,2,13
HND-016950,2011,180900023,,,,8,7,15
HND-016951,2011,180900024,,,,5,0,5
HND-016953,2011,180900026,,,,5,3,8
HND-016954,2011,180900027,,,,3,2,5
HND-016963,2011,180900039,,,,7,6,13
HND-016970,2011,180900049,,,,9,4,13
HND-016971,2011,180900050,,,,1,1,2
,2011,180900054,,,,8,4,12
HND-016976,2011,180900056,,,,15,21,36
,2011,180900057,,,,4,9,13
HND-016987,2011,180900113,,,,6,2,8
HND-016989,2011,180900117,,,,5,2,7
HND-016930,2011,180900003,,,,2,2,4
HND-016933,2011,180900006,,,,6,5,11
HND-016934,2011,180900007,,,,9,6,15
HND-016936,2011,180900009,,,,1,0,1
HND-016937,2011,180900010,,,,3,2,5
HND-016938,2011,180900011,,,,7,5,12
HND-016940,2011,180900013,,,,5,4,9
HND-016941,2011,180900014,,,,7,7,14
HND-016944,2011,180900017,,,,2,3,5
HND-016945,2011,180900018,,,,4,12,16
HND-016947,2011,180900020,,,,4,6,10
HND-016948,2011,180900021,,,,6,5,11
HND-016949,2011,180900022,,,,9,7,16
HND-016952,2011,180900025,,,,8,6,14
HND-016956,2011,180900030,,,,10,4,14
HND-016957,2011,180900031,,,,1,1,2
HND-016962,2011,180900038,,,,3,5,8
HND-016970,2011,180900049,,,,3,4,7
HND-016971,2011,180900050,,,,5,0,5
HND-016973,2011,180900052,,,,12,12,24
,2011,180900054,,,,6,3,9
HND-016976,2011,180900056,,,,22,17,39
,2011,180900112,,,,2,0,2
HND-016928,2011,180900001,,,,28,31,59
HND-016929,2011,180900002,,,,10,13,23
HND-016931,2011,180900004,,,,24,15,39
HND-016932,2011,180900005,,,,7,4,11
HND-016935,2011,180900008,,,,10,3,13
HND-016939,2011,180900012,,,,9,8,17
HND-016942,2011,180900015,,,,8,2,10
HND-016943,2011,180900016,,,,5,11,16
HND-016946,2011,180900019,,,,5,0,5
HND-016950,2011,180900023,,,,6,6,12
HND-016953,2011,180900026,,,,3,3,6
HND-016954,2011,180900027,,,,0,2,2
HND-016955,2011,180900029,,,,10,3,13
HND-016958,2011,180900032,,,,2,2,4
HND-016963,2011,180900039,,,,8,3,11
,2011,180900057,,,,6,7,13
,2011,180900111,,,,4,2,6
HND-016987,2011,180900113,,,,7,4,11
HND-016989,2011,180900117,,,,2,2,4
HND-016929,2011,180900002,,,,13,11,24
HND-016930,2011,180900003,,,,5,2,7
HND-016931,2011,180900004,,,,20,16,36
HND-016934,2011,180900007,,,,2,9,11
HND-016935,2011,180900008,,,,4,20,24
HND-016939,2011,180900012,,,,4,9,13
HND-016941,2011,180900014,,,,6,10,16
HND-016942,2011,180900015,,,,10,1,11
HND-016945,2011,180900018,,,,6,8,14
HND-016949,2011,180900022,,,,13,17,30
HND-016952,2011,180900025,,,,4,8,12
HND-016953,2011,180900026,,,,4,6,10
HND-016955,2011,180900029,,,,4,5,9
HND-016956,2011,180900030,,,,7,5,12
HND-016958,2011,180900032,,,,5,1,6
HND-016962,2011,180900038,,,,6,8,14
,2011,180900111,,,,2,2,4
HND-016987,2011,180900113,,,,3,8,11
HND-016928,2011,180900001,,,,28,29,57
HND-016932,2011,180900005,,,,2,4,6
HND-016933,2011,180900006,,,,6,7,13
HND-016936,2011,180900009,,,,2,4,6
HND-016938,2011,180900011,,,,4,2,6
HND-016940,2011,180900013,,,,2,6,8
HND-016943,2011,180900016,,,,10,5,15
HND-016944,2011,180900017,,,,3,4,7
HND-016946,2011,180900019,,,,4,1,5
HND-016947,2011,180900020,,,,4,4,8
HND-016948,2011,180900021,,,,6,3,9
HND-016950,2011,180900023,,,,12,12,24
HND-016951,2011,180900024,,,,3,1,4
HND-016954,2011,180900027,,,,2,1,3
HND-016957,2011,180900031,,,,2,2,4
HND-016963,2011,180900039,,,,4,2,6
HND-016970,2011,180900049,,,,3,4,7
HND-016973,2011,180900052,,,,6,12,18
,2011,180900054,,,,2,4,6
HND-016976,2011,180900056,,,,26,26,52
,2011,180900057,,,,3,7,10
HND-016989,2011,180900117,,,,3,1,4
HND-016928,2011,180900001,,,,29,38,67
HND-016929,2011,180900002,,,,7,12,19
HND-016931,2011,180900004,,,,18,25,43
HND-016934,2011,180900007,,,,2,9,11
HND-016935,2011,180900008,,,,6,9,15
HND-016939,2011,180900012,,,,11,9,20
HND-016942,2011,180900015,,,,3,5,8
HND-016945,2011,180900018,,,,3,11,14
HND-016946,2011,180900019,,,,1,2,3
HND-016950,2011,180900023,,,,5,6,11
HND-016952,2011,180900025,,,,7,6,13
HND-016953,2011,180900026,,,,0,3,3
HND-016955,2011,180900029,,,,5,2,7
HND-016958,2011,180900032,,,,0,2,2
HND-016962,2011,180900038,,,,4,5,9
HND-016963,2011,180900039,,,,3,5,8
,2011,180900057,,,,5,7,12
,2011,180900111,,,,1,1,2
HND-016987,2011,180900113,,,,5,3,8
HND-016989,2011,180900117,,,,2,1,3
HND-016930,2011,180900003,,,,0,5,5
HND-016932,2011,180900005,,,,5,3,8
HND-016933,2011,180900006,,,,9,9,18
HND-016936,2011,180900009,,,,1,3,4
HND-016937,2011,180900010,,,,2,4,6
HND-016938,2011,180900011,,,,4,4,8
HND-016940,2011,180900013,,,,6,4,10
HND-016941,2011,180900014,,,,8,14,22
HND-016943,2011,180900016,,,,6,8,14
HND-016944,2011,180900017,,,,3,4,7
HND-016947,2011,180900020,,,,7,10,17
HND-016948,2011,180900021,,,,10,1,11
HND-016949,2011,180900022,,,,21,19,40
HND-016954,2011,180900027,,,,0,3,3
HND-016956,2011,180900030,,,,3,5,8
HND-016957,2011,180900031,,,,0,5,5
HND-016970,2011,180900049,,,,6,6,12
HND-016971,2011,180900050,,,,2,3,5
HND-016973,2011,180900052,,,,7,6,13
,2011,180900054,,,,5,3,8
HND-016976,2011,180900056,,,,13,21,34
HND-016928,2011,180900001,,,,43,36,79
HND-016929,2011,180900002,,,,14,14,28
HND-016932,2011,180900005,,,,5,6,11
HND-016935,2011,180900008,,,,3,7,10
HND-016936,2011,180900009,,,,1,5,6
HND-016943,2011,180900016,,,,6,7,13
HND-016944,2011,180900017,,,,4,3,7
HND-016948,2011,180900021,,,,2,8,10
HND-016950,2011,180900023,,,,11,6,17
HND-016951,2011,180900024,,,,1,1,2
HND-016953,2011,180900026,,,,3,1,4
HND-016954,2011,180900027,,,,1,2,3
HND-016956,2011,180900030,,,,6,3,9
HND-016957,2011,180900031,,,,2,3,5
HND-016958,2011,180900032,,,,0,2,2
HND-016962,2011,180900038,,,,8,5,13
HND-016973,2011,180900052,,,,8,4,12
HND-016987,2011,180900113,,,,6,4,10
HND-016989,2011,180900117,,,,0,4,4
HND-016930,2011,180900003,,,,2,2,4
HND-016931,2011,180900004,,,,12,17,29
HND-016933,2011,180900006,,,,10,7,17
HND-016934,2011,180900007,,,,3,7,10
HND-016937,2011,180900010,,,,2,5,7
HND-016938,2011,180900011,,,,4,4,8
HND-016939,2011,180900012,,,,5,8,13
HND-016941,2011,180900014,,,,8,6,14
HND-016942,2011,180900015,,,,1,5,6
HND-016945,2011,180900018,,,,8,14,22
HND-016947,2011,180900020,,,,6,5,11
HND-016949,2011,180900022,,,,13,15,28
HND-016952,2011,180900025,,,,3,6,9
HND-016955,2011,180900029,,,,1,1,2
HND-016963,2011,180900039,,,,3,4,7
HND-016970,2011,180900049,,,,4,1,5
HND-016971,2011,180900050,,,,3,1,4
,2011,180900054,,,,2,3,5
HND-016976,2011,180900056,,,,20,20,40
,2011,180900057,,,,5,3,8
,2011,180900111,,,,1,2,3
HND-016931,2011,180900004,,,,47,32,79
HND-016964,2011,180900040,,,,82,95,177
HND-016983,2011,180900104,,,,50,47,97
HND-016933,2011,180900006,,,,7,14,21
HND-016934,2011,180900007,,,,9,17,26
HND-016949,2011,180900022,,,,13,26,39
HND-016931,2011,180900004,,,,23,28,51
HND-016933,2011,180900006,,,,9,11,20
HND-016934,2011,180900007,,,,8,13,21
HND-016949,2011,180900022,,,,22,12,34
HND-016983,2011,180900104,,,,36,53,89
HND-016964,2011,180900040,,,,56,72,128
HND-016931,2011,180900004,,,,34,29,63
HND-016934,2011,180900007,,,,5,9,14
HND-016949,2011,180900022,,,,8,18,26
HND-016964,2011,180900040,,,,53,61,114
HND-016933,2011,180900006,,,,12,3,15
HND-016983,2011,180900104,,,,30,45,75
HND-016983,2011,180900104,,,,64,125,189
HND-016964,2011,180900040,,,,57,69,126
HND-016983,2011,180900104,,,,40,79,119
HND-016964,2011,180900040,,,,51,51,102
HND-016964,2011,180900040,,,,30,62,92
HND-016983,2011,180900104,,,,28,52,80
HND-017007,2011,181000018,,,,7,3,10
HND-017046,2011,181000059,,,,4,7,11
HND-017065,2011,181000079,,,,12,5,17
HND-017098,2011,181000129,,,,3,4,7
,2011,181000164,,,,5,3,8
HND-017101,2011,181000165,,,,5,5,10
HND-017102,2011,181000166,,,,5,5,10
,2011,181000167,,,,6,3,9
,2011,181000168,,,,5,3,8
,2011,181000171,,,,10,5,15
,2011,181000182,,,,2,8,10
,2011,181000183,,,,10,2,12
,2011,181000192,,,,6,4,10
,2011,181000195,,,,7,8,15
HND-017120,2011,181000212,,,,9,10,19
HND-017121,2011,181000213,,,,3,3,6
HND-017123,2011,181000217,,,,4,3,7
,2011,181000218,,,,9,6,15
HND-017124,2011,181000220,,,,9,4,13
,2011,181000222,,,,6,2,8
,2011,181000224,,,,6,3,9
HND-017125,2011,181000225,,,,8,3,11
HND-017126,2011,181000227,,,,3,10,13
,2011,181000238,,,,11,6,17
,2011,181000239,,,,10,8,18
HND-017131,2011,181000240,,,,5,3,8
HND-017133,2011,181000243,,,,6,11,17
,2011,181000244,,,,3,2,5
HND-017134,2011,181000245,,,,5,5,10
HND-016998,2011,181000008,,,,6,4,10
HND-017059,2011,181000073,,,,2,8,10
,2011,181000158,,,,3,7,10
HND-017099,2011,181000160,,,,0,1,1
HND-017100,2011,181000162,,,,8,7,15
HND-017103,2011,181000173,,,,5,5,10
HND-017104,2011,181000176,,,,5,1,6
HND-017109,2011,181000193,,,,5,10,15
HND-017110,2011,181000194,,,,5,3,8
HND-017111,2011,181000197,,,,6,1,7
HND-017112,2011,181000199,,,,8,3,11
,2011,181000200,,,,3,4,7
,2011,181000201,,,,4,3,7
HND-017113,2011,181000202,,,,8,3,11
,2011,181000207,,,,9,6,15
,2011,181000216,,,,1,5,6
,2011,181000219,,,,6,8,14
HND-017128,2011,181000230,,,,6,7,13
,2011,181000231,,,,6,2,8
HND-017129,2011,181000232,,,,8,11,19
,2011,181000233,,,,5,5,10
HND-017130,2011,181000234,,,,8,5,13
,2011,181000235,,,,10,3,13
,2011,181000236,,,,8,5,13
,2011,181000237,,,,5,4,9
HND-017081,2011,181000103,,,,4,5,9
HND-017083,2011,181000106,,,,0,1,1
HND-017099,2011,181000160,,,,2,1,3
HND-017047,2011,181000060,,,,5,5,10
HND-017048,2011,181000061,,,,4,5,9
HND-017073,2011,181000088,,,,3,2,5
HND-017084,2011,181000107,,,,3,3,6
HND-017085,2011,181000108,,,,4,2,6
,2011,181000125,,,,3,3,6
HND-017101,2011,181000165,,,,3,2,5
HND-017132,2011,181000241,,,,3,6,9
HND-017136,2011,181000247,,,,3,2,5
HND-017047,2011,181000060,,,,4,1,5
HND-017050,2011,181000063,,,,4,2,6
HND-017067,2011,181000081,,,,18,15,33
,2011,181000086,,,,3,2,5
,2011,181000092,,,,12,14,26
HND-017078,2011,181000097,,,,5,5,10
,2011,181000098,,,,7,6,13
HND-017079,2011,181000099,,,,15,5,20
HND-017082,2011,181000104,,,,2,1,3
,2011,181000105,,,,6,6,12
HND-017083,2011,181000106,,,,4,1,5
HND-017084,2011,181000107,,,,6,5,11
HND-017101,2011,181000165,,,,6,4,10
,2011,181000179,,,,1,0,1
HND-017107,2011,181000189,,,,6,3,9
,2011,181000209,,,,1,3,4
HND-017121,2011,181000213,,,,3,2,5
HND-017132,2011,181000241,,,,3,0,3
HND-017045,2011,181000058,,,,9,7,16
HND-017048,2011,181000061,,,,5,2,7
HND-017063,2011,181000077,,,,24,21,45
HND-017064,2011,181000078,,,,33,16,49
HND-017073,2011,181000088,,,,6,4,10
,2011,181000094,,,,3,1,4
,2011,181000096,,,,2,2,4
HND-017081,2011,181000103,,,,1,2,3
HND-017085,2011,181000108,,,,13,5,18
,2011,181000125,,,,1,3,4
HND-017099,2011,181000160,,,,3,2,5
,2011,181000187,,,,1,6,7
HND-017108,2011,181000190,,,,5,0,5
HND-017136,2011,181000247,,,,4,4,8
HND-017048,2011,181000061,,,,3,4,7
,2011,181000086,,,,8,3,11
,2011,181000098,,,,3,3,6
HND-017079,2011,181000099,,,,9,8,17
HND-017081,2011,181000103,,,,2,3,5
,2011,181000125,,,,1,2,3
HND-017099,2011,181000160,,,,4,4,8
,2011,181000179,,,,1,4,5
HND-017108,2011,181000190,,,,5,7,12
HND-017136,2011,181000247,,,,2,5,7
HND-017045,2011,181000058,,,,5,5,10
HND-017047,2011,181000060,,,,1,0,1
HND-017050,2011,181000063,,,,6,14,20
HND-017063,2011,181000077,,,,17,9,26
HND-017064,2011,181000078,,,,12,18,30
HND-017065,2011,181000079,,,,22,16,38
HND-017067,2011,181000081,,,,17,13,30
HND-017073,2011,181000088,,,,3,2,5
,2011,181000092,,,,14,24,38
,2011,181000094,,,,3,2,5
,2011,181000096,,,,1,2,3
HND-017078,2011,181000097,,,,6,5,11
HND-017082,2011,181000104,,,,7,2,9
,2011,181000105,,,,6,2,8
HND-017083,2011,181000106,,,,4,6,10
HND-017084,2011,181000107,,,,5,7,12
HND-017085,2011,181000108,,,,1,2,3
HND-017101,2011,181000165,,,,3,2,5
,2011,181000187,,,,3,5,8
HND-017107,2011,181000189,,,,4,3,7
,2011,181000209,,,,7,9,16
HND-017121,2011,181000213,,,,1,2,3
HND-017132,2011,181000241,,,,2,2,4
HND-016992,2011,181000001,,,,3,2,5
HND-016996,2011,181000006,,,,7,9,16
HND-016999,2011,181000009,,,,9,7,16
HND-017000,2011,181000010,,,,30,23,53
HND-017003,2011,181000013,,,,6,2,8
HND-017004,2011,181000014,,,,9,5,14
HND-017005,2011,181000015,,,,10,5,15
,2011,181000017,,,,1,2,3
HND-017011,2011,181000023,,,,8,7,15
HND-017013,2011,181000025,,,,14,13,27
HND-017015,2011,181000027,,,,35,25,60
HND-017016,2011,181000028,,,,6,6,12
HND-017017,2011,181000029,,,,16,11,27
HND-017018,2011,181000030,,,,7,4,11
HND-017019,2011,181000031,,,,1,4,5
HND-017024,2011,181000036,,,,9,5,14
HND-017025,2011,181000037,,,,5,3,8
HND-017027,2011,181000039,,,,7,2,9
HND-017028,2011,181000040,,,,5,7,12
HND-017029,2011,181000041,,,,19,15,34
HND-017037,2011,181000049,,,,6,4,10
HND-017038,2011,181000051,,,,9,5,14
HND-017039,2011,181000052,,,,9,8,17
HND-017041,2011,181000054,,,,5,3,8
HND-017043,2011,181000056,,,,3,6,9
HND-017047,2011,181000060,,,,5,5,10
HND-017048,2011,181000061,,,,5,4,9
HND-017049,2011,181000062,,,,6,8,14
HND-017051,2011,181000064,,,,4,3,7
HND-017053,2011,181000066,,,,6,4,10
HND-017057,2011,181000070,,,,3,7,10
,2011,181000071,,,,4,1,5
HND-017062,2011,181000076,,,,8,2,10
HND-017063,2011,181000077,,,,5,2,7
HND-017073,2011,181000088,,,,7,5,12
HND-017074,2011,181000089,,,,5,4,9
HND-017077,2011,181000093,,,,7,12,19
HND-017080,2011,181000101,,,,9,7,16
HND-017085,2011,181000108,,,,9,1,10
HND-017090,2011,181000114,,,,3,2,5
,2011,181000115,,,,2,3,5
HND-017092,2011,181000116,,,,4,1,5
HND-017094,2011,181000118,,,,2,5,7
,2011,181000119,,,,3,2,5
HND-017095,2011,181000120,,,,6,4,10
HND-017097,2011,181000126,,,,2,0,2
,2011,181000179,,,,4,3,7
HND-017106,2011,181000180,,,,0,2,2
HND-017114,2011,181000203,,,,3,1,4
HND-017116,2011,181000205,,,,2,3,5
HND-017118,2011,181000210,,,,1,0,1
HND-017119,2011,181000211,,,,1,4,5
HND-017122,2011,181000214,,,,5,1,6
,2011,181000242,,,,2,4,6
HND-017135,2011,181000246,,,,4,4,8
HND-017138,2011,181000250,,,,4,1,5
,2011,181000251,,,,7,2,9
HND-016993,2011,181000002,,,,3,5,8
HND-016994,2011,181000004,,,,20,12,32
HND-016995,2011,181000005,,,,6,2,8
HND-016997,2011,181000007,,,,4,0,4
HND-016998,2011,181000008,,,,5,5,10
HND-017001,2011,181000011,,,,8,3,11
HND-017002,2011,181000012,,,,36,39,75
HND-017006,2011,181000016,,,,1,3,4
HND-017007,2011,181000018,,,,8,4,12
,2011,181000019,,,,1,4,5
HND-017008,2011,181000020,,,,0,4,4
HND-017009,2011,181000021,,,,3,2,5
HND-017010,2011,181000022,,,,3,5,8
HND-017012,2011,181000024,,,,2,2,4
HND-017014,2011,181000026,,,,3,3,6
HND-017020,2011,181000032,,,,5,1,6
HND-017021,2011,181000033,,,,5,2,7
HND-017022,2011,181000034,,,,3,2,5
HND-017023,2011,181000035,,,,3,1,4
HND-017026,2011,181000038,,,,24,11,35
HND-017030,2011,181000042,,,,3,4,7
HND-017031,2011,181000043,,,,3,2,5
HND-017032,2011,181000044,,,,4,0,4
HND-017033,2011,181000045,,,,2,5,7
HND-017034,2011,181000046,,,,5,0,5
HND-017035,2011,181000047,,,,14,9,23
HND-017036,2011,181000048,,,,5,9,14
HND-017040,2011,181000053,,,,4,6,10
HND-017042,2011,181000055,,,,5,3,8
HND-017044,2011,181000057,,,,4,5,9
HND-017045,2011,181000058,,,,4,12,16
HND-017046,2011,181000059,,,,5,5,10
HND-017050,2011,181000063,,,,3,9,12
HND-017052,2011,181000065,,,,9,6,15
HND-017054,2011,181000067,,,,7,3,10
HND-017055,2011,181000068,,,,9,7,16
HND-017056,2011,181000069,,,,1,6,7
HND-017058,2011,181000072,,,,4,3,7
HND-017059,2011,181000073,,,,3,3,6
HND-017060,2011,181000074,,,,2,1,3
HND-017061,2011,181000075,,,,10,15,25
HND-017068,2011,181000082,,,,5,3,8
HND-017069,2011,181000083,,,,3,5,8
HND-017070,2011,181000084,,,,9,8,17
HND-017071,2011,181000085,,,,2,2,4
HND-017072,2011,181000087,,,,3,3,6
HND-017075,2011,181000090,,,,6,1,7
HND-017076,2011,181000091,,,,4,8,12
,2011,181000100,,,,3,7,10
HND-017081,2011,181000103,,,,6,6,12
HND-017083,2011,181000106,,,,5,6,11
HND-017084,2011,181000107,,,,7,11,18
HND-017086,2011,181000109,,,,0,6,6
HND-017087,2011,181000111,,,,9,8,17
HND-017088,2011,181000112,,,,10,4,14
HND-017089,2011,181000113,,,,4,3,7
HND-017093,2011,181000117,,,,8,4,12
HND-017096,2011,181000121,,,,3,0,3
,2011,181000181,,,,5,2,7
,2011,181000188,,,,0,7,7
HND-017110,2011,181000194,,,,3,3,6
HND-017115,2011,181000204,,,,5,6,11
HND-017117,2011,181000206,,,,0,1,1
,2011,181000228,,,,6,4,10
HND-017127,2011,181000229,,,,2,1,3
,2011,181000248,,,,5,1,6
HND-017137,2011,181000249,,,,1,2,3
HND-016995,2011,181000005,,,,5,2,7
HND-016998,2011,181000008,,,,5,4,9
HND-016999,2011,181000009,,,,8,6,14
HND-017001,2011,181000011,,,,8,7,15
HND-017004,2011,181000014,,,,4,11,15
HND-017006,2011,181000016,,,,5,4,9
HND-017008,2011,181000020,,,,0,3,3
HND-017009,2011,181000021,,,,4,2,6
HND-017010,2011,181000022,,,,4,5,9
HND-017011,2011,181000023,,,,7,3,10
HND-017012,2011,181000024,,,,1,3,4
HND-017013,2011,181000025,,,,7,16,23
HND-017015,2011,181000027,,,,32,20,52
HND-017018,2011,181000030,,,,5,2,7
HND-017019,2011,181000031,,,,2,5,7
HND-017020,2011,181000032,,,,3,3,6
HND-017022,2011,181000034,,,,2,3,5
HND-017024,2011,181000036,,,,13,5,18
HND-017028,2011,181000040,,,,1,5,6
HND-017029,2011,181000041,,,,24,12,36
HND-017030,2011,181000042,,,,1,1,2
HND-017031,2011,181000043,,,,1,7,8
HND-017032,2011,181000044,,,,6,3,9
HND-017034,2011,181000046,,,,6,2,8
HND-017035,2011,181000047,,,,12,14,26
HND-017039,2011,181000052,,,,4,6,10
HND-017040,2011,181000053,,,,1,5,6
HND-017041,2011,181000054,,,,1,1,2
HND-017042,2011,181000055,,,,3,2,5
HND-017044,2011,181000057,,,,2,1,3
HND-017055,2011,181000068,,,,5,4,9
HND-017056,2011,181000069,,,,6,5,11
HND-017057,2011,181000070,,,,2,4,6
,2011,181000071,,,,3,4,7
HND-017059,2011,181000073,,,,2,4,6
HND-017060,2011,181000074,,,,1,1,2
HND-017062,2011,181000076,,,,6,2,8
HND-017074,2011,181000089,,,,2,7,9
HND-017080,2011,181000101,,,,6,4,10
HND-017081,2011,181000103,,,,4,9,13
HND-017086,2011,181000109,,,,3,4,7
,2011,181000115,,,,1,0,1
HND-017092,2011,181000116,,,,5,3,8
HND-017094,2011,181000118,,,,2,0,2
HND-017097,2011,181000126,,,,3,1,4
,2011,181000179,,,,3,3,6
,2011,181000181,,,,4,3,7
,2011,181000188,,,,3,5,8
HND-017110,2011,181000194,,,,2,2,4
HND-017118,2011,181000210,,,,3,1,4
HND-017122,2011,181000214,,,,3,3,6
,2011,181000248,,,,5,3,8
HND-017137,2011,181000249,,,,2,2,4
,2011,181000251,,,,0,3,3
HND-016992,2011,181000001,,,,0,2,2
HND-016993,2011,181000002,,,,1,0,1
HND-016994,2011,181000004,,,,17,13,30
HND-016996,2011,181000006,,,,8,9,17
HND-016997,2011,181000007,,,,3,7,10
HND-017000,2011,181000010,,,,23,27,50
HND-017002,2011,181000012,,,,33,20,53
HND-017003,2011,181000013,,,,4,5,9
HND-017005,2011,181000015,,,,3,6,9
,2011,181000017,,,,2,2,4
HND-017007,2011,181000018,,,,6,4,10
,2011,181000019,,,,4,6,10
HND-017014,2011,181000026,,,,3,2,5
HND-017016,2011,181000028,,,,8,8,16
HND-017017,2011,181000029,,,,11,5,16
HND-017021,2011,181000033,,,,6,2,8
HND-017023,2011,181000035,,,,1,3,4
HND-017025,2011,181000037,,,,7,6,13
HND-017026,2011,181000038,,,,4,12,16
HND-017027,2011,181000039,,,,6,4,10
HND-017033,2011,181000045,,,,5,4,9
HND-017036,2011,181000048,,,,3,7,10
HND-017037,2011,181000049,,,,2,3,5
HND-017038,2011,181000051,,,,5,5,10
HND-017043,2011,181000056,,,,2,1,3
HND-017045,2011,181000058,,,,8,5,13
HND-017046,2011,181000059,,,,9,4,13
HND-017047,2011,181000060,,,,4,3,7
HND-017048,2011,181000061,,,,10,7,17
HND-017049,2011,181000062,,,,2,2,4
HND-017050,2011,181000063,,,,7,3,10
HND-017051,2011,181000064,,,,0,1,1
HND-017052,2011,181000065,,,,8,0,8
HND-017053,2011,181000066,,,,8,2,10
HND-017054,2011,181000067,,,,7,7,14
HND-017058,2011,181000072,,,,2,2,4
HND-017061,2011,181000075,,,,3,8,11
HND-017063,2011,181000077,,,,2,2,4
HND-017068,2011,181000082,,,,0,5,5
HND-017070,2011,181000084,,,,2,6,8
HND-017071,2011,181000085,,,,2,3,5
HND-017072,2011,181000087,,,,1,3,4
HND-017073,2011,181000088,,,,8,6,14
HND-017075,2011,181000090,,,,2,2,4
HND-017076,2011,181000091,,,,5,5,10
HND-017077,2011,181000093,,,,3,3,6
,2011,181000100,,,,7,5,12
HND-017083,2011,181000106,,,,6,5,11
HND-017084,2011,181000107,,,,10,8,18
HND-017085,2011,181000108,,,,5,4,9
HND-017087,2011,181000111,,,,3,2,5
HND-017088,2011,181000112,,,,0,7,7
HND-017089,2011,181000113,,,,2,4,6
HND-017090,2011,181000114,,,,2,2,4
HND-017093,2011,181000117,,,,3,3,6
,2011,181000119,,,,4,3,7
HND-017095,2011,181000120,,,,3,2,5
HND-017096,2011,181000121,,,,3,2,5
HND-017106,2011,181000180,,,,3,3,6
HND-017114,2011,181000203,,,,2,1,3
HND-017115,2011,181000204,,,,1,1,2
HND-017116,2011,181000205,,,,1,4,5
HND-017117,2011,181000206,,,,2,2,4
HND-017119,2011,181000211,,,,2,3,5
,2011,181000228,,,,5,0,5
HND-017127,2011,181000229,,,,1,2,3
,2011,181000242,,,,6,1,7
HND-017135,2011,181000246,,,,0,1,1
HND-017138,2011,181000250,,,,2,4,6
HND-016993,2011,181000002,,,,1,2,3
HND-016994,2011,181000004,,,,22,14,36
HND-016995,2011,181000005,,,,4,3,7
HND-016997,2011,181000007,,,,2,2,4
HND-016998,2011,181000008,,,,6,1,7
HND-017001,2011,181000011,,,,4,7,11
HND-017002,2011,181000012,,,,32,26,58
HND-017006,2011,181000016,,,,8,7,15
,2011,181000019,,,,2,4,6
HND-017008,2011,181000020,,,,4,1,5
HND-017009,2011,181000021,,,,4,4,8
HND-017010,2011,181000022,,,,4,3,7
HND-017011,2011,181000023,,,,6,4,10
HND-017012,2011,181000024,,,,1,1,2
HND-017014,2011,181000026,,,,3,3,6
HND-017018,2011,181000030,,,,2,1,3
HND-017019,2011,181000031,,,,0,3,3
HND-017024,2011,181000036,,,,3,0,3
HND-017027,2011,181000039,,,,7,2,9
HND-017028,2011,181000040,,,,4,3,7
HND-017029,2011,181000041,,,,7,9,16
HND-017030,2011,181000042,,,,7,3,10
HND-017032,2011,181000044,,,,1,6,7
HND-017037,2011,181000049,,,,7,5,12
HND-017038,2011,181000051,,,,5,3,8
HND-017039,2011,181000052,,,,2,4,6
HND-017040,2011,181000053,,,,5,3,8
HND-017041,2011,181000054,,,,3,1,4
HND-017043,2011,181000056,,,,2,5,7
HND-017050,2011,181000063,,,,4,2,6
HND-017052,2011,181000065,,,,5,5,10
HND-017054,2011,181000067,,,,7,2,9
HND-017055,2011,181000068,,,,3,2,5
HND-017056,2011,181000069,,,,9,5,14
HND-017057,2011,181000070,,,,3,6,9
,2011,181000071,,,,2,5,7
HND-017062,2011,181000076,,,,6,4,10
HND-017063,2011,181000077,,,,2,1,3
HND-017073,2011,181000088,,,,4,3,7
HND-017074,2011,181000089,,,,3,6,9
HND-017077,2011,181000093,,,,9,7,16
HND-017080,2011,181000101,,,,6,7,13
HND-017085,2011,181000108,,,,15,2,17
HND-017090,2011,181000114,,,,0,3,3
,2011,181000115,,,,3,2,5
HND-017092,2011,181000116,,,,2,2,4
HND-017094,2011,181000118,,,,2,0,2
HND-017095,2011,181000120,,,,0,2,2
HND-017097,2011,181000126,,,,1,0,1
,2011,181000181,,,,0,2,2
,2011,181000188,,,,0,1,1
HND-017110,2011,181000194,,,,0,3,3
HND-017115,2011,181000204,,,,4,0,4
HND-017117,2011,181000206,,,,2,0,2
,2011,181000228,,,,3,1,4
HND-017127,2011,181000229,,,,2,2,4
,2011,181000248,,,,0,2,2
HND-017137,2011,181000249,,,,2,1,3
HND-016992,2011,181000001,,,,0,1,1
HND-016996,2011,181000006,,,,6,10,16
HND-016999,2011,181000009,,,,8,5,13
HND-017000,2011,181000010,,,,31,30,61
HND-017003,2011,181000013,,,,3,4,7
HND-017004,2011,181000014,,,,9,4,13
HND-017005,2011,181000015,,,,6,4,10
HND-017007,2011,181000018,,,,8,8,16
HND-017013,2011,181000025,,,,12,7,19
HND-017015,2011,181000027,,,,22,13,35
HND-017016,2011,181000028,,,,4,4,8
HND-017017,2011,181000029,,,,3,7,10
HND-017020,2011,181000032,,,,2,2,4
HND-017021,2011,181000033,,,,5,5,10
HND-017022,2011,181000034,,,,2,3,5
HND-017023,2011,181000035,,,,1,2,3
HND-017025,2011,181000037,,,,6,3,9
HND-017026,2011,181000038,,,,3,6,9
HND-017031,2011,181000043,,,,5,0,5
HND-017033,2011,181000045,,,,5,1,6
HND-017034,2011,181000046,,,,1,1,2
HND-017035,2011,181000047,,,,17,12,29
HND-017036,2011,181000048,,,,5,4,9
HND-017042,2011,181000055,,,,3,3,6
HND-017044,2011,181000057,,,,3,1,4
HND-017045,2011,181000058,,,,9,7,16
HND-017046,2011,181000059,,,,4,4,8
HND-017047,2011,181000060,,,,6,5,11
HND-017048,2011,181000061,,,,3,7,10
HND-017049,2011,181000062,,,,3,2,5
HND-017051,2011,181000064,,,,4,2,6
HND-017053,2011,181000066,,,,2,1,3
HND-017058,2011,181000072,,,,2,0,2
HND-017059,2011,181000073,,,,1,4,5
HND-017060,2011,181000074,,,,2,5,7
HND-017061,2011,181000075,,,,5,7,12
HND-017068,2011,181000082,,,,2,2,4
HND-017069,2011,181000083,,,,0,1,1
HND-017070,2011,181000084,,,,3,3,6
HND-017071,2011,181000085,,,,9,3,12
HND-017072,2011,181000087,,,,6,2,8
HND-017075,2011,181000090,,,,6,2,8
HND-017076,2011,181000091,,,,4,6,10
,2011,181000100,,,,9,3,12
HND-017081,2011,181000103,,,,4,6,10
HND-017083,2011,181000106,,,,5,5,10
HND-017084,2011,181000107,,,,7,5,12
HND-017086,2011,181000109,,,,6,4,10
HND-017087,2011,181000111,,,,5,2,7
HND-017088,2011,181000112,,,,7,2,9
HND-017089,2011,181000113,,,,3,6,9
HND-017093,2011,181000117,,,,6,2,8
,2011,181000119,,,,6,2,8
HND-017096,2011,181000121,,,,2,4,6
,2011,181000179,,,,5,1,6
HND-017106,2011,181000180,,,,1,5,6
HND-017114,2011,181000203,,,,2,0,2
HND-017116,2011,181000205,,,,0,2,2
HND-017118,2011,181000210,,,,3,3,6
HND-017119,2011,181000211,,,,1,0,1
HND-017122,2011,181000214,,,,2,2,4
,2011,181000242,,,,4,3,7
HND-017135,2011,181000246,,,,4,2,6
HND-017138,2011,181000250,,,,4,2,6
,2011,181000251,,,,2,1,3
HND-016998,2011,181000008,,,,4,3,7
HND-016999,2011,181000009,,,,5,6,11
HND-017001,2011,181000011,,,,0,3,3
HND-017003,2011,181000013,,,,2,3,5
HND-017004,2011,181000014,,,,9,9,18
HND-017006,2011,181000016,,,,6,5,11
,2011,181000017,,,,0,4,4
HND-017010,2011,181000022,,,,4,3,7
HND-017011,2011,181000023,,,,8,10,18
HND-017012,2011,181000024,,,,1,1,2
HND-017013,2011,181000025,,,,16,10,26
HND-017015,2011,181000027,,,,26,18,44
HND-017016,2011,181000028,,,,4,3,7
HND-017018,2011,181000030,,,,4,3,7
HND-017019,2011,181000031,,,,2,4,6
HND-017020,2011,181000032,,,,6,0,6
HND-017021,2011,181000033,,,,0,3,3
HND-017022,2011,181000034,,,,6,2,8
HND-017024,2011,181000036,,,,4,7,11
HND-017030,2011,181000042,,,,2,4,6
HND-017031,2011,181000043,,,,2,2,4
HND-017032,2011,181000044,,,,6,7,13
HND-017033,2011,181000045,,,,3,3,6
HND-017034,2011,181000046,,,,2,6,8
HND-017035,2011,181000047,,,,16,11,27
HND-017039,2011,181000052,,,,5,2,7
HND-017040,2011,181000053,,,,2,5,7
HND-017041,2011,181000054,,,,1,1,2
HND-017042,2011,181000055,,,,4,4,8
HND-017044,2011,181000057,,,,4,1,5
HND-017045,2011,181000058,,,,8,9,17
HND-017047,2011,181000060,,,,2,1,3
HND-017048,2011,181000061,,,,5,4,9
HND-017053,2011,181000066,,,,3,4,7
HND-017056,2011,181000069,,,,7,9,16
HND-017057,2011,181000070,,,,4,4,8
HND-017058,2011,181000072,,,,2,3,5
HND-017059,2011,181000073,,,,4,3,7
HND-017060,2011,181000074,,,,3,0,3
HND-017061,2011,181000075,,,,2,5,7
HND-017062,2011,181000076,,,,2,3,5
HND-017068,2011,181000082,,,,2,1,3
HND-017070,2011,181000084,,,,6,5,11
,2011,181000100,,,,3,2,5
HND-017080,2011,181000101,,,,2,1,3
HND-017081,2011,181000103,,,,3,4,7
HND-017086,2011,181000109,,,,4,1,5
HND-017087,2011,181000111,,,,2,5,7
HND-017088,2011,181000112,,,,1,3,4
,2011,181000115,,,,1,2,3
HND-017092,2011,181000116,,,,3,4,7
HND-017093,2011,181000117,,,,3,3,6
HND-017094,2011,181000118,,,,2,1,3
HND-017096,2011,181000121,,,,3,0,3
,2011,181000179,,,,1,1,2
,2011,181000188,,,,1,2,3
HND-017110,2011,181000194,,,,5,6,11
HND-017117,2011,181000206,,,,4,3,7
HND-017118,2011,181000210,,,,2,3,5
,2011,181000228,,,,2,1,3
HND-017135,2011,181000246,,,,1,4,5
HND-017137,2011,181000249,,,,4,1,5
,2011,181000251,,,,2,1,3
HND-016992,2011,181000001,,,,3,0,3
HND-016994,2011,181000004,,,,7,12,19
HND-016995,2011,181000005,,,,2,4,6
HND-016996,2011,181000006,,,,4,6,10
HND-016997,2011,181000007,,,,5,7,12
HND-017000,2011,181000010,,,,28,26,54
HND-017002,2011,181000012,,,,28,37,65
HND-017005,2011,181000015,,,,5,6,11
HND-017007,2011,181000018,,,,6,5,11
,2011,181000019,,,,3,1,4
HND-017008,2011,181000020,,,,2,4,6
HND-017009,2011,181000021,,,,1,5,6
HND-017014,2011,181000026,,,,4,2,6
HND-017017,2011,181000029,,,,2,1,3
HND-017023,2011,181000035,,,,2,5,7
HND-017025,2011,181000037,,,,6,5,11
HND-017026,2011,181000038,,,,9,9,18
HND-017027,2011,181000039,,,,0,2,2
HND-017028,2011,181000040,,,,4,3,7
HND-017029,2011,181000041,,,,3,10,13
HND-017036,2011,181000048,,,,4,5,9
HND-017037,2011,181000049,,,,8,8,16
HND-017038,2011,181000051,,,,0,3,3
HND-017043,2011,181000056,,,,0,5,5
HND-017046,2011,181000059,,,,3,0,3
HND-017049,2011,181000062,,,,1,3,4
HND-017050,2011,181000063,,,,2,2,4
HND-017051,2011,181000064,,,,2,3,5
HND-017052,2011,181000065,,,,2,4,6
HND-017054,2011,181000067,,,,3,5,8
HND-017055,2011,181000068,,,,6,5,11
HND-017063,2011,181000077,,,,2,2,4
HND-017069,2011,181000083,,,,3,0,3
HND-017071,2011,181000085,,,,3,5,8
HND-017072,2011,181000087,,,,2,1,3
HND-017073,2011,181000088,,,,9,6,15
HND-017074,2011,181000089,,,,6,3,9
HND-017075,2011,181000090,,,,0,2,2
HND-017076,2011,181000091,,,,8,4,12
HND-017077,2011,181000093,,,,5,7,12
HND-017083,2011,181000106,,,,1,5,6
HND-017084,2011,181000107,,,,6,8,14
HND-017085,2011,181000108,,,,3,5,8
HND-017089,2011,181000113,,,,4,3,7
HND-017090,2011,181000114,,,,4,3,7
,2011,181000119,,,,0,4,4
HND-017095,2011,181000120,,,,2,4,6
HND-017097,2011,181000126,,,,2,1,3
HND-017106,2011,181000180,,,,3,3,6
,2011,181000181,,,,3,1,4
HND-017114,2011,181000203,,,,3,1,4
HND-017115,2011,181000204,,,,5,2,7
HND-017116,2011,181000205,,,,2,1,3
HND-017119,2011,181000211,,,,2,1,3
HND-017122,2011,181000214,,,,9,2,11
HND-017127,2011,181000229,,,,3,1,4
,2011,181000242,,,,3,2,5
,2011,181000248,,,,3,0,3
HND-017138,2011,181000250,,,,3,1,4
HND-016992,2011,181000001,,,,2,1,3
HND-016996,2011,181000006,,,,2,2,4
HND-016999,2011,181000009,,,,1,6,7
HND-017000,2011,181000010,,,,26,23,49
HND-017001,2011,181000011,,,,1,3,4
HND-017003,2011,181000013,,,,2,2,4
HND-017004,2011,181000014,,,,13,8,21
HND-017005,2011,181000015,,,,9,5,14
HND-017006,2011,181000016,,,,6,3,9
,2011,181000017,,,,0,3,3
HND-017011,2011,181000023,,,,6,5,11
HND-017013,2011,181000025,,,,13,13,26
HND-017015,2011,181000027,,,,22,23,45
HND-017016,2011,181000028,,,,0,2,2
HND-017018,2011,181000030,,,,1,3,4
HND-017019,2011,181000031,,,,4,1,5
HND-017020,2011,181000032,,,,3,4,7
HND-017021,2011,181000033,,,,0,2,2
HND-017022,2011,181000034,,,,5,5,10
HND-017023,2011,181000035,,,,1,0,1
HND-017024,2011,181000036,,,,6,7,13
HND-017030,2011,181000042,,,,2,2,4
HND-017031,2011,181000043,,,,7,5,12
HND-017032,2011,181000044,,,,1,2,3
HND-017033,2011,181000045,,,,3,2,5
HND-017034,2011,181000046,,,,2,1,3
HND-017035,2011,181000047,,,,15,19,34
HND-017036,2011,181000048,,,,2,1,3
HND-017040,2011,181000053,,,,4,2,6
HND-017042,2011,181000055,,,,2,0,2
HND-017044,2011,181000057,,,,3,4,7
HND-017045,2011,181000058,,,,8,4,12
HND-017047,2011,181000060,,,,4,2,6
HND-017048,2011,181000061,,,,4,1,5
HND-017053,2011,181000066,,,,1,5,6
HND-017056,2011,181000069,,,,6,7,13
HND-017058,2011,181000072,,,,1,0,1
HND-017059,2011,181000073,,,,2,4,6
HND-017060,2011,181000074,,,,0,7,7
HND-017061,2011,181000075,,,,5,1,6
HND-017068,2011,181000082,,,,4,6,10
HND-017069,2011,181000083,,,,1,0,1
HND-017070,2011,181000084,,,,5,3,8
HND-017072,2011,181000087,,,,1,1,2
HND-017075,2011,181000090,,,,1,4,5
HND-017076,2011,181000091,,,,1,2,3
,2011,181000100,,,,3,7,10
HND-017081,2011,181000103,,,,7,2,9
HND-017086,2011,181000109,,,,3,0,3
HND-017087,2011,181000111,,,,2,5,7
HND-017088,2011,181000112,,,,0,4,4
HND-017092,2011,181000116,,,,2,1,3
HND-017093,2011,181000117,,,,4,3,7
HND-017094,2011,181000118,,,,0,2,2
HND-017096,2011,181000121,,,,4,3,7
HND-017110,2011,181000194,,,,2,1,3
HND-017117,2011,181000206,,,,1,1,2
HND-017118,2011,181000210,,,,2,0,2
,2011,181000228,,,,0,2,2
HND-017135,2011,181000246,,,,1,0,1
HND-017137,2011,181000249,,,,2,4,6
,2011,181000251,,,,2,1,3
HND-016993,2011,181000002,,,,2,2,4
HND-016994,2011,181000004,,,,16,12,28
HND-016995,2011,181000005,,,,1,3,4
HND-016997,2011,181000007,,,,1,2,3
HND-016998,2011,181000008,,,,6,4,10
HND-017002,2011,181000012,,,,16,21,37
HND-017007,2011,181000018,,,,4,8,12
,2011,181000019,,,,7,2,9
HND-017008,2011,181000020,,,,2,1,3
HND-017009,2011,181000021,,,,3,3,6
HND-017010,2011,181000022,,,,2,4,6
HND-017012,2011,181000024,,,,6,2,8
HND-017014,2011,181000026,,,,4,3,7
HND-017017,2011,181000029,,,,4,6,10
HND-017025,2011,181000037,,,,4,3,7
HND-017026,2011,181000038,,,,5,5,10
HND-017027,2011,181000039,,,,0,3,3
HND-017028,2011,181000040,,,,2,4,6
HND-017029,2011,181000041,,,,7,7,14
HND-017037,2011,181000049,,,,7,4,11
HND-017038,2011,181000051,,,,2,5,7
HND-017039,2011,181000052,,,,2,4,6
HND-017041,2011,181000054,,,,2,0,2
HND-017043,2011,181000056,,,,4,2,6
HND-017046,2011,181000059,,,,5,12,17
HND-017049,2011,181000062,,,,1,0,1
HND-017050,2011,181000063,,,,3,1,4
HND-017051,2011,181000064,,,,2,0,2
HND-017052,2011,181000065,,,,1,6,7
HND-017054,2011,181000067,,,,7,2,9
HND-017055,2011,181000068,,,,4,5,9
HND-017057,2011,181000070,,,,1,3,4
,2011,181000071,,,,5,4,9
HND-017062,2011,181000076,,,,7,6,13
HND-017063,2011,181000077,,,,1,5,6
HND-017071,2011,181000085,,,,4,6,10
HND-017073,2011,181000088,,,,5,6,11
HND-017074,2011,181000089,,,,4,4,8
HND-017077,2011,181000093,,,,6,1,7
HND-017080,2011,181000101,,,,1,4,5
HND-017083,2011,181000106,,,,4,6,10
HND-017084,2011,181000107,,,,5,7,12
HND-017085,2011,181000108,,,,3,0,3
HND-017089,2011,181000113,,,,4,4,8
,2011,181000115,,,,1,0,1
,2011,181000119,,,,1,2,3
HND-017095,2011,181000120,,,,3,4,7
HND-017097,2011,181000126,,,,5,1,6
HND-017106,2011,181000180,,,,3,2,5
,2011,181000181,,,,1,1,2
,2011,181000188,,,,2,4,6
HND-017114,2011,181000203,,,,0,3,3
HND-017115,2011,181000204,,,,4,0,4
HND-017116,2011,181000205,,,,2,2,4
HND-017119,2011,181000211,,,,1,1,2
HND-017122,2011,181000214,,,,3,6,9
HND-017127,2011,181000229,,,,0,2,2
,2011,181000242,,,,1,3,4
,2011,181000248,,,,1,1,2
HND-017138,2011,181000250,,,,1,2,3
HND-016992,2011,181000001,,,,2,0,2
HND-016993,2011,181000002,,,,3,0,3
HND-016994,2011,181000004,,,,10,9,19
HND-016997,2011,181000007,,,,2,5,7
HND-017000,2011,181000010,,,,20,26,46
HND-017002,2011,181000012,,,,20,22,42
HND-017003,2011,181000013,,,,3,3,6
HND-017005,2011,181000015,,,,3,7,10
,2011,181000017,,,,0,3,3
HND-017007,2011,181000018,,,,2,3,5
HND-017014,2011,181000026,,,,3,2,5
HND-017016,2011,181000028,,,,4,6,10
HND-017017,2011,181000029,,,,4,1,5
HND-017023,2011,181000035,,,,1,2,3
HND-017025,2011,181000037,,,,1,4,5
HND-017026,2011,181000038,,,,9,5,14
HND-017033,2011,181000045,,,,3,2,5
HND-017036,2011,181000048,,,,6,5,11
HND-017037,2011,181000049,,,,7,6,13
HND-017038,2011,181000051,,,,3,7,10
HND-017043,2011,181000056,,,,2,2,4
HND-017045,2011,181000058,,,,6,1,7
HND-017046,2011,181000059,,,,7,7,14
HND-017047,2011,181000060,,,,2,3,5
HND-017048,2011,181000061,,,,1,4,5
HND-017049,2011,181000062,,,,0,1,1
HND-017050,2011,181000063,,,,1,3,4
HND-017051,2011,181000064,,,,1,1,2
HND-017052,2011,181000065,,,,3,4,7
HND-017053,2011,181000066,,,,2,5,7
HND-017054,2011,181000067,,,,2,3,5
HND-017058,2011,181000072,,,,4,1,5
HND-017063,2011,181000077,,,,0,1,1
HND-017068,2011,181000082,,,,1,2,3
HND-017069,2011,181000083,,,,1,0,1
HND-017070,2011,181000084,,,,4,4,8
HND-017071,2011,181000085,,,,2,4,6
HND-017072,2011,181000087,,,,2,2,4
HND-017073,2011,181000088,,,,10,9,19
HND-017075,2011,181000090,,,,1,1,2
HND-017076,2011,181000091,,,,1,2,3
HND-017077,2011,181000093,,,,6,3,9
,2011,181000100,,,,1,4,5
HND-017083,2011,181000106,,,,7,2,9
HND-017084,2011,181000107,,,,0,3,3
HND-017085,2011,181000108,,,,2,0,2
HND-017086,2011,181000109,,,,5,1,6
HND-017087,2011,181000111,,,,0,2,2
HND-017088,2011,181000112,,,,2,2,4
HND-017089,2011,181000113,,,,1,1,2
HND-017090,2011,181000114,,,,3,3,6
HND-017093,2011,181000117,,,,1,4,5
,2011,181000119,,,,2,2,4
HND-017095,2011,181000120,,,,2,2,4
HND-017096,2011,181000121,,,,2,3,5
HND-017106,2011,181000180,,,,2,0,2
HND-017115,2011,181000204,,,,1,3,4
HND-017117,2011,181000206,,,,1,1,2
HND-017119,2011,181000211,,,,1,0,1
HND-017127,2011,181000229,,,,2,0,2
,2011,181000242,,,,1,2,3
HND-017135,2011,181000246,,,,1,2,3
HND-017138,2011,181000250,,,,1,1,2
HND-016995,2011,181000005,,,,2,1,3
HND-016998,2011,181000008,,,,5,1,6
HND-017004,2011,181000014,,,,5,9,14
HND-017006,2011,181000016,,,,3,5,8
,2011,181000019,,,,6,6,12
HND-017008,2011,181000020,,,,1,2,3
HND-017009,2011,181000021,,,,4,5,9
HND-017010,2011,181000022,,,,3,5,8
HND-017011,2011,181000023,,,,4,5,9
HND-017012,2011,181000024,,,,7,3,10
HND-017013,2011,181000025,,,,11,8,19
HND-017015,2011,181000027,,,,29,23,52
HND-017018,2011,181000030,,,,5,4,9
HND-017019,2011,181000031,,,,2,4,6
HND-017020,2011,181000032,,,,3,4,7
HND-017022,2011,181000034,,,,5,4,9
HND-017024,2011,181000036,,,,4,7,11
HND-017028,2011,181000040,,,,1,1,2
HND-017029,2011,181000041,,,,7,1,8
HND-017030,2011,181000042,,,,3,4,7
HND-017031,2011,181000043,,,,2,2,4
HND-017032,2011,181000044,,,,3,7,10
HND-017034,2011,181000046,,,,1,1,2
HND-017035,2011,181000047,,,,7,11,18
HND-017039,2011,181000052,,,,1,3,4
HND-017040,2011,181000053,,,,1,5,6
HND-017042,2011,181000055,,,,1,2,3
HND-017044,2011,181000057,,,,4,2,6
HND-017055,2011,181000068,,,,3,2,5
HND-017056,2011,181000069,,,,4,7,11
HND-017057,2011,181000070,,,,4,2,6
,2011,181000071,,,,2,4,6
HND-017059,2011,181000073,,,,2,0,2
HND-017060,2011,181000074,,,,3,4,7
HND-017062,2011,181000076,,,,1,3,4
HND-017074,2011,181000089,,,,3,3,6
HND-017080,2011,181000101,,,,2,1,3
HND-017081,2011,181000103,,,,4,5,9
,2011,181000115,,,,2,1,3
HND-017092,2011,181000116,,,,6,4,10
HND-017094,2011,181000118,,,,0,1,1
HND-017097,2011,181000126,,,,1,2,3
,2011,181000181,,,,1,1,2
,2011,181000188,,,,2,0,2
HND-017118,2011,181000210,,,,2,0,2
,2011,181000248,,,,1,1,2
HND-017137,2011,181000249,,,,6,1,7
,2011,181000251,,,,0,2,2
HND-017013,2011,181000025,,,,11,16,27
HND-017015,2011,181000027,,,,28,25,53
HND-017022,2011,181000034,,,,13,10,23
HND-017033,2011,181000045,,,,6,8,14
HND-017035,2011,181000047,,,,6,8,14
HND-017045,2011,181000058,,,,5,7,12
HND-016994,2011,181000004,,,,6,11,17
,2011,181000019,,,,4,7,11
HND-017062,2011,181000076,,,,3,6,9
HND-017066,2011,181000080,,,,65,54,119
HND-017013,2011,181000025,,,,8,10,18
HND-017015,2011,181000027,,,,16,17,33
HND-017022,2011,181000034,,,,12,14,26
HND-017035,2011,181000047,,,,9,20,29
HND-017062,2011,181000076,,,,5,5,10
HND-017066,2011,181000080,,,,42,44,86
HND-016994,2011,181000004,,,,8,5,13
,2011,181000019,,,,5,4,9
HND-017033,2011,181000045,,,,3,5,8
HND-017045,2011,181000058,,,,3,2,5
HND-017013,2011,181000025,,,,7,15,22
HND-017015,2011,181000027,,,,14,12,26
HND-017022,2011,181000034,,,,8,6,14
HND-017033,2011,181000045,,,,4,5,9
HND-017035,2011,181000047,,,,6,12,18
HND-017045,2011,181000058,,,,5,5,10
HND-017062,2011,181000076,,,,4,7,11
HND-016994,2011,181000004,,,,5,2,7
,2011,181000019,,,,5,6,11
HND-017066,2011,181000080,,,,32,54,86
HND-017066,2011,181000080,,,,35,53,88
HND-017105,2011,181000178,,,,9,8,17
HND-017066,2011,181000080,,,,18,36,54
HND-017105,2011,181000178,,,,1,8,9
HND-017105,2011,181000178,,,,6,6,12
HND-017066,2011,181000080,,,,21,29,50
HND-017143,2011,181100005,,,,2,2,4
HND-017175,2011,181100040,,,,1,1,2
HND-017180,2011,181100046,,,,0,1,1
HND-017183,2011,181100051,,,,4,5,9
,2011,181100063,,,,2,2,4
HND-017193,2011,181100094,,,,3,4,7
,2011,181100099,,,,2,2,4
HND-017202,2011,181100107,,,,5,3,8
HND-017204,2011,181100110,,,,1,3,4
,2011,181100114,,,,5,4,9
HND-017206,2011,181100115,,,,2,2,4
HND-017207,2011,181100116,,,,1,3,4
HND-017209,2011,181101625,,,,2,2,4
HND-017210,2011,181101626,,,,2,2,4
,2011,181101630,,,,5,5,10
,2011,181101632,,,,5,1,6
HND-017214,2011,181101636,,,,10,11,21
,2011,181101637,,,,6,4,10
,2011,181101638,,,,3,5,8
,2011,181101639,,,,4,4,8
HND-017172,2011,181100037,,,,2,2,4
,2011,181100047,,,,2,3,5
HND-017191,2011,181100059,,,,0,1,1
,2011,181100061,,,,3,4,7
,2011,181100095,,,,5,5,10
HND-017194,2011,181100097,,,,2,3,5
HND-017195,2011,181100098,,,,2,2,4
,2011,181100103,,,,4,4,8
HND-017203,2011,181100109,,,,3,2,5
,2011,181100111,,,,2,2,4
,2011,181100112,,,,4,4,8
,2011,181101627,,,,0,1,1
,2011,181101628,,,,2,2,4
HND-017212,2011,181101631,,,,6,2,8
HND-017213,2011,181101633,,,,4,5,9
,2011,181101634,,,,6,6,12
,2011,181101635,,,,5,3,8
HND-017165,2011,181100028,,,,1,4,5
HND-017170,2011,181100035,,,,6,6,12
HND-017184,2011,181100052,,,,4,10,14
HND-017186,2011,181100054,,,,6,6,12
HND-017187,2011,181100055,,,,2,3,5
HND-017178,2011,181100043,,,,1,1,2
HND-017165,2011,181100028,,,,3,4,7
HND-017168,2011,181100031,,,,5,8,13
HND-017175,2011,181100040,,,,1,2,3
HND-017176,2011,181100041,,,,3,4,7
HND-017177,2011,181100042,,,,11,6,17
HND-017180,2011,181100046,,,,7,6,13
HND-017181,2011,181100048,,,,5,4,9
HND-017182,2011,181100050,,,,4,4,8
HND-017184,2011,181100052,,,,2,1,3
HND-017205,2011,181100113,,,,3,4,7
HND-017167,2011,181100030,,,,13,14,27
,2011,181100032,,,,4,2,6
,2011,181100033,,,,4,6,10
HND-017169,2011,181100034,,,,14,9,23
HND-017189,2011,181100057,,,,4,4,8
HND-017165,2011,181100028,,,,1,8,9
HND-017167,2011,181100030,,,,31,22,53
,2011,181100033,,,,16,5,21
HND-017170,2011,181100035,,,,4,2,6
HND-017177,2011,181100042,,,,11,12,23
HND-017178,2011,181100043,,,,4,4,8
HND-017181,2011,181100048,,,,3,1,4
HND-017187,2011,181100055,,,,2,4,6
HND-017168,2011,181100031,,,,21,18,39
,2011,181100032,,,,4,7,11
HND-017169,2011,181100034,,,,15,16,31
HND-017175,2011,181100040,,,,2,5,7
HND-017176,2011,181100041,,,,7,10,17
HND-017180,2011,181100046,,,,8,5,13
HND-017182,2011,181100050,,,,10,7,17
HND-017184,2011,181100052,,,,2,1,3
HND-017186,2011,181100054,,,,0,2,2
HND-017189,2011,181100057,,,,6,5,11
HND-017205,2011,181100113,,,,7,7,14
HND-017139,2011,181100001,,,,36,21,57
HND-017140,2011,181100002,,,,31,20,51
HND-017141,2011,181100003,,,,9,7,16
HND-017142,2011,181100004,,,,24,16,40
HND-017143,2011,181100005,,,,1,7,8
HND-017144,2011,181100006,,,,12,6,18
HND-017145,2011,181100007,,,,10,20,30
HND-017154,2011,181100016,,,,9,10,19
HND-017156,2011,181100018,,,,10,10,20
HND-017157,2011,181100019,,,,10,8,18
HND-017159,2011,181100022,,,,1,3,4
HND-017160,2011,181100023,,,,3,2,5
HND-017161,2011,181100024,,,,9,1,10
HND-017162,2011,181100025,,,,3,3,6
HND-017163,2011,181100026,,,,19,16,35
HND-017164,2011,181100027,,,,4,3,7
HND-017174,2011,181100039,,,,7,11,18
HND-017179,2011,181100044,,,,6,11,17
HND-017181,2011,181100048,,,,3,11,14
HND-017183,2011,181100051,,,,8,8,16
HND-017191,2011,181100059,,,,1,4,5
HND-017192,2011,181100060,,,,2,4,6
,2011,181100103,,,,8,4,12
HND-017199,2011,181100104,,,,4,7,11
HND-017200,2011,181100105,,,,4,3,7
HND-017201,2011,181100106,,,,3,6,9
HND-017211,2011,181101629,,,,3,2,5
HND-017146,2011,181100008,,,,3,3,6
HND-017147,2011,181100009,,,,16,11,27
HND-017148,2011,181100010,,,,6,1,7
HND-017149,2011,181100011,,,,6,5,11
HND-017150,2011,181100012,,,,17,29,46
HND-017151,2011,181100013,,,,4,10,14
HND-017152,2011,181100014,,,,4,7,11
HND-017153,2011,181100015,,,,5,2,7
HND-017155,2011,181100017,,,,19,10,29
HND-017158,2011,181100021,,,,5,1,6
HND-017165,2011,181100028,,,,10,11,21
HND-017166,2011,181100029,,,,4,2,6
HND-017173,2011,181100038,,,,1,2,3
HND-017178,2011,181100043,,,,4,6,10
HND-017184,2011,181100052,,,,5,9,14
HND-017185,2011,181100053,,,,5,5,10
HND-017186,2011,181100054,,,,12,8,20
HND-017187,2011,181100055,,,,8,5,13
HND-017189,2011,181100057,,,,19,11,30
HND-017190,2011,181100058,,,,10,1,11
HND-017196,2011,181100101,,,,4,4,8
HND-017197,2011,181100102,,,,4,6,10
,2011,181100117,,,,4,7,11
,2011,181101624,,,,7,5,12
HND-017139,2011,181100001,,,,27,30,57
HND-017140,2011,181100002,,,,22,13,35
HND-017141,2011,181100003,,,,10,7,17
HND-017142,2011,181100004,,,,14,17,31
HND-017143,2011,181100005,,,,9,4,13
HND-017145,2011,181100007,,,,10,5,15
HND-017146,2011,181100008,,,,3,4,7
HND-017148,2011,181100010,,,,6,6,12
HND-017149,2011,181100011,,,,5,1,6
HND-017150,2011,181100012,,,,18,23,41
HND-017152,2011,181100014,,,,1,5,6
HND-017154,2011,181100016,,,,5,5,10
HND-017157,2011,181100019,,,,4,6,10
HND-017160,2011,181100023,,,,3,3,6
HND-017162,2011,181100025,,,,0,2,2
HND-017163,2011,181100026,,,,18,13,31
HND-017164,2011,181100027,,,,8,2,10
HND-017165,2011,181100028,,,,7,5,12
HND-017173,2011,181100038,,,,3,0,3
HND-017174,2011,181100039,,,,4,2,6
HND-017178,2011,181100043,,,,2,3,5
HND-017181,2011,181100048,,,,7,1,8
HND-017187,2011,181100055,,,,8,6,14
HND-017190,2011,181100058,,,,8,6,14
HND-017191,2011,181100059,,,,2,0,2
HND-017196,2011,181100101,,,,2,0,2
HND-017197,2011,181100102,,,,1,2,3
,2011,181100103,,,,4,0,4
,2011,181101624,,,,5,6,11
HND-017144,2011,181100006,,,,9,6,15
HND-017147,2011,181100009,,,,6,7,13
HND-017151,2011,181100013,,,,0,5,5
HND-017153,2011,181100015,,,,2,2,4
HND-017155,2011,181100017,,,,7,16,23
HND-017156,2011,181100018,,,,5,4,9
,2011,181100020,,,,3,4,7
HND-017158,2011,181100021,,,,4,1,5
HND-017159,2011,181100022,,,,5,2,7
HND-017161,2011,181100024,,,,3,1,4
HND-017166,2011,181100029,,,,4,2,6
HND-017179,2011,181100044,,,,7,5,12
HND-017183,2011,181100051,,,,7,7,14
HND-017184,2011,181100052,,,,7,11,18
HND-017186,2011,181100054,,,,8,4,12
HND-017188,2011,181100056,,,,3,3,6
HND-017189,2011,181100057,,,,1,3,4
HND-017192,2011,181100060,,,,2,3,5
HND-017200,2011,181100105,,,,0,1,1
HND-017201,2011,181100106,,,,2,2,4
,2011,181100117,,,,3,4,7
HND-017211,2011,181101629,,,,3,4,7
HND-017139,2011,181100001,,,,29,27,56
HND-017140,2011,181100002,,,,15,11,26
HND-017141,2011,181100003,,,,8,11,19
HND-017142,2011,181100004,,,,24,14,38
HND-017143,2011,181100005,,,,4,3,7
HND-017144,2011,181100006,,,,8,5,13
HND-017145,2011,181100007,,,,6,6,12
HND-017148,2011,181100010,,,,6,8,14
HND-017149,2011,181100011,,,,5,6,11
HND-017154,2011,181100016,,,,1,3,4
HND-017156,2011,181100018,,,,4,5,9
HND-017157,2011,181100019,,,,12,7,19
HND-017159,2011,181100022,,,,5,3,8
HND-017160,2011,181100023,,,,6,3,9
HND-017161,2011,181100024,,,,4,1,5
HND-017162,2011,181100025,,,,0,1,1
HND-017163,2011,181100026,,,,19,10,29
HND-017164,2011,181100027,,,,2,6,8
HND-017165,2011,181100028,,,,4,6,10
HND-017173,2011,181100038,,,,2,1,3
HND-017178,2011,181100043,,,,1,2,3
HND-017184,2011,181100052,,,,0,1,1
HND-017185,2011,181100053,,,,1,1,2
HND-017186,2011,181100054,,,,7,2,9
HND-017187,2011,181100055,,,,2,3,5
HND-017189,2011,181100057,,,,5,4,9
HND-017190,2011,181100058,,,,7,4,11
HND-017196,2011,181100101,,,,2,2,4
HND-017197,2011,181100102,,,,0,2,2
,2011,181101624,,,,3,2,5
HND-017146,2011,181100008,,,,5,4,9
HND-017147,2011,181100009,,,,2,6,8
HND-017150,2011,181100012,,,,29,20,49
HND-017151,2011,181100013,,,,4,3,7
HND-017152,2011,181100014,,,,1,1,2
HND-017153,2011,181100015,,,,3,2,5
HND-017155,2011,181100017,,,,6,4,10
,2011,181100020,,,,3,2,5
HND-017158,2011,181100021,,,,4,7,11
HND-017166,2011,181100029,,,,4,4,8
HND-017174,2011,181100039,,,,6,2,8
HND-017179,2011,181100044,,,,6,8,14
HND-017181,2011,181100048,,,,5,4,9
HND-017183,2011,181100051,,,,1,6,7
HND-017188,2011,181100056,,,,2,2,4
HND-017191,2011,181100059,,,,0,1,1
HND-017192,2011,181100060,,,,3,3,6
,2011,181100103,,,,0,1,1
HND-017199,2011,181100104,,,,5,2,7
HND-017200,2011,181100105,,,,1,1,2
HND-017201,2011,181100106,,,,2,1,3
HND-017211,2011,181101629,,,,3,4,7
HND-017139,2011,181100001,,,,22,23,45
HND-017141,2011,181100003,,,,7,3,10
HND-017143,2011,181100005,,,,0,3,3
HND-017145,2011,181100007,,,,6,4,10
HND-017146,2011,181100008,,,,5,9,14
HND-017148,2011,181100010,,,,5,4,9
HND-017149,2011,181100011,,,,3,2,5
HND-017150,2011,181100012,,,,23,14,37
HND-017151,2011,181100013,,,,1,1,2
HND-017152,2011,181100014,,,,2,3,5
HND-017154,2011,181100016,,,,2,4,6
HND-017162,2011,181100025,,,,0,5,5
HND-017163,2011,181100026,,,,13,11,24
HND-017165,2011,181100028,,,,5,2,7
HND-017166,2011,181100029,,,,2,1,3
HND-017173,2011,181100038,,,,3,3,6
HND-017174,2011,181100039,,,,7,4,11
HND-017178,2011,181100043,,,,1,2,3
HND-017179,2011,181100044,,,,5,3,8
HND-017181,2011,181100048,,,,2,2,4
HND-017188,2011,181100056,,,,1,4,5
HND-017190,2011,181100058,,,,7,10,17
HND-017191,2011,181100059,,,,1,2,3
HND-017197,2011,181100102,,,,1,1,2
,2011,181100103,,,,2,1,3
HND-017199,2011,181100104,,,,1,1,2
HND-017140,2011,181100002,,,,14,15,29
HND-017142,2011,181100004,,,,12,15,27
HND-017144,2011,181100006,,,,6,6,12
HND-017147,2011,181100009,,,,8,7,15
HND-017153,2011,181100015,,,,2,2,4
HND-017155,2011,181100017,,,,2,2,4
HND-017156,2011,181100018,,,,5,7,12
HND-017157,2011,181100019,,,,7,4,11
,2011,181100020,,,,0,2,2
HND-017158,2011,181100021,,,,5,2,7
HND-017159,2011,181100022,,,,4,3,7
HND-017160,2011,181100023,,,,1,1,2
HND-017161,2011,181100024,,,,3,2,5
HND-017164,2011,181100027,,,,1,2,3
HND-017183,2011,181100051,,,,4,7,11
HND-017184,2011,181100052,,,,4,3,7
HND-017186,2011,181100054,,,,5,5,10
HND-017189,2011,181100057,,,,2,3,5
HND-017192,2011,181100060,,,,1,3,4
HND-017196,2011,181100101,,,,0,2,2
HND-017200,2011,181100105,,,,1,1,2
HND-017201,2011,181100106,,,,2,3,5
,2011,181101624,,,,1,1,2
HND-017211,2011,181101629,,,,1,3,4
HND-017139,2011,181100001,,,,23,44,67
HND-017143,2011,181100005,,,,4,2,6
HND-017145,2011,181100007,,,,6,4,10
HND-017146,2011,181100008,,,,8,9,17
HND-017147,2011,181100009,,,,6,5,11
HND-017148,2011,181100010,,,,13,13,26
HND-017149,2011,181100011,,,,2,3,5
HND-017150,2011,181100012,,,,25,25,50
HND-017152,2011,181100014,,,,1,0,1
HND-017153,2011,181100015,,,,2,6,8
HND-017154,2011,181100016,,,,2,6,8
HND-017155,2011,181100017,,,,3,3,6
HND-017165,2011,181100028,,,,7,6,13
HND-017173,2011,181100038,,,,2,2,4
HND-017174,2011,181100039,,,,4,5,9
HND-017178,2011,181100043,,,,3,1,4
HND-017179,2011,181100044,,,,5,11,16
HND-017181,2011,181100048,,,,2,3,5
HND-017183,2011,181100051,,,,4,1,5
HND-017188,2011,181100056,,,,2,1,3
HND-017191,2011,181100059,,,,1,4,5
HND-017197,2011,181100102,,,,0,2,2
,2011,181100103,,,,2,1,3
HND-017199,2011,181100104,,,,1,0,1
HND-017201,2011,181100106,,,,1,5,6
HND-017140,2011,181100002,,,,14,19,33
HND-017141,2011,181100003,,,,7,5,12
HND-017142,2011,181100004,,,,17,18,35
HND-017144,2011,181100006,,,,7,7,14
HND-017156,2011,181100018,,,,8,12,20
HND-017157,2011,181100019,,,,13,0,13
,2011,181100020,,,,4,1,5
HND-017158,2011,181100021,,,,0,5,5
HND-017159,2011,181100022,,,,4,4,8
HND-017160,2011,181100023,,,,1,2,3
HND-017162,2011,181100025,,,,7,3,10
HND-017163,2011,181100026,,,,14,4,18
HND-017164,2011,181100027,,,,2,1,3
HND-017184,2011,181100052,,,,1,0,1
HND-017186,2011,181100054,,,,5,7,12
HND-017190,2011,181100058,,,,0,4,4
HND-017192,2011,181100060,,,,3,0,3
HND-017196,2011,181100101,,,,3,0,3
HND-017200,2011,181100105,,,,3,0,3
HND-017211,2011,181101629,,,,1,1,2
HND-017144,2011,181100006,,,,11,4,15
HND-017147,2011,181100009,,,,12,7,19
HND-017150,2011,181100012,,,,23,26,49
HND-017153,2011,181100015,,,,0,7,7
HND-017155,2011,181100017,,,,1,5,6
HND-017156,2011,181100018,,,,4,5,9
,2011,181100020,,,,1,1,2
HND-017158,2011,181100021,,,,1,2,3
HND-017179,2011,181100044,,,,5,2,7
HND-017183,2011,181100051,,,,3,2,5
HND-017185,2011,181100053,,,,2,1,3
HND-017188,2011,181100056,,,,3,1,4
HND-017192,2011,181100060,,,,4,4,8
HND-017200,2011,181100105,,,,0,4,4
HND-017201,2011,181100106,,,,4,2,6
HND-017211,2011,181101629,,,,1,1,2
HND-017139,2011,181100001,,,,30,30,60
HND-017140,2011,181100002,,,,18,14,32
HND-017142,2011,181100004,,,,15,14,29
HND-017143,2011,181100005,,,,2,3,5
HND-017145,2011,181100007,,,,2,3,5
HND-017146,2011,181100008,,,,9,5,14
HND-017148,2011,181100010,,,,4,1,5
HND-017149,2011,181100011,,,,0,8,8
HND-017154,2011,181100016,,,,4,1,5
HND-017157,2011,181100019,,,,5,8,13
HND-017160,2011,181100023,,,,0,4,4
HND-017162,2011,181100025,,,,1,0,1
HND-017163,2011,181100026,,,,5,9,14
HND-017164,2011,181100027,,,,3,0,3
HND-017165,2011,181100028,,,,4,3,7
HND-017173,2011,181100038,,,,1,2,3
HND-017174,2011,181100039,,,,0,7,7
HND-017178,2011,181100043,,,,1,1,2
HND-017190,2011,181100058,,,,3,4,7
HND-017191,2011,181100059,,,,5,1,6
HND-017197,2011,181100102,,,,2,1,3
HND-017142,2011,181100004,,,,19,21,40
HND-017144,2011,181100006,,,,4,13,17
HND-017145,2011,181100007,,,,5,6,11
HND-017171,2011,181100036,,,,44,57,101
HND-017147,2011,181100009,,,,6,5,11
HND-017150,2011,181100012,,,,41,33,74
HND-017142,2011,181100004,,,,11,11,22
HND-017145,2011,181100007,,,,6,3,9
HND-017150,2011,181100012,,,,26,37,63
HND-017144,2011,181100006,,,,6,7,13
HND-017147,2011,181100009,,,,1,8,9
HND-017171,2011,181100036,,,,37,57,94
HND-017145,2011,181100007,,,,6,2,8
HND-017150,2011,181100012,,,,24,26,50
HND-017142,2011,181100004,,,,7,17,24
HND-017144,2011,181100006,,,,2,2,4
HND-017147,2011,181100009,,,,6,1,7
HND-017171,2011,181100036,,,,37,38,75
HND-017171,2011,181100036,,,,32,45,77
HND-017171,2011,181100036,,,,22,28,50
HND-017171,2011,181100036,,,,25,29,54
,2013,010100001,,,,446,463,909
,2013,010100002,,,,221,227,448
,2013,010100003,,,,182,135,317
,2013,010100004,,,,121,87,208
,2013,010100005,,,,187,156,343
,2013,010100006,,,,88,83,171
,2013,010100007,,,,143,129,272
,2013,010100007,,,,15,14,29
,2013,010100008,,,,192,173,365
,2013,010100009,,,,79,64,143
,2013,010100010,,,,326,319,645
,2013,010100011,,,,157,147,304
,2013,010100011,,,,11,15,26
,2013,010100012,,,,24,25,49
,2013,010100013,,,,61,63,124
,2013,010100013,,,,34,43,77
,2013,010100013,,,,15,14,29
,2013,010100014,,,,132,132,264
,2013,010100015,,,,276,393,669
,2013,010100016,,,,393,412,805
,2013,010100017,,,,49,45,94
,2013,010100018,,,,31,27,58
,2013,010100019,,,,38,23,61
,2013,010100020,,,,48,27,75
,2013,010100021,,,,144,90,234
,2013,010100022,,,,84,75,159
,2013,010100023,,,,9,7,16
,2013,010100024,,,,27,17,44
,2013,010100025,,,,263,251,514
,2013,010100026,,,,39,31,70
,2013,010100027,,,,9,1,10
,2013,010100028,,,,210,206,416
,2013,010100029,,,,66,53,119
,2013,010100030,,,,46,56,102
,2013,010100031,,,,152,125,277
,2013,010100032,,,,491,453,944
,2013,010100033,,,,390,381,771
,2013,010100034,,,,214,218,432
,2013,010100035,,,,259,249,508
,2013,010100036,,,,45,37,82
,2013,010100037,,,,29,31,60
,2013,010100038,,,,21,18,39
,2013,010100039,,,,43,32,75
,2013,010100040,,,,58,63,121
,2013,010100041,,,,51,51,102
,2013,010100042,,,,230,244,474
,2013,010100043,,,,66,46,112
,2013,010100044,,,,502,493,995
,2013,010100045,,,,427,422,849
,2013,010100046,,,,232,264,496
,2013,010100047,,,,135,107,242
,2013,010100048,,,,57,44,101
,2013,010100049,,,,30,38,68
,2013,010100050,,,,193,165,358
,2013,010100051,,,,9,11,20
,2013,010100052,,,,234,222,456
,2013,010100053,,,,185,215,400
,2013,010100053,,,,74,96,170
,2013,010100054,,,,24,17,41
,2013,010100055,,,,72,85,157
,2013,010100055,,,,76,83,159
,2013,010100055,,,,39,39,78
,2013,010100056,,,,84,84,168
,2013,010100057,,,,8,10,18
,2013,010100058,,,,11,18,29
,2013,010100058,,,,4,6,10
,2013,010100060,,,,33,27,60
,2013,010100061,,,,15,18,33
,2013,010100062,,,,11,10,21
,2013,010100063,,,,57,68,125
,2013,010100064,,,,79,80,159
,2013,010100066,,,,144,165,309
,2013,010100066,,,,102,108,210
,2013,010100067,,,,52,41,93
,2013,010100068,,,,185,169,354
,2013,010100069,,,,9,14,23
,2013,010100071,,,,335,362,697
,2013,010100072,,,,220,229,449
,2013,010100073,,,,39,53,92
,2013,010100075,,,,44,39,83
,2013,010100076,,,,49,49,98
,2013,010100078,,,,404,369,773
,2013,010100079,,,,171,145,316
,2013,010100080,,,,93,91,184
,2013,010100080,,,,14,17,31
,2013,010100080,,,,108,93,201
,2013,010100081,,,,14,11,25
,2013,010100081,,,,2,1,3
,2013,010100082,,,,101,111,212
,2013,010100086,,,,48,50,98
,2013,010100087,,,,39,43,82
,2013,010100088,,,,41,45,86
,2013,010100089,,,,17,30,47
,2013,010100090,,,,31,35,66
,2013,010100091,,,,37,27,64
,2013,010100092,,,,17,22,39
,2013,010100093,,,,20,22,42
,2013,010100094,,,,24,28,52
,2013,010100095,,,,29,24,53
,2013,010100095,,,,781,1112,1893
,2013,010100096,,,,18,16,34
,2013,010100097,,,,66,72,138
,2013,010100098,,,,28,32,60
,2013,010100099,,,,17,20,37
,2013,010100100,,,,10,18,28
,2013,010100101,,,,39,39,78
,2013,010100102,,,,49,54,103
,2013,010100103,,,,16,6,22
,2013,010100104,,,,4,15,19
,2013,010100104,,,,79,80,159
,2013,010100105,,,,61,37,98
,2013,010100106,,,,11,8,19
,2013,010100107,,,,3,7,10
,2013,010100107,,,,52,50,102
,2013,010100108,,,,86,76,162
,2013,010100108,,,,16,24,40
,2013,010100110,,,,39,42,81
,2013,010100111,,,,26,43,69
,2013,010100112,,,,5,6,11
,2013,010100113,,,,12,9,21
,2013,010100114,,,,4,11,15
,2013,010100115,,,,40,23,63
,2013,010100117,,,,1,5,6
,2013,010100118,,,,21,19,40
,2013,010100124,,,,2,4,6
,2013,010100126,,,,146,140,286
,2013,010100127,,,,16,15,31
,2013,010100128,,,,9,3,12
,2013,010100129,,,,9,11,20
,2013,010100130,,,,1,5,6
,2013,010100131,,,,1666,2133,3799
,2013,010100132,,,,970,258,1228
,2013,010100134,,,,25,41,66
,2013,010100135,,,,208,309,517
,2013,010100136,,,,70,210,280
,2013,010100137,,,,338,352,690
,2013,010100137,,,,211,248,459
,2013,010100138,,,,128,174,302
,2013,010100139,,,,64,70,134
,2013,010100140,,,,85,197,282
,2013,010100141,,,,78,130,208
,2013,010100142,,,,88,95,183
,2013,010100144,,,,47,45,92
,2013,010100144,,,,102,108,210
,2013,010100144,,,,101,110,211
,2013,010100145,,,,163,238,401
,2013,010100146,,,,38,36,74
,2013,010100147,,,,8,4,12
,2013,010100148,,,,114,131,245
,2013,010100149,,,,1,6,7
,2013,010100150,,,,18,21,39
,2013,010100151,,,,19,18,37
,2013,010100152,,,,17,6,23
,2013,010100153,,,,11,13,24
,2013,010100154,,,,5,7,12
,2013,010100157,,,,105,95,200
,2013,010100158,,,,17,12,29
,2013,010100158,,,,62,68,130
,2013,010100158,,,,16,17,33
,2013,010100159,,,,4,1,5
,2013,010100160,,,,25,10,35
,2013,010100162,,,,35,43,78
,2013,010100162,,,,54,60,114
,2013,010100162,,,,75,66,141
,2013,010100164,,,,14,12,26
,2013,010100165,,,,11,3,14
,2013,010100168,,,,102,95,197
,2013,010100169,,,,21,20,41
,2013,010100170,,,,30,24,54
,2013,010100170,,,,56,51,107
,2013,010100171,,,,155,154,309
,2013,010100172,,,,6,3,9
,2013,010100173,,,,61,66,127
,2013,010100176,,,,14,8,22
,2013,010100176,,,,6,5,11
,2013,010100177,,,,6,7,13
,2013,010100180,,,,6,7,13
,2013,010100181,,,,178,172,350
,2013,010100184,,,,29,42,71
,2013,010100184,,,,7,5,12
,2013,010100185,,,,12,13,25
,2013,010100185,,,,26,33,59
,2013,010100186,,,,19,17,36
,2013,010100187,,,,16,13,29
,2013,010100188,,,,26,27,53
,2013,010100190,,,,24,17,41
,2013,010100191,,,,92,88,180
,2013,010100192,,,,80,86,166
,2013,010100193,,,,143,100,243
,2013,010100195,,,,74,77,151
,2013,010100195,,,,64,71,135
,2013,010100195,,,,39,37,76
,2013,010100197,,,,12,10,22
,2013,010100199,,,,1,7,8
,2013,010100201,,,,27,23,50
,2013,010100203,,,,4,10,14
,2013,010100206,,,,4,4,8
,2013,010100208,,,,117,137,254
,2013,010100209,,,,93,97,190
,2013,010100210,,,,93,82,175
,2013,010100214,,,,48,51,99
,2013,010100214,,,,88,90,178
,2013,010100214,,,,123,138,261
,2013,010100215,,,,7,5,12
,2013,010100215,,,,8,6,14
,2013,010100217,,,,26,28,54
,2013,010100217,,,,68,60,128
,2013,010100217,,,,23,28,51
,2013,010100219,,,,5,6,11
,2013,010100220,,,,4,3,7
,2013,010100225,,,,6,9,15
,2013,010100226,,,,46,35,81
,2013,010100228,,,,5,4,9
,2013,010100229,,,,31,32,63
,2013,010100230,,,,46,37,83
,2013,010100231,,,,95,97,192
,2013,010100234,,,,3,6,9
,2013,010100236,,,,6,0,6
,2013,010100237,,,,11,10,21
,2013,010100239,,,,1,2,3
,2013,010100241,,,,28,37,65
,2013,010100241,,,,0,8,8
,2013,010100241,,,,20,32,52
,2013,010100242,,,,7,4,11
,2013,010100243,,,,4,6,10
,2013,010100246,,,,10,11,21
,2013,010100247,,,,19,14,33
,2013,010100249,,,,12,12,24
,2013,010100250,,,,29,34,63
,2013,010100250,,,,15,20,35
,2013,010100254,,,,2,2,4
,2013,010100254,,,,10,10,20
,2013,010100255,,,,11,11,22
,2013,010100256,,,,21,10,31
,2013,010100257,,,,1,1,2
,2013,010100258,,,,5,2,7
,2013,010100259,,,,11,8,19
,2013,010100260,,,,3,0,3
,2013,010100262,,,,5,4,9
,2013,010100269,,,,71,70,141
,2013,010100280,,,,47,43,90
,2013,010100280,,,,15,13,28
,2013,010100280,,,,6,14,20
,2013,010100281,,,,52,44,96
,2013,010100285,,,,11,9,20
,2013,010100286,,,,58,59,117
,2013,010100286,,,,7,10,17
,2013,010100287,,,,19,14,33
,2013,010100288,,,,3,5,8
,2013,010100289,,,,399,495,894
,2013,010100290,,,,10,10,20
,2013,010100293,,,,1,0,1
,2013,010100303,,,,42,39,81
,2013,010100304,,,,5,4,9
,2013,010100308,,,,20,13,33
,2013,010100308,,,,87,95,182
,2013,010100311,,,,4,2,6
,2013,010100315,,,,3,3,6
,2013,010100316,,,,13,8,21
,2013,010100320,,,,6,6,12
,2013,010100321,,,,9,11,20
,2013,010100323,,,,7,2,9
,2013,010100324,,,,12,10,22
,2013,010100324,,,,12,22,34
,2013,010100326,,,,43,37,80
,2013,010100326,,,,5,10,15
,2013,010100328,,,,2,4,6
,2013,010100330,,,,6,3,9
,2013,010100332,,,,8,5,13
,2013,010100333,,,,3,3,6
,2013,010100335,,,,1,1,2
,2013,010100338,,,,3,3,6
,2013,010100339,,,,3,1,4
,2013,010100342,,,,12,15,27
,2013,010100343,,,,10,16,26
,2013,010100344,,,,7,3,10
,2013,010100344,,,,17,21,38
,2013,010100344,,,,94,74,168
,2013,010100345,,,,24,29,53
,2013,010100345,,,,14,15,29
,2013,010100346,,,,55,69,124
,2013,010100346,,,,19,20,39
,2013,010100347,,,,20,31,51
,2013,010100347,,,,102,125,227
,2013,010100347,,,,20,31,51
,2013,010100348,,,,5,7,12
,2013,010100348,,,,42,36,78
,2013,010100349,,,,6,10,16
,2013,010100350,,,,62,45,107
,2013,010100351,,,,6,9,15
,2013,010100353,,,,3,4,7
,2013,010100355,,,,21,23,44
,2013,010100356,,,,26,19,45
,2013,010100356,,,,65,61,126
,2013,010100356,,,,29,20,49
,2013,010100358,,,,12,6,18
,2013,010100360,,,,14,10,24
,2013,010100361,,,,7,12,19
,2013,010100362,,,,12,2,14
,2013,010100363,,,,6,5,11
,2013,010100363,,,,10,4,14
,2013,010100364,,,,28,28,56
,2013,010100364,,,,100,77,177
,2013,010100367,,,,48,43,91
,2013,010100368,,,,30,23,53
,2013,010100368,,,,39,30,69
,2013,010100369,,,,8,2,10
,2013,010100369,,,,16,12,28
,2013,010100370,,,,6,7,13
,2013,010100371,,,,21,28,49
,2013,010100418,,,,496,915,1411
,2013,010200001,,,,32,27,59
,2013,010200001,,,,7,2,9
,2013,010200002,,,,267,260,527
,2013,010200003,,,,27,31,58
,2013,010200004,,,,30,23,53
,2013,010200005,,,,39,43,82
,2013,010200006,,,,31,27,58
,2013,010200007,,,,239,274,513
,2013,010200008,,,,64,40,104
,2013,010200010,,,,29,31,60
,2013,010200011,,,,123,116,239
,2013,010200012,,,,16,5,21
,2013,010200013,,,,51,47,98
,2013,010200014,,,,130,116,246
,2013,010200014,,,,14,6,20
,2013,010200015,,,,27,33,60
,2013,010200016,,,,24,22,46
,2013,010200017,,,,8,12,20
,2013,010200018,,,,235,191,426
,2013,010200019,,,,7,10,17
,2013,010200020,,,,8,8,16
,2013,010200021,,,,8,7,15
,2013,010200022,,,,11,3,14
,2013,010200023,,,,8,8,16
,2013,010200024,,,,11,10,21
,2013,010200025,,,,3,7,10
,2013,010200026,,,,289,281,570
,2013,010200027,,,,152,190,342
,2013,010200028,,,,250,287,537
,2013,010200028,,,,22,76,98
,2013,010200031,,,,12,15,27
,2013,010200032,,,,76,83,159
,2013,010200033,,,,7,8,15
,2013,010200035,,,,102,85,187
,2013,010200038,,,,12,16,28
,2013,010200039,,,,6,6,12
,2013,010200041,,,,3,4,7
,2013,010200041,,,,7,15,22
,2013,010200042,,,,149,123,272
,2013,010200047,,,,34,32,66
,2013,010200048,,,,14,9,23
,2013,010200049,,,,10,2,12
,2013,010200050,,,,13,3,16
,2013,010200051,,,,7,8,15
,2013,010200052,,,,4,1,5
,2013,010200053,,,,8,15,23
,2013,010200056,,,,21,13,34
,2013,010200057,,,,8,8,16
,2013,010200061,,,,5,12,17
,2013,010200062,,,,8,7,15
,2013,010200063,,,,5,1,6
,2013,010200064,,,,6,11,17
,2013,010300001,,,,101,102,203
,2013,010300002,,,,22,20,42
,2013,010300003,,,,19,23,42
,2013,010300004,,,,17,20,37
,2013,010300005,,,,17,5,22
,2013,010300006,,,,26,20,46
,2013,010300007,,,,17,13,30
,2013,010300008,,,,43,37,80
,2013,010300009,,,,13,15,28
,2013,010300010,,,,25,29,54
,2013,010300011,,,,25,17,42
,2013,010300012,,,,32,37,69
,2013,010300013,,,,37,35,72
,2013,010300014,,,,11,12,23
,2013,010300015,,,,25,16,41
,2013,010300016,,,,8,8,16
,2013,010300017,,,,36,16,52
,2013,010300018,,,,117,126,243
,2013,010300019,,,,25,22,47
,2013,010300020,,,,62,79,141
,2013,010300021,,,,41,44,85
,2013,010300022,,,,7,4,11
,2013,010300023,,,,24,26,50
,2013,010300024,,,,50,37,87
,2013,010300025,,,,11,7,18
,2013,010300026,,,,125,139,264
,2013,010300026,,,,17,25,42
,2013,010300027,,,,19,10,29
,2013,010300028,,,,22,18,40
,2013,010300029,,,,80,61,141
,2013,010300030,,,,5,6,11
,2013,010300031,,,,72,74,146
,2013,010300032,,,,147,127,274
,2013,010300032,,,,28,24,52
,2013,010300033,,,,15,10,25
,2013,010300034,,,,45,52,97
,2013,010300035,,,,19,18,37
,2013,010300036,,,,18,17,35
,2013,010300037,,,,8,7,15
,2013,010300038,,,,28,19,47
,2013,010300039,,,,18,15,33
,2013,010300040,,,,4,5,9
,2013,010300041,,,,20,15,35
,2013,010300042,,,,24,11,35
,2013,010300043,,,,17,8,25
,2013,010300044,,,,8,6,14
,2013,010300045,,,,13,12,25
,2013,010300046,,,,142,159,301
,2013,010300046,,,,230,245,475
,2013,010300047,,,,36,27,63
,2013,010300050,,,,30,25,55
,2013,010300051,,,,20,8,28
,2013,010300052,,,,12,18,30
,2013,010300053,,,,13,14,27
,2013,010300054,,,,14,5,19
,2013,010300055,,,,7,8,15
,2013,010300056,,,,27,19,46
,2013,010300057,,,,7,3,10
,2013,010300058,,,,3,7,10
,2013,010300067,,,,3,3,6
,2013,010300071,,,,5,13,18
,2013,010300074,,,,8,5,13
,2013,010300076,,,,15,9,24
,2013,010300077,,,,6,5,11
,2013,010300078,,,,2,8,10
,2013,010300079,,,,24,18,42
,2013,010300080,,,,10,1,11
,2013,010300081,,,,8,8,16
,2013,010300082,,,,2,5,7
,2013,010300083,,,,9,7,16
,2013,010300084,,,,6,5,11
,2013,010300085,,,,5,6,11
,2013,010300086,,,,8,6,14
,2013,010300087,,,,4,11,15
,2013,010300088,,,,4,6,10
,2013,010300089,,,,7,5,12
,2013,010300090,,,,7,4,11
,2013,010300092,,,,4,7,11
,2013,010300093,,,,8,7,15
,2013,010300094,,,,6,7,13
,2013,010300095,,,,1,2,3
,2013,010300096,,,,3,4,7
,2013,010300097,,,,2,3,5
,2013,010300099,,,,28,19,47
,2013,010300100,,,,2,2,4
,2013,010300101,,,,2,3,5
,2013,010300102,,,,1,2,3
,2013,010300103,,,,2,2,4
,2013,010300104,,,,3,2,5
,2013,010300105,,,,2,2,4
,2013,010300106,,,,3,2,5
,2013,010300108,,,,14,3,17
,2013,010300109,,,,1,3,4
,2013,010400001,,,,477,466,943
,2013,010400001,,,,314,409,723
,2013,010400002,,,,21,24,45
,2013,010400003,,,,9,14,23
,2013,010400004,,,,7,13,20
,2013,010400005,,,,24,20,44
,2013,010400006,,,,8,12,20
,2013,010400007,,,,51,55,106
,2013,010400008,,,,63,77,140
,2013,010400008,,,,29,32,61
,2013,010400009,,,,18,24,42
,2013,010400010,,,,168,156,324
,2013,010400011,,,,160,157,317
,2013,010400012,,,,15,11,26
,2013,010400013,,,,249,238,487
,2013,010400014,,,,36,45,81
,2013,010400015,,,,96,95,191
,2013,010400015,,,,21,28,49
,2013,010400016,,,,93,87,180
,2013,010400017,,,,44,55,99
,2013,010400018,,,,20,12,32
,2013,010400019,,,,29,28,57
,2013,010400020,,,,38,40,78
,2013,010400021,,,,16,15,31
,2013,010400022,,,,28,33,61
,2013,010400023,,,,74,83,157
,2013,010400024,,,,34,29,63
,2013,010400025,,,,37,52,89
,2013,010400026,,,,24,25,49
,2013,010400027,,,,16,16,32
,2013,010400028,,,,10,14,24
,2013,010400029,,,,25,23,48
,2013,010400030,,,,9,8,17
,2013,010400031,,,,11,14,25
,2013,010400032,,,,38,23,61
,2013,010400033,,,,23,19,42
,2013,010400034,,,,32,28,60
,2013,010400035,,,,34,33,67
,2013,010400036,,,,28,30,58
,2013,010400037,,,,45,47,92
,2013,010400038,,,,11,15,26
,2013,010400039,,,,5,7,12
,2013,010400040,,,,32,29,61
,2013,010400041,,,,15,30,45
,2013,010400041,,,,136,160,296
,2013,010400042,,,,14,15,29
,2013,010400043,,,,8,16,24
,2013,010400044,,,,21,16,37
,2013,010400045,,,,30,30,60
,2013,010400046,,,,21,11,32
,2013,010400047,,,,15,16,31
,2013,010400048,,,,23,25,48
,2013,010400049,,,,13,9,22
,2013,010400050,,,,12,18,30
,2013,010400052,,,,49,61,110
,2013,010400053,,,,7,13,20
,2013,010400054,,,,9,14,23
,2013,010400055,,,,11,8,19
,2013,010400056,,,,22,25,47
,2013,010400057,,,,25,11,36
,2013,010400058,,,,29,43,72
,2013,010400059,,,,27,32,59
,2013,010400060,,,,20,22,42
,2013,010400062,,,,20,13,33
,2013,010400063,,,,12,12,24
,2013,010400065,,,,41,38,79
,2013,010400066,,,,102,118,220
,2013,010400067,,,,169,177,346
,2013,010400068,,,,12,6,18
,2013,010400069,,,,70,71,141
,2013,010400070,,,,22,24,46
,2013,010400071,,,,24,29,53
,2013,010400072,,,,9,12,21
,2013,010400073,,,,20,9,29
,2013,010400074,,,,12,6,18
,2013,010400075,,,,11,14,25
,2013,010400077,,,,12,12,24
,2013,010400078,,,,6,6,12
,2013,010400079,,,,10,11,21
,2013,010400080,,,,12,6,18
,2013,010400081,,,,11,22,33
,2013,010400083,,,,20,25,45
,2013,010400086,,,,12,7,19
,2013,010400087,,,,15,8,23
,2013,010400088,,,,21,24,45
,2013,010400089,,,,7,3,10
,2013,010400091,,,,15,16,31
,2013,010400093,,,,5,5,10
,2013,010400094,,,,10,14,24
,2013,010400097,,,,5,3,8
,2013,010400103,,,,11,9,20
,2013,010400104,,,,10,7,17
,2013,010400105,,,,10,7,17
,2013,010400106,,,,33,18,51
,2013,010400107,,,,7,9,16
,2013,010400108,,,,17,23,40
,2013,010400108,,,,7,14,21
,2013,010400109,,,,5,5,10
,2013,010400110,,,,10,3,13
,2013,010400112,,,,31,32,63
,2013,010400115,,,,3,4,7
,2013,010400117,,,,5,2,7
,2013,010400119,,,,26,26,52
,2013,010400120,,,,14,8,22
,2013,010400121,,,,12,9,21
,2013,010400122,,,,12,7,19
,2013,010400124,,,,5,5,10
,2013,010400125,,,,10,10,20
,2013,010400126,,,,11,9,20
,2013,010400127,,,,2,2,4
,2013,010400128,,,,6,2,8
,2013,010400129,,,,10,9,19
,2013,010400130,,,,12,15,27
,2013,010400131,,,,7,8,15
,2013,010400134,,,,4,12,16
,2013,010400135,,,,19,20,39
,2013,010400137,,,,18,11,29
,2013,010400138,,,,11,12,23
,2013,010400139,,,,10,11,21
,2013,010400140,,,,12,8,20
,2013,010400142,,,,8,12,20
,2013,010400143,,,,12,10,22
,2013,010400144,,,,21,29,50
,2013,010400144,,,,12,9,21
,2013,010400144,,,,8,14,22
,2013,010400145,,,,11,13,24
,2013,010400147,,,,13,11,24
,2013,010400149,,,,11,9,20
,2013,010400150,,,,14,6,20
,2013,010400154,,,,6,9,15
,2013,010400155,,,,11,13,24
,2013,010400156,,,,8,7,15
,2013,010400158,,,,10,10,20
,2013,010400159,,,,12,13,25
,2013,010400160,,,,14,10,24
,2013,010400162,,,,11,9,20
,2013,010400163,,,,2,4,6
,2013,010400164,,,,12,8,20
,2013,010400165,,,,9,8,17
,2013,010400166,,,,6,0,6
,2013,010400168,,,,3,5,8
,2013,010400171,,,,7,13,20
,2013,010400172,,,,6,0,6
,2013,010400173,,,,23,19,42
,2013,010400174,,,,104,99,203
,2013,010400179,,,,6,7,13
,2013,010400184,,,,37,35,72
,2013,010400188,,,,9,8,17
,2013,010400189,,,,7,16,23
,2013,010400190,,,,12,13,25
,2013,010400191,,,,13,6,19
,2013,010400194,,,,12,8,20
,2013,010400196,,,,18,26,44
,2013,010400204,,,,10,10,20
,2013,010400207,,,,4,6,10
,2013,010400213,,,,17,23,40
,2013,010400215,,,,10,5,15
,2013,010400217,,,,20,5,25
,2013,010400218,,,,13,13,26
,2013,010400221,,,,9,10,19
,2013,010400222,,,,4,5,9
,2013,010400225,,,,11,11,22
,2013,010400228,,,,12,8,20
,2013,010400236,,,,10,15,25
,2013,010400238,,,,3,3,6
,2013,010400247,,,,4,3,7
,2013,010400248,,,,5,4,9
,2013,010400249,,,,7,13,20
,2013,010400250,,,,2,9,11
,2013,010400250,,,,11,11,22
,2013,010400250,,,,2,9,11
,2013,010400251,,,,25,25,50
,2013,010400252,,,,26,18,44
,2013,010400253,,,,11,11,22
,2013,010500001,,,,9,8,17
,2013,010500002,,,,8,19,27
,2013,010500003,,,,176,191,367
,2013,010500004,,,,27,30,57
,2013,010500005,,,,14,3,17
,2013,010500006,,,,36,23,59
,2013,010500007,,,,12,9,21
,2013,010500008,,,,19,12,31
,2013,010500009,,,,51,43,94
,2013,010500010,,,,23,31,54
,2013,010500013,,,,103,103,206
,2013,010500014,,,,28,31,59
,2013,010500015,,,,14,13,27
,2013,010500015,,,,96,95,191
,2013,010500016,,,,33,42,75
,2013,010500017,,,,80,73,153
,2013,010500018,,,,12,6,18
,2013,010500019,,,,90,100,190
,2013,010500021,,,,42,34,76
,2013,010500022,,,,41,32,73
,2013,010500023,,,,169,178,347
,2013,010500024,,,,101,93,194
,2013,010500025,,,,17,22,39
,2013,010500026,,,,6,12,18
,2013,010500027,,,,35,13,48
,2013,010500028,,,,8,26,34
,2013,010500029,,,,11,4,15
,2013,010500030,,,,10,12,22
,2013,010500031,,,,7,2,9
,2013,010500032,,,,11,5,16
,2013,010500033,,,,25,32,57
,2013,010500034,,,,42,44,86
,2013,010500035,,,,163,138,301
,2013,010500036,,,,20,7,27
,2013,010500037,,,,6,5,11
,2013,010500038,,,,8,3,11
,2013,010500040,,,,5,7,12
,2013,010500041,,,,11,7,18
,2013,010500042,,,,29,15,44
,2013,010500043,,,,28,32,60
,2013,010500044,,,,13,22,35
,2013,010500045,,,,29,27,56
,2013,010500046,,,,6,10,16
,2013,010500047,,,,15,16,31
,2013,010500048,,,,14,16,30
,2013,010500049,,,,7,9,16
,2013,010500050,,,,6,9,15
,2013,010500051,,,,10,3,13
,2013,010500052,,,,4,9,13
,2013,010500055,,,,6,14,20
,2013,010500055,,,,94,83,177
,2013,010500056,,,,341,411,752
,2013,010500057,,,,213,254,467
,2013,010500058,,,,716,801,1517
,2013,010500059,,,,23,21,44
,2013,010500060,,,,13,11,24
,2013,010500061,,,,18,20,38
,2013,010500062,,,,26,32,58
,2013,010500062,,,,1,4,5
,2013,010500063,,,,28,22,50
,2013,010500063,,,,1,2,3
,2013,010500064,,,,51,58,109
,2013,010500065,,,,23,16,39
,2013,010500071,,,,15,19,34
,2013,010500072,,,,9,6,15
,2013,010500073,,,,9,8,17
,2013,010500074,,,,4,11,15
,2013,010500075,,,,13,10,23
,2013,010500076,,,,6,7,13
,2013,010500077,,,,6,8,14
,2013,010500078,,,,10,5,15
,2013,010500080,,,,83,63,146
,2013,010500083,,,,19,23,42
,2013,010500085,,,,8,6,14
,2013,010500090,,,,10,6,16
,2013,010500093,,,,7,3,10
,2013,010500094,,,,11,10,21
,2013,010500095,,,,22,17,39
,2013,010500096,,,,15,10,25
,2013,010500097,,,,4,2,6
,2013,010500098,,,,15,23,38
,2013,010500116,,,,67,61,128
,2013,010500117,,,,18,18,36
,2013,010500118,,,,35,28,63
,2013,010500119,,,,22,32,54
,2013,010500121,,,,12,9,21
,2013,010500122,,,,5,7,12
,2013,010500123,,,,7,9,16
,2013,010500124,,,,10,12,22
,2013,010500126,,,,4,11,15
,2013,010500128,,,,0,4,4
,2013,010500129,,,,9,6,15
,2013,010500130,,,,10,7,17
,2013,010500131,,,,59,70,129
,2013,010500131,,,,42,60,102
,2013,010500132,,,,8,3,11
,2013,010500134,,,,4,1,5
,2013,010500136,,,,5,5,10
,2013,010500137,,,,3,3,6
,2013,010500141,,,,16,21,37
,2013,010500141,,,,36,40,76
,2013,010500142,,,,9,7,16
,2013,010500143,,,,304,282,586
,2013,010500144,,,,7,3,10
,2013,010500145,,,,1,3,4
,2013,010500147,,,,2,0,2
,2013,010500148,,,,1,7,8
,2013,010500150,,,,4,1,5
,2013,010500151,,,,2,5,7
,2013,010500152,,,,1,5,6
,2013,010500153,,,,1,3,4
,2013,010500154,,,,15,20,35
,2013,010500155,,,,12,7,19
,2013,010500156,,,,16,18,34
,2013,010600001,,,,198,160,358
,2013,010600002,,,,268,254,522
,2013,010600002,,,,6,2,8
,2013,010600003,,,,23,28,51
,2013,010600004,,,,15,18,33
,2013,010600005,,,,61,54,115
,2013,010600006,,,,33,23,56
,2013,010600007,,,,34,30,64
,2013,010600008,,,,20,24,44
,2013,010600009,,,,17,18,35
,2013,010600010,,,,36,29,65
,2013,010600011,,,,32,9,41
,2013,010600012,,,,19,17,36
,2013,010600013,,,,312,255,567
,2013,010600013,,,,21,13,34
,2013,010600014,,,,42,32,74
,2013,010600015,,,,33,33,66
,2013,010600018,,,,43,32,75
,2013,010600019,,,,6,9,15
,2013,010600020,,,,275,241,516
,2013,010600021,,,,198,9,207
,2013,010600022,,,,300,343,643
,2013,010600024,,,,2,4,6
,2013,010600025,,,,3,5,8
,2013,010600036,,,,4,1,5
,2013,010600037,,,,4,5,9
,2013,010600038,,,,3,2,5
,2013,010600039,,,,3,3,6
,2013,010600040,,,,7,12,19
,2013,010600041,,,,5,3,8
,2013,010600042,,,,3,11,14
,2013,010600043,,,,3,1,4
,2013,010600044,,,,3,5,8
,2013,010600045,,,,6,9,15
,2013,010600045,,,,19,23,42
,2013,010600049,,,,8,7,15
,2013,010600050,,,,0,7,7
,2013,010700001,,,,12,14,26
,2013,010700002,,,,33,38,71
,2013,010700003,,,,12,19,31
,2013,010700003,,,,301,278,579
,2013,010700004,,,,12,7,19
,2013,010700005,,,,23,13,36
,2013,010700005,,,,1,2,3
,2013,010700007,,,,11,10,21
,2013,010700008,,,,12,11,23
,2013,010700009,,,,235,230,465
,2013,010700010,,,,220,225,445
,2013,010700010,,,,37,32,69
,2013,010700011,,,,13,8,21
,2013,010700011,,,,102,91,193
,2013,010700012,,,,142,155,297
,2013,010700012,,,,3,19,22
,2013,010700013,,,,27,20,47
,2013,010700013,,,,254,203,457
,2013,010700014,,,,82,67,149
,2013,010700015,,,,55,36,91
,2013,010700016,,,,47,43,90
,2013,010700016,,,,6,4,10
,2013,010700017,,,,324,345,669
,2013,010700018,,,,235,234,469
,2013,010700019,,,,26,34,60
,2013,010700019,,,,7,6,13
,2013,010700020,,,,67,47,114
,2013,010700021,,,,7,1,8
,2013,010700022,,,,511,520,1031
,2013,010700023,,,,106,129,235
,2013,010700024,,,,61,55,116
,2013,010700024,,,,6,3,9
,2013,010700025,,,,25,47,72
,2013,010700026,,,,29,36,65
,2013,010700026,,,,2,1,3
,2013,010700027,,,,52,34,86
,2013,010700028,,,,108,85,193
,2013,010700028,,,,16,10,26
,2013,010700029,,,,5,8,13
,2013,010700029,,,,31,38,69
,2013,010700030,,,,57,52,109
,2013,010700030,,,,6,4,10
,2013,010700031,,,,3,8,11
,2013,010700031,,,,32,42,74
,2013,010700032,,,,24,18,42
,2013,010700032,,,,3,2,5
,2013,010700033,,,,3,5,8
,2013,010700033,,,,26,37,63
,2013,010700034,,,,134,111,245
,2013,010700034,,,,13,14,27
,2013,010700035,,,,20,21,41
,2013,010700036,,,,56,54,110
,2013,010700036,,,,6,6,12
,2013,010700037,,,,7,6,13
,2013,010700037,,,,66,47,113
,2013,010700038,,,,124,104,228
,2013,010700039,,,,6,13,19
,2013,010700040,,,,48,29,77
,2013,010700040,,,,6,5,11
,2013,010700041,,,,4,7,11
,2013,010700041,,,,69,72,141
,2013,010700042,,,,47,34,81
,2013,010700043,,,,45,29,74
,2013,010700044,,,,59,64,123
,2013,010700045,,,,6,18,24
,2013,010700046,,,,11,11,22
,2013,010700046,,,,2,1,3
,2013,010700047,,,,19,20,39
,2013,010700047,,,,216,216,432
,2013,010700048,,,,5,4,9
,2013,010700049,,,,12,8,20
,2013,010700050,,,,10,9,19
,2013,010700051,,,,7,10,17
,2013,010700052,,,,23,27,50
,2013,010700052,,,,2,1,3
,2013,010700053,,,,7,14,21
,2013,010700053,,,,99,82,181
,2013,010700054,,,,26,26,52
,2013,010700054,,,,13,7,20
,2013,010700055,,,,9,16,25
,2013,010700056,,,,119,90,209
,2013,010700057,,,,30,29,59
,2013,010700057,,,,0,3,3
,2013,010700058,,,,18,10,28
,2013,010700059,,,,39,28,67
,2013,010700059,,,,6,4,10
,2013,010700060,,,,20,20,40
,2013,010700062,,,,14,13,27
,2013,010700062,,,,5,0,5
,2013,010700063,,,,8,13,21
,2013,010700063,,,,97,120,217
,2013,010700064,,,,12,14,26
,2013,010700065,,,,56,54,110
,2013,010700066,,,,18,22,40
,2013,010700066,,,,3,1,4
,2013,010700067,,,,18,9,27
,2013,010700068,,,,5,11,16
,2013,010700070,,,,81,67,148
,2013,010700070,,,,6,6,12
,2013,010700071,,,,5,7,12
,2013,010700072,,,,7,6,13
,2013,010700073,,,,10,26,36
,2013,010700073,,,,2,3,5
,2013,010700074,,,,1,1,2
,2013,010700074,,,,28,18,46
,2013,010700075,,,,23,20,43
,2013,010700075,,,,4,1,5
,2013,010700076,,,,9,16,25
,2013,010700077,,,,15,15,30
,2013,010700077,,,,1,2,3
,2013,010700078,,,,13,14,27
,2013,010700079,,,,16,16,32
,2013,010700080,,,,28,18,46
,2013,010700080,,,,3,3,6
,2013,010700081,,,,7,12,19
,2013,010700081,,,,69,80,149
,2013,010700082,,,,30,36,66
,2013,010700082,,,,1,5,6
,2013,010700083,,,,18,10,28
,2013,010700084,,,,12,15,27
,2013,010700085,,,,18,10,28
,2013,010700086,,,,89,81,170
,2013,010700086,,,,11,3,14
,2013,010700087,,,,22,16,38
,2013,010700088,,,,8,12,20
,2013,010700089,,,,8,5,13
,2013,010700089,,,,1,1,2
,2013,010700090,,,,57,48,105
,2013,010700091,,,,15,7,22
,2013,010700091,,,,1,4,5
,2013,010700092,,,,13,8,21
,2013,010700093,,,,13,15,28
,2013,010700094,,,,14,16,30
,2013,010700095,,,,7,18,25
,2013,010700096,,,,45,29,74
,2013,010700096,,,,3,6,9
,2013,010700097,,,,10,2,12
,2013,010700098,,,,32,36,68
,2013,010700098,,,,2,5,7
,2013,010700099,,,,23,18,41
,2013,010700100,,,,11,14,25
,2013,010700102,,,,9,3,12
,2013,010700103,,,,8,4,12
,2013,010700104,,,,11,4,15
,2013,010700105,,,,27,14,41
,2013,010700106,,,,55,36,91
,2013,010700106,,,,5,2,7
,2013,010700107,,,,41,44,85
,2013,010700108,,,,10,13,23
,2013,010700109,,,,156,157,313
,2013,010700110,,,,310,282,592
,2013,010700111,,,,115,98,213
,2013,010700112,,,,15,16,31
,2013,010700113,,,,28,25,53
,2013,010700114,,,,6,10,16
,2013,010700115,,,,26,28,54
,2013,010700115,,,,4,2,6
,2013,010700116,,,,18,17,35
,2013,010700116,,,,2,5,7
,2013,010700117,,,,20,13,33
,2013,010700118,,,,22,26,48
,2013,010700119,,,,16,11,27
,2013,010700120,,,,10,10,20
,2013,010700121,,,,22,23,45
,2013,010700122,,,,29,28,57
,2013,010700124,,,,28,22,50
,2013,010700125,,,,16,9,25
,2013,010700126,,,,79,77,156
,2013,010700126,,,,14,13,27
,2013,010700127,,,,110,97,207
,2013,010700128,,,,80,75,155
,2013,010700129,,,,65,53,118
,2013,010700129,,,,13,11,24
,2013,010700129,,,,51,55,106
,2013,010700130,,,,18,8,26
,2013,010700132,,,,20,11,31
,2013,010700133,,,,26,29,55
,2013,010700133,,,,157,152,309
,2013,010700134,,,,34,20,54
,2013,010700135,,,,16,15,31
,2013,010700137,,,,35,32,67
,2013,010700138,,,,10,15,25
,2013,010700140,,,,184,277,461
,2013,010700140,,,,5,7,12
,2013,010700140,,,,38,72,110
,2013,010700141,,,,26,30,56
,2013,010700142,,,,23,17,40
,2013,010700143,,,,23,23,46
,2013,010700144,,,,27,30,57
,2013,010700145,,,,15,12,27
,2013,010700146,,,,9,8,17
,2013,010700148,,,,17,21,38
,2013,010700149,,,,27,29,56
,2013,010700150,,,,18,15,33
,2013,010700151,,,,9,12,21
,2013,010700152,,,,10,11,21
,2013,010700153,,,,11,11,22
,2013,010700154,,,,7,8,15
,2013,010700155,,,,20,19,39
,2013,010700157,,,,40,51,91
,2013,010700157,,,,143,156,299
,2013,010700158,,,,9,10,19
,2013,010700159,,,,73,60,133
,2013,010700161,,,,8,8,16
,2013,010700162,,,,19,31,50
,2013,010700162,,,,6,4,10
,2013,010700163,,,,235,601,836
,2013,010700164,,,,43,59,102
,2013,010700164,,,,27,31,58
,2013,010700164,,,,33,51,84
,2013,010700165,,,,136,97,233
,2013,010700166,,,,256,319,575
,2013,010700167,,,,25,19,44
,2013,010700168,,,,167,224,391
,2013,010700168,,,,323,387,710
,2013,010700170,,,,6,8,14
,2013,010700172,,,,31,38,69
,2013,010700173,,,,762,916,1678
,2013,010700174,,,,6,9,15
,2013,010700175,,,,7,10,17
,2013,010700176,,,,5,9,14
,2013,010700179,,,,52,64,116
,2013,010700179,,,,20,24,44
,2013,010700180,,,,226,265,491
,2013,010700182,,,,2,2,4
,2013,010700183,,,,9,12,21
,2013,010700183,,,,57,44,101
,2013,010700184,,,,2,0,2
,2013,010700187,,,,13,7,20
,2013,010700190,,,,11,7,18
,2013,010700190,,,,127,143,270
,2013,010700194,,,,3,0,3
,2013,010700195,,,,82,73,155
,2013,010700196,,,,3,0,3
,2013,010700199,,,,12,8,20
,2013,010700200,,,,12,10,22
,2013,010700200,,,,3,0,3
,2013,010700201,,,,19,12,31
,2013,010700201,,,,4,12,16
,2013,010700201,,,,33,44,77
,2013,010700203,,,,18,21,39
,2013,010700204,,,,12,7,19
,2013,010700206,,,,12,21,33
,2013,010700206,,,,54,64,118
,2013,010700206,,,,3,2,5
,2013,010700206,,,,11,14,25
,2013,010700208,,,,6,3,9
,2013,010700210,,,,5,2,7
,2013,010700211,,,,80,100,180
,2013,010700212,,,,36,30,66
,2013,010700213,,,,10,6,16
,2013,010700214,,,,15,11,26
,2013,010700215,,,,12,15,27
,2013,010700216,,,,2,11,13
,2013,010700217,,,,5,10,15
,2013,010700218,,,,21,12,33
,2013,010700219,,,,14,13,27
,2013,010700220,,,,60,63,123
,2013,010700222,,,,13,9,22
,2013,010700223,,,,11,5,16
,2013,010700224,,,,9,9,18
,2013,010700225,,,,3,11,14
,2013,010700226,,,,7,9,16
,2013,010700227,,,,31,28,59
,2013,010700228,,,,14,16,30
,2013,010700229,,,,7,7,14
,2013,010700232,,,,3,3,6
,2013,010700237,,,,2,4,6
,2013,010700238,,,,12,12,24
,2013,010700238,,,,24,21,45
,2013,010700239,,,,11,18,29
,2013,010700239,,,,4,6,10
,2013,010700241,,,,4,1,5
,2013,010700242,,,,1,4,5
,2013,010700243,,,,5,1,6
,2013,010700244,,,,1,1,2
,2013,010700245,,,,7,10,17
,2013,010700245,,,,18,20,38
,2013,010700246,,,,17,28,45
,2013,010700246,,,,34,32,66
,2013,010700248,,,,3,2,5
,2013,010700248,,,,37,32,69
,2013,010700250,,,,0,1,1
,2013,010700251,,,,2,1,3
,2013,010700252,,,,0,4,4
,2013,010700253,,,,1,1,2
,2013,010700254,,,,7,0,7
,2013,010700255,,,,4,0,4
,2013,010700257,,,,6,8,14
,2013,010700258,,,,2,0,2
,2013,010700282,,,,18,35,53
,2013,010700283,,,,94,165,259
,2013,010800001,,,,9,3,12
,2013,010800002,,,,20,21,41
,2013,010800003,,,,16,25,41
,2013,010800004,,,,24,19,43
,2013,010800005,,,,20,28,48
,2013,010800006,,,,50,47,97
,2013,010800007,,,,171,153,324
,2013,010800008,,,,16,16,32
,2013,010800009,,,,18,13,31
,2013,010800010,,,,11,10,21
,2013,010800011,,,,15,14,29
,2013,010800012,,,,15,8,23
,2013,010800013,,,,20,21,41
,2013,010800014,,,,234,219,453
,2013,010800015,,,,22,21,43
,2013,010800016,,,,184,159,343
,2013,010800017,,,,130,159,289
,2013,010800018,,,,80,85,165
,2013,010800019,,,,36,44,80
,2013,010800020,,,,99,105,204
,2013,010800021,,,,122,127,249
,2013,010800022,,,,33,17,50
,2013,010800023,,,,115,119,234
,2013,010800024,,,,100,119,219
,2013,010800025,,,,43,29,72
,2013,010800026,,,,15,14,29
,2013,010800027,,,,55,63,118
,2013,010800029,,,,27,23,50
,2013,010800030,,,,13,20,33
,2013,010800031,,,,120,103,223
,2013,010800032,,,,11,16,27
,2013,010800033,,,,19,22,41
,2013,010800034,,,,36,29,65
,2013,010800035,,,,7,8,15
,2013,010800036,,,,14,10,24
,2013,010800037,,,,19,30,49
,2013,010800038,,,,13,11,24
,2013,010800039,,,,10,12,22
,2013,010800040,,,,148,230,378
,2013,010800040,,,,30,47,77
,2013,010800041,,,,128,164,292
,2013,010800042,,,,106,141,247
,2013,010800042,,,,55,65,120
,2013,010800043,,,,174,291,465
,2013,010800044,,,,16,8,24
,2013,010800045,,,,10,8,18
,2013,010800046,,,,11,7,18
,2013,010800047,,,,9,6,15
,2013,010800048,,,,3,11,14
,2013,010800049,,,,8,4,12
,2013,010800050,,,,17,15,32
,2013,010800052,,,,2,2,4
,2013,010800053,,,,7,8,15
,2013,010800056,,,,20,20,40
,2013,010800057,,,,15,17,32
,2013,010800059,,,,8,8,16
,2013,010800060,,,,13,9,22
,2013,010800061,,,,10,7,17
,2013,010800062,,,,4,3,7
,2013,010800063,,,,6,9,15
,2013,010800064,,,,8,8,16
,2013,010800065,,,,20,20,40
,2013,010800066,,,,4,0,4
,2013,010800067,,,,4,3,7
,2013,010800068,,,,1,5,6
,2013,010800069,,,,6,5,11
,2013,010800070,,,,4,5,9
,2013,010800071,,,,6,3,9
,2013,010800072,,,,9,6,15
,2013,010800073,,,,6,10,16
,2013,010800075,,,,2,3,5
,2013,010800076,,,,1,3,4
,2013,010800077,,,,3,0,3
,2013,010800081,,,,0,4,4
,2013,010800082,,,,1,2,3
,2013,010800084,,,,3,4,7
,2013,010800085,,,,4,4,8
,2013,010800087,,,,11,24,35
,2013,020100001,,,,53,73,126
,2013,020100002,,,,116,92,208
,2013,020100004,,,,25,26,51
,2013,020100005,,,,53,42,95
,2013,020100006,,,,28,25,53
,2013,020100007,,,,42,32,74
,2013,020100008,,,,41,47,88
,2013,020100009,,,,14,19,33
,2013,020100010,,,,46,34,80
,2013,020100011,,,,54,47,101
,2013,020100012,,,,104,89,193
,2013,020100013,,,,90,99,189
,2013,020100014,,,,60,54,114
,2013,020100015,,,,166,132,298
,2013,020100016,,,,202,164,366
,2013,020100017,,,,46,49,95
,2013,020100018,,,,99,90,189
,2013,020100019,,,,39,42,81
,2013,020100020,,,,58,49,107
,2013,020100021,,,,55,31,86
,2013,020100022,,,,42,53,95
,2013,020100023,,,,148,112,260
,2013,020100024,,,,40,31,71
,2013,020100025,,,,27,21,48
,2013,020100026,,,,71,46,117
,2013,020100027,,,,69,60,129
,2013,020100028,,,,39,22,61
,2013,020100029,,,,52,26,78
,2013,020100030,,,,34,26,60
,2013,020100031,,,,29,27,56
,2013,020100032,,,,61,54,115
,2013,020100033,,,,40,50,90
,2013,020100034,,,,69,54,123
,2013,020100035,,,,60,60,120
,2013,020100036,,,,19,17,36
,2013,020100037,,,,74,71,145
,2013,020100038,,,,172,182,354
,2013,020100039,,,,37,51,88
,2013,020100041,,,,190,214,404
,2013,020100042,,,,72,59,131
,2013,020100043,,,,268,250,518
,2013,020100044,,,,199,158,357
,2013,020100045,,,,9,19,28
,2013,020100046,,,,82,54,136
,2013,020100047,,,,3,2,5
,2013,020100047,,,,16,14,30
,2013,020100048,,,,40,33,73
,2013,020100048,,,,11,28,39
,2013,020100048,,,,9,5,14
,2013,020100049,,,,24,25,49
,2013,020100049,,,,7,14,21
,2013,020100050,,,,19,15,34
,2013,020100051,,,,342,335,677
,2013,020100052,,,,1,4,5
,2013,020100054,,,,83,86,169
,2013,020100055,,,,10,14,24
,2013,020100057,,,,50,35,85
,2013,020100058,,,,16,11,27
,2013,020100058,,,,99,92,191
,2013,020100058,,,,33,68,101
,2013,020100059,,,,213,174,387
,2013,020100060,,,,163,165,328
,2013,020100061,,,,37,37,74
,2013,020100062,,,,23,22,45
,2013,020100063,,,,12,8,20
,2013,020100064,,,,53,30,83
,2013,020100065,,,,36,46,82
,2013,020100066,,,,10,14,24
,2013,020100067,,,,20,13,33
,2013,020100068,,,,13,10,23
,2013,020100069,,,,24,35,59
,2013,020100071,,,,54,48,102
,2013,020100072,,,,21,23,44
,2013,020100073,,,,21,14,35
,2013,020100074,,,,9,5,14
,2013,020100075,,,,24,12,36
,2013,020100076,,,,5,4,9
,2013,020100077,,,,13,14,27
,2013,020100078,,,,7,5,12
,2013,020100079,,,,13,7,20
,2013,020100080,,,,20,18,38
,2013,020100081,,,,7,13,20
,2013,020100083,,,,16,25,41
,2013,020100084,,,,19,24,43
,2013,020100086,,,,16,23,39
,2013,020100087,,,,14,12,26
,2013,020100089,,,,26,25,51
,2013,020100090,,,,37,25,62
,2013,020100091,,,,27,24,51
,2013,020100092,,,,277,708,985
,2013,020100092,,,,76,122,198
,2013,020100093,,,,253,296,549
,2013,020100094,,,,703,660,1363
,2013,020100094,,,,85,138,223
,2013,020100095,,,,215,247,462
,2013,020100096,,,,24,23,47
,2013,020100097,,,,10,9,19
,2013,020100098,,,,9,15,24
,2013,020100099,,,,7,10,17
,2013,020100100,,,,4,12,16
,2013,020100101,,,,10,12,22
,2013,020100102,,,,41,41,82
,2013,020100103,,,,9,13,22
,2013,020100104,,,,33,20,53
,2013,020100105,,,,95,96,191
,2013,020100106,,,,20,18,38
,2013,020100108,,,,54,53,107
,2013,020100109,,,,16,14,30
,2013,020100110,,,,163,167,330
,2013,020100111,,,,13,7,20
,2013,020100112,,,,5,4,9
,2013,020100113,,,,35,42,77
,2013,020100114,,,,7,8,15
,2013,020100115,,,,11,9,20
,2013,020100116,,,,9,5,14
,2013,020100117,,,,38,31,69
,2013,020100118,,,,11,14,25
,2013,020100119,,,,38,28,66
,2013,020100120,,,,51,49,100
,2013,020100122,,,,4,11,15
,2013,020100122,,,,44,35,79
,2013,020100123,,,,80,169,249
,2013,020100124,,,,10,15,25
,2013,020100125,,,,9,5,14
,2013,020100126,,,,5,6,11
,2013,020100127,,,,7,10,17
,2013,020100148,,,,48,44,92
,2013,020100148,,,,8,7,15
,2013,020100153,,,,2,7,9
,2013,020100155,,,,3,4,7
,2013,020100159,,,,5,10,15
,2013,020100160,,,,4,7,11
,2013,020100161,,,,7,6,13
,2013,020100163,,,,11,14,25
,2013,020100164,,,,6,4,10
,2013,020100165,,,,10,10,20
,2013,020100165,,,,13,20,33
,2013,020100167,,,,1,10,11
,2013,020100168,,,,4,7,11
,2013,020100170,,,,5,10,15
,2013,020100171,,,,4,4,8
,2013,020100172,,,,4,9,13
,2013,020100175,,,,11,13,24
,2013,020100176,,,,12,13,25
,2013,020100180,,,,6,5,11
,2013,020100181,,,,2,4,6
,2013,020100182,,,,43,42,85
,2013,020100183,,,,6,10,16
,2013,020100184,,,,8,7,15
,2013,020100184,,,,49,41,90
,2013,020100185,,,,19,24,43
,2013,020100186,,,,33,68,101
,2013,020100188,,,,16,14,30
,2013,020100189,,,,5,4,9
,2013,020100190,,,,23,20,43
,2013,020100191,,,,41,29,70
,2013,020100192,,,,5,11,16
,2013,020100193,,,,9,11,20
,2013,020100195,,,,29,16,45
,2013,020100197,,,,7,5,12
,2013,020100200,,,,13,13,26
,2013,020100202,,,,5,13,18
,2013,020100202,,,,19,21,40
,2013,020100203,,,,27,23,50
,2013,020100203,,,,21,43,64
,2013,020100203,,,,3,6,9
,2013,020100204,,,,5,6,11
,2013,020100204,,,,21,8,29
,2013,020100205,,,,13,12,25
,2013,020100206,,,,7,7,14
,2013,020100207,,,,6,8,14
,2013,020100208,,,,2,9,11
,2013,020100209,,,,3,7,10
,2013,020100210,,,,60,53,113
,2013,020100211,,,,3,7,10
,2013,020100212,,,,18,15,33
,2013,020100213,,,,48,53,101
,2013,020100214,,,,7,4,11
,2013,020100215,,,,19,7,26
,2013,020100217,,,,9,8,17
,2013,020100218,,,,7,12,19
,2013,020100219,,,,7,5,12
,2013,020100220,,,,3,5,8
,2013,020100221,,,,7,3,10
,2013,020100221,,,,128,265,393
,2013,020100244,,,,73,66,139
,2013,020200001,,,,108,98,206
,2013,020200002,,,,31,24,55
,2013,020200003,,,,25,22,47
,2013,020200004,,,,124,104,228
,2013,020200005,,,,6,5,11
,2013,020200006,,,,20,15,35
,2013,020200007,,,,22,16,38
,2013,020200008,,,,116,108,224
,2013,020200009,,,,46,40,86
,2013,020200010,,,,13,14,27
,2013,020200011,,,,61,84,145
,2013,020200012,,,,36,33,69
,2013,020200013,,,,129,126,255
,2013,020200014,,,,59,76,135
,2013,020200015,,,,94,73,167
,2013,020200016,,,,31,19,50
,2013,020200017,,,,18,16,34
,2013,020200018,,,,11,8,19
,2013,020200019,,,,23,14,37
,2013,020200020,,,,13,4,17
,2013,020200021,,,,25,18,43
,2013,020200022,,,,6,9,15
,2013,020200023,,,,137,185,322
,2013,020200024,,,,105,92,197
,2013,020200025,,,,1,4,5
,2013,020200025,,,,18,18,36
,2013,020200026,,,,2,5,7
,2013,020200027,,,,17,13,30
,2013,020200028,,,,7,10,17
,2013,020200030,,,,10,19,29
,2013,020200031,,,,7,14,21
,2013,020200032,,,,2,9,11
,2013,020200033,,,,19,16,35
,2013,020200034,,,,17,17,34
,2013,020200035,,,,35,39,74
,2013,020200036,,,,40,43,83
,2013,020200037,,,,10,7,17
,2013,020200039,,,,18,10,28
,2013,020200040,,,,6,7,13
,2013,020200041,,,,17,7,24
,2013,020200042,,,,12,10,22
,2013,020200043,,,,19,16,35
,2013,020200044,,,,9,13,22
,2013,020200045,,,,7,3,10
,2013,020200046,,,,10,6,16
,2013,020200047,,,,17,14,31
,2013,020200048,,,,32,22,54
,2013,020200064,,,,2,1,3
,2013,020200068,,,,2,4,6
,2013,020200069,,,,4,2,6
,2013,020200070,,,,2,7,9
,2013,020200071,,,,2,3,5
,2013,020200072,,,,3,1,4
,2013,020200073,,,,2,1,3
,2013,020200074,,,,5,4,9
,2013,020200076,,,,11,14,25
,2013,020200077,,,,12,3,15
,2013,020200078,,,,12,13,25
,2013,020200079,,,,22,13,35
,2013,020200080,,,,3,5,8
,2013,020200081,,,,2,2,4
,2013,020200083,,,,0,4,4
,2013,020200084,,,,4,2,6
,2013,020200085,,,,0,3,3
,2013,020200086,,,,6,1,7
,2013,020200087,,,,2,2,4
,2013,020200088,,,,4,3,7
,2013,020200089,,,,1,3,4
,2013,020200090,,,,4,4,8
,2013,020200091,,,,2,2,4
,2013,020200092,,,,2,3,5
,2013,020200093,,,,2,3,5
,2013,020200094,,,,3,1,4
,2013,020200095,,,,3,6,9
,2013,020200096,,,,31,33,64
,2013,020200096,,,,3,8,11
,2013,020200096,,,,11,3,14
,2013,020200097,,,,19,15,34
,2013,020200098,,,,2,5,7
,2013,020200101,,,,12,9,21
,2013,020200103,,,,3,2,5
,2013,020200104,,,,2,6,8
,2013,020300001,,,,183,165,348
,2013,020300002,,,,35,20,55
,2013,020300003,,,,93,80,173
,2013,020300004,,,,17,30,47
,2013,020300005,,,,22,12,34
,2013,020300006,,,,14,28,42
,2013,020300007,,,,27,30,57
,2013,020300008,,,,37,39,76
,2013,020300009,,,,80,67,147
,2013,020300010,,,,110,74,184
,2013,020300011,,,,136,104,240
,2013,020300012,,,,167,158,325
,2013,020300013,,,,131,113,244
,2013,020300014,,,,153,119,272
,2013,020300015,,,,220,166,386
,2013,020300016,,,,105,130,235
,2013,020300017,,,,28,17,45
,2013,020300018,,,,32,26,58
,2013,020300019,,,,17,15,32
,2013,020300020,,,,54,66,120
,2013,020300021,,,,21,11,32
,2013,020300022,,,,40,23,63
,2013,020300023,,,,33,16,49
,2013,020300024,,,,23,27,50
,2013,020300025,,,,51,37,88
,2013,020300026,,,,19,17,36
,2013,020300027,,,,13,14,27
,2013,020300029,,,,20,19,39
,2013,020300030,,,,22,16,38
,2013,020300031,,,,22,18,40
,2013,020300032,,,,39,36,75
,2013,020300033,,,,42,35,77
,2013,020300034,,,,42,38,80
,2013,020300035,,,,23,18,41
,2013,020300036,,,,10,10,20
,2013,020300037,,,,13,9,22
,2013,020300038,,,,7,7,14
,2013,020300039,,,,13,10,23
,2013,020300040,,,,66,86,152
,2013,020300041,,,,76,80,156
,2013,020300042,,,,7,17,24
,2013,020300043,,,,10,10,20
,2013,020300044,,,,16,7,23
,2013,020300044,,,,47,25,72
,2013,020300046,,,,5,10,15
,2013,020300047,,,,23,21,44
,2013,020300048,,,,18,13,31
,2013,020300049,,,,14,24,38
,2013,020300050,,,,55,47,102
,2013,020300051,,,,12,12,24
,2013,020300053,,,,31,23,54
,2013,020300054,,,,24,14,38
,2013,020300055,,,,19,25,44
,2013,020300056,,,,23,18,41
,2013,020300057,,,,22,19,41
,2013,020300058,,,,20,20,40
,2013,020300059,,,,8,9,17
,2013,020300059,,,,12,19,31
,2013,020300060,,,,6,10,16
,2013,020300061,,,,8,11,19
,2013,020300061,,,,32,25,57
,2013,020300062,,,,28,16,44
,2013,020300063,,,,16,14,30
,2013,020300064,,,,22,13,35
,2013,020300065,,,,15,22,37
,2013,020300066,,,,19,20,39
,2013,020300072,,,,7,9,16
,2013,020300073,,,,11,10,21
,2013,020300074,,,,6,3,9
,2013,020300075,,,,7,11,18
,2013,020300076,,,,9,8,17
,2013,020300077,,,,11,5,16
,2013,020300078,,,,9,14,23
,2013,020300079,,,,10,6,16
,2013,020300084,,,,41,48,89
,2013,020300085,,,,10,10,20
,2013,020300091,,,,17,7,24
,2013,020300092,,,,28,28,56
,2013,020300093,,,,14,8,22
,2013,020300094,,,,4,7,11
,2013,020300096,,,,20,21,41
,2013,020300097,,,,25,25,50
,2013,020300098,,,,15,5,20
,2013,020300099,,,,10,12,22
,2013,020300100,,,,9,11,20
,2013,020300102,,,,10,10,20
,2013,020300104,,,,8,8,16
,2013,020300106,,,,12,7,19
,2013,020300108,,,,4,5,9
,2013,020400001,,,,62,81,143
,2013,020400002,,,,62,35,97
,2013,020400003,,,,33,30,63
,2013,020400004,,,,246,233,479
,2013,020400005,,,,200,198,398
,2013,020400006,,,,57,41,98
,2013,020400007,,,,42,55,97
,2013,020400008,,,,136,150,286
,2013,020400009,,,,26,28,54
,2013,020400011,,,,8,9,17
,2013,020400013,,,,74,63,137
,2013,020400014,,,,16,23,39
,2013,020400015,,,,65,102,167
,2013,020400016,,,,7,5,12
,2013,020400018,,,,8,10,18
,2013,020400020,,,,21,29,50
,2013,020400021,,,,90,88,178
,2013,020400023,,,,18,12,30
,2013,020400024,,,,13,18,31
,2013,020400025,,,,15,11,26
,2013,020400027,,,,37,35,72
,2013,020400028,,,,8,7,15
,2013,020400029,,,,12,9,21
,2013,020400030,,,,52,50,102
,2013,020400031,,,,14,11,25
,2013,020400033,,,,23,26,49
,2013,020400034,,,,11,4,15
,2013,020400045,,,,11,8,19
,2013,020400046,,,,11,13,24
,2013,020400047,,,,7,13,20
,2013,020400049,,,,5,5,10
,2013,020400051,,,,7,3,10
,2013,020400053,,,,5,5,10
,2013,020400054,,,,6,7,13
,2013,020400055,,,,48,55,103
,2013,020400056,,,,33,37,70
,2013,020400057,,,,13,13,26
,2013,020400058,,,,25,28,53
,2013,020400059,,,,26,15,41
,2013,020400059,,,,6,7,13
,2013,020400060,,,,7,23,30
,2013,020400061,,,,5,5,10
,2013,020400062,,,,6,8,14
,2013,020400063,,,,22,27,49
,2013,020400064,,,,9,7,16
,2013,020400066,,,,13,14,27
,2013,020400067,,,,30,40,70
,2013,020400068,,,,7,7,14
,2013,020400069,,,,5,5,10
,2013,020400070,,,,13,14,27
,2013,020400071,,,,7,7,14
,2013,020400072,,,,5,5,10
,2013,020400073,,,,16,13,29
,2013,020400074,,,,5,5,10
,2013,020400075,,,,37,67,104
,2013,020400077,,,,23,34,57
,2013,020500001,,,,21,19,40
,2013,020500004,,,,383,353,736
,2013,020500005,,,,8,13,21
,2013,020500005,,,,30,35,65
,2013,020500006,,,,25,32,57
,2013,020500007,,,,26,31,57
,2013,020500008,,,,122,129,251
,2013,020500009,,,,27,22,49
,2013,020500010,,,,48,36,84
,2013,020500011,,,,83,83,166
,2013,020500012,,,,116,117,233
,2013,020500014,,,,44,33,77
,2013,020500015,,,,61,59,120
,2013,020500016,,,,64,58,122
,2013,020500017,,,,47,35,82
,2013,020500017,,,,8,4,12
,2013,020500019,,,,151,146,297
,2013,020500020,,,,55,60,115
,2013,020500021,,,,122,126,248
,2013,020500022,,,,22,34,56
,2013,020500023,,,,7,17,24
,2013,020500024,,,,14,16,30
,2013,020500025,,,,19,17,36
,2013,020500026,,,,14,13,27
,2013,020500028,,,,237,235,472
,2013,020500029,,,,26,23,49
,2013,020500030,,,,6,14,20
,2013,020500031,,,,115,90,205
,2013,020500032,,,,16,12,28
,2013,020500033,,,,29,32,61
,2013,020500034,,,,29,26,55
,2013,020500035,,,,24,26,50
,2013,020500036,,,,107,142,249
,2013,020500037,,,,94,78,172
,2013,020500038,,,,61,53,114
,2013,020500040,,,,24,17,41
,2013,020500041,,,,97,83,180
,2013,020500042,,,,276,220,496
,2013,020500043,,,,15,17,32
,2013,020500045,,,,237,242,479
,2013,020500046,,,,18,15,33
,2013,020500047,,,,16,17,33
,2013,020500048,,,,174,195,369
,2013,020500049,,,,13,17,30
,2013,020500050,,,,747,829,1576
,2013,020500051,,,,25,30,55
,2013,020500051,,,,10,12,22
,2013,020500052,,,,87,99,186
,2013,020500053,,,,11,9,20
,2013,020500054,,,,14,16,30
,2013,020500055,,,,6,5,11
,2013,020500056,,,,55,49,104
,2013,020500057,,,,45,45,90
,2013,020500057,,,,25,15,40
,2013,020500057,,,,93,119,212
,2013,020500057,,,,83,125,208
,2013,020500058,,,,90,71,161
,2013,020500059,,,,7,8,15
,2013,020500062,,,,11,10,21
,2013,020500063,,,,4,4,8
,2013,020500064,,,,7,5,12
,2013,020500065,,,,9,5,14
,2013,020500067,,,,4,6,10
,2013,020500078,,,,24,24,48
,2013,020500079,,,,25,15,40
,2013,020500080,,,,15,0,15
,2013,020500081,,,,4,5,9
,2013,020500083,,,,12,9,21
,2013,020500084,,,,3,6,9
,2013,020500088,,,,7,7,14
,2013,020500089,,,,3,3,6
,2013,020500090,,,,12,15,27
,2013,020500090,,,,23,27,50
,2013,020500091,,,,40,50,90
,2013,020500093,,,,18,18,36
,2013,020500094,,,,10,9,19
,2013,020500096,,,,11,2,13
,2013,020500098,,,,5,4,9
,2013,020500099,,,,4,8,12
,2013,020500100,,,,4,1,5
,2013,020500102,,,,3,2,5
,2013,020500104,,,,12,5,17
,2013,020500105,,,,31,30,61
,2013,020500106,,,,62,55,117
,2013,020500106,,,,12,9,21
,2013,020500107,,,,9,11,20
,2013,020500108,,,,1,3,4
,2013,020500111,,,,173,264,437
,2013,020500113,,,,18,19,37
,2013,020500113,,,,11,17,28
,2013,020600002,,,,16,11,27
,2013,020600003,,,,15,20,35
,2013,020600004,,,,19,17,36
,2013,020600005,,,,33,39,72
,2013,020600006,,,,60,43,103
,2013,020600007,,,,33,28,61
,2013,020600008,,,,37,39,76
,2013,020600009,,,,12,12,24
,2013,020600010,,,,46,24,70
,2013,020600011,,,,98,138,236
,2013,020600012,,,,44,42,86
,2013,020600013,,,,17,14,31
,2013,020600014,,,,44,33,77
,2013,020600015,,,,111,96,207
,2013,020600016,,,,35,34,69
,2013,020600017,,,,9,13,22
,2013,020600018,,,,46,29,75
,2013,020600019,,,,5,4,9
,2013,020600020,,,,3,6,9
,2013,020600021,,,,10,8,18
,2013,020600022,,,,5,1,6
,2013,020600023,,,,4,11,15
,2013,020600024,,,,5,7,12
,2013,020600037,,,,14,17,31
,2013,020600042,,,,4,2,6
,2013,020600043,,,,4,2,6
,2013,020600044,,,,2,5,7
,2013,020600045,,,,5,2,7
,2013,020600046,,,,4,8,12
,2013,020600047,,,,7,6,13
,2013,020600048,,,,4,6,10
,2013,020600049,,,,8,1,9
,2013,020600050,,,,9,7,16
,2013,020600051,,,,9,1,10
,2013,020600052,,,,4,6,10
,2013,020600053,,,,5,6,11
,2013,020600054,,,,8,6,14
,2013,020600055,,,,4,2,6
,2013,020600056,,,,3,5,8
,2013,020700001,,,,54,49,103
,2013,020700002,,,,94,55,149
,2013,020700004,,,,53,107,160
,2013,020700005,,,,231,240,471
,2013,020700006,,,,22,23,45
,2013,020700008,,,,21,26,47
,2013,020700009,,,,17,19,36
,2013,020700010,,,,90,73,163
,2013,020700011,,,,28,36,64
,2013,020700013,,,,9,9,18
,2013,020700014,,,,58,47,105
,2013,020700015,,,,7,13,20
,2013,020700028,,,,15,16,31
,2013,020700028,,,,15,16,31
,2013,020700029,,,,6,13,19
,2013,020700030,,,,6,4,10
,2013,020700031,,,,4,11,15
,2013,020700031,,,,4,11,15
,2013,020700032,,,,13,9,22
,2013,020700032,,,,13,9,22
,2013,020700033,,,,11,16,27
,2013,020700034,,,,5,7,12
,2013,020700035,,,,5,4,9
,2013,020800001,,,,21,13,34
,2013,020800002,,,,42,52,94
,2013,020800003,,,,83,83,166
,2013,020800004,,,,43,48,91
,2013,020800005,,,,67,56,123
,2013,020800006,,,,74,68,142
,2013,020800007,,,,17,11,28
,2013,020800008,,,,21,18,39
,2013,020800009,,,,34,28,62
,2013,020800010,,,,53,63,116
,2013,020800012,,,,81,77,158
,2013,020800013,,,,28,20,48
,2013,020800014,,,,29,38,67
,2013,020800015,,,,70,84,154
,2013,020800016,,,,14,12,26
,2013,020800017,,,,27,25,52
,2013,020800018,,,,56,60,116
,2013,020800020,,,,42,39,81
,2013,020800022,,,,36,18,54
,2013,020800023,,,,16,11,27
,2013,020800024,,,,40,43,83
,2013,020800025,,,,167,200,367
,2013,020800026,,,,17,28,45
,2013,020800027,,,,46,42,88
,2013,020800028,,,,97,106,203
,2013,020800029,,,,54,45,99
,2013,020800030,,,,24,30,54
,2013,020800031,,,,57,57,114
,2013,020800032,,,,20,17,37
,2013,020800033,,,,77,60,137
,2013,020800034,,,,31,29,60
,2013,020800036,,,,29,23,52
,2013,020800037,,,,20,21,41
,2013,020800039,,,,22,23,45
,2013,020800041,,,,23,26,49
,2013,020800042,,,,24,30,54
,2013,020800044,,,,76,84,160
,2013,020800045,,,,76,63,139
,2013,020800046,,,,39,25,64
,2013,020800047,,,,83,70,153
,2013,020800048,,,,37,39,76
,2013,020800050,,,,16,21,37
,2013,020800055,,,,1,0,1
,2013,020800057,,,,17,10,27
,2013,020800057,,,,25,28,53
,2013,020800061,,,,17,8,25
,2013,020800063,,,,730,806,1536
,2013,020800064,,,,42,50,92
,2013,020800068,,,,17,11,28
,2013,020800073,,,,92,98,190
,2013,020800074,,,,105,73,178
,2013,020800076,,,,15,16,31
,2013,020800077,,,,8,11,19
,2013,020800079,,,,4,7,11
,2013,020800081,,,,26,6,32
,2013,020800082,,,,25,40,65
,2013,020800082,,,,18,11,29
,2013,020800083,,,,1,7,8
,2013,020800083,,,,5,3,8
,2013,020800087,,,,11,15,26
,2013,020800088,,,,13,12,25
,2013,020800088,,,,8,7,15
,2013,020800089,,,,19,12,31
,2013,020800090,,,,7,7,14
,2013,020800092,,,,9,7,16
,2013,020800093,,,,25,26,51
,2013,020800093,,,,9,8,17
,2013,020800094,,,,23,11,34
,2013,020800096,,,,13,9,22
,2013,020800097,,,,7,3,10
,2013,020800098,,,,26,23,49
,2013,020800102,,,,13,8,21
,2013,020800103,,,,10,5,15
,2013,020800104,,,,7,10,17
,2013,020800106,,,,82,97,179
,2013,020800107,,,,11,29,40
,2013,020800107,,,,33,29,62
,2013,020800108,,,,18,25,43
,2013,020800109,,,,45,45,90
,2013,020800109,,,,48,42,90
,2013,020800109,,,,18,17,35
,2013,020800110,,,,26,19,45
,2013,020800111,,,,24,31,55
,2013,020800112,,,,4,5,9
,2013,020800114,,,,4,9,13
,2013,020800115,,,,27,14,41
,2013,020800120,,,,17,27,44
,2013,020800125,,,,7,5,12
,2013,020800126,,,,13,12,25
,2013,020800127,,,,13,17,30
,2013,020800128,,,,26,18,44
,2013,020800131,,,,3,5,8
,2013,020800132,,,,12,7,19
,2013,020800133,,,,4,2,6
,2013,020800134,,,,6,7,13
,2013,020800135,,,,7,7,14
,2013,020800136,,,,10,10,20
,2013,020800136,,,,10,10,20
,2013,020800137,,,,6,2,8
,2013,020800138,,,,3,3,6
,2013,020800139,,,,5,8,13
,2013,020800140,,,,13,13,26
,2013,020800141,,,,3,5,8
,2013,020800142,,,,4,5,9
,2013,020800143,,,,7,10,17
,2013,020800143,,,,11,14,25
,2013,020800145,,,,5,6,11
,2013,020800146,,,,5,5,10
,2013,020800147,,,,2,2,4
,2013,020800148,,,,4,9,13
,2013,020800149,,,,6,6,12
,2013,020800150,,,,3,7,10
,2013,020800151,,,,6,5,11
,2013,020800152,,,,15,15,30
,2013,020800153,,,,2,7,9
,2013,020800154,,,,3,4,7
,2013,020800155,,,,3,8,11
,2013,020800156,,,,4,6,10
,2013,020800157,,,,2,9,11
,2013,020800158,,,,27,34,61
,2013,020800159,,,,45,34,79
,2013,020800160,,,,6,7,13
,2013,020800161,,,,3,4,7
,2013,020800162,,,,4,4,8
,2013,020800163,,,,4,7,11
,2013,020800164,,,,15,22,37
,2013,020800165,,,,12,13,25
,2013,020800167,,,,13,10,23
,2013,020800168,,,,25,18,43
,2013,020800169,,,,15,9,24
,2013,020800170,,,,12,5,17
,2013,020800172,,,,10,5,15
,2013,020800174,,,,2,7,9
,2013,020800175,,,,7,5,12
,2013,020800176,,,,8,17,25
,2013,020800177,,,,11,6,17
,2013,020800178,,,,8,4,12
,2013,020800179,,,,4,4,8
,2013,020800180,,,,1,0,1
,2013,020800181,,,,4,1,5
,2013,020800182,,,,11,4,15
,2013,020800183,,,,2,4,6
,2013,020800184,,,,4,6,10
,2013,020800185,,,,5,3,8
,2013,020800186,,,,3,3,6
,2013,020800187,,,,4,5,9
,2013,020800188,,,,3,3,6
,2013,020800189,,,,3,5,8
,2013,020800190,,,,14,10,24
,2013,020800200,,,,82,160,242
,2013,020900001,,,,8,2,10
,2013,020900001,,,,32,27,59
,2013,020900002,,,,356,319,675
,2013,020900003,,,,62,48,110
,2013,020900004,,,,267,215,482
,2013,020900005,,,,133,122,255
,2013,020900007,,,,312,359,671
,2013,020900008,,,,318,343,661
,2013,020900009,,,,661,645,1306
,2013,020900010,,,,20,23,43
,2013,020900011,,,,101,88,189
,2013,020900012,,,,109,92,201
,2013,020900013,,,,33,28,61
,2013,020900014,,,,42,34,76
,2013,020900015,,,,39,36,75
,2013,020900016,,,,89,95,184
,2013,020900017,,,,76,74,150
,2013,020900018,,,,185,167,352
,2013,020900019,,,,226,249,475
,2013,020900020,,,,172,166,338
,2013,020900021,,,,127,151,278
,2013,020900022,,,,42,48,90
,2013,020900023,,,,70,82,152
,2013,020900024,,,,20,27,47
,2013,020900025,,,,36,45,81
,2013,020900026,,,,48,61,109
,2013,020900027,,,,61,77,138
,2013,020900028,,,,28,22,50
,2013,020900029,,,,29,36,65
,2013,020900030,,,,246,256,502
,2013,020900031,,,,60,45,105
,2013,020900032,,,,22,20,42
,2013,020900033,,,,43,34,77
,2013,020900034,,,,168,164,332
,2013,020900035,,,,88,72,160
,2013,020900036,,,,15,15,30
,2013,020900036,,,,84,80,164
,2013,020900037,,,,19,17,36
,2013,020900038,,,,190,204,394
,2013,020900039,,,,174,157,331
,2013,020900040,,,,21,16,37
,2013,020900041,,,,4,7,11
,2013,020900041,,,,44,40,84
,2013,020900042,,,,29,28,57
,2013,020900043,,,,14,11,25
,2013,020900044,,,,198,131,329
,2013,020900045,,,,6,1,7
,2013,020900045,,,,27,31,58
,2013,020900046,,,,23,19,42
,2013,020900047,,,,18,21,39
,2013,020900048,,,,9,9,18
,2013,020900049,,,,36,39,75
,2013,020900050,,,,222,233,455
,2013,020900051,,,,37,31,68
,2013,020900052,,,,7,8,15
,2013,020900052,,,,18,18,36
,2013,020900053,,,,9,5,14
,2013,020900054,,,,22,28,50
,2013,020900055,,,,106,105,211
,2013,020900056,,,,35,24,59
,2013,020900057,,,,28,30,58
,2013,020900058,,,,6,10,16
,2013,020900059,,,,31,20,51
,2013,020900060,,,,101,102,203
,2013,020900061,,,,43,44,87
,2013,020900062,,,,21,19,40
,2013,020900063,,,,25,19,44
,2013,020900064,,,,44,41,85
,2013,020900065,,,,17,13,30
,2013,020900066,,,,46,43,89
,2013,020900067,,,,15,14,29
,2013,020900068,,,,7,9,16
,2013,020900069,,,,12,6,18
,2013,020900070,,,,33,29,62
,2013,020900071,,,,26,35,61
,2013,020900072,,,,46,55,101
,2013,020900073,,,,1011,657,1668
,2013,020900074,,,,108,99,207
,2013,020900075,,,,192,228,420
,2013,020900076,,,,1233,1759,2992
,2013,020900078,,,,98,131,229
,2013,020900079,,,,15,14,29
,2013,020900080,,,,31,29,60
,2013,020900081,,,,11,17,28
,2013,020900083,,,,9,12,21
,2013,020900084,,,,14,13,27
,2013,020900085,,,,28,26,54
,2013,020900086,,,,49,45,94
,2013,020900087,,,,65,36,101
,2013,020900088,,,,15,16,31
,2013,020900089,,,,12,16,28
,2013,020900090,,,,49,48,97
,2013,020900091,,,,25,16,41
,2013,020900092,,,,30,21,51
,2013,020900093,,,,7,3,10
,2013,020900094,,,,16,12,28
,2013,020900095,,,,16,11,27
,2013,020900096,,,,9,10,19
,2013,020900097,,,,12,8,20
,2013,020900098,,,,8,8,16
,2013,020900099,,,,9,4,13
,2013,020900100,,,,20,22,42
,2013,020900101,,,,17,15,32
,2013,020900102,,,,15,24,39
,2013,020900103,,,,18,11,29
,2013,020900104,,,,12,13,25
,2013,020900104,,,,43,59,102
,2013,020900104,,,,36,44,80
,2013,020900104,,,,49,77,126
,2013,020900104,,,,16,14,30
,2013,020900106,,,,9,4,13
,2013,020900107,,,,203,204,407
,2013,020900108,,,,69,54,123
,2013,020900109,,,,17,23,40
,2013,020900109,,,,33,32,65
,2013,020900109,,,,54,68,122
,2013,020900110,,,,12,8,20
,2013,020900110,,,,12,8,20
,2013,020900111,,,,33,26,59
,2013,020900112,,,,14,15,29
,2013,020900113,,,,9,15,24
,2013,020900114,,,,10,10,20
,2013,020900115,,,,15,12,27
,2013,020900116,,,,66,228,294
,2013,020900117,,,,25,18,43
,2013,020900118,,,,24,23,47
,2013,020900119,,,,17,15,32
,2013,020900120,,,,14,9,23
,2013,020900121,,,,20,17,37
,2013,020900122,,,,84,75,159
,2013,020900122,,,,13,12,25
,2013,020900122,,,,84,108,192
,2013,020900123,,,,19,21,40
,2013,020900126,,,,111,119,230
,2013,020900127,,,,19,12,31
,2013,020900128,,,,13,6,19
,2013,020900129,,,,27,25,52
,2013,020900130,,,,30,24,54
,2013,020900131,,,,19,16,35
,2013,020900132,,,,11,12,23
,2013,020900133,,,,7,9,16
,2013,020900134,,,,9,9,18
,2013,020900135,,,,13,12,25
,2013,020900136,,,,3,3,6
,2013,020900137,,,,4,6,10
,2013,020900138,,,,7,0,7
,2013,020900139,,,,1,8,9
,2013,020900144,,,,318,343,661
,2013,020900172,,,,3,5,8
,2013,020900173,,,,3,6,9
,2013,020900175,,,,1,6,7
,2013,020900176,,,,5,2,7
,2013,020900177,,,,7,3,10
,2013,020900178,,,,3,5,8
,2013,020900179,,,,4,2,6
,2013,020900180,,,,4,4,8
,2013,020900181,,,,9,11,20
,2013,020900184,,,,13,23,36
,2013,020900185,,,,4,3,7
,2013,020900186,,,,12,18,30
,2013,020900186,,,,13,12,25
,2013,020900187,,,,13,9,22
,2013,020900188,,,,10,7,17
,2013,020900188,,,,16,15,31
,2013,020900189,,,,3,3,6
,2013,020900191,,,,1,4,5
,2013,020900192,,,,12,14,26
,2013,020900192,,,,22,17,39
,2013,020900192,,,,4,4,8
,2013,020900193,,,,19,19,38
,2013,020900193,,,,45,26,71
,2013,020900194,,,,4,4,8
,2013,020900196,,,,4,4,8
,2013,020900199,,,,6,3,9
,2013,020900201,,,,7,1,8
,2013,020900202,,,,16,9,25
,2013,020900202,,,,4,3,7
,2013,020900203,,,,6,2,8
,2013,020900206,,,,4,7,11
,2013,020900207,,,,7,3,10
,2013,020900210,,,,1,6,7
,2013,020900211,,,,12,4,16
,2013,020900212,,,,8,9,17
,2013,020900213,,,,3,3,6
,2013,020900214,,,,5,8,13
,2013,020900223,,,,18,25,43
,2013,020900223,,,,2,5,7
,2013,020900224,,,,11,15,26
,2013,020900227,,,,72,165,237
,2013,021000001,,,,210,209,419
,2013,021000002,,,,170,159,329
,2013,021000003,,,,309,302,611
,2013,021000004,,,,67,56,123
,2013,021000005,,,,15,11,26
,2013,021000006,,,,51,70,121
,2013,021000007,,,,21,22,43
,2013,021000008,,,,66,82,148
,2013,021000009,,,,22,20,42
,2013,021000010,,,,75,79,154
,2013,021000011,,,,29,19,48
,2013,021000012,,,,48,41,89
,2013,021000013,,,,109,163,272
,2013,021000014,,,,31,36,67
,2013,021000015,,,,13,24,37
,2013,021000016,,,,248,212,460
,2013,021000017,,,,25,14,39
,2013,021000018,,,,31,24,55
,2013,021000019,,,,13,13,26
,2013,021000020,,,,49,33,82
,2013,021000022,,,,45,46,91
,2013,021000023,,,,181,212,393
,2013,021000024,,,,13,16,29
,2013,021000025,,,,18,18,36
,2013,021000026,,,,4,6,10
,2013,021000027,,,,43,37,80
,2013,021000028,,,,10,3,13
,2013,021000029,,,,34,39,73
,2013,021000030,,,,23,14,37
,2013,021000031,,,,128,155,283
,2013,021000032,,,,9,5,14
,2013,021000035,,,,18,24,42
,2013,021000036,,,,17,11,28
,2013,021000038,,,,28,32,60
,2013,021000039,,,,33,42,75
,2013,021000040,,,,43,44,87
,2013,021000041,,,,31,28,59
,2013,021000042,,,,8,5,13
,2013,021000043,,,,9,21,30
,2013,021000044,,,,6,11,17
,2013,021000045,,,,14,16,30
,2013,021000046,,,,238,311,549
,2013,021000047,,,,63,63,126
,2013,021000048,,,,11,13,24
,2013,021000048,,,,5,0,5
,2013,021000049,,,,12,5,17
,2013,021000053,,,,4,13,17
,2013,021000054,,,,3,12,15
,2013,021000056,,,,14,7,21
,2013,021000057,,,,12,18,30
,2013,021000058,,,,11,10,21
,2013,021000059,,,,5,8,13
,2013,021000060,,,,8,10,18
,2013,021000061,,,,2,3,5
,2013,021000062,,,,10,7,17
,2013,021000063,,,,4,10,14
,2013,021000064,,,,20,18,38
,2013,021000066,,,,18,12,30
,2013,021000067,,,,16,13,29
,2013,021000068,,,,11,8,19
,2013,021000069,,,,34,20,54
,2013,021000070,,,,22,9,31
,2013,021000071,,,,9,16,25
,2013,021000072,,,,12,11,23
,2013,021000073,,,,20,20,40
,2013,021000074,,,,16,10,26
,2013,021000075,,,,23,22,45
,2013,021000076,,,,34,11,45
,2013,021000077,,,,22,23,45
,2013,021000078,,,,12,9,21
,2013,021000079,,,,15,30,45
,2013,021000080,,,,25,14,39
,2013,021000081,,,,12,13,25
,2013,021000082,,,,5,10,15
,2013,021000083,,,,32,36,68
,2013,021000084,,,,57,34,91
,2013,021000085,,,,12,7,19
,2013,021000086,,,,5,7,12
,2013,021000088,,,,5,13,18
,2013,021000094,,,,9,5,14
,2013,021000096,,,,27,23,50
,2013,021000100,,,,14,7,21
,2013,021000101,,,,24,9,33
,2013,021000103,,,,114,196,310
,2013,021000103,,,,114,196,310
,2013,021000104,,,,4,2,6
,2013,021000105,,,,6,2,8
,2013,021000106,,,,4,2,6
,2013,021000107,,,,3,3,6
,2013,021000109,,,,7,10,17
,2013,021000110,,,,7,5,12
,2013,021000123,,,,6,7,13
,2013,021000124,,,,8,5,13
,2013,021000125,,,,9,7,16
,2013,021000126,,,,51,41,92
,2013,021000126,,,,5,4,9
,2013,021000127,,,,4,4,8
,2013,021000128,,,,3,4,7
,2013,021000131,,,,0,3,3
,2013,021000132,,,,4,1,5
,2013,021000133,,,,1,2,3
,2013,021000134,,,,4,5,9
,2013,021000135,,,,2,7,9
,2013,021000136,,,,4,3,7
,2013,021000137,,,,3,3,6
,2013,021000138,,,,3,3,6
,2013,021000139,,,,6,5,11
,2013,021000141,,,,6,5,11
,2013,021000143,,,,7,5,12
,2013,021000144,,,,5,6,11
,2013,021000144,,,,41,50,91
,2013,021000145,,,,16,10,26
,2013,021000146,,,,6,13,19
,2013,021000147,,,,4,3,7
,2013,021000148,,,,4,3,7
,2013,021000150,,,,4,5,9
,2013,021000151,,,,4,6,10
,2013,021000152,,,,2,4,6
,2013,021000153,,,,1,4,5
,2013,021000154,,,,2,2,4
,2013,021000155,,,,3,3,6
,2013,021000156,,,,2,4,6
,2013,021000157,,,,5,4,9
,2013,021000158,,,,2,2,4
,2013,021000159,,,,4,6,10
,2013,021000160,,,,3,3,6
,2013,021000161,,,,2,4,6
,2013,021000162,,,,5,2,7
,2013,021000163,,,,9,11,20
,2013,021000164,,,,5,4,9
,2013,021000165,,,,10,6,16
,2013,021000166,,,,5,10,15
,2013,021000167,,,,11,16,27
,2013,021000168,,,,3,9,12
,2013,021000168,,,,9,12,21
,2013,021000170,,,,72,51,123
,2013,021000171,,,,24,21,45
,2013,021000172,,,,11,7,18
,2013,021000175,,,,3,4,7
,2013,021000176,,,,2,3,5
,2013,021000177,,,,2,3,5
,2013,021000180,,,,8,3,11
,2013,021000180,,,,6,14,20
,2013,021000180,,,,0,1,1
,2013,030100002,,,,88,71,159
,2013,030100003,,,,10,10,20
,2013,030100004,,,,85,79,164
,2013,030100005,,,,32,21,53
,2013,030100006,,,,10,5,15
,2013,030100007,,,,118,116,234
,2013,030100008,,,,68,67,135
,2013,030100009,,,,116,133,249
,2013,030100010,,,,52,75,127
,2013,030100011,,,,74,70,144
,2013,030100012,,,,62,63,125
,2013,030100013,,,,35,33,68
,2013,030100014,,,,23,14,37
,2013,030100015,,,,37,41,78
,2013,030100016,,,,476,470,946
,2013,030100017,,,,480,320,800
,2013,030100018,,,,534,389,923
,2013,030100019,,,,272,162,434
,2013,030100020,,,,70,64,134
,2013,030100021,,,,95,74,169
,2013,030100022,,,,41,44,85
,2013,030100023,,,,55,49,104
,2013,030100024,,,,18,14,32
,2013,030100025,,,,56,55,111
,2013,030100026,,,,260,270,530
,2013,030100027,,,,10,22,32
,2013,030100028,,,,16,11,27
,2013,030100029,,,,39,27,66
,2013,030100030,,,,172,159,331
,2013,030100031,,,,33,20,53
,2013,030100032,,,,36,36,72
,2013,030100033,,,,54,59,113
,2013,030100034,,,,200,171,371
,2013,030100036,,,,73,69,142
,2013,030100037,,,,332,275,607
,2013,030100038,,,,68,56,124
,2013,030100039,,,,302,282,584
,2013,030100040,,,,41,38,79
,2013,030100041,,,,59,67,126
,2013,030100042,,,,113,89,202
,2013,030100043,,,,26,22,48
,2013,030100044,,,,40,46,86
,2013,030100045,,,,39,28,67
,2013,030100046,,,,32,35,67
,2013,030100047,,,,130,87,217
,2013,030100048,,,,12,3,15
,2013,030100049,,,,22,25,47
,2013,030100050,,,,21,18,39
,2013,030100050,,,,3,3,6
,2013,030100051,,,,43,40,83
,2013,030100052,,,,381,374,755
,2013,030100053,,,,16,12,28
,2013,030100054,,,,34,31,65
,2013,030100055,,,,233,240,473
,2013,030100056,,,,73,68,141
,2013,030100057,,,,18,26,44
,2013,030100057,,,,146,116,262
,2013,030100057,,,,71,114,185
,2013,030100058,,,,348,318,666
,2013,030100059,,,,23,26,49
,2013,030100060,,,,36,35,71
,2013,030100061,,,,31,30,61
,2013,030100062,,,,79,68,147
,2013,030100063,,,,45,50,95
,2013,030100064,,,,53,74,127
,2013,030100065,,,,26,21,47
,2013,030100066,,,,174,164,338
,2013,030100067,,,,69,88,157
,2013,030100068,,,,58,62,120
,2013,030100069,,,,42,23,65
,2013,030100069,,,,9,16,25
,2013,030100069,,,,47,27,74
,2013,030100070,,,,30,33,63
,2013,030100070,,,,328,301,629
,2013,030100071,,,,41,39,80
,2013,030100072,,,,32,31,63
,2013,030100073,,,,113,91,204
,2013,030100074,,,,51,54,105
,2013,030100076,,,,42,27,69
,2013,030100077,,,,27,30,57
,2013,030100078,,,,70,51,121
,2013,030100079,,,,54,61,115
,2013,030100079,,,,8,10,18
,2013,030100080,,,,47,51,98
,2013,030100081,,,,15,19,34
,2013,030100082,,,,45,32,77
,2013,030100083,,,,23,12,35
,2013,030100083,,,,101,82,183
,2013,030100084,,,,36,29,65
,2013,030100085,,,,41,19,60
,2013,030100086,,,,31,36,67
,2013,030100088,,,,24,18,42
,2013,030100089,,,,14,18,32
,2013,030100090,,,,20,32,52
,2013,030100091,,,,36,32,68
,2013,030100092,,,,42,37,79
,2013,030100093,,,,120,127,247
,2013,030100094,,,,56,50,106
,2013,030100095,,,,43,40,83
,2013,030100096,,,,61,67,128
,2013,030100097,,,,148,118,266
,2013,030100098,,,,39,51,90
,2013,030100099,,,,42,53,95
,2013,030100100,,,,0,48,48
,2013,030100101,,,,50,47,97
,2013,030100102,,,,36,28,64
,2013,030100103,,,,9,11,20
,2013,030100104,,,,11,20,31
,2013,030100105,,,,37,42,79
,2013,030100106,,,,31,31,62
,2013,030100107,,,,12,19,31
,2013,030100108,,,,38,39,77
,2013,030100109,,,,22,24,46
,2013,030100110,,,,51,52,103
,2013,030100111,,,,17,11,28
,2013,030100112,,,,157,116,273
,2013,030100113,,,,9,13,22
,2013,030100114,,,,10,12,22
,2013,030100115,,,,24,20,44
,2013,030100116,,,,85,93,178
,2013,030100116,,,,129,118,247
,2013,030100116,,,,73,71,144
,2013,030100117,,,,26,24,50
,2013,030100118,,,,15,18,33
,2013,030100118,,,,136,123,259
,2013,030100119,,,,12,8,20
,2013,030100120,,,,7,10,17
,2013,030100121,,,,18,14,32
,2013,030100122,,,,7,7,14
,2013,030100123,,,,16,10,26
,2013,030100124,,,,266,251,517
,2013,030100124,,,,25,13,38
,2013,030100125,,,,20,16,36
,2013,030100126,,,,13,7,20
,2013,030100127,,,,24,9,33
,2013,030100128,,,,5,10,15
,2013,030100129,,,,460,498,958
,2013,030100130,,,,1485,1883,3368
,2013,030100132,,,,54,57,111
,2013,030100132,,,,16,26,42
,2013,030100134,,,,6,16,22
,2013,030100135,,,,17,24,41
,2013,030100135,,,,33,51,84
,2013,030100136,,,,6,3,9
,2013,030100136,,,,22,27,49
,2013,030100137,,,,2,2,4
,2013,030100137,,,,18,15,33
,2013,030100138,,,,60,54,114
,2013,030100140,,,,11,5,16
,2013,030100141,,,,8,8,16
,2013,030100142,,,,8,14,22
,2013,030100143,,,,13,9,22
,2013,030100144,,,,4,8,12
,2013,030100146,,,,9,12,21
,2013,030100147,,,,16,21,37
,2013,030100148,,,,15,8,23
,2013,030100150,,,,29,27,56
,2013,030100151,,,,42,25,67
,2013,030100152,,,,7,7,14
,2013,030100153,,,,13,7,20
,2013,030100154,,,,5,7,12
,2013,030100155,,,,8,9,17
,2013,030100156,,,,9,13,22
,2013,030100158,,,,92,117,209
,2013,030100158,,,,46,67,113
,2013,030100158,,,,77,88,165
,2013,030100159,,,,115,85,200
,2013,030100159,,,,12,19,31
,2013,030100160,,,,125,111,236
,2013,030100161,,,,0,668,668
,2013,030100162,,,,17,6,23
,2013,030100163,,,,15,5,20
,2013,030100164,,,,13,3,16
,2013,030100165,,,,8,7,15
,2013,030100165,,,,3,3,6
,2013,030100166,,,,21,14,35
,2013,030100168,,,,13,5,18
,2013,030100169,,,,57,59,116
,2013,030100170,,,,14,14,28
,2013,030100171,,,,27,17,44
,2013,030100173,,,,133,128,261
,2013,030100175,,,,412,573,985
,2013,030100176,,,,315,722,1037
,2013,030100178,,,,9,6,15
,2013,030100178,,,,22,13,35
,2013,030100179,,,,141,209,350
,2013,030100182,,,,14,9,23
,2013,030100182,,,,6,10,16
,2013,030100183,,,,17,19,36
,2013,030100183,,,,3,12,15
,2013,030100184,,,,12,8,20
,2013,030100185,,,,11,10,21
,2013,030100186,,,,9,6,15
,2013,030100188,,,,26,19,45
,2013,030100191,,,,28,36,64
,2013,030100192,,,,11,5,16
,2013,030100192,,,,22,23,45
,2013,030100194,,,,33,42,75
,2013,030100195,,,,14,16,30
,2013,030100196,,,,13,19,32
,2013,030100199,,,,10,11,21
,2013,030100200,,,,19,21,40
,2013,030100201,,,,708,239,947
,2013,030100202,,,,15,18,33
,2013,030100203,,,,66,70,136
,2013,030100203,,,,14,8,22
,2013,030100204,,,,20,29,49
,2013,030100204,,,,91,89,180
,2013,030100204,,,,29,35,64
,2013,030100204,,,,29,35,64
,2013,030100206,,,,3,7,10
,2013,030100207,,,,5,4,9
,2013,030100209,,,,15,9,24
,2013,030100211,,,,9,12,21
,2013,030100212,,,,11,21,32
,2013,030100213,,,,13,20,33
,2013,030100216,,,,126,88,214
,2013,030100218,,,,22,25,47
,2013,030100218,,,,22,24,46
,2013,030100218,,,,345,618,963
,2013,030100218,,,,77,124,201
,2013,030100219,,,,349,509,858
,2013,030100219,,,,11,15,26
,2013,030100219,,,,7,5,12
,2013,030100220,,,,45,42,87
,2013,030100221,,,,199,135,334
,2013,030100222,,,,22,20,42
,2013,030100224,,,,23,32,55
,2013,030100224,,,,13,26,39
,2013,030100225,,,,11,13,24
,2013,030100226,,,,3,8,11
,2013,030100227,,,,5,5,10
,2013,030100228,,,,9,6,15
,2013,030100229,,,,24,34,58
,2013,030100230,,,,5,5,10
,2013,030100232,,,,10,6,16
,2013,030100233,,,,7,9,16
,2013,030100234,,,,5,8,13
,2013,030100235,,,,4,4,8
,2013,030100244,,,,60,4,64
,2013,030100250,,,,251,329,580
,2013,030100251,,,,3,4,7
,2013,030100260,,,,4,4,8
,2013,030100260,,,,18,31,49
,2013,030100261,,,,11,11,22
,2013,030100262,,,,13,14,27
,2013,030100264,,,,28,24,52
,2013,030100264,,,,10,8,18
,2013,030100268,,,,9,8,17
,2013,030100269,,,,24,28,52
,2013,030100273,,,,5,10,15
,2013,030100275,,,,20,21,41
,2013,030100275,,,,3,8,11
,2013,030100278,,,,12,5,17
,2013,030100279,,,,20,9,29
,2013,030100280,,,,28,32,60
,2013,030100286,,,,1,1,2
,2013,030100289,,,,78,76,154
,2013,030100289,,,,177,350,527
,2013,030100289,,,,277,426,703
,2013,030100296,,,,52,50,102
,2013,030100297,,,,100,140,240
,2013,030100297,,,,92,110,202
,2013,030100297,,,,14,13,27
,2013,030100299,,,,36,44,80
,2013,030100302,,,,12,6,18
,2013,030100302,,,,21,26,47
,2013,030100302,,,,13,22,35
,2013,030100303,,,,17,26,43
,2013,030100304,,,,17,9,26
,2013,030100305,,,,10,13,23
,2013,030100305,,,,8,7,15
,2013,030100306,,,,17,22,39
,2013,030100306,,,,99,73,172
,2013,030100306,,,,10,16,26
,2013,030100307,,,,2,5,7
,2013,030100308,,,,7,3,10
,2013,030100309,,,,2,6,8
,2013,030100310,,,,2,3,5
,2013,030100313,,,,5,5,10
,2013,030100315,,,,3,4,7
,2013,030100316,,,,6,6,12
,2013,030100317,,,,6,10,16
,2013,030100317,,,,31,19,50
,2013,030100319,,,,8,16,24
,2013,030100320,,,,4,2,6
,2013,030100321,,,,4,4,8
,2013,030100322,,,,6,2,8
,2013,030100323,,,,9,8,17
,2013,030100329,,,,6,4,10
,2013,030100330,,,,4,5,9
,2013,030100331,,,,5,4,9
,2013,030100332,,,,3,3,6
,2013,030100333,,,,4,3,7
,2013,030100335,,,,11,7,18
,2013,030100336,,,,4,1,5
,2013,030100337,,,,5,8,13
,2013,030100337,,,,8,10,18
,2013,030100338,,,,15,16,31
,2013,030100339,,,,25,26,51
,2013,030100339,,,,38,30,68
,2013,030100340,,,,21,17,38
,2013,030100341,,,,2,6,8
,2013,030100342,,,,4,7,11
,2013,030100343,,,,3,3,6
,2013,030100346,,,,9,7,16
,2013,030100347,,,,2,6,8
,2013,030100348,,,,18,18,36
,2013,030100349,,,,3,4,7
,2013,030100350,,,,5,7,12
,2013,030100351,,,,6,2,8
,2013,030100353,,,,6,4,10
,2013,030100355,,,,2,3,5
,2013,030100356,,,,6,5,11
,2013,030100357,,,,4,5,9
,2013,030100357,,,,52,30,82
,2013,030100358,,,,2,3,5
,2013,030100359,,,,4,7,11
,2013,030100360,,,,106,100,206
,2013,030100363,,,,5,4,9
,2013,030100364,,,,35,26,61
,2013,030100364,,,,16,18,34
,2013,030100366,,,,3,6,9
,2013,030100367,,,,2,2,4
,2013,030100368,,,,3,3,6
,2013,030100369,,,,7,8,15
,2013,030100370,,,,3,11,14
,2013,030100371,,,,5,11,16
,2013,030100372,,,,2,6,8
,2013,030100373,,,,45,25,70
,2013,030100374,,,,4,3,7
,2013,030100375,,,,11,25,36
,2013,030100376,,,,6,6,12
,2013,030100377,,,,5,7,12
,2013,030100378,,,,5,7,12
,2013,030100379,,,,8,8,16
,2013,030100380,,,,5,5,10
,2013,030100381,,,,2,6,8
,2013,030100382,,,,2,4,6
,2013,030100383,,,,6,2,8
,2013,030100384,,,,8,6,14
,2013,030100385,,,,3,7,10
,2013,030100386,,,,3,4,7
,2013,030100387,,,,8,3,11
,2013,030100388,,,,8,3,11
,2013,030100389,,,,4,4,8
,2013,030100390,,,,6,3,9
,2013,030100391,,,,8,7,15
,2013,030100392,,,,4,7,11
,2013,030100393,,,,5,11,16
,2013,030100394,,,,19,16,35
,2013,030100395,,,,21,21,42
,2013,030100395,,,,60,49,109
,2013,030100396,,,,4,7,11
,2013,030100397,,,,349,509,858
,2013,030100397,,,,5,7,12
,2013,030100397,,,,55,39,94
,2013,030100398,,,,6,7,13
,2013,030100399,,,,10,7,17
,2013,030100404,,,,6,4,10
,2013,030100404,,,,2,1,3
,2013,030100448,,,,27,13,40
,2013,030200001,,,,51,35,86
,2013,030200002,,,,46,58,104
,2013,030200003,,,,21,13,34
,2013,030200004,,,,31,28,59
,2013,030200005,,,,18,18,36
,2013,030200006,,,,85,76,161
,2013,030200007,,,,78,64,142
,2013,030200008,,,,209,174,383
,2013,030200009,,,,173,164,337
,2013,030200010,,,,6,16,22
,2013,030200011,,,,40,19,59
,2013,030200012,,,,17,19,36
,2013,030200013,,,,19,16,35
,2013,030200014,,,,7,10,17
,2013,030200015,,,,58,52,110
,2013,030200016,,,,30,42,72
,2013,030200017,,,,13,10,23
,2013,030200018,,,,367,420,787
,2013,030200019,,,,22,19,41
,2013,030200020,,,,5,8,13
,2013,030200020,,,,14,17,31
,2013,030200021,,,,5,12,17
,2013,030200022,,,,7,9,16
,2013,030200023,,,,16,10,26
,2013,030200027,,,,8,4,12
,2013,030200028,,,,7,8,15
,2013,030200029,,,,18,16,34
,2013,030200030,,,,4,1,5
,2013,030200032,,,,5,3,8
,2013,030200034,,,,8,10,18
,2013,030200035,,,,3,6,9
,2013,030200036,,,,10,7,17
,2013,030200037,,,,3,5,8
,2013,030200038,,,,3,4,7
,2013,030200039,,,,8,8,16
,2013,030300001,,,,15,15,30
,2013,030300001,,,,104,115,219
,2013,030300002,,,,50,57,107
,2013,030300003,,,,6,11,17
,2013,030300004,,,,132,133,265
,2013,030300005,,,,118,166,284
,2013,030300006,,,,38,33,71
,2013,030300007,,,,29,30,59
,2013,030300008,,,,136,148,284
,2013,030300009,,,,239,255,494
,2013,030300010,,,,38,30,68
,2013,030300011,,,,26,39,65
,2013,030300012,,,,64,68,132
,2013,030300013,,,,54,58,112
,2013,030300014,,,,29,25,54
,2013,030300015,,,,30,23,53
,2013,030300016,,,,34,45,79
,2013,030300017,,,,8,10,18
,2013,030300018,,,,13,26,39
,2013,030300019,,,,13,15,28
,2013,030300020,,,,52,60,112
,2013,030300021,,,,19,13,32
,2013,030300022,,,,28,20,48
,2013,030300023,,,,47,77,124
,2013,030300024,,,,61,47,108
,2013,030300025,,,,38,39,77
,2013,030300026,,,,19,16,35
,2013,030300027,,,,94,100,194
,2013,030300027,,,,8,8,16
,2013,030300029,,,,25,16,41
,2013,030300030,,,,43,45,88
,2013,030300031,,,,28,48,76
,2013,030300032,,,,11,15,26
,2013,030300033,,,,16,25,41
,2013,030300034,,,,21,17,38
,2013,030300035,,,,12,9,21
,2013,030300036,,,,31,19,50
,2013,030300037,,,,24,16,40
,2013,030300038,,,,40,33,73
,2013,030300039,,,,192,160,352
,2013,030300040,,,,159,173,332
,2013,030300041,,,,19,18,37
,2013,030300042,,,,27,41,68
,2013,030300043,,,,53,64,117
,2013,030300043,,,,8,6,14
,2013,030300044,,,,17,12,29
,2013,030300045,,,,5,6,11
,2013,030300046,,,,57,51,108
,2013,030300047,,,,4,9,13
,2013,030300048,,,,8,5,13
,2013,030300050,,,,17,19,36
,2013,030300051,,,,34,44,78
,2013,030300052,,,,244,209,453
,2013,030300053,,,,17,33,50
,2013,030300056,,,,4,10,14
,2013,030300058,,,,8,6,14
,2013,030300060,,,,14,9,23
,2013,030300067,,,,9,12,21
,2013,030300068,,,,4,9,13
,2013,030300069,,,,2,5,7
,2013,030300070,,,,5,5,10
,2013,030300071,,,,5,7,12
,2013,030300072,,,,16,9,25
,2013,030300073,,,,2,8,10
,2013,030300075,,,,4,5,9
,2013,030300077,,,,7,7,14
,2013,030300078,,,,8,7,15
,2013,030300079,,,,5,5,10
,2013,030300080,,,,4,16,20
,2013,030300081,,,,3,5,8
,2013,030300083,,,,12,10,22
,2013,030300084,,,,8,7,15
,2013,030300087,,,,4,2,6
,2013,030300088,,,,2,2,4
,2013,030300089,,,,7,7,14
,2013,030300091,,,,5,4,9
,2013,030300092,,,,9,1,10
,2013,030300094,,,,7,6,13
,2013,030300095,,,,2,8,10
,2013,030300096,,,,3,5,8
,2013,030300097,,,,11,6,17
,2013,030300098,,,,6,5,11
,2013,030300099,,,,8,11,19
,2013,030300100,,,,38,24,62
,2013,030300102,,,,4,6,10
,2013,030300103,,,,7,5,12
,2013,030300104,,,,9,7,16
,2013,030300105,,,,3,6,9
,2013,030300110,,,,41,48,89
,2013,030400001,,,,123,128,251
,2013,030400002,,,,47,31,78
,2013,030400003,,,,188,201,389
,2013,030400003,,,,16,35,51
,2013,030400004,,,,2,3,5
,2013,030400004,,,,6,13,19
,2013,030400005,,,,87,88,175
,2013,030400005,,,,47,47,94
,2013,030400006,,,,6,5,11
,2013,030400006,,,,23,21,44
,2013,030400007,,,,20,24,44
,2013,030400008,,,,19,18,37
,2013,030400009,,,,26,27,53
,2013,030400010,,,,65,70,135
,2013,030400011,,,,30,20,50
,2013,030400012,,,,17,21,38
,2013,030400013,,,,75,78,153
,2013,030400014,,,,38,27,65
,2013,030400015,,,,37,31,68
,2013,030400015,,,,3,9,12
,2013,030400016,,,,15,15,30
,2013,030400017,,,,12,12,24
,2013,030400017,,,,34,60,94
,2013,030400018,,,,3,6,9
,2013,030400018,,,,22,20,42
,2013,030400019,,,,40,46,86
,2013,030400020,,,,18,17,35
,2013,030400021,,,,31,34,65
,2013,030400022,,,,21,16,37
,2013,030400022,,,,3,2,5
,2013,030400023,,,,18,16,34
,2013,030400024,,,,48,41,89
,2013,030400024,,,,4,2,6
,2013,030400025,,,,14,9,23
,2013,030400026,,,,21,23,44
,2013,030400027,,,,55,58,113
,2013,030400028,,,,10,11,21
,2013,030400028,,,,0,4,4
,2013,030400029,,,,17,21,38
,2013,030400031,,,,7,8,15
,2013,030400032,,,,25,18,43
,2013,030400032,,,,2,2,4
,2013,030400033,,,,13,19,32
,2013,030400033,,,,0,6,6
,2013,030400034,,,,32,34,66
,2013,030400035,,,,24,37,61
,2013,030400035,,,,5,8,13
,2013,030400036,,,,45,41,86
,2013,030400037,,,,20,22,42
,2013,030400039,,,,11,7,18
,2013,030400040,,,,121,109,230
,2013,030400042,,,,7,7,14
,2013,030400043,,,,14,11,25
,2013,030400043,,,,7,6,13
,2013,030400045,,,,10,8,18
,2013,030400046,,,,5,6,11
,2013,030400047,,,,6,12,18
,2013,030400048,,,,9,7,16
,2013,030400050,,,,13,13,26
,2013,030400053,,,,18,24,42
,2013,030400056,,,,22,20,42
,2013,030400057,,,,8,13,21
,2013,030400057,,,,4,2,6
,2013,030400059,,,,4,2,6
,2013,030400064,,,,2,2,4
,2013,030400065,,,,3,6,9
,2013,030400066,,,,21,21,42
,2013,030400067,,,,15,15,30
,2013,030400068,,,,23,17,40
,2013,030400068,,,,5,2,7
,2013,030400068,,,,2,3,5
,2013,030400069,,,,3,9,12
,2013,030400069,,,,29,20,49
,2013,030400071,,,,38,44,82
,2013,030400072,,,,6,3,9
,2013,030400073,,,,12,12,24
,2013,030400084,,,,21,15,36
,2013,030400085,,,,14,10,24
,2013,030400087,,,,3,6,9
,2013,030400090,,,,5,9,14
,2013,030400091,,,,2,3,5
,2013,030400092,,,,4,2,6
,2013,030400093,,,,4,5,9
,2013,030400094,,,,11,15,26
,2013,030400095,,,,7,7,14
,2013,030400096,,,,8,12,20
,2013,030400097,,,,5,5,10
,2013,030400098,,,,12,9,21
,2013,030400099,,,,2,3,5
,2013,030400100,,,,3,3,6
,2013,030400101,,,,2,5,7
,2013,030400102,,,,9,8,17
,2013,030400103,,,,2,3,5
,2013,030400104,,,,7,2,9
,2013,030500001,,,,4,12,16
,2013,030500001,,,,24,16,40
,2013,030500002,,,,77,79,156
,2013,030500003,,,,9,3,12
,2013,030500004,,,,10,7,17
,2013,030500006,,,,3,2,5
,2013,030500007,,,,7,8,15
,2013,030600001,,,,38,17,55
,2013,030600003,,,,99,107,206
,2013,030600004,,,,43,41,84
,2013,030600005,,,,45,24,69
,2013,030600006,,,,32,28,60
,2013,030600006,,,,6,6,12
,2013,030600007,,,,8,8,16
,2013,030600008,,,,4,12,16
,2013,030600009,,,,125,123,248
,2013,030600009,,,,5,9,14
,2013,030600010,,,,37,21,58
,2013,030600011,,,,22,11,33
,2013,030600012,,,,13,11,24
,2013,030600013,,,,44,32,76
,2013,030600013,,,,336,340,676
,2013,030600014,,,,10,8,18
,2013,030600015,,,,7,8,15
,2013,030600016,,,,25,17,42
,2013,030600017,,,,63,53,116
,2013,030600018,,,,38,23,61
,2013,030600019,,,,129,90,219
,2013,030600020,,,,50,57,107
,2013,030600021,,,,34,30,64
,2013,030600022,,,,29,34,63
,2013,030600023,,,,207,205,412
,2013,030600024,,,,37,38,75
,2013,030600025,,,,56,48,104
,2013,030600026,,,,21,19,40
,2013,030600027,,,,24,27,51
,2013,030600028,,,,6,11,17
,2013,030600029,,,,28,33,61
,2013,030600030,,,,35,29,64
,2013,030600031,,,,38,38,76
,2013,030600032,,,,38,26,64
,2013,030600033,,,,35,35,70
,2013,030600034,,,,68,76,144
,2013,030600035,,,,12,5,17
,2013,030600036,,,,35,32,67
,2013,030600037,,,,101,101,202
,2013,030600037,,,,18,23,41
,2013,030600038,,,,24,24,48
,2013,030600039,,,,12,6,18
,2013,030600040,,,,21,18,39
,2013,030600041,,,,31,37,68
,2013,030600042,,,,76,94,170
,2013,030600043,,,,25,27,52
,2013,030600043,,,,14,5,19
,2013,030600044,,,,10,11,21
,2013,030600045,,,,34,33,67
,2013,030600046,,,,19,25,44
,2013,030600047,,,,47,51,98
,2013,030600047,,,,9,10,19
,2013,030600048,,,,31,37,68
,2013,030600049,,,,6,4,10
,2013,030600050,,,,10,8,18
,2013,030600051,,,,6,12,18
,2013,030600051,,,,22,16,38
,2013,030600054,,,,9,11,20
,2013,030600055,,,,8,11,19
,2013,030600056,,,,12,14,26
,2013,030600057,,,,3,7,10
,2013,030600058,,,,14,9,23
,2013,030600059,,,,12,13,25
,2013,030600060,,,,42,62,104
,2013,030600061,,,,58,61,119
,2013,030600064,,,,10,8,18
,2013,030600066,,,,5,10,15
,2013,030600067,,,,24,27,51
,2013,030600068,,,,6,5,11
,2013,030600069,,,,5,10,15
,2013,030600070,,,,7,7,14
,2013,030600071,,,,36,33,69
,2013,030600073,,,,5,7,12
,2013,030600074,,,,10,7,17
,2013,030600076,,,,5,8,13
,2013,030600078,,,,5,5,10
,2013,030600079,,,,3,3,6
,2013,030600080,,,,6,4,10
,2013,030600082,,,,16,9,25
,2013,030600083,,,,35,17,52
,2013,030600085,,,,15,14,29
,2013,030600086,,,,83,143,226
,2013,030600087,,,,21,21,42
,2013,030600090,,,,1,6,7
,2013,030600092,,,,12,11,23
,2013,030600094,,,,5,3,8
,2013,030600095,,,,5,4,9
,2013,030600102,,,,12,6,18
,2013,030600109,,,,15,8,23
,2013,030600112,,,,13,14,27
,2013,030600115,,,,12,6,18
,2013,030600117,,,,6,6,12
,2013,030600118,,,,4,3,7
,2013,030600119,,,,6,3,9
,2013,030600120,,,,10,6,16
,2013,030600127,,,,4,11,15
,2013,030600129,,,,2,4,6
,2013,030600130,,,,6,7,13
,2013,030600133,,,,6,7,13
,2013,030600135,,,,2,6,8
,2013,030600136,,,,196,228,424
,2013,030600137,,,,4,6,10
,2013,030600137,,,,3,6,9
,2013,030600138,,,,3,6,9
,2013,030600139,,,,5,9,14
,2013,030600140,,,,3,6,9
,2013,030600141,,,,7,6,13
,2013,030600144,,,,7,6,13
,2013,030600145,,,,1,5,6
,2013,030600146,,,,140,6,146
,2013,030600147,,,,10,14,24
,2013,030600148,,,,8,4,12
,2013,030600149,,,,4,4,8
,2013,030700001,,,,46,33,79
,2013,030700002,,,,160,156,316
,2013,030700003,,,,63,45,108
,2013,030700005,,,,7,7,14
,2013,030700006,,,,9,5,14
,2013,030700007,,,,38,41,79
,2013,030700008,,,,49,54,103
,2013,030700009,,,,20,24,44
,2013,030700010,,,,23,9,32
,2013,030700011,,,,11,13,24
,2013,030700012,,,,28,31,59
,2013,030700013,,,,192,183,375
,2013,030700019,,,,11,8,19
,2013,030700020,,,,13,2,15
,2013,030700021,,,,47,41,88
,2013,030700021,,,,6,10,16
,2013,030700022,,,,18,14,32
,2013,030700024,,,,27,24,51
,2013,030700027,,,,7,8,15
,2013,030700028,,,,7,9,16
,2013,030700029,,,,11,10,21
,2013,030700031,,,,42,34,76
,2013,030700033,,,,6,7,13
,2013,030700040,,,,15,12,27
,2013,030700041,,,,10,11,21
,2013,030700042,,,,8,5,13
,2013,030700043,,,,2,3,5
,2013,030700045,,,,4,3,7
,2013,030800001,,,,127,147,274
,2013,030800002,,,,13,18,31
,2013,030800003,,,,12,8,20
,2013,030800004,,,,30,20,50
,2013,030800005,,,,15,26,41
,2013,030800006,,,,123,109,232
,2013,030800006,,,,12,9,21
,2013,030800007,,,,34,30,64
,2013,030800008,,,,36,38,74
,2013,030800009,,,,4,5,9
,2013,030800011,,,,7,15,22
,2013,030800012,,,,3,1,4
,2013,030800013,,,,10,18,28
,2013,030800015,,,,40,54,94
,2013,030800016,,,,4,6,10
,2013,030800017,,,,6,6,12
,2013,030800018,,,,1,3,4
,2013,030800019,,,,23,36,59
,2013,030800020,,,,8,14,22
,2013,030800022,,,,5,3,8
,2013,030800023,,,,10,10,20
,2013,030800024,,,,7,4,11
,2013,030800025,,,,6,5,11
,2013,030900001,,,,256,268,524
,2013,030900002,,,,18,43,61
,2013,030900003,,,,59,57,116
,2013,030900004,,,,9,13,22
,2013,030900006,,,,216,177,393
,2013,030900007,,,,15,7,22
,2013,030900009,,,,27,19,46
,2013,030900010,,,,16,14,30
,2013,030900011,,,,45,33,78
,2013,031000001,,,,72,82,154
,2013,031000002,,,,85,79,164
,2013,031000003,,,,18,13,31
,2013,031000004,,,,69,85,154
,2013,031000005,,,,44,33,77
,2013,031000006,,,,53,50,103
,2013,031000008,,,,23,33,56
,2013,031000009,,,,18,26,44
,2013,031000010,,,,33,37,70
,2013,031000011,,,,28,26,54
,2013,031000012,,,,20,10,30
,2013,031000013,,,,23,37,60
,2013,031000014,,,,19,27,46
,2013,031000015,,,,22,26,48
,2013,031000016,,,,25,20,45
,2013,031000018,,,,32,29,61
,2013,031000018,,,,3,4,7
,2013,031000019,,,,16,28,44
,2013,031000020,,,,16,26,42
,2013,031000021,,,,10,13,23
,2013,031000022,,,,35,14,49
,2013,031000023,,,,23,25,48
,2013,031000024,,,,17,17,34
,2013,031000027,,,,3,5,8
,2013,031000027,,,,17,19,36
,2013,031000028,,,,15,18,33
,2013,031000029,,,,56,54,110
,2013,031000030,,,,23,25,48
,2013,031000031,,,,33,32,65
,2013,031000033,,,,13,22,35
,2013,031000034,,,,5,9,14
,2013,031000035,,,,22,17,39
,2013,031000036,,,,14,12,26
,2013,031000037,,,,27,36,63
,2013,031000038,,,,19,13,32
,2013,031000040,,,,26,24,50
,2013,031000041,,,,20,17,37
,2013,031000042,,,,10,12,22
,2013,031000043,,,,16,24,40
,2013,031000043,,,,82,80,162
,2013,031000044,,,,9,8,17
,2013,031000045,,,,9,7,16
,2013,031000046,,,,10,3,13
,2013,031000048,,,,7,16,23
,2013,031000049,,,,4,4,8
,2013,031000050,,,,18,7,25
,2013,031000051,,,,5,10,15
,2013,031000067,,,,24,25,49
,2013,031000072,,,,59,62,121
,2013,031000073,,,,6,2,8
,2013,031000074,,,,2,3,5
,2013,031000075,,,,5,5,10
,2013,031000076,,,,2,5,7
,2013,031000078,,,,4,9,13
,2013,031000079,,,,4,7,11
,2013,031000080,,,,5,2,7
,2013,031000082,,,,5,3,8
,2013,031000088,,,,6,2,8
,2013,031000089,,,,4,5,9
,2013,031000090,,,,7,5,12
,2013,031000091,,,,9,8,17
,2013,031000092,,,,2,9,11
,2013,031000093,,,,5,6,11
,2013,031000096,,,,7,11,18
,2013,031000098,,,,3,1,4
,2013,031000099,,,,2,2,4
,2013,031000100,,,,4,6,10
,2013,031000101,,,,1,3,4
,2013,031000102,,,,3,5,8
,2013,031000103,,,,2,5,7
,2013,031000104,,,,5,3,8
,2013,031000105,,,,2,3,5
,2013,031000106,,,,4,3,7
,2013,031000107,,,,1,7,8
,2013,031000108,,,,7,6,13
,2013,031000109,,,,3,3,6
,2013,031000110,,,,5,4,9
,2013,031000111,,,,4,1,5
,2013,031000112,,,,4,4,8
,2013,031000113,,,,5,2,7
,2013,031000114,,,,4,3,7
,2013,031000115,,,,5,6,11
,2013,031000116,,,,6,9,15
,2013,031000117,,,,7,7,14
,2013,031000118,,,,7,8,15
,2013,031100001,,,,13,11,24
,2013,031100002,,,,81,99,180
,2013,031100003,,,,14,12,26
,2013,031100004,,,,39,33,72
,2013,031100005,,,,39,50,89
,2013,031100006,,,,66,59,125
,2013,031100007,,,,49,42,91
,2013,031100008,,,,106,113,219
,2013,031100009,,,,14,6,20
,2013,031100010,,,,45,29,74
,2013,031100011,,,,25,17,42
,2013,031100012,,,,28,26,54
,2013,031100013,,,,5,2,7
,2013,031100014,,,,55,53,108
,2013,031100015,,,,35,37,72
,2013,031100016,,,,17,10,27
,2013,031100017,,,,24,20,44
,2013,031100018,,,,17,19,36
,2013,031100019,,,,102,77,179
,2013,031100020,,,,33,39,72
,2013,031100021,,,,10,13,23
,2013,031100022,,,,15,12,27
,2013,031100023,,,,11,13,24
,2013,031100024,,,,10,7,17
,2013,031100025,,,,14,12,26
,2013,031100026,,,,19,13,32
,2013,031100027,,,,17,12,29
,2013,031100028,,,,60,60,120
,2013,031100029,,,,12,10,22
,2013,031100031,,,,6,6,12
,2013,031100032,,,,6,6,12
,2013,031100033,,,,14,6,20
,2013,031100034,,,,3,6,9
,2013,031100035,,,,8,12,20
,2013,031100036,,,,266,263,529
,2013,031100036,,,,75,78,153
,2013,031100037,,,,4,8,12
,2013,031100038,,,,7,3,10
,2013,031100039,,,,7,10,17
,2013,031100040,,,,7,15,22
,2013,031100042,,,,4,8,12
,2013,031100043,,,,29,27,56
,2013,031100047,,,,15,2,17
,2013,031100048,,,,16,25,41
,2013,031100049,,,,11,10,21
,2013,031100050,,,,6,3,9
,2013,031100051,,,,9,4,13
,2013,031100052,,,,4,3,7
,2013,031100054,,,,11,7,18
,2013,031100055,,,,6,2,8
,2013,031100056,,,,8,2,10
,2013,031100058,,,,11,2,13
,2013,031100058,,,,0,6,6
,2013,031100063,,,,13,10,23
,2013,031100065,,,,3,3,6
,2013,031100068,,,,3,4,7
,2013,031100073,,,,5,7,12
,2013,031100076,,,,4,4,8
,2013,031100077,,,,5,3,8
,2013,031100078,,,,5,5,10
,2013,031100079,,,,4,2,6
,2013,031100081,,,,2,3,5
,2013,031100082,,,,5,3,8
,2013,031100083,,,,6,2,8
,2013,031100085,,,,10,0,10
,2013,031100086,,,,22,17,39
,2013,031100087,,,,9,6,15
,2013,031100088,,,,4,6,10
,2013,031100089,,,,7,8,15
,2013,031100094,,,,5,3,8
,2013,031100095,,,,7,1,8
,2013,031100096,,,,4,5,9
,2013,031100099,,,,24,33,57
,2013,031200002,,,,85,72,157
,2013,031200003,,,,35,34,69
,2013,031200004,,,,130,94,224
,2013,031200005,,,,25,29,54
,2013,031200006,,,,10,4,14
,2013,031200007,,,,11,21,32
,2013,031200008,,,,58,54,112
,2013,031200009,,,,38,35,73
,2013,031200010,,,,42,57,99
,2013,031200011,,,,22,12,34
,2013,031200011,,,,5,4,9
,2013,031200012,,,,67,76,143
,2013,031200013,,,,41,35,76
,2013,031200014,,,,34,28,62
,2013,031200015,,,,48,37,85
,2013,031200015,,,,4,9,13
,2013,031200016,,,,21,26,47
,2013,031200017,,,,33,32,65
,2013,031200018,,,,15,10,25
,2013,031200019,,,,21,18,39
,2013,031200020,,,,23,8,31
,2013,031200021,,,,33,24,57
,2013,031200022,,,,38,32,70
,2013,031200023,,,,38,36,74
,2013,031200023,,,,10,4,14
,2013,031200024,,,,10,13,23
,2013,031200025,,,,18,21,39
,2013,031200026,,,,15,13,28
,2013,031200027,,,,8,7,15
,2013,031200027,,,,14,21,35
,2013,031200029,,,,4,3,7
,2013,031200030,,,,9,6,15
,2013,031200031,,,,16,10,26
,2013,031200032,,,,6,8,14
,2013,031200034,,,,3,6,9
,2013,031200036,,,,9,5,14
,2013,031200037,,,,7,13,20
,2013,031200042,,,,8,8,16
,2013,031200042,,,,27,18,45
,2013,031200043,,,,14,6,20
,2013,031200044,,,,13,19,32
,2013,031200044,,,,5,3,8
,2013,031200045,,,,42,47,89
,2013,031200049,,,,24,36,60
,2013,031200051,,,,9,5,14
,2013,031200053,,,,11,19,30
,2013,031200053,,,,8,7,15
,2013,031200056,,,,8,13,21
,2013,031200064,,,,9,8,17
,2013,031200066,,,,21,14,35
,2013,031200067,,,,8,8,16
,2013,031200069,,,,5,3,8
,2013,031200070,,,,12,4,16
,2013,031200071,,,,2,5,7
,2013,031200073,,,,5,8,13
,2013,031200074,,,,5,3,8
,2013,031200077,,,,4,2,6
,2013,031200078,,,,6,3,9
,2013,031200083,,,,9,2,11
,2013,031200085,,,,7,8,15
,2013,031200089,,,,9,6,15
,2013,031200090,,,,11,7,18
,2013,031200091,,,,5,6,11
,2013,031200094,,,,8,7,15
,2013,031200095,,,,9,19,28
,2013,031300001,,,,13,7,20
,2013,031300001,,,,4,2,6
,2013,031300002,,,,27,33,60
,2013,031300002,,,,9,7,16
,2013,031300003,,,,11,12,23
,2013,031300004,,,,29,36,65
,2013,031300006,,,,35,30,65
,2013,031300006,,,,10,6,16
,2013,031300007,,,,154,135,289
,2013,031300008,,,,98,92,190
,2013,031300009,,,,59,57,116
,2013,031300010,,,,49,65,114
,2013,031300011,,,,16,23,39
,2013,031300012,,,,58,104,162
,2013,031300013,,,,34,16,50
,2013,031300014,,,,30,24,54
,2013,031300015,,,,34,32,66
,2013,031300016,,,,26,18,44
,2013,031300017,,,,42,39,81
,2013,031300018,,,,6,2,8
,2013,031300018,,,,44,56,100
,2013,031300019,,,,44,45,89
,2013,031300020,,,,13,27,40
,2013,031300020,,,,75,79,154
,2013,031300021,,,,63,59,122
,2013,031300021,,,,12,12,24
,2013,031300022,,,,107,89,196
,2013,031300023,,,,20,10,30
,2013,031300024,,,,19,18,37
,2013,031300025,,,,8,12,20
,2013,031300026,,,,4,0,4
,2013,031300026,,,,12,13,25
,2013,031300027,,,,47,50,97
,2013,031300028,,,,35,36,71
,2013,031300029,,,,30,28,58
,2013,031300030,,,,20,12,32
,2013,031300030,,,,4,4,8
,2013,031300031,,,,24,15,39
,2013,031300032,,,,17,29,46
,2013,031300033,,,,33,27,60
,2013,031300033,,,,8,10,18
,2013,031300034,,,,14,11,25
,2013,031300035,,,,13,15,28
,2013,031300037,,,,53,40,93
,2013,031300038,,,,19,17,36
,2013,031300038,,,,10,11,21
,2013,031300039,,,,34,36,70
,2013,031300040,,,,14,19,33
,2013,031300041,,,,19,19,38
,2013,031300042,,,,14,13,27
,2013,031300043,,,,36,34,70
,2013,031300043,,,,6,5,11
,2013,031300044,,,,3,2,5
,2013,031300044,,,,11,19,30
,2013,031300045,,,,18,14,32
,2013,031300045,,,,0,1,1
,2013,031300046,,,,11,12,23
,2013,031300046,,,,8,7,15
,2013,031300048,,,,14,16,30
,2013,031300049,,,,14,22,36
,2013,031300050,,,,169,172,341
,2013,031300056,,,,4,5,9
,2013,031300056,,,,15,12,27
,2013,031300057,,,,31,51,82
,2013,031300058,,,,6,3,9
,2013,031300059,,,,9,11,20
,2013,031300059,,,,6,6,12
,2013,031300060,,,,22,7,29
,2013,031300061,,,,9,13,22
,2013,031300062,,,,3,7,10
,2013,031300065,,,,6,10,16
,2013,031300066,,,,14,13,27
,2013,031300067,,,,7,8,15
,2013,031300068,,,,3,2,5
,2013,031300068,,,,15,33,48
,2013,031300069,,,,12,15,27
,2013,031300070,,,,8,5,13
,2013,031300071,,,,6,5,11
,2013,031300072,,,,27,21,48
,2013,031300072,,,,13,7,20
,2013,031300074,,,,10,10,20
,2013,031300075,,,,10,4,14
,2013,031300076,,,,14,16,30
,2013,031300077,,,,5,3,8
,2013,031300078,,,,146,184,330
,2013,031300079,,,,55,59,114
,2013,031300080,,,,45,53,98
,2013,031300081,,,,6,19,25
,2013,031300082,,,,20,18,38
,2013,031300084,,,,8,7,15
,2013,031300085,,,,6,2,8
,2013,031300086,,,,1,1,2
,2013,031300087,,,,10,12,22
,2013,031300088,,,,4,5,9
,2013,031300089,,,,4,2,6
,2013,031300090,,,,11,11,22
,2013,031300104,,,,12,15,27
,2013,031300104,,,,3,3,6
,2013,031300109,,,,9,11,20
,2013,031300112,,,,9,7,16
,2013,031300115,,,,4,0,4
,2013,031300117,,,,5,6,11
,2013,031300118,,,,7,7,14
,2013,031300119,,,,8,5,13
,2013,031300120,,,,1,1,2
,2013,031300121,,,,11,11,22
,2013,031300122,,,,0,5,5
,2013,031300123,,,,5,6,11
,2013,031300124,,,,2,4,6
,2013,031300125,,,,6,6,12
,2013,031300126,,,,3,3,6
,2013,031300127,,,,6,6,12
,2013,031300128,,,,4,4,8
,2013,031300129,,,,4,2,6
,2013,031300130,,,,7,4,11
,2013,031300131,,,,2,3,5
,2013,031300132,,,,22,29,51
,2013,031300133,,,,5,1,6
,2013,031300133,,,,13,6,19
,2013,031300134,,,,5,3,8
,2013,031300135,,,,3,4,7
,2013,031300136,,,,4,5,9
,2013,031300137,,,,6,4,10
,2013,031300138,,,,3,4,7
,2013,031300139,,,,2,3,5
,2013,031300140,,,,5,5,10
,2013,031300141,,,,4,4,8
,2013,031300142,,,,6,8,14
,2013,031300143,,,,1,1,2
,2013,031400002,,,,31,24,55
,2013,031400003,,,,38,34,72
,2013,031400004,,,,119,78,197
,2013,031400005,,,,27,47,74
,2013,031400006,,,,7,14,21
,2013,031400007,,,,15,15,30
,2013,031400009,,,,39,39,78
,2013,031400010,,,,33,22,55
,2013,031400011,,,,32,28,60
,2013,031400013,,,,23,21,44
,2013,031400014,,,,30,29,59
,2013,031400015,,,,12,15,27
,2013,031400016,,,,91,113,204
,2013,031400017,,,,35,29,64
,2013,031400019,,,,25,23,48
,2013,031400020,,,,4,7,11
,2013,031400021,,,,10,11,21
,2013,031400022,,,,20,22,42
,2013,031400023,,,,12,18,30
,2013,031400024,,,,10,6,16
,2013,031400025,,,,16,6,22
,2013,031400026,,,,8,9,17
,2013,031400027,,,,15,5,20
,2013,031400029,,,,17,12,29
,2013,031400030,,,,44,53,97
,2013,031400032,,,,7,14,21
,2013,031400033,,,,46,28,74
,2013,031400034,,,,10,8,18
,2013,031400036,,,,7,3,10
,2013,031400037,,,,2,8,10
,2013,031400038,,,,10,8,18
,2013,031400040,,,,6,6,12
,2013,031400041,,,,7,20,27
,2013,031400042,,,,212,225,437
,2013,031400044,,,,42,17,59
,2013,031400045,,,,9,1,10
,2013,031400046,,,,4,6,10
,2013,031400047,,,,7,4,11
,2013,031400048,,,,7,11,18
,2013,031400049,,,,5,6,11
,2013,031400050,,,,4,4,8
,2013,031500001,,,,90,81,171
,2013,031500002,,,,14,15,29
,2013,031500003,,,,27,10,37
,2013,031500004,,,,38,40,78
,2013,031500005,,,,23,23,46
,2013,031500006,,,,16,16,32
,2013,031500007,,,,23,25,48
,2013,031500008,,,,41,46,87
,2013,031500009,,,,11,6,17
,2013,031500010,,,,21,11,32
,2013,031500011,,,,20,16,36
,2013,031500012,,,,28,25,53
,2013,031500013,,,,47,34,81
,2013,031500014,,,,21,31,52
,2013,031500015,,,,12,17,29
,2013,031500016,,,,18,23,41
,2013,031500017,,,,13,10,23
,2013,031500019,,,,29,19,48
,2013,031500020,,,,12,6,18
,2013,031500021,,,,90,115,205
,2013,031500022,,,,7,9,16
,2013,031500023,,,,6,8,14
,2013,031500026,,,,11,8,19
,2013,031500027,,,,10,3,13
,2013,031500028,,,,22,19,41
,2013,031500029,,,,50,44,94
,2013,031500031,,,,21,24,45
,2013,031500032,,,,4,9,13
,2013,031500033,,,,11,9,20
,2013,031500037,,,,4,5,9
,2013,031500039,,,,8,8,16
,2013,031500040,,,,9,8,17
,2013,031500042,,,,5,2,7
,2013,031500043,,,,11,15,26
,2013,031500044,,,,7,12,19
,2013,031500046,,,,6,5,11
,2013,031500049,,,,3,7,10
,2013,031500050,,,,12,3,15
,2013,031500054,,,,0,4,4
,2013,031500055,,,,5,5,10
,2013,031500057,,,,4,4,8
,2013,031600001,,,,15,17,32
,2013,031600002,,,,51,32,83
,2013,031600003,,,,80,76,156
,2013,031600004,,,,26,50,76
,2013,031600005,,,,31,32,63
,2013,031600006,,,,56,49,105
,2013,031600007,,,,54,50,104
,2013,031600008,,,,22,20,42
,2013,031600010,,,,22,22,44
,2013,031600011,,,,42,27,69
,2013,031600012,,,,181,167,348
,2013,031600012,,,,9,9,18
,2013,031600013,,,,41,42,83
,2013,031600014,,,,11,12,23
,2013,031600015,,,,40,41,81
,2013,031600017,,,,26,11,37
,2013,031600020,,,,23,9,32
,2013,031600022,,,,58,51,109
,2013,031600023,,,,10,9,19
,2013,031600024,,,,2,3,5
,2013,031600025,,,,10,15,25
,2013,031600026,,,,147,192,339
,2013,031600027,,,,8,16,24
,2013,031600028,,,,11,21,32
,2013,031600030,,,,11,10,21
,2013,031600032,,,,12,5,17
,2013,031600033,,,,12,7,19
,2013,031600034,,,,7,6,13
,2013,031600035,,,,10,5,15
,2013,031600036,,,,2,4,6
,2013,031600037,,,,3,1,4
,2013,031600039,,,,6,3,9
,2013,031600040,,,,3,7,10
,2013,031600041,,,,2,4,6
,2013,031600042,,,,41,36,77
,2013,031600043,,,,24,27,51
,2013,031600044,,,,5,9,14
,2013,031600048,,,,8,13,21
,2013,031600051,,,,18,17,35
,2013,031600052,,,,5,3,8
,2013,031600053,,,,2,6,8
,2013,031600054,,,,2,6,8
,2013,031600057,,,,3,3,6
,2013,031600058,,,,4,4,8
,2013,031600062,,,,2,4,6
,2013,031700001,,,,15,10,25
,2013,031700002,,,,16,20,36
,2013,031700003,,,,5,12,17
,2013,031700004,,,,9,7,16
,2013,031700004,,,,3,3,6
,2013,031700005,,,,25,24,49
,2013,031700006,,,,98,97,195
,2013,031700007,,,,13,16,29
,2013,031700008,,,,8,7,15
,2013,031700009,,,,31,30,61
,2013,031700010,,,,112,102,214
,2013,031700011,,,,3,3,6
,2013,031700014,,,,7,5,12
,2013,031700015,,,,6,14,20
,2013,031700016,,,,15,11,26
,2013,031700017,,,,13,14,27
,2013,031700019,,,,5,10,15
,2013,031700020,,,,21,17,38
,2013,031700022,,,,5,6,11
,2013,031700023,,,,2,3,5
,2013,031700024,,,,5,4,9
,2013,031700026,,,,5,5,10
,2013,031700027,,,,2,3,5
,2013,031700029,,,,3,3,6
,2013,031800001,,,,229,96,325
,2013,031800002,,,,73,61,134
,2013,031800003,,,,446,425,871
,2013,031800004,,,,194,156,350
,2013,031800005,,,,413,385,798
,2013,031800006,,,,75,92,167
,2013,031800007,,,,337,263,600
,2013,031800008,,,,138,103,241
,2013,031800009,,,,30,22,52
,2013,031800010,,,,82,94,176
,2013,031800011,,,,196,180,376
,2013,031800012,,,,178,177,355
,2013,031800013,,,,227,198,425
,2013,031800014,,,,48,30,78
,2013,031800015,,,,129,159,288
,2013,031800016,,,,54,50,104
,2013,031800017,,,,51,52,103
,2013,031800019,,,,60,52,112
,2013,031800020,,,,215,185,400
,2013,031800021,,,,73,69,142
,2013,031800022,,,,21,27,48
,2013,031800023,,,,55,59,114
,2013,031800024,,,,143,128,271
,2013,031800025,,,,265,287,552
,2013,031800026,,,,42,25,67
,2013,031800027,,,,46,32,78
,2013,031800028,,,,119,109,228
,2013,031800029,,,,40,38,78
,2013,031800030,,,,30,25,55
,2013,031800031,,,,19,14,33
,2013,031800032,,,,112,102,214
,2013,031800033,,,,13,11,24
,2013,031800033,,,,107,80,187
,2013,031800035,,,,50,44,94
,2013,031800036,,,,47,38,85
,2013,031800037,,,,81,74,155
,2013,031800038,,,,48,43,91
,2013,031800039,,,,31,26,57
,2013,031800040,,,,43,48,91
,2013,031800041,,,,27,32,59
,2013,031800043,,,,29,24,53
,2013,031800044,,,,19,19,38
,2013,031800045,,,,26,24,50
,2013,031800046,,,,10,6,16
,2013,031800047,,,,14,23,37
,2013,031800048,,,,12,11,23
,2013,031800049,,,,10,18,28
,2013,031800050,,,,44,50,94
,2013,031800052,,,,24,22,46
,2013,031800052,,,,63,63,126
,2013,031800052,,,,29,53,82
,2013,031800056,,,,16,9,25
,2013,031800057,,,,129,219,348
,2013,031800058,,,,46,53,99
,2013,031800058,,,,67,91,158
,2013,031800058,,,,101,138,239
,2013,031800059,,,,57,84,141
,2013,031800060,,,,138,147,285
,2013,031800061,,,,179,15,194
,2013,031800062,,,,475,164,639
,2013,031800063,,,,1398,1934,3332
,2013,031800063,,,,196,371,567
,2013,031800064,,,,80,68,148
,2013,031800065,,,,95,75,170
,2013,031800066,,,,25,19,44
,2013,031800067,,,,49,37,86
,2013,031800068,,,,60,76,136
,2013,031800070,,,,47,34,81
,2013,031800072,,,,55,58,113
,2013,031800073,,,,32,30,62
,2013,031800074,,,,216,216,432
,2013,031800075,,,,11,12,23
,2013,031800075,,,,82,69,151
,2013,031800075,,,,41,43,84
,2013,031800076,,,,6,4,10
,2013,031800076,,,,15,25,40
,2013,031800076,,,,12,21,33
,2013,031800077,,,,17,8,25
,2013,031800078,,,,9,16,25
,2013,031800079,,,,64,68,132
,2013,031800080,,,,15,13,28
,2013,031800081,,,,9,7,16
,2013,031800082,,,,59,58,117
,2013,031800083,,,,334,286,620
,2013,031800084,,,,23,14,37
,2013,031800085,,,,59,60,119
,2013,031800086,,,,43,42,85
,2013,031800087,,,,53,60,113
,2013,031800088,,,,159,137,296
,2013,031800089,,,,22,18,40
,2013,031800090,,,,0,356,356
,2013,031800091,,,,31,21,52
,2013,031800092,,,,14,10,24
,2013,031800093,,,,27,25,52
,2013,031800094,,,,22,16,38
,2013,031800095,,,,69,60,129
,2013,031800097,,,,42,50,92
,2013,031800099,,,,36,37,73
,2013,031800099,,,,43,50,93
,2013,031800101,,,,34,35,69
,2013,031800102,,,,10,10,20
,2013,031800103,,,,50,47,97
,2013,031800104,,,,19,19,38
,2013,031800105,,,,55,65,120
,2013,031800106,,,,190,212,402
,2013,031800107,,,,69,75,144
,2013,031800108,,,,25,34,59
,2013,031800109,,,,13,9,22
,2013,031800110,,,,340,251,591
,2013,031800111,,,,110,104,214
,2013,031800112,,,,17,28,45
,2013,031800113,,,,14,12,26
,2013,031800115,,,,14,13,27
,2013,031800115,,,,36,47,83
,2013,031800115,,,,15,9,24
,2013,031800116,,,,41,37,78
,2013,031800117,,,,15,18,33
,2013,031800117,,,,90,84,174
,2013,031800117,,,,57,59,116
,2013,031800118,,,,8,7,15
,2013,031800119,,,,13,13,26
,2013,031800120,,,,70,71,141
,2013,031800121,,,,26,33,59
,2013,031800122,,,,15,12,27
,2013,031800123,,,,194,213,407
,2013,031800124,,,,79,75,154
,2013,031800126,,,,39,43,82
,2013,031800127,,,,11,7,18
,2013,031800135,,,,46,63,109
,2013,031800136,,,,29,19,48
,2013,031800137,,,,70,57,127
,2013,031800137,,,,12,12,24
,2013,031800139,,,,32,23,55
,2013,031800141,,,,25,22,47
,2013,031800141,,,,4,3,7
,2013,031800141,,,,42,64,106
,2013,031800142,,,,52,60,112
,2013,031800143,,,,23,29,52
,2013,031800143,,,,71,90,161
,2013,031800143,,,,15,15,30
,2013,031800144,,,,38,45,83
,2013,031800145,,,,12,7,19
,2013,031800147,,,,8,6,14
,2013,031800149,,,,10,9,19
,2013,031800153,,,,3,5,8
,2013,031800154,,,,3,12,15
,2013,031800156,,,,5,5,10
,2013,031800157,,,,8,6,14
,2013,031800160,,,,19,8,27
,2013,031800161,,,,14,9,23
,2013,031800162,,,,10,8,18
,2013,031800163,,,,3,2,5
,2013,031800165,,,,6,7,13
,2013,031800166,,,,7,9,16
,2013,031800169,,,,5,9,14
,2013,031800170,,,,8,3,11
,2013,031800171,,,,5,13,18
,2013,031800173,,,,88,153,241
,2013,031800185,,,,7,3,10
,2013,031800188,,,,11,13,24
,2013,031800200,,,,30,12,42
,2013,031800201,,,,14,12,26
,2013,031800202,,,,15,11,26
,2013,031800203,,,,9,10,19
,2013,031800204,,,,6,7,13
,2013,031800205,,,,3,2,5
,2013,031800206,,,,3,3,6
,2013,031800207,,,,8,10,18
,2013,031800210,,,,3,7,10
,2013,031800213,,,,6,3,9
,2013,031800219,,,,11,5,16
,2013,031800221,,,,16,16,32
,2013,031800223,,,,7,4,11
,2013,031800223,,,,22,16,38
,2013,031800224,,,,26,29,55
,2013,031800225,,,,13,7,20
,2013,031800225,,,,8,3,11
,2013,031800226,,,,15,16,31
,2013,031800228,,,,11,14,25
,2013,031800230,,,,2,3,5
,2013,031800231,,,,19,11,30
,2013,031800232,,,,3,4,7
,2013,031800233,,,,2,3,5
,2013,031800234,,,,4,3,7
,2013,031800235,,,,7,10,17
,2013,031800236,,,,12,12,24
,2013,031800238,,,,4,6,10
,2013,031800239,,,,23,16,39
,2013,031800240,,,,17,9,26
,2013,031800241,,,,31,32,63
,2013,031800243,,,,4,6,10
,2013,031800244,,,,13,15,28
,2013,031800246,,,,4,1,5
,2013,031800247,,,,4,4,8
,2013,031800248,,,,11,5,16
,2013,031800249,,,,4,3,7
,2013,031800250,,,,9,6,15
,2013,031800251,,,,26,9,35
,2013,031800252,,,,29,51,80
,2013,031800253,,,,20,19,39
,2013,031800253,,,,5,2,7
,2013,031800254,,,,18,29,47
,2013,031800255,,,,9,9,18
,2013,031800256,,,,13,13,26
,2013,031800257,,,,7,9,16
,2013,031800259,,,,5,7,12
,2013,031800260,,,,4,2,6
,2013,031800261,,,,3,4,7
,2013,031800262,,,,6,3,9
,2013,031800264,,,,9,4,13
,2013,031800265,,,,4,4,8
,2013,031900001,,,,67,57,124
,2013,031900002,,,,82,56,138
,2013,031900004,,,,51,51,102
,2013,031900004,,,,8,18,26
,2013,031900005,,,,17,32,49
,2013,031900007,,,,27,23,50
,2013,031900008,,,,19,19,38
,2013,031900008,,,,7,8,15
,2013,031900009,,,,167,186,353
,2013,031900010,,,,11,13,24
,2013,031900010,,,,56,77,133
,2013,031900011,,,,22,13,35
,2013,031900012,,,,32,22,54
,2013,031900013,,,,47,36,83
,2013,031900013,,,,11,6,17
,2013,031900014,,,,9,5,14
,2013,031900015,,,,53,50,103
,2013,031900015,,,,6,14,20
,2013,031900016,,,,59,51,110
,2013,031900017,,,,25,36,61
,2013,031900018,,,,108,103,211
,2013,031900019,,,,15,10,25
,2013,031900019,,,,2,2,4
,2013,031900020,,,,30,14,44
,2013,031900020,,,,12,10,22
,2013,031900021,,,,230,201,431
,2013,031900022,,,,30,25,55
,2013,031900024,,,,58,46,104
,2013,031900026,,,,48,57,105
,2013,031900027,,,,47,41,88
,2013,031900028,,,,14,8,22
,2013,031900029,,,,19,12,31
,2013,031900030,,,,13,11,24
,2013,031900033,,,,314,388,702
,2013,031900033,,,,114,198,312
,2013,031900034,,,,161,182,343
,2013,031900036,,,,61,55,116
,2013,031900037,,,,25,34,59
,2013,031900038,,,,43,39,82
,2013,031900039,,,,5,16,21
,2013,031900041,,,,356,305,661
,2013,031900043,,,,2,5,7
,2013,031900046,,,,32,34,66
,2013,031900046,,,,4,9,13
,2013,031900047,,,,212,192,404
,2013,031900049,,,,22,18,40
,2013,031900051,,,,22,20,42
,2013,031900052,,,,13,15,28
,2013,031900052,,,,1,4,5
,2013,031900053,,,,13,17,30
,2013,031900057,,,,11,15,26
,2013,031900061,,,,6,7,13
,2013,031900062,,,,2,5,7
,2013,031900063,,,,4,4,8
,2013,031900064,,,,7,15,22
,2013,031900065,,,,3,5,8
,2013,031900066,,,,4,6,10
,2013,031900068,,,,13,7,20
,2013,031900070,,,,13,9,22
,2013,031900071,,,,27,29,56
,2013,031900073,,,,4,5,9
,2013,032000001,,,,53,39,92
,2013,032000001,,,,5,5,10
,2013,032000002,,,,183,196,379
,2013,032000003,,,,41,56,97
,2013,032000004,,,,9,17,26
,2013,032000005,,,,89,82,171
,2013,032000006,,,,158,154,312
,2013,032000007,,,,40,45,85
,2013,032000008,,,,16,13,29
,2013,032000009,,,,21,16,37
,2013,032000009,,,,5,5,10
,2013,032000010,,,,20,30,50
,2013,032000011,,,,37,81,118
,2013,032000012,,,,12,14,26
,2013,032000013,,,,20,22,42
,2013,032000014,,,,15,9,24
,2013,032000016,,,,27,23,50
,2013,032000017,,,,7,8,15
,2013,032000018,,,,5,5,10
,2013,032000018,,,,25,27,52
,2013,032000019,,,,32,30,62
,2013,032000020,,,,8,8,16
,2013,032000021,,,,206,208,414
,2013,032000022,,,,164,160,324
,2013,032000023,,,,5,7,12
,2013,032000024,,,,35,21,56
,2013,032000025,,,,16,14,30
,2013,032000025,,,,10,6,16
,2013,032000026,,,,29,33,62
,2013,032000027,,,,206,317,523
,2013,032000030,,,,5,3,8
,2013,032000033,,,,8,15,23
,2013,032000034,,,,8,7,15
,2013,032000035,,,,10,5,15
,2013,032000036,,,,6,6,12
,2013,032000040,,,,7,3,10
,2013,032000041,,,,8,9,17
,2013,032000042,,,,41,23,64
,2013,032000043,,,,6,4,10
,2013,032000044,,,,6,5,11
,2013,032000045,,,,7,7,14
,2013,032000046,,,,5,6,11
,2013,032000047,,,,7,4,11
,2013,032000048,,,,1,5,6
,2013,032000049,,,,4,3,7
,2013,032000050,,,,4,3,7
,2013,032000051,,,,4,4,8
,2013,032000053,,,,4,5,9
,2013,032000055,,,,3,5,8
,2013,032000057,,,,5,1,6
,2013,032000058,,,,1,3,4
,2013,032000059,,,,5,4,9
,2013,032000060,,,,5,8,13
,2013,032000061,,,,4,1,5
,2013,032000062,,,,4,5,9
,2013,032000066,,,,2,3,5
,2013,032000067,,,,4,6,10
,2013,032000068,,,,2,4,6
,2013,032000069,,,,5,5,10
,2013,032000070,,,,4,6,10
,2013,032100001,,,,194,182,376
,2013,032100002,,,,203,198,401
,2013,032100003,,,,112,127,239
,2013,032100004,,,,44,33,77
,2013,032100005,,,,180,163,343
,2013,032100006,,,,44,49,93
,2013,032100007,,,,34,34,68
,2013,032100008,,,,41,53,94
,2013,032100009,,,,32,34,66
,2013,032100010,,,,42,42,84
,2013,032100011,,,,53,52,105
,2013,032100012,,,,21,26,47
,2013,032100013,,,,39,33,72
,2013,032100014,,,,145,148,293
,2013,032100015,,,,31,34,65
,2013,032100016,,,,48,49,97
,2013,032100017,,,,37,36,73
,2013,032100018,,,,11,21,32
,2013,032100019,,,,28,25,53
,2013,032100020,,,,35,36,71
,2013,032100021,,,,49,46,95
,2013,032100022,,,,17,18,35
,2013,032100023,,,,31,30,61
,2013,032100024,,,,42,42,84
,2013,032100025,,,,21,22,43
,2013,032100026,,,,30,35,65
,2013,032100027,,,,108,103,211
,2013,032100028,,,,59,41,100
,2013,032100029,,,,25,22,47
,2013,032100030,,,,6,9,15
,2013,032100031,,,,10,15,25
,2013,032100032,,,,9,10,19
,2013,032100033,,,,7,9,16
,2013,032100034,,,,9,14,23
,2013,032100035,,,,60,39,99
,2013,032100036,,,,64,84,148
,2013,032100036,,,,57,70,127
,2013,032100037,,,,29,13,42
,2013,032100039,,,,21,15,36
,2013,032100040,,,,56,42,98
,2013,032100041,,,,6,13,19
,2013,032100042,,,,6,13,19
,2013,032100043,,,,412,462,874
,2013,032100044,,,,15,21,36
,2013,032100045,,,,2,8,10
,2013,032100046,,,,4,8,12
,2013,032100047,,,,16,17,33
,2013,032100048,,,,13,11,24
,2013,032100049,,,,10,12,22
,2013,032100050,,,,10,18,28
,2013,032100051,,,,8,9,17
,2013,032100052,,,,15,12,27
,2013,032100053,,,,15,14,29
,2013,032100055,,,,155,149,304
,2013,032100056,,,,20,21,41
,2013,032100057,,,,17,12,29
,2013,032100058,,,,12,14,26
,2013,032100059,,,,8,13,21
,2013,032100060,,,,5,6,11
,2013,032100061,,,,9,15,24
,2013,032100062,,,,7,10,17
,2013,032100063,,,,12,6,18
,2013,032100064,,,,11,1,12
,2013,032100065,,,,8,4,12
,2013,032100068,,,,30,31,61
,2013,032100069,,,,18,12,30
,2013,032100070,,,,9,11,20
,2013,032100071,,,,3,5,8
,2013,032100071,,,,6,18,24
,2013,032100072,,,,6,4,10
,2013,032100073,,,,8,8,16
,2013,032100074,,,,9,2,11
,2013,032100075,,,,8,5,13
,2013,032100076,,,,4,6,10
,2013,032100077,,,,5,6,11
,2013,032100078,,,,9,2,11
,2013,032100079,,,,5,5,10
,2013,032100084,,,,2,8,10
,2013,032100085,,,,6,10,16
,2013,032100088,,,,5,6,11
,2013,032100090,,,,7,4,11
,2013,032100093,,,,7,9,16
,2013,032100094,,,,3,8,11
,2013,032100095,,,,4,7,11
,2013,032100096,,,,3,8,11
,2013,032100097,,,,7,6,13
,2013,032100098,,,,14,13,27
,2013,032100100,,,,10,10,20
,2013,032100101,,,,4,5,9
,2013,032100102,,,,6,9,15
,2013,032100103,,,,6,3,9
,2013,032100104,,,,5,3,8
,2013,032100105,,,,4,5,9
,2013,040100001,,,,252,244,496
,2013,040100002,,,,546,552,1098
,2013,040100003,,,,400,341,741
,2013,040100004,,,,35,29,64
,2013,040100005,,,,14,10,24
,2013,040100006,,,,73,75,148
,2013,040100007,,,,144,98,242
,2013,040100008,,,,97,89,186
,2013,040100009,,,,103,70,173
,2013,040100010,,,,46,20,66
,2013,040100011,,,,31,25,56
,2013,040100012,,,,75,75,150
,2013,040100013,,,,40,28,68
,2013,040100014,,,,21,21,42
,2013,040100015,,,,178,157,335
,2013,040100016,,,,141,141,282
,2013,040100017,,,,392,390,782
,2013,040100018,,,,2,4,6
,2013,040100018,,,,465,474,939
,2013,040100019,,,,19,21,40
,2013,040100020,,,,19,19,38
,2013,040100021,,,,210,190,400
,2013,040100022,,,,31,19,50
,2013,040100023,,,,29,21,50
,2013,040100024,,,,25,13,38
,2013,040100025,,,,25,22,47
,2013,040100026,,,,13,12,25
,2013,040100028,,,,77,77,154
,2013,040100029,,,,32,17,49
,2013,040100030,,,,74,53,127
,2013,040100031,,,,24,23,47
,2013,040100032,,,,49,41,90
,2013,040100033,,,,17,13,30
,2013,040100034,,,,33,44,77
,2013,040100035,,,,15,14,29
,2013,040100036,,,,19,13,32
,2013,040100037,,,,46,46,92
,2013,040100038,,,,26,22,48
,2013,040100038,,,,7,7,14
,2013,040100039,,,,7,33,40
,2013,040100040,,,,54,57,111
,2013,040100040,,,,18,12,30
,2013,040100040,,,,31,39,70
,2013,040100041,,,,289,393,682
,2013,040100042,,,,68,49,117
,2013,040100043,,,,222,246,468
,2013,040100044,,,,14,16,30
,2013,040100045,,,,15,8,23
,2013,040100045,,,,86,98,184
,2013,040100045,,,,103,112,215
,2013,040100046,,,,67,65,132
,2013,040100047,,,,27,33,60
,2013,040100048,,,,27,33,60
,2013,040100049,,,,33,32,65
,2013,040100052,,,,47,33,80
,2013,040100053,,,,32,43,75
,2013,040100055,,,,20,24,44
,2013,040100056,,,,24,22,46
,2013,040100057,,,,26,23,49
,2013,040100058,,,,25,29,54
,2013,040100060,,,,25,15,40
,2013,040100061,,,,0,339,339
,2013,040100062,,,,325,435,760
,2013,040100063,,,,26,15,41
,2013,040100066,,,,11,17,28
,2013,040100067,,,,31,29,60
,2013,040100068,,,,16,18,34
,2013,040100072,,,,9,12,21
,2013,040100073,,,,10,10,20
,2013,040100074,,,,33,28,61
,2013,040100076,,,,8,12,20
,2013,040100076,,,,72,61,133
,2013,040100076,,,,79,88,167
,2013,040100077,,,,1170,1174,2344
,2013,040100078,,,,21,19,40
,2013,040100080,,,,14,18,32
,2013,040100081,,,,27,25,52
,2013,040100082,,,,14,27,41
,2013,040100082,,,,367,582,949
,2013,040100085,,,,6,6,12
,2013,040100086,,,,8,8,16
,2013,040100090,,,,3,7,10
,2013,040100093,,,,6,7,13
,2013,040100094,,,,15,10,25
,2013,040100122,,,,11,7,18
,2013,040100123,,,,12,14,26
,2013,040100125,,,,6,7,13
,2013,040100126,,,,9,2,11
,2013,040100131,,,,3,7,10
,2013,040100132,,,,4,5,9
,2013,040100134,,,,14,19,33
,2013,040100143,,,,2,6,8
,2013,040100147,,,,2,5,7
,2013,040100148,,,,6,10,16
,2013,040100151,,,,7,8,15
,2013,040100154,,,,23,17,40
,2013,040100157,,,,11,17,28
,2013,040100158,,,,3,6,9
,2013,040100159,,,,53,55,108
,2013,040100160,,,,34,32,66
,2013,040100161,,,,9,23,32
,2013,040100162,,,,12,7,19
,2013,040100163,,,,74,66,140
,2013,040100163,,,,90,109,199
,2013,040100163,,,,25,26,51
,2013,040100166,,,,7,5,12
,2013,040100167,,,,8,2,10
,2013,040100168,,,,3,7,10
,2013,040100169,,,,3,9,12
,2013,040100171,,,,7,7,14
,2013,040100173,,,,4,7,11
,2013,040100174,,,,5,4,9
,2013,040100175,,,,6,4,10
,2013,040100176,,,,7,8,15
,2013,040100177,,,,3,8,11
,2013,040100178,,,,3,4,7
,2013,040100180,,,,5,7,12
,2013,040100182,,,,1,9,10
,2013,040100183,,,,5,8,13
,2013,040100187,,,,7,2,9
,2013,040100188,,,,4,3,7
,2013,040100191,,,,55,34,89
,2013,040100192,,,,42,0,42
,2013,040100193,,,,23,18,41
,2013,040100194,,,,6,6,12
,2013,040100195,,,,5,3,8
,2013,040200001,,,,200,201,401
,2013,040200002,,,,38,32,70
,2013,040200003,,,,19,31,50
,2013,040200004,,,,41,31,72
,2013,040200005,,,,95,77,172
,2013,040200006,,,,13,15,28
,2013,040200007,,,,45,47,92
,2013,040200009,,,,14,16,30
,2013,040200010,,,,28,26,54
,2013,040200011,,,,60,60,120
,2013,040200012,,,,38,45,83
,2013,040200014,,,,31,19,50
,2013,040200014,,,,5,5,10
,2013,040200016,,,,6,8,14
,2013,040200016,,,,15,11,26
,2013,040200017,,,,20,17,37
,2013,040200018,,,,64,67,131
,2013,040200019,,,,16,18,34
,2013,040200021,,,,40,27,67
,2013,040200022,,,,13,16,29
,2013,040200022,,,,4,6,10
,2013,040200025,,,,10,8,18
,2013,040200025,,,,28,26,54
,2013,040200026,,,,6,11,17
,2013,040200027,,,,26,20,46
,2013,040200028,,,,12,16,28
,2013,040200029,,,,36,33,69
,2013,040200030,,,,19,16,35
,2013,040200031,,,,32,32,64
,2013,040200032,,,,16,15,31
,2013,040200033,,,,15,17,32
,2013,040200034,,,,21,21,42
,2013,040200035,,,,30,20,50
,2013,040200036,,,,10,12,22
,2013,040200037,,,,26,28,54
,2013,040200037,,,,8,12,20
,2013,040200039,,,,13,11,24
,2013,040200040,,,,14,10,24
,2013,040200041,,,,12,13,25
,2013,040200042,,,,18,24,42
,2013,040200044,,,,22,21,43
,2013,040200045,,,,27,20,47
,2013,040200047,,,,10,12,22
,2013,040200048,,,,11,10,21
,2013,040200049,,,,12,13,25
,2013,040200050,,,,24,25,49
,2013,040200053,,,,3,17,20
,2013,040200054,,,,21,23,44
,2013,040200055,,,,6,24,30
,2013,040200056,,,,5,5,10
,2013,040200058,,,,3,7,10
,2013,040200059,,,,4,6,10
,2013,040200060,,,,4,7,11
,2013,040200061,,,,6,5,11
,2013,040200073,,,,13,14,27
,2013,040200091,,,,1,9,10
,2013,040200096,,,,4,7,11
,2013,040200103,,,,10,11,21
,2013,040200107,,,,11,8,19
,2013,040200107,,,,15,26,41
,2013,040200113,,,,14,4,18
,2013,040200114,,,,2,8,10
,2013,040200115,,,,4,7,11
,2013,040200116,,,,6,8,14
,2013,040200118,,,,6,5,11
,2013,040200120,,,,6,5,11
,2013,040200125,,,,3,7,10
,2013,040200125,,,,11,12,23
,2013,040200126,,,,11,11,22
,2013,040200126,,,,2,8,10
,2013,040200127,,,,17,32,49
,2013,040200128,,,,4,7,11
,2013,040200129,,,,4,6,10
,2013,040200130,,,,8,4,12
,2013,040200131,,,,5,6,11
,2013,040200132,,,,4,6,10
,2013,040200133,,,,3,7,10
,2013,040200134,,,,9,9,18
,2013,040200135,,,,6,9,15
,2013,040200136,,,,3,8,11
,2013,040200137,,,,4,6,10
,2013,040200138,,,,5,5,10
,2013,040200139,,,,6,4,10
,2013,040200140,,,,14,7,21
,2013,040200141,,,,10,0,10
,2013,040300001,,,,44,50,94
,2013,040300002,,,,11,21,32
,2013,040300003,,,,57,55,112
,2013,040300004,,,,65,50,115
,2013,040300005,,,,39,43,82
,2013,040300006,,,,38,47,85
,2013,040300007,,,,100,111,211
,2013,040300008,,,,50,28,78
,2013,040300009,,,,19,12,31
,2013,040300010,,,,35,18,53
,2013,040300011,,,,26,20,46
,2013,040300012,,,,35,26,61
,2013,040300013,,,,37,18,55
,2013,040300014,,,,27,19,46
,2013,040300015,,,,10,3,13
,2013,040300016,,,,15,8,23
,2013,040300017,,,,15,18,33
,2013,040300020,,,,33,45,78
,2013,040300021,,,,26,14,40
,2013,040300022,,,,4,5,9
,2013,040300025,,,,6,2,8
,2013,040300027,,,,4,5,9
,2013,040300028,,,,5,4,9
,2013,040300029,,,,13,14,27
,2013,040300030,,,,16,16,32
,2013,040300031,,,,20,20,40
,2013,040300046,,,,5,5,10
,2013,040300048,,,,4,5,9
,2013,040300050,,,,5,3,8
,2013,040300060,,,,4,6,10
,2013,040300063,,,,4,11,15
,2013,040300082,,,,2,6,8
,2013,040300083,,,,3,7,10
,2013,040300084,,,,6,4,10
,2013,040300085,,,,12,4,16
,2013,040300086,,,,5,4,9
,2013,040300087,,,,2,6,8
,2013,040300088,,,,11,4,15
,2013,040300089,,,,4,6,10
,2013,040300090,,,,6,9,15
,2013,040300091,,,,4,5,9
,2013,040300092,,,,5,5,10
,2013,040300093,,,,4,6,10
,2013,040300094,,,,8,3,11
,2013,040300095,,,,4,5,9
,2013,040400001,,,,18,20,38
,2013,040400002,,,,51,48,99
,2013,040400003,,,,464,420,884
,2013,040400004,,,,44,52,96
,2013,040400005,,,,49,43,92
,2013,040400006,,,,19,29,48
,2013,040400007,,,,38,26,64
,2013,040400008,,,,33,44,77
,2013,040400009,,,,34,51,85
,2013,040400010,,,,119,117,236
,2013,040400011,,,,104,85,189
,2013,040400012,,,,61,47,108
,2013,040400013,,,,52,66,118
,2013,040400014,,,,27,23,50
,2013,040400015,,,,42,41,83
,2013,040400016,,,,22,21,43
,2013,040400017,,,,18,10,28
,2013,040400018,,,,59,53,112
,2013,040400019,,,,61,98,159
,2013,040400020,,,,17,20,37
,2013,040400021,,,,16,13,29
,2013,040400022,,,,96,77,173
,2013,040400023,,,,47,31,78
,2013,040400024,,,,33,29,62
,2013,040400025,,,,39,26,65
,2013,040400026,,,,22,14,36
,2013,040400027,,,,11,15,26
,2013,040400028,,,,31,39,70
,2013,040400029,,,,12,17,29
,2013,040400030,,,,82,88,170
,2013,040400031,,,,24,20,44
,2013,040400032,,,,19,20,39
,2013,040400033,,,,27,13,40
,2013,040400034,,,,20,23,43
,2013,040400035,,,,23,26,49
,2013,040400036,,,,15,11,26
,2013,040400037,,,,28,16,44
,2013,040400038,,,,25,24,49
,2013,040400040,,,,18,12,30
,2013,040400041,,,,91,83,174
,2013,040400042,,,,51,44,95
,2013,040400043,,,,40,35,75
,2013,040400043,,,,16,12,28
,2013,040400044,,,,33,37,70
,2013,040400045,,,,10,10,20
,2013,040400048,,,,27,28,55
,2013,040400050,,,,26,31,57
,2013,040400051,,,,40,29,69
,2013,040400052,,,,47,36,83
,2013,040400053,,,,44,49,93
,2013,040400054,,,,18,26,44
,2013,040400055,,,,50,29,79
,2013,040400056,,,,5,6,11
,2013,040400057,,,,26,23,49
,2013,040400060,,,,2,4,6
,2013,040400060,,,,11,11,22
,2013,040400061,,,,87,59,146
,2013,040400062,,,,53,52,105
,2013,040400062,,,,81,98,179
,2013,040400062,,,,27,24,51
,2013,040400063,,,,48,21,69
,2013,040400064,,,,21,29,50
,2013,040400065,,,,32,34,66
,2013,040400066,,,,62,73,135
,2013,040400069,,,,13,12,25
,2013,040400070,,,,18,12,30
,2013,040400071,,,,12,22,34
,2013,040400072,,,,12,19,31
,2013,040400073,,,,286,331,617
,2013,040400073,,,,169,187,356
,2013,040400074,,,,24,8,32
,2013,040400075,,,,14,5,19
,2013,040400076,,,,12,12,24
,2013,040400077,,,,30,27,57
,2013,040400077,,,,4,4,8
,2013,040400078,,,,7,14,21
,2013,040400079,,,,10,9,19
,2013,040400083,,,,10,21,31
,2013,040400084,,,,3,6,9
,2013,040400084,,,,15,28,43
,2013,040400085,,,,25,34,59
,2013,040400086,,,,11,7,18
,2013,040400087,,,,10,9,19
,2013,040400088,,,,12,14,26
,2013,040400089,,,,19,13,32
,2013,040400091,,,,21,32,53
,2013,040400092,,,,12,12,24
,2013,040400093,,,,11,16,27
,2013,040400094,,,,51,46,97
,2013,040400096,,,,14,10,24
,2013,040400097,,,,12,10,22
,2013,040400097,,,,12,25,37
,2013,040400098,,,,14,15,29
,2013,040400099,,,,13,16,29
,2013,040400101,,,,30,34,64
,2013,040400102,,,,32,35,67
,2013,040400103,,,,45,39,84
,2013,040400106,,,,15,16,31
,2013,040400107,,,,25,21,46
,2013,040400108,,,,58,56,114
,2013,040400111,,,,9,10,19
,2013,040400113,,,,17,20,37
,2013,040400114,,,,26,20,46
,2013,040400116,,,,33,23,56
,2013,040400117,,,,14,3,17
,2013,040400118,,,,9,9,18
,2013,040400119,,,,21,22,43
,2013,040400120,,,,10,14,24
,2013,040400121,,,,2,8,10
,2013,040400122,,,,11,13,24
,2013,040400124,,,,33,21,54
,2013,040400125,,,,41,25,66
,2013,040400152,,,,4,10,14
,2013,040400153,,,,16,9,25
,2013,040400157,,,,2,4,6
,2013,040400166,,,,9,6,15
,2013,040400169,,,,6,5,11
,2013,040400173,,,,40,52,92
,2013,040400181,,,,37,35,72
,2013,040400182,,,,8,11,19
,2013,040400183,,,,28,16,44
,2013,040400184,,,,18,19,37
,2013,040400185,,,,13,12,25
,2013,040400186,,,,49,39,88
,2013,040400187,,,,14,15,29
,2013,040400188,,,,10,10,20
,2013,040400189,,,,10,12,22
,2013,040400190,,,,11,16,27
,2013,040400192,,,,4,5,9
,2013,040400193,,,,4,5,9
,2013,040400194,,,,5,2,7
,2013,040400195,,,,5,6,11
,2013,040400197,,,,5,4,9
,2013,040400198,,,,5,4,9
,2013,040400199,,,,6,5,11
,2013,040400200,,,,5,3,8
,2013,040400201,,,,6,3,9
,2013,040400202,,,,4,8,12
,2013,040400203,,,,7,3,10
,2013,040400204,,,,5,3,8
,2013,040400205,,,,5,8,13
,2013,040400206,,,,5,7,12
,2013,040400209,,,,6,4,10
,2013,040400211,,,,4,4,8
,2013,040400212,,,,1,6,7
,2013,040400213,,,,7,6,13
,2013,040400214,,,,7,5,12
,2013,040400215,,,,5,5,10
,2013,040400218,,,,4,5,9
,2013,040400219,,,,7,7,14
,2013,040400220,,,,4,3,7
,2013,040400222,,,,6,3,9
,2013,040400224,,,,10,4,14
,2013,040400225,,,,5,4,9
,2013,040400226,,,,4,5,9
,2013,040400227,,,,6,7,13
,2013,040400228,,,,4,4,8
,2013,040400229,,,,4,5,9
,2013,040400230,,,,2,4,6
,2013,040400231,,,,5,4,9
,2013,040400232,,,,5,9,14
,2013,040400233,,,,5,2,7
,2013,040400234,,,,2,2,4
,2013,040400235,,,,6,3,9
,2013,040400237,,,,12,10,22
,2013,040400238,,,,4,3,7
,2013,040400240,,,,6,7,13
,2013,040400241,,,,11,9,20
,2013,040400242,,,,2,5,7
,2013,040400243,,,,6,6,12
,2013,040400245,,,,6,3,9
,2013,040400246,,,,5,3,8
,2013,040400247,,,,6,4,10
,2013,040400248,,,,3,4,7
,2013,040400249,,,,7,3,10
,2013,040400250,,,,1,7,8
,2013,040400251,,,,7,3,10
,2013,040400253,,,,11,11,22
,2013,040400254,,,,11,13,24
,2013,040400255,,,,14,16,30
,2013,040400256,,,,25,9,34
,2013,040400257,,,,5,16,21
,2013,040400259,,,,20,25,45
,2013,040400259,,,,13,14,27
,2013,040400260,,,,5,0,5
,2013,040400261,,,,4,9,13
,2013,040400263,,,,10,7,17
,2013,040400264,,,,13,10,23
,2013,040400265,,,,5,5,10
,2013,040400266,,,,4,5,9
,2013,040400267,,,,2,6,8
,2013,040400270,,,,6,4,10
,2013,040500001,,,,11,17,28
,2013,040500002,,,,23,17,40
,2013,040500003,,,,352,357,709
,2013,040500004,,,,44,38,82
,2013,040500005,,,,22,36,58
,2013,040500006,,,,46,51,97
,2013,040500007,,,,99,86,185
,2013,040500008,,,,10,16,26
,2013,040500009,,,,25,26,51
,2013,040500010,,,,27,27,54
,2013,040500011,,,,24,19,43
,2013,040500012,,,,33,29,62
,2013,040500013,,,,33,33,66
,2013,040500014,,,,29,14,43
,2013,040500015,,,,11,18,29
,2013,040500016,,,,18,13,31
,2013,040500017,,,,9,13,22
,2013,040500018,,,,20,14,34
,2013,040500019,,,,17,10,27
,2013,040500019,,,,4,7,11
,2013,040500020,,,,13,14,27
,2013,040500022,,,,9,8,17
,2013,040500024,,,,15,19,34
,2013,040500025,,,,19,13,32
,2013,040500026,,,,11,11,22
,2013,040500027,,,,31,31,62
,2013,040500027,,,,7,10,17
,2013,040500028,,,,66,52,118
,2013,040500029,,,,48,59,107
,2013,040500031,,,,20,22,42
,2013,040500032,,,,7,11,18
,2013,040500032,,,,14,11,25
,2013,040500035,,,,143,195,338
,2013,040500036,,,,6,8,14
,2013,040500037,,,,6,13,19
,2013,040500038,,,,13,13,26
,2013,040500039,,,,7,9,16
,2013,040500040,,,,10,8,18
,2013,040500041,,,,6,10,16
,2013,040500041,,,,11,19,30
,2013,040500044,,,,8,8,16
,2013,040500047,,,,10,14,24
,2013,040500048,,,,8,14,22
,2013,040500049,,,,8,10,18
,2013,040500050,,,,9,9,18
,2013,040500052,,,,10,1,11
,2013,040500053,,,,8,5,13
,2013,040500054,,,,3,6,9
,2013,040500056,,,,3,5,8
,2013,040500058,,,,6,3,9
,2013,040500060,,,,3,6,9
,2013,040500061,,,,7,3,10
,2013,040500064,,,,5,9,14
,2013,040500066,,,,5,7,12
,2013,040500067,,,,6,2,8
,2013,040500068,,,,9,6,15
,2013,040500071,,,,17,23,40
,2013,040500072,,,,14,33,47
,2013,040500073,,,,7,5,12
,2013,040500074,,,,7,3,10
,2013,040500076,,,,9,7,16
,2013,040500078,,,,6,4,10
,2013,040500081,,,,6,2,8
,2013,040500082,,,,6,4,10
,2013,040500083,,,,7,2,9
,2013,040500084,,,,7,11,18
,2013,040600001,,,,33,26,59
,2013,040600002,,,,247,236,483
,2013,040600003,,,,64,85,149
,2013,040600004,,,,60,52,112
,2013,040600005,,,,106,116,222
,2013,040600006,,,,69,77,146
,2013,040600007,,,,53,36,89
,2013,040600008,,,,22,34,56
,2013,040600009,,,,49,32,81
,2013,040600010,,,,31,39,70
,2013,040600011,,,,55,52,107
,2013,040600012,,,,21,36,57
,2013,040600013,,,,28,14,42
,2013,040600014,,,,28,20,48
,2013,040600015,,,,13,18,31
,2013,040600016,,,,32,25,57
,2013,040600017,,,,21,24,45
,2013,040600018,,,,23,28,51
,2013,040600019,,,,58,37,95
,2013,040600020,,,,21,19,40
,2013,040600021,,,,38,31,69
,2013,040600022,,,,106,107,213
,2013,040600024,,,,5,5,10
,2013,040600025,,,,28,16,44
,2013,040600026,,,,16,5,21
,2013,040600027,,,,7,15,22
,2013,040600028,,,,12,14,26
,2013,040600029,,,,18,27,45
,2013,040600030,,,,68,77,145
,2013,040600031,,,,19,11,30
,2013,040600031,,,,4,3,7
,2013,040600032,,,,23,27,50
,2013,040600033,,,,14,10,24
,2013,040600034,,,,14,14,28
,2013,040600035,,,,9,12,21
,2013,040600036,,,,21,21,42
,2013,040600037,,,,12,15,27
,2013,040600038,,,,280,348,628
,2013,040600040,,,,9,6,15
,2013,040600041,,,,18,13,31
,2013,040600042,,,,10,14,24
,2013,040600043,,,,16,11,27
,2013,040600045,,,,25,23,48
,2013,040600046,,,,20,20,40
,2013,040600047,,,,5,5,10
,2013,040600050,,,,12,8,20
,2013,040600053,,,,4,4,8
,2013,040600058,,,,4,3,7
,2013,040600060,,,,4,4,8
,2013,040600068,,,,9,11,20
,2013,040600069,,,,6,7,13
,2013,040600070,,,,4,5,9
,2013,040600071,,,,5,5,10
,2013,040600073,,,,4,5,9
,2013,040600074,,,,5,4,9
,2013,040600075,,,,5,4,9
,2013,040600076,,,,4,4,8
,2013,040600078,,,,5,5,10
,2013,040600079,,,,3,4,7
,2013,040600080,,,,5,6,11
,2013,040600081,,,,3,6,9
,2013,040600083,,,,4,4,8
,2013,040600084,,,,4,6,10
,2013,040600085,,,,6,4,10
,2013,040600086,,,,3,4,7
,2013,040600087,,,,6,6,12
,2013,040600088,,,,4,4,8
,2013,040600089,,,,4,4,8
,2013,040600090,,,,6,6,12
,2013,040600092,,,,4,4,8
,2013,040600093,,,,4,4,8
,2013,040600094,,,,4,3,7
,2013,040600095,,,,5,5,10
,2013,040600096,,,,6,7,13
,2013,040600097,,,,13,29,42
,2013,040600098,,,,23,21,44
,2013,040600099,,,,3,4,7
,2013,040600100,,,,4,4,8
,2013,040600101,,,,4,4,8
,2013,040600102,,,,4,3,7
,2013,040600103,,,,3,4,7
,2013,040600104,,,,4,5,9
,2013,040600105,,,,6,3,9
,2013,040600106,,,,4,4,8
,2013,040600107,,,,5,4,9
,2013,040600108,,,,4,3,7
,2013,040600109,,,,4,5,9
,2013,040600110,,,,5,4,9
,2013,040600111,,,,4,6,10
,2013,040600112,,,,5,3,8
,2013,040600113,,,,4,3,7
,2013,040600114,,,,5,5,10
,2013,040700001,,,,161,154,315
,2013,040700003,,,,30,32,62
,2013,040700004,,,,13,10,23
,2013,040700005,,,,17,13,30
,2013,040700006,,,,38,29,67
,2013,040700007,,,,56,46,102
,2013,040700008,,,,24,24,48
,2013,040700009,,,,66,61,127
,2013,040700010,,,,57,47,104
,2013,040700011,,,,33,34,67
,2013,040700012,,,,27,17,44
,2013,040700014,,,,14,14,28
,2013,040700015,,,,6,8,14
,2013,040700016,,,,22,14,36
,2013,040700018,,,,52,44,96
,2013,040700019,,,,8,15,23
,2013,040700020,,,,2,6,8
,2013,040700022,,,,4,4,8
,2013,040700023,,,,4,5,9
,2013,040700024,,,,26,28,54
,2013,040700025,,,,6,11,17
,2013,040700031,,,,8,3,11
,2013,040700034,,,,5,6,11
,2013,040700035,,,,4,3,7
,2013,040700039,,,,10,7,17
,2013,040700040,,,,4,6,10
,2013,040700041,,,,4,3,7
,2013,040700042,,,,4,4,8
,2013,040700044,,,,2,5,7
,2013,040700047,,,,6,4,10
,2013,040700048,,,,5,5,10
,2013,040700049,,,,10,9,19
,2013,040700050,,,,4,5,9
,2013,040700052,,,,9,2,11
,2013,040700053,,,,3,4,7
,2013,040700054,,,,6,11,17
,2013,040700055,,,,3,6,9
,2013,040800001,,,,276,293,569
,2013,040800002,,,,28,31,59
,2013,040800003,,,,38,32,70
,2013,040800004,,,,11,9,20
,2013,040800005,,,,18,18,36
,2013,040800006,,,,30,29,59
,2013,040800007,,,,13,6,19
,2013,040800008,,,,11,8,19
,2013,040800008,,,,5,6,11
,2013,040800009,,,,55,50,105
,2013,040800010,,,,9,1,10
,2013,040800010,,,,81,132,213
,2013,040800012,,,,17,19,36
,2013,040800014,,,,9,13,22
,2013,040800015,,,,3,5,8
,2013,040800016,,,,13,11,24
,2013,040800018,,,,26,27,53
,2013,040800021,,,,1,6,7
,2013,040800035,,,,5,6,11
,2013,040800040,,,,2,5,7
,2013,040800041,,,,5,4,9
,2013,040800043,,,,7,10,17
,2013,040800045,,,,4,3,7
,2013,040900001,,,,20,21,41
,2013,040900002,,,,326,291,617
,2013,040900003,,,,28,37,65
,2013,040900004,,,,175,186,361
,2013,040900005,,,,30,39,69
,2013,040900006,,,,79,58,137
,2013,040900007,,,,66,61,127
,2013,040900008,,,,67,67,134
,2013,040900009,,,,55,59,114
,2013,040900010,,,,61,65,126
,2013,040900011,,,,27,17,44
,2013,040900012,,,,126,155,281
,2013,040900013,,,,56,42,98
,2013,040900014,,,,105,96,201
,2013,040900015,,,,17,19,36
,2013,040900016,,,,35,22,57
,2013,040900017,,,,8,4,12
,2013,040900018,,,,75,62,137
,2013,040900019,,,,83,74,157
,2013,040900020,,,,44,28,72
,2013,040900021,,,,11,15,26
,2013,040900022,,,,23,28,51
,2013,040900023,,,,26,22,48
,2013,040900024,,,,5,13,18
,2013,040900025,,,,22,27,49
,2013,040900027,,,,8,7,15
,2013,040900028,,,,9,19,28
,2013,040900029,,,,7,9,16
,2013,040900030,,,,32,30,62
,2013,040900031,,,,40,35,75
,2013,040900032,,,,42,47,89
,2013,040900033,,,,27,26,53
,2013,040900034,,,,25,28,53
,2013,040900035,,,,15,6,21
,2013,040900036,,,,34,29,63
,2013,040900037,,,,13,9,22
,2013,040900038,,,,247,256,503
,2013,040900039,,,,6,9,15
,2013,040900041,,,,18,20,38
,2013,040900042,,,,24,16,40
,2013,040900043,,,,14,11,25
,2013,040900044,,,,19,21,40
,2013,040900045,,,,12,10,22
,2013,040900046,,,,95,75,170
,2013,040900047,,,,13,14,27
,2013,040900049,,,,6,15,21
,2013,040900050,,,,8,1,9
,2013,040900055,,,,9,8,17
,2013,040900059,,,,8,7,15
,2013,040900082,,,,9,5,14
,2013,040900084,,,,13,13,26
,2013,040900087,,,,6,4,10
,2013,040900093,,,,6,4,10
,2013,040900095,,,,7,8,15
,2013,040900097,,,,6,5,11
,2013,040900100,,,,7,4,11
,2013,040900101,,,,6,16,22
,2013,040900102,,,,11,13,24
,2013,040900103,,,,13,10,23
,2013,040900104,,,,4,0,4
,2013,040900104,,,,9,8,17
,2013,040900104,,,,3,6,9
,2013,040900106,,,,3,8,11
,2013,040900111,,,,5,4,9
,2013,040900112,,,,2,7,9
,2013,040900114,,,,3,5,8
,2013,040900115,,,,6,4,10
,2013,040900117,,,,3,5,8
,2013,040900119,,,,20,21,41
,2013,040900120,,,,6,8,14
,2013,040900124,,,,4,4,8
,2013,040900125,,,,4,5,9
,2013,040900126,,,,5,6,11
,2013,041000002,,,,270,271,541
,2013,041000003,,,,39,35,74
,2013,041000004,,,,12,7,19
,2013,041000005,,,,45,47,92
,2013,041000006,,,,16,16,32
,2013,041000007,,,,82,69,151
,2013,041000008,,,,47,58,105
,2013,041000009,,,,16,24,40
,2013,041000011,,,,21,20,41
,2013,041000012,,,,50,54,104
,2013,041000013,,,,57,43,100
,2013,041000014,,,,101,92,193
,2013,041000015,,,,42,69,111
,2013,041000016,,,,188,198,386
,2013,041000017,,,,40,23,63
,2013,041000018,,,,33,22,55
,2013,041000019,,,,53,71,124
,2013,041000020,,,,60,61,121
,2013,041000021,,,,26,47,73
,2013,041000022,,,,37,37,74
,2013,041000023,,,,27,28,55
,2013,041000025,,,,27,25,52
,2013,041000026,,,,10,9,19
,2013,041000027,,,,31,32,63
,2013,041000028,,,,42,46,88
,2013,041000029,,,,32,22,54
,2013,041000029,,,,5,3,8
,2013,041000030,,,,137,167,304
,2013,041000031,,,,29,20,49
,2013,041000033,,,,21,27,48
,2013,041000034,,,,21,22,43
,2013,041000035,,,,7,12,19
,2013,041000036,,,,13,21,34
,2013,041000037,,,,27,28,55
,2013,041000038,,,,24,26,50
,2013,041000039,,,,8,14,22
,2013,041000040,,,,8,13,21
,2013,041000041,,,,13,10,23
,2013,041000042,,,,12,15,27
,2013,041000043,,,,16,12,28
,2013,041000044,,,,45,30,75
,2013,041000045,,,,19,19,38
,2013,041000046,,,,27,16,43
,2013,041000048,,,,14,25,39
,2013,041000049,,,,8,16,24
,2013,041000050,,,,15,23,38
,2013,041000051,,,,44,75,119
,2013,041000052,,,,53,39,92
,2013,041000053,,,,24,17,41
,2013,041000054,,,,24,31,55
,2013,041000056,,,,36,43,79
,2013,041000057,,,,11,6,17
,2013,041000058,,,,240,225,465
,2013,041000059,,,,33,36,69
,2013,041000060,,,,35,44,79
,2013,041000062,,,,301,353,654
,2013,041000063,,,,14,16,30
,2013,041000065,,,,14,10,24
,2013,041000067,,,,16,10,26
,2013,041000068,,,,7,14,21
,2013,041000069,,,,13,9,22
,2013,041000070,,,,16,26,42
,2013,041000072,,,,5,5,10
,2013,041000073,,,,6,3,9
,2013,041000074,,,,8,13,21
,2013,041000076,,,,34,39,73
,2013,041000078,,,,9,12,21
,2013,041000079,,,,18,17,35
,2013,041000080,,,,9,13,22
,2013,041000084,,,,5,8,13
,2013,041000085,,,,6,6,12
,2013,041000089,,,,3,5,8
,2013,041000091,,,,4,3,7
,2013,041000093,,,,4,3,7
,2013,041000097,,,,6,3,9
,2013,041000099,,,,3,2,5
,2013,041000103,,,,3,4,7
,2013,041000104,,,,5,1,6
,2013,041000108,,,,4,4,8
,2013,041000114,,,,16,24,40
,2013,041000115,,,,9,14,23
,2013,041000116,,,,11,14,25
,2013,041000117,,,,4,6,10
,2013,041000123,,,,3,7,10
,2013,041000133,,,,6,6,12
,2013,041000136,,,,5,3,8
,2013,041000141,,,,38,51,89
,2013,041000141,,,,14,30,44
,2013,041000142,,,,20,31,51
,2013,041000143,,,,3,5,8
,2013,041000143,,,,11,12,23
,2013,041000144,,,,11,14,25
,2013,041000148,,,,5,3,8
,2013,041000151,,,,5,4,9
,2013,041000152,,,,4,5,9
,2013,041000157,,,,3,3,6
,2013,041000159,,,,10,7,17
,2013,041000162,,,,3,5,8
,2013,041000169,,,,7,3,10
,2013,041000173,,,,3,3,6
,2013,041000175,,,,2,6,8
,2013,041000176,,,,3,5,8
,2013,041000177,,,,4,3,7
,2013,041000180,,,,4,4,8
,2013,041000181,,,,2,5,7
,2013,041000182,,,,6,6,12
,2013,041000183,,,,6,3,9
,2013,041000184,,,,1,6,7
,2013,041000185,,,,5,8,13
,2013,041000187,,,,2,2,4
,2013,041000188,,,,5,5,10
,2013,041000189,,,,4,4,8
,2013,041000191,,,,4,6,10
,2013,041000193,,,,15,11,26
,2013,041000194,,,,16,17,33
,2013,041100001,,,,12,16,28
,2013,041100002,,,,61,73,134
,2013,041100003,,,,14,17,31
,2013,041100004,,,,23,26,49
,2013,041100005,,,,79,84,163
,2013,041100006,,,,45,45,90
,2013,041100007,,,,45,47,92
,2013,041100008,,,,9,8,17
,2013,041100009,,,,94,86,180
,2013,041100010,,,,75,71,146
,2013,041100011,,,,86,85,171
,2013,041100012,,,,16,12,28
,2013,041100014,,,,19,26,45
,2013,041100015,,,,40,49,89
,2013,041100016,,,,14,12,26
,2013,041100017,,,,9,15,24
,2013,041100018,,,,10,13,23
,2013,041100019,,,,8,12,20
,2013,041100020,,,,9,7,16
,2013,041100022,,,,88,107,195
,2013,041100023,,,,18,7,25
,2013,041100024,,,,4,5,9
,2013,041100025,,,,10,8,18
,2013,041100026,,,,15,7,22
,2013,041100027,,,,11,6,17
,2013,041100030,,,,8,7,15
,2013,041100030,,,,263,310,573
,2013,041100031,,,,8,7,15
,2013,041100035,,,,9,4,13
,2013,041100036,,,,12,6,18
,2013,041100037,,,,3,6,9
,2013,041100041,,,,5,7,12
,2013,041100045,,,,5,5,10
,2013,041200001,,,,36,29,65
,2013,041200002,,,,11,9,20
,2013,041200003,,,,9,20,29
,2013,041200004,,,,25,22,47
,2013,041200005,,,,83,71,154
,2013,041200006,,,,78,99,177
,2013,041200007,,,,45,43,88
,2013,041200009,,,,63,88,151
,2013,041200010,,,,128,114,242
,2013,041200011,,,,106,98,204
,2013,041200012,,,,54,59,113
,2013,041200013,,,,16,13,29
,2013,041200014,,,,26,26,52
,2013,041200016,,,,26,22,48
,2013,041200017,,,,12,11,23
,2013,041200018,,,,19,14,33
,2013,041200019,,,,29,24,53
,2013,041200020,,,,15,8,23
,2013,041200021,,,,8,16,24
,2013,041200022,,,,20,15,35
,2013,041200023,,,,11,16,27
,2013,041200024,,,,13,3,16
,2013,041200025,,,,22,19,41
,2013,041200026,,,,21,24,45
,2013,041200027,,,,201,173,374
,2013,041200028,,,,37,30,67
,2013,041200029,,,,38,32,70
,2013,041200030,,,,24,17,41
,2013,041200031,,,,30,22,52
,2013,041200032,,,,36,35,71
,2013,041200033,,,,51,39,90
,2013,041200034,,,,22,34,56
,2013,041200035,,,,6,11,17
,2013,041200036,,,,19,12,31
,2013,041200037,,,,25,9,34
,2013,041200045,,,,15,10,25
,2013,041200046,,,,14,19,33
,2013,041200047,,,,24,11,35
,2013,041200048,,,,8,10,18
,2013,041200049,,,,19,14,33
,2013,041200062,,,,3,6,9
,2013,041200063,,,,3,7,10
,2013,041200064,,,,6,2,8
,2013,041200065,,,,6,3,9
,2013,041200066,,,,5,4,9
,2013,041200067,,,,3,5,8
,2013,041200070,,,,6,4,10
,2013,041200072,,,,4,4,8
,2013,041200073,,,,6,6,12
,2013,041200074,,,,24,21,45
,2013,041200074,,,,12,14,26
,2013,041200076,,,,8,4,12
,2013,041200077,,,,4,5,9
,2013,041200078,,,,4,5,9
,2013,041200079,,,,5,4,9
,2013,041200080,,,,4,4,8
,2013,041200081,,,,6,9,15
,2013,041200082,,,,8,4,12
,2013,041200083,,,,4,6,10
,2013,041200084,,,,5,4,9
,2013,041200085,,,,5,4,9
,2013,041200086,,,,5,4,9
,2013,041200087,,,,5,5,10
,2013,041200088,,,,2,7,9
,2013,041200089,,,,7,5,12
,2013,041200090,,,,5,5,10
,2013,041200091,,,,11,13,24
,2013,041200092,,,,9,2,11
,2013,041200093,,,,5,6,11
,2013,041200094,,,,4,6,10
,2013,041200095,,,,5,5,10
,2013,041200096,,,,6,5,11
,2013,041200098,,,,4,4,8
,2013,041200099,,,,6,2,8
,2013,041200100,,,,14,6,20
,2013,041200101,,,,8,13,21
,2013,041300001,,,,151,127,278
,2013,041300002,,,,261,210,471
,2013,041300003,,,,110,136,246
,2013,041300004,,,,16,16,32
,2013,041300005,,,,73,77,150
,2013,041300006,,,,90,88,178
,2013,041300007,,,,166,200,366
,2013,041300008,,,,433,391,824
,2013,041300009,,,,14,13,27
,2013,041300010,,,,204,191,395
,2013,041300011,,,,52,44,96
,2013,041300012,,,,29,24,53
,2013,041300013,,,,63,68,131
,2013,041300015,,,,202,184,386
,2013,041300016,,,,141,158,299
,2013,041300017,,,,73,66,139
,2013,041300018,,,,43,48,91
,2013,041300019,,,,15,15,30
,2013,041300020,,,,251,250,501
,2013,041300021,,,,59,37,96
,2013,041300022,,,,16,9,25
,2013,041300023,,,,13,20,33
,2013,041300024,,,,14,15,29
,2013,041300025,,,,17,20,37
,2013,041300025,,,,45,43,88
,2013,041300029,,,,19,23,42
,2013,041300030,,,,17,13,30
,2013,041300031,,,,13,15,28
,2013,041300032,,,,13,16,29
,2013,041300033,,,,14,17,31
,2013,041300034,,,,31,26,57
,2013,041300035,,,,13,18,31
,2013,041300036,,,,27,26,53
,2013,041300037,,,,27,42,69
,2013,041300038,,,,52,41,93
,2013,041300041,,,,15,12,27
,2013,041300042,,,,9,12,21
,2013,041300043,,,,17,26,43
,2013,041300043,,,,123,132,255
,2013,041300044,,,,9,13,22
,2013,041300045,,,,12,14,26
,2013,041300046,,,,38,45,83
,2013,041300047,,,,55,49,104
,2013,041300049,,,,12,14,26
,2013,041300050,,,,503,583,1086
,2013,041300051,,,,132,155,287
,2013,041300052,,,,115,97,212
,2013,041300054,,,,42,70,112
,2013,041300054,,,,56,41,97
,2013,041300055,,,,14,6,20
,2013,041300057,,,,9,7,16
,2013,041300058,,,,22,15,37
,2013,041300059,,,,100,84,184
,2013,041300060,,,,24,11,35
,2013,041300062,,,,7,6,13
,2013,041300065,,,,7,3,10
,2013,041300067,,,,5,4,9
,2013,041300068,,,,41,42,83
,2013,041300069,,,,8,1,9
,2013,041300071,,,,6,3,9
,2013,041300072,,,,5,6,11
,2013,041300072,,,,40,28,68
,2013,041300072,,,,14,12,26
,2013,041300073,,,,36,43,79
,2013,041300092,,,,97,99,196
,2013,041300097,,,,5,8,13
,2013,041300104,,,,16,16,32
,2013,041300105,,,,6,5,11
,2013,041300106,,,,7,2,9
,2013,041300107,,,,4,4,8
,2013,041300108,,,,6,4,10
,2013,041300109,,,,6,3,9
,2013,041300110,,,,5,4,9
,2013,041300111,,,,5,5,10
,2013,041300112,,,,6,3,9
,2013,041300113,,,,2,6,8
,2013,041300114,,,,5,5,10
,2013,041300115,,,,1,8,9
,2013,041300116,,,,879,1142,2021
,2013,041300118,,,,7,3,10
,2013,041300119,,,,3,3,6
,2013,041300120,,,,14,9,23
,2013,041300120,,,,7,7,14
,2013,041300120,,,,22,18,40
,2013,041300121,,,,4,7,11
,2013,041300122,,,,5,5,10
,2013,041300123,,,,5,4,9
,2013,041300124,,,,5,3,8
,2013,041300125,,,,7,3,10
,2013,041300126,,,,5,1,6
,2013,041300127,,,,3,6,9
,2013,041300129,,,,256,384,640
,2013,041400001,,,,22,27,49
,2013,041400002,,,,133,204,337
,2013,041400003,,,,27,25,52
,2013,041400004,,,,23,44,67
,2013,041400005,,,,28,41,69
,2013,041400006,,,,10,8,18
,2013,041400006,,,,19,9,28
,2013,041400007,,,,5,1,6
,2013,041400008,,,,3,5,8
,2013,041400009,,,,6,12,18
,2013,041400010,,,,15,5,20
,2013,041400011,,,,12,20,32
,2013,041400015,,,,4,5,9
,2013,041400028,,,,1,5,6
,2013,041400046,,,,10,6,16
,2013,041400046,,,,11,20,31
,2013,041400047,,,,2,2,4
,2013,041400048,,,,8,2,10
,2013,041400049,,,,1,4,5
,2013,041400050,,,,2,3,5
,2013,041400052,,,,8,7,15
,2013,041400053,,,,9,8,17
,2013,041400054,,,,36,36,72
,2013,041400055,,,,4,6,10
,2013,041400056,,,,6,13,19
,2013,041400057,,,,7,5,12
,2013,041400059,,,,4,5,9
,2013,041500001,,,,200,213,413
,2013,041500002,,,,53,60,113
,2013,041500003,,,,91,113,204
,2013,041500004,,,,69,66,135
,2013,041500005,,,,10,11,21
,2013,041500006,,,,21,17,38
,2013,041500008,,,,59,72,131
,2013,041500009,,,,69,61,130
,2013,041500010,,,,12,11,23
,2013,041500011,,,,5,9,14
,2013,041500012,,,,28,20,48
,2013,041500013,,,,91,73,164
,2013,041500014,,,,19,18,37
,2013,041500015,,,,11,12,23
,2013,041500016,,,,4,10,14
,2013,041500017,,,,8,4,12
,2013,041500018,,,,13,12,25
,2013,041500019,,,,87,96,183
,2013,041500021,,,,9,14,23
,2013,041500022,,,,11,19,30
,2013,041500023,,,,20,16,36
,2013,041500024,,,,12,12,24
,2013,041500025,,,,11,15,26
,2013,041500026,,,,38,45,83
,2013,041500027,,,,9,13,22
,2013,041500028,,,,19,20,39
,2013,041500031,,,,12,20,32
,2013,041500032,,,,11,10,21
,2013,041500034,,,,23,17,40
,2013,041500035,,,,7,9,16
,2013,041500036,,,,9,7,16
,2013,041500040,,,,3,8,11
,2013,041500061,,,,3,9,12
,2013,041500062,,,,3,3,6
,2013,041500064,,,,3,5,8
,2013,041500065,,,,4,3,7
,2013,041500066,,,,3,4,7
,2013,041500067,,,,6,4,10
,2013,041500070,,,,3,3,6
,2013,041500071,,,,3,4,7
,2013,041500072,,,,4,5,9
,2013,041500075,,,,3,4,7
,2013,041500076,,,,3,5,8
,2013,041500077,,,,5,6,11
,2013,041500079,,,,4,6,10
,2013,041500080,,,,4,4,8
,2013,041500082,,,,11,9,20
,2013,041500083,,,,11,4,15
,2013,041500084,,,,5,8,13
,2013,041500085,,,,12,17,29
,2013,041500086,,,,4,6,10
,2013,041500087,,,,6,5,11
,2013,041500088,,,,5,5,10
,2013,041500089,,,,4,4,8
,2013,041500090,,,,2,7,9
,2013,041600001,,,,159,123,282
,2013,041600002,,,,41,53,94
,2013,041600003,,,,91,53,144
,2013,041600004,,,,86,65,151
,2013,041600005,,,,18,21,39
,2013,041600006,,,,36,34,70
,2013,041600007,,,,14,18,32
,2013,041600008,,,,14,11,25
,2013,041600009,,,,19,20,39
,2013,041600010,,,,13,7,20
,2013,041600012,,,,12,9,21
,2013,041600013,,,,28,16,44
,2013,041600014,,,,17,9,26
,2013,041600015,,,,21,19,40
,2013,041600016,,,,10,10,20
,2013,041600051,,,,5,5,10
,2013,041600055,,,,7,3,10
,2013,041600056,,,,2,3,5
,2013,041600061,,,,8,3,11
,2013,041600062,,,,4,5,9
,2013,041700001,,,,5,6,11
,2013,041700002,,,,151,137,288
,2013,041700003,,,,192,152,344
,2013,041700004,,,,22,22,44
,2013,041700005,,,,114,109,223
,2013,041700006,,,,48,40,88
,2013,041700007,,,,27,25,52
,2013,041700008,,,,15,25,40
,2013,041700009,,,,13,13,26
,2013,041700010,,,,16,18,34
,2013,041700011,,,,42,47,89
,2013,041700012,,,,26,16,42
,2013,041700013,,,,130,127,257
,2013,041700014,,,,21,17,38
,2013,041700030,,,,6,8,14
,2013,041700031,,,,5,5,10
,2013,041700031,,,,4,6,10
,2013,041700033,,,,6,4,10
,2013,041700034,,,,3,3,6
,2013,041700037,,,,5,4,9
,2013,041800001,,,,10,14,24
,2013,041800003,,,,78,72,150
,2013,041800004,,,,44,42,86
,2013,041800005,,,,51,45,96
,2013,041800005,,,,3,6,9
,2013,041800006,,,,32,35,67
,2013,041800007,,,,32,31,63
,2013,041800009,,,,32,20,52
,2013,041800010,,,,42,39,81
,2013,041800011,,,,160,138,298
,2013,041800012,,,,36,47,83
,2013,041800013,,,,75,61,136
,2013,041800014,,,,31,44,75
,2013,041800015,,,,46,65,111
,2013,041800016,,,,6,6,12
,2013,041800016,,,,11,15,26
,2013,041800017,,,,10,4,14
,2013,041800018,,,,4,4,8
,2013,041800018,,,,37,37,74
,2013,041800019,,,,23,19,42
,2013,041800019,,,,12,7,19
,2013,041800020,,,,3,4,7
,2013,041800022,,,,31,31,62
,2013,041800023,,,,13,20,33
,2013,041800024,,,,10,20,30
,2013,041800025,,,,13,11,24
,2013,041800026,,,,12,12,24
,2013,041800027,,,,108,119,227
,2013,041800028,,,,9,7,16
,2013,041800029,,,,9,9,18
,2013,041800030,,,,8,12,20
,2013,041800031,,,,13,8,21
,2013,041800032,,,,8,12,20
,2013,041800034,,,,7,4,11
,2013,041800055,,,,3,7,10
,2013,041800058,,,,3,6,9
,2013,041800063,,,,4,5,9
,2013,041800064,,,,3,6,9
,2013,041800067,,,,4,4,8
,2013,041800069,,,,2,6,8
,2013,041800070,,,,5,5,10
,2013,041800074,,,,4,4,8
,2013,041800075,,,,5,7,12
,2013,041800078,,,,5,4,9
,2013,041800080,,,,2,6,8
,2013,041800081,,,,5,3,8
,2013,041800082,,,,4,5,9
,2013,041800083,,,,11,21,32
,2013,041800088,,,,6,6,12
,2013,041800089,,,,4,6,10
,2013,041800091,,,,5,4,9
,2013,041800092,,,,3,8,11
,2013,041800093,,,,5,4,9
,2013,041800094,,,,5,2,7
,2013,041800096,,,,3,4,7
,2013,041800097,,,,5,4,9
,2013,041800098,,,,3,5,8
,2013,041800099,,,,1,5,6
,2013,041900001,,,,216,231,447
,2013,041900002,,,,47,52,99
,2013,041900003,,,,10,13,23
,2013,041900004,,,,32,30,62
,2013,041900005,,,,57,52,109
,2013,041900006,,,,11,14,25
,2013,041900007,,,,30,36,66
,2013,041900008,,,,72,62,134
,2013,041900009,,,,14,10,24
,2013,041900010,,,,29,26,55
,2013,041900011,,,,15,11,26
,2013,041900012,,,,13,12,25
,2013,041900013,,,,7,6,13
,2013,041900014,,,,30,32,62
,2013,041900015,,,,6,8,14
,2013,041900016,,,,13,18,31
,2013,041900017,,,,127,102,229
,2013,041900018,,,,9,19,28
,2013,041900019,,,,11,4,15
,2013,041900020,,,,9,11,20
,2013,041900023,,,,5,10,15
,2013,041900024,,,,1,8,9
,2013,041900026,,,,7,3,10
,2013,041900030,,,,2,4,6
,2013,041900033,,,,3,5,8
,2013,041900044,,,,29,21,50
,2013,041900047,,,,4,8,12
,2013,041900052,,,,4,5,9
,2013,041900053,,,,7,4,11
,2013,041900054,,,,6,8,14
,2013,041900055,,,,3,6,9
,2013,042000001,,,,10,10,20
,2013,042000003,,,,9,6,15
,2013,042000004,,,,23,25,48
,2013,042000005,,,,158,120,278
,2013,042000006,,,,29,22,51
,2013,042000007,,,,57,66,123
,2013,042000008,,,,12,9,21
,2013,042000010,,,,13,9,22
,2013,042000011,,,,11,8,19
,2013,042000012,,,,8,13,21
,2013,042000013,,,,11,14,25
,2013,042000014,,,,20,22,42
,2013,042000016,,,,21,13,34
,2013,042000017,,,,8,9,17
,2013,042000018,,,,18,19,37
,2013,042000019,,,,23,18,41
,2013,042000021,,,,12,8,20
,2013,042000022,,,,26,21,47
,2013,042000023,,,,22,22,44
,2013,042000024,,,,91,174,265
,2013,042000025,,,,18,21,39
,2013,042000026,,,,16,29,45
,2013,042000027,,,,11,10,21
,2013,042000031,,,,12,10,22
,2013,042000032,,,,10,10,20
,2013,042000034,,,,9,5,14
,2013,042000035,,,,12,11,23
,2013,042000036,,,,10,10,20
,2013,042000037,,,,15,2,17
,2013,042000038,,,,12,5,17
,2013,042000041,,,,19,21,40
,2013,042000043,,,,5,1,6
,2013,042000044,,,,2,7,9
,2013,042000049,,,,6,3,9
,2013,042000052,,,,5,5,10
,2013,042000053,,,,4,5,9
,2013,042000054,,,,2,4,6
,2013,042000057,,,,5,3,8
,2013,042000059,,,,7,6,13
,2013,042000060,,,,139,132,271
,2013,042100001,,,,37,24,61
,2013,042100002,,,,6,4,10
,2013,042100002,,,,34,28,62
,2013,042100003,,,,266,251,517
,2013,042100004,,,,20,22,42
,2013,042100005,,,,34,21,55
,2013,042100006,,,,33,39,72
,2013,042100007,,,,62,59,121
,2013,042100008,,,,77,54,131
,2013,042100009,,,,20,15,35
,2013,042100010,,,,49,61,110
,2013,042100011,,,,26,22,48
,2013,042100012,,,,28,46,74
,2013,042100013,,,,36,40,76
,2013,042100014,,,,20,19,39
,2013,042100015,,,,32,28,60
,2013,042100016,,,,20,25,45
,2013,042100017,,,,49,60,109
,2013,042100018,,,,174,168,342
,2013,042100019,,,,22,34,56
,2013,042100020,,,,59,61,120
,2013,042100021,,,,35,43,78
,2013,042100022,,,,50,41,91
,2013,042100023,,,,38,40,78
,2013,042100024,,,,18,33,51
,2013,042100025,,,,44,41,85
,2013,042100026,,,,22,28,50
,2013,042100027,,,,20,29,49
,2013,042100027,,,,9,10,19
,2013,042100029,,,,41,34,75
,2013,042100030,,,,30,28,58
,2013,042100031,,,,20,22,42
,2013,042100032,,,,26,19,45
,2013,042100033,,,,16,17,33
,2013,042100034,,,,14,13,27
,2013,042100035,,,,64,57,121
,2013,042100036,,,,27,31,58
,2013,042100037,,,,29,46,75
,2013,042100038,,,,18,23,41
,2013,042100039,,,,24,20,44
,2013,042100040,,,,23,31,54
,2013,042100041,,,,26,19,45
,2013,042100042,,,,14,14,28
,2013,042100043,,,,13,7,20
,2013,042100044,,,,16,18,34
,2013,042100047,,,,15,13,28
,2013,042100048,,,,23,21,44
,2013,042100049,,,,39,40,79
,2013,042100050,,,,29,34,63
,2013,042100055,,,,14,11,25
,2013,042100055,,,,4,6,10
,2013,042100056,,,,17,13,30
,2013,042100057,,,,80,66,146
,2013,042100058,,,,15,11,26
,2013,042100059,,,,17,15,32
,2013,042100060,,,,22,17,39
,2013,042100062,,,,38,30,68
,2013,042100062,,,,166,170,336
,2013,042100063,,,,24,34,58
,2013,042100066,,,,6,4,10
,2013,042100068,,,,25,11,36
,2013,042100069,,,,4,6,10
,2013,042100071,,,,8,12,20
,2013,042100072,,,,29,29,58
,2013,042100073,,,,27,19,46
,2013,042100075,,,,16,10,26
,2013,042100076,,,,10,12,22
,2013,042100077,,,,41,36,77
,2013,042100080,,,,13,23,36
,2013,042100081,,,,12,11,23
,2013,042100082,,,,12,10,22
,2013,042100084,,,,14,9,23
,2013,042100085,,,,15,15,30
,2013,042100086,,,,15,7,22
,2013,042100088,,,,11,10,21
,2013,042100089,,,,16,10,26
,2013,042100090,,,,4,4,8
,2013,042100092,,,,15,22,37
,2013,042100093,,,,18,16,34
,2013,042100096,,,,38,33,71
,2013,042100098,,,,16,12,28
,2013,042100100,,,,15,17,32
,2013,042100100,,,,5,5,10
,2013,042100105,,,,5,5,10
,2013,042100107,,,,9,2,11
,2013,042100108,,,,5,4,9
,2013,042100112,,,,5,5,10
,2013,042100114,,,,4,6,10
,2013,042100115,,,,2,8,10
,2013,042100116,,,,4,6,10
,2013,042100121,,,,19,23,42
,2013,042100142,,,,4,5,9
,2013,042100157,,,,13,7,20
,2013,042100161,,,,3,6,9
,2013,042100167,,,,14,17,31
,2013,042100168,,,,20,23,43
,2013,042100169,,,,22,17,39
,2013,042100170,,,,20,28,48
,2013,042100173,,,,5,6,11
,2013,042100175,,,,6,3,9
,2013,042100180,,,,4,6,10
,2013,042100181,,,,5,5,10
,2013,042100182,,,,7,3,10
,2013,042100184,,,,5,5,10
,2013,042100185,,,,4,6,10
,2013,042100186,,,,4,6,10
,2013,042100192,,,,8,2,10
,2013,042100196,,,,15,19,34
,2013,042100201,,,,5,5,10
,2013,042100202,,,,4,6,10
,2013,042100205,,,,7,3,10
,2013,042100207,,,,5,5,10
,2013,042100208,,,,6,13,19
,2013,042100209,,,,10,11,21
,2013,042100209,,,,42,32,74
,2013,042100210,,,,48,54,102
,2013,042100212,,,,12,9,21
,2013,042100213,,,,6,4,10
,2013,042100214,,,,5,5,10
,2013,042100215,,,,5,5,10
,2013,042100216,,,,5,5,10
,2013,042100217,,,,5,4,9
,2013,042100218,,,,5,4,9
,2013,042100219,,,,6,4,10
,2013,042100220,,,,5,5,10
,2013,042100221,,,,1,9,10
,2013,042100222,,,,6,7,13
,2013,042100223,,,,3,7,10
,2013,042100224,,,,3,7,10
,2013,042100225,,,,7,3,10
,2013,042100227,,,,3,7,10
,2013,042100228,,,,6,4,10
,2013,042100229,,,,7,3,10
,2013,042100230,,,,7,3,10
,2013,042100231,,,,3,6,9
,2013,042100232,,,,7,3,10
,2013,042100233,,,,4,4,8
,2013,042100234,,,,5,5,10
,2013,042100235,,,,3,7,10
,2013,042100236,,,,3,7,10
,2013,042100237,,,,4,6,10
,2013,042100238,,,,4,6,10
,2013,042100240,,,,5,5,10
,2013,042100241,,,,4,7,11
,2013,042100242,,,,3,7,10
,2013,042100243,,,,6,4,10
,2013,042100245,,,,6,4,10
,2013,042100246,,,,5,5,10
,2013,042100247,,,,4,6,10
,2013,042100248,,,,5,5,10
,2013,042100249,,,,5,5,10
,2013,042100250,,,,9,1,10
,2013,042100251,,,,5,5,10
,2013,042100252,,,,5,5,10
,2013,042100253,,,,5,5,10
,2013,042100254,,,,7,3,10
,2013,042100255,,,,5,5,10
,2013,042100257,,,,6,4,10
,2013,042100258,,,,3,7,10
,2013,042100259,,,,5,5,10
,2013,042100260,,,,3,7,10
,2013,042100261,,,,6,6,12
,2013,042100262,,,,6,6,12
,2013,042100263,,,,8,2,10
,2013,042100264,,,,9,2,11
,2013,042100265,,,,6,4,10
,2013,042100266,,,,4,6,10
,2013,042200001,,,,49,43,92
,2013,042200002,,,,197,173,370
,2013,042200003,,,,51,58,109
,2013,042200004,,,,45,49,94
,2013,042200004,,,,13,9,22
,2013,042200005,,,,46,28,74
,2013,042200006,,,,132,147,279
,2013,042200007,,,,8,9,17
,2013,042200008,,,,13,10,23
,2013,042200009,,,,15,14,29
,2013,042200010,,,,42,45,87
,2013,042200011,,,,19,27,46
,2013,042200012,,,,103,129,232
,2013,042200013,,,,18,11,29
,2013,042200014,,,,13,9,22
,2013,042200015,,,,13,15,28
,2013,042200016,,,,14,10,24
,2013,042200017,,,,10,11,21
,2013,042200018,,,,5,4,9
,2013,042200036,,,,4,2,6
,2013,042200038,,,,4,5,9
,2013,042200044,,,,2,4,6
,2013,042300001,,,,119,103,222
,2013,042300002,,,,26,19,45
,2013,042300003,,,,33,36,69
,2013,042300004,,,,56,53,109
,2013,042300005,,,,39,38,77
,2013,042300006,,,,30,21,51
,2013,042300007,,,,16,19,35
,2013,042300008,,,,16,9,25
,2013,042300016,,,,2,4,6
,2013,042300017,,,,7,5,12
,2013,042300018,,,,4,6,10
,2013,042300020,,,,3,3,6
,2013,042300021,,,,5,7,12
,2013,042300022,,,,8,5,13
,2013,042300024,,,,3,5,8
,2013,042300026,,,,6,6,12
,2013,042300027,,,,8,5,13
,2013,050100001,,,,521,516,1037
,2013,050100002,,,,3,10,13
,2013,050100002,,,,36,34,70
,2013,050100003,,,,18,12,30
,2013,050100004,,,,13,14,27
,2013,050100005,,,,165,152,317
,2013,050100006,,,,123,121,244
,2013,050100007,,,,336,294,630
,2013,050100007,,,,81,74,155
,2013,050100008,,,,15,14,29
,2013,050100009,,,,64,57,121
,2013,050100009,,,,7,12,19
,2013,050100010,,,,13,11,24
,2013,050100010,,,,70,55,125
,2013,050100011,,,,55,43,98
,2013,050100011,,,,141,249,390
,2013,050100011,,,,7,3,10
,2013,050100012,,,,26,38,64
,2013,050100012,,,,76,84,160
,2013,050100012,,,,35,32,67
,2013,050100013,,,,17,25,42
,2013,050100013,,,,288,268,556
,2013,050100014,,,,12,13,25
,2013,050100014,,,,5,15,20
,2013,050100015,,,,3,2,5
,2013,050100015,,,,18,16,34
,2013,050100015,,,,6,7,13
,2013,050100016,,,,30,37,67
,2013,050100017,,,,22,20,42
,2013,050100017,,,,205,168,373
,2013,050100018,,,,854,869,1723
,2013,050100020,,,,22,25,47
,2013,050100021,,,,369,399,768
,2013,050100022,,,,406,372,778
,2013,050100024,,,,15,9,24
,2013,050100025,,,,350,389,739
,2013,050100027,,,,11,13,24
,2013,050100028,,,,151,132,283
,2013,050100029,,,,8,14,22
,2013,050100031,,,,614,665,1279
,2013,050100032,,,,14,20,34
,2013,050100032,,,,151,100,251
,2013,050100032,,,,12,21,33
,2013,050100033,,,,48,37,85
,2013,050100034,,,,640,575,1215
,2013,050100035,,,,58,60,118
,2013,050100036,,,,276,311,587
,2013,050100037,,,,215,199,414
,2013,050100038,,,,0,140,140
,2013,050100038,,,,0,33,33
,2013,050100038,,,,0,332,332
,2013,050100038,,,,0,687,687
,2013,050100038,,,,0,69,69
,2013,050100039,,,,0,29,29
,2013,050100039,,,,0,211,211
,2013,050100040,,,,12,10,22
,2013,050100040,,,,3,1,4
,2013,050100041,,,,789,771,1560
,2013,050100042,,,,886,824,1710
,2013,050100043,,,,331,303,634
,2013,050100044,,,,257,261,518
,2013,050100044,,,,21,22,43
,2013,050100045,,,,184,190,374
,2013,050100046,,,,8,5,13
,2013,050100046,,,,33,37,70
,2013,050100046,,,,573,517,1090
,2013,050100047,,,,48,38,86
,2013,050100048,,,,183,201,384
,2013,050100049,,,,201,151,352
,2013,050100050,,,,16,28,44
,2013,050100050,,,,5,4,9
,2013,050100051,,,,253,282,535
,2013,050100052,,,,98,94,192
,2013,050100053,,,,67,34,101
,2013,050100055,,,,195,197,392
,2013,050100055,,,,29,27,56
,2013,050100056,,,,36,36,72
,2013,050100057,,,,109,114,223
,2013,050100058,,,,173,182,355
,2013,050100058,,,,23,22,45
,2013,050100059,,,,84,61,145
,2013,050100059,,,,17,8,25
,2013,050100060,,,,85,72,157
,2013,050100060,,,,8,5,13
,2013,050100061,,,,191,175,366
,2013,050100062,,,,825,812,1637
,2013,050100062,,,,48,45,93
,2013,050100063,,,,24,8,32
,2013,050100063,,,,175,82,257
,2013,050100064,,,,227,242,469
,2013,050100066,,,,385,355,740
,2013,050100066,,,,57,52,109
,2013,050100067,,,,396,413,809
,2013,050100068,,,,29,32,61
,2013,050100068,,,,257,343,600
,2013,050100069,,,,619,646,1265
,2013,050100070,,,,160,136,296
,2013,050100070,,,,20,19,39
,2013,050100071,,,,17,22,39
,2013,050100071,,,,250,232,482
,2013,050100072,,,,46,39,85
,2013,050100073,,,,25,16,41
,2013,050100074,,,,17,20,37
,2013,050100075,,,,33,41,74
,2013,050100076,,,,19,18,37
,2013,050100076,,,,8,8,16
,2013,050100077,,,,530,535,1065
,2013,050100078,,,,253,219,472
,2013,050100079,,,,245,207,452
,2013,050100079,,,,4,3,7
,2013,050100080,,,,487,398,885
,2013,050100082,,,,24,23,47
,2013,050100083,,,,460,465,925
,2013,050100084,,,,200,194,394
,2013,050100085,,,,13,13,26
,2013,050100087,,,,474,426,900
,2013,050100087,,,,47,39,86
,2013,050100088,,,,20,31,51
,2013,050100089,,,,206,174,380
,2013,050100090,,,,313,303,616
,2013,050100090,,,,22,19,41
,2013,050100091,,,,8,7,15
,2013,050100092,,,,25,33,58
,2013,050100092,,,,406,378,784
,2013,050100093,,,,2,10,12
,2013,050100093,,,,18,8,26
,2013,050100094,,,,29,17,46
,2013,050100094,,,,7,1,8
,2013,050100095,,,,7,6,13
,2013,050100095,,,,257,279,536
,2013,050100096,,,,321,311,632
,2013,050100097,,,,23,35,58
,2013,050100098,,,,23,28,51
,2013,050100099,,,,60,51,111
,2013,050100099,,,,11,6,17
,2013,050100100,,,,24,20,44
,2013,050100100,,,,39,33,72
,2013,050100101,,,,381,377,758
,2013,050100102,,,,35,31,66
,2013,050100104,,,,359,415,774
,2013,050100105,,,,124,134,258
,2013,050100106,,,,237,235,472
,2013,050100107,,,,371,368,739
,2013,050100107,,,,28,12,40
,2013,050100108,,,,192,163,355
,2013,050100109,,,,382,359,741
,2013,050100112,,,,150,131,281
,2013,050100112,,,,298,269,567
,2013,050100112,,,,19,17,36
,2013,050100112,,,,2,5,7
,2013,050100113,,,,404,421,825
,2013,050100114,,,,16,20,36
,2013,050100114,,,,303,258,561
,2013,050100115,,,,677,696,1373
,2013,050100116,,,,266,293,559
,2013,050100117,,,,40,51,91
,2013,050100117,,,,40,51,91
,2013,050100117,,,,87,129,216
,2013,050100117,,,,159,146,305
,2013,050100118,,,,181,172,353
,2013,050100119,,,,55,46,101
,2013,050100120,,,,200,167,367
,2013,050100123,,,,468,414,882
,2013,050100124,,,,67,59,126
,2013,050100124,,,,13,12,25
,2013,050100126,,,,75,72,147
,2013,050100127,,,,545,566,1111
,2013,050100129,,,,435,457,892
,2013,050100130,,,,161,22,183
,2013,050100130,,,,10,4,14
,2013,050100130,,,,52,12,64
,2013,050100131,,,,1,3,4
,2013,050100131,,,,28,20,48
,2013,050100131,,,,36,43,79
,2013,050100133,,,,9,14,23
,2013,050100133,,,,12,9,21
,2013,050100133,,,,193,139,332
,2013,050100134,,,,27,23,50
,2013,050100134,,,,5,5,10
,2013,050100134,,,,35,25,60
,2013,050100135,,,,17,8,25
,2013,050100135,,,,30,25,55
,2013,050100135,,,,21,19,40
,2013,050100136,,,,85,72,157
,2013,050100136,,,,16,15,31
,2013,050100137,,,,237,251,488
,2013,050100138,,,,127,99,226
,2013,050100139,,,,85,87,172
,2013,050100139,,,,12,5,17
,2013,050100140,,,,275,268,543
,2013,050100142,,,,17,16,33
,2013,050100142,,,,4,3,7
,2013,050100143,,,,33,28,61
,2013,050100144,,,,133,119,252
,2013,050100145,,,,1,6,7
,2013,050100145,,,,9,4,13
,2013,050100145,,,,2,3,5
,2013,050100146,,,,264,203,467
,2013,050100147,,,,14,10,24
,2013,050100147,,,,31,32,63
,2013,050100147,,,,14,9,23
,2013,050100148,,,,23,29,52
,2013,050100148,,,,266,255,521
,2013,050100149,,,,26,30,56
,2013,050100149,,,,72,73,145
,2013,050100149,,,,37,46,83
,2013,050100149,,,,26,30,56
,2013,050100150,,,,287,277,564
,2013,050100150,,,,83,106,189
,2013,050100151,,,,197,164,361
,2013,050100152,,,,12,8,20
,2013,050100154,,,,119,107,226
,2013,050100154,,,,11,13,24
,2013,050100156,,,,1,4,5
,2013,050100156,,,,28,20,48
,2013,050100157,,,,13,14,27
,2013,050100157,,,,27,31,58
,2013,050100157,,,,63,53,116
,2013,050100159,,,,123,113,236
,2013,050100159,,,,16,16,32
,2013,050100159,,,,18,16,34
,2013,050100160,,,,108,107,215
,2013,050100161,,,,620,626,1246
,2013,050100162,,,,16,4,20
,2013,050100165,,,,50,53,103
,2013,050100166,,,,309,304,613
,2013,050100167,,,,120,120,240
,2013,050100167,,,,21,14,35
,2013,050100168,,,,264,256,520
,2013,050100169,,,,20,15,35
,2013,050100170,,,,4,4,8
,2013,050100170,,,,13,25,38
,2013,050100170,,,,23,34,57
,2013,050100171,,,,5,7,12
,2013,050100171,,,,31,17,48
,2013,050100171,,,,15,11,26
,2013,050100171,,,,2,3,5
,2013,050100173,,,,28,24,52
,2013,050100173,,,,76,123,199
,2013,050100173,,,,69,103,172
,2013,050100174,,,,78,92,170
,2013,050100174,,,,6,15,21
,2013,050100175,,,,8,7,15
,2013,050100175,,,,92,97,189
,2013,050100175,,,,174,216,390
,2013,050100176,,,,13,16,29
,2013,050100177,,,,17,10,27
,2013,050100178,,,,22,14,36
,2013,050100179,,,,14,16,30
,2013,050100179,,,,37,27,64
,2013,050100180,,,,171,176,347
,2013,050100180,,,,23,21,44
,2013,050100182,,,,12,29,41
,2013,050100184,,,,52,50,102
,2013,050100187,,,,12,13,25
,2013,050100187,,,,92,77,169
,2013,050100187,,,,35,44,79
,2013,050100188,,,,24,16,40
,2013,050100193,,,,50,39,89
,2013,050100195,,,,109,91,200
,2013,050100197,,,,22,13,35
,2013,050100197,,,,204,218,422
,2013,050100198,,,,75,66,141
,2013,050100198,,,,38,27,65
,2013,050100199,,,,9,9,18
,2013,050100200,,,,34,30,64
,2013,050100201,,,,31,38,69
,2013,050100201,,,,299,246,545
,2013,050100203,,,,12,12,24
,2013,050100206,,,,14,20,34
,2013,050100207,,,,17,18,35
,2013,050100211,,,,17,16,33
,2013,050100212,,,,292,291,583
,2013,050100213,,,,43,39,82
,2013,050100213,,,,15,16,31
,2013,050100213,,,,27,23,50
,2013,050100214,,,,224,211,435
,2013,050100214,,,,29,41,70
,2013,050100215,,,,153,79,232
,2013,050100216,,,,4,1,5
,2013,050100216,,,,9,6,15
,2013,050100217,,,,16,17,33
,2013,050100218,,,,65,65,130
,2013,050100218,,,,198,229,427
,2013,050100220,,,,90,108,198
,2013,050100220,,,,18,8,26
,2013,050100220,,,,77,79,156
,2013,050100221,,,,70,86,156
,2013,050100221,,,,95,116,211
,2013,050100221,,,,24,36,60
,2013,050100224,,,,4,14,18
,2013,050100225,,,,765,887,1652
,2013,050100226,,,,326,431,757
,2013,050100227,,,,3,3,6
,2013,050100227,,,,5,4,9
,2013,050100227,,,,27,37,64
,2013,050100228,,,,940,959,1899
,2013,050100230,,,,437,505,942
,2013,050100231,,,,30,38,68
,2013,050100231,,,,146,101,247
,2013,050100232,,,,153,192,345
,2013,050100233,,,,369,407,776
,2013,050100234,,,,60,35,95
,2013,050100235,,,,773,1100,1873
,2013,050100237,,,,90,116,206
,2013,050100237,,,,36,42,78
,2013,050100237,,,,68,84,152
,2013,050100239,,,,4,14,18
,2013,050100239,,,,3,1,4
,2013,050100239,,,,0,1,1
,2013,050100240,,,,46,46,92
,2013,050100241,,,,215,235,450
,2013,050100243,,,,40,42,82
,2013,050100243,,,,268,251,519
,2013,050100244,,,,195,405,600
,2013,050100246,,,,79,84,163
,2013,050100246,,,,12,15,27
,2013,050100247,,,,230,272,502
,2013,050100248,,,,166,212,378
,2013,050100250,,,,80,76,156
,2013,050100250,,,,29,22,51
,2013,050100253,,,,75,80,155
,2013,050100254,,,,37,34,71
,2013,050100256,,,,6,4,10
,2013,050100258,,,,2,7,9
,2013,050100258,,,,15,18,33
,2013,050100261,,,,18,12,30
,2013,050100262,,,,39,40,79
,2013,050100264,,,,18,35,53
,2013,050100266,,,,24,25,49
,2013,050100267,,,,3,3,6
,2013,050100268,,,,134,133,267
,2013,050100269,,,,31,26,57
,2013,050100270,,,,3,4,7
,2013,050100270,,,,5,14,19
,2013,050100270,,,,34,32,66
,2013,050100271,,,,8,23,31
,2013,050100272,,,,40,30,70
,2013,050100273,,,,17,16,33
,2013,050100273,,,,65,58,123
,2013,050100273,,,,6,3,9
,2013,050100273,,,,14,15,29
,2013,050100274,,,,12,15,27
,2013,050100275,,,,6,3,9
,2013,050100276,,,,49,39,88
,2013,050100277,,,,19,13,32
,2013,050100278,,,,14,21,35
,2013,050100279,,,,27,26,53
,2013,050100280,,,,31,30,61
,2013,050100283,,,,72,55,127
,2013,050100286,,,,56,53,109
,2013,050100287,,,,5,2,7
,2013,050100289,,,,10,19,29
,2013,050100289,,,,38,42,80
,2013,050100291,,,,86,92,178
,2013,050100291,,,,2,5,7
,2013,050100292,,,,5,5,10
,2013,050100293,,,,34,19,53
,2013,050100294,,,,49,55,104
,2013,050100294,,,,45,49,94
,2013,050100294,,,,18,8,26
,2013,050100295,,,,46,47,93
,2013,050100295,,,,8,7,15
,2013,050100296,,,,82,74,156
,2013,050100299,,,,19,18,37
,2013,050100300,,,,279,291,570
,2013,050100302,,,,17,26,43
,2013,050100304,,,,21,15,36
,2013,050100307,,,,29,33,62
,2013,050100308,,,,11,7,18
,2013,050100310,,,,10,11,21
,2013,050100312,,,,22,15,37
,2013,050100313,,,,40,35,75
,2013,050100314,,,,12,12,24
,2013,050100314,,,,65,63,128
,2013,050100317,,,,22,16,38
,2013,050100319,,,,22,22,44
,2013,050100321,,,,35,36,71
,2013,050100323,,,,238,248,486
,2013,050100324,,,,26,32,58
,2013,050100325,,,,10,12,22
,2013,050100325,,,,32,21,53
,2013,050100327,,,,17,16,33
,2013,050100327,,,,61,50,111
,2013,050100327,,,,21,24,45
,2013,050100327,,,,12,13,25
,2013,050100329,,,,57,47,104
,2013,050100331,,,,16,23,39
,2013,050100334,,,,49,34,83
,2013,050100335,,,,5,13,18
,2013,050100336,,,,210,210,420
,2013,050100337,,,,264,286,550
,2013,050100338,,,,28,18,46
,2013,050100338,,,,87,103,190
,2013,050100338,,,,25,41,66
,2013,050100339,,,,4,4,8
,2013,050100340,,,,13,2,15
,2013,050100341,,,,177,181,358
,2013,050100342,,,,26,25,51
,2013,050100343,,,,11,9,20
,2013,050100346,,,,73,69,142
,2013,050100346,,,,22,15,37
,2013,050100346,,,,49,59,108
,2013,050100346,,,,22,15,37
,2013,050100347,,,,15,12,27
,2013,050100349,,,,15,20,35
,2013,050100352,,,,39,38,77
,2013,050100352,,,,38,72,110
,2013,050100352,,,,27,61,88
,2013,050100353,,,,186,167,353
,2013,050100354,,,,40,29,69
,2013,050100354,,,,73,55,128
,2013,050100354,,,,86,89,175
,2013,050100356,,,,90,85,175
,2013,050100357,,,,224,183,407
,2013,050100357,,,,43,36,79
,2013,050100359,,,,42,55,97
,2013,050100359,,,,42,51,93
,2013,050100361,,,,80,71,151
,2013,050100363,,,,146,157,303
,2013,050100365,,,,351,331,682
,2013,050100366,,,,239,370,609
,2013,050100367,,,,195,211,406
,2013,050100368,,,,1268,134,1402
,2013,050100369,,,,22,30,52
,2013,050100370,,,,12,8,20
,2013,050100371,,,,68,75,143
,2013,050100371,,,,58,91,149
,2013,050100371,,,,8,7,15
,2013,050100374,,,,16,18,34
,2013,050100374,,,,97,114,211
,2013,050100381,,,,140,76,216
,2013,050100382,,,,310,363,673
,2013,050100382,,,,48,86,134
,2013,050100383,,,,42,133,175
,2013,050100384,,,,219,270,489
,2013,050100385,,,,197,246,443
,2013,050100387,,,,109,119,228
,2013,050100388,,,,2336,2610,4946
,2013,050100392,,,,27,25,52
,2013,050100394,,,,5,2,7
,2013,050100395,,,,13,10,23
,2013,050100400,,,,26,25,51
,2013,050100402,,,,61,44,105
,2013,050100404,,,,35,48,83
,2013,050100404,,,,114,106,220
,2013,050100404,,,,118,118,236
,2013,050100409,,,,58,58,116
,2013,050100411,,,,27,19,46
,2013,050100412,,,,16,23,39
,2013,050100413,,,,6,11,17
,2013,050100413,,,,30,27,57
,2013,050100413,,,,53,45,98
,2013,050100414,,,,75,90,165
,2013,050100415,,,,4,2,6
,2013,050100415,,,,28,20,48
,2013,050100416,,,,22,51,73
,2013,050100416,,,,7,4,11
,2013,050100419,,,,15,22,37
,2013,050100419,,,,31,41,72
,2013,050100419,,,,63,47,110
,2013,050100420,,,,38,27,65
,2013,050100420,,,,42,59,101
,2013,050100421,,,,34,46,80
,2013,050100421,,,,19,16,35
,2013,050100422,,,,63,65,128
,2013,050100423,,,,11,9,20
,2013,050100423,,,,52,56,108
,2013,050100425,,,,50,53,103
,2013,050100426,,,,69,81,150
,2013,050100426,,,,43,30,73
,2013,050100426,,,,68,75,143
,2013,050100428,,,,90,115,205
,2013,050100428,,,,119,100,219
,2013,050100428,,,,42,47,89
,2013,050100429,,,,19,17,36
,2013,050100429,,,,71,75,146
,2013,050100429,,,,56,56,112
,2013,050100430,,,,52,67,119
,2013,050100430,,,,90,127,217
,2013,050100430,,,,53,61,114
,2013,050100431,,,,63,82,145
,2013,050100431,,,,31,42,73
,2013,050100433,,,,48,60,108
,2013,050100433,,,,33,19,52
,2013,050100433,,,,41,28,69
,2013,050100436,,,,15,10,25
,2013,050100436,,,,72,82,154
,2013,050100437,,,,24,26,50
,2013,050100438,,,,34,42,76
,2013,050100438,,,,66,77,143
,2013,050100438,,,,14,22,36
,2013,050100442,,,,511,122,633
,2013,050100443,,,,50,36,86
,2013,050100443,,,,87,98,185
,2013,050100443,,,,77,74,151
,2013,050100444,,,,63,73,136
,2013,050100444,,,,3,5,8
,2013,050100444,,,,35,25,60
,2013,050100445,,,,40,34,74
,2013,050100445,,,,42,38,80
,2013,050100445,,,,40,34,74
,2013,050100445,,,,115,107,222
,2013,050100446,,,,13,8,21
,2013,050100446,,,,105,84,189
,2013,050100446,,,,153,198,351
,2013,050100447,,,,19,27,46
,2013,050100448,,,,3,9,12
,2013,050100448,,,,7,8,15
,2013,050100448,,,,18,28,46
,2013,050100449,,,,321,335,656
,2013,050100450,,,,35,24,59
,2013,050100450,,,,13,12,25
,2013,050100451,,,,75,82,157
,2013,050100453,,,,16,18,34
,2013,050100454,,,,19,30,49
,2013,050100455,,,,58,81,139
,2013,050100455,,,,78,74,152
,2013,050100455,,,,34,29,63
,2013,050100457,,,,39,38,77
,2013,050100458,,,,11,10,21
,2013,050100458,,,,39,35,74
,2013,050100459,,,,86,103,189
,2013,050100459,,,,22,31,53
,2013,050100459,,,,23,33,56
,2013,050100459,,,,86,103,189
,2013,050100461,,,,5,7,12
,2013,050100461,,,,19,24,43
,2013,050100461,,,,6,5,11
,2013,050100461,,,,6,5,11
,2013,050100468,,,,12,9,21
,2013,050100468,,,,20,12,32
,2013,050100469,,,,8,2,10
,2013,050100469,,,,40,27,67
,2013,050100470,,,,26,43,69
,2013,050100470,,,,63,73,136
,2013,050100470,,,,30,35,65
,2013,050100472,,,,9,8,17
,2013,050100472,,,,13,15,28
,2013,050100475,,,,6,4,10
,2013,050100475,,,,48,33,81
,2013,050100475,,,,6,3,9
,2013,050100476,,,,116,146,262
,2013,050100476,,,,174,154,328
,2013,050100476,,,,239,255,494
,2013,050100477,,,,192,226,418
,2013,050100477,,,,227,200,427
,2013,050100477,,,,75,81,156
,2013,050100478,,,,28,39,67
,2013,050100478,,,,16,8,24
,2013,050100481,,,,18,15,33
,2013,050100481,,,,65,63,128
,2013,050100483,,,,26,24,50
,2013,050100483,,,,53,47,100
,2013,050100483,,,,35,24,59
,2013,050100485,,,,5,10,15
,2013,050100485,,,,13,23,36
,2013,050100486,,,,9,6,15
,2013,050100487,,,,61,37,98
,2013,050100488,,,,9,17,26
,2013,050100489,,,,14,12,26
,2013,050100490,,,,20,20,40
,2013,050100491,,,,31,39,70
,2013,050100492,,,,36,37,73
,2013,050100493,,,,82,105,187
,2013,050100493,,,,199,217,416
,2013,050100493,,,,161,235,396
,2013,050100494,,,,34,31,65
,2013,050100496,,,,132,110,242
,2013,050100497,,,,28,41,69
,2013,050100497,,,,54,57,111
,2013,050100497,,,,21,23,44
,2013,050100499,,,,65,72,137
,2013,050100499,,,,142,154,296
,2013,050100499,,,,128,151,279
,2013,050100500,,,,156,132,288
,2013,050100500,,,,180,124,304
,2013,050100500,,,,66,57,123
,2013,050100501,,,,36,36,72
,2013,050100502,,,,43,45,88
,2013,050100503,,,,20,17,37
,2013,050100508,,,,10,9,19
,2013,050100508,,,,25,23,48
,2013,050100508,,,,12,8,20
,2013,050100512,,,,6,6,12
,2013,050100512,,,,4,7,11
,2013,050100512,,,,22,17,39
,2013,050100512,,,,4,7,11
,2013,050100515,,,,60,45,105
,2013,050100515,,,,9,4,13
,2013,050100516,,,,3,6,9
,2013,050100516,,,,28,18,46
,2013,050100516,,,,42,49,91
,2013,050100517,,,,56,59,115
,2013,050100517,,,,120,120,240
,2013,050100517,,,,73,75,148
,2013,050100519,,,,24,20,44
,2013,050100520,,,,34,34,68
,2013,050100521,,,,31,34,65
,2013,050100521,,,,2,2,4
,2013,050100521,,,,17,11,28
,2013,050100522,,,,24,19,43
,2013,050100523,,,,25,17,42
,2013,050100523,,,,217,199,416
,2013,050100525,,,,75,67,142
,2013,050100525,,,,215,213,428
,2013,050100526,,,,7,19,26
,2013,050100526,,,,46,39,85
,2013,050100526,,,,10,4,14
,2013,050100527,,,,16,14,30
,2013,050100527,,,,4,7,11
,2013,050100527,,,,31,21,52
,2013,050100528,,,,69,71,140
,2013,050100528,,,,30,24,54
,2013,050100528,,,,85,87,172
,2013,050100531,,,,89,130,219
,2013,050100531,,,,6,23,29
,2013,050100531,,,,14,31,45
,2013,050100532,,,,15,12,27
,2013,050100532,,,,308,241,549
,2013,050100533,,,,176,158,334
,2013,050100534,,,,390,329,719
,2013,050100535,,,,11,5,16
,2013,050100535,,,,33,32,65
,2013,050100535,,,,3,7,10
,2013,050100536,,,,190,240,430
,2013,050100537,,,,80,70,150
,2013,050100538,,,,147,131,278
,2013,050100539,,,,51,51,102
,2013,050100539,,,,6,6,12
,2013,050100540,,,,200,179,379
,2013,050100541,,,,9,9,18
,2013,050100543,,,,32,25,57
,2013,050100543,,,,74,65,139
,2013,050100543,,,,48,40,88
,2013,050100544,,,,5,5,10
,2013,050100544,,,,45,31,76
,2013,050100547,,,,26,23,49
,2013,050100548,,,,146,107,253
,2013,050100549,,,,22,33,55
,2013,050100549,,,,56,57,113
,2013,050100549,,,,21,19,40
,2013,050100551,,,,4,3,7
,2013,050100554,,,,163,227,390
,2013,050100554,,,,95,82,177
,2013,050100554,,,,18,15,33
,2013,050100557,,,,19,9,28
,2013,050100558,,,,96,88,184
,2013,050100559,,,,313,289,602
,2013,050100560,,,,120,111,231
,2013,050100561,,,,306,271,577
,2013,050100563,,,,240,241,481
,2013,050100563,,,,30,35,65
,2013,050100564,,,,282,314,596
,2013,050100564,,,,366,347,713
,2013,050100565,,,,37,32,69
,2013,050100566,,,,635,629,1264
,2013,050100567,,,,834,816,1650
,2013,050100568,,,,10,10,20
,2013,050100569,,,,46,49,95
,2013,050100569,,,,202,233,435
,2013,050100570,,,,32,29,61
,2013,050100572,,,,12,13,25
,2013,050100573,,,,12,28,40
,2013,050100576,,,,44,49,93
,2013,050100578,,,,260,314,574
,2013,050100579,,,,21,26,47
,2013,050100579,,,,72,87,159
,2013,050100580,,,,130,145,275
,2013,050100580,,,,49,44,93
,2013,050100580,,,,7,6,13
,2013,050100582,,,,97,74,171
,2013,050100582,,,,40,42,82
,2013,050100585,,,,225,173,398
,2013,050100585,,,,38,39,77
,2013,050100585,,,,369,304,673
,2013,050100586,,,,74,79,153
,2013,050100586,,,,48,52,100
,2013,050100586,,,,85,92,177
,2013,050100588,,,,100,144,244
,2013,050100588,,,,31,26,57
,2013,050100588,,,,18,21,39
,2013,050100589,,,,7,9,16
,2013,050100589,,,,45,40,85
,2013,050100589,,,,102,162,264
,2013,050100593,,,,136,166,302
,2013,050100595,,,,14,19,33
,2013,050100596,,,,115,120,235
,2013,050100597,,,,393,351,744
,2013,050100598,,,,53,59,112
,2013,050100598,,,,41,37,78
,2013,050100598,,,,3,0,3
,2013,050100599,,,,68,65,133
,2013,050100600,,,,12,20,32
,2013,050100600,,,,41,37,78
,2013,050100600,,,,67,46,113
,2013,050100606,,,,195,314,509
,2013,050100607,,,,161,235,396
,2013,050100608,,,,252,362,614
,2013,050100608,,,,73,103,176
,2013,050100608,,,,12,10,22
,2013,050100608,,,,5,4,9
,2013,050100609,,,,131,143,274
,2013,050100609,,,,12,34,46
,2013,050100610,,,,33,45,78
,2013,050100610,,,,160,210,370
,2013,050100612,,,,220,194,414
,2013,050100618,,,,55,63,118
,2013,050100620,,,,30,14,44
,2013,050100621,,,,16,18,34
,2013,050100621,,,,46,63,109
,2013,050100621,,,,13,11,24
,2013,050100626,,,,105,101,206
,2013,050100629,,,,9,7,16
,2013,050100631,,,,155,276,431
,2013,050100631,,,,1539,2224,3763
,2013,050100633,,,,16,23,39
,2013,050100633,,,,46,57,103
,2013,050100634,,,,191,207,398
,2013,050100635,,,,258,296,554
,2013,050100636,,,,1,0,1
,2013,050100636,,,,1,0,1
,2013,050100636,,,,3,3,6
,2013,050100638,,,,133,179,312
,2013,050100643,,,,55,63,118
,2013,050100643,,,,27,32,59
,2013,050100643,,,,223,276,499
,2013,050100645,,,,48,42,90
,2013,050100645,,,,17,27,44
,2013,050100651,,,,5,7,12
,2013,050100651,,,,27,25,52
,2013,050100651,,,,5,7,12
,2013,050100653,,,,4,6,10
,2013,050100653,,,,4,5,9
,2013,050100655,,,,8,7,15
,2013,050100655,,,,78,72,150
,2013,050100655,,,,65,63,128
,2013,050100666,,,,10,14,24
,2013,050100666,,,,31,40,71
,2013,050100668,,,,82,114,196
,2013,050100668,,,,8,14,22
,2013,050100671,,,,65,66,131
,2013,050100674,,,,14,11,25
,2013,050100678,,,,66,56,122
,2013,050100680,,,,20,15,35
,2013,050100680,,,,46,64,110
,2013,050100680,,,,20,15,35
,2013,050100684,,,,59,60,119
,2013,050100684,,,,2,1,3
,2013,050100684,,,,23,16,39
,2013,050100685,,,,99,97,196
,2013,050100685,,,,15,15,30
,2013,050100686,,,,20,27,47
,2013,050100688,,,,22,26,48
,2013,050100688,,,,13,15,28
,2013,050100688,,,,9,7,16
,2013,050100689,,,,76,56,132
,2013,050100689,,,,207,181,388
,2013,050100689,,,,62,75,137
,2013,050100690,,,,15,10,25
,2013,050100691,,,,15,22,37
,2013,050100691,,,,72,62,134
,2013,050100691,,,,20,18,38
,2013,050100692,,,,95,72,167
,2013,050100696,,,,40,23,63
,2013,050100697,,,,111,127,238
,2013,050100697,,,,100,121,221
,2013,050100697,,,,30,24,54
,2013,050100697,,,,0,2,2
,2013,050100698,,,,28,36,64
,2013,050100699,,,,21,17,38
,2013,050100702,,,,26,40,66
,2013,050100703,,,,3,5,8
,2013,050100703,,,,32,20,52
,2013,050100703,,,,19,30,49
,2013,050100705,,,,71,79,150
,2013,050100705,,,,17,28,45
,2013,050100705,,,,32,34,66
,2013,050100706,,,,161,175,336
,2013,050100706,,,,6,4,10
,2013,050100709,,,,87,117,204
,2013,050100709,,,,34,42,76
,2013,050100709,,,,29,34,63
,2013,050100710,,,,14,15,29
,2013,050100710,,,,34,43,77
,2013,050100710,,,,8,7,15
,2013,050100711,,,,10,10,20
,2013,050100711,,,,17,14,31
,2013,050100712,,,,32,26,58
,2013,050100712,,,,78,71,149
,2013,050100712,,,,41,57,98
,2013,050100713,,,,40,47,87
,2013,050100713,,,,27,30,57
,2013,050100713,,,,10,14,24
,2013,050100714,,,,10,16,26
,2013,050100714,,,,39,33,72
,2013,050100714,,,,21,21,42
,2013,050100714,,,,4,1,5
,2013,050100715,,,,22,15,37
,2013,050100716,,,,46,34,80
,2013,050100717,,,,308,332,640
,2013,050100717,,,,21,21,42
,2013,050100726,,,,4,6,10
,2013,050100734,,,,21,21,42
,2013,050100736,,,,25,10,35
,2013,050100736,,,,2,12,14
,2013,050100742,,,,5,5,10
,2013,050100743,,,,36,40,76
,2013,050100746,,,,6,5,11
,2013,050100747,,,,6,23,29
,2013,050100756,,,,14,16,30
,2013,050100759,,,,8,10,18
,2013,050100761,,,,7,2,9
,2013,050100764,,,,7,4,11
,2013,050100764,,,,3,6,9
,2013,050100765,,,,10,10,20
,2013,050100766,,,,2,4,6
,2013,050100768,,,,7,11,18
,2013,050100770,,,,6,3,9
,2013,050100771,,,,4,7,11
,2013,050100771,,,,70,73,143
,2013,050100772,,,,2,5,7
,2013,050100772,,,,25,28,53
,2013,050100772,,,,12,20,32
,2013,050100778,,,,7,6,13
,2013,050100779,,,,49,31,80
,2013,050100780,,,,19,11,30
,2013,050100785,,,,13,5,18
,2013,050100788,,,,173,147,320
,2013,050100789,,,,4,8,12
,2013,050100792,,,,8,7,15
,2013,050100792,,,,84,79,163
,2013,050100792,,,,12,13,25
,2013,050100795,,,,24,15,39
,2013,050100796,,,,7,7,14
,2013,050100797,,,,6,5,11
,2013,050100798,,,,6,11,17
,2013,050100798,,,,58,52,110
,2013,050100803,,,,128,176,304
,2013,050100803,,,,45,68,113
,2013,050100808,,,,37,29,66
,2013,050100808,,,,29,26,55
,2013,050100808,,,,114,96,210
,2013,050100810,,,,43,35,78
,2013,050100817,,,,46,41,87
,2013,050100818,,,,60,41,101
,2013,050100818,,,,11,22,33
,2013,050100818,,,,53,45,98
,2013,050100819,,,,183,242,425
,2013,050100819,,,,99,90,189
,2013,050100819,,,,84,122,206
,2013,050100820,,,,93,70,163
,2013,050100820,,,,20,27,47
,2013,050100820,,,,12,7,19
,2013,050100822,,,,9,3,12
,2013,050100822,,,,24,23,47
,2013,050100823,,,,10,14,24
,2013,050100824,,,,11,8,19
,2013,050100824,,,,19,13,32
,2013,050100827,,,,24,10,34
,2013,050100827,,,,24,21,45
,2013,050100829,,,,70,83,153
,2013,050100829,,,,5,2,7
,2013,050100829,,,,21,15,36
,2013,050100830,,,,0,1,1
,2013,050100830,,,,3,2,5
,2013,050100831,,,,10,14,24
,2013,050100831,,,,42,37,79
,2013,050100832,,,,12,9,21
,2013,050100832,,,,39,20,59
,2013,050100834,,,,24,38,62
,2013,050100834,,,,4,8,12
,2013,050100834,,,,13,15,28
,2013,050100840,,,,58,72,130
,2013,050100840,,,,40,25,65
,2013,050100840,,,,110,109,219
,2013,050100844,,,,22,28,50
,2013,050100845,,,,6,2,8
,2013,050100845,,,,34,35,69
,2013,050100848,,,,5,6,11
,2013,050100848,,,,29,38,67
,2013,050100849,,,,44,47,91
,2013,050100850,,,,5,7,12
,2013,050100850,,,,24,32,56
,2013,050100851,,,,5,8,13
,2013,050100851,,,,40,35,75
,2013,050100852,,,,9,8,17
,2013,050100852,,,,23,29,52
,2013,050100853,,,,7,6,13
,2013,050100854,,,,9,5,14
,2013,050100856,,,,22,14,36
,2013,050100857,,,,12,1,13
,2013,050100858,,,,1,5,6
,2013,050100859,,,,38,34,72
,2013,050100859,,,,8,5,13
,2013,050100859,,,,159,169,328
,2013,050100860,,,,8,5,13
,2013,050100863,,,,15,23,38
,2013,050100863,,,,65,75,140
,2013,050100863,,,,2,3,5
,2013,050100880,,,,5,5,10
,2013,050100880,,,,42,26,68
,2013,050100882,,,,58,72,130
,2013,050100883,,,,24,23,47
,2013,050100884,,,,231,235,466
,2013,050100884,,,,122,167,289
,2013,050100888,,,,9,6,15
,2013,050100888,,,,7,3,10
,2013,050100891,,,,0,1,1
,2013,050100891,,,,3,1,4
,2013,050100893,,,,122,155,277
,2013,050100894,,,,92,103,195
,2013,050100896,,,,134,145,279
,2013,050100896,,,,175,289,464
,2013,050100897,,,,8,8,16
,2013,050100897,,,,42,29,71
,2013,050100899,,,,106,101,207
,2013,050100901,,,,10,10,20
,2013,050100903,,,,2,2,4
,2013,050100903,,,,3,3,6
,2013,050100907,,,,229,205,434
,2013,050100911,,,,17,20,37
,2013,050100911,,,,13,19,32
,2013,050100911,,,,44,39,83
,2013,050100916,,,,9,8,17
,2013,050100916,,,,56,44,100
,2013,050100916,,,,25,36,61
,2013,050100917,,,,40,90,130
,2013,050100919,,,,7,12,19
,2013,050100919,,,,3,1,4
,2013,050100919,,,,8,9,17
,2013,050100920,,,,47,57,104
,2013,050100921,,,,1,1,2
,2013,050100921,,,,3,8,11
,2013,050100921,,,,13,17,30
,2013,050100923,,,,118,112,230
,2013,050100923,,,,12,12,24
,2013,050100923,,,,2,3,5
,2013,050100926,,,,12,11,23
,2013,050100928,,,,6,3,9
,2013,050100929,,,,7,3,10
,2013,050100931,,,,76,59,135
,2013,050100932,,,,0,3,3
,2013,050100932,,,,15,18,33
,2013,050100932,,,,8,5,13
,2013,050100934,,,,23,17,40
,2013,050100934,,,,10,12,22
,2013,050100935,,,,31,44,75
,2013,050100936,,,,8,8,16
,2013,050100936,,,,17,8,25
,2013,050100937,,,,25,41,66
,2013,050100938,,,,29,52,81
,2013,050100940,,,,10,17,27
,2013,050100940,,,,5,6,11
,2013,050100940,,,,27,23,50
,2013,050100941,,,,22,13,35
,2013,050100941,,,,24,29,53
,2013,050100941,,,,4,3,7
,2013,050100944,,,,1,3,4
,2013,050100944,,,,4,2,6
,2013,050100945,,,,13,7,20
,2013,050100947,,,,93,109,202
,2013,050100949,,,,16,25,41
,2013,050100949,,,,4,7,11
,2013,050100950,,,,25,27,52
,2013,050100951,,,,4,6,10
,2013,050100951,,,,9,11,20
,2013,050100954,,,,8,10,18
,2013,050100956,,,,16,12,28
,2013,050100958,,,,16,26,42
,2013,050100958,,,,23,13,36
,2013,050100958,,,,79,82,161
,2013,050100963,,,,19,21,40
,2013,050100965,,,,34,29,63
,2013,050100969,,,,15,18,33
,2013,050100972,,,,1433,1748,3181
,2013,050100973,,,,120,124,244
,2013,050100980,,,,4,6,10
,2013,050100983,,,,6,3,9
,2013,050100983,,,,7,19,26
,2013,050100986,,,,12,19,31
,2013,050100995,,,,11,10,21
,2013,050100998,,,,32,22,54
,2013,050100999,,,,7,9,16
,2013,050101010,,,,3,1,4
,2013,050101011,,,,2,8,10
,2013,050101014,,,,5,5,10
,2013,050101016,,,,7,6,13
,2013,050101018,,,,10,9,19
,2013,050101020,,,,19,20,39
,2013,050101021,,,,9,10,19
,2013,050101022,,,,8,7,15
,2013,050101024,,,,10,15,25
,2013,050101026,,,,11,14,25
,2013,050101028,,,,5,7,12
,2013,050101036,,,,48,47,95
,2013,050101037,,,,4,5,9
,2013,050101037,,,,25,23,48
,2013,050101039,,,,3,4,7
,2013,050101039,,,,35,29,64
,2013,050101039,,,,24,35,59
,2013,050101040,,,,12,8,20
,2013,050101042,,,,27,29,56
,2013,050101042,,,,49,50,99
,2013,050101042,,,,6,22,28
,2013,050101044,,,,1,6,7
,2013,050101044,,,,70,75,145
,2013,050101044,,,,9,3,12
,2013,050101046,,,,14,10,24
,2013,050101046,,,,40,29,69
,2013,050101046,,,,13,5,18
,2013,050101047,,,,73,84,157
,2013,050101047,,,,33,29,62
,2013,050101047,,,,51,58,109
,2013,050101048,,,,147,175,322
,2013,050101049,,,,9,5,14
,2013,050101050,,,,18,25,43
,2013,050101050,,,,22,36,58
,2013,050101051,,,,83,72,155
,2013,050101053,,,,21,18,39
,2013,050101053,,,,10,8,18
,2013,050101055,,,,58,68,126
,2013,050101055,,,,9,7,16
,2013,050101057,,,,5,5,10
,2013,050101057,,,,11,9,20
,2013,050101057,,,,40,24,64
,2013,050101058,,,,13,13,26
,2013,050101058,,,,43,50,93
,2013,050101058,,,,31,31,62
,2013,050101061,,,,7,15,22
,2013,050101062,,,,15,14,29
,2013,050101062,,,,18,8,26
,2013,050101063,,,,2,1,3
,2013,050101063,,,,23,29,52
,2013,050101064,,,,12,18,30
,2013,050101064,,,,24,28,52
,2013,050101072,,,,28,25,53
,2013,050101072,,,,38,24,62
,2013,050101074,,,,16,11,27
,2013,050101074,,,,14,12,26
,2013,050101082,,,,19,27,46
,2013,050101083,,,,13,17,30
,2013,050101084,,,,9,12,21
,2013,050101099,,,,8,12,20
,2013,050101101,,,,11,14,25
,2013,050101102,,,,10,6,16
,2013,050101108,,,,8,4,12
,2013,050101108,,,,49,28,77
,2013,050101110,,,,12,10,22
,2013,050101112,,,,8,5,13
,2013,050101114,,,,11,8,19
,2013,050101116,,,,9,6,15
,2013,050101117,,,,3,11,14
,2013,050101118,,,,12,8,20
,2013,050101120,,,,1,10,11
,2013,050101121,,,,8,4,12
,2013,050101122,,,,15,20,35
,2013,050101122,,,,47,54,101
,2013,050101123,,,,6,4,10
,2013,050101125,,,,4,4,8
,2013,050101130,,,,9,16,25
,2013,050101133,,,,7,6,13
,2013,050101137,,,,11,7,18
,2013,050101139,,,,7,5,12
,2013,050101143,,,,16,9,25
,2013,050101146,,,,13,7,20
,2013,050101149,,,,4,14,18
,2013,050101151,,,,28,21,49
,2013,050101151,,,,134,121,255
,2013,050101164,,,,4,5,9
,2013,050101164,,,,20,46,66
,2013,050101164,,,,9,9,18
,2013,050101164,,,,1,1,2
,2013,050101165,,,,4,3,7
,2013,050101165,,,,5,4,9
,2013,050101165,,,,27,23,50
,2013,050101166,,,,7,4,11
,2013,050101166,,,,25,27,52
,2013,050101167,,,,51,39,90
,2013,050101167,,,,4,3,7
,2013,050101168,,,,0,2,2
,2013,050101168,,,,9,12,21
,2013,050101168,,,,7,14,21
,2013,050101170,,,,17,12,29
,2013,050101170,,,,1,3,4
,2013,050101170,,,,10,17,27
,2013,050101171,,,,7,9,16
,2013,050101171,,,,11,9,20
,2013,050101171,,,,15,28,43
,2013,050101172,,,,20,7,27
,2013,050101173,,,,71,65,136
,2013,050101174,,,,2,5,7
,2013,050101174,,,,12,17,29
,2013,050101175,,,,203,162,365
,2013,050101176,,,,3,8,11
,2013,050101176,,,,8,9,17
,2013,050101178,,,,11,21,32
,2013,050101178,,,,19,19,38
,2013,050101178,,,,5,2,7
,2013,050101179,,,,14,6,20
,2013,050101179,,,,16,17,33
,2013,050101180,,,,98,149,247
,2013,050101180,,,,37,56,93
,2013,050101181,,,,17,16,33
,2013,050101181,,,,8,5,13
,2013,050101182,,,,66,94,160
,2013,050101182,,,,31,33,64
,2013,050101183,,,,28,41,69
,2013,050101183,,,,11,21,32
,2013,050101184,,,,124,148,272
,2013,050101185,,,,112,113,225
,2013,050101187,,,,93,116,209
,2013,050101188,,,,51,53,104
,2013,050101191,,,,47,36,83
,2013,050101192,,,,40,21,61
,2013,050101193,,,,9,10,19
,2013,050101194,,,,14,12,26
,2013,050101194,,,,7,7,14
,2013,050101196,,,,16,3,19
,2013,050101197,,,,9,6,15
,2013,050101197,,,,5,10,15
,2013,050101198,,,,5,5,10
,2013,050101198,,,,54,54,108
,2013,050101198,,,,59,72,131
,2013,050101200,,,,7,9,16
,2013,050101200,,,,7,7,14
,2013,050101201,,,,6,4,10
,2013,050101205,,,,8,3,11
,2013,050101206,,,,5,4,9
,2013,050101210,,,,3,5,8
,2013,050101211,,,,9,7,16
,2013,050101213,,,,3,5,8
,2013,050101215,,,,7,7,14
,2013,050101217,,,,6,4,10
,2013,050101218,,,,12,5,17
,2013,050101219,,,,4,10,14
,2013,050101221,,,,6,5,11
,2013,050101222,,,,11,9,20
,2013,050101225,,,,6,5,11
,2013,050101226,,,,7,5,12
,2013,050101228,,,,9,2,11
,2013,050101233,,,,9,9,18
,2013,050101234,,,,7,6,13
,2013,050101235,,,,6,7,13
,2013,050101236,,,,4,5,9
,2013,050101238,,,,7,6,13
,2013,050101242,,,,6,1,7
,2013,050101244,,,,23,29,52
,2013,050101246,,,,9,6,15
,2013,050101247,,,,9,11,20
,2013,050101250,,,,11,6,17
,2013,050101251,,,,11,6,17
,2013,050101252,,,,5,4,9
,2013,050101254,,,,7,6,13
,2013,050101255,,,,210,848,1058
,2013,050101256,,,,4,6,10
,2013,050101256,,,,14,14,28
,2013,050101256,,,,5,4,9
,2013,050101257,,,,2,4,6
,2013,050101257,,,,2,4,6
,2013,050101258,,,,12,9,21
,2013,050101258,,,,15,9,24
,2013,050101259,,,,6,6,12
,2013,050101259,,,,11,2,13
,2013,050101259,,,,3,2,5
,2013,050101260,,,,12,17,29
,2013,050101260,,,,8,16,24
,2013,050101261,,,,23,27,50
,2013,050101261,,,,2,4,6
,2013,050101262,,,,7,6,13
,2013,050101262,,,,6,9,15
,2013,050101264,,,,13,11,24
,2013,050101264,,,,9,12,21
,2013,050101264,,,,34,45,79
,2013,050101265,,,,72,49,121
,2013,050101265,,,,70,53,123
,2013,050101265,,,,13,15,28
,2013,050101266,,,,5,5,10
,2013,050101266,,,,15,25,40
,2013,050101267,,,,63,54,117
,2013,050101272,,,,7,7,14
,2013,050101276,,,,7,9,16
,2013,050101276,,,,2,4,6
,2013,050101277,,,,29,19,48
,2013,050101280,,,,6,4,10
,2013,050101282,,,,8,9,17
,2013,050101282,,,,17,22,39
,2013,050101282,,,,28,34,62
,2013,050101283,,,,6,8,14
,2013,050101284,,,,6,9,15
,2013,050101285,,,,7,6,13
,2013,050101286,,,,3,5,8
,2013,050101287,,,,3,2,5
,2013,050101294,,,,10,10,20
,2013,050101295,,,,8,4,12
,2013,050101296,,,,13,5,18
,2013,050101297,,,,8,5,13
,2013,050101298,,,,7,11,18
,2013,050101299,,,,5,8,13
,2013,050101300,,,,10,10,20
,2013,050101301,,,,4,3,7
,2013,050101305,,,,8,9,17
,2013,050101306,,,,10,11,21
,2013,050101308,,,,7,4,11
,2013,050101309,,,,8,2,10
,2013,050101309,,,,4,11,15
,2013,050101309,,,,1,2,3
,2013,050101310,,,,14,11,25
,2013,050101310,,,,37,31,68
,2013,050101311,,,,17,13,30
,2013,050101312,,,,60,61,121
,2013,050101313,,,,6,6,12
,2013,050101314,,,,9,6,15
,2013,050101316,,,,6,2,8
,2013,050101317,,,,10,9,19
,2013,050101317,,,,5,7,12
,2013,050101319,,,,17,24,41
,2013,050101320,,,,5,3,8
,2013,050101321,,,,6,4,10
,2013,050101321,,,,11,13,24
,2013,050101321,,,,4,3,7
,2013,050101321,,,,7,3,10
,2013,050101322,,,,39,35,74
,2013,050101322,,,,11,10,21
,2013,050101325,,,,10,5,15
,2013,050101326,,,,10,6,16
,2013,050101327,,,,5,15,20
,2013,050101328,,,,8,12,20
,2013,050101329,,,,8,7,15
,2013,050101330,,,,7,5,12
,2013,050101331,,,,9,5,14
,2013,050101332,,,,12,4,16
,2013,050101336,,,,11,17,28
,2013,050101336,,,,7,10,17
,2013,050101336,,,,38,36,74
,2013,050101337,,,,40,43,83
,2013,050101337,,,,21,16,37
,2013,050101338,,,,19,21,40
,2013,050101338,,,,4,15,19
,2013,050101338,,,,11,4,15
,2013,050101339,,,,9,5,14
,2013,050101339,,,,16,12,28
,2013,050101339,,,,3,23,26
,2013,050101339,,,,23,54,77
,2013,050101340,,,,14,12,26
,2013,050101340,,,,11,9,20
,2013,050101341,,,,23,25,48
,2013,050101341,,,,13,11,24
,2013,050101342,,,,25,13,38
,2013,050101343,,,,7,8,15
,2013,050101343,,,,7,10,17
,2013,050101344,,,,36,26,62
,2013,050101344,,,,15,8,23
,2013,050101344,,,,2,3,5
,2013,050101345,,,,20,26,46
,2013,050101345,,,,4,2,6
,2013,050101345,,,,34,44,78
,2013,050101346,,,,14,14,28
,2013,050101347,,,,1,0,1
,2013,050101347,,,,13,16,29
,2013,050101347,,,,32,23,55
,2013,050101348,,,,55,49,104
,2013,050101348,,,,60,54,114
,2013,050101348,,,,5,12,17
,2013,050101349,,,,3,2,5
,2013,050101349,,,,8,8,16
,2013,050101351,,,,3,2,5
,2013,050101352,,,,3,2,5
,2013,050101355,,,,8,2,10
,2013,050101357,,,,59,54,113
,2013,050101361,,,,23,24,47
,2013,050101362,,,,68,36,104
,2013,050101363,,,,19,24,43
,2013,050101364,,,,5,4,9
,2013,050101364,,,,9,11,20
,2013,050101364,,,,7,2,9
,2013,050101366,,,,16,7,23
,2013,050101366,,,,57,35,92
,2013,050101367,,,,36,24,60
,2013,050101368,,,,7,7,14
,2013,050101368,,,,23,51,74
,2013,050101368,,,,39,27,66
,2013,050101369,,,,6,6,12
,2013,050101369,,,,5,7,12
,2013,050101370,,,,26,21,47
,2013,050101433,,,,6,5,11
,2013,050101434,,,,28,23,51
,2013,050101435,,,,9,7,16
,2013,050101435,,,,13,14,27
,2013,050101436,,,,0,1,1
,2013,050101437,,,,7,5,12
,2013,050101437,,,,2,2,4
,2013,050101438,,,,7,8,15
,2013,050101438,,,,11,4,15
,2013,050101439,,,,8,8,16
,2013,050101439,,,,8,11,19
,2013,050101440,,,,8,3,11
,2013,050101440,,,,7,9,16
,2013,050101441,,,,10,14,24
,2013,050101444,,,,3,4,7
,2013,050101444,,,,26,32,58
,2013,050101446,,,,336,725,1061
,2013,050101447,,,,151,232,383
,2013,050101448,,,,105,188,293
,2013,050200001,,,,16,20,36
,2013,050200002,,,,32,33,65
,2013,050200003,,,,6,4,10
,2013,050200003,,,,25,11,36
,2013,050200004,,,,188,206,394
,2013,050200005,,,,12,10,22
,2013,050200005,,,,97,82,179
,2013,050200006,,,,8,14,22
,2013,050200007,,,,111,136,247
,2013,050200008,,,,34,20,54
,2013,050200009,,,,529,432,961
,2013,050200009,,,,35,23,58
,2013,050200010,,,,176,159,335
,2013,050200011,,,,6,3,9
,2013,050200011,,,,56,38,94
,2013,050200012,,,,22,29,51
,2013,050200012,,,,267,238,505
,2013,050200013,,,,215,225,440
,2013,050200014,,,,59,60,119
,2013,050200014,,,,52,72,124
,2013,050200015,,,,182,165,347
,2013,050200016,,,,16,14,30
,2013,050200017,,,,16,14,30
,2013,050200018,,,,42,38,80
,2013,050200019,,,,27,30,57
,2013,050200020,,,,19,17,36
,2013,050200021,,,,45,30,75
,2013,050200022,,,,66,49,115
,2013,050200023,,,,87,84,171
,2013,050200024,,,,437,449,886
,2013,050200025,,,,25,17,42
,2013,050200025,,,,241,244,485
,2013,050200026,,,,10,15,25
,2013,050200027,,,,80,75,155
,2013,050200028,,,,234,192,426
,2013,050200029,,,,451,382,833
,2013,050200030,,,,37,33,70
,2013,050200031,,,,112,122,234
,2013,050200032,,,,21,12,33
,2013,050200033,,,,10,8,18
,2013,050200034,,,,99,100,199
,2013,050200036,,,,63,64,127
,2013,050200037,,,,66,65,131
,2013,050200038,,,,109,98,207
,2013,050200039,,,,77,65,142
,2013,050200040,,,,52,37,89
,2013,050200041,,,,105,91,196
,2013,050200042,,,,8,7,15
,2013,050200042,,,,92,77,169
,2013,050200043,,,,352,364,716
,2013,050200044,,,,117,81,198
,2013,050200045,,,,31,28,59
,2013,050200045,,,,4,7,11
,2013,050200046,,,,67,46,113
,2013,050200047,,,,259,305,564
,2013,050200048,,,,209,206,415
,2013,050200049,,,,28,28,56
,2013,050200050,,,,21,21,42
,2013,050200051,,,,351,362,713
,2013,050200052,,,,190,170,360
,2013,050200053,,,,423,362,785
,2013,050200053,,,,40,47,87
,2013,050200054,,,,615,610,1225
,2013,050200055,,,,140,125,265
,2013,050200056,,,,21,15,36
,2013,050200057,,,,12,12,24
,2013,050200058,,,,9,10,19
,2013,050200058,,,,86,82,168
,2013,050200059,,,,311,289,600
,2013,050200060,,,,188,214,402
,2013,050200061,,,,475,466,941
,2013,050200064,,,,305,295,600
,2013,050200064,,,,21,22,43
,2013,050200065,,,,25,19,44
,2013,050200065,,,,2,6,8
,2013,050200068,,,,26,22,48
,2013,050200068,,,,5,3,8
,2013,050200071,,,,33,26,59
,2013,050200071,,,,89,92,181
,2013,050200071,,,,13,29,42
,2013,050200072,,,,10,16,26
,2013,050200072,,,,65,41,106
,2013,050200073,,,,3,3,6
,2013,050200073,,,,43,39,82
,2013,050200073,,,,91,140,231
,2013,050200074,,,,293,280,573
,2013,050200074,,,,30,40,70
,2013,050200075,,,,10,7,17
,2013,050200075,,,,43,29,72
,2013,050200076,,,,22,16,38
,2013,050200076,,,,273,279,552
,2013,050200077,,,,8,12,20
,2013,050200077,,,,133,112,245
,2013,050200078,,,,7,8,15
,2013,050200078,,,,51,39,90
,2013,050200079,,,,54,45,99
,2013,050200079,,,,15,10,25
,2013,050200080,,,,96,84,180
,2013,050200081,,,,80,115,195
,2013,050200081,,,,47,48,95
,2013,050200081,,,,10,10,20
,2013,050200082,,,,58,48,106
,2013,050200082,,,,9,9,18
,2013,050200082,,,,133,105,238
,2013,050200083,,,,315,267,582
,2013,050200086,,,,53,45,98
,2013,050200087,,,,45,26,71
,2013,050200088,,,,90,83,173
,2013,050200089,,,,2,7,9
,2013,050200089,,,,24,22,46
,2013,050200089,,,,63,71,134
,2013,050200089,,,,1,9,10
,2013,050200090,,,,69,57,126
,2013,050200091,,,,4,0,4
,2013,050200091,,,,17,17,34
,2013,050200092,,,,12,3,15
,2013,050200093,,,,184,182,366
,2013,050200094,,,,45,46,91
,2013,050200094,,,,472,481,953
,2013,050200095,,,,24,19,43
,2013,050200096,,,,13,15,28
,2013,050200097,,,,34,44,78
,2013,050200098,,,,23,46,69
,2013,050200099,,,,24,21,45
,2013,050200100,,,,1282,1354,2636
,2013,050200101,,,,16,11,27
,2013,050200103,,,,134,179,313
,2013,050200104,,,,103,85,188
,2013,050200105,,,,94,88,182
,2013,050200106,,,,1301,1548,2849
,2013,050200107,,,,227,226,453
,2013,050200109,,,,10,10,20
,2013,050200110,,,,8,10,18
,2013,050200111,,,,13,14,27
,2013,050200113,,,,7,13,20
,2013,050200113,,,,36,40,76
,2013,050200114,,,,13,13,26
,2013,050200115,,,,19,18,37
,2013,050200115,,,,61,61,122
,2013,050200116,,,,4,2,6
,2013,050200118,,,,97,114,211
,2013,050200118,,,,13,18,31
,2013,050200118,,,,13,18,31
,2013,050200120,,,,10,9,19
,2013,050200121,,,,13,10,23
,2013,050200122,,,,32,31,63
,2013,050200124,,,,33,35,68
,2013,050200125,,,,50,42,92
,2013,050200127,,,,16,18,34
,2013,050200128,,,,12,7,19
,2013,050200130,,,,63,74,137
,2013,050200130,,,,10,16,26
,2013,050200131,,,,7,3,10
,2013,050200132,,,,252,234,486
,2013,050200133,,,,177,168,345
,2013,050200133,,,,8,2,10
,2013,050200134,,,,11,11,22
,2013,050200137,,,,8,22,30
,2013,050200138,,,,37,28,65
,2013,050200139,,,,22,24,46
,2013,050200140,,,,20,16,36
,2013,050200140,,,,85,63,148
,2013,050200144,,,,18,18,36
,2013,050200144,,,,16,18,34
,2013,050200145,,,,18,17,35
,2013,050200146,,,,10,13,23
,2013,050200147,,,,22,14,36
,2013,050200147,,,,252,206,458
,2013,050200148,,,,5,13,18
,2013,050200148,,,,20,21,41
,2013,050200149,,,,47,39,86
,2013,050200150,,,,86,76,162
,2013,050200151,,,,7,4,11
,2013,050200153,,,,8,19,27
,2013,050200155,,,,59,53,112
,2013,050200156,,,,114,111,225
,2013,050200159,,,,46,54,100
,2013,050200161,,,,3,4,7
,2013,050200161,,,,34,31,65
,2013,050200162,,,,253,237,490
,2013,050200163,,,,184,235,419
,2013,050200165,,,,53,80,133
,2013,050200165,,,,21,20,41
,2013,050200165,,,,95,103,198
,2013,050200166,,,,1,1,2
,2013,050200166,,,,20,18,38
,2013,050200167,,,,37,42,79
,2013,050200171,,,,56,88,144
,2013,050200172,,,,41,50,91
,2013,050200172,,,,290,371,661
,2013,050200173,,,,32,40,72
,2013,050200174,,,,113,92,205
,2013,050200174,,,,9,12,21
,2013,050200174,,,,78,77,155
,2013,050200175,,,,19,15,34
,2013,050200176,,,,7,7,14
,2013,050200177,,,,13,4,17
,2013,050200178,,,,70,53,123
,2013,050200180,,,,25,17,42
,2013,050200181,,,,31,15,46
,2013,050200183,,,,79,80,159
,2013,050200183,,,,16,11,27
,2013,050200185,,,,14,13,27
,2013,050200186,,,,85,65,150
,2013,050200186,,,,17,11,28
,2013,050200187,,,,167,153,320
,2013,050200188,,,,313,283,596
,2013,050200190,,,,170,133,303
,2013,050200191,,,,10,8,18
,2013,050200191,,,,79,50,129
,2013,050200191,,,,2,4,6
,2013,050200191,,,,25,23,48
,2013,050200193,,,,10,13,23
,2013,050200194,,,,58,65,123
,2013,050200194,,,,10,7,17
,2013,050200195,,,,214,203,417
,2013,050200195,,,,15,24,39
,2013,050200198,,,,6,4,10
,2013,050200199,,,,7,5,12
,2013,050200199,,,,30,27,57
,2013,050200202,,,,68,55,123
,2013,050200206,,,,59,68,127
,2013,050200206,,,,15,11,26
,2013,050200207,,,,12,18,30
,2013,050200207,,,,25,31,56
,2013,050200207,,,,62,57,119
,2013,050200208,,,,9,4,13
,2013,050200208,,,,8,12,20
,2013,050200208,,,,17,36,53
,2013,050200209,,,,26,19,45
,2013,050200209,,,,48,70,118
,2013,050200209,,,,3,10,13
,2013,050200210,,,,4,10,14
,2013,050200210,,,,21,18,39
,2013,050200210,,,,49,34,83
,2013,050200211,,,,3,4,7
,2013,050200211,,,,24,25,49
,2013,050200212,,,,197,183,380
,2013,050200212,,,,193,171,364
,2013,050200212,,,,20,23,43
,2013,050200213,,,,6,3,9
,2013,050200213,,,,21,41,62
,2013,050200213,,,,15,27,42
,2013,050200213,,,,10,16,26
,2013,050200214,,,,50,101,151
,2013,050200214,,,,31,41,72
,2013,050200215,,,,66,68,134
,2013,050200215,,,,5,6,11
,2013,050200216,,,,7,5,12
,2013,050200217,,,,9,8,17
,2013,050200220,,,,5,5,10
,2013,050200221,,,,12,6,18
,2013,050200222,,,,3,3,6
,2013,050200223,,,,8,9,17
,2013,050200229,,,,17,12,29
,2013,050200230,,,,6,9,15
,2013,050200236,,,,10,4,14
,2013,050200237,,,,4,13,17
,2013,050200238,,,,5,11,16
,2013,050200241,,,,5,13,18
,2013,050200250,,,,4,3,7
,2013,050200250,,,,45,44,89
,2013,050200263,,,,11,16,27
,2013,050200263,,,,2,0,2
,2013,050200264,,,,5,3,8
,2013,050200264,,,,34,37,71
,2013,050200264,,,,15,11,26
,2013,050200265,,,,6,7,13
,2013,050200266,,,,18,6,24
,2013,050200272,,,,193,162,355
,2013,050200273,,,,7,13,20
,2013,050200277,,,,78,84,162
,2013,050200277,,,,7,10,17
,2013,050200278,,,,109,103,212
,2013,050200279,,,,6,14,20
,2013,050200279,,,,5,5,10
,2013,050200280,,,,0,1,1
,2013,050200280,,,,7,6,13
,2013,050200280,,,,27,35,62
,2013,050200282,,,,19,14,33
,2013,050200283,,,,7,9,16
,2013,050200285,,,,6,6,12
,2013,050200286,,,,6,4,10
,2013,050200288,,,,5,5,10
,2013,050200290,,,,10,5,15
,2013,050200292,,,,72,62,134
,2013,050200296,,,,8,4,12
,2013,050200300,,,,31,39,70
,2013,050200300,,,,44,46,90
,2013,050200300,,,,5,3,8
,2013,050200301,,,,36,53,89
,2013,050200302,,,,63,48,111
,2013,050200302,,,,71,116,187
,2013,050200302,,,,9,18,27
,2013,050200303,,,,13,35,48
,2013,050200303,,,,25,28,53
,2013,050200305,,,,49,60,109
,2013,050200305,,,,10,8,18
,2013,050200305,,,,28,30,58
,2013,050200306,,,,23,15,38
,2013,050200306,,,,9,7,16
,2013,050200307,,,,12,17,29
,2013,050200308,,,,6,8,14
,2013,050200309,,,,56,66,122
,2013,050200312,,,,3,3,6
,2013,050200313,,,,27,12,39
,2013,050200314,,,,10,7,17
,2013,050200316,,,,15,6,21
,2013,050200317,,,,7,8,15
,2013,050200319,,,,5,10,15
,2013,050200320,,,,8,6,14
,2013,050200321,,,,7,10,17
,2013,050200323,,,,9,5,14
,2013,050200325,,,,5,12,17
,2013,050200326,,,,1,5,6
,2013,050200327,,,,9,6,15
,2013,050200330,,,,7,4,11
,2013,050200332,,,,6,6,12
,2013,050200333,,,,9,7,16
,2013,050200336,,,,9,6,15
,2013,050200337,,,,5,6,11
,2013,050200338,,,,9,10,19
,2013,050200341,,,,3,1,4
,2013,050200342,,,,0,5,5
,2013,050200344,,,,44,70,114
,2013,050200345,,,,1,2,3
,2013,050200345,,,,8,0,8
,2013,050200346,,,,78,69,147
,2013,050200347,,,,18,18,36
,2013,050200349,,,,22,12,34
,2013,050200349,,,,0,4,4
,2013,050200350,,,,13,17,30
,2013,050200350,,,,4,2,6
,2013,050200351,,,,49,34,83
,2013,050200352,,,,150,101,251
,2013,050200353,,,,17,13,30
,2013,050200353,,,,17,7,24
,2013,050200354,,,,3,3,6
,2013,050200354,,,,13,15,28
,2013,050200354,,,,20,19,39
,2013,050200355,,,,13,9,22
,2013,050200355,,,,43,38,81
,2013,050200356,,,,61,46,107
,2013,050200357,,,,3,7,10
,2013,050200358,,,,93,106,199
,2013,050200358,,,,22,21,43
,2013,050200358,,,,44,51,95
,2013,050200359,,,,11,9,20
,2013,050200359,,,,4,2,6
,2013,050200359,,,,21,30,51
,2013,050200360,,,,12,12,24
,2013,050200361,,,,11,5,16
,2013,050200364,,,,1,2,3
,2013,050200365,,,,0,4,4
,2013,050200366,,,,2,3,5
,2013,050200367,,,,4,2,6
,2013,050200368,,,,2,4,6
,2013,050200369,,,,11,9,20
,2013,050200370,,,,4,2,6
,2013,050200371,,,,12,11,23
,2013,050200373,,,,10,7,17
,2013,050200374,,,,8,8,16
,2013,050200375,,,,13,8,21
,2013,050200377,,,,5,5,10
,2013,050200378,,,,7,8,15
,2013,050200379,,,,10,9,19
,2013,050200380,,,,13,7,20
,2013,050200381,,,,8,11,19
,2013,050200382,,,,9,6,15
,2013,050200383,,,,6,4,10
,2013,050200384,,,,5,7,12
,2013,050200387,,,,6,14,20
,2013,050200388,,,,6,4,10
,2013,050200389,,,,61,45,106
,2013,050200390,,,,5,8,13
,2013,050200390,,,,11,10,21
,2013,050200390,,,,19,17,36
,2013,050200391,,,,16,9,25
,2013,050200391,,,,32,27,59
,2013,050200392,,,,9,5,14
,2013,050200393,,,,9,9,18
,2013,050200394,,,,5,12,17
,2013,050200395,,,,7,7,14
,2013,050200397,,,,3,2,5
,2013,050200398,,,,4,6,10
,2013,050200399,,,,6,9,15
,2013,050200400,,,,3,3,6
,2013,050200401,,,,6,8,14
,2013,050200402,,,,5,4,9
,2013,050200402,,,,9,8,17
,2013,050200403,,,,1,4,5
,2013,050200403,,,,13,12,25
,2013,050200403,,,,1,3,4
,2013,050200404,,,,3,4,7
,2013,050200404,,,,9,8,17
,2013,050200405,,,,18,20,38
,2013,050200405,,,,0,3,3
,2013,050200405,,,,12,12,24
,2013,050200406,,,,21,21,42
,2013,050200406,,,,7,4,11
,2013,050200406,,,,3,6,9
,2013,050200407,,,,19,16,35
,2013,050200407,,,,11,9,20
,2013,050200407,,,,97,78,175
,2013,050200409,,,,14,12,26
,2013,050200409,,,,5,2,7
,2013,050200410,,,,2,3,5
,2013,050200410,,,,32,37,69
,2013,050200411,,,,8,7,15
,2013,050200411,,,,15,16,31
,2013,050200412,,,,4,5,9
,2013,050200414,,,,3,7,10
,2013,050200415,,,,441,603,1044
,2013,050200416,,,,10,5,15
,2013,050200416,,,,14,20,34
,2013,050200417,,,,13,26,39
,2013,050200418,,,,2,5,7
,2013,050200419,,,,3,0,3
,2013,050200419,,,,2,4,6
,2013,050200453,,,,39,23,62
,2013,050200453,,,,208,183,391
,2013,050200454,,,,1,3,4
,2013,050200454,,,,2,0,2
,2013,050200454,,,,1,2,3
,2013,050200455,,,,6,3,9
,2013,050200455,,,,6,3,9
,2013,050200456,,,,10,8,18
,2013,050200456,,,,66,67,133
,2013,050200457,,,,13,24,37
,2013,050200462,,,,590,1068,1658
,2013,050200463,,,,91,128,219
,2013,050300001,,,,27,17,44
,2013,050300002,,,,27,20,47
,2013,050300003,,,,139,129,268
,2013,050300004,,,,93,101,194
,2013,050300004,,,,7,7,14
,2013,050300005,,,,9,12,21
,2013,050300006,,,,61,61,122
,2013,050300007,,,,142,163,305
,2013,050300007,,,,9,15,24
,2013,050300008,,,,49,26,75
,2013,050300009,,,,132,108,240
,2013,050300009,,,,13,11,24
,2013,050300010,,,,150,125,275
,2013,050300011,,,,16,16,32
,2013,050300012,,,,10,10,20
,2013,050300014,,,,296,289,585
,2013,050300015,,,,18,10,28
,2013,050300016,,,,9,7,16
,2013,050300016,,,,47,39,86
,2013,050300017,,,,40,25,65
,2013,050300018,,,,67,46,113
,2013,050300018,,,,12,19,31
,2013,050300019,,,,10,11,21
,2013,050300019,,,,101,74,175
,2013,050300020,,,,645,645,1290
,2013,050300021,,,,424,365,789
,2013,050300022,,,,38,32,70
,2013,050300022,,,,181,202,383
,2013,050300023,,,,24,18,42
,2013,050300024,,,,30,26,56
,2013,050300025,,,,163,149,312
,2013,050300026,,,,96,117,213
,2013,050300026,,,,16,13,29
,2013,050300027,,,,5,8,13
,2013,050300027,,,,27,19,46
,2013,050300028,,,,173,176,349
,2013,050300029,,,,26,11,37
,2013,050300029,,,,5,3,8
,2013,050300030,,,,22,19,41
,2013,050300031,,,,72,49,121
,2013,050300032,,,,25,26,51
,2013,050300033,,,,5,8,13
,2013,050300034,,,,28,25,53
,2013,050300035,,,,60,52,112
,2013,050300036,,,,9,10,19
,2013,050300037,,,,20,14,34
,2013,050300038,,,,136,118,254
,2013,050300039,,,,35,30,65
,2013,050300042,,,,13,14,27
,2013,050300044,,,,18,13,31
,2013,050300045,,,,8,5,13
,2013,050300047,,,,96,56,152
,2013,050300048,,,,286,281,567
,2013,050300048,,,,14,12,26
,2013,050300049,,,,11,9,20
,2013,050300050,,,,49,39,88
,2013,050300051,,,,6,7,13
,2013,050300052,,,,8,8,16
,2013,050300053,,,,29,35,64
,2013,050300055,,,,15,12,27
,2013,050300056,,,,14,12,26
,2013,050300057,,,,21,23,44
,2013,050300058,,,,20,11,31
,2013,050300060,,,,8,10,18
,2013,050300061,,,,9,10,19
,2013,050300062,,,,17,6,23
,2013,050300063,,,,11,6,17
,2013,050300065,,,,14,14,28
,2013,050300067,,,,14,18,32
,2013,050300068,,,,19,26,45
,2013,050300068,,,,5,3,8
,2013,050300070,,,,30,25,55
,2013,050300071,,,,32,27,59
,2013,050300072,,,,13,19,32
,2013,050300073,,,,17,20,37
,2013,050300074,,,,28,18,46
,2013,050300075,,,,13,5,18
,2013,050300076,,,,14,9,23
,2013,050300076,,,,2,0,2
,2013,050300081,,,,12,22,34
,2013,050300082,,,,11,9,20
,2013,050300083,,,,8,15,23
,2013,050300085,,,,17,24,41
,2013,050300085,,,,2,2,4
,2013,050300086,,,,12,6,18
,2013,050300087,,,,36,52,88
,2013,050300088,,,,14,9,23
,2013,050300089,,,,25,16,41
,2013,050300091,,,,25,27,52
,2013,050300093,,,,353,409,762
,2013,050300094,,,,97,88,185
,2013,050300095,,,,3,2,5
,2013,050300095,,,,5,8,13
,2013,050300095,,,,1,0,1
,2013,050300096,,,,28,27,55
,2013,050300097,,,,11,11,22
,2013,050300098,,,,16,18,34
,2013,050300099,,,,60,58,118
,2013,050300102,,,,5,5,10
,2013,050300104,,,,19,19,38
,2013,050300105,,,,27,25,52
,2013,050300106,,,,14,9,23
,2013,050300108,,,,21,15,36
,2013,050300111,,,,31,35,66
,2013,050300112,,,,9,10,19
,2013,050300113,,,,18,4,22
,2013,050300115,,,,12,13,25
,2013,050300116,,,,16,17,33
,2013,050300119,,,,13,7,20
,2013,050300120,,,,24,56,80
,2013,050300121,,,,47,60,107
,2013,050300121,,,,13,7,20
,2013,050300121,,,,3,0,3
,2013,050300122,,,,6,6,12
,2013,050300124,,,,2,4,6
,2013,050300126,,,,4,6,10
,2013,050300128,,,,2,3,5
,2013,050300131,,,,2,6,8
,2013,050300133,,,,6,6,12
,2013,050300142,,,,4,4,8
,2013,050300142,,,,49,30,79
,2013,050300144,,,,3,6,9
,2013,050300145,,,,3,3,6
,2013,050300148,,,,16,6,22
,2013,050300149,,,,11,11,22
,2013,050300151,,,,2,3,5
,2013,050300153,,,,13,8,21
,2013,050300154,,,,11,10,21
,2013,050300154,,,,6,6,12
,2013,050300155,,,,4,3,7
,2013,050300156,,,,5,2,7
,2013,050300157,,,,1,5,6
,2013,050300159,,,,3,7,10
,2013,050300160,,,,2,6,8
,2013,050300162,,,,39,33,72
,2013,050300162,,,,25,37,62
,2013,050300162,,,,2,0,2
,2013,050300163,,,,26,16,42
,2013,050300164,,,,41,30,71
,2013,050300165,,,,6,7,13
,2013,050300166,,,,3,2,5
,2013,050300167,,,,6,6,12
,2013,050300168,,,,2,1,3
,2013,050300169,,,,5,3,8
,2013,050300171,,,,3,5,8
,2013,050300172,,,,5,3,8
,2013,050300173,,,,4,5,9
,2013,050300174,,,,1,2,3
,2013,050300175,,,,4,4,8
,2013,050300176,,,,1,2,3
,2013,050300178,,,,4,1,5
,2013,050300179,,,,4,4,8
,2013,050300180,,,,5,4,9
,2013,050300180,,,,4,5,9
,2013,050300181,,,,3,3,6
,2013,050300182,,,,9,6,15
,2013,050300183,,,,28,53,81
,2013,050300183,,,,5,7,12
,2013,050400001,,,,145,113,258
,2013,050400002,,,,266,257,523
,2013,050400003,,,,263,268,531
,2013,050400004,,,,67,56,123
,2013,050400005,,,,137,113,250
,2013,050400006,,,,296,290,586
,2013,050400007,,,,32,27,59
,2013,050400008,,,,25,27,52
,2013,050400009,,,,358,369,727
,2013,050400010,,,,140,129,269
,2013,050400014,,,,9,12,21
,2013,050400016,,,,19,22,41
,2013,050400021,,,,8,12,20
,2013,050400022,,,,17,11,28
,2013,050400023,,,,6,8,14
,2013,050400024,,,,97,73,170
,2013,050400028,,,,133,162,295
,2013,050400029,,,,159,160,319
,2013,050400030,,,,15,19,34
,2013,050400030,,,,3,3,6
,2013,050400034,,,,31,27,58
,2013,050400035,,,,4,4,8
,2013,050400035,,,,21,21,42
,2013,050400036,,,,4,3,7
,2013,050400037,,,,8,5,13
,2013,050400038,,,,25,36,61
,2013,050400038,,,,17,21,38
,2013,050400038,,,,4,5,9
,2013,050400039,,,,5,8,13
,2013,050400040,,,,5,5,10
,2013,050400041,,,,4,3,7
,2013,050400042,,,,1,4,5
,2013,050400043,,,,8,6,14
,2013,050400044,,,,3,6,9
,2013,050400044,,,,30,41,71
,2013,050400044,,,,43,47,90
,2013,050500001,,,,366,311,677
,2013,050500002,,,,187,176,363
,2013,050500003,,,,126,132,258
,2013,050500004,,,,10,5,15
,2013,050500005,,,,99,93,192
,2013,050500006,,,,192,188,380
,2013,050500007,,,,27,25,52
,2013,050500008,,,,97,62,159
,2013,050500009,,,,16,15,31
,2013,050500010,,,,137,122,259
,2013,050500011,,,,111,92,203
,2013,050500012,,,,68,66,134
,2013,050500013,,,,191,182,373
,2013,050500014,,,,48,53,101
,2013,050500015,,,,20,9,29
,2013,050500016,,,,2,6,8
,2013,050500016,,,,51,44,95
,2013,050500016,,,,76,91,167
,2013,050500017,,,,24,24,48
,2013,050500018,,,,18,34,52
,2013,050500019,,,,53,66,119
,2013,050500020,,,,31,24,55
,2013,050500021,,,,19,17,36
,2013,050500022,,,,408,401,809
,2013,050500024,,,,11,18,29
,2013,050500027,,,,20,24,44
,2013,050500028,,,,11,8,19
,2013,050500029,,,,13,7,20
,2013,050500030,,,,24,20,44
,2013,050500031,,,,22,23,45
,2013,050500032,,,,11,10,21
,2013,050500033,,,,26,15,41
,2013,050500035,,,,20,21,41
,2013,050500036,,,,8,12,20
,2013,050500043,,,,21,25,46
,2013,050500044,,,,10,10,20
,2013,050500050,,,,101,102,203
,2013,050500051,,,,4,6,10
,2013,050500051,,,,26,16,42
,2013,050500051,,,,15,15,30
,2013,050500051,,,,57,56,113
,2013,050500060,,,,4,3,7
,2013,050500060,,,,20,18,38
,2013,050500063,,,,30,25,55
,2013,050500064,,,,8,4,12
,2013,050500071,,,,15,11,26
,2013,050500071,,,,29,29,58
,2013,050600001,,,,35,21,56
,2013,050600002,,,,22,23,45
,2013,050600002,,,,165,147,312
,2013,050600003,,,,7,7,14
,2013,050600004,,,,87,74,161
,2013,050600005,,,,52,59,111
,2013,050600005,,,,39,23,62
,2013,050600005,,,,1,4,5
,2013,050600006,,,,264,229,493
,2013,050600007,,,,59,51,110
,2013,050600008,,,,167,159,326
,2013,050600009,,,,285,238,523
,2013,050600010,,,,396,397,793
,2013,050600011,,,,184,175,359
,2013,050600011,,,,31,27,58
,2013,050600012,,,,243,218,461
,2013,050600013,,,,30,22,52
,2013,050600013,,,,167,186,353
,2013,050600015,,,,10,14,24
,2013,050600017,,,,194,190,384
,2013,050600018,,,,344,326,670
,2013,050600019,,,,102,89,191
,2013,050600019,,,,282,303,585
,2013,050600019,,,,359,385,744
,2013,050600019,,,,39,46,85
,2013,050600020,,,,249,246,495
,2013,050600021,,,,196,168,364
,2013,050600022,,,,13,6,19
,2013,050600023,,,,45,35,80
,2013,050600024,,,,43,40,83
,2013,050600025,,,,104,73,177
,2013,050600026,,,,73,53,126
,2013,050600026,,,,6,13,19
,2013,050600027,,,,234,224,458
,2013,050600028,,,,70,69,139
,2013,050600029,,,,44,32,76
,2013,050600030,,,,116,114,230
,2013,050600031,,,,173,139,312
,2013,050600032,,,,5,11,16
,2013,050600032,,,,80,69,149
,2013,050600034,,,,25,24,49
,2013,050600035,,,,48,47,95
,2013,050600035,,,,11,7,18
,2013,050600037,,,,22,19,41
,2013,050600037,,,,153,129,282
,2013,050600037,,,,15,15,30
,2013,050600038,,,,340,295,635
,2013,050600038,,,,37,18,55
,2013,050600039,,,,24,8,32
,2013,050600039,,,,109,108,217
,2013,050600040,,,,257,221,478
,2013,050600041,,,,126,119,245
,2013,050600042,,,,112,114,226
,2013,050600043,,,,167,166,333
,2013,050600044,,,,2,7,9
,2013,050600045,,,,88,78,166
,2013,050600046,,,,30,41,71
,2013,050600047,,,,135,166,301
,2013,050600048,,,,10,18,28
,2013,050600049,,,,3,40,43
,2013,050600049,,,,158,163,321
,2013,050600050,,,,85,79,164
,2013,050600051,,,,6,3,9
,2013,050600051,,,,30,25,55
,2013,050600052,,,,24,24,48
,2013,050600054,,,,29,29,58
,2013,050600054,,,,72,55,127
,2013,050600054,,,,5,3,8
,2013,050600055,,,,11,9,20
,2013,050600056,,,,123,104,227
,2013,050600057,,,,21,11,32
,2013,050600060,,,,59,48,107
,2013,050600062,,,,14,8,22
,2013,050600063,,,,1,3,4
,2013,050600063,,,,36,31,67
,2013,050600063,,,,83,121,204
,2013,050600063,,,,59,67,126
,2013,050600064,,,,113,102,215
,2013,050600064,,,,179,278,457
,2013,050600064,,,,7,8,15
,2013,050600065,,,,38,57,95
,2013,050600066,,,,305,241,546
,2013,050600066,,,,35,29,64
,2013,050600067,,,,11,14,25
,2013,050600067,,,,84,69,153
,2013,050600068,,,,52,63,115
,2013,050600068,,,,7,4,11
,2013,050600069,,,,274,322,596
,2013,050600070,,,,495,432,927
,2013,050600070,,,,20,11,31
,2013,050600071,,,,8,18,26
,2013,050600072,,,,75,94,169
,2013,050600073,,,,76,50,126
,2013,050600074,,,,30,27,57
,2013,050600075,,,,28,48,76
,2013,050600076,,,,107,132,239
,2013,050600076,,,,39,31,70
,2013,050600077,,,,27,18,45
,2013,050600079,,,,3,4,7
,2013,050600079,,,,42,47,89
,2013,050600079,,,,11,26,37
,2013,050600081,,,,3,3,6
,2013,050600081,,,,31,31,62
,2013,050600082,,,,36,36,72
,2013,050600083,,,,49,55,104
,2013,050600084,,,,13,21,34
,2013,050600085,,,,30,41,71
,2013,050600087,,,,13,13,26
,2013,050600088,,,,1171,1337,2508
,2013,050600090,,,,14,18,32
,2013,050600092,,,,11,8,19
,2013,050600094,,,,12,15,27
,2013,050600095,,,,10,15,25
,2013,050600096,,,,10,11,21
,2013,050600097,,,,15,10,25
,2013,050600099,,,,10,20,30
,2013,050600100,,,,9,10,19
,2013,050600101,,,,35,18,53
,2013,050600102,,,,11,11,22
,2013,050600105,,,,6,5,11
,2013,050600106,,,,12,8,20
,2013,050600108,,,,55,32,87
,2013,050600109,,,,7,11,18
,2013,050600109,,,,14,14,28
,2013,050600109,,,,56,58,114
,2013,050600113,,,,36,30,66
,2013,050600114,,,,44,41,85
,2013,050600115,,,,35,23,58
,2013,050600116,,,,8,15,23
,2013,050600117,,,,69,89,158
,2013,050600118,,,,9,8,17
,2013,050600119,,,,15,13,28
,2013,050600121,,,,41,27,68
,2013,050600121,,,,129,129,258
,2013,050600121,,,,91,91,182
,2013,050600121,,,,41,27,68
,2013,050600124,,,,39,51,90
,2013,050600125,,,,14,6,20
,2013,050600125,,,,25,13,38
,2013,050600126,,,,6,10,16
,2013,050600127,,,,25,17,42
,2013,050600128,,,,16,5,21
,2013,050600129,,,,28,19,47
,2013,050600133,,,,129,36,165
,2013,050600135,,,,72,110,182
,2013,050600138,,,,20,28,48
,2013,050600139,,,,11,14,25
,2013,050600140,,,,27,24,51
,2013,050600140,,,,55,61,116
,2013,050600140,,,,65,65,130
,2013,050600140,,,,27,24,51
,2013,050600141,,,,36,32,68
,2013,050600142,,,,44,53,97
,2013,050600143,,,,25,28,53
,2013,050600144,,,,87,73,160
,2013,050600145,,,,36,36,72
,2013,050600145,,,,8,8,16
,2013,050600146,,,,11,18,29
,2013,050600148,,,,13,12,25
,2013,050600149,,,,21,24,45
,2013,050600150,,,,12,12,24
,2013,050600151,,,,16,9,25
,2013,050600152,,,,7,6,13
,2013,050600153,,,,3,3,6
,2013,050600153,,,,62,58,120
,2013,050600153,,,,18,19,37
,2013,050600155,,,,53,47,100
,2013,050600156,,,,60,75,135
,2013,050600156,,,,14,16,30
,2013,050600156,,,,29,21,50
,2013,050600158,,,,5,10,15
,2013,050600160,,,,71,62,133
,2013,050600161,,,,6,10,16
,2013,050600162,,,,12,10,22
,2013,050600164,,,,33,55,88
,2013,050600164,,,,35,38,73
,2013,050600164,,,,102,120,222
,2013,050600166,,,,14,12,26
,2013,050600168,,,,1,3,4
,2013,050600168,,,,9,11,20
,2013,050600169,,,,72,81,153
,2013,050600169,,,,2,5,7
,2013,050600172,,,,9,7,16
,2013,050600174,,,,5,3,8
,2013,050600177,,,,7,4,11
,2013,050600188,,,,11,8,19
,2013,050600206,,,,16,9,25
,2013,050600207,,,,20,17,37
,2013,050600207,,,,21,40,61
,2013,050600207,,,,79,85,164
,2013,050600207,,,,8,6,14
,2013,050600208,,,,64,45,109
,2013,050600216,,,,15,21,36
,2013,050600216,,,,12,6,18
,2013,050600216,,,,36,41,77
,2013,050600218,,,,4,3,7
,2013,050600218,,,,103,135,238
,2013,050600218,,,,28,26,54
,2013,050600219,,,,51,36,87
,2013,050600220,,,,4,5,9
,2013,050600220,,,,26,24,50
,2013,050600220,,,,5,2,7
,2013,050600221,,,,35,33,68
,2013,050600221,,,,17,16,33
,2013,050600223,,,,19,17,36
,2013,050600224,,,,15,20,35
,2013,050600225,,,,5,12,17
,2013,050600226,,,,11,9,20
,2013,050600227,,,,2,4,6
,2013,050600229,,,,5,8,13
,2013,050600230,,,,8,12,20
,2013,050600231,,,,7,5,12
,2013,050600232,,,,4,7,11
,2013,050600235,,,,6,6,12
,2013,050600237,,,,3,5,8
,2013,050600238,,,,6,5,11
,2013,050600239,,,,14,5,19
,2013,050600239,,,,32,32,64
,2013,050600242,,,,9,3,12
,2013,050600243,,,,7,16,23
,2013,050600243,,,,89,79,168
,2013,050600244,,,,19,22,41
,2013,050600245,,,,8,7,15
,2013,050600247,,,,6,7,13
,2013,050600249,,,,2,1,3
,2013,050600250,,,,6,10,16
,2013,050600250,,,,2,7,9
,2013,050600250,,,,9,9,18
,2013,050600251,,,,17,11,28
,2013,050600253,,,,170,319,489
,2013,050600254,,,,18,18,36
,2013,050600255,,,,29,35,64
,2013,050600255,,,,6,8,14
,2013,050600276,,,,13,9,22
,2013,050600276,,,,11,10,21
,2013,050600278,,,,364,531,895
,2013,050700003,,,,498,466,964
,2013,050700004,,,,18,8,26
,2013,050700005,,,,31,36,67
,2013,050700006,,,,23,33,56
,2013,050700006,,,,217,200,417
,2013,050700007,,,,45,42,87
,2013,050700008,,,,3,4,7
,2013,050700009,,,,61,52,113
,2013,050700010,,,,59,58,117
,2013,050700011,,,,70,65,135
,2013,050700012,,,,52,45,97
,2013,050700013,,,,17,14,31
,2013,050700014,,,,133,112,245
,2013,050700015,,,,17,24,41
,2013,050700016,,,,142,133,275
,2013,050700016,,,,31,27,58
,2013,050700017,,,,92,102,194
,2013,050700018,,,,47,51,98
,2013,050700019,,,,75,59,134
,2013,050700020,,,,21,17,38
,2013,050700021,,,,68,69,137
,2013,050700022,,,,46,36,82
,2013,050700023,,,,16,25,41
,2013,050700024,,,,58,48,106
,2013,050700025,,,,47,32,79
,2013,050700026,,,,29,20,49
,2013,050700027,,,,38,37,75
,2013,050700028,,,,18,10,28
,2013,050700029,,,,21,10,31
,2013,050700030,,,,47,36,83
,2013,050700031,,,,11,15,26
,2013,050700032,,,,12,7,19
,2013,050700033,,,,19,6,25
,2013,050700034,,,,12,14,26
,2013,050700035,,,,9,14,23
,2013,050700036,,,,10,11,21
,2013,050700036,,,,7,14,21
,2013,050700037,,,,23,16,39
,2013,050700038,,,,60,59,119
,2013,050700040,,,,30,20,50
,2013,050700041,,,,12,8,20
,2013,050700042,,,,27,34,61
,2013,050700043,,,,15,15,30
,2013,050700044,,,,7,14,21
,2013,050700045,,,,16,20,36
,2013,050700047,,,,6,3,9
,2013,050700048,,,,10,11,21
,2013,050700049,,,,5,9,14
,2013,050700050,,,,4,4,8
,2013,050700051,,,,8,16,24
,2013,050700052,,,,11,9,20
,2013,050700053,,,,9,13,22
,2013,050700054,,,,385,391,776
,2013,050700055,,,,11,11,22
,2013,050700056,,,,7,4,11
,2013,050700061,,,,8,8,16
,2013,050700062,,,,5,5,10
,2013,050700063,,,,5,2,7
,2013,050700065,,,,4,3,7
,2013,050700066,,,,4,3,7
,2013,050700068,,,,6,7,13
,2013,050700072,,,,4,0,4
,2013,050700073,,,,7,9,16
,2013,050700075,,,,13,12,25
,2013,050700088,,,,13,11,24
,2013,050700089,,,,8,10,18
,2013,050700090,,,,13,7,20
,2013,050700092,,,,16,17,33
,2013,050700095,,,,4,2,6
,2013,050700097,,,,5,7,12
,2013,050700098,,,,3,2,5
,2013,050700099,,,,3,2,5
,2013,050700100,,,,3,4,7
,2013,050700101,,,,15,19,34
,2013,050700102,,,,5,5,10
,2013,050700103,,,,6,3,9
,2013,050700104,,,,8,13,21
,2013,050700105,,,,4,5,9
,2013,050700106,,,,12,11,23
,2013,050700109,,,,79,73,152
,2013,050800001,,,,171,165,336
,2013,050800002,,,,222,163,385
,2013,050800003,,,,71,95,166
,2013,050800004,,,,50,45,95
,2013,050800005,,,,60,57,117
,2013,050800006,,,,28,24,52
,2013,050800007,,,,107,120,227
,2013,050800008,,,,231,196,427
,2013,050800009,,,,178,184,362
,2013,050800010,,,,429,391,820
,2013,050800011,,,,46,57,103
,2013,050800012,,,,18,17,35
,2013,050800014,,,,43,44,87
,2013,050800015,,,,10,22,32
,2013,050800016,,,,414,413,827
,2013,050800017,,,,239,193,432
,2013,050800018,,,,504,544,1048
,2013,050800020,,,,124,111,235
,2013,050800021,,,,14,18,32
,2013,050800022,,,,109,156,265
,2013,050800023,,,,17,11,28
,2013,050800024,,,,26,23,49
,2013,050800025,,,,10,10,20
,2013,050800026,,,,7,4,11
,2013,050800027,,,,18,22,40
,2013,050800028,,,,12,14,26
,2013,050800029,,,,18,25,43
,2013,050800030,,,,14,19,33
,2013,050800032,,,,27,28,55
,2013,050800033,,,,3,6,9
,2013,050800035,,,,13,12,25
,2013,050800036,,,,24,28,52
,2013,050800037,,,,6,9,15
,2013,050800038,,,,5,11,16
,2013,050800040,,,,4,12,16
,2013,050800043,,,,9,6,15
,2013,050800043,,,,3,11,14
,2013,050800043,,,,11,9,20
,2013,050800050,,,,6,5,11
,2013,050800051,,,,1,12,13
,2013,050800053,,,,2,4,6
,2013,050800054,,,,24,38,62
,2013,050800055,,,,13,14,27
,2013,050900001,,,,316,344,660
,2013,050900002,,,,58,67,125
,2013,050900003,,,,381,389,770
,2013,050900003,,,,39,42,81
,2013,050900004,,,,314,308,622
,2013,050900005,,,,160,156,316
,2013,050900005,,,,22,14,36
,2013,050900006,,,,36,23,59
,2013,050900006,,,,4,4,8
,2013,050900007,,,,89,78,167
,2013,050900008,,,,135,102,237
,2013,050900009,,,,19,16,35
,2013,050900009,,,,392,403,795
,2013,050900010,,,,28,20,48
,2013,050900011,,,,324,280,604
,2013,050900012,,,,17,12,29
,2013,050900012,,,,146,161,307
,2013,050900013,,,,4,13,17
,2013,050900013,,,,82,62,144
,2013,050900013,,,,90,71,161
,2013,050900014,,,,38,37,75
,2013,050900014,,,,4,7,11
,2013,050900015,,,,86,96,182
,2013,050900016,,,,173,151,324
,2013,050900017,,,,77,70,147
,2013,050900020,,,,26,18,44
,2013,050900020,,,,9,3,12
,2013,050900021,,,,36,30,66
,2013,050900022,,,,29,23,52
,2013,050900023,,,,255,233,488
,2013,050900024,,,,332,367,699
,2013,050900025,,,,154,138,292
,2013,050900026,,,,13,12,25
,2013,050900027,,,,36,34,70
,2013,050900029,,,,16,12,28
,2013,050900030,,,,7,16,23
,2013,050900031,,,,9,8,17
,2013,050900032,,,,12,17,29
,2013,050900033,,,,36,34,70
,2013,050900035,,,,13,11,24
,2013,050900036,,,,3,0,3
,2013,050900036,,,,27,25,52
,2013,050900038,,,,36,44,80
,2013,050900039,,,,9,16,25
,2013,050900040,,,,1,1,2
,2013,050900040,,,,12,13,25
,2013,050900041,,,,46,51,97
,2013,050900041,,,,63,73,136
,2013,050900041,,,,6,7,13
,2013,050900043,,,,19,15,34
,2013,050900043,,,,3,6,9
,2013,050900045,,,,7,4,11
,2013,050900045,,,,14,14,28
,2013,050900045,,,,52,49,101
,2013,050900046,,,,9,11,20
,2013,050900049,,,,13,14,27
,2013,050900053,,,,57,56,113
,2013,050900053,,,,11,12,23
,2013,050900053,,,,22,25,47
,2013,050900056,,,,317,270,587
,2013,050900058,,,,2,8,10
,2013,050900058,,,,17,20,37
,2013,050900058,,,,15,22,37
,2013,050900060,,,,7,10,17
,2013,050900062,,,,149,120,269
,2013,050900063,,,,1,2,3
,2013,050900063,,,,11,14,25
,2013,050900063,,,,5,5,10
,2013,050900064,,,,123,88,211
,2013,050900064,,,,10,9,19
,2013,050900065,,,,12,9,21
,2013,050900065,,,,93,104,197
,2013,050900065,,,,15,16,31
,2013,050900066,,,,13,5,18
,2013,050900068,,,,15,11,26
,2013,050900069,,,,2,4,6
,2013,050900070,,,,3,5,8
,2013,050900071,,,,3,10,13
,2013,050900072,,,,3,4,7
,2013,050900073,,,,6,3,9
,2013,050900074,,,,2,1,3
,2013,050900075,,,,8,6,14
,2013,050900076,,,,5,14,19
,2013,050900077,,,,8,18,26
,2013,050900077,,,,54,51,105
,2013,050900078,,,,4,9,13
,2013,050900078,,,,9,3,12
,2013,050900078,,,,20,23,43
,2013,050900079,,,,29,24,53
,2013,050900080,,,,26,24,50
,2013,050900081,,,,9,11,20
,2013,050900083,,,,11,7,18
,2013,050900084,,,,6,2,8
,2013,050900085,,,,5,2,7
,2013,050900086,,,,4,4,8
,2013,050900087,,,,8,9,17
,2013,050900088,,,,5,3,8
,2013,050900091,,,,108,144,252
,2013,051000001,,,,65,59,124
,2013,051000002,,,,26,16,42
,2013,051000002,,,,4,6,10
,2013,051000003,,,,169,152,321
,2013,051000004,,,,17,17,34
,2013,051000005,,,,48,34,82
,2013,051000005,,,,10,11,21
,2013,051000006,,,,13,15,28
,2013,051000007,,,,505,509,1014
,2013,051000008,,,,40,61,101
,2013,051000009,,,,59,41,100
,2013,051000011,,,,36,43,79
,2013,051000012,,,,161,134,295
,2013,051000013,,,,136,112,248
,2013,051000014,,,,17,20,37
,2013,051000015,,,,7,15,22
,2013,051000016,,,,146,117,263
,2013,051000017,,,,119,109,228
,2013,051000017,,,,14,23,37
,2013,051000018,,,,6,9,15
,2013,051000018,,,,52,60,112
,2013,051000019,,,,102,68,170
,2013,051000020,,,,109,96,205
,2013,051000021,,,,36,39,75
,2013,051000022,,,,143,137,280
,2013,051000023,,,,85,85,170
,2013,051000024,,,,138,107,245
,2013,051000025,,,,62,46,108
,2013,051000026,,,,32,35,67
,2013,051000027,,,,110,129,239
,2013,051000028,,,,72,65,137
,2013,051000029,,,,91,98,189
,2013,051000030,,,,73,64,137
,2013,051000031,,,,59,53,112
,2013,051000032,,,,97,85,182
,2013,051000033,,,,19,19,38
,2013,051000034,,,,26,38,64
,2013,051000035,,,,36,33,69
,2013,051000037,,,,136,144,280
,2013,051000038,,,,177,184,361
,2013,051000039,,,,73,80,153
,2013,051000041,,,,36,37,73
,2013,051000041,,,,112,132,244
,2013,051000042,,,,146,132,278
,2013,051000043,,,,93,74,167
,2013,051000044,,,,17,16,33
,2013,051000045,,,,36,34,70
,2013,051000046,,,,148,162,310
,2013,051000047,,,,219,237,456
,2013,051000047,,,,36,22,58
,2013,051000048,,,,90,80,170
,2013,051000049,,,,45,56,101
,2013,051000050,,,,74,52,126
,2013,051000051,,,,87,84,171
,2013,051000052,,,,98,93,191
,2013,051000054,,,,57,53,110
,2013,051000055,,,,30,18,48
,2013,051000056,,,,17,17,34
,2013,051000057,,,,39,35,74
,2013,051000058,,,,27,24,51
,2013,051000059,,,,50,37,87
,2013,051000060,,,,16,5,21
,2013,051000061,,,,24,18,42
,2013,051000062,,,,111,104,215
,2013,051000063,,,,29,21,50
,2013,051000065,,,,55,61,116
,2013,051000066,,,,26,22,48
,2013,051000067,,,,69,44,113
,2013,051000068,,,,239,215,454
,2013,051000069,,,,12,11,23
,2013,051000070,,,,55,50,105
,2013,051000072,,,,16,14,30
,2013,051000073,,,,22,25,47
,2013,051000074,,,,35,28,63
,2013,051000075,,,,31,26,57
,2013,051000076,,,,35,33,68
,2013,051000076,,,,10,7,17
,2013,051000077,,,,21,23,44
,2013,051000078,,,,55,66,121
,2013,051000078,,,,11,9,20
,2013,051000079,,,,39,51,90
,2013,051000080,,,,13,7,20
,2013,051000081,,,,9,11,20
,2013,051000082,,,,125,133,258
,2013,051000083,,,,21,22,43
,2013,051000084,,,,5,4,9
,2013,051000087,,,,103,85,188
,2013,051000088,,,,16,21,37
,2013,051000088,,,,4,4,8
,2013,051000091,,,,30,23,53
,2013,051000092,,,,34,39,73
,2013,051000094,,,,11,11,22
,2013,051000095,,,,29,42,71
,2013,051000096,,,,15,19,34
,2013,051000097,,,,14,19,33
,2013,051000098,,,,18,7,25
,2013,051000099,,,,19,13,32
,2013,051000100,,,,36,44,80
,2013,051000101,,,,9,14,23
,2013,051000102,,,,14,18,32
,2013,051000103,,,,15,9,24
,2013,051000104,,,,7,8,15
,2013,051000105,,,,13,8,21
,2013,051000106,,,,70,82,152
,2013,051000107,,,,9,16,25
,2013,051000108,,,,14,11,25
,2013,051000109,,,,11,8,19
,2013,051000110,,,,20,24,44
,2013,051000111,,,,6,11,17
,2013,051000111,,,,32,40,72
,2013,051000113,,,,13,11,24
,2013,051000114,,,,19,15,34
,2013,051000115,,,,25,33,58
,2013,051000116,,,,130,106,236
,2013,051000117,,,,669,380,1049
,2013,051000119,,,,196,242,438
,2013,051000120,,,,342,543,885
,2013,051000120,,,,75,193,268
,2013,051000121,,,,46,74,120
,2013,051000121,,,,131,214,345
,2013,051000122,,,,126,137,263
,2013,051000123,,,,220,247,467
,2013,051000126,,,,15,27,42
,2013,051000128,,,,6,9,15
,2013,051000129,,,,10,5,15
,2013,051000130,,,,14,6,20
,2013,051000131,,,,3,6,9
,2013,051000132,,,,13,17,30
,2013,051000133,,,,6,7,13
,2013,051000134,,,,7,8,15
,2013,051000135,,,,12,18,30
,2013,051000136,,,,11,19,30
,2013,051000137,,,,9,12,21
,2013,051000138,,,,6,5,11
,2013,051000139,,,,34,32,66
,2013,051000141,,,,28,28,56
,2013,051000142,,,,7,18,25
,2013,051000143,,,,6,3,9
,2013,051000144,,,,8,8,16
,2013,051000145,,,,10,15,25
,2013,051000149,,,,7,17,24
,2013,051000152,,,,18,13,31
,2013,051000153,,,,11,16,27
,2013,051000154,,,,17,19,36
,2013,051000156,,,,11,21,32
,2013,051000158,,,,45,52,97
,2013,051000159,,,,35,36,71
,2013,051000160,,,,19,18,37
,2013,051000161,,,,120,125,245
,2013,051000162,,,,267,346,613
,2013,051000163,,,,34,45,79
,2013,051000167,,,,11,14,25
,2013,051000168,,,,7,7,14
,2013,051000168,,,,32,39,71
,2013,051000169,,,,3,4,7
,2013,051000170,,,,79,82,161
,2013,051000172,,,,4,5,9
,2013,051000173,,,,12,7,19
,2013,051000174,,,,6,4,10
,2013,051000177,,,,19,14,33
,2013,051000177,,,,51,46,97
,2013,051000177,,,,8,12,20
,2013,051000180,,,,6,7,13
,2013,051000181,,,,23,52,75
,2013,051000181,,,,7,11,18
,2013,051000182,,,,24,29,53
,2013,051000182,,,,29,20,49
,2013,051000182,,,,78,67,145
,2013,051000183,,,,9,12,21
,2013,051000184,,,,10,3,13
,2013,051000186,,,,4,10,14
,2013,051000187,,,,3,2,5
,2013,051000188,,,,4,6,10
,2013,051000190,,,,18,10,28
,2013,051000205,,,,49,58,107
,2013,051000206,,,,27,22,49
,2013,051000206,,,,7,11,18
,2013,051000207,,,,14,14,28
,2013,051000208,,,,107,124,231
,2013,051000208,,,,18,17,35
,2013,051000208,,,,45,44,89
,2013,051000209,,,,21,20,41
,2013,051000210,,,,14,10,24
,2013,051000211,,,,7,8,15
,2013,051000212,,,,5,6,11
,2013,051000213,,,,6,5,11
,2013,051000214,,,,5,3,8
,2013,051000215,,,,6,5,11
,2013,051000216,,,,6,10,16
,2013,051000232,,,,15,17,32
,2013,051000234,,,,5,11,16
,2013,051000235,,,,12,7,19
,2013,051000236,,,,29,29,58
,2013,051000236,,,,9,9,18
,2013,051000237,,,,5,8,13
,2013,051000241,,,,11,3,14
,2013,051000244,,,,4,7,11
,2013,051000246,,,,8,4,12
,2013,051000247,,,,4,3,7
,2013,051000248,,,,4,2,6
,2013,051000250,,,,8,3,11
,2013,051000251,,,,5,1,6
,2013,051000252,,,,11,6,17
,2013,051000253,,,,2,3,5
,2013,051000254,,,,2,6,8
,2013,051000256,,,,3,2,5
,2013,051000257,,,,5,1,6
,2013,051000258,,,,8,6,14
,2013,051000259,,,,10,11,21
,2013,051000260,,,,4,3,7
,2013,051000261,,,,2,6,8
,2013,051000266,,,,3,8,11
,2013,051000266,,,,19,18,37
,2013,051000268,,,,10,10,20
,2013,051000269,,,,5,3,8
,2013,051000270,,,,3,2,5
,2013,051000272,,,,30,24,54
,2013,051000273,,,,2,10,12
,2013,051000274,,,,9,11,20
,2013,051000276,,,,29,52,81
,2013,051000277,,,,32,35,67
,2013,051000277,,,,39,62,101
,2013,051000278,,,,33,46,79
,2013,051000279,,,,12,18,30
,2013,051000280,,,,16,22,38
,2013,051000281,,,,2,6,8
,2013,051000282,,,,3,1,4
,2013,051000282,,,,14,11,25
,2013,051000283,,,,74,113,187
,2013,051000284,,,,7,6,13
,2013,051000285,,,,9,3,12
,2013,051000286,,,,16,17,33
,2013,051100001,,,,42,62,104
,2013,051100002,,,,34,24,58
,2013,051100003,,,,367,340,707
,2013,051100004,,,,58,66,124
,2013,051100004,,,,407,381,788
,2013,051100005,,,,163,148,311
,2013,051100006,,,,316,329,645
,2013,051100007,,,,31,32,63
,2013,051100008,,,,149,150,299
,2013,051100009,,,,14,14,28
,2013,051100011,,,,40,30,70
,2013,051100012,,,,53,57,110
,2013,051100013,,,,17,13,30
,2013,051100014,,,,176,178,354
,2013,051100015,,,,29,25,54
,2013,051100016,,,,108,103,211
,2013,051100017,,,,438,410,848
,2013,051100018,,,,275,283,558
,2013,051100019,,,,478,469,947
,2013,051100020,,,,544,511,1055
,2013,051100021,,,,159,124,283
,2013,051100022,,,,85,68,153
,2013,051100023,,,,356,331,687
,2013,051100024,,,,258,244,502
,2013,051100025,,,,26,15,41
,2013,051100026,,,,45,32,77
,2013,051100026,,,,44,45,89
,2013,051100026,,,,9,8,17
,2013,051100027,,,,26,37,63
,2013,051100028,,,,55,44,99
,2013,051100029,,,,95,68,163
,2013,051100029,,,,9,15,24
,2013,051100030,,,,34,37,71
,2013,051100031,,,,38,38,76
,2013,051100032,,,,15,15,30
,2013,051100032,,,,71,78,149
,2013,051100034,,,,327,294,621
,2013,051100035,,,,44,47,91
,2013,051100036,,,,60,45,105
,2013,051100037,,,,104,105,209
,2013,051100038,,,,110,105,215
,2013,051100039,,,,547,576,1123
,2013,051100039,,,,52,45,97
,2013,051100040,,,,22,28,50
,2013,051100041,,,,13,13,26
,2013,051100041,,,,14,9,23
,2013,051100041,,,,60,66,126
,2013,051100042,,,,65,90,155
,2013,051100043,,,,96,116,212
,2013,051100044,,,,37,30,67
,2013,051100044,,,,5,2,7
,2013,051100044,,,,13,23,36
,2013,051100045,,,,682,621,1303
,2013,051100045,,,,189,270,459
,2013,051100046,,,,203,208,411
,2013,051100048,,,,16,15,31
,2013,051100048,,,,27,19,46
,2013,051100048,,,,4,4,8
,2013,051100051,,,,14,18,32
,2013,051100052,,,,11,18,29
,2013,051100052,,,,43,28,71
,2013,051100052,,,,9,7,16
,2013,051100053,,,,19,11,30
,2013,051100054,,,,19,12,31
,2013,051100055,,,,20,14,34
,2013,051100056,,,,9,9,18
,2013,051100057,,,,77,68,145
,2013,051100058,,,,42,40,82
,2013,051100059,,,,41,54,95
,2013,051100060,,,,103,105,208
,2013,051100061,,,,7,10,17
,2013,051100062,,,,150,157,307
,2013,051100064,,,,13,11,24
,2013,051100068,,,,9,11,20
,2013,051100068,,,,42,36,78
,2013,051100069,,,,54,42,96
,2013,051100069,,,,12,31,43
,2013,051100069,,,,10,9,19
,2013,051100071,,,,24,23,47
,2013,051100072,,,,12,19,31
,2013,051100073,,,,23,24,47
,2013,051100074,,,,83,77,160
,2013,051100077,,,,10,5,15
,2013,051100077,,,,41,46,87
,2013,051100077,,,,14,6,20
,2013,051100079,,,,11,11,22
,2013,051100079,,,,44,55,99
,2013,051100079,,,,11,11,22
,2013,051100080,,,,20,14,34
,2013,051100081,,,,18,16,34
,2013,051100082,,,,40,33,73
,2013,051100084,,,,14,13,27
,2013,051100085,,,,15,15,30
,2013,051100086,,,,182,191,373
,2013,051100087,,,,22,23,45
,2013,051100088,,,,16,9,25
,2013,051100089,,,,6,5,11
,2013,051100090,,,,3,1,4
,2013,051100091,,,,29,26,55
,2013,051100093,,,,15,10,25
,2013,051100094,,,,16,17,33
,2013,051100094,,,,156,153,309
,2013,051100095,,,,47,48,95
,2013,051100097,,,,49,57,106
,2013,051100097,,,,10,11,21
,2013,051100097,,,,52,47,99
,2013,051100099,,,,155,160,315
,2013,051100099,,,,10,18,28
,2013,051100100,,,,26,18,44
,2013,051100100,,,,133,121,254
,2013,051100101,,,,51,51,102
,2013,051100102,,,,15,12,27
,2013,051100103,,,,35,28,63
,2013,051100106,,,,27,33,60
,2013,051100108,,,,10,16,26
,2013,051100109,,,,15,26,41
,2013,051100110,,,,17,23,40
,2013,051100111,,,,16,14,30
,2013,051100113,,,,7,10,17
,2013,051100113,,,,46,42,88
,2013,051100115,,,,173,177,350
,2013,051100116,,,,14,16,30
,2013,051100117,,,,48,31,79
,2013,051100120,,,,75,67,142
,2013,051100120,,,,25,22,47
,2013,051100120,,,,4,1,5
,2013,051100121,,,,317,298,615
,2013,051100124,,,,19,18,37
,2013,051100125,,,,8,5,13
,2013,051100125,,,,55,53,108
,2013,051100125,,,,147,211,358
,2013,051100126,,,,34,54,88
,2013,051100127,,,,23,26,49
,2013,051100127,,,,30,34,64
,2013,051100127,,,,5,4,9
,2013,051100127,,,,30,34,64
,2013,051100128,,,,5,6,11
,2013,051100128,,,,59,47,106
,2013,051100128,,,,17,10,27
,2013,051100130,,,,26,19,45
,2013,051100130,,,,61,59,120
,2013,051100130,,,,22,19,41
,2013,051100132,,,,1460,1583,3043
,2013,051100132,,,,844,1386,2230
,2013,051100133,,,,14,18,32
,2013,051100134,,,,191,160,351
,2013,051100135,,,,7,7,14
,2013,051100137,,,,1,6,7
,2013,051100138,,,,11,3,14
,2013,051100139,,,,22,21,43
,2013,051100141,,,,10,6,16
,2013,051100141,,,,22,28,50
,2013,051100143,,,,28,30,58
,2013,051100143,,,,11,15,26
,2013,051100143,,,,8,9,17
,2013,051100144,,,,20,22,42
,2013,051100144,,,,9,10,19
,2013,051100144,,,,137,127,264
,2013,051100145,,,,107,95,202
,2013,051100146,,,,41,38,79
,2013,051100147,,,,10,7,17
,2013,051100148,,,,1,7,8
,2013,051100149,,,,37,23,60
,2013,051100152,,,,18,14,32
,2013,051100152,,,,10,11,21
,2013,051100153,,,,78,57,135
,2013,051100153,,,,11,13,24
,2013,051100154,,,,13,17,30
,2013,051100155,,,,175,170,345
,2013,051100156,,,,10,13,23
,2013,051100156,,,,50,47,97
,2013,051100158,,,,10,10,20
,2013,051100158,,,,46,68,114
,2013,051100158,,,,145,220,365
,2013,051100159,,,,44,33,77
,2013,051100160,,,,141,141,282
,2013,051100162,,,,21,19,40
,2013,051100163,,,,75,82,157
,2013,051100164,,,,83,118,201
,2013,051100164,,,,39,44,83
,2013,051100166,,,,17,25,42
,2013,051100170,,,,3,2,5
,2013,051100172,,,,6,8,14
,2013,051100173,,,,8,3,11
,2013,051100174,,,,14,7,21
,2013,051100175,,,,27,17,44
,2013,051100177,,,,6,4,10
,2013,051100178,,,,6,7,13
,2013,051100179,,,,11,9,20
,2013,051100180,,,,20,43,63
,2013,051100209,,,,8,8,16
,2013,051100209,,,,27,28,55
,2013,051100211,,,,7,5,12
,2013,051100211,,,,55,56,111
,2013,051100212,,,,2,4,6
,2013,051100214,,,,23,22,45
,2013,051100214,,,,223,229,452
,2013,051100215,,,,18,24,42
,2013,051100215,,,,5,3,8
,2013,051100216,,,,6,9,15
,2013,051100216,,,,18,18,36
,2013,051100216,,,,4,6,10
,2013,051100217,,,,66,35,101
,2013,051100218,,,,75,84,159
,2013,051100218,,,,33,11,44
,2013,051100219,,,,7,5,12
,2013,051100219,,,,22,12,34
,2013,051100219,,,,14,21,35
,2013,051100219,,,,3,3,6
,2013,051100220,,,,10,15,25
,2013,051100220,,,,65,61,126
,2013,051100222,,,,161,163,324
,2013,051100223,,,,17,6,23
,2013,051100224,,,,6,3,9
,2013,051100224,,,,45,30,75
,2013,051100224,,,,54,76,130
,2013,051100225,,,,32,35,67
,2013,051100226,,,,25,19,44
,2013,051100228,,,,29,26,55
,2013,051100230,,,,65,99,164
,2013,051100239,,,,112,100,212
,2013,051100240,,,,3,3,6
,2013,051100242,,,,16,19,35
,2013,051100242,,,,2,4,6
,2013,051100242,,,,34,15,49
,2013,051100243,,,,7,9,16
,2013,051100246,,,,161,154,315
,2013,051100247,,,,58,42,100
,2013,051100248,,,,127,155,282
,2013,051100248,,,,71,65,136
,2013,051100248,,,,39,50,89
,2013,051100249,,,,22,20,42
,2013,051100249,,,,48,46,94
,2013,051100250,,,,29,24,53
,2013,051100253,,,,13,17,30
,2013,051100254,,,,10,8,18
,2013,051100254,,,,74,75,149
,2013,051100259,,,,4,7,11
,2013,051100260,,,,9,7,16
,2013,051100261,,,,5,5,10
,2013,051100262,,,,2,5,7
,2013,051100264,,,,4,4,8
,2013,051100266,,,,310,266,576
,2013,051100268,,,,31,26,57
,2013,051100268,,,,38,38,76
,2013,051100268,,,,9,12,21
,2013,051100270,,,,29,23,52
,2013,051100270,,,,10,14,24
,2013,051100272,,,,19,14,33
,2013,051100272,,,,9,15,24
,2013,051100272,,,,9,15,24
,2013,051100273,,,,1,5,6
,2013,051100273,,,,5,6,11
,2013,051100275,,,,7,7,14
,2013,051100275,,,,31,37,68
,2013,051100275,,,,32,28,60
,2013,051100276,,,,608,881,1489
,2013,051100278,,,,11,7,18
,2013,051100280,,,,20,31,51
,2013,051100281,,,,1,5,6
,2013,051100281,,,,48,39,87
,2013,051100281,,,,12,7,19
,2013,051100282,,,,6,12,18
,2013,051100284,,,,16,15,31
,2013,051100286,,,,15,14,29
,2013,051100287,,,,3,8,11
,2013,051100288,,,,8,1,9
,2013,051100289,,,,4,2,6
,2013,051100290,,,,21,14,35
,2013,051100292,,,,34,39,73
,2013,051100292,,,,1,1,2
,2013,051100293,,,,25,36,61
,2013,051100293,,,,14,18,32
,2013,051100294,,,,12,8,20
,2013,051100295,,,,10,10,20
,2013,051100297,,,,99,133,232
,2013,051100298,,,,29,29,58
,2013,051100299,,,,11,7,18
,2013,051100300,,,,2,2,4
,2013,051100301,,,,1,3,4
,2013,051100301,,,,18,11,29
,2013,051100301,,,,8,6,14
,2013,051100302,,,,15,5,20
,2013,051100302,,,,25,32,57
,2013,051100302,,,,44,35,79
,2013,051100303,,,,34,30,64
,2013,051100304,,,,186,219,405
,2013,051100305,,,,20,18,38
,2013,051100306,,,,11,11,22
,2013,051100307,,,,18,22,40
,2013,051100307,,,,27,23,50
,2013,051100307,,,,8,8,16
,2013,051100308,,,,15,14,29
,2013,051100308,,,,1,3,4
,2013,051100309,,,,2,1,3
,2013,051100309,,,,12,10,22
,2013,051100310,,,,45,50,95
,2013,051100325,,,,13,4,17
,2013,051100326,,,,4,4,8
,2013,051100326,,,,2,4,6
,2013,051100326,,,,8,1,9
,2013,051100327,,,,6,1,7
,2013,051100327,,,,5,5,10
,2013,051200001,,,,360,283,643
,2013,051200004,,,,27,20,47
,2013,051200006,,,,12,8,20
,2013,051200007,,,,127,130,257
,2013,051200008,,,,66,73,139
,2013,051200009,,,,21,15,36
,2013,051200009,,,,313,357,670
,2013,051200009,,,,13,7,20
,2013,051200010,,,,64,50,114
,2013,051200010,,,,6,2,8
,2013,051200011,,,,33,29,62
,2013,051200011,,,,275,266,541
,2013,051200020,,,,53,60,113
,2013,051200021,,,,3,3,6
,2013,051200022,,,,36,20,56
,2013,051200023,,,,146,137,283
,2013,051200023,,,,4,6,10
,2013,051200024,,,,430,466,896
,2013,051200024,,,,10,15,25
,2013,051200025,,,,394,317,711
,2013,051200026,,,,102,105,207
,2013,051200027,,,,47,41,88
,2013,051200027,,,,8,9,17
,2013,051200028,,,,75,61,136
,2013,051200029,,,,118,106,224
,2013,051200030,,,,44,27,71
,2013,051200031,,,,11,9,20
,2013,051200031,,,,63,71,134
,2013,051200032,,,,66,68,134
,2013,051200032,,,,17,20,37
,2013,051200033,,,,25,15,40
,2013,051200034,,,,23,26,49
,2013,051200034,,,,3,4,7
,2013,051200038,,,,4,4,8
,2013,051200038,,,,37,24,61
,2013,051200039,,,,54,52,106
,2013,051200039,,,,37,47,84
,2013,051200039,,,,4,17,21
,2013,051200040,,,,5,4,9
,2013,051200041,,,,59,53,112
,2013,051200042,,,,13,19,32
,2013,051200042,,,,137,136,273
,2013,051200043,,,,24,14,38
,2013,051200044,,,,124,124,248
,2013,051200047,,,,121,160,281
,2013,051200047,,,,8,7,15
,2013,051200048,,,,228,288,516
,2013,051200049,,,,1524,1853,3377
,2013,051200050,,,,198,122,320
,2013,051200051,,,,36,43,79
,2013,051200051,,,,24,17,41
,2013,051200054,,,,6,3,9
,2013,051200054,,,,39,32,71
,2013,051200060,,,,5,2,7
,2013,051200061,,,,15,4,19
,2013,051200062,,,,13,17,30
,2013,051200063,,,,13,18,31
,2013,051200069,,,,7,2,9
,2013,051200070,,,,7,1,8
,2013,051200070,,,,15,6,21
,2013,051200073,,,,4,5,9
,2013,051200074,,,,9,7,16
,2013,051200074,,,,22,15,37
,2013,051200077,,,,11,6,17
,2013,051200078,,,,25,15,40
,2013,051200079,,,,2,7,9
,2013,051200080,,,,14,19,33
,2013,051200082,,,,10,10,20
,2013,051200086,,,,531,578,1109
,2013,051200087,,,,6,7,13
,2013,051200087,,,,22,13,35
,2013,051200088,,,,6,6,12
,2013,051200088,,,,47,32,79
,2013,051200088,,,,7,9,16
,2013,051200089,,,,203,163,366
,2013,051200091,,,,21,13,34
,2013,051200091,,,,20,17,37
,2013,051200091,,,,53,40,93
,2013,051200092,,,,42,37,79
,2013,051200093,,,,150,128,278
,2013,051200093,,,,17,10,27
,2013,051200093,,,,12,18,30
,2013,051200094,,,,37,37,74
,2013,051200096,,,,37,29,66
,2013,051200096,,,,23,22,45
,2013,051200096,,,,53,54,107
,2013,051200097,,,,57,46,103
,2013,051200097,,,,69,91,160
,2013,051200097,,,,26,28,54
,2013,051200098,,,,52,46,98
,2013,051200098,,,,14,17,31
,2013,051200098,,,,7,18,25
,2013,051200100,,,,22,13,35
,2013,051200101,,,,10,12,22
,2013,051200101,,,,86,81,167
,2013,051200102,,,,21,19,40
,2013,051200103,,,,7,8,15
,2013,051200108,,,,53,45,98
,2013,051200108,,,,442,405,847
,2013,051200112,,,,8,9,17
,2013,051200112,,,,167,134,301
,2013,051200113,,,,13,13,26
,2013,051200115,,,,17,12,29
,2013,051200116,,,,5,2,7
,2013,051200117,,,,6,8,14
,2013,051200118,,,,10,11,21
,2013,051200119,,,,10,7,17
,2013,051200128,,,,4,20,24
,2013,051200136,,,,44,58,102
,2013,051200137,,,,19,15,34
,2013,051200139,,,,9,14,23
,2013,051200139,,,,114,112,226
,2013,051200141,,,,17,16,33
,2013,051200141,,,,23,41,64
,2013,051200141,,,,17,16,33
,2013,051200141,,,,80,89,169
,2013,051200147,,,,178,139,317
,2013,051200148,,,,9,10,19
,2013,051200149,,,,4,4,8
,2013,051200150,,,,11,4,15
,2013,051200150,,,,37,34,71
,2013,051200151,,,,6,5,11
,2013,051200153,,,,7,3,10
,2013,051200154,,,,2,8,10
,2013,051200155,,,,13,19,32
,2013,051200155,,,,23,18,41
,2013,051200157,,,,7,6,13
,2013,051200158,,,,24,26,50
,2013,051200158,,,,28,22,50
,2013,051200159,,,,26,6,32
,2013,051200160,,,,14,10,24
,2013,051200162,,,,14,17,31
,2013,051200164,,,,6,5,11
,2013,051200164,,,,4,7,11
,2013,051200165,,,,4,5,9
,2013,051200166,,,,2,2,4
,2013,051200166,,,,1,2,3
,2013,060100001,,,,18,18,36
,2013,060100002,,,,84,84,168
,2013,060100004,,,,45,40,85
,2013,060100005,,,,192,152,344
,2013,060100006,,,,138,93,231
,2013,060100007,,,,39,38,77
,2013,060100009,,,,16,23,39
,2013,060100010,,,,194,167,361
,2013,060100011,,,,37,28,65
,2013,060100012,,,,27,30,57
,2013,060100013,,,,10,17,27
,2013,060100014,,,,19,21,40
,2013,060100015,,,,25,16,41
,2013,060100016,,,,31,37,68
,2013,060100017,,,,53,51,104
,2013,060100018,,,,45,35,80
,2013,060100019,,,,16,24,40
,2013,060100020,,,,29,34,63
,2013,060100020,,,,7,3,10
,2013,060100021,,,,45,49,94
,2013,060100022,,,,17,25,42
,2013,060100023,,,,6,7,13
,2013,060100024,,,,31,32,63
,2013,060100025,,,,14,17,31
,2013,060100025,,,,8,7,15
,2013,060100026,,,,108,101,209
,2013,060100027,,,,170,146,316
,2013,060100028,,,,353,338,691
,2013,060100029,,,,108,103,211
,2013,060100030,,,,10,21,31
,2013,060100031,,,,117,112,229
,2013,060100032,,,,11,9,20
,2013,060100033,,,,24,21,45
,2013,060100034,,,,17,13,30
,2013,060100035,,,,33,23,56
,2013,060100036,,,,18,21,39
,2013,060100037,,,,93,93,186
,2013,060100038,,,,92,84,176
,2013,060100038,,,,15,15,30
,2013,060100039,,,,28,21,49
,2013,060100040,,,,11,10,21
,2013,060100041,,,,203,175,378
,2013,060100043,,,,6,9,15
,2013,060100044,,,,18,16,34
,2013,060100045,,,,90,72,162
,2013,060100046,,,,18,21,39
,2013,060100047,,,,25,18,43
,2013,060100048,,,,23,19,42
,2013,060100049,,,,19,28,47
,2013,060100050,,,,30,22,52
,2013,060100051,,,,64,67,131
,2013,060100052,,,,76,74,150
,2013,060100053,,,,7,4,11
,2013,060100054,,,,9,4,13
,2013,060100055,,,,10,8,18
,2013,060100056,,,,84,46,130
,2013,060100057,,,,24,24,48
,2013,060100058,,,,434,406,840
,2013,060100059,,,,9,14,23
,2013,060100060,,,,171,157,328
,2013,060100061,,,,21,23,44
,2013,060100062,,,,11,11,22
,2013,060100063,,,,66,38,104
,2013,060100064,,,,74,48,122
,2013,060100065,,,,39,41,80
,2013,060100066,,,,11,15,26
,2013,060100067,,,,63,53,116
,2013,060100068,,,,13,25,38
,2013,060100068,,,,4,4,8
,2013,060100069,,,,5,6,11
,2013,060100070,,,,22,30,52
,2013,060100071,,,,393,305,698
,2013,060100072,,,,183,142,325
,2013,060100073,,,,110,106,216
,2013,060100074,,,,59,48,107
,2013,060100075,,,,36,26,62
,2013,060100076,,,,120,102,222
,2013,060100077,,,,37,34,71
,2013,060100078,,,,42,52,94
,2013,060100079,,,,9,14,23
,2013,060100080,,,,40,41,81
,2013,060100081,,,,44,26,70
,2013,060100083,,,,98,75,173
,2013,060100084,,,,26,30,56
,2013,060100085,,,,16,15,31
,2013,060100086,,,,13,16,29
,2013,060100087,,,,31,39,70
,2013,060100088,,,,24,21,45
,2013,060100089,,,,274,254,528
,2013,060100090,,,,29,24,53
,2013,060100091,,,,100,92,192
,2013,060100092,,,,28,26,54
,2013,060100093,,,,237,234,471
,2013,060100094,,,,24,16,40
,2013,060100095,,,,8,14,22
,2013,060100096,,,,16,21,37
,2013,060100097,,,,29,28,57
,2013,060100098,,,,61,57,118
,2013,060100099,,,,29,31,60
,2013,060100101,,,,9,19,28
,2013,060100102,,,,24,34,58
,2013,060100103,,,,124,114,238
,2013,060100104,,,,44,46,90
,2013,060100105,,,,312,313,625
,2013,060100106,,,,32,31,63
,2013,060100107,,,,157,153,310
,2013,060100107,,,,125,99,224
,2013,060100107,,,,17,11,28
,2013,060100109,,,,214,216,430
,2013,060100110,,,,69,71,140
,2013,060100111,,,,10,18,28
,2013,060100112,,,,88,79,167
,2013,060100113,,,,128,101,229
,2013,060100114,,,,169,158,327
,2013,060100115,,,,159,155,314
,2013,060100116,,,,13,15,28
,2013,060100117,,,,47,38,85
,2013,060100118,,,,11,17,28
,2013,060100118,,,,9,12,21
,2013,060100118,,,,5,9,14
,2013,060100119,,,,78,89,167
,2013,060100119,,,,124,130,254
,2013,060100119,,,,32,36,68
,2013,060100122,,,,4,8,12
,2013,060100122,,,,28,19,47
,2013,060100123,,,,16,23,39
,2013,060100124,,,,12,12,24
,2013,060100125,,,,34,37,71
,2013,060100127,,,,113,117,230
,2013,060100128,,,,396,505,901
,2013,060100129,,,,210,293,503
,2013,060100129,,,,95,94,189
,2013,060100129,,,,7,8,15
,2013,060100130,,,,41,43,84
,2013,060100131,,,,20,20,40
,2013,060100132,,,,24,24,48
,2013,060100133,,,,156,125,281
,2013,060100135,,,,26,31,57
,2013,060100136,,,,89,101,190
,2013,060100137,,,,110,91,201
,2013,060100138,,,,251,224,475
,2013,060100138,,,,10,13,23
,2013,060100139,,,,569,588,1157
,2013,060100140,,,,218,187,405
,2013,060100141,,,,196,188,384
,2013,060100142,,,,104,91,195
,2013,060100143,,,,229,192,421
,2013,060100144,,,,387,396,783
,2013,060100145,,,,511,587,1098
,2013,060100146,,,,79,74,153
,2013,060100147,,,,25,20,45
,2013,060100148,,,,39,36,75
,2013,060100150,,,,7,7,14
,2013,060100152,,,,8,7,15
,2013,060100152,,,,23,19,42
,2013,060100153,,,,20,22,42
,2013,060100153,,,,11,7,18
,2013,060100155,,,,15,18,33
,2013,060100156,,,,197,199,396
,2013,060100157,,,,77,61,138
,2013,060100158,,,,34,40,74
,2013,060100158,,,,174,163,337
,2013,060100160,,,,18,13,31
,2013,060100162,,,,27,26,53
,2013,060100163,,,,21,19,40
,2013,060100164,,,,25,14,39
,2013,060100165,,,,14,19,33
,2013,060100167,,,,37,34,71
,2013,060100168,,,,21,13,34
,2013,060100169,,,,8,19,27
,2013,060100169,,,,21,24,45
,2013,060100170,,,,12,23,35
,2013,060100171,,,,9,3,12
,2013,060100171,,,,43,39,82
,2013,060100172,,,,11,13,24
,2013,060100173,,,,55,64,119
,2013,060100174,,,,13,8,21
,2013,060100175,,,,45,39,84
,2013,060100176,,,,15,15,30
,2013,060100177,,,,27,28,55
,2013,060100178,,,,60,47,107
,2013,060100179,,,,11,5,16
,2013,060100180,,,,28,24,52
,2013,060100181,,,,18,18,36
,2013,060100182,,,,11,12,23
,2013,060100183,,,,14,13,27
,2013,060100184,,,,8,2,10
,2013,060100185,,,,11,11,22
,2013,060100186,,,,9,6,15
,2013,060100187,,,,11,6,17
,2013,060100189,,,,12,11,23
,2013,060100190,,,,31,22,53
,2013,060100191,,,,44,31,75
,2013,060100192,,,,23,32,55
,2013,060100193,,,,11,12,23
,2013,060100195,,,,10,9,19
,2013,060100196,,,,330,577,907
,2013,060100196,,,,1415,2026,3441
,2013,060100197,,,,85,161,246
,2013,060100197,,,,30,24,54
,2013,060100197,,,,1,2,3
,2013,060100198,,,,558,1482,2040
,2013,060100199,,,,1459,110,1569
,2013,060100200,,,,63,92,155
,2013,060100200,,,,79,112,191
,2013,060100200,,,,34,35,69
,2013,060100202,,,,2,4,6
,2013,060100203,,,,10,7,17
,2013,060100204,,,,36,31,67
,2013,060100205,,,,21,26,47
,2013,060100207,,,,26,23,49
,2013,060100208,,,,10,11,21
,2013,060100209,,,,11,11,22
,2013,060100211,,,,9,15,24
,2013,060100213,,,,8,7,15
,2013,060100215,,,,8,4,12
,2013,060100217,,,,11,16,27
,2013,060100218,,,,56,41,97
,2013,060100219,,,,20,21,41
,2013,060100221,,,,11,11,22
,2013,060100221,,,,53,51,104
,2013,060100222,,,,31,42,73
,2013,060100223,,,,20,9,29
,2013,060100223,,,,8,5,13
,2013,060100224,,,,9,5,14
,2013,060100226,,,,9,18,27
,2013,060100227,,,,47,52,99
,2013,060100228,,,,14,18,32
,2013,060100229,,,,31,25,56
,2013,060100230,,,,193,188,381
,2013,060100230,,,,24,26,50
,2013,060100231,,,,38,35,73
,2013,060100232,,,,20,29,49
,2013,060100233,,,,11,11,22
,2013,060100234,,,,36,34,70
,2013,060100237,,,,11,9,20
,2013,060100238,,,,236,183,419
,2013,060100239,,,,10,10,20
,2013,060100240,,,,6,11,17
,2013,060100241,,,,15,8,23
,2013,060100243,,,,7,8,15
,2013,060100244,,,,10,15,25
,2013,060100245,,,,19,15,34
,2013,060100246,,,,15,10,25
,2013,060100247,,,,21,28,49
,2013,060100248,,,,29,35,64
,2013,060100249,,,,54,35,89
,2013,060100250,,,,448,427,875
,2013,060100251,,,,19,16,35
,2013,060100252,,,,5,5,10
,2013,060100253,,,,18,16,34
,2013,060100254,,,,9,13,22
,2013,060100255,,,,9,14,23
,2013,060100258,,,,20,19,39
,2013,060100258,,,,98,89,187
,2013,060100259,,,,14,19,33
,2013,060100260,,,,12,17,29
,2013,060100261,,,,8,9,17
,2013,060100263,,,,11,13,24
,2013,060100266,,,,5,14,19
,2013,060100268,,,,9,9,18
,2013,060100270,,,,43,16,59
,2013,060100271,,,,10,8,18
,2013,060100271,,,,4,9,13
,2013,060100271,,,,187,175,362
,2013,060100274,,,,6,5,11
,2013,060100274,,,,41,50,91
,2013,060100274,,,,387,493,880
,2013,060100275,,,,22,30,52
,2013,060100276,,,,18,21,39
,2013,060100282,,,,357,507,864
,2013,060100283,,,,1,6,7
,2013,060100285,,,,3,7,10
,2013,060100289,,,,5,3,8
,2013,060100313,,,,260,207,467
,2013,060100313,,,,249,269,518
,2013,060100316,,,,7,10,17
,2013,060100365,,,,14,16,30
,2013,060100367,,,,9,4,13
,2013,060100370,,,,5,7,12
,2013,060100373,,,,9,6,15
,2013,060100380,,,,4,4,8
,2013,060100384,,,,5,2,7
,2013,060100386,,,,21,12,33
,2013,060100388,,,,9,6,15
,2013,060100389,,,,13,7,20
,2013,060100390,,,,24,1,25
,2013,060100394,,,,14,9,23
,2013,060100395,,,,30,30,60
,2013,060100396,,,,6,9,15
,2013,060100397,,,,100,111,211
,2013,060100401,,,,146,233,379
,2013,060100401,,,,30,46,76
,2013,060100403,,,,14,16,30
,2013,060100404,,,,10,9,19
,2013,060100405,,,,9,19,28
,2013,060100407,,,,9,8,17
,2013,060100408,,,,9,11,20
,2013,060100409,,,,12,18,30
,2013,060100411,,,,30,46,76
,2013,060100411,,,,139,126,265
,2013,060100412,,,,0,1,1
,2013,060100412,,,,52,38,90
,2013,060100413,,,,18,27,45
,2013,060100413,,,,43,54,97
,2013,060100413,,,,23,16,39
,2013,060100414,,,,12,4,16
,2013,060100416,,,,78,74,152
,2013,060100416,,,,10,9,19
,2013,060100416,,,,85,65,150
,2013,060100419,,,,7,10,17
,2013,060100419,,,,5,14,19
,2013,060100420,,,,34,42,76
,2013,060100421,,,,49,23,72
,2013,060100423,,,,259,480,739
,2013,060100424,,,,6,9,15
,2013,060100425,,,,10,11,21
,2013,060100426,,,,6,5,11
,2013,060100427,,,,5,4,9
,2013,060100428,,,,12,8,20
,2013,060100429,,,,9,6,15
,2013,060100432,,,,6,8,14
,2013,060100436,,,,5,8,13
,2013,060100437,,,,11,8,19
,2013,060100438,,,,3,10,13
,2013,060100439,,,,14,8,22
,2013,060100440,,,,11,4,15
,2013,060100441,,,,12,3,15
,2013,060100444,,,,5,5,10
,2013,060100445,,,,6,4,10
,2013,060100448,,,,9,4,13
,2013,060100449,,,,7,3,10
,2013,060100452,,,,9,5,14
,2013,060100453,,,,2,8,10
,2013,060100455,,,,6,7,13
,2013,060100457,,,,4,6,10
,2013,060100458,,,,18,19,37
,2013,060100458,,,,21,18,39
,2013,060100459,,,,44,49,93
,2013,060100460,,,,324,511,835
,2013,060100464,,,,8,9,17
,2013,060100465,,,,6,4,10
,2013,060100466,,,,10,2,12
,2013,060100470,,,,4,6,10
,2013,060100471,,,,6,5,11
,2013,060100472,,,,5,7,12
,2013,060100474,,,,7,4,11
,2013,060100480,,,,15,10,25
,2013,060100481,,,,24,41,65
,2013,060100481,,,,5,4,9
,2013,060100482,,,,61,46,107
,2013,060100482,,,,8,2,10
,2013,060100482,,,,11,8,19
,2013,060100484,,,,34,34,68
,2013,060100486,,,,4,1,5
,2013,060100486,,,,1,6,7
,2013,060200002,,,,3,10,13
,2013,060200004,,,,11,5,16
,2013,060200005,,,,107,107,214
,2013,060200005,,,,129,122,251
,2013,060200007,,,,11,16,27
,2013,060200008,,,,14,14,28
,2013,060200009,,,,34,42,76
,2013,060200010,,,,37,31,68
,2013,060200011,,,,28,18,46
,2013,060200012,,,,8,11,19
,2013,060200013,,,,26,23,49
,2013,060200014,,,,6,8,14
,2013,060200015,,,,26,20,46
,2013,060200016,,,,22,17,39
,2013,060200017,,,,8,15,23
,2013,060200018,,,,16,16,32
,2013,060200019,,,,9,9,18
,2013,060200020,,,,16,18,34
,2013,060200021,,,,17,24,41
,2013,060200022,,,,7,9,16
,2013,060200023,,,,16,11,27
,2013,060200024,,,,6,15,21
,2013,060200025,,,,33,20,53
,2013,060200026,,,,27,29,56
,2013,060200027,,,,18,11,29
,2013,060200028,,,,10,8,18
,2013,060200029,,,,37,35,72
,2013,060200030,,,,11,14,25
,2013,060200031,,,,28,17,45
,2013,060200032,,,,14,20,34
,2013,060200033,,,,13,11,24
,2013,060200035,,,,11,9,20
,2013,060200036,,,,23,18,41
,2013,060200037,,,,9,7,16
,2013,060200038,,,,35,23,58
,2013,060200039,,,,21,9,30
,2013,060200040,,,,12,7,19
,2013,060200041,,,,22,27,49
,2013,060200042,,,,6,10,16
,2013,060200044,,,,18,21,39
,2013,060200045,,,,14,14,28
,2013,060200063,,,,11,9,20
,2013,060200073,,,,7,5,12
,2013,060200075,,,,1,7,8
,2013,060200076,,,,1,5,6
,2013,060200077,,,,4,1,5
,2013,060200080,,,,3,10,13
,2013,060300001,,,,12,14,26
,2013,060300002,,,,11,17,28
,2013,060300003,,,,13,15,28
,2013,060300004,,,,34,27,61
,2013,060300005,,,,31,54,85
,2013,060300006,,,,25,45,70
,2013,060300007,,,,31,32,63
,2013,060300008,,,,27,33,60
,2013,060300009,,,,27,27,54
,2013,060300009,,,,4,2,6
,2013,060300010,,,,50,38,88
,2013,060300011,,,,63,71,134
,2013,060300012,,,,145,127,272
,2013,060300013,,,,116,98,214
,2013,060300014,,,,125,83,208
,2013,060300015,,,,40,42,82
,2013,060300016,,,,19,21,40
,2013,060300017,,,,48,44,92
,2013,060300018,,,,28,38,66
,2013,060300019,,,,39,53,92
,2013,060300020,,,,50,53,103
,2013,060300021,,,,58,52,110
,2013,060300022,,,,15,17,32
,2013,060300023,,,,69,73,142
,2013,060300024,,,,39,25,64
,2013,060300025,,,,36,38,74
,2013,060300026,,,,61,65,126
,2013,060300027,,,,27,27,54
,2013,060300028,,,,45,34,79
,2013,060300029,,,,37,32,69
,2013,060300031,,,,51,41,92
,2013,060300032,,,,32,40,72
,2013,060300033,,,,118,97,215
,2013,060300034,,,,48,50,98
,2013,060300035,,,,31,36,67
,2013,060300036,,,,52,48,100
,2013,060300037,,,,74,45,119
,2013,060300038,,,,24,33,57
,2013,060300038,,,,4,6,10
,2013,060300039,,,,23,27,50
,2013,060300040,,,,38,25,63
,2013,060300041,,,,20,51,71
,2013,060300042,,,,9,6,15
,2013,060300043,,,,27,25,52
,2013,060300044,,,,26,18,44
,2013,060300045,,,,45,44,89
,2013,060300046,,,,22,19,41
,2013,060300047,,,,29,29,58
,2013,060300047,,,,3,12,15
,2013,060300048,,,,3,4,7
,2013,060300048,,,,30,14,44
,2013,060300049,,,,43,46,89
,2013,060300049,,,,11,6,17
,2013,060300050,,,,5,6,11
,2013,060300050,,,,6,16,22
,2013,060300051,,,,4,4,8
,2013,060300052,,,,7,10,17
,2013,060300052,,,,16,25,41
,2013,060300053,,,,28,33,61
,2013,060300053,,,,7,5,12
,2013,060300054,,,,77,102,179
,2013,060300055,,,,2,3,5
,2013,060300055,,,,33,37,70
,2013,060300056,,,,45,40,85
,2013,060300056,,,,3,6,9
,2013,060300057,,,,8,5,13
,2013,060300057,,,,35,23,58
,2013,060300058,,,,9,7,16
,2013,060300059,,,,19,27,46
,2013,060300060,,,,10,13,23
,2013,060300061,,,,14,8,22
,2013,060300062,,,,10,13,23
,2013,060300063,,,,10,16,26
,2013,060300064,,,,10,6,16
,2013,060300066,,,,30,33,63
,2013,060300067,,,,8,12,20
,2013,060300068,,,,7,9,16
,2013,060300068,,,,48,54,102
,2013,060300070,,,,250,216,466
,2013,060300071,,,,9,8,17
,2013,060300072,,,,12,9,21
,2013,060300073,,,,9,11,20
,2013,060300074,,,,6,10,16
,2013,060300075,,,,11,10,21
,2013,060300076,,,,8,12,20
,2013,060300077,,,,4,6,10
,2013,060300078,,,,10,5,15
,2013,060300079,,,,11,9,20
,2013,060300080,,,,10,21,31
,2013,060300081,,,,8,8,16
,2013,060300082,,,,5,5,10
,2013,060300083,,,,4,6,10
,2013,060300085,,,,1,8,9
,2013,060300086,,,,8,9,17
,2013,060300087,,,,7,11,18
,2013,060300089,,,,6,6,12
,2013,060300090,,,,9,6,15
,2013,060300090,,,,20,24,44
,2013,060300091,,,,16,12,28
,2013,060300092,,,,7,9,16
,2013,060300093,,,,8,4,12
,2013,060300094,,,,2,4,6
,2013,060300095,,,,3,5,8
,2013,060300097,,,,67,43,110
,2013,060300099,,,,24,15,39
,2013,060300100,,,,11,4,15
,2013,060300101,,,,6,8,14
,2013,060300103,,,,4,2,6
,2013,060300111,,,,9,12,21
,2013,060300122,,,,6,1,7
,2013,060300125,,,,2,7,9
,2013,060300126,,,,8,5,13
,2013,060300129,,,,5,3,8
,2013,060300131,,,,3,13,16
,2013,060300133,,,,5,3,8
,2013,060300134,,,,8,12,20
,2013,060300135,,,,36,32,68
,2013,060300136,,,,26,11,37
,2013,060300137,,,,197,133,330
,2013,060300140,,,,76,56,132
,2013,060300141,,,,23,18,41
,2013,060300142,,,,2,4,6
,2013,060300143,,,,4,1,5
,2013,060300146,,,,7,2,9
,2013,060300147,,,,7,7,14
,2013,060300201,,,,22,15,37
,2013,060300202,,,,3,4,7
,2013,060300203,,,,6,4,10
,2013,060300206,,,,3,3,6
,2013,060300207,,,,3,3,6
,2013,060400001,,,,118,109,227
,2013,060400002,,,,43,25,68
,2013,060400003,,,,46,33,79
,2013,060400004,,,,11,8,19
,2013,060400005,,,,28,21,49
,2013,060400006,,,,8,8,16
,2013,060400007,,,,46,46,92
,2013,060400008,,,,15,4,19
,2013,060400014,,,,5,10,15
,2013,060400015,,,,8,9,17
,2013,060400016,,,,5,4,9
,2013,060400017,,,,15,20,35
,2013,060400018,,,,94,91,185
,2013,060400019,,,,30,16,46
,2013,060400020,,,,11,7,18
,2013,060500001,,,,6,9,15
,2013,060500001,,,,27,30,57
,2013,060500003,,,,13,12,25
,2013,060500004,,,,23,35,58
,2013,060500005,,,,111,118,229
,2013,060500006,,,,56,54,110
,2013,060500007,,,,30,15,45
,2013,060500008,,,,10,5,15
,2013,060500009,,,,64,60,124
,2013,060500010,,,,46,44,90
,2013,060500011,,,,11,9,20
,2013,060500012,,,,12,22,34
,2013,060500013,,,,45,49,94
,2013,060500014,,,,71,50,121
,2013,060500015,,,,59,45,104
,2013,060500016,,,,31,35,66
,2013,060500017,,,,28,33,61
,2013,060500018,,,,62,65,127
,2013,060500019,,,,135,125,260
,2013,060500020,,,,61,54,115
,2013,060500020,,,,9,12,21
,2013,060500021,,,,36,35,71
,2013,060500022,,,,26,23,49
,2013,060500023,,,,7,6,13
,2013,060500024,,,,23,16,39
,2013,060500025,,,,39,39,78
,2013,060500026,,,,36,29,65
,2013,060500027,,,,31,24,55
,2013,060500028,,,,52,71,123
,2013,060500029,,,,48,45,93
,2013,060500031,,,,16,16,32
,2013,060500032,,,,25,26,51
,2013,060500033,,,,109,95,204
,2013,060500034,,,,27,23,50
,2013,060500035,,,,12,16,28
,2013,060500036,,,,50,33,83
,2013,060500037,,,,46,30,76
,2013,060500038,,,,64,64,128
,2013,060500038,,,,5,5,10
,2013,060500039,,,,45,49,94
,2013,060500040,,,,35,26,61
,2013,060500040,,,,5,7,12
,2013,060500041,,,,35,28,63
,2013,060500042,,,,37,31,68
,2013,060500043,,,,31,27,58
,2013,060500045,,,,22,13,35
,2013,060500046,,,,19,15,34
,2013,060500046,,,,7,8,15
,2013,060500050,,,,22,20,42
,2013,060500051,,,,24,18,42
,2013,060500053,,,,91,103,194
,2013,060500054,,,,8,12,20
,2013,060500055,,,,9,7,16
,2013,060500056,,,,0,15,15
,2013,060500057,,,,25,37,62
,2013,060500058,,,,24,15,39
,2013,060500059,,,,14,6,20
,2013,060500060,,,,11,10,21
,2013,060500061,,,,17,18,35
,2013,060500062,,,,22,25,47
,2013,060500064,,,,9,6,15
,2013,060500064,,,,28,23,51
,2013,060500065,,,,24,20,44
,2013,060500066,,,,16,14,30
,2013,060500067,,,,28,28,56
,2013,060500070,,,,9,8,17
,2013,060500071,,,,12,12,24
,2013,060500074,,,,9,7,16
,2013,060500075,,,,8,7,15
,2013,060500076,,,,11,4,15
,2013,060500077,,,,12,6,18
,2013,060500079,,,,7,13,20
,2013,060500081,,,,6,6,12
,2013,060500082,,,,5,5,10
,2013,060500084,,,,3,7,10
,2013,060500085,,,,5,5,10
,2013,060500087,,,,7,3,10
,2013,060500088,,,,5,10,15
,2013,060500089,,,,34,44,78
,2013,060500090,,,,8,8,16
,2013,060500091,,,,4,6,10
,2013,060500092,,,,9,5,14
,2013,060500110,,,,6,5,11
,2013,060500113,,,,53,67,120
,2013,060500114,,,,136,140,276
,2013,060500115,,,,159,156,315
,2013,060500119,,,,6,5,11
,2013,060500122,,,,3,5,8
,2013,060500124,,,,2,8,10
,2013,060500125,,,,2,3,5
,2013,060600002,,,,17,22,39
,2013,060600003,,,,32,28,60
,2013,060600005,,,,10,6,16
,2013,060600007,,,,58,42,100
,2013,060600008,,,,22,20,42
,2013,060600009,,,,47,44,91
,2013,060600010,,,,52,61,113
,2013,060600011,,,,41,40,81
,2013,060600012,,,,152,145,297
,2013,060600013,,,,210,200,410
,2013,060600014,,,,35,37,72
,2013,060600015,,,,73,53,126
,2013,060600016,,,,513,408,921
,2013,060600017,,,,50,51,101
,2013,060600018,,,,32,35,67
,2013,060600019,,,,34,25,59
,2013,060600020,,,,69,43,112
,2013,060600022,,,,229,201,430
,2013,060600023,,,,39,40,79
,2013,060600024,,,,37,34,71
,2013,060600025,,,,28,21,49
,2013,060600026,,,,68,53,121
,2013,060600027,,,,21,24,45
,2013,060600028,,,,218,208,426
,2013,060600029,,,,284,243,527
,2013,060600030,,,,116,101,217
,2013,060600031,,,,62,62,124
,2013,060600032,,,,30,37,67
,2013,060600033,,,,23,25,48
,2013,060600034,,,,104,98,202
,2013,060600035,,,,37,28,65
,2013,060600036,,,,28,32,60
,2013,060600037,,,,27,16,43
,2013,060600038,,,,32,20,52
,2013,060600039,,,,73,80,153
,2013,060600040,,,,121,89,210
,2013,060600041,,,,168,192,360
,2013,060600042,,,,36,32,68
,2013,060600043,,,,36,26,62
,2013,060600044,,,,58,63,121
,2013,060600045,,,,80,58,138
,2013,060600046,,,,67,51,118
,2013,060600047,,,,35,18,53
,2013,060600048,,,,70,66,136
,2013,060600049,,,,51,38,89
,2013,060600050,,,,46,26,72
,2013,060600051,,,,14,15,29
,2013,060600052,,,,46,40,86
,2013,060600053,,,,52,49,101
,2013,060600054,,,,61,49,110
,2013,060600055,,,,8,8,16
,2013,060600056,,,,33,30,63
,2013,060600057,,,,33,21,54
,2013,060600058,,,,41,31,72
,2013,060600059,,,,27,30,57
,2013,060600060,,,,10,9,19
,2013,060600060,,,,35,25,60
,2013,060600061,,,,92,74,166
,2013,060600063,,,,22,28,50
,2013,060600064,,,,58,63,121
,2013,060600065,,,,70,64,134
,2013,060600066,,,,43,41,84
,2013,060600067,,,,21,20,41
,2013,060600068,,,,18,14,32
,2013,060600069,,,,21,12,33
,2013,060600070,,,,11,7,18
,2013,060600071,,,,7,12,19
,2013,060600072,,,,976,845,1821
,2013,060600073,,,,11,10,21
,2013,060600074,,,,16,9,25
,2013,060600075,,,,18,19,37
,2013,060600076,,,,16,11,27
,2013,060600078,,,,24,29,53
,2013,060600081,,,,7,8,15
,2013,060600081,,,,26,24,50
,2013,060600083,,,,11,6,17
,2013,060600084,,,,12,10,22
,2013,060600085,,,,20,22,42
,2013,060600086,,,,37,33,70
,2013,060600086,,,,9,12,21
,2013,060600087,,,,7,9,16
,2013,060600088,,,,15,11,26
,2013,060600089,,,,16,10,26
,2013,060600090,,,,16,10,26
,2013,060600092,,,,9,6,15
,2013,060600093,,,,12,10,22
,2013,060600096,,,,11,4,15
,2013,060600097,,,,11,12,23
,2013,060600100,,,,21,16,37
,2013,060600101,,,,29,14,43
,2013,060600103,,,,31,28,59
,2013,060600104,,,,8,7,15
,2013,060600106,,,,2,5,7
,2013,060600107,,,,3,6,9
,2013,060600109,,,,11,8,19
,2013,060600111,,,,10,6,16
,2013,060600112,,,,7,8,15
,2013,060600113,,,,37,36,73
,2013,060600114,,,,4,4,8
,2013,060600114,,,,30,28,58
,2013,060600121,,,,9,0,9
,2013,060600157,,,,5,4,9
,2013,060600158,,,,10,9,19
,2013,060600160,,,,9,1,10
,2013,060600161,,,,4,4,8
,2013,060600162,,,,6,9,15
,2013,060600164,,,,8,9,17
,2013,060600165,,,,3,7,10
,2013,060600167,,,,7,7,14
,2013,060600168,,,,8,7,15
,2013,060600169,,,,6,3,9
,2013,060600170,,,,1,4,5
,2013,060600171,,,,3,4,7
,2013,060600173,,,,4,7,11
,2013,060600178,,,,5,6,11
,2013,060600179,,,,5,5,10
,2013,060600180,,,,11,4,15
,2013,060600181,,,,237,228,465
,2013,060600182,,,,9,2,11
,2013,060600183,,,,2,6,8
,2013,060600184,,,,7,4,11
,2013,060600185,,,,3,3,6
,2013,060600186,,,,6,6,12
,2013,060600187,,,,7,5,12
,2013,060600188,,,,3,6,9
,2013,060600190,,,,9,6,15
,2013,060600190,,,,37,25,62
,2013,060600191,,,,1,4,5
,2013,060600193,,,,11,7,18
,2013,060600193,,,,46,54,100
,2013,060600194,,,,7,8,15
,2013,060600196,,,,35,35,70
,2013,060600197,,,,4,5,9
,2013,060600198,,,,8,5,13
,2013,060600199,,,,2,4,6
,2013,060600200,,,,5,6,11
,2013,060600203,,,,10,6,16
,2013,060600204,,,,6,3,9
,2013,060600205,,,,7,6,13
,2013,060600206,,,,9,0,9
,2013,060600207,,,,5,5,10
,2013,060600208,,,,5,4,9
,2013,060600209,,,,7,5,12
,2013,060600210,,,,51,44,95
,2013,060600211,,,,25,36,61
,2013,060700002,,,,10,12,22
,2013,060700003,,,,20,19,39
,2013,060700005,,,,7,13,20
,2013,060700006,,,,41,30,71
,2013,060700007,,,,218,219,437
,2013,060700008,,,,128,132,260
,2013,060700009,,,,146,119,265
,2013,060700010,,,,98,87,185
,2013,060700011,,,,6,5,11
,2013,060700011,,,,51,60,111
,2013,060700012,,,,37,39,76
,2013,060700013,,,,51,45,96
,2013,060700014,,,,60,47,107
,2013,060700015,,,,17,23,40
,2013,060700016,,,,42,45,87
,2013,060700017,,,,16,26,42
,2013,060700018,,,,12,8,20
,2013,060700019,,,,5,9,14
,2013,060700020,,,,190,166,356
,2013,060700021,,,,210,239,449
,2013,060700022,,,,28,36,64
,2013,060700022,,,,3,4,7
,2013,060700023,,,,23,26,49
,2013,060700024,,,,22,22,44
,2013,060700024,,,,2,2,4
,2013,060700025,,,,76,68,144
,2013,060700026,,,,16,11,27
,2013,060700027,,,,14,23,37
,2013,060700028,,,,176,208,384
,2013,060700029,,,,48,33,81
,2013,060700030,,,,27,14,41
,2013,060700031,,,,96,104,200
,2013,060700032,,,,58,57,115
,2013,060700033,,,,11,5,16
,2013,060700034,,,,53,61,114
,2013,060700035,,,,41,57,98
,2013,060700036,,,,68,50,118
,2013,060700037,,,,284,281,565
,2013,060700038,,,,103,108,211
,2013,060700039,,,,266,240,506
,2013,060700040,,,,163,122,285
,2013,060700041,,,,69,62,131
,2013,060700042,,,,6,11,17
,2013,060700043,,,,33,30,63
,2013,060700044,,,,95,103,198
,2013,060700045,,,,275,255,530
,2013,060700046,,,,266,243,509
,2013,060700047,,,,37,34,71
,2013,060700048,,,,47,34,81
,2013,060700049,,,,23,17,40
,2013,060700050,,,,21,24,45
,2013,060700051,,,,20,27,47
,2013,060700052,,,,10,15,25
,2013,060700053,,,,3,11,14
,2013,060700054,,,,26,17,43
,2013,060700055,,,,21,30,51
,2013,060700056,,,,41,34,75
,2013,060700057,,,,8,7,15
,2013,060700058,,,,19,20,39
,2013,060700059,,,,23,18,41
,2013,060700060,,,,7,10,17
,2013,060700061,,,,8,12,20
,2013,060700062,,,,5,10,15
,2013,060700064,,,,12,11,23
,2013,060700065,,,,9,5,14
,2013,060700066,,,,7,14,21
,2013,060700068,,,,40,44,84
,2013,060700069,,,,149,118,267
,2013,060700069,,,,12,17,29
,2013,060700070,,,,15,9,24
,2013,060700071,,,,3,3,6
,2013,060700071,,,,3,12,15
,2013,060700072,,,,421,517,938
,2013,060700074,,,,164,156,320
,2013,060700075,,,,6,21,27
,2013,060700076,,,,9,21,30
,2013,060700077,,,,3,5,8
,2013,060700079,,,,6,8,14
,2013,060700080,,,,6,5,11
,2013,060700098,,,,3,11,14
,2013,060700100,,,,9,12,21
,2013,060700101,,,,14,7,21
,2013,060700102,,,,8,4,12
,2013,060700103,,,,17,13,30
,2013,060700103,,,,116,117,233
,2013,060700104,,,,16,13,29
,2013,060700105,,,,6,3,9
,2013,060700106,,,,4,4,8
,2013,060700107,,,,4,4,8
,2013,060700108,,,,4,3,7
,2013,060700109,,,,3,1,4
,2013,060700110,,,,1,5,6
,2013,060700111,,,,7,2,9
,2013,060700116,,,,6,7,13
,2013,060700117,,,,2,4,6
,2013,060700119,,,,6,3,9
,2013,060700120,,,,4,3,7
,2013,060700120,,,,23,30,53
,2013,060700120,,,,35,61,96
,2013,060700121,,,,85,61,146
,2013,060700122,,,,37,35,72
,2013,060700123,,,,15,16,31
,2013,060700123,,,,4,4,8
,2013,060800001,,,,64,70,134
,2013,060800002,,,,8,5,13
,2013,060800003,,,,7,13,20
,2013,060800004,,,,40,31,71
,2013,060800005,,,,11,19,30
,2013,060800006,,,,14,19,33
,2013,060800007,,,,8,10,18
,2013,060800008,,,,9,10,19
,2013,060800009,,,,8,9,17
,2013,060800010,,,,25,15,40
,2013,060800011,,,,30,15,45
,2013,060800012,,,,42,41,83
,2013,060800013,,,,20,29,49
,2013,060800014,,,,8,3,11
,2013,060800015,,,,14,21,35
,2013,060800016,,,,8,1,9
,2013,060800017,,,,5,5,10
,2013,060800018,,,,7,8,15
,2013,060800019,,,,13,11,24
,2013,060800021,,,,17,13,30
,2013,060800022,,,,14,10,24
,2013,060800023,,,,98,80,178
,2013,060800025,,,,6,8,14
,2013,060800033,,,,3,2,5
,2013,060800038,,,,3,3,6
,2013,060800039,,,,5,2,7
,2013,060800040,,,,4,1,5
,2013,060900001,,,,8,7,15
,2013,060900002,,,,209,176,385
,2013,060900003,,,,42,28,70
,2013,060900004,,,,76,75,151
,2013,060900005,,,,195,168,363
,2013,060900006,,,,50,38,88
,2013,060900007,,,,123,92,215
,2013,060900008,,,,92,117,209
,2013,060900010,,,,63,65,128
,2013,060900011,,,,41,46,87
,2013,060900012,,,,83,97,180
,2013,060900013,,,,32,31,63
,2013,060900014,,,,32,40,72
,2013,060900015,,,,99,102,201
,2013,060900016,,,,76,70,146
,2013,060900017,,,,32,24,56
,2013,060900018,,,,35,29,64
,2013,060900019,,,,25,44,69
,2013,060900020,,,,117,121,238
,2013,060900021,,,,142,145,287
,2013,060900022,,,,73,54,127
,2013,060900023,,,,43,41,84
,2013,060900024,,,,32,36,68
,2013,060900025,,,,62,49,111
,2013,060900026,,,,143,134,277
,2013,060900027,,,,53,37,90
,2013,060900028,,,,68,72,140
,2013,060900029,,,,30,31,61
,2013,060900030,,,,79,55,134
,2013,060900031,,,,24,25,49
,2013,060900032,,,,20,14,34
,2013,060900033,,,,50,54,104
,2013,060900034,,,,22,28,50
,2013,060900035,,,,30,24,54
,2013,060900035,,,,6,4,10
,2013,060900036,,,,9,9,18
,2013,060900036,,,,47,33,80
,2013,060900037,,,,26,21,47
,2013,060900037,,,,5,1,6
,2013,060900038,,,,7,8,15
,2013,060900038,,,,33,33,66
,2013,060900039,,,,13,14,27
,2013,060900039,,,,7,7,14
,2013,060900040,,,,6,9,15
,2013,060900040,,,,41,27,68
,2013,060900041,,,,50,57,107
,2013,060900042,,,,21,22,43
,2013,060900043,,,,12,6,18
,2013,060900044,,,,46,46,92
,2013,060900045,,,,13,8,21
,2013,060900046,,,,7,15,22
,2013,060900047,,,,15,22,37
,2013,060900048,,,,15,18,33
,2013,060900049,,,,10,7,17
,2013,060900050,,,,12,10,22
,2013,060900052,,,,235,220,455
,2013,060900053,,,,7,14,21
,2013,060900054,,,,11,9,20
,2013,060900055,,,,11,7,18
,2013,060900056,,,,11,6,17
,2013,060900057,,,,14,13,27
,2013,060900058,,,,9,6,15
,2013,060900059,,,,11,10,21
,2013,060900060,,,,9,11,20
,2013,060900061,,,,15,13,28
,2013,060900063,,,,7,12,19
,2013,060900064,,,,13,12,25
,2013,060900065,,,,5,10,15
,2013,060900066,,,,2,11,13
,2013,060900067,,,,4,3,7
,2013,060900068,,,,4,3,7
,2013,060900070,,,,4,6,10
,2013,060900071,,,,9,12,21
,2013,060900096,,,,8,12,20
,2013,060900097,,,,6,4,10
,2013,060900098,,,,5,0,5
,2013,060900099,,,,3,4,7
,2013,060900100,,,,4,3,7
,2013,060900101,,,,1,1,2
,2013,060900102,,,,2,2,4
,2013,060900103,,,,3,3,6
,2013,060900104,,,,8,6,14
,2013,060900105,,,,3,5,8
,2013,060900106,,,,4,3,7
,2013,060900107,,,,3,4,7
,2013,060900108,,,,5,1,6
,2013,060900109,,,,3,7,10
,2013,060900110,,,,8,5,13
,2013,060900111,,,,0,4,4
,2013,060900113,,,,0,2,2
,2013,061000001,,,,14,17,31
,2013,061000002,,,,24,17,41
,2013,061000003,,,,175,177,352
,2013,061000004,,,,6,2,8
,2013,061000005,,,,58,58,116
,2013,061000006,,,,63,48,111
,2013,061000007,,,,60,63,123
,2013,061000008,,,,52,46,98
,2013,061000009,,,,14,14,28
,2013,061000010,,,,24,15,39
,2013,061000011,,,,28,19,47
,2013,061000012,,,,92,116,208
,2013,061000013,,,,16,22,38
,2013,061000014,,,,22,16,38
,2013,061000015,,,,40,39,79
,2013,061000016,,,,15,15,30
,2013,061000017,,,,15,13,28
,2013,061000018,,,,50,59,109
,2013,061000019,,,,20,15,35
,2013,061000020,,,,15,12,27
,2013,061000021,,,,29,29,58
,2013,061000022,,,,11,16,27
,2013,061000023,,,,22,20,42
,2013,061000024,,,,80,85,165
,2013,061000025,,,,20,21,41
,2013,061000026,,,,34,38,72
,2013,061000027,,,,26,15,41
,2013,061000029,,,,14,9,23
,2013,061000030,,,,57,57,114
,2013,061000031,,,,12,14,26
,2013,061000032,,,,49,42,91
,2013,061000033,,,,14,11,25
,2013,061000034,,,,18,28,46
,2013,061000035,,,,11,10,21
,2013,061000036,,,,51,37,88
,2013,061000037,,,,24,28,52
,2013,061000038,,,,190,186,376
,2013,061000039,,,,124,138,262
,2013,061000040,,,,41,37,78
,2013,061000041,,,,11,7,18
,2013,061000042,,,,13,15,28
,2013,061000043,,,,32,28,60
,2013,061000044,,,,9,8,17
,2013,061000045,,,,4,9,13
,2013,061000046,,,,4,7,11
,2013,061000047,,,,8,8,16
,2013,061000048,,,,4,4,8
,2013,061000049,,,,210,222,432
,2013,061000050,,,,7,5,12
,2013,061000051,,,,4,9,13
,2013,061000052,,,,12,14,26
,2013,061000053,,,,11,9,20
,2013,061000054,,,,33,40,73
,2013,061000055,,,,11,10,21
,2013,061000056,,,,24,19,43
,2013,061000057,,,,8,7,15
,2013,061000058,,,,20,30,50
,2013,061000059,,,,4,7,11
,2013,061000060,,,,0,4,4
,2013,061000061,,,,6,8,14
,2013,061000062,,,,7,5,12
,2013,061000063,,,,10,10,20
,2013,061000064,,,,5,8,13
,2013,061000065,,,,9,5,14
,2013,061000067,,,,7,1,8
,2013,061000068,,,,14,16,30
,2013,061000069,,,,5,4,9
,2013,061000070,,,,1,4,5
,2013,061000071,,,,4,3,7
,2013,061000091,,,,3,12,15
,2013,061000093,,,,8,2,10
,2013,061000094,,,,1,1,2
,2013,061000095,,,,2,3,5
,2013,061000096,,,,8,19,27
,2013,061000097,,,,83,122,205
,2013,061000098,,,,3,4,7
,2013,061000099,,,,4,5,9
,2013,061000100,,,,6,0,6
,2013,061000101,,,,3,5,8
,2013,061000102,,,,3,1,4
,2013,061000103,,,,5,4,9
,2013,061000106,,,,7,7,14
,2013,061000107,,,,24,18,42
,2013,061100002,,,,26,19,45
,2013,061100003,,,,23,20,43
,2013,061100004,,,,23,21,44
,2013,061100006,,,,48,31,79
,2013,061100007,,,,5,15,20
,2013,061100008,,,,77,78,155
,2013,061100009,,,,7,7,14
,2013,061100010,,,,39,32,71
,2013,061100011,,,,15,17,32
,2013,061100012,,,,26,26,52
,2013,061100013,,,,21,25,46
,2013,061100014,,,,27,32,59
,2013,061100015,,,,37,23,60
,2013,061100016,,,,58,56,114
,2013,061100017,,,,20,18,38
,2013,061100018,,,,20,10,30
,2013,061100019,,,,27,23,50
,2013,061100020,,,,37,25,62
,2013,061100021,,,,98,98,196
,2013,061100022,,,,43,32,75
,2013,061100023,,,,98,97,195
,2013,061100024,,,,56,29,85
,2013,061100025,,,,80,106,186
,2013,061100026,,,,49,40,89
,2013,061100027,,,,18,12,30
,2013,061100028,,,,37,48,85
,2013,061100029,,,,12,12,24
,2013,061100030,,,,44,24,68
,2013,061100031,,,,29,30,59
,2013,061100032,,,,77,69,146
,2013,061100033,,,,35,24,59
,2013,061100034,,,,28,23,51
,2013,061100035,,,,21,22,43
,2013,061100036,,,,38,32,70
,2013,061100037,,,,82,100,182
,2013,061100038,,,,7,6,13
,2013,061100039,,,,37,36,73
,2013,061100040,,,,52,46,98
,2013,061100041,,,,17,16,33
,2013,061100042,,,,22,22,44
,2013,061100043,,,,27,35,62
,2013,061100044,,,,10,12,22
,2013,061100045,,,,35,49,84
,2013,061100046,,,,38,38,76
,2013,061100047,,,,6,8,14
,2013,061100048,,,,35,23,58
,2013,061100049,,,,28,27,55
,2013,061100050,,,,20,11,31
,2013,061100051,,,,25,26,51
,2013,061100052,,,,49,50,99
,2013,061100053,,,,29,34,63
,2013,061100054,,,,14,9,23
,2013,061100055,,,,23,13,36
,2013,061100056,,,,16,9,25
,2013,061100057,,,,11,20,31
,2013,061100058,,,,24,18,42
,2013,061100059,,,,20,11,31
,2013,061100060,,,,84,49,133
,2013,061100061,,,,37,28,65
,2013,061100062,,,,28,19,47
,2013,061100063,,,,18,23,41
,2013,061100064,,,,11,14,25
,2013,061100064,,,,7,6,13
,2013,061100065,,,,41,36,77
,2013,061100065,,,,283,332,615
,2013,061100066,,,,14,16,30
,2013,061100068,,,,3,6,9
,2013,061100069,,,,6,7,13
,2013,061100070,,,,7,4,11
,2013,061100071,,,,11,16,27
,2013,061100072,,,,7,5,12
,2013,061100073,,,,6,4,10
,2013,061100074,,,,10,8,18
,2013,061100075,,,,7,4,11
,2013,061100076,,,,6,9,15
,2013,061100078,,,,6,6,12
,2013,061100079,,,,6,13,19
,2013,061100080,,,,7,8,15
,2013,061100081,,,,451,423,874
,2013,061100082,,,,3,7,10
,2013,061100084,,,,6,12,18
,2013,061100085,,,,7,5,12
,2013,061100086,,,,5,8,13
,2013,061100087,,,,5,8,13
,2013,061100088,,,,13,5,18
,2013,061100089,,,,8,2,10
,2013,061100090,,,,7,11,18
,2013,061100091,,,,26,22,48
,2013,061100093,,,,6,7,13
,2013,061100094,,,,7,6,13
,2013,061100095,,,,18,12,30
,2013,061100096,,,,6,10,16
,2013,061100098,,,,417,412,829
,2013,061100099,,,,10,5,15
,2013,061100101,,,,8,6,14
,2013,061100139,,,,3,4,7
,2013,061100140,,,,8,4,12
,2013,061100142,,,,7,6,13
,2013,061100143,,,,16,14,30
,2013,061100145,,,,6,8,14
,2013,061100146,,,,6,9,15
,2013,061100149,,,,25,16,41
,2013,061100150,,,,6,3,9
,2013,061100153,,,,7,2,9
,2013,061100154,,,,3,8,11
,2013,061100155,,,,6,1,7
,2013,061100156,,,,1,6,7
,2013,061100158,,,,6,5,11
,2013,061100162,,,,12,19,31
,2013,061100162,,,,18,23,41
,2013,061100163,,,,24,6,30
,2013,061100164,,,,7,8,15
,2013,061100166,,,,3,7,10
,2013,061100167,,,,15,15,30
,2013,061100168,,,,5,4,9
,2013,061200001,,,,40,33,73
,2013,061200002,,,,123,95,218
,2013,061200003,,,,47,39,86
,2013,061200004,,,,34,33,67
,2013,061200005,,,,67,57,124
,2013,061200006,,,,33,42,75
,2013,061200007,,,,36,32,68
,2013,061200008,,,,44,33,77
,2013,061200009,,,,6,8,14
,2013,061200010,,,,8,13,21
,2013,061200011,,,,8,6,14
,2013,061200012,,,,6,12,18
,2013,061200013,,,,4,14,18
,2013,061200014,,,,6,5,11
,2013,061200028,,,,5,3,8
,2013,061200042,,,,5,5,10
,2013,061200044,,,,2,3,5
,2013,061200047,,,,4,2,6
,2013,061300001,,,,108,106,214
,2013,061300002,,,,37,33,70
,2013,061300003,,,,24,18,42
,2013,061300004,,,,34,39,73
,2013,061300005,,,,38,48,86
,2013,061300006,,,,47,30,77
,2013,061300007,,,,6,12,18
,2013,061300008,,,,33,20,53
,2013,061300009,,,,18,21,39
,2013,061300009,,,,1,4,5
,2013,061300010,,,,8,7,15
,2013,061300011,,,,6,9,15
,2013,061300012,,,,40,26,66
,2013,061300013,,,,5,6,11
,2013,061300015,,,,14,8,22
,2013,061300017,,,,13,10,23
,2013,061300045,,,,7,4,11
,2013,061300046,,,,8,4,12
,2013,061300047,,,,5,6,11
,2013,061300048,,,,9,4,13
,2013,061400001,,,,6,8,14
,2013,061400002,,,,11,5,16
,2013,061400004,,,,149,127,276
,2013,061400005,,,,48,42,90
,2013,061400006,,,,44,49,93
,2013,061400007,,,,35,29,64
,2013,061400008,,,,46,46,92
,2013,061400009,,,,8,1,9
,2013,061400010,,,,14,18,32
,2013,061400011,,,,29,33,62
,2013,061400012,,,,10,31,41
,2013,061400013,,,,18,17,35
,2013,061400014,,,,7,9,16
,2013,061400015,,,,6,6,12
,2013,061400035,,,,6,2,8
,2013,061400036,,,,4,4,8
,2013,061400037,,,,9,7,16
,2013,061500001,,,,16,5,21
,2013,061500002,,,,67,47,114
,2013,061500003,,,,79,90,169
,2013,061500004,,,,77,96,173
,2013,061500004,,,,14,14,28
,2013,061500005,,,,39,37,76
,2013,061500006,,,,17,14,31
,2013,061500007,,,,11,8,19
,2013,061500008,,,,13,13,26
,2013,061500009,,,,35,27,62
,2013,061500010,,,,66,77,143
,2013,061500011,,,,24,31,55
,2013,061500012,,,,19,10,29
,2013,061500013,,,,10,5,15
,2013,061500014,,,,50,26,76
,2013,061500015,,,,28,39,67
,2013,061500016,,,,48,50,98
,2013,061500017,,,,21,27,48
,2013,061500018,,,,51,51,102
,2013,061500019,,,,129,131,260
,2013,061500020,,,,159,154,313
,2013,061500021,,,,9,8,17
,2013,061500022,,,,16,16,32
,2013,061500023,,,,16,17,33
,2013,061500024,,,,8,15,23
,2013,061500025,,,,14,14,28
,2013,061500026,,,,24,23,47
,2013,061500027,,,,107,104,211
,2013,061500028,,,,30,33,63
,2013,061500029,,,,23,21,44
,2013,061500030,,,,12,11,23
,2013,061500031,,,,5,6,11
,2013,061500032,,,,15,7,22
,2013,061500033,,,,66,61,127
,2013,061500034,,,,30,21,51
,2013,061500035,,,,10,4,14
,2013,061500036,,,,33,28,61
,2013,061500037,,,,26,22,48
,2013,061500038,,,,12,17,29
,2013,061500039,,,,219,248,467
,2013,061500039,,,,319,396,715
,2013,061500040,,,,15,30,45
,2013,061500041,,,,401,470,871
,2013,061500042,,,,11,13,24
,2013,061500043,,,,14,12,26
,2013,061500044,,,,11,15,26
,2013,061500048,,,,3,7,10
,2013,061500049,,,,12,24,36
,2013,061500050,,,,12,12,24
,2013,061500051,,,,30,17,47
,2013,061500052,,,,9,4,13
,2013,061500056,,,,89,89,178
,2013,061500057,,,,16,22,38
,2013,061500058,,,,20,13,33
,2013,061500059,,,,8,6,14
,2013,061500060,,,,19,26,45
,2013,061500061,,,,23,19,42
,2013,061500063,,,,17,27,44
,2013,061500064,,,,9,3,12
,2013,061500066,,,,10,9,19
,2013,061500070,,,,4,7,11
,2013,061500072,,,,17,28,45
,2013,061500073,,,,4,10,14
,2013,061500074,,,,7,9,16
,2013,061500075,,,,3,8,11
,2013,061500076,,,,14,10,24
,2013,061500077,,,,9,13,22
,2013,061500078,,,,57,56,113
,2013,061500079,,,,19,17,36
,2013,061500080,,,,12,13,25
,2013,061500095,,,,43,49,92
,2013,061500097,,,,6,4,10
,2013,061500098,,,,3,1,4
,2013,061500101,,,,7,6,13
,2013,061500102,,,,7,8,15
,2013,061500103,,,,5,5,10
,2013,061500104,,,,3,3,6
,2013,061500105,,,,5,4,9
,2013,061500106,,,,2,5,7
,2013,061500107,,,,5,5,10
,2013,061500108,,,,5,5,10
,2013,061500109,,,,2,7,9
,2013,061500111,,,,4,2,6
,2013,061500112,,,,4,4,8
,2013,061500113,,,,12,11,23
,2013,061500113,,,,33,25,58
,2013,061600001,,,,55,63,118
,2013,061600002,,,,55,54,109
,2013,061600003,,,,35,38,73
,2013,061600004,,,,180,182,362
,2013,061600005,,,,177,192,369
,2013,061600006,,,,33,23,56
,2013,061600007,,,,202,190,392
,2013,061600008,,,,285,284,569
,2013,061600009,,,,11,14,25
,2013,061600010,,,,21,21,42
,2013,061600011,,,,19,19,38
,2013,061600012,,,,22,25,47
,2013,061600013,,,,23,21,44
,2013,061600014,,,,17,14,31
,2013,061600015,,,,13,17,30
,2013,061600016,,,,7,13,20
,2013,061600017,,,,12,12,24
,2013,061600018,,,,149,110,259
,2013,061600047,,,,4,6,10
,2013,061600048,,,,19,15,34
,2013,061600051,,,,8,7,15
,2013,061600052,,,,9,8,17
,2013,061600053,,,,4,4,8
,2013,070100001,,,,33,32,65
,2013,070100002,,,,9,9,18
,2013,070100003,,,,33,38,71
,2013,070100004,,,,23,22,45
,2013,070100005,,,,25,11,36
,2013,070100006,,,,44,53,97
,2013,070100007,,,,23,14,37
,2013,070100008,,,,29,17,46
,2013,070100009,,,,14,16,30
,2013,070100010,,,,55,47,102
,2013,070100011,,,,40,30,70
,2013,070100012,,,,247,230,477
,2013,070100013,,,,17,12,29
,2013,070100014,,,,143,161,304
,2013,070100015,,,,11,14,25
,2013,070100016,,,,10,13,23
,2013,070100017,,,,18,16,34
,2013,070100018,,,,25,18,43
,2013,070100019,,,,2,8,10
,2013,070100020,,,,34,33,67
,2013,070100021,,,,7,5,12
,2013,070100022,,,,24,12,36
,2013,070100023,,,,34,47,81
,2013,070100024,,,,19,9,28
,2013,070100025,,,,3,7,10
,2013,070100026,,,,42,29,71
,2013,070100027,,,,6,4,10
,2013,070100028,,,,231,163,394
,2013,070100029,,,,6,2,8
,2013,070100030,,,,8,8,16
,2013,070100031,,,,39,36,75
,2013,070100033,,,,149,136,285
,2013,070100034,,,,10,7,17
,2013,070100035,,,,12,7,19
,2013,070100036,,,,8,10,18
,2013,070100037,,,,5,8,13
,2013,070100039,,,,43,10,53
,2013,070100041,,,,13,17,30
,2013,070100042,,,,116,142,258
,2013,070100061,,,,3,5,8
,2013,070100062,,,,4,2,6
,2013,070100063,,,,6,4,10
,2013,070100064,,,,5,3,8
,2013,070100068,,,,3,2,5
,2013,070100069,,,,5,4,9
,2013,070100073,,,,8,10,18
,2013,070100075,,,,2,3,5
,2013,070100077,,,,4,4,8
,2013,070100078,,,,3,4,7
,2013,070100079,,,,5,0,5
,2013,070100080,,,,4,2,6
,2013,070100081,,,,4,2,6
,2013,070100082,,,,4,5,9
,2013,070200001,,,,65,77,142
,2013,070200002,,,,7,21,28
,2013,070200003,,,,49,40,89
,2013,070200004,,,,22,15,37
,2013,070200005,,,,31,20,51
,2013,070200006,,,,39,27,66
,2013,070200007,,,,17,8,25
,2013,070200008,,,,5,3,8
,2013,070200009,,,,13,17,30
,2013,070200011,,,,58,67,125
,2013,070200012,,,,7,8,15
,2013,070200013,,,,22,23,45
,2013,070200015,,,,7,6,13
,2013,070200017,,,,9,9,18
,2013,070200018,,,,20,23,43
,2013,070200019,,,,5,2,7
,2013,070200020,,,,21,21,42
,2013,070200021,,,,15,5,20
,2013,070200022,,,,23,15,38
,2013,070200025,,,,9,12,21
,2013,070200027,,,,215,168,383
,2013,070200029,,,,6,6,12
,2013,070200030,,,,7,7,14
,2013,070200031,,,,8,4,12
,2013,070200032,,,,15,10,25
,2013,070200033,,,,9,4,13
,2013,070200034,,,,7,9,16
,2013,070200035,,,,7,4,11
,2013,070200035,,,,14,18,32
,2013,070200037,,,,6,13,19
,2013,070200038,,,,14,14,28
,2013,070200039,,,,16,17,33
,2013,070200039,,,,3,4,7
,2013,070200040,,,,8,7,15
,2013,070200041,,,,10,7,17
,2013,070200042,,,,24,30,54
,2013,070200051,,,,29,42,71
,2013,070200052,,,,20,11,31
,2013,070200053,,,,8,15,23
,2013,070200055,,,,11,4,15
,2013,070200056,,,,8,6,14
,2013,070200058,,,,3,3,6
,2013,070200059,,,,6,5,11
,2013,070200060,,,,7,5,12
,2013,070200062,,,,3,2,5
,2013,070200063,,,,3,3,6
,2013,070200064,,,,4,4,8
,2013,070300002,,,,28,21,49
,2013,070300004,,,,18,18,36
,2013,070300005,,,,11,13,24
,2013,070300006,,,,43,46,89
,2013,070300007,,,,15,20,35
,2013,070300009,,,,20,22,42
,2013,070300010,,,,18,18,36
,2013,070300011,,,,163,189,352
,2013,070300012,,,,74,61,135
,2013,070300013,,,,44,37,81
,2013,070300014,,,,41,42,83
,2013,070300015,,,,15,21,36
,2013,070300017,,,,161,156,317
,2013,070300018,,,,30,20,50
,2013,070300019,,,,242,231,473
,2013,070300020,,,,49,35,84
,2013,070300021,,,,70,64,134
,2013,070300022,,,,22,13,35
,2013,070300023,,,,16,15,31
,2013,070300024,,,,31,27,58
,2013,070300025,,,,48,40,88
,2013,070300026,,,,375,396,771
,2013,070300027,,,,25,25,50
,2013,070300028,,,,28,28,56
,2013,070300029,,,,15,10,25
,2013,070300030,,,,24,24,48
,2013,070300031,,,,339,332,671
,2013,070300032,,,,85,70,155
,2013,070300034,,,,378,378,756
,2013,070300035,,,,109,98,207
,2013,070300036,,,,24,24,48
,2013,070300037,,,,37,40,77
,2013,070300038,,,,25,41,66
,2013,070300038,,,,9,6,15
,2013,070300040,,,,19,7,26
,2013,070300041,,,,55,67,122
,2013,070300042,,,,38,30,68
,2013,070300043,,,,32,29,61
,2013,070300044,,,,7,10,17
,2013,070300045,,,,51,41,92
,2013,070300046,,,,5,7,12
,2013,070300048,,,,22,33,55
,2013,070300049,,,,46,38,84
,2013,070300050,,,,14,10,24
,2013,070300051,,,,31,30,61
,2013,070300052,,,,15,23,38
,2013,070300053,,,,18,29,47
,2013,070300054,,,,99,62,161
,2013,070300056,,,,232,223,455
,2013,070300057,,,,28,23,51
,2013,070300058,,,,10,14,24
,2013,070300059,,,,78,82,160
,2013,070300060,,,,14,8,22
,2013,070300061,,,,7,6,13
,2013,070300062,,,,174,161,335
,2013,070300064,,,,19,9,28
,2013,070300065,,,,31,27,58
,2013,070300066,,,,29,20,49
,2013,070300067,,,,33,21,54
,2013,070300068,,,,122,111,233
,2013,070300069,,,,25,21,46
,2013,070300070,,,,59,63,122
,2013,070300070,,,,5,2,7
,2013,070300071,,,,31,9,40
,2013,070300072,,,,35,37,72
,2013,070300073,,,,16,15,31
,2013,070300075,,,,33,35,68
,2013,070300076,,,,103,106,209
,2013,070300077,,,,137,116,253
,2013,070300078,,,,20,19,39
,2013,070300079,,,,117,108,225
,2013,070300080,,,,32,26,58
,2013,070300081,,,,73,80,153
,2013,070300082,,,,12,15,27
,2013,070300083,,,,30,24,54
,2013,070300084,,,,22,18,40
,2013,070300085,,,,28,20,48
,2013,070300086,,,,9,9,18
,2013,070300087,,,,24,16,40
,2013,070300088,,,,1030,1030,2060
,2013,070300089,,,,65,58,123
,2013,070300091,,,,37,23,60
,2013,070300092,,,,93,98,191
,2013,070300093,,,,109,95,204
,2013,070300094,,,,173,224,397
,2013,070300095,,,,35,27,62
,2013,070300096,,,,49,49,98
,2013,070300097,,,,205,220,425
,2013,070300098,,,,223,186,409
,2013,070300099,,,,16,25,41
,2013,070300100,,,,196,163,359
,2013,070300101,,,,391,374,765
,2013,070300102,,,,18,18,36
,2013,070300105,,,,27,24,51
,2013,070300106,,,,13,12,25
,2013,070300107,,,,32,22,54
,2013,070300109,,,,29,32,61
,2013,070300110,,,,48,26,74
,2013,070300111,,,,90,59,149
,2013,070300112,,,,48,38,86
,2013,070300112,,,,7,3,10
,2013,070300113,,,,148,170,318
,2013,070300114,,,,255,244,499
,2013,070300115,,,,246,250,496
,2013,070300116,,,,53,36,89
,2013,070300117,,,,31,44,75
,2013,070300118,,,,50,49,99
,2013,070300119,,,,41,30,71
,2013,070300120,,,,37,29,66
,2013,070300121,,,,64,44,108
,2013,070300122,,,,137,114,251
,2013,070300124,,,,68,59,127
,2013,070300125,,,,27,33,60
,2013,070300126,,,,27,22,49
,2013,070300127,,,,101,88,189
,2013,070300128,,,,32,25,57
,2013,070300129,,,,57,69,126
,2013,070300130,,,,35,24,59
,2013,070300131,,,,34,17,51
,2013,070300132,,,,7,15,22
,2013,070300133,,,,63,59,122
,2013,070300134,,,,265,250,515
,2013,070300135,,,,135,133,268
,2013,070300136,,,,46,56,102
,2013,070300137,,,,42,37,79
,2013,070300139,,,,25,19,44
,2013,070300140,,,,78,64,142
,2013,070300141,,,,26,21,47
,2013,070300142,,,,88,75,163
,2013,070300143,,,,13,8,21
,2013,070300144,,,,30,38,68
,2013,070300145,,,,125,106,231
,2013,070300146,,,,79,76,155
,2013,070300147,,,,67,61,128
,2013,070300148,,,,73,55,128
,2013,070300149,,,,23,17,40
,2013,070300150,,,,64,49,113
,2013,070300151,,,,26,38,64
,2013,070300152,,,,32,28,60
,2013,070300153,,,,193,195,388
,2013,070300154,,,,26,30,56
,2013,070300155,,,,139,138,277
,2013,070300156,,,,34,33,67
,2013,070300157,,,,10,18,28
,2013,070300158,,,,10,9,19
,2013,070300159,,,,54,34,88
,2013,070300161,,,,23,10,33
,2013,070300162,,,,8,7,15
,2013,070300163,,,,31,36,67
,2013,070300164,,,,51,36,87
,2013,070300165,,,,31,27,58
,2013,070300166,,,,19,17,36
,2013,070300167,,,,27,35,62
,2013,070300168,,,,38,44,82
,2013,070300169,,,,28,18,46
,2013,070300173,,,,28,23,51
,2013,070300176,,,,20,24,44
,2013,070300177,,,,139,252,391
,2013,070300178,,,,4,5,9
,2013,070300178,,,,40,42,82
,2013,070300179,,,,11,12,23
,2013,070300181,,,,30,15,45
,2013,070300181,,,,7,14,21
,2013,070300182,,,,7,8,15
,2013,070300183,,,,13,17,30
,2013,070300184,,,,8,17,25
,2013,070300185,,,,20,12,32
,2013,070300186,,,,31,25,56
,2013,070300187,,,,31,30,61
,2013,070300188,,,,16,13,29
,2013,070300190,,,,17,15,32
,2013,070300191,,,,26,27,53
,2013,070300193,,,,25,22,47
,2013,070300195,,,,16,25,41
,2013,070300198,,,,337,340,677
,2013,070300199,,,,36,58,94
,2013,070300200,,,,46,32,78
,2013,070300201,,,,25,22,47
,2013,070300203,,,,34,28,62
,2013,070300204,,,,16,8,24
,2013,070300205,,,,33,25,58
,2013,070300206,,,,46,50,96
,2013,070300207,,,,45,44,89
,2013,070300208,,,,11,9,20
,2013,070300209,,,,12,11,23
,2013,070300210,,,,29,16,45
,2013,070300211,,,,37,43,80
,2013,070300212,,,,40,24,64
,2013,070300213,,,,108,114,222
,2013,070300214,,,,12,12,24
,2013,070300215,,,,14,16,30
,2013,070300216,,,,18,26,44
,2013,070300217,,,,42,43,85
,2013,070300218,,,,34,28,62
,2013,070300219,,,,90,74,164
,2013,070300220,,,,32,21,53
,2013,070300221,,,,25,14,39
,2013,070300222,,,,15,10,25
,2013,070300223,,,,41,33,74
,2013,070300224,,,,16,5,21
,2013,070300226,,,,82,81,163
,2013,070300227,,,,11,9,20
,2013,070300229,,,,14,12,26
,2013,070300231,,,,37,42,79
,2013,070300235,,,,22,26,48
,2013,070300236,,,,40,44,84
,2013,070300237,,,,22,19,41
,2013,070300237,,,,3,4,7
,2013,070300238,,,,22,17,39
,2013,070300239,,,,21,28,49
,2013,070300240,,,,22,31,53
,2013,070300242,,,,8,7,15
,2013,070300243,,,,31,25,56
,2013,070300245,,,,16,18,34
,2013,070300246,,,,65,56,121
,2013,070300247,,,,18,10,28
,2013,070300248,,,,10,11,21
,2013,070300249,,,,18,15,33
,2013,070300250,,,,20,21,41
,2013,070300251,,,,4,8,12
,2013,070300252,,,,67,47,114
,2013,070300253,,,,7,4,11
,2013,070300254,,,,20,6,26
,2013,070300255,,,,11,18,29
,2013,070300256,,,,17,17,34
,2013,070300257,,,,26,17,43
,2013,070300258,,,,9,6,15
,2013,070300259,,,,19,5,24
,2013,070300260,,,,19,21,40
,2013,070300261,,,,6,9,15
,2013,070300262,,,,36,18,54
,2013,070300264,,,,32,32,64
,2013,070300265,,,,14,14,28
,2013,070300267,,,,9,7,16
,2013,070300271,,,,54,51,105
,2013,070300273,,,,77,49,126
,2013,070300274,,,,17,27,44
,2013,070300275,,,,26,19,45
,2013,070300276,,,,9,10,19
,2013,070300277,,,,79,63,142
,2013,070300278,,,,24,16,40
,2013,070300279,,,,119,126,245
,2013,070300280,,,,14,16,30
,2013,070300281,,,,16,25,41
,2013,070300282,,,,18,15,33
,2013,070300283,,,,17,8,25
,2013,070300284,,,,19,17,36
,2013,070300285,,,,17,19,36
,2013,070300286,,,,6,4,10
,2013,070300287,,,,19,13,32
,2013,070300288,,,,4,11,15
,2013,070300289,,,,11,8,19
,2013,070300290,,,,15,16,31
,2013,070300291,,,,10,9,19
,2013,070300292,,,,10,5,15
,2013,070300293,,,,5,9,14
,2013,070300294,,,,10,3,13
,2013,070300295,,,,13,7,20
,2013,070300295,,,,42,28,70
,2013,070300297,,,,37,30,67
,2013,070300298,,,,85,51,136
,2013,070300299,,,,18,9,27
,2013,070300300,,,,35,30,65
,2013,070300302,,,,6,10,16
,2013,070300303,,,,46,43,89
,2013,070300304,,,,10,8,18
,2013,070300305,,,,23,10,33
,2013,070300306,,,,38,27,65
,2013,070300307,,,,18,12,30
,2013,070300308,,,,20,18,38
,2013,070300309,,,,175,191,366
,2013,070300310,,,,1713,1970,3683
,2013,070300311,,,,139,153,292
,2013,070300313,,,,366,473,839
,2013,070300314,,,,393,1125,1518
,2013,070300315,,,,121,114,235
,2013,070300315,,,,16,14,30
,2013,070300316,,,,4,5,9
,2013,070300318,,,,54,64,118
,2013,070300319,,,,11,8,19
,2013,070300320,,,,5,2,7
,2013,070300321,,,,11,3,14
,2013,070300322,,,,8,6,14
,2013,070300324,,,,53,29,82
,2013,070300325,,,,7,5,12
,2013,070300326,,,,14,17,31
,2013,070300327,,,,10,6,16
,2013,070300328,,,,7,4,11
,2013,070300329,,,,8,6,14
,2013,070300330,,,,3,9,12
,2013,070300331,,,,6,7,13
,2013,070300332,,,,5,7,12
,2013,070300333,,,,9,4,13
,2013,070300334,,,,3,6,9
,2013,070300335,,,,9,5,14
,2013,070300336,,,,12,5,17
,2013,070300337,,,,32,24,56
,2013,070300339,,,,4,9,13
,2013,070300340,,,,9,3,12
,2013,070300340,,,,36,33,69
,2013,070300341,,,,32,21,53
,2013,070300342,,,,24,28,52
,2013,070300343,,,,23,21,44
,2013,070300344,,,,42,38,80
,2013,070300345,,,,28,17,45
,2013,070300347,,,,74,55,129
,2013,070300349,,,,6,3,9
,2013,070300353,,,,9,10,19
,2013,070300355,,,,15,24,39
,2013,070300356,,,,18,23,41
,2013,070300357,,,,4,3,7
,2013,070300358,,,,2,3,5
,2013,070300359,,,,11,7,18
,2013,070300360,,,,12,6,18
,2013,070300361,,,,17,13,30
,2013,070300362,,,,11,4,15
,2013,070300363,,,,7,8,15
,2013,070300364,,,,11,9,20
,2013,070300367,,,,40,36,76
,2013,070300368,,,,15,16,31
,2013,070300370,,,,6,4,10
,2013,070300371,,,,7,8,15
,2013,070300372,,,,637,409,1046
,2013,070300374,,,,39,22,61
,2013,070300375,,,,4,6,10
,2013,070300376,,,,5,11,16
,2013,070300379,,,,7,4,11
,2013,070300380,,,,167,156,323
,2013,070300381,,,,11,14,25
,2013,070300384,,,,19,29,48
,2013,070300385,,,,4,8,12
,2013,070300387,,,,4,3,7
,2013,070300388,,,,8,8,16
,2013,070300389,,,,2,3,5
,2013,070300389,,,,17,10,27
,2013,070300390,,,,14,19,33
,2013,070300392,,,,13,9,22
,2013,070300393,,,,26,10,36
,2013,070300394,,,,9,10,19
,2013,070300396,,,,35,26,61
,2013,070300397,,,,19,18,37
,2013,070300398,,,,14,14,28
,2013,070300401,,,,14,9,23
,2013,070300402,,,,25,18,43
,2013,070300403,,,,34,23,57
,2013,070300404,,,,32,31,63
,2013,070300405,,,,22,25,47
,2013,070300406,,,,23,22,45
,2013,070300407,,,,26,27,53
,2013,070300408,,,,213,261,474
,2013,070300409,,,,29,31,60
,2013,070300410,,,,20,10,30
,2013,070300412,,,,53,48,101
,2013,070300413,,,,20,16,36
,2013,070300415,,,,14,15,29
,2013,070300416,,,,13,16,29
,2013,070300417,,,,5,8,13
,2013,070300418,,,,27,29,56
,2013,070300419,,,,13,13,26
,2013,070300420,,,,17,20,37
,2013,070300422,,,,85,88,173
,2013,070300423,,,,31,39,70
,2013,070300424,,,,21,16,37
,2013,070300424,,,,13,7,20
,2013,070300424,,,,110,133,243
,2013,070300425,,,,256,246,502
,2013,070300426,,,,206,256,462
,2013,070300427,,,,43,41,84
,2013,070300430,,,,35,27,62
,2013,070300438,,,,14,10,24
,2013,070300518,,,,9,6,15
,2013,070300520,,,,26,19,45
,2013,070300524,,,,20,39,59
,2013,070300527,,,,15,12,27
,2013,070300528,,,,28,44,72
,2013,070300528,,,,14,17,31
,2013,070300528,,,,16,21,37
,2013,070300529,,,,72,119,191
,2013,070300529,,,,35,35,70
,2013,070300530,,,,13,12,25
,2013,070300531,,,,24,16,40
,2013,070300533,,,,33,20,53
,2013,070300536,,,,10,8,18
,2013,070300538,,,,15,7,22
,2013,070300539,,,,13,9,22
,2013,070300540,,,,5,9,14
,2013,070300541,,,,14,15,29
,2013,070300541,,,,13,9,22
,2013,070300543,,,,5,8,13
,2013,070300544,,,,25,24,49
,2013,070300545,,,,34,32,66
,2013,070300546,,,,19,19,38
,2013,070300547,,,,52,57,109
,2013,070300548,,,,48,57,105
,2013,070300550,,,,7,11,18
,2013,070300551,,,,10,11,21
,2013,070300552,,,,26,27,53
,2013,070300553,,,,26,34,60
,2013,070300555,,,,8,5,13
,2013,070300557,,,,23,47,70
,2013,070300558,,,,20,12,32
,2013,070300559,,,,18,20,38
,2013,070300560,,,,16,17,33
,2013,070300560,,,,4,3,7
,2013,070300563,,,,3,4,7
,2013,070300567,,,,2,5,7
,2013,070300570,,,,3,5,8
,2013,070300572,,,,4,4,8
,2013,070300575,,,,3,2,5
,2013,070300576,,,,6,2,8
,2013,070300578,,,,2,5,7
,2013,070300580,,,,11,9,20
,2013,070300581,,,,10,11,21
,2013,070300583,,,,28,21,49
,2013,070300584,,,,20,22,42
,2013,070300585,,,,9,14,23
,2013,070300587,,,,11,14,25
,2013,070300588,,,,26,12,38
,2013,070300588,,,,3,2,5
,2013,070300589,,,,12,9,21
,2013,070300590,,,,19,21,40
,2013,070300591,,,,9,6,15
,2013,070300592,,,,13,12,25
,2013,070300593,,,,5,7,12
,2013,070300594,,,,3,7,10
,2013,070300599,,,,3,4,7
,2013,070300602,,,,3,2,5
,2013,070300604,,,,6,2,8
,2013,070300605,,,,2,5,7
,2013,070300606,,,,2,3,5
,2013,070300607,,,,5,7,12
,2013,070300608,,,,5,4,9
,2013,070300611,,,,3,5,8
,2013,070300614,,,,2,4,6
,2013,070300617,,,,1,7,8
,2013,070300619,,,,5,3,8
,2013,070300620,,,,1,4,5
,2013,070300622,,,,2,3,5
,2013,070300623,,,,6,4,10
,2013,070300625,,,,7,6,13
,2013,070300627,,,,2,3,5
,2013,070300628,,,,5,9,14
,2013,070300629,,,,5,2,7
,2013,070300631,,,,6,5,11
,2013,070300632,,,,10,12,22
,2013,070300633,,,,19,15,34
,2013,070300633,,,,12,8,20
,2013,070300636,,,,7,9,16
,2013,070300637,,,,2,4,6
,2013,070300639,,,,2,3,5
,2013,070300641,,,,3,3,6
,2013,070300643,,,,1,4,5
,2013,070300644,,,,2,3,5
,2013,070300645,,,,4,3,7
,2013,070300647,,,,4,1,5
,2013,070300650,,,,4,1,5
,2013,070300651,,,,4,2,6
,2013,070300652,,,,3,10,13
,2013,070300653,,,,4,5,9
,2013,070300654,,,,2,5,7
,2013,070300655,,,,1,3,4
,2013,070300656,,,,9,4,13
,2013,070300657,,,,5,0,5
,2013,070300658,,,,2,4,6
,2013,070300660,,,,2,4,6
,2013,070300661,,,,5,3,8
,2013,070300662,,,,2,4,6
,2013,070300663,,,,9,1,10
,2013,070300664,,,,3,5,8
,2013,070300665,,,,2,3,5
,2013,070300666,,,,2,5,7
,2013,070300667,,,,3,3,6
,2013,070300669,,,,4,4,8
,2013,070300670,,,,3,2,5
,2013,070300671,,,,3,2,5
,2013,070300679,,,,5,5,10
,2013,070300680,,,,4,5,9
,2013,070300681,,,,7,2,9
,2013,070300682,,,,3,4,7
,2013,070300683,,,,3,5,8
,2013,070300684,,,,2,3,5
,2013,070300685,,,,3,4,7
,2013,070300686,,,,3,2,5
,2013,070300687,,,,6,7,13
,2013,070300688,,,,0,5,5
,2013,070300689,,,,3,2,5
,2013,070300690,,,,6,4,10
,2013,070300691,,,,2,3,5
,2013,070300692,,,,3,4,7
,2013,070300693,,,,6,3,9
,2013,070300696,,,,3,2,5
,2013,070300697,,,,3,2,5
,2013,070300703,,,,9,1,10
,2013,070300704,,,,5,3,8
,2013,070300705,,,,2,3,5
,2013,070300707,,,,3,6,9
,2013,070300710,,,,3,8,11
,2013,070300711,,,,5,5,10
,2013,070300712,,,,3,6,9
,2013,070300713,,,,5,2,7
,2013,070300714,,,,2,3,5
,2013,070300715,,,,6,3,9
,2013,070300718,,,,1,4,5
,2013,070300722,,,,9,9,18
,2013,070300723,,,,1,4,5
,2013,070300725,,,,5,6,11
,2013,070300729,,,,2,5,7
,2013,070300730,,,,24,14,38
,2013,070300731,,,,3,10,13
,2013,070300732,,,,10,1,11
,2013,070300733,,,,68,78,146
,2013,070300734,,,,5,2,7
,2013,070300736,,,,3,3,6
,2013,070300737,,,,3,3,6
,2013,070300738,,,,3,2,5
,2013,070300739,,,,8,5,13
,2013,070300740,,,,4,3,7
,2013,070300741,,,,4,3,7
,2013,070300742,,,,2,3,5
,2013,070300743,,,,6,2,8
,2013,070300744,,,,6,4,10
,2013,070300745,,,,6,4,10
,2013,070300748,,,,10,3,13
,2013,070300749,,,,11,13,24
,2013,070300750,,,,10,12,22
,2013,070300751,,,,8,7,15
,2013,070300752,,,,7,8,15
,2013,070300753,,,,2,5,7
,2013,070300755,,,,7,2,9
,2013,070300758,,,,3,3,6
,2013,070300759,,,,4,6,10
,2013,070300760,,,,4,1,5
,2013,070300761,,,,2,5,7
,2013,070300762,,,,3,2,5
,2013,070300763,,,,5,8,13
,2013,070300765,,,,1,4,5
,2013,070300766,,,,3,5,8
,2013,070300767,,,,2,4,6
,2013,070300768,,,,3,3,6
,2013,070300769,,,,3,4,7
,2013,070300770,,,,4,5,9
,2013,070300771,,,,2,3,5
,2013,070300772,,,,2,3,5
,2013,070300773,,,,2,3,5
,2013,070300774,,,,3,4,7
,2013,070300776,,,,4,5,9
,2013,070300777,,,,5,9,14
,2013,070300778,,,,6,5,11
,2013,070300780,,,,3,5,8
,2013,070300781,,,,3,3,6
,2013,070300814,,,,19,24,43
,2013,070400002,,,,14,13,27
,2013,070400003,,,,203,187,390
,2013,070400004,,,,9,6,15
,2013,070400005,,,,38,42,80
,2013,070400006,,,,28,15,43
,2013,070400007,,,,24,14,38
,2013,070400008,,,,28,31,59
,2013,070400009,,,,44,37,81
,2013,070400010,,,,20,22,42
,2013,070400011,,,,36,31,67
,2013,070400012,,,,10,13,23
,2013,070400012,,,,2,2,4
,2013,070400013,,,,27,18,45
,2013,070400014,,,,34,22,56
,2013,070400015,,,,347,337,684
,2013,070400016,,,,34,23,57
,2013,070400017,,,,22,12,34
,2013,070400017,,,,4,2,6
,2013,070400018,,,,36,27,63
,2013,070400019,,,,25,22,47
,2013,070400020,,,,35,26,61
,2013,070400021,,,,63,61,124
,2013,070400022,,,,37,31,68
,2013,070400023,,,,27,25,52
,2013,070400025,,,,44,45,89
,2013,070400026,,,,28,25,53
,2013,070400027,,,,29,19,48
,2013,070400028,,,,48,43,91
,2013,070400029,,,,97,106,203
,2013,070400030,,,,95,67,162
,2013,070400030,,,,6,5,11
,2013,070400031,,,,44,40,84
,2013,070400032,,,,212,190,402
,2013,070400033,,,,111,93,204
,2013,070400034,,,,97,85,182
,2013,070400034,,,,19,15,34
,2013,070400035,,,,184,179,363
,2013,070400036,,,,93,92,185
,2013,070400037,,,,58,54,112
,2013,070400038,,,,23,17,40
,2013,070400039,,,,21,18,39
,2013,070400040,,,,243,238,481
,2013,070400041,,,,56,38,94
,2013,070400043,,,,17,18,35
,2013,070400044,,,,22,19,41
,2013,070400045,,,,23,16,39
,2013,070400046,,,,25,17,42
,2013,070400047,,,,420,428,848
,2013,070400048,,,,19,14,33
,2013,070400049,,,,16,11,27
,2013,070400050,,,,26,24,50
,2013,070400051,,,,17,27,44
,2013,070400052,,,,24,24,48
,2013,070400053,,,,9,11,20
,2013,070400054,,,,15,10,25
,2013,070400056,,,,20,23,43
,2013,070400057,,,,10,18,28
,2013,070400059,,,,68,61,129
,2013,070400060,,,,30,23,53
,2013,070400062,,,,24,38,62
,2013,070400063,,,,24,23,47
,2013,070400064,,,,24,29,53
,2013,070400065,,,,10,5,15
,2013,070400065,,,,39,19,58
,2013,070400066,,,,6,9,15
,2013,070400067,,,,12,8,20
,2013,070400069,,,,27,24,51
,2013,070400071,,,,110,102,212
,2013,070400073,,,,36,41,77
,2013,070400074,,,,8,7,15
,2013,070400076,,,,2,2,4
,2013,070400077,,,,15,13,28
,2013,070400078,,,,10,8,18
,2013,070400080,,,,12,11,23
,2013,070400081,,,,14,10,24
,2013,070400081,,,,3,2,5
,2013,070400082,,,,6,6,12
,2013,070400082,,,,9,15,24
,2013,070400083,,,,18,12,30
,2013,070400085,,,,8,4,12
,2013,070400087,,,,6,9,15
,2013,070400088,,,,111,87,198
,2013,070400090,,,,24,20,44
,2013,070400091,,,,22,27,49
,2013,070400092,,,,31,31,62
,2013,070400093,,,,25,28,53
,2013,070400094,,,,5,8,13
,2013,070400095,,,,18,15,33
,2013,070400096,,,,18,11,29
,2013,070400098,,,,20,13,33
,2013,070400099,,,,10,13,23
,2013,070400100,,,,46,36,82
,2013,070400100,,,,8,6,14
,2013,070400101,,,,22,27,49
,2013,070400102,,,,20,16,36
,2013,070400103,,,,36,21,57
,2013,070400104,,,,30,16,46
,2013,070400104,,,,2,5,7
,2013,070400106,,,,27,32,59
,2013,070400107,,,,39,25,64
,2013,070400112,,,,26,33,59
,2013,070400113,,,,8,12,20
,2013,070400117,,,,1130,1024,2154
,2013,070400118,,,,50,38,88
,2013,070400119,,,,41,51,92
,2013,070400120,,,,22,13,35
,2013,070400121,,,,10,17,27
,2013,070400122,,,,25,23,48
,2013,070400123,,,,7,9,16
,2013,070400124,,,,4,8,12
,2013,070400126,,,,53,53,106
,2013,070400126,,,,18,22,40
,2013,070400126,,,,10,15,25
,2013,070400127,,,,11,12,23
,2013,070400128,,,,5,5,10
,2013,070400129,,,,222,303,525
,2013,070400130,,,,10,7,17
,2013,070400131,,,,3,5,8
,2013,070400132,,,,3,2,5
,2013,070400136,,,,2,2,4
,2013,070400137,,,,2,5,7
,2013,070400138,,,,4,8,12
,2013,070400183,,,,7,6,13
,2013,070400200,,,,5,5,10
,2013,070400201,,,,5,2,7
,2013,070400204,,,,7,6,13
,2013,070400205,,,,4,3,7
,2013,070400207,,,,4,1,5
,2013,070400208,,,,380,609,989
,2013,070400209,,,,28,17,45
,2013,070400211,,,,1,4,5
,2013,070400219,,,,4,4,8
,2013,070400223,,,,6,9,15
,2013,070400224,,,,13,10,23
,2013,070400225,,,,9,11,20
,2013,070400225,,,,54,81,135
,2013,070400225,,,,73,55,128
,2013,070400225,,,,74,84,158
,2013,070400227,,,,7,7,14
,2013,070400228,,,,4,1,5
,2013,070400229,,,,3,3,6
,2013,070400230,,,,4,3,7
,2013,070400231,,,,12,28,40
,2013,070400231,,,,58,48,106
,2013,070400233,,,,9,5,14
,2013,070400234,,,,4,3,7
,2013,070400237,,,,2,5,7
,2013,070400238,,,,2,2,4
,2013,070400239,,,,7,3,10
,2013,070400240,,,,2,2,4
,2013,070400241,,,,5,2,7
,2013,070400243,,,,2,3,5
,2013,070400245,,,,8,7,15
,2013,070400246,,,,2,3,5
,2013,070400252,,,,3,2,5
,2013,070400253,,,,5,3,8
,2013,070400254,,,,2,4,6
,2013,070400255,,,,2,1,3
,2013,070400257,,,,1,5,6
,2013,070400259,,,,12,2,14
,2013,070400261,,,,1,3,4
,2013,070400262,,,,3,6,9
,2013,070400263,,,,3,2,5
,2013,070400264,,,,9,7,16
,2013,070400265,,,,1,3,4
,2013,070400266,,,,10,3,13
,2013,070400267,,,,4,1,5
,2013,070400268,,,,4,7,11
,2013,070400279,,,,2,5,7
,2013,070400280,,,,4,5,9
,2013,070400281,,,,3,4,7
,2013,070400282,,,,5,5,10
,2013,070400283,,,,6,1,7
,2013,070400284,,,,6,9,15
,2013,070400285,,,,7,6,13
,2013,070400286,,,,3,2,5
,2013,070400287,,,,3,1,4
,2013,070400288,,,,5,4,9
,2013,070500001,,,,206,196,402
,2013,070500002,,,,58,56,114
,2013,070500003,,,,58,74,132
,2013,070500004,,,,17,16,33
,2013,070500005,,,,18,20,38
,2013,070500006,,,,25,17,42
,2013,070500007,,,,124,155,279
,2013,070500008,,,,7,12,19
,2013,070500009,,,,19,17,36
,2013,070500010,,,,17,11,28
,2013,070500011,,,,31,30,61
,2013,070500012,,,,8,6,14
,2013,070500013,,,,68,62,130
,2013,070500014,,,,4,6,10
,2013,070500015,,,,142,182,324
,2013,070500016,,,,4,4,8
,2013,070500017,,,,14,20,34
,2013,070500018,,,,6,6,12
,2013,070500022,,,,5,7,12
,2013,070500023,,,,10,9,19
,2013,070500024,,,,3,7,10
,2013,070500025,,,,21,20,41
,2013,070500026,,,,30,32,62
,2013,070500042,,,,28,15,43
,2013,070500043,,,,4,5,9
,2013,070500044,,,,7,8,15
,2013,070500045,,,,11,7,18
,2013,070500046,,,,8,4,12
,2013,070500047,,,,3,1,4
,2013,070500048,,,,63,65,128
,2013,070500048,,,,66,67,133
,2013,070500050,,,,4,4,8
,2013,070500051,,,,2,9,11
,2013,070600001,,,,37,29,66
,2013,070600002,,,,155,160,315
,2013,070600003,,,,23,18,41
,2013,070600004,,,,20,16,36
,2013,070600005,,,,13,20,33
,2013,070600006,,,,187,162,349
,2013,070600007,,,,3,3,6
,2013,070600008,,,,4,3,7
,2013,070600009,,,,12,10,22
,2013,070600010,,,,10,6,16
,2013,070700001,,,,17,19,36
,2013,070700004,,,,9,12,21
,2013,070700005,,,,50,34,84
,2013,070700006,,,,16,27,43
,2013,070700007,,,,15,13,28
,2013,070700008,,,,21,19,40
,2013,070700009,,,,24,27,51
,2013,070700010,,,,19,25,44
,2013,070700011,,,,42,17,59
,2013,070700012,,,,43,34,77
,2013,070700013,,,,46,45,91
,2013,070700014,,,,39,36,75
,2013,070700015,,,,8,7,15
,2013,070700016,,,,21,8,29
,2013,070700017,,,,22,17,39
,2013,070700018,,,,38,32,70
,2013,070700019,,,,23,25,48
,2013,070700020,,,,32,34,66
,2013,070700021,,,,20,24,44
,2013,070700022,,,,7,4,11
,2013,070700023,,,,19,17,36
,2013,070700024,,,,31,61,92
,2013,070700025,,,,111,110,221
,2013,070700027,,,,8,14,22
,2013,070700028,,,,110,114,224
,2013,070700029,,,,3,9,12
,2013,070700030,,,,37,35,72
,2013,070700030,,,,5,8,13
,2013,070700031,,,,9,10,19
,2013,070700032,,,,5,10,15
,2013,070700033,,,,8,7,15
,2013,070700033,,,,15,24,39
,2013,070700037,,,,7,9,16
,2013,070700038,,,,21,20,41
,2013,070700079,,,,10,6,16
,2013,070700080,,,,5,7,12
,2013,070700081,,,,3,5,8
,2013,070700084,,,,10,6,16
,2013,070700085,,,,5,6,11
,2013,070700086,,,,5,2,7
,2013,070700087,,,,3,7,10
,2013,070700088,,,,6,0,6
,2013,070700089,,,,9,6,15
,2013,070700091,,,,14,17,31
,2013,070700092,,,,4,3,7
,2013,070700093,,,,6,9,15
,2013,070700094,,,,4,3,7
,2013,070700095,,,,4,3,7
,2013,070700096,,,,8,7,15
,2013,070700097,,,,5,7,12
,2013,070700098,,,,4,4,8
,2013,070700099,,,,5,5,10
,2013,070700100,,,,15,17,32
,2013,070700101,,,,26,21,47
,2013,070700102,,,,6,3,9
,2013,070800001,,,,81,94,175
,2013,070800002,,,,39,49,88
,2013,070800003,,,,62,60,122
,2013,070800004,,,,6,5,11
,2013,070800004,,,,26,24,50
,2013,070800005,,,,20,10,30
,2013,070800006,,,,9,4,13
,2013,070800007,,,,225,235,460
,2013,070800008,,,,50,59,109
,2013,070800009,,,,29,34,63
,2013,070800010,,,,5,10,15
,2013,070800011,,,,35,40,75
,2013,070800012,,,,15,32,47
,2013,070800013,,,,15,18,33
,2013,070800014,,,,3,2,5
,2013,070800015,,,,147,130,277
,2013,070800016,,,,27,29,56
,2013,070800017,,,,14,12,26
,2013,070800018,,,,27,22,49
,2013,070800019,,,,38,48,86
,2013,070800020,,,,21,17,38
,2013,070800021,,,,11,6,17
,2013,070800022,,,,10,8,18
,2013,070800023,,,,49,36,85
,2013,070800024,,,,6,4,10
,2013,070800025,,,,23,11,34
,2013,070800027,,,,32,34,66
,2013,070800028,,,,1,5,6
,2013,070800029,,,,15,6,21
,2013,070800030,,,,42,31,73
,2013,070800030,,,,11,5,16
,2013,070800031,,,,8,10,18
,2013,070800032,,,,13,7,20
,2013,070800032,,,,3,8,11
,2013,070800033,,,,16,19,35
,2013,070800035,,,,6,5,11
,2013,070800037,,,,18,16,34
,2013,070800038,,,,170,184,354
,2013,070800039,,,,106,116,222
,2013,070800039,,,,289,290,579
,2013,070800041,,,,5,5,10
,2013,070800042,,,,6,1,7
,2013,070800043,,,,7,3,10
,2013,070800044,,,,7,1,8
,2013,070800045,,,,16,17,33
,2013,070800047,,,,6,9,15
,2013,070800048,,,,26,17,43
,2013,070800049,,,,6,3,9
,2013,070800050,,,,5,12,17
,2013,070800051,,,,4,2,6
,2013,070800052,,,,5,5,10
,2013,070800058,,,,25,18,43
,2013,070800059,,,,37,48,85
,2013,070800060,,,,8,15,23
,2013,070800061,,,,16,10,26
,2013,070800063,,,,3,5,8
,2013,070800064,,,,2,1,3
,2013,070800065,,,,5,3,8
,2013,070800066,,,,2,6,8
,2013,070800067,,,,6,5,11
,2013,070800068,,,,5,5,10
,2013,070800069,,,,1,6,7
,2013,070800070,,,,8,7,15
,2013,070800071,,,,11,10,21
,2013,070800675,,,,7,4,11
,2013,070800676,,,,8,6,14
,2013,070800677,,,,3,5,8
,2013,070800678,,,,4,2,6
,2013,070800679,,,,4,3,7
,2013,070800681,,,,145,120,265
,2013,070900001,,,,20,21,41
,2013,070900002,,,,111,94,205
,2013,070900003,,,,38,27,65
,2013,070900004,,,,15,23,38
,2013,070900005,,,,36,39,75
,2013,070900006,,,,14,11,25
,2013,070900007,,,,8,9,17
,2013,070900008,,,,42,35,77
,2013,070900009,,,,9,7,16
,2013,070900010,,,,53,32,85
,2013,070900011,,,,24,21,45
,2013,070900012,,,,68,74,142
,2013,070900013,,,,7,7,14
,2013,070900014,,,,32,16,48
,2013,070900016,,,,58,42,100
,2013,070900017,,,,13,9,22
,2013,070900018,,,,7,10,17
,2013,070900019,,,,10,9,19
,2013,070900020,,,,163,170,333
,2013,070900021,,,,18,16,34
,2013,070900022,,,,12,5,17
,2013,070900023,,,,12,4,16
,2013,070900024,,,,7,5,12
,2013,070900025,,,,9,9,18
,2013,070900026,,,,11,20,31
,2013,070900027,,,,7,2,9
,2013,070900028,,,,5,6,11
,2013,070900029,,,,4,4,8
,2013,070900030,,,,1,2,3
,2013,070900044,,,,6,11,17
,2013,070900045,,,,4,2,6
,2013,071000001,,,,19,26,45
,2013,071000002,,,,30,42,72
,2013,071000003,,,,8,5,13
,2013,071000004,,,,87,77,164
,2013,071000005,,,,7,5,12
,2013,071000006,,,,27,18,45
,2013,071000007,,,,73,102,175
,2013,071000008,,,,26,25,51
,2013,071000009,,,,47,34,81
,2013,071000010,,,,20,16,36
,2013,071000011,,,,19,13,32
,2013,071000012,,,,12,9,21
,2013,071000014,,,,7,5,12
,2013,071000015,,,,14,4,18
,2013,071000016,,,,8,6,14
,2013,071000017,,,,6,4,10
,2013,071000018,,,,5,6,11
,2013,071000019,,,,4,3,7
,2013,071000020,,,,10,9,19
,2013,071000021,,,,4,4,8
,2013,071000022,,,,3,11,14
,2013,071000023,,,,5,4,9
,2013,071000024,,,,48,43,91
,2013,071100001,,,,44,48,92
,2013,071100002,,,,129,125,254
,2013,071100003,,,,71,77,148
,2013,071100004,,,,14,22,36
,2013,071100005,,,,19,22,41
,2013,071100006,,,,8,7,15
,2013,071100007,,,,4,11,15
,2013,071100008,,,,21,19,40
,2013,071100009,,,,43,32,75
,2013,071100010,,,,38,46,84
,2013,071100011,,,,8,7,15
,2013,071100012,,,,13,15,28
,2013,071100013,,,,41,24,65
,2013,071100014,,,,7,5,12
,2013,071100015,,,,39,28,67
,2013,071100015,,,,8,7,15
,2013,071100016,,,,17,11,28
,2013,071100017,,,,9,12,21
,2013,071100018,,,,92,67,159
,2013,071100020,,,,10,13,23
,2013,071100023,,,,14,10,24
,2013,071100024,,,,4,5,9
,2013,071100025,,,,16,19,35
,2013,071100026,,,,7,3,10
,2013,071100027,,,,9,8,17
,2013,071100028,,,,2,5,7
,2013,071100030,,,,1,4,5
,2013,071100030,,,,15,15,30
,2013,071100031,,,,9,4,13
,2013,071100032,,,,8,6,14
,2013,071100034,,,,4,3,7
,2013,071100064,,,,5,7,12
,2013,071100065,,,,2,4,6
,2013,071100066,,,,4,3,7
,2013,071200001,,,,104,79,183
,2013,071200002,,,,10,10,20
,2013,071200003,,,,29,16,45
,2013,071200004,,,,105,102,207
,2013,071200005,,,,36,24,60
,2013,071200006,,,,29,24,53
,2013,071200007,,,,28,32,60
,2013,071200008,,,,116,132,248
,2013,071200009,,,,19,21,40
,2013,071200010,,,,36,36,72
,2013,071200011,,,,7,5,12
,2013,071200012,,,,16,13,29
,2013,071200013,,,,26,26,52
,2013,071200014,,,,22,24,46
,2013,071200015,,,,23,20,43
,2013,071200016,,,,8,6,14
,2013,071200017,,,,93,116,209
,2013,071200018,,,,11,8,19
,2013,071200019,,,,15,10,25
,2013,071200027,,,,24,26,50
,2013,071200028,,,,16,16,32
,2013,071200029,,,,28,23,51
,2013,071200029,,,,2,5,7
,2013,071200032,,,,4,10,14
,2013,071200033,,,,6,7,13
,2013,071200034,,,,8,10,18
,2013,071200035,,,,8,12,20
,2013,071200037,,,,5,10,15
,2013,071200038,,,,28,18,46
,2013,071200074,,,,5,2,7
,2013,071200075,,,,5,13,18
,2013,071200076,,,,5,4,9
,2013,071200077,,,,3,2,5
,2013,071200078,,,,2,3,5
,2013,071200079,,,,3,2,5
,2013,071200080,,,,6,6,12
,2013,071200082,,,,7,1,8
,2013,071200083,,,,5,3,8
,2013,071200084,,,,6,11,17
,2013,071200084,,,,6,11,17
,2013,071300001,,,,166,133,299
,2013,071300002,,,,20,23,43
,2013,071300003,,,,42,43,85
,2013,071300004,,,,35,24,59
,2013,071300005,,,,16,21,37
,2013,071300006,,,,6,6,12
,2013,071300007,,,,29,26,55
,2013,071300008,,,,9,10,19
,2013,071300009,,,,10,8,18
,2013,071300010,,,,3,5,8
,2013,071300011,,,,9,4,13
,2013,071300012,,,,10,5,15
,2013,071300015,,,,37,33,70
,2013,071300016,,,,21,13,34
,2013,071300018,,,,14,30,44
,2013,071300019,,,,3,4,7
,2013,071300020,,,,5,3,8
,2013,071300021,,,,3,1,4
,2013,071400001,,,,62,49,111
,2013,071400002,,,,25,20,45
,2013,071400003,,,,78,68,146
,2013,071400004,,,,21,16,37
,2013,071400005,,,,24,34,58
,2013,071400006,,,,10,5,15
,2013,071400007,,,,59,46,105
,2013,071400008,,,,58,45,103
,2013,071400009,,,,58,43,101
,2013,071400010,,,,23,20,43
,2013,071400011,,,,54,68,122
,2013,071400012,,,,63,77,140
,2013,071400013,,,,5,8,13
,2013,071400014,,,,8,9,17
,2013,071400015,,,,5,7,12
,2013,071400016,,,,14,14,28
,2013,071400017,,,,17,11,28
,2013,071400019,,,,7,7,14
,2013,071400020,,,,19,18,37
,2013,071400021,,,,21,19,40
,2013,071400022,,,,15,14,29
,2013,071400023,,,,4,7,11
,2013,071400024,,,,25,25,50
,2013,071400025,,,,11,11,22
,2013,071400026,,,,112,102,214
,2013,071400027,,,,11,8,19
,2013,071400028,,,,16,16,32
,2013,071400029,,,,3,5,8
,2013,071400030,,,,13,14,27
,2013,071400031,,,,8,7,15
,2013,071400032,,,,17,13,30
,2013,071400033,,,,9,3,12
,2013,071400034,,,,11,4,15
,2013,071400035,,,,6,9,15
,2013,071400036,,,,138,93,231
,2013,071400037,,,,6,2,8
,2013,071400039,,,,9,6,15
,2013,071400040,,,,5,7,12
,2013,071400041,,,,7,9,16
,2013,071400042,,,,1,5,6
,2013,071400043,,,,4,6,10
,2013,071400044,,,,15,10,25
,2013,071400045,,,,21,9,30
,2013,071400046,,,,12,9,21
,2013,071400047,,,,19,12,31
,2013,071400049,,,,6,7,13
,2013,071400050,,,,6,8,14
,2013,071400052,,,,6,7,13
,2013,071400053,,,,8,4,12
,2013,071400089,,,,4,5,9
,2013,071400091,,,,3,5,8
,2013,071400092,,,,15,15,30
,2013,071400093,,,,1,5,6
,2013,071500006,,,,3,7,10
,2013,071500006,,,,23,10,33
,2013,071500007,,,,7,7,14
,2013,071500008,,,,15,11,26
,2013,071500009,,,,25,11,36
,2013,071500010,,,,8,7,15
,2013,071500011,,,,15,17,32
,2013,071500012,,,,15,15,30
,2013,071500013,,,,23,17,40
,2013,071500013,,,,0,3,3
,2013,071500014,,,,16,12,28
,2013,071500015,,,,10,9,19
,2013,071500016,,,,26,21,47
,2013,071500017,,,,2,5,7
,2013,071500017,,,,39,38,77
,2013,071500018,,,,28,32,60
,2013,071500019,,,,13,7,20
,2013,071500020,,,,32,38,70
,2013,071500021,,,,29,22,51
,2013,071500022,,,,31,31,62
,2013,071500023,,,,27,18,45
,2013,071500024,,,,18,12,30
,2013,071500025,,,,11,17,28
,2013,071500026,,,,4,6,10
,2013,071500027,,,,4,6,10
,2013,071500028,,,,14,12,26
,2013,071500030,,,,6,5,11
,2013,071500031,,,,12,12,24
,2013,071500032,,,,45,35,80
,2013,071500033,,,,8,10,18
,2013,071500034,,,,72,70,142
,2013,071500035,,,,7,10,17
,2013,071500036,,,,30,26,56
,2013,071500037,,,,14,14,28
,2013,071500038,,,,32,24,56
,2013,071500039,,,,10,12,22
,2013,071500039,,,,3,5,8
,2013,071500040,,,,7,10,17
,2013,071500041,,,,9,19,28
,2013,071500042,,,,7,5,12
,2013,071500043,,,,10,10,20
,2013,071500044,,,,28,26,54
,2013,071500045,,,,12,14,26
,2013,071500046,,,,6,8,14
,2013,071500047,,,,11,9,20
,2013,071500048,,,,5,6,11
,2013,071500049,,,,14,15,29
,2013,071500050,,,,9,7,16
,2013,071500051,,,,29,18,47
,2013,071500052,,,,6,11,17
,2013,071500053,,,,15,10,25
,2013,071500054,,,,5,7,12
,2013,071500055,,,,33,33,66
,2013,071500056,,,,3,5,8
,2013,071500057,,,,21,15,36
,2013,071500058,,,,5,7,12
,2013,071500058,,,,4,7,11
,2013,071500059,,,,43,47,90
,2013,071500060,,,,16,11,27
,2013,071500061,,,,7,2,9
,2013,071500062,,,,17,12,29
,2013,071500063,,,,8,8,16
,2013,071500064,,,,16,17,33
,2013,071500065,,,,14,11,25
,2013,071500066,,,,16,17,33
,2013,071500067,,,,15,17,32
,2013,071500068,,,,12,9,21
,2013,071500069,,,,25,26,51
,2013,071500070,,,,15,9,24
,2013,071500071,,,,26,27,53
,2013,071500072,,,,12,12,24
,2013,071500074,,,,43,36,79
,2013,071500075,,,,30,24,54
,2013,071500076,,,,12,10,22
,2013,071500078,,,,10,9,19
,2013,071500079,,,,15,13,28
,2013,071500081,,,,4,5,9
,2013,071500082,,,,25,37,62
,2013,071500083,,,,36,30,66
,2013,071500084,,,,16,16,32
,2013,071500085,,,,337,412,749
,2013,071500086,,,,7,10,17
,2013,071500088,,,,24,21,45
,2013,071500089,,,,14,12,26
,2013,071500091,,,,14,14,28
,2013,071500093,,,,13,9,22
,2013,071500094,,,,29,27,56
,2013,071500095,,,,11,15,26
,2013,071500097,,,,15,5,20
,2013,071500098,,,,12,11,23
,2013,071500099,,,,7,11,18
,2013,071500100,,,,19,13,32
,2013,071500101,,,,9,7,16
,2013,071500102,,,,15,18,33
,2013,071500103,,,,5,7,12
,2013,071500104,,,,11,14,25
,2013,071500105,,,,12,7,19
,2013,071500106,,,,4,4,8
,2013,071500107,,,,27,24,51
,2013,071500108,,,,15,15,30
,2013,071500109,,,,13,11,24
,2013,071500111,,,,3,4,7
,2013,071500113,,,,9,3,12
,2013,071500114,,,,11,9,20
,2013,071500115,,,,15,6,21
,2013,071500116,,,,3,2,5
,2013,071500117,,,,8,8,16
,2013,071500118,,,,7,12,19
,2013,071500120,,,,6,8,14
,2013,071500121,,,,10,7,17
,2013,071500122,,,,14,10,24
,2013,071500125,,,,23,22,45
,2013,071500126,,,,16,10,26
,2013,071500127,,,,16,14,30
,2013,071500128,,,,29,16,45
,2013,071500129,,,,14,10,24
,2013,071500130,,,,17,27,44
,2013,071500131,,,,10,10,20
,2013,071500132,,,,13,9,22
,2013,071500133,,,,7,7,14
,2013,071500134,,,,36,34,70
,2013,071500136,,,,8,12,20
,2013,071500137,,,,2,2,4
,2013,071500137,,,,4,5,9
,2013,071500138,,,,10,8,18
,2013,071500139,,,,5,5,10
,2013,071500140,,,,13,8,21
,2013,071500141,,,,17,12,29
,2013,071500142,,,,6,8,14
,2013,071500147,,,,4,6,10
,2013,071500151,,,,4,5,9
,2013,071500159,,,,6,5,11
,2013,071500169,,,,4,1,5
,2013,071500188,,,,2,7,9
,2013,071500223,,,,4,6,10
,2013,071500223,,,,9,5,14
,2013,071500225,,,,8,11,19
,2013,071500226,,,,17,14,31
,2013,071500227,,,,10,7,17
,2013,071500229,,,,21,13,34
,2013,071500230,,,,9,5,14
,2013,071500231,,,,11,5,16
,2013,071500232,,,,14,9,23
,2013,071500233,,,,16,15,31
,2013,071500234,,,,17,10,27
,2013,071500235,,,,7,11,18
,2013,071500236,,,,5,3,8
,2013,071500237,,,,2,6,8
,2013,071500239,,,,4,6,10
,2013,071500240,,,,2,2,4
,2013,071500241,,,,3,6,9
,2013,071500246,,,,22,23,45
,2013,071500247,,,,11,13,24
,2013,071500249,,,,7,6,13
,2013,071500252,,,,5,2,7
,2013,071500255,,,,3,4,7
,2013,071500256,,,,3,5,8
,2013,071500257,,,,2,3,5
,2013,071500258,,,,3,6,9
,2013,071500260,,,,8,8,16
,2013,071500261,,,,5,6,11
,2013,071500262,,,,4,7,11
,2013,071500263,,,,3,5,8
,2013,071500264,,,,9,4,13
,2013,071500265,,,,5,4,9
,2013,071500266,,,,6,3,9
,2013,071500267,,,,3,2,5
,2013,071500269,,,,2,5,7
,2013,071500269,,,,6,2,8
,2013,071500272,,,,3,1,4
,2013,071500274,,,,1,3,4
,2013,071500275,,,,3,6,9
,2013,071500276,,,,4,3,7
,2013,071500278,,,,5,2,7
,2013,071500279,,,,3,6,9
,2013,071500281,,,,8,2,10
,2013,071500282,,,,5,6,11
,2013,071500283,,,,4,3,7
,2013,071500284,,,,4,7,11
,2013,071500285,,,,3,3,6
,2013,071500286,,,,6,3,9
,2013,071500289,,,,5,5,10
,2013,071500290,,,,2,4,6
,2013,071500291,,,,7,4,11
,2013,071500292,,,,3,3,6
,2013,071500293,,,,4,3,7
,2013,071500295,,,,4,5,9
,2013,071500299,,,,4,3,7
,2013,071500300,,,,8,4,12
,2013,071500301,,,,3,1,4
,2013,071500302,,,,4,5,9
,2013,071500303,,,,3,3,6
,2013,071500304,,,,2,5,7
,2013,071500305,,,,4,5,9
,2013,071500306,,,,1,2,3
,2013,071500307,,,,2,6,8
,2013,071500308,,,,7,1,8
,2013,071500309,,,,2,4,6
,2013,071500310,,,,2,4,6
,2013,071500311,,,,1,5,6
,2013,071500312,,,,4,4,8
,2013,071500313,,,,4,3,7
,2013,071500314,,,,4,5,9
,2013,071500315,,,,4,5,9
,2013,071500316,,,,1,7,8
,2013,071500317,,,,6,5,11
,2013,071500321,,,,4,6,10
,2013,071500322,,,,5,6,11
,2013,071500323,,,,5,8,13
,2013,071600001,,,,9,16,25
,2013,071600002,,,,8,9,17
,2013,071600003,,,,37,31,68
,2013,071600004,,,,22,31,53
,2013,071600005,,,,33,30,63
,2013,071600006,,,,20,15,35
,2013,071600007,,,,42,36,78
,2013,071600008,,,,38,43,81
,2013,071600009,,,,29,35,64
,2013,071600010,,,,4,4,8
,2013,071600011,,,,119,126,245
,2013,071600012,,,,11,3,14
,2013,071600013,,,,7,5,12
,2013,071600014,,,,11,18,29
,2013,071600015,,,,32,42,74
,2013,071600016,,,,24,19,43
,2013,071600017,,,,131,126,257
,2013,071600018,,,,47,36,83
,2013,071600019,,,,26,20,46
,2013,071600020,,,,5,2,7
,2013,071600021,,,,24,37,61
,2013,071600022,,,,40,44,84
,2013,071600023,,,,18,9,27
,2013,071600024,,,,18,19,37
,2013,071600025,,,,19,18,37
,2013,071600026,,,,36,42,78
,2013,071600027,,,,29,21,50
,2013,071600028,,,,37,27,64
,2013,071600029,,,,121,102,223
,2013,071600030,,,,7,10,17
,2013,071600031,,,,10,11,21
,2013,071600032,,,,28,22,50
,2013,071600034,,,,13,7,20
,2013,071600035,,,,4,8,12
,2013,071600036,,,,4,5,9
,2013,071600037,,,,4,11,15
,2013,071600039,,,,7,9,16
,2013,071600043,,,,14,23,37
,2013,071600044,,,,30,34,64
,2013,071600045,,,,8,12,20
,2013,071600046,,,,13,14,27
,2013,071600048,,,,10,16,26
,2013,071600049,,,,20,12,32
,2013,071600050,,,,8,11,19
,2013,071600071,,,,9,13,22
,2013,071600072,,,,9,6,15
,2013,071600073,,,,7,6,13
,2013,071600074,,,,2,2,4
,2013,071600075,,,,5,5,10
,2013,071600076,,,,3,5,8
,2013,071600077,,,,7,8,15
,2013,071600078,,,,5,7,12
,2013,071600079,,,,6,4,10
,2013,071600080,,,,7,7,14
,2013,071600082,,,,4,3,7
,2013,071600084,,,,1,4,5
,2013,071600088,,,,2,3,5
,2013,071600089,,,,3,5,8
,2013,071600091,,,,4,1,5
,2013,071600092,,,,4,1,5
,2013,071600093,,,,15,11,26
,2013,071600094,,,,2,3,5
,2013,071700001,,,,79,62,141
,2013,071700002,,,,23,19,42
,2013,071700003,,,,46,45,91
,2013,071700004,,,,21,16,37
,2013,071700005,,,,32,23,55
,2013,071700006,,,,26,25,51
,2013,071700007,,,,9,16,25
,2013,071700009,,,,15,21,36
,2013,071700010,,,,16,14,30
,2013,071700011,,,,17,14,31
,2013,071700012,,,,11,11,22
,2013,071700013,,,,34,32,66
,2013,071700014,,,,39,47,86
,2013,071700015,,,,11,12,23
,2013,071700016,,,,29,34,63
,2013,071700017,,,,30,20,50
,2013,071700018,,,,35,16,51
,2013,071700019,,,,4,4,8
,2013,071700026,,,,6,3,9
,2013,071700028,,,,7,4,11
,2013,071700029,,,,2,5,7
,2013,071700031,,,,4,8,12
,2013,071700033,,,,4,4,8
,2013,071700034,,,,5,4,9
,2013,071700035,,,,2,4,6
,2013,071700036,,,,2,3,5
,2013,071700037,,,,6,2,8
,2013,071700038,,,,2,4,6
,2013,071700039,,,,1,3,4
,2013,071700040,,,,3,2,5
,2013,071800001,,,,78,70,148
,2013,071800002,,,,9,12,21
,2013,071800003,,,,15,10,25
,2013,071800004,,,,35,19,54
,2013,071800005,,,,10,6,16
,2013,071800006,,,,5,5,10
,2013,071800007,,,,8,6,14
,2013,071800008,,,,7,2,9
,2013,071800012,,,,4,5,9
,2013,071900004,,,,340,295,635
,2013,071900005,,,,71,72,143
,2013,071900006,,,,33,29,62
,2013,071900006,,,,6,4,10
,2013,071900007,,,,16,11,27
,2013,071900008,,,,36,30,66
,2013,071900009,,,,6,10,16
,2013,071900010,,,,28,25,53
,2013,071900011,,,,17,10,27
,2013,071900012,,,,40,38,78
,2013,071900012,,,,4,8,12
,2013,071900013,,,,16,14,30
,2013,071900014,,,,45,34,79
,2013,071900015,,,,25,27,52
,2013,071900016,,,,14,14,28
,2013,071900017,,,,27,23,50
,2013,071900018,,,,13,22,35
,2013,071900019,,,,24,16,40
,2013,071900020,,,,49,50,99
,2013,071900021,,,,45,41,86
,2013,071900022,,,,16,17,33
,2013,071900023,,,,14,23,37
,2013,071900024,,,,26,26,52
,2013,071900025,,,,9,9,18
,2013,071900025,,,,6,3,9
,2013,071900026,,,,12,7,19
,2013,071900027,,,,21,31,52
,2013,071900028,,,,84,73,157
,2013,071900029,,,,24,13,37
,2013,071900030,,,,16,13,29
,2013,071900031,,,,25,19,44
,2013,071900033,,,,20,21,41
,2013,071900034,,,,46,47,93
,2013,071900035,,,,35,39,74
,2013,071900036,,,,12,18,30
,2013,071900037,,,,20,19,39
,2013,071900038,,,,41,45,86
,2013,071900038,,,,3,6,9
,2013,071900039,,,,10,5,15
,2013,071900039,,,,57,46,103
,2013,071900040,,,,13,14,27
,2013,071900041,,,,26,24,50
,2013,071900042,,,,21,13,34
,2013,071900043,,,,16,14,30
,2013,071900044,,,,18,20,38
,2013,071900045,,,,46,43,89
,2013,071900046,,,,40,19,59
,2013,071900047,,,,19,27,46
,2013,071900048,,,,16,13,29
,2013,071900049,,,,13,19,32
,2013,071900049,,,,1,6,7
,2013,071900050,,,,47,37,84
,2013,071900051,,,,24,22,46
,2013,071900052,,,,2,3,5
,2013,071900052,,,,13,18,31
,2013,071900053,,,,19,14,33
,2013,071900054,,,,11,12,23
,2013,071900056,,,,79,65,144
,2013,071900057,,,,21,20,41
,2013,071900058,,,,8,13,21
,2013,071900058,,,,50,69,119
,2013,071900059,,,,11,10,21
,2013,071900060,,,,23,30,53
,2013,071900061,,,,31,43,74
,2013,071900062,,,,41,51,92
,2013,071900063,,,,17,25,42
,2013,071900064,,,,16,16,32
,2013,071900065,,,,13,12,25
,2013,071900066,,,,15,11,26
,2013,071900067,,,,8,9,17
,2013,071900068,,,,161,193,354
,2013,071900068,,,,11,4,15
,2013,071900069,,,,21,33,54
,2013,071900070,,,,4,2,6
,2013,071900070,,,,24,10,34
,2013,071900071,,,,29,35,64
,2013,071900072,,,,16,12,28
,2013,071900074,,,,23,26,49
,2013,071900075,,,,20,14,34
,2013,071900076,,,,16,17,33
,2013,071900076,,,,1,4,5
,2013,071900077,,,,4,10,14
,2013,071900078,,,,21,22,43
,2013,071900079,,,,21,24,45
,2013,071900080,,,,24,26,50
,2013,071900081,,,,16,11,27
,2013,071900082,,,,34,25,59
,2013,071900083,,,,12,21,33
,2013,071900084,,,,37,32,69
,2013,071900085,,,,11,11,22
,2013,071900086,,,,7,11,18
,2013,071900087,,,,17,24,41
,2013,071900088,,,,31,23,54
,2013,071900089,,,,21,7,28
,2013,071900090,,,,6,15,21
,2013,071900091,,,,3,6,9
,2013,071900093,,,,11,7,18
,2013,071900094,,,,110,124,234
,2013,071900094,,,,7,10,17
,2013,071900095,,,,40,30,70
,2013,071900096,,,,5,5,10
,2013,071900097,,,,9,11,20
,2013,071900098,,,,4,1,5
,2013,071900099,,,,14,13,27
,2013,071900100,,,,13,16,29
,2013,071900101,,,,6,9,15
,2013,071900101,,,,6,9,15
,2013,071900103,,,,13,8,21
,2013,071900104,,,,10,7,17
,2013,071900105,,,,5,1,6
,2013,071900109,,,,10,10,20
,2013,071900110,,,,17,16,33
,2013,071900110,,,,5,6,11
,2013,071900111,,,,25,8,33
,2013,071900112,,,,34,20,54
,2013,071900113,,,,9,15,24
,2013,071900114,,,,21,23,44
,2013,071900115,,,,25,25,50
,2013,071900116,,,,16,4,20
,2013,071900117,,,,27,23,50
,2013,071900118,,,,8,5,13
,2013,071900120,,,,15,20,35
,2013,071900121,,,,39,46,85
,2013,071900122,,,,44,40,84
,2013,071900123,,,,19,14,33
,2013,071900124,,,,3,3,6
,2013,071900124,,,,34,25,59
,2013,071900125,,,,27,32,59
,2013,071900126,,,,27,20,47
,2013,071900128,,,,35,29,64
,2013,071900129,,,,31,21,52
,2013,071900130,,,,14,10,24
,2013,071900131,,,,26,25,51
,2013,071900132,,,,3,3,6
,2013,071900134,,,,32,20,52
,2013,071900135,,,,33,25,58
,2013,071900136,,,,23,23,46
,2013,071900137,,,,5,10,15
,2013,071900138,,,,5,15,20
,2013,071900139,,,,33,26,59
,2013,071900140,,,,26,24,50
,2013,071900141,,,,19,24,43
,2013,071900142,,,,10,13,23
,2013,071900143,,,,23,25,48
,2013,071900144,,,,21,31,52
,2013,071900146,,,,10,11,21
,2013,071900148,,,,9,7,16
,2013,071900149,,,,40,40,80
,2013,071900150,,,,33,34,67
,2013,071900151,,,,15,22,37
,2013,071900152,,,,26,28,54
,2013,071900153,,,,24,20,44
,2013,071900154,,,,16,7,23
,2013,071900155,,,,38,30,68
,2013,071900155,,,,5,14,19
,2013,071900158,,,,22,11,33
,2013,071900159,,,,10,23,33
,2013,071900160,,,,21,13,34
,2013,071900161,,,,24,21,45
,2013,071900162,,,,20,14,34
,2013,071900163,,,,18,9,27
,2013,071900164,,,,12,18,30
,2013,071900165,,,,6,9,15
,2013,071900166,,,,21,33,54
,2013,071900167,,,,20,32,52
,2013,071900168,,,,28,35,63
,2013,071900169,,,,22,15,37
,2013,071900170,,,,29,15,44
,2013,071900171,,,,31,39,70
,2013,071900172,,,,358,451,809
,2013,071900172,,,,155,138,293
,2013,071900173,,,,16,27,43
,2013,071900174,,,,29,25,54
,2013,071900175,,,,22,19,41
,2013,071900176,,,,21,12,33
,2013,071900177,,,,17,14,31
,2013,071900179,,,,28,22,50
,2013,071900180,,,,15,17,32
,2013,071900181,,,,18,10,28
,2013,071900182,,,,18,21,39
,2013,071900183,,,,16,13,29
,2013,071900184,,,,30,21,51
,2013,071900228,,,,2,7,9
,2013,071900241,,,,15,8,23
,2013,071900242,,,,7,5,12
,2013,071900242,,,,31,28,59
,2013,071900243,,,,16,8,24
,2013,071900244,,,,30,27,57
,2013,071900246,,,,15,16,31
,2013,071900247,,,,12,11,23
,2013,071900248,,,,24,12,36
,2013,071900249,,,,13,10,23
,2013,071900252,,,,16,7,23
,2013,071900258,,,,15,8,23
,2013,071900260,,,,22,23,45
,2013,071900263,,,,18,18,36
,2013,071900264,,,,15,11,26
,2013,071900265,,,,11,12,23
,2013,071900266,,,,39,42,81
,2013,071900266,,,,1,3,4
,2013,071900267,,,,4,1,5
,2013,071900268,,,,6,4,10
,2013,071900277,,,,5,3,8
,2013,071900278,,,,2,4,6
,2013,071900281,,,,22,22,44
,2013,071900282,,,,25,16,41
,2013,071900283,,,,19,23,42
,2013,071900284,,,,11,13,24
,2013,071900285,,,,2,5,7
,2013,071900288,,,,105,101,206
,2013,071900289,,,,2,3,5
,2013,071900290,,,,4,1,5
,2013,071900294,,,,1,4,5
,2013,071900295,,,,3,2,5
,2013,071900297,,,,2,2,4
,2013,071900298,,,,5,3,8
,2013,071900299,,,,2,5,7
,2013,071900300,,,,6,3,9
,2013,071900301,,,,2,5,7
,2013,071900305,,,,6,3,9
,2013,071900307,,,,5,6,11
,2013,071900308,,,,2,3,5
,2013,071900309,,,,4,1,5
,2013,071900310,,,,5,4,9
,2013,071900311,,,,4,1,5
,2013,071900312,,,,6,4,10
,2013,071900313,,,,2,7,9
,2013,071900314,,,,5,2,7
,2013,071900316,,,,6,4,10
,2013,071900317,,,,5,4,9
,2013,071900318,,,,3,1,4
,2013,071900319,,,,9,16,25
,2013,071900320,,,,25,17,42
,2013,071900323,,,,11,10,21
,2013,071900324,,,,3,2,5
,2013,071900326,,,,1,4,5
,2013,071900328,,,,3,2,5
,2013,071900329,,,,4,7,11
,2013,071900330,,,,3,3,6
,2013,071900331,,,,3,2,5
,2013,071900332,,,,3,3,6
,2013,071900333,,,,5,4,9
,2013,071900334,,,,3,3,6
,2013,071900335,,,,4,1,5
,2013,071900337,,,,1,4,5
,2013,071900338,,,,2,3,5
,2013,071900339,,,,3,2,5
,2013,071900340,,,,5,2,7
,2013,071900341,,,,2,3,5
,2013,071900342,,,,3,5,8
,2013,071900343,,,,7,4,11
,2013,071900344,,,,4,2,6
,2013,071900345,,,,5,3,8
,2013,080100001,,,,119,99,218
,2013,080100002,,,,72,72,144
,2013,080100003,,,,112,91,203
,2013,080100003,,,,6,8,14
,2013,080100004,,,,11,8,19
,2013,080100005,,,,202,191,393
,2013,080100006,,,,252,233,485
,2013,080100007,,,,24,25,49
,2013,080100008,,,,397,385,782
,2013,080100009,,,,263,288,551
,2013,080100009,,,,244,262,506
,2013,080100009,,,,117,87,204
,2013,080100011,,,,112,104,216
,2013,080100011,,,,18,18,36
,2013,080100012,,,,18,12,30
,2013,080100013,,,,24,20,44
,2013,080100014,,,,39,36,75
,2013,080100015,,,,428,454,882
,2013,080100016,,,,101,127,228
,2013,080100017,,,,390,331,721
,2013,080100018,,,,712,688,1400
,2013,080100019,,,,77,80,157
,2013,080100019,,,,12,15,27
,2013,080100020,,,,5,2,7
,2013,080100020,,,,34,47,81
,2013,080100021,,,,12,9,21
,2013,080100022,,,,168,126,294
,2013,080100023,,,,40,24,64
,2013,080100024,,,,60,54,114
,2013,080100024,,,,12,14,26
,2013,080100025,,,,154,130,284
,2013,080100026,,,,77,65,142
,2013,080100026,,,,4,7,11
,2013,080100027,,,,56,33,89
,2013,080100028,,,,11,7,18
,2013,080100029,,,,56,37,93
,2013,080100030,,,,330,301,631
,2013,080100031,,,,44,39,83
,2013,080100032,,,,10,12,22
,2013,080100033,,,,19,21,40
,2013,080100033,,,,83,77,160
,2013,080100034,,,,42,34,76
,2013,080100035,,,,487,430,917
,2013,080100035,,,,38,26,64
,2013,080100036,,,,18,22,40
,2013,080100038,,,,257,222,479
,2013,080100039,,,,318,285,603
,2013,080100040,,,,22,20,42
,2013,080100040,,,,171,153,324
,2013,080100041,,,,63,64,127
,2013,080100042,,,,12,7,19
,2013,080100043,,,,141,120,261
,2013,080100044,,,,260,206,466
,2013,080100045,,,,144,152,296
,2013,080100045,,,,27,16,43
,2013,080100045,,,,206,247,453
,2013,080100048,,,,22,27,49
,2013,080100049,,,,320,340,660
,2013,080100050,,,,253,265,518
,2013,080100051,,,,321,257,578
,2013,080100052,,,,138,127,265
,2013,080100053,,,,241,221,462
,2013,080100054,,,,302,255,557
,2013,080100055,,,,29,21,50
,2013,080100055,,,,155,183,338
,2013,080100056,,,,159,169,328
,2013,080100057,,,,29,32,61
,2013,080100058,,,,2,4,6
,2013,080100058,,,,12,9,21
,2013,080100059,,,,343,323,666
,2013,080100060,,,,146,135,281
,2013,080100061,,,,329,329,658
,2013,080100062,,,,14,20,34
,2013,080100063,,,,13,31,44
,2013,080100064,,,,245,246,491
,2013,080100064,,,,15,17,32
,2013,080100066,,,,31,29,60
,2013,080100067,,,,22,23,45
,2013,080100069,,,,215,205,420
,2013,080100069,,,,28,52,80
,2013,080100070,,,,5,12,17
,2013,080100070,,,,24,26,50
,2013,080100071,,,,24,17,41
,2013,080100071,,,,473,468,941
,2013,080100072,,,,121,119,240
,2013,080100073,,,,85,69,154
,2013,080100074,,,,96,120,216
,2013,080100075,,,,24,24,48
,2013,080100076,,,,55,55,110
,2013,080100077,,,,90,74,164
,2013,080100078,,,,32,28,60
,2013,080100078,,,,16,10,26
,2013,080100079,,,,61,70,131
,2013,080100079,,,,424,415,839
,2013,080100080,,,,300,316,616
,2013,080100081,,,,19,16,35
,2013,080100081,,,,357,370,727
,2013,080100082,,,,20,40,60
,2013,080100082,,,,181,196,377
,2013,080100083,,,,19,21,40
,2013,080100084,,,,103,100,203
,2013,080100085,,,,27,18,45
,2013,080100086,,,,17,24,41
,2013,080100087,,,,17,11,28
,2013,080100088,,,,26,24,50
,2013,080100089,,,,21,27,48
,2013,080100090,,,,20,16,36
,2013,080100090,,,,178,179,357
,2013,080100091,,,,322,286,608
,2013,080100091,,,,19,15,34
,2013,080100092,,,,50,26,76
,2013,080100093,,,,36,35,71
,2013,080100094,,,,37,38,75
,2013,080100095,,,,12,12,24
,2013,080100096,,,,71,112,183
,2013,080100097,,,,111,86,197
,2013,080100098,,,,28,30,58
,2013,080100099,,,,155,168,323
,2013,080100099,,,,52,58,110
,2013,080100099,,,,182,170,352
,2013,080100102,,,,67,61,128
,2013,080100103,,,,103,112,215
,2013,080100104,,,,15,17,32
,2013,080100105,,,,35,34,69
,2013,080100106,,,,4,3,7
,2013,080100106,,,,46,32,78
,2013,080100107,,,,57,60,117
,2013,080100107,,,,54,81,135
,2013,080100108,,,,89,83,172
,2013,080100109,,,,176,195,371
,2013,080100110,,,,173,155,328
,2013,080100111,,,,120,113,233
,2013,080100112,,,,236,154,390
,2013,080100113,,,,472,476,948
,2013,080100115,,,,226,218,444
,2013,080100116,,,,132,134,266
,2013,080100116,,,,16,10,26
,2013,080100117,,,,29,34,63
,2013,080100117,,,,226,215,441
,2013,080100118,,,,23,25,48
,2013,080100119,,,,57,67,124
,2013,080100120,,,,6,5,11
,2013,080100121,,,,80,72,152
,2013,080100122,,,,12,10,22
,2013,080100122,,,,57,60,117
,2013,080100123,,,,8,9,17
,2013,080100124,,,,84,78,162
,2013,080100125,,,,34,31,65
,2013,080100126,,,,11,6,17
,2013,080100127,,,,14,17,31
,2013,080100127,,,,94,152,246
,2013,080100128,,,,59,53,112
,2013,080100129,,,,103,84,187
,2013,080100129,,,,8,10,18
,2013,080100130,,,,128,107,235
,2013,080100131,,,,212,161,373
,2013,080100132,,,,26,23,49
,2013,080100133,,,,469,350,819
,2013,080100134,,,,82,64,146
,2013,080100135,,,,63,61,124
,2013,080100137,,,,95,113,208
,2013,080100138,,,,84,73,157
,2013,080100139,,,,18,16,34
,2013,080100140,,,,13,12,25
,2013,080100140,,,,53,51,104
,2013,080100141,,,,24,31,55
,2013,080100142,,,,71,80,151
,2013,080100143,,,,29,21,50
,2013,080100143,,,,187,183,370
,2013,080100144,,,,42,41,83
,2013,080100144,,,,307,272,579
,2013,080100146,,,,332,272,604
,2013,080100147,,,,244,257,501
,2013,080100148,,,,519,0,519
,2013,080100149,,,,413,379,792
,2013,080100149,,,,37,42,79
,2013,080100151,,,,57,37,94
,2013,080100152,,,,19,20,39
,2013,080100152,,,,220,213,433
,2013,080100154,,,,35,47,82
,2013,080100154,,,,12,5,17
,2013,080100156,,,,120,127,247
,2013,080100156,,,,55,52,107
,2013,080100156,,,,96,130,226
,2013,080100157,,,,22,15,37
,2013,080100157,,,,228,218,446
,2013,080100158,,,,98,126,224
,2013,080100159,,,,51,48,99
,2013,080100161,,,,99,91,190
,2013,080100162,,,,59,55,114
,2013,080100163,,,,18,12,30
,2013,080100164,,,,99,78,177
,2013,080100164,,,,79,117,196
,2013,080100164,,,,20,19,39
,2013,080100165,,,,47,49,96
,2013,080100166,,,,41,27,68
,2013,080100166,,,,4,4,8
,2013,080100167,,,,195,157,352
,2013,080100167,,,,445,561,1006
,2013,080100168,,,,223,220,443
,2013,080100168,,,,24,20,44
,2013,080100169,,,,297,233,530
,2013,080100170,,,,399,388,787
,2013,080100170,,,,36,29,65
,2013,080100172,,,,0,905,905
,2013,080100173,,,,74,50,124
,2013,080100173,,,,42,47,89
,2013,080100173,,,,3,3,6
,2013,080100174,,,,214,239,453
,2013,080100175,,,,122,109,231
,2013,080100175,,,,115,103,218
,2013,080100176,,,,16,20,36
,2013,080100177,,,,10,17,27
,2013,080100177,,,,1,4,5
,2013,080100178,,,,152,147,299
,2013,080100179,,,,11,16,27
,2013,080100180,,,,26,32,58
,2013,080100180,,,,7,7,14
,2013,080100181,,,,182,154,336
,2013,080100182,,,,47,37,84
,2013,080100183,,,,0,147,147
,2013,080100183,,,,0,37,37
,2013,080100184,,,,342,305,647
,2013,080100185,,,,683,637,1320
,2013,080100185,,,,19,26,45
,2013,080100186,,,,170,168,338
,2013,080100187,,,,28,36,64
,2013,080100187,,,,328,344,672
,2013,080100188,,,,293,263,556
,2013,080100189,,,,669,618,1287
,2013,080100190,,,,46,66,112
,2013,080100190,,,,423,385,808
,2013,080100191,,,,353,368,721
,2013,080100192,,,,402,453,855
,2013,080100192,,,,45,43,88
,2013,080100193,,,,463,384,847
,2013,080100194,,,,244,223,467
,2013,080100195,,,,399,0,399
,2013,080100196,,,,0,415,415
,2013,080100197,,,,151,127,278
,2013,080100198,,,,221,170,391
,2013,080100199,,,,368,393,761
,2013,080100200,,,,106,129,235
,2013,080100202,,,,86,53,139
,2013,080100202,,,,17,16,33
,2013,080100202,,,,129,121,250
,2013,080100203,,,,96,104,200
,2013,080100204,,,,17,15,32
,2013,080100204,,,,69,66,135
,2013,080100205,,,,79,54,133
,2013,080100205,,,,10,7,17
,2013,080100205,,,,183,152,335
,2013,080100207,,,,29,36,65
,2013,080100207,,,,141,135,276
,2013,080100207,,,,137,182,319
,2013,080100208,,,,232,243,475
,2013,080100208,,,,261,276,537
,2013,080100208,,,,110,93,203
,2013,080100209,,,,35,38,73
,2013,080100210,,,,117,101,218
,2013,080100211,,,,0,676,676
,2013,080100211,,,,18,33,51
,2013,080100211,,,,0,191,191
,2013,080100212,,,,69,0,69
,2013,080100212,,,,571,0,571
,2013,080100213,,,,15,12,27
,2013,080100213,,,,54,34,88
,2013,080100214,,,,68,54,122
,2013,080100215,,,,33,27,60
,2013,080100216,,,,18,19,37
,2013,080100216,,,,12,7,19
,2013,080100217,,,,168,158,326
,2013,080100217,,,,117,108,225
,2013,080100217,,,,18,12,30
,2013,080100218,,,,30,32,62
,2013,080100219,,,,69,63,132
,2013,080100219,,,,10,10,20
,2013,080100219,,,,108,134,242
,2013,080100220,,,,446,516,962
,2013,080100221,,,,13,7,20
,2013,080100221,,,,74,80,154
,2013,080100222,,,,329,333,662
,2013,080100223,,,,57,45,102
,2013,080100224,,,,31,25,56
,2013,080100225,,,,43,47,90
,2013,080100225,,,,92,105,197
,2013,080100225,,,,277,284,561
,2013,080100225,,,,296,307,603
,2013,080100226,,,,222,259,481
,2013,080100227,,,,27,29,56
,2013,080100228,,,,148,135,283
,2013,080100229,,,,17,18,35
,2013,080100230,,,,0,63,63
,2013,080100230,,,,36,37,73
,2013,080100230,,,,0,365,365
,2013,080100231,,,,99,88,187
,2013,080100232,,,,31,27,58
,2013,080100233,,,,50,64,114
,2013,080100234,,,,134,109,243
,2013,080100235,,,,244,252,496
,2013,080100236,,,,444,436,880
,2013,080100237,,,,120,120,240
,2013,080100237,,,,241,219,460
,2013,080100237,,,,226,236,462
,2013,080100239,,,,346,381,727
,2013,080100239,,,,89,64,153
,2013,080100240,,,,139,143,282
,2013,080100241,,,,650,678,1328
,2013,080100241,,,,119,123,242
,2013,080100242,,,,115,101,216
,2013,080100243,,,,16,17,33
,2013,080100243,,,,183,162,345
,2013,080100244,,,,26,25,51
,2013,080100244,,,,206,182,388
,2013,080100245,,,,284,327,611
,2013,080100246,,,,187,181,368
,2013,080100247,,,,102,66,168
,2013,080100248,,,,110,113,223
,2013,080100249,,,,188,159,347
,2013,080100250,,,,230,226,456
,2013,080100250,,,,86,95,181
,2013,080100250,,,,207,213,420
,2013,080100251,,,,43,24,67
,2013,080100252,,,,143,134,277
,2013,080100253,,,,37,36,73
,2013,080100253,,,,6,4,10
,2013,080100254,,,,37,35,72
,2013,080100255,,,,36,0,36
,2013,080100256,,,,272,275,547
,2013,080100257,,,,10,8,18
,2013,080100258,,,,206,180,386
,2013,080100259,,,,181,205,386
,2013,080100259,,,,8,15,23
,2013,080100260,,,,330,336,666
,2013,080100261,,,,121,114,235
,2013,080100262,,,,63,93,156
,2013,080100262,,,,394,465,859
,2013,080100263,,,,5,3,8
,2013,080100263,,,,25,20,45
,2013,080100264,,,,361,341,702
,2013,080100265,,,,125,108,233
,2013,080100265,,,,22,22,44
,2013,080100266,,,,31,29,60
,2013,080100266,,,,169,153,322
,2013,080100267,,,,168,168,336
,2013,080100268,,,,243,242,485
,2013,080100270,,,,34,37,71
,2013,080100270,,,,10,10,20
,2013,080100271,,,,0,1,1
,2013,080100271,,,,2,4,6
,2013,080100273,,,,28,19,47
,2013,080100273,,,,4,2,6
,2013,080100273,,,,17,6,23
,2013,080100275,,,,195,178,373
,2013,080100276,,,,39,26,65
,2013,080100278,,,,30,29,59
,2013,080100278,,,,64,70,134
,2013,080100278,,,,53,42,95
,2013,080100279,,,,196,241,437
,2013,080100279,,,,221,226,447
,2013,080100282,,,,147,123,270
,2013,080100282,,,,62,43,105
,2013,080100282,,,,12,4,16
,2013,080100283,,,,5,5,10
,2013,080100283,,,,13,13,26
,2013,080100284,,,,157,138,295
,2013,080100284,,,,11,22,33
,2013,080100284,,,,40,60,100
,2013,080100286,,,,37,36,73
,2013,080100287,,,,42,28,70
,2013,080100290,,,,183,193,376
,2013,080100291,,,,35,44,79
,2013,080100291,,,,6,9,15
,2013,080100292,,,,102,104,206
,2013,080100292,,,,336,326,662
,2013,080100293,,,,287,230,517
,2013,080100294,,,,222,220,442
,2013,080100294,,,,21,23,44
,2013,080100295,,,,156,115,271
,2013,080100296,,,,91,95,186
,2013,080100296,,,,18,9,27
,2013,080100297,,,,7,7,14
,2013,080100297,,,,13,13,26
,2013,080100298,,,,284,319,603
,2013,080100298,,,,32,33,65
,2013,080100299,,,,138,125,263
,2013,080100300,,,,8,5,13
,2013,080100300,,,,45,53,98
,2013,080100301,,,,52,54,106
,2013,080100301,,,,11,9,20
,2013,080100302,,,,36,41,77
,2013,080100303,,,,119,125,244
,2013,080100303,,,,28,18,46
,2013,080100303,,,,158,163,321
,2013,080100305,,,,79,27,106
,2013,080100306,,,,169,166,335
,2013,080100306,,,,17,29,46
,2013,080100307,,,,213,214,427
,2013,080100308,,,,5,15,20
,2013,080100308,,,,11,12,23
,2013,080100308,,,,32,45,77
,2013,080100310,,,,15,9,24
,2013,080100310,,,,0,3,3
,2013,080100312,,,,2,4,6
,2013,080100312,,,,43,39,82
,2013,080100312,,,,53,50,103
,2013,080100315,,,,188,175,363
,2013,080100316,,,,19,19,38
,2013,080100317,,,,241,228,469
,2013,080100317,,,,92,146,238
,2013,080100318,,,,22,21,43
,2013,080100318,,,,130,86,216
,2013,080100318,,,,9,9,18
,2013,080100319,,,,12,7,19
,2013,080100319,,,,72,78,150
,2013,080100319,,,,141,186,327
,2013,080100322,,,,91,69,160
,2013,080100322,,,,121,128,249
,2013,080100324,,,,16,25,41
,2013,080100325,,,,430,525,955
,2013,080100326,,,,18,8,26
,2013,080100328,,,,127,92,219
,2013,080100329,,,,14,19,33
,2013,080100329,,,,49,56,105
,2013,080100329,,,,62,36,98
,2013,080100330,,,,15,20,35
,2013,080100332,,,,86,96,182
,2013,080100332,,,,68,65,133
,2013,080100332,,,,16,7,23
,2013,080100333,,,,143,129,272
,2013,080100334,,,,107,117,224
,2013,080100335,,,,133,111,244
,2013,080100335,,,,17,14,31
,2013,080100336,,,,11,12,23
,2013,080100336,,,,62,50,112
,2013,080100336,,,,46,51,97
,2013,080100337,,,,75,64,139
,2013,080100337,,,,20,27,47
,2013,080100337,,,,56,48,104
,2013,080100338,,,,69,73,142
,2013,080100338,,,,29,27,56
,2013,080100338,,,,38,27,65
,2013,080100340,,,,100,89,189
,2013,080100341,,,,13,19,32
,2013,080100341,,,,201,191,392
,2013,080100342,,,,301,297,598
,2013,080100343,,,,10,4,14
,2013,080100344,,,,39,35,74
,2013,080100344,,,,71,69,140
,2013,080100344,,,,14,25,39
,2013,080100345,,,,12,12,24
,2013,080100345,,,,28,36,64
,2013,080100345,,,,37,36,73
,2013,080100346,,,,220,254,474
,2013,080100346,,,,23,11,34
,2013,080100346,,,,202,173,375
,2013,080100348,,,,13,11,24
,2013,080100349,,,,9,18,27
,2013,080100350,,,,7,7,14
,2013,080100350,,,,99,52,151
,2013,080100350,,,,283,152,435
,2013,080100351,,,,66,53,119
,2013,080100352,,,,272,240,512
,2013,080100353,,,,14,27,41
,2013,080100353,,,,139,134,273
,2013,080100354,,,,11,14,25
,2013,080100355,,,,158,132,290
,2013,080100355,,,,39,35,74
,2013,080100355,,,,200,214,414
,2013,080100357,,,,394,349,743
,2013,080100359,,,,102,98,200
,2013,080100361,,,,35,36,71
,2013,080100361,,,,61,62,123
,2013,080100362,,,,10,5,15
,2013,080100362,,,,46,30,76
,2013,080100362,,,,5,7,12
,2013,080100363,,,,71,58,129
,2013,080100364,,,,176,143,319
,2013,080100366,,,,252,214,466
,2013,080100367,,,,69,82,151
,2013,080100368,,,,92,107,199
,2013,080100368,,,,43,41,84
,2013,080100369,,,,191,184,375
,2013,080100370,,,,69,46,115
,2013,080100371,,,,94,60,154
,2013,080100371,,,,10,6,16
,2013,080100373,,,,130,108,238
,2013,080100374,,,,32,29,61
,2013,080100374,,,,59,60,119
,2013,080100375,,,,38,41,79
,2013,080100375,,,,80,91,171
,2013,080100375,,,,65,91,156
,2013,080100376,,,,50,36,86
,2013,080100376,,,,25,18,43
,2013,080100377,,,,13,8,21
,2013,080100380,,,,46,45,91
,2013,080100380,,,,34,48,82
,2013,080100380,,,,6,10,16
,2013,080100382,,,,15,19,34
,2013,080100382,,,,15,15,30
,2013,080100383,,,,61,54,115
,2013,080100383,,,,31,26,57
,2013,080100383,,,,45,39,84
,2013,080100384,,,,27,40,67
,2013,080100384,,,,9,7,16
,2013,080100384,,,,21,17,38
,2013,080100385,,,,393,314,707
,2013,080100385,,,,31,32,63
,2013,080100387,,,,199,190,389
,2013,080100388,,,,59,68,127
,2013,080100388,,,,18,15,33
,2013,080100391,,,,45,50,95
,2013,080100391,,,,522,510,1032
,2013,080100392,,,,8,7,15
,2013,080100393,,,,13,24,37
,2013,080100395,,,,65,63,128
,2013,080100395,,,,15,15,30
,2013,080100395,,,,39,33,72
,2013,080100396,,,,18,11,29
,2013,080100396,,,,71,70,141
,2013,080100396,,,,30,40,70
,2013,080100398,,,,69,60,129
,2013,080100398,,,,34,14,48
,2013,080100399,,,,33,36,69
,2013,080100399,,,,183,146,329
,2013,080100400,,,,429,457,886
,2013,080100400,,,,33,42,75
,2013,080100401,,,,32,33,65
,2013,080100401,,,,188,206,394
,2013,080100404,,,,6,7,13
,2013,080100404,,,,11,12,23
,2013,080100405,,,,10,8,18
,2013,080100405,,,,38,27,65
,2013,080100406,,,,109,137,246
,2013,080100406,,,,204,230,434
,2013,080100406,,,,43,33,76
,2013,080100407,,,,108,100,208
,2013,080100407,,,,1200,1106,2306
,2013,080100407,,,,326,343,669
,2013,080100407,,,,35,39,74
,2013,080100408,,,,143,100,243
,2013,080100408,,,,13,17,30
,2013,080100409,,,,115,133,248
,2013,080100409,,,,52,48,100
,2013,080100410,,,,5,4,9
,2013,080100410,,,,31,35,66
,2013,080100411,,,,313,307,620
,2013,080100411,,,,64,69,133
,2013,080100413,,,,32,39,71
,2013,080100414,,,,14,5,19
,2013,080100415,,,,22,20,42
,2013,080100416,,,,9,10,19
,2013,080100417,,,,10,13,23
,2013,080100417,,,,46,59,105
,2013,080100418,,,,267,303,570
,2013,080100420,,,,57,62,119
,2013,080100420,,,,14,4,18
,2013,080100421,,,,30,38,68
,2013,080100422,,,,85,93,178
,2013,080100423,,,,67,75,142
,2013,080100424,,,,230,262,492
,2013,080100425,,,,271,216,487
,2013,080100426,,,,137,127,264
,2013,080100427,,,,31,35,66
,2013,080100427,,,,32,28,60
,2013,080100427,,,,5,6,11
,2013,080100428,,,,48,59,107
,2013,080100428,,,,184,189,373
,2013,080100428,,,,127,185,312
,2013,080100429,,,,126,64,190
,2013,080100430,,,,67,79,146
,2013,080100432,,,,27,12,39
,2013,080100432,,,,5,6,11
,2013,080100432,,,,4,2,6
,2013,080100433,,,,262,251,513
,2013,080100434,,,,62,50,112
,2013,080100435,,,,64,49,113
,2013,080100435,,,,268,303,571
,2013,080100435,,,,14,8,22
,2013,080100436,,,,10,5,15
,2013,080100436,,,,62,45,107
,2013,080100436,,,,85,72,157
,2013,080100438,,,,108,109,217
,2013,080100438,,,,25,26,51
,2013,080100441,,,,68,65,133
,2013,080100442,,,,38,27,65
,2013,080100443,,,,36,25,61
,2013,080100444,,,,29,29,58
,2013,080100445,,,,54,50,104
,2013,080100446,,,,31,28,59
,2013,080100447,,,,64,70,134
,2013,080100448,,,,38,38,76
,2013,080100449,,,,41,52,93
,2013,080100450,,,,88,68,156
,2013,080100451,,,,24,18,42
,2013,080100452,,,,72,74,146
,2013,080100454,,,,38,33,71
,2013,080100455,,,,31,26,57
,2013,080100456,,,,10,12,22
,2013,080100457,,,,127,109,236
,2013,080100458,,,,15,30,45
,2013,080100459,,,,34,51,85
,2013,080100459,,,,114,100,214
,2013,080100460,,,,217,180,397
,2013,080100462,,,,25,21,46
,2013,080100463,,,,54,35,89
,2013,080100464,,,,72,42,114
,2013,080100465,,,,4,5,9
,2013,080100465,,,,17,22,39
,2013,080100467,,,,57,41,98
,2013,080100467,,,,94,69,163
,2013,080100468,,,,9,9,18
,2013,080100469,,,,52,57,109
,2013,080100470,,,,33,23,56
,2013,080100471,,,,7,11,18
,2013,080100472,,,,104,64,168
,2013,080100473,,,,115,119,234
,2013,080100474,,,,81,78,159
,2013,080100477,,,,6,2,8
,2013,080100478,,,,42,36,78
,2013,080100479,,,,21,21,42
,2013,080100480,,,,70,68,138
,2013,080100482,,,,33,14,47
,2013,080100484,,,,16,17,33
,2013,080100486,,,,45,34,79
,2013,080100487,,,,30,26,56
,2013,080100488,,,,407,282,689
,2013,080100489,,,,22,17,39
,2013,080100490,,,,15,15,30
,2013,080100491,,,,23,25,48
,2013,080100492,,,,11,14,25
,2013,080100493,,,,21,14,35
,2013,080100494,,,,4,13,17
,2013,080100494,,,,11,19,30
,2013,080100495,,,,21,18,39
,2013,080100496,,,,113,90,203
,2013,080100497,,,,42,31,73
,2013,080100498,,,,32,30,62
,2013,080100498,,,,704,785,1489
,2013,080100498,,,,75,40,115
,2013,080100499,,,,71,51,122
,2013,080100499,,,,12,18,30
,2013,080100499,,,,71,56,127
,2013,080100500,,,,57,56,113
,2013,080100502,,,,27,23,50
,2013,080100502,,,,209,191,400
,2013,080100503,,,,85,81,166
,2013,080100506,,,,14,19,33
,2013,080100507,,,,44,37,81
,2013,080100508,,,,54,96,150
,2013,080100508,,,,85,96,181
,2013,080100508,,,,92,86,178
,2013,080100510,,,,179,162,341
,2013,080100511,,,,10,13,23
,2013,080100513,,,,26,35,61
,2013,080100514,,,,10,11,21
,2013,080100515,,,,19,11,30
,2013,080100516,,,,20,16,36
,2013,080100517,,,,60,66,126
,2013,080100519,,,,44,47,91
,2013,080100521,,,,501,443,944
,2013,080100522,,,,8,8,16
,2013,080100523,,,,15,22,37
,2013,080100525,,,,86,71,157
,2013,080100526,,,,30,33,63
,2013,080100528,,,,197,195,392
,2013,080100529,,,,15,15,30
,2013,080100530,,,,41,29,70
,2013,080100531,,,,52,58,110
,2013,080100533,,,,18,28,46
,2013,080100534,,,,50,38,88
,2013,080100535,,,,16,10,26
,2013,080100538,,,,125,107,232
,2013,080100539,,,,12,3,15
,2013,080100541,,,,12,7,19
,2013,080100541,,,,85,77,162
,2013,080100543,,,,134,109,243
,2013,080100544,,,,81,75,156
,2013,080100545,,,,43,57,100
,2013,080100546,,,,23,16,39
,2013,080100547,,,,38,43,81
,2013,080100552,,,,47,34,81
,2013,080100553,,,,32,41,73
,2013,080100554,,,,42,49,91
,2013,080100555,,,,30,24,54
,2013,080100557,,,,1,3,4
,2013,080100557,,,,18,16,34
,2013,080100559,,,,17,16,33
,2013,080100560,,,,11,7,18
,2013,080100560,,,,229,242,471
,2013,080100560,,,,85,73,158
,2013,080100561,,,,40,28,68
,2013,080100564,,,,5,6,11
,2013,080100564,,,,8,5,13
,2013,080100565,,,,51,63,114
,2013,080100565,,,,138,162,300
,2013,080100565,,,,14,20,34
,2013,080100565,,,,70,76,146
,2013,080100566,,,,55,42,97
,2013,080100568,,,,71,44,115
,2013,080100569,,,,35,44,79
,2013,080100573,,,,70,79,149
,2013,080100574,,,,73,78,151
,2013,080100575,,,,13,19,32
,2013,080100577,,,,40,52,92
,2013,080100578,,,,21,15,36
,2013,080100580,,,,45,23,68
,2013,080100581,,,,10,9,19
,2013,080100581,,,,54,80,134
,2013,080100581,,,,38,49,87
,2013,080100582,,,,53,92,145
,2013,080100582,,,,64,73,137
,2013,080100582,,,,11,13,24
,2013,080100583,,,,6,13,19
,2013,080100585,,,,286,255,541
,2013,080100586,,,,64,73,137
,2013,080100586,,,,20,16,36
,2013,080100586,,,,70,62,132
,2013,080100588,,,,29,30,59
,2013,080100589,,,,18,15,33
,2013,080100590,,,,37,30,67
,2013,080100591,,,,27,15,42
,2013,080100592,,,,30,28,58
,2013,080100593,,,,31,14,45
,2013,080100595,,,,11,7,18
,2013,080100595,,,,9,20,29
,2013,080100595,,,,18,17,35
,2013,080100597,,,,693,720,1413
,2013,080100598,,,,11,9,20
,2013,080100598,,,,75,87,162
,2013,080100599,,,,20,12,32
,2013,080100599,,,,52,77,129
,2013,080100599,,,,38,46,84
,2013,080100602,,,,41,32,73
,2013,080100603,,,,303,316,619
,2013,080100605,,,,32,34,66
,2013,080100606,,,,34,27,61
,2013,080100607,,,,28,37,65
,2013,080100608,,,,8,11,19
,2013,080100609,,,,14,8,22
,2013,080100609,,,,73,64,137
,2013,080100611,,,,12,18,30
,2013,080100613,,,,23,22,45
,2013,080100614,,,,150,117,267
,2013,080100615,,,,77,108,185
,2013,080100615,,,,3,3,6
,2013,080100615,,,,26,41,67
,2013,080100616,,,,72,86,158
,2013,080100619,,,,101,108,209
,2013,080100620,,,,1387,1768,3155
,2013,080100621,,,,1313,1861,3174
,2013,080100622,,,,508,604,1112
,2013,080100622,,,,45,63,108
,2013,080100622,,,,137,127,264
,2013,080100622,,,,27,19,46
,2013,080100627,,,,163,76,239
,2013,080100628,,,,137,150,287
,2013,080100629,,,,38,60,98
,2013,080100630,,,,1005,594,1599
,2013,080100631,,,,1460,287,1747
,2013,080100632,,,,2557,467,3024
,2013,080100633,,,,159,161,320
,2013,080100634,,,,280,33,313
,2013,080100635,,,,317,459,776
,2013,080100635,,,,221,290,511
,2013,080100635,,,,97,109,206
,2013,080100635,,,,30,41,71
,2013,080100636,,,,351,301,652
,2013,080100637,,,,23,19,42
,2013,080100637,,,,142,250,392
,2013,080100637,,,,22,24,46
,2013,080100638,,,,92,109,201
,2013,080100640,,,,48,41,89
,2013,080100640,,,,36,29,65
,2013,080100642,,,,199,418,617
,2013,080100642,,,,2000,2661,4661
,2013,080100643,,,,2734,3969,6703
,2013,080100644,,,,475,604,1079
,2013,080100648,,,,1259,1643,2902
,2013,080100650,,,,23,8,31
,2013,080100652,,,,720,949,1669
,2013,080100653,,,,168,188,356
,2013,080100654,,,,147,147,294
,2013,080100655,,,,69,99,168
,2013,080100656,,,,23,25,48
,2013,080100656,,,,5,5,10
,2013,080100658,,,,13,13,26
,2013,080100658,,,,5,6,11
,2013,080100659,,,,2,121,123
,2013,080100660,,,,71,85,156
,2013,080100660,,,,16,31,47
,2013,080100660,,,,23,35,58
,2013,080100661,,,,177,201,378
,2013,080100663,,,,77,91,168
,2013,080100663,,,,36,25,61
,2013,080100663,,,,65,107,172
,2013,080100664,,,,717,942,1659
,2013,080100666,,,,10,6,16
,2013,080100672,,,,37,53,90
,2013,080100673,,,,471,614,1085
,2013,080100675,,,,281,225,506
,2013,080100675,,,,104,116,220
,2013,080100675,,,,214,237,451
,2013,080100677,,,,231,222,453
,2013,080100679,,,,671,672,1343
,2013,080100680,,,,253,249,502
,2013,080100681,,,,389,376,765
,2013,080100682,,,,386,485,871
,2013,080100683,,,,561,725,1286
,2013,080100684,,,,412,188,600
,2013,080100685,,,,445,260,705
,2013,080100686,,,,156,173,329
,2013,080100687,,,,396,440,836
,2013,080100688,,,,254,260,514
,2013,080100691,,,,604,757,1361
,2013,080100692,,,,25,25,50
,2013,080100693,,,,200,0,200
,2013,080100694,,,,438,406,844
,2013,080100695,,,,132,157,289
,2013,080100696,,,,149,137,286
,2013,080100696,,,,40,30,70
,2013,080100697,,,,327,378,705
,2013,080100698,,,,348,362,710
,2013,080100699,,,,369,486,855
,2013,080100700,,,,171,185,356
,2013,080100701,,,,88,92,180
,2013,080100702,,,,68,57,125
,2013,080100703,,,,29,29,58
,2013,080100705,,,,234,249,483
,2013,080100708,,,,199,190,389
,2013,080100710,,,,6,15,21
,2013,080100711,,,,12,18,30
,2013,080100712,,,,15,15,30
,2013,080100716,,,,14,10,24
,2013,080100717,,,,21,15,36
,2013,080100718,,,,7,9,16
,2013,080100720,,,,21,23,44
,2013,080100720,,,,17,14,31
,2013,080100721,,,,18,17,35
,2013,080100722,,,,16,7,23
,2013,080100722,,,,40,38,78
,2013,080100722,,,,48,66,114
,2013,080100723,,,,98,208,306
,2013,080100724,,,,15,37,52
,2013,080100725,,,,35,25,60
,2013,080100726,,,,17,13,30
,2013,080100728,,,,11,4,15
,2013,080100728,,,,7,6,13
,2013,080100729,,,,68,59,127
,2013,080100730,,,,11,11,22
,2013,080100732,,,,19,13,32
,2013,080100733,,,,38,34,72
,2013,080100734,,,,315,309,624
,2013,080100736,,,,18,18,36
,2013,080100736,,,,3,5,8
,2013,080100736,,,,30,30,60
,2013,080100738,,,,94,73,167
,2013,080100738,,,,15,17,32
,2013,080100738,,,,33,31,64
,2013,080100739,,,,351,484,835
,2013,080100741,,,,453,300,753
,2013,080100742,,,,42,32,74
,2013,080100742,,,,5,10,15
,2013,080100742,,,,11,15,26
,2013,080100742,,,,67,73,140
,2013,080100743,,,,31,14,45
,2013,080100744,,,,18,14,32
,2013,080100745,,,,55,65,120
,2013,080100748,,,,31,17,48
,2013,080100749,,,,6,3,9
,2013,080100749,,,,8,7,15
,2013,080100750,,,,36,21,57
,2013,080100751,,,,28,20,48
,2013,080100752,,,,42,41,83
,2013,080100753,,,,135,118,253
,2013,080100754,,,,60,30,90
,2013,080100755,,,,34,25,59
,2013,080100757,,,,46,31,77
,2013,080100757,,,,45,50,95
,2013,080100757,,,,17,19,36
,2013,080100758,,,,18,34,52
,2013,080100759,,,,18,19,37
,2013,080100760,,,,37,43,80
,2013,080100762,,,,173,181,354
,2013,080100762,,,,23,13,36
,2013,080100765,,,,14,15,29
,2013,080100767,,,,22,18,40
,2013,080100767,,,,77,72,149
,2013,080100767,,,,41,52,93
,2013,080100769,,,,13,14,27
,2013,080100770,,,,13,14,27
,2013,080100772,,,,29,27,56
,2013,080100773,,,,11,10,21
,2013,080100774,,,,14,19,33
,2013,080100775,,,,5,12,17
,2013,080100776,,,,16,17,33
,2013,080100777,,,,34,35,69
,2013,080100778,,,,43,34,77
,2013,080100779,,,,41,39,80
,2013,080100780,,,,4,8,12
,2013,080100781,,,,40,37,77
,2013,080100782,,,,56,48,104
,2013,080100785,,,,44,37,81
,2013,080100786,,,,7,8,15
,2013,080100788,,,,29,28,57
,2013,080100789,,,,13,28,41
,2013,080100791,,,,25,21,46
,2013,080100791,,,,26,28,54
,2013,080100791,,,,5,10,15
,2013,080100794,,,,33,21,54
,2013,080100795,,,,48,43,91
,2013,080100799,,,,42,43,85
,2013,080100800,,,,18,14,32
,2013,080100800,,,,153,130,283
,2013,080100801,,,,19,10,29
,2013,080100802,,,,57,64,121
,2013,080100802,,,,22,17,39
,2013,080100802,,,,54,48,102
,2013,080100803,,,,348,367,715
,2013,080100804,,,,55,48,103
,2013,080100807,,,,13,11,24
,2013,080100808,,,,48,57,105
,2013,080100811,,,,17,11,28
,2013,080100811,,,,3,2,5
,2013,080100815,,,,99,0,99
,2013,080100816,,,,21,15,36
,2013,080100816,,,,115,100,215
,2013,080100817,,,,21,17,38
,2013,080100818,,,,10,15,25
,2013,080100819,,,,38,41,79
,2013,080100822,,,,208,163,371
,2013,080100823,,,,634,640,1274
,2013,080100825,,,,68,62,130
,2013,080100826,,,,102,106,208
,2013,080100827,,,,16,17,33
,2013,080100828,,,,63,44,107
,2013,080100829,,,,9,8,17
,2013,080100829,,,,60,45,105
,2013,080100829,,,,13,13,26
,2013,080100830,,,,7,3,10
,2013,080100831,,,,4,7,11
,2013,080100831,,,,30,33,63
,2013,080100831,,,,14,12,26
,2013,080100833,,,,13,13,26
,2013,080100835,,,,55,54,109
,2013,080100836,,,,13,12,25
,2013,080100837,,,,26,27,53
,2013,080100838,,,,15,12,27
,2013,080100839,,,,77,71,148
,2013,080100839,,,,29,17,46
,2013,080100840,,,,28,28,56
,2013,080100842,,,,19,14,33
,2013,080100843,,,,24,21,45
,2013,080100844,,,,29,25,54
,2013,080100846,,,,11,17,28
,2013,080100846,,,,43,36,79
,2013,080100846,,,,35,23,58
,2013,080100848,,,,42,37,79
,2013,080100851,,,,41,29,70
,2013,080100852,,,,13,16,29
,2013,080100853,,,,8,18,26
,2013,080100854,,,,25,30,55
,2013,080100855,,,,18,10,28
,2013,080100856,,,,22,29,51
,2013,080100857,,,,56,34,90
,2013,080100860,,,,11,10,21
,2013,080100861,,,,14,13,27
,2013,080100864,,,,121,118,239
,2013,080100865,,,,442,463,905
,2013,080100866,,,,113,129,242
,2013,080100866,,,,21,22,43
,2013,080100867,,,,189,191,380
,2013,080100868,,,,63,62,125
,2013,080100868,,,,369,320,689
,2013,080100870,,,,12,12,24
,2013,080100871,,,,24,16,40
,2013,080100872,,,,36,45,81
,2013,080100874,,,,83,91,174
,2013,080100874,,,,54,48,102
,2013,080100877,,,,45,24,69
,2013,080100877,,,,22,17,39
,2013,080100877,,,,7,2,9
,2013,080100879,,,,400,385,785
,2013,080100881,,,,245,303,548
,2013,080100881,,,,6,4,10
,2013,080100882,,,,723,631,1354
,2013,080100882,,,,174,145,319
,2013,080100883,,,,12,11,23
,2013,080100885,,,,112,124,236
,2013,080100886,,,,20,18,38
,2013,080100890,,,,118,140,258
,2013,080100892,,,,84,72,156
,2013,080100893,,,,91,86,177
,2013,080100893,,,,13,14,27
,2013,080100894,,,,331,426,757
,2013,080100895,,,,381,646,1027
,2013,080100896,,,,19,19,38
,2013,080100896,,,,259,236,495
,2013,080100897,,,,81,72,153
,2013,080100900,,,,46,38,84
,2013,080100900,,,,29,48,77
,2013,080100901,,,,414,289,703
,2013,080100904,,,,31,31,62
,2013,080100905,,,,191,181,372
,2013,080100908,,,,86,87,173
,2013,080100910,,,,259,283,542
,2013,080100911,,,,115,90,205
,2013,080100912,,,,96,118,214
,2013,080100915,,,,90,76,166
,2013,080100916,,,,113,116,229
,2013,080100917,,,,17,17,34
,2013,080100920,,,,23,11,34
,2013,080100922,,,,540,1461,2001
,2013,080100924,,,,32,41,73
,2013,080100925,,,,4,16,20
,2013,080100927,,,,84,0,84
,2013,080100928,,,,6,13,19
,2013,080100929,,,,48,39,87
,2013,080100929,,,,88,100,188
,2013,080100932,,,,17,15,32
,2013,080100933,,,,47,39,86
,2013,080100933,,,,20,20,40
,2013,080100934,,,,10,12,22
,2013,080100934,,,,12,10,22
,2013,080100935,,,,17,17,34
,2013,080100935,,,,93,89,182
,2013,080100937,,,,26,26,52
,2013,080100938,,,,25,41,66
,2013,080100941,,,,45,39,84
,2013,080100944,,,,168,208,376
,2013,080100944,,,,17,16,33
,2013,080100944,,,,88,85,173
,2013,080100945,,,,59,45,104
,2013,080100947,,,,225,235,460
,2013,080100948,,,,120,129,249
,2013,080100948,,,,42,25,67
,2013,080100948,,,,97,119,216
,2013,080100949,,,,12,20,32
,2013,080100951,,,,56,65,121
,2013,080100953,,,,23,26,49
,2013,080100954,,,,19,15,34
,2013,080100954,,,,6,6,12
,2013,080100954,,,,16,31,47
,2013,080100955,,,,17,10,27
,2013,080100956,,,,18,14,32
,2013,080100957,,,,24,25,49
,2013,080100959,,,,28,38,66
,2013,080100961,,,,18,11,29
,2013,080100963,,,,29,37,66
,2013,080100965,,,,15,15,30
,2013,080100966,,,,17,13,30
,2013,080100966,,,,67,68,135
,2013,080100967,,,,46,34,80
,2013,080100968,,,,17,19,36
,2013,080100968,,,,20,21,41
,2013,080100969,,,,42,46,88
,2013,080100969,,,,23,32,55
,2013,080100970,,,,18,21,39
,2013,080100970,,,,51,54,105
,2013,080100971,,,,42,41,83
,2013,080100971,,,,22,15,37
,2013,080100980,,,,6,6,12
,2013,080100980,,,,20,19,39
,2013,080100983,,,,85,70,155
,2013,080100986,,,,4,5,9
,2013,080100990,,,,235,272,507
,2013,080100990,,,,76,75,151
,2013,080100990,,,,261,264,525
,2013,080100991,,,,46,56,102
,2013,080100993,,,,32,22,54
,2013,080100994,,,,4,3,7
,2013,080100995,,,,3,7,10
,2013,080100996,,,,12,14,26
,2013,080100997,,,,7,4,11
,2013,080100997,,,,2,8,10
,2013,080100999,,,,16,13,29
,2013,080101002,,,,53,54,107
,2013,080101004,,,,163,146,309
,2013,080101004,,,,30,24,54
,2013,080101005,,,,7,2,9
,2013,080101005,,,,5,5,10
,2013,080101006,,,,5,4,9
,2013,080101006,,,,21,26,47
,2013,080101007,,,,140,140,280
,2013,080101007,,,,21,25,46
,2013,080101008,,,,6,3,9
,2013,080101008,,,,16,13,29
,2013,080101009,,,,161,150,311
,2013,080101010,,,,7,1,8
,2013,080101010,,,,15,13,28
,2013,080101013,,,,27,10,37
,2013,080101014,,,,145,191,336
,2013,080101014,,,,44,54,98
,2013,080101014,,,,93,164,257
,2013,080101015,,,,29,28,57
,2013,080101016,,,,13,30,43
,2013,080101017,,,,176,186,362
,2013,080101018,,,,14,6,20
,2013,080101020,,,,20,5,25
,2013,080101021,,,,6,6,12
,2013,080101021,,,,32,40,72
,2013,080101022,,,,156,159,315
,2013,080101022,,,,2,11,13
,2013,080101023,,,,27,26,53
,2013,080101023,,,,107,88,195
,2013,080101027,,,,66,82,148
,2013,080101028,,,,210,193,403
,2013,080101028,,,,42,47,89
,2013,080101028,,,,7,7,14
,2013,080101030,,,,8,13,21
,2013,080101030,,,,73,101,174
,2013,080101032,,,,11,15,26
,2013,080101033,,,,19,24,43
,2013,080101033,,,,93,85,178
,2013,080101035,,,,106,91,197
,2013,080101035,,,,10,10,20
,2013,080101036,,,,10,8,18
,2013,080101037,,,,143,116,259
,2013,080101038,,,,16,11,27
,2013,080101039,,,,17,32,49
,2013,080101039,,,,10,13,23
,2013,080101041,,,,13,10,23
,2013,080101043,,,,4,5,9
,2013,080101044,,,,29,27,56
,2013,080101049,,,,6,9,15
,2013,080101063,,,,16,21,37
,2013,080101069,,,,574,481,1055
,2013,080101071,,,,31,40,71
,2013,080101071,,,,145,159,304
,2013,080101073,,,,147,131,278
,2013,080101074,,,,52,35,87
,2013,080101079,,,,90,39,129
,2013,080101082,,,,163,106,269
,2013,080101083,,,,12,4,16
,2013,080101083,,,,30,16,46
,2013,080101084,,,,203,285,488
,2013,080101084,,,,201,244,445
,2013,080101085,,,,9,22,31
,2013,080101087,,,,19,26,45
,2013,080101087,,,,9,5,14
,2013,080101088,,,,3,8,11
,2013,080101100,,,,232,224,456
,2013,080101103,,,,176,171,347
,2013,080101106,,,,212,224,436
,2013,080101111,,,,168,125,293
,2013,080101114,,,,24,26,50
,2013,080101117,,,,4,2,6
,2013,080101117,,,,26,14,40
,2013,080101119,,,,15,29,44
,2013,080101120,,,,23,18,41
,2013,080101122,,,,10,13,23
,2013,080101123,,,,32,26,58
,2013,080101123,,,,4,8,12
,2013,080101125,,,,4,2,6
,2013,080101129,,,,45,46,91
,2013,080101134,,,,220,335,555
,2013,080101134,,,,78,82,160
,2013,080101134,,,,331,334,665
,2013,080101139,,,,49,38,87
,2013,080101139,,,,4,4,8
,2013,080101144,,,,8,11,19
,2013,080101145,,,,44,50,94
,2013,080101145,,,,178,300,478
,2013,080101145,,,,2,4,6
,2013,080101148,,,,29,31,60
,2013,080101149,,,,228,266,494
,2013,080101153,,,,205,184,389
,2013,080101153,,,,45,28,73
,2013,080101157,,,,15,10,25
,2013,080101157,,,,80,65,145
,2013,080101157,,,,187,247,434
,2013,080101158,,,,10,9,19
,2013,080101158,,,,7,7,14
,2013,080101159,,,,9,12,21
,2013,080101161,,,,10,8,18
,2013,080101161,,,,103,76,179
,2013,080101161,,,,334,349,683
,2013,080101161,,,,135,130,265
,2013,080101162,,,,10,10,20
,2013,080101162,,,,44,29,73
,2013,080101164,,,,53,43,96
,2013,080101164,,,,43,47,90
,2013,080101164,,,,13,11,24
,2013,080101167,,,,64,75,139
,2013,080101168,,,,13,8,21
,2013,080101170,,,,8,5,13
,2013,080101172,,,,7,15,22
,2013,080101173,,,,29,32,61
,2013,080101174,,,,15,18,33
,2013,080101175,,,,25,26,51
,2013,080101177,,,,6,6,12
,2013,080101180,,,,18,13,31
,2013,080101184,,,,1,1,2
,2013,080101184,,,,21,25,46
,2013,080101185,,,,11,12,23
,2013,080101186,,,,6,6,12
,2013,080101186,,,,27,23,50
,2013,080101187,,,,14,17,31
,2013,080101187,,,,4,6,10
,2013,080101187,,,,1,3,4
,2013,080101187,,,,25,19,44
,2013,080101188,,,,40,35,75
,2013,080101191,,,,18,10,28
,2013,080101192,,,,28,25,53
,2013,080101193,,,,19,22,41
,2013,080101195,,,,4,6,10
,2013,080101195,,,,32,22,54
,2013,080101197,,,,7,3,10
,2013,080101199,,,,17,13,30
,2013,080101200,,,,104,76,180
,2013,080101200,,,,40,37,77
,2013,080101200,,,,12,7,19
,2013,080101201,,,,92,181,273
,2013,080101201,,,,175,334,509
,2013,080101203,,,,17,15,32
,2013,080101203,,,,8,8,16
,2013,080101204,,,,78,78,156
,2013,080101204,,,,177,187,364
,2013,080101204,,,,161,159,320
,2013,080101205,,,,35,43,78
,2013,080101205,,,,19,21,40
,2013,080101205,,,,64,66,130
,2013,080101206,,,,31,27,58
,2013,080101206,,,,66,54,120
,2013,080101206,,,,38,46,84
,2013,080101209,,,,24,15,39
,2013,080101209,,,,11,15,26
,2013,080101209,,,,0,3,3
,2013,080101210,,,,7,6,13
,2013,080101210,,,,8,16,24
,2013,080101213,,,,3,5,8
,2013,080101215,,,,2,2,4
,2013,080101215,,,,20,2,22
,2013,080101219,,,,8,10,18
,2013,080101221,,,,46,44,90
,2013,080101222,,,,3,1,4
,2013,080101222,,,,22,28,50
,2013,080101259,,,,230,255,485
,2013,080101259,,,,208,257,465
,2013,080101259,,,,37,29,66
,2013,080101262,,,,42,32,74
,2013,080101263,,,,17,16,33
,2013,080101264,,,,22,15,37
,2013,080101264,,,,11,12,23
,2013,080101268,,,,55,39,94
,2013,080101268,,,,16,7,23
,2013,080101272,,,,14,10,24
,2013,080101273,,,,11,9,20
,2013,080101274,,,,24,19,43
,2013,080101274,,,,59,53,112
,2013,080101275,,,,56,56,112
,2013,080101277,,,,14,21,35
,2013,080101282,,,,10,8,18
,2013,080101282,,,,155,143,298
,2013,080101285,,,,13,25,38
,2013,080101286,,,,25,22,47
,2013,080101293,,,,8,12,20
,2013,080101293,,,,35,33,68
,2013,080101295,,,,30,35,65
,2013,080101296,,,,27,19,46
,2013,080101297,,,,6,8,14
,2013,080101297,,,,31,30,61
,2013,080101300,,,,9,7,16
,2013,080101300,,,,28,23,51
,2013,080101307,,,,9,7,16
,2013,080101307,,,,48,37,85
,2013,080101307,,,,5,4,9
,2013,080101308,,,,27,18,45
,2013,080101308,,,,74,86,160
,2013,080101308,,,,83,116,199
,2013,080101308,,,,41,63,104
,2013,080101309,,,,28,39,67
,2013,080101309,,,,10,26,36
,2013,080101309,,,,4,1,5
,2013,080101310,,,,7,8,15
,2013,080101310,,,,4,1,5
,2013,080101310,,,,11,8,19
,2013,080101311,,,,35,34,69
,2013,080101311,,,,92,84,176
,2013,080101312,,,,23,18,41
,2013,080101312,,,,60,74,134
,2013,080101315,,,,9,11,20
,2013,080101315,,,,10,20,30
,2013,080101318,,,,8,9,17
,2013,080101318,,,,39,17,56
,2013,080101320,,,,30,22,52
,2013,080101321,,,,35,27,62
,2013,080101323,,,,25,8,33
,2013,080101326,,,,30,16,46
,2013,080101328,,,,40,22,62
,2013,080101329,,,,78,110,188
,2013,080101333,,,,17,14,31
,2013,080101334,,,,34,36,70
,2013,080101335,,,,24,12,36
,2013,080101336,,,,24,16,40
,2013,080101344,,,,8,2,10
,2013,080101345,,,,6,19,25
,2013,080101348,,,,0,84,84
,2013,080101353,,,,157,116,273
,2013,080101355,,,,35,45,80
,2013,080101356,,,,51,56,107
,2013,080101357,,,,57,56,113
,2013,080101357,,,,9,7,16
,2013,080101357,,,,4,2,6
,2013,080101359,,,,0,21,21
,2013,080101361,,,,38,28,66
,2013,080101361,,,,8,13,21
,2013,080101361,,,,14,19,33
,2013,080101363,,,,63,52,115
,2013,080101365,,,,41,52,93
,2013,080101365,,,,10,8,18
,2013,080101365,,,,56,40,96
,2013,080101368,,,,49,39,88
,2013,080101369,,,,243,267,510
,2013,080101370,,,,43,35,78
,2013,080101370,,,,11,9,20
,2013,080101370,,,,38,44,82
,2013,080101371,,,,103,102,205
,2013,080101440,,,,11,12,23
,2013,080101445,,,,54,56,110
,2013,080101448,,,,153,127,280
,2013,080101463,,,,272,295,567
,2013,080101464,,,,228,349,577
,2013,080101464,,,,94,97,191
,2013,080101464,,,,17,16,33
,2013,080101466,,,,78,82,160
,2013,080101467,,,,121,112,233
,2013,080101469,,,,164,178,342
,2013,080101470,,,,122,107,229
,2013,080101471,,,,152,199,351
,2013,080101471,,,,313,345,658
,2013,080101471,,,,19,10,29
,2013,080101471,,,,20,23,43
,2013,080101476,,,,16,17,33
,2013,080101476,,,,5,4,9
,2013,080101476,,,,9,14,23
,2013,080101477,,,,270,0,270
,2013,080101478,,,,23,22,45
,2013,080101480,,,,18,14,32
,2013,080101480,,,,90,86,176
,2013,080101480,,,,16,20,36
,2013,080101481,,,,6,5,11
,2013,080101481,,,,25,25,50
,2013,080101483,,,,40,47,87
,2013,080101483,,,,68,71,139
,2013,080101483,,,,23,23,46
,2013,080101486,,,,26,17,43
,2013,080101491,,,,25,21,46
,2013,080101491,,,,19,14,33
,2013,080101492,,,,7,7,14
,2013,080101492,,,,15,5,20
,2013,080101493,,,,40,59,99
,2013,080101493,,,,10,9,19
,2013,080101495,,,,40,30,70
,2013,080101495,,,,61,58,119
,2013,080101495,,,,7,5,12
,2013,080101496,,,,56,34,90
,2013,080101496,,,,61,74,135
,2013,080101496,,,,21,10,31
,2013,080101499,,,,10,21,31
,2013,080101499,,,,26,41,67
,2013,080101500,,,,23,25,48
,2013,080101500,,,,46,45,91
,2013,080101504,,,,10,4,14
,2013,080101504,,,,16,9,25
,2013,080101505,,,,17,11,28
,2013,080101506,,,,6,8,14
,2013,080101507,,,,4,5,9
,2013,080101508,,,,4,4,8
,2013,080101511,,,,8,6,14
,2013,080101512,,,,9,11,20
,2013,080101514,,,,7,2,9
,2013,080101517,,,,3,5,8
,2013,080101518,,,,26,35,61
,2013,080101519,,,,8,9,17
,2013,080101521,,,,41,40,81
,2013,080101522,,,,8,15,23
,2013,080101523,,,,6,12,18
,2013,080101524,,,,7,10,17
,2013,080101527,,,,30,33,63
,2013,080101528,,,,4441,6148,10589
,2013,080101541,,,,13,10,23
,2013,080101542,,,,20,26,46
,2013,080101542,,,,17,9,26
,2013,080101543,,,,50,37,87
,2013,080101543,,,,91,62,153
,2013,080101543,,,,10,9,19
,2013,080101544,,,,4,4,8
,2013,080101544,,,,4,2,6
,2013,080101545,,,,15,14,29
,2013,080101545,,,,7,14,21
,2013,080101546,,,,6,1,7
,2013,080101546,,,,3,7,10
,2013,080101547,,,,18,14,32
,2013,080101547,,,,6,16,22
,2013,080101548,,,,6,10,16
,2013,080101548,,,,22,26,48
,2013,080101548,,,,5,11,16
,2013,080101549,,,,12,21,33
,2013,080101549,,,,3,5,8
,2013,080101551,,,,2,4,6
,2013,080101551,,,,12,17,29
,2013,080101552,,,,22,19,41
,2013,080101552,,,,8,8,16
,2013,080101554,,,,5,5,10
,2013,080101554,,,,6,8,14
,2013,080101555,,,,23,16,39
,2013,080101555,,,,7,12,19
,2013,080101556,,,,1,3,4
,2013,080101556,,,,12,5,17
,2013,080101557,,,,128,168,296
,2013,080101557,,,,264,365,629
,2013,080101558,,,,17,15,32
,2013,080101558,,,,53,112,165
,2013,080101559,,,,20,34,54
,2013,080101559,,,,15,18,33
,2013,080101560,,,,159,168,327
,2013,080101561,,,,68,73,141
,2013,080101564,,,,7,7,14
,2013,080101565,,,,13,13,26
,2013,080101566,,,,8,8,16
,2013,080101567,,,,15,11,26
,2013,080101569,,,,9,11,20
,2013,080101570,,,,27,20,47
,2013,080101572,,,,54,35,89
,2013,080101573,,,,3,4,7
,2013,080101574,,,,3,7,10
,2013,080101575,,,,8,3,11
,2013,080101576,,,,5,3,8
,2013,080101577,,,,6,3,9
,2013,080101578,,,,10,7,17
,2013,080101579,,,,4,5,9
,2013,080101580,,,,11,8,19
,2013,080101581,,,,29,31,60
,2013,080101582,,,,7,13,20
,2013,080101584,,,,12,11,23
,2013,080101585,,,,8,11,19
,2013,080101587,,,,14,24,38
,2013,080101588,,,,10,6,16
,2013,080101588,,,,9,10,19
,2013,080101590,,,,17,19,36
,2013,080101591,,,,30,28,58
,2013,080101592,,,,3,6,9
,2013,080101592,,,,19,10,29
,2013,080101592,,,,91,108,199
,2013,080101593,,,,11,14,25
,2013,080101593,,,,4,3,7
,2013,080101594,,,,34,43,77
,2013,080101594,,,,23,24,47
,2013,080101595,,,,7,9,16
,2013,080101597,,,,107,51,158
,2013,080101599,,,,25,27,52
,2013,080101599,,,,12,12,24
,2013,080101600,,,,22,17,39
,2013,080101601,,,,3,6,9
,2013,080101603,,,,15,17,32
,2013,080101605,,,,7,9,16
,2013,080101605,,,,36,32,68
,2013,080101607,,,,74,84,158
,2013,080101607,,,,17,8,25
,2013,080101607,,,,22,37,59
,2013,080101608,,,,5,12,17
,2013,080101609,,,,4,7,11
,2013,080101610,,,,3,2,5
,2013,080101611,,,,14,14,28
,2013,080101612,,,,4,14,18
,2013,080101613,,,,15,13,28
,2013,080101615,,,,11,10,21
,2013,080101615,,,,1,0,1
,2013,080101615,,,,15,16,31
,2013,080101617,,,,52,45,97
,2013,080101617,,,,10,16,26
,2013,080101620,,,,5,13,18
,2013,080101621,,,,10,5,15
,2013,080101622,,,,3,4,7
,2013,080101622,,,,19,18,37
,2013,080101623,,,,7,5,12
,2013,080101625,,,,44,58,102
,2013,080101625,,,,26,17,43
,2013,080101627,,,,18,3,21
,2013,080101628,,,,28,17,45
,2013,080101629,,,,17,19,36
,2013,080101630,,,,30,21,51
,2013,080101631,,,,17,21,38
,2013,080101632,,,,12,11,23
,2013,080101633,,,,17,14,31
,2013,080101634,,,,6,9,15
,2013,080101634,,,,49,49,98
,2013,080101634,,,,64,56,120
,2013,080101635,,,,107,179,286
,2013,080101635,,,,71,90,161
,2013,080101636,,,,3,4,7
,2013,080101638,,,,5,3,8
,2013,080101639,,,,4,4,8
,2013,080101645,,,,15,14,29
,2013,080101646,,,,15,16,31
,2013,080101647,,,,12,7,19
,2013,080101648,,,,21,20,41
,2013,080101649,,,,4,4,8
,2013,080101649,,,,37,39,76
,2013,080101649,,,,25,26,51
,2013,080101650,,,,35,34,69
,2013,080101650,,,,5,7,12
,2013,080101652,,,,14,11,25
,2013,080101652,,,,30,22,52
,2013,080101652,,,,5,7,12
,2013,080101653,,,,35,23,58
,2013,080101653,,,,9,10,19
,2013,080101655,,,,20,18,38
,2013,080101656,,,,8,2,10
,2013,080101657,,,,1,1,2
,2013,080101657,,,,2,3,5
,2013,080101657,,,,53,52,105
,2013,080101659,,,,15,14,29
,2013,080101659,,,,15,9,24
,2013,080101661,,,,88,106,194
,2013,080101662,,,,8,6,14
,2013,080101663,,,,14,21,35
,2013,080101664,,,,15,15,30
,2013,080101665,,,,7,7,14
,2013,080101665,,,,24,23,47
,2013,080101666,,,,2,4,6
,2013,080101667,,,,13,8,21
,2013,080101668,,,,4,10,14
,2013,080101670,,,,29,21,50
,2013,080101671,,,,8,11,19
,2013,080101672,,,,10,7,17
,2013,080101672,,,,27,18,45
,2013,080101673,,,,291,0,291
,2013,080101675,,,,0,107,107
,2013,080101675,,,,25,25,50
,2013,080101676,,,,54,50,104
,2013,080101676,,,,164,178,342
,2013,080101676,,,,13,14,27
,2013,080101677,,,,9,11,20
,2013,080101678,,,,11,13,24
,2013,080101681,,,,4,2,6
,2013,080101681,,,,1,2,3
,2013,080101682,,,,26,28,54
,2013,080101683,,,,4,13,17
,2013,080101683,,,,26,17,43
,2013,080101683,,,,6,10,16
,2013,080101684,,,,18,8,26
,2013,080101686,,,,18,12,30
,2013,080101687,,,,21,36,57
,2013,080101688,,,,2,4,6
,2013,080101690,,,,55,51,106
,2013,080101690,,,,73,77,150
,2013,080101691,,,,23,19,42
,2013,080101691,,,,33,55,88
,2013,080101692,,,,26,23,49
,2013,080101692,,,,83,99,182
,2013,080101693,,,,12,8,20
,2013,080101696,,,,16,28,44
,2013,080101698,,,,13,16,29
,2013,080101700,,,,13,5,18
,2013,080101700,,,,9,4,13
,2013,080101701,,,,9,8,17
,2013,080101702,,,,103,74,177
,2013,080101703,,,,2,2,4
,2013,080101703,,,,12,4,16
,2013,080101704,,,,76,112,188
,2013,080101705,,,,4,20,24
,2013,080101705,,,,4,1,5
,2013,080101705,,,,2,4,6
,2013,080101706,,,,5,12,17
,2013,080101707,,,,13,23,36
,2013,080101707,,,,18,10,28
,2013,080101708,,,,108,179,287
,2013,080101709,,,,39,39,78
,2013,080101710,,,,21,36,57
,2013,080101711,,,,4,6,10
,2013,080101712,,,,5,5,10
,2013,080101713,,,,6,5,11
,2013,080101715,,,,3,2,5
,2013,080101722,,,,13,12,25
,2013,080101723,,,,22,19,41
,2013,080101723,,,,2,1,3
,2013,080101723,,,,10,5,15
,2013,080101723,,,,38,31,69
,2013,080101724,,,,39,20,59
,2013,080101724,,,,20,14,34
,2013,080101725,,,,13,18,31
,2013,080101725,,,,1,2,3
,2013,080101726,,,,9,15,24
,2013,080101726,,,,13,10,23
,2013,080101728,,,,8,15,23
,2013,080101728,,,,12,13,25
,2013,080101729,,,,3,6,9
,2013,080101729,,,,5,8,13
,2013,080101730,,,,34,29,63
,2013,080101730,,,,28,32,60
,2013,080101732,,,,13,10,23
,2013,080101732,,,,7,5,12
,2013,080101733,,,,0,1,1
,2013,080101733,,,,4,0,4
,2013,080101734,,,,3,2,5
,2013,080101734,,,,3,7,10
,2013,080101736,,,,13,16,29
,2013,080101738,,,,14,28,42
,2013,080101739,,,,14,9,23
,2013,080101741,,,,11,18,29
,2013,080101742,,,,4,3,7
,2013,080101743,,,,6,5,11
,2013,080101744,,,,6,9,15
,2013,080101745,,,,23,26,49
,2013,080101747,,,,11,17,28
,2013,080101748,,,,10,15,25
,2013,080101749,,,,12,12,24
,2013,080101751,,,,79,37,116
,2013,080101752,,,,62,45,107
,2013,080101753,,,,11,7,18
,2013,080101753,,,,6,4,10
,2013,080101753,,,,17,6,23
,2013,080101754,,,,2,7,9
,2013,080101754,,,,4,3,7
,2013,080101755,,,,6,4,10
,2013,080101756,,,,12,7,19
,2013,080101756,,,,2,4,6
,2013,080101757,,,,5,9,14
,2013,080101758,,,,60,45,105
,2013,080101759,,,,5,3,8
,2013,080101759,,,,14,10,24
,2013,080101759,,,,27,38,65
,2013,080101761,,,,44,46,90
,2013,080101761,,,,6,13,19
,2013,080101762,,,,28,36,64
,2013,080101762,,,,10,9,19
,2013,080101764,,,,8,5,13
,2013,080101765,,,,5,8,13
,2013,080101766,,,,11,12,23
,2013,080101767,,,,19,28,47
,2013,080101769,,,,15,14,29
,2013,080101868,,,,19,29,48
,2013,080101870,,,,147,165,312
,2013,080101871,,,,210,299,509
,2013,080101871,,,,70,146,216
,2013,080101872,,,,17,17,34
,2013,080101872,,,,58,53,111
,2013,080101873,,,,6,15,21
,2013,080101874,,,,55,73,128
,2013,080101874,,,,10,6,16
,2013,080101874,,,,3,1,4
,2013,080101876,,,,7,10,17
,2013,080101876,,,,55,44,99
,2013,080101877,,,,5,7,12
,2013,080101877,,,,2,1,3
,2013,080101878,,,,78,138,216
,2013,080101879,,,,5,9,14
,2013,080101879,,,,4,2,6
,2013,080101880,,,,2,7,9
,2013,080101880,,,,17,20,37
,2013,080101881,,,,23,12,35
,2013,080101881,,,,11,8,19
,2013,080101882,,,,30,29,59
,2013,080101882,,,,2,2,4
,2013,080101882,,,,6,14,20
,2013,080101883,,,,26,32,58
,2013,080101883,,,,8,9,17
,2013,080101883,,,,42,69,111
,2013,080101884,,,,4,10,14
,2013,080101884,,,,8,7,15
,2013,080101885,,,,2,0,2
,2013,080101885,,,,2,8,10
,2013,080101886,,,,15,23,38
,2013,080101886,,,,30,35,65
,2013,080101887,,,,115,143,258
,2013,080101888,,,,0,294,294
,2013,080101889,,,,36,25,61
,2013,080101889,,,,2,1,3
,2013,080101890,,,,9,4,13
,2013,080101891,,,,2,4,6
,2013,080101891,,,,20,25,45
,2013,080101891,,,,66,79,145
,2013,080101892,,,,39,35,74
,2013,080101893,,,,41,28,69
,2013,080101893,,,,8,8,16
,2013,080101894,,,,85,155,240
,2013,080101895,,,,16,13,29
,2013,080101896,,,,30,25,55
,2013,080101897,,,,89,134,223
,2013,080101898,,,,7,2,9
,2013,080101898,,,,34,13,47
,2013,080102050,,,,351,319,670
,2013,080102051,,,,290,149,439
,2013,080102052,,,,36,36,72
,2013,080102054,,,,3,3,6
,2013,080102054,,,,10,9,19
,2013,080102055,,,,18,25,43
,2013,080102055,,,,27,21,48
,2013,080102057,,,,49,53,102
,2013,080102057,,,,19,25,44
,2013,080102059,,,,14,14,28
,2013,080102059,,,,10,7,17
,2013,080102061,,,,25,31,56
,2013,080102061,,,,9,11,20
,2013,080102064,,,,3,8,11
,2013,080102066,,,,29,27,56
,2013,080102067,,,,75,120,195
,2013,080102069,,,,119,244,363
,2013,080102071,,,,219,323,542
,2013,080102072,,,,534,624,1158
,2013,080102073,,,,163,403,566
,2013,080102075,,,,83,153,236
,2013,080102076,,,,241,389,630
,2013,080102077,,,,588,1182,1770
,2013,080200001,,,,14,16,30
,2013,080200002,,,,15,11,26
,2013,080200003,,,,36,30,66
,2013,080200004,,,,151,132,283
,2013,080200005,,,,78,63,141
,2013,080200006,,,,50,45,95
,2013,080200007,,,,40,33,73
,2013,080200008,,,,98,84,182
,2013,080200009,,,,23,23,46
,2013,080200010,,,,25,17,42
,2013,080200011,,,,2,3,5
,2013,080200013,,,,4,2,6
,2013,080200015,,,,5,3,8
,2013,080200019,,,,5,7,12
,2013,080200020,,,,1,5,6
,2013,080200021,,,,4,3,7
,2013,080200023,,,,163,125,288
,2013,080200024,,,,10,6,16
,2013,080200027,,,,0,3,3
,2013,080200028,,,,2,2,4
,2013,080200029,,,,14,13,27
,2013,080200030,,,,66,52,118
,2013,080200031,,,,16,9,25
,2013,080200040,,,,13,11,24
,2013,080200067,,,,40,24,64
,2013,080200074,,,,11,7,18
,2013,080200079,,,,25,27,52
,2013,080300003,,,,78,66,144
,2013,080300004,,,,18,13,31
,2013,080300005,,,,10,6,16
,2013,080300006,,,,10,15,25
,2013,080300007,,,,8,8,16
,2013,080300008,,,,39,26,65
,2013,080300009,,,,16,25,41
,2013,080300010,,,,13,11,24
,2013,080300011,,,,25,29,54
,2013,080300012,,,,180,168,348
,2013,080300013,,,,32,30,62
,2013,080300014,,,,146,140,286
,2013,080300015,,,,192,146,338
,2013,080300016,,,,26,24,50
,2013,080300017,,,,126,89,215
,2013,080300018,,,,48,45,93
,2013,080300019,,,,166,179,345
,2013,080300020,,,,10,10,20
,2013,080300021,,,,11,4,15
,2013,080300022,,,,28,27,55
,2013,080300023,,,,17,9,26
,2013,080300024,,,,23,36,59
,2013,080300025,,,,21,22,43
,2013,080300026,,,,24,19,43
,2013,080300027,,,,29,21,50
,2013,080300028,,,,154,102,256
,2013,080300029,,,,10,10,20
,2013,080300030,,,,18,16,34
,2013,080300031,,,,16,7,23
,2013,080300032,,,,21,12,33
,2013,080300032,,,,2,4,6
,2013,080300033,,,,2,4,6
,2013,080300034,,,,61,53,114
,2013,080300035,,,,46,42,88
,2013,080300036,,,,17,14,31
,2013,080300037,,,,17,13,30
,2013,080300038,,,,47,43,90
,2013,080300039,,,,22,37,59
,2013,080300040,,,,53,59,112
,2013,080300041,,,,23,20,43
,2013,080300042,,,,4,13,17
,2013,080300043,,,,28,22,50
,2013,080300044,,,,9,14,23
,2013,080300045,,,,16,16,32
,2013,080300046,,,,10,19,29
,2013,080300047,,,,156,232,388
,2013,080300048,,,,78,76,154
,2013,080300049,,,,94,95,189
,2013,080300050,,,,92,92,184
,2013,080300051,,,,17,20,37
,2013,080300052,,,,11,19,30
,2013,080300053,,,,15,11,26
,2013,080300054,,,,7,10,17
,2013,080300055,,,,3,10,13
,2013,080300056,,,,7,3,10
,2013,080300057,,,,7,7,14
,2013,080300058,,,,17,8,25
,2013,080300059,,,,11,7,18
,2013,080300060,,,,17,19,36
,2013,080300062,,,,15,8,23
,2013,080300063,,,,17,0,17
,2013,080300064,,,,13,12,25
,2013,080300066,,,,16,21,37
,2013,080300071,,,,29,59,88
,2013,080300072,,,,13,6,19
,2013,080300073,,,,34,20,54
,2013,080300076,,,,14,13,27
,2013,080300080,,,,5,1,6
,2013,080300081,,,,5,1,6
,2013,080300083,,,,4,4,8
,2013,080300084,,,,9,9,18
,2013,080300085,,,,7,10,17
,2013,080300087,,,,4,3,7
,2013,080300088,,,,2,5,7
,2013,080300089,,,,6,3,9
,2013,080300091,,,,1,3,4
,2013,080300092,,,,4,1,5
,2013,080400001,,,,156,135,291
,2013,080400002,,,,28,20,48
,2013,080400003,,,,41,38,79
,2013,080400004,,,,165,128,293
,2013,080400005,,,,115,105,220
,2013,080400006,,,,43,35,78
,2013,080400007,,,,27,22,49
,2013,080400008,,,,49,55,104
,2013,080400009,,,,19,20,39
,2013,080400010,,,,66,50,116
,2013,080400011,,,,8,15,23
,2013,080400012,,,,8,12,20
,2013,080400013,,,,27,35,62
,2013,080400014,,,,5,7,12
,2013,080400015,,,,107,94,201
,2013,080400016,,,,45,39,84
,2013,080400017,,,,37,37,74
,2013,080400018,,,,19,29,48
,2013,080400019,,,,54,55,109
,2013,080400020,,,,66,80,146
,2013,080400021,,,,98,67,165
,2013,080400022,,,,26,24,50
,2013,080400023,,,,84,67,151
,2013,080400024,,,,24,22,46
,2013,080400025,,,,5,4,9
,2013,080400026,,,,69,70,139
,2013,080400027,,,,52,54,106
,2013,080400028,,,,28,26,54
,2013,080400029,,,,31,22,53
,2013,080400030,,,,85,78,163
,2013,080400031,,,,32,22,54
,2013,080400032,,,,56,34,90
,2013,080400033,,,,87,86,173
,2013,080400034,,,,31,29,60
,2013,080400035,,,,19,31,50
,2013,080400036,,,,50,52,102
,2013,080400036,,,,3,7,10
,2013,080400038,,,,7,20,27
,2013,080400039,,,,8,7,15
,2013,080400040,,,,20,25,45
,2013,080400041,,,,23,27,50
,2013,080400042,,,,20,11,31
,2013,080400043,,,,16,23,39
,2013,080400044,,,,70,51,121
,2013,080400045,,,,41,28,69
,2013,080400049,,,,13,3,16
,2013,080400050,,,,4,4,8
,2013,080400051,,,,9,6,15
,2013,080400052,,,,32,21,53
,2013,080400053,,,,9,16,25
,2013,080400054,,,,13,7,20
,2013,080400055,,,,5,2,7
,2013,080400056,,,,3,4,7
,2013,080400057,,,,42,33,75
,2013,080400058,,,,8,6,14
,2013,080400059,,,,6,6,12
,2013,080400062,,,,5,7,12
,2013,080400063,,,,3,0,3
,2013,080400064,,,,38,34,72
,2013,080400065,,,,31,36,67
,2013,080400068,,,,5,2,7
,2013,080400085,,,,5,6,11
,2013,080400088,,,,5,4,9
,2013,080400090,,,,16,11,27
,2013,080400093,,,,8,8,16
,2013,080400094,,,,14,13,27
,2013,080400096,,,,4,1,5
,2013,080400097,,,,2,2,4
,2013,080400098,,,,3,6,9
,2013,080400099,,,,3,0,3
,2013,080400101,,,,2,3,5
,2013,080400103,,,,2,2,4
,2013,080400111,,,,7,2,9
,2013,080400120,,,,7,7,14
,2013,080400121,,,,25,32,57
,2013,080400123,,,,3,3,6
,2013,080400124,,,,5,2,7
,2013,080400125,,,,5,4,9
,2013,080400126,,,,5,3,8
,2013,080400128,,,,4,5,9
,2013,080400129,,,,4,2,6
,2013,080400130,,,,7,0,7
,2013,080400131,,,,4,2,6
,2013,080400132,,,,4,3,7
,2013,080400133,,,,3,4,7
,2013,080400134,,,,8,10,18
,2013,080400137,,,,2,3,5
,2013,080400139,,,,7,8,15
,2013,080400140,,,,8,8,16
,2013,080400142,,,,2,13,15
,2013,080400143,,,,7,8,15
,2013,080400144,,,,15,13,28
,2013,080400146,,,,6,3,9
,2013,080400147,,,,12,11,23
,2013,080400148,,,,1,5,6
,2013,080400149,,,,7,1,8
,2013,080400150,,,,2,2,4
,2013,080400153,,,,3,2,5
,2013,080400166,,,,2,3,5
,2013,080400167,,,,3,2,5
,2013,080400168,,,,2,3,5
,2013,080400169,,,,2,3,5
,2013,080500001,,,,148,213,361
,2013,080500002,,,,25,20,45
,2013,080500003,,,,11,13,24
,2013,080500004,,,,23,6,29
,2013,080500005,,,,123,114,237
,2013,080500006,,,,157,197,354
,2013,080500007,,,,58,49,107
,2013,080500008,,,,121,136,257
,2013,080500009,,,,8,1,9
,2013,080500010,,,,137,114,251
,2013,080500011,,,,304,275,579
,2013,080500012,,,,26,26,52
,2013,080500013,,,,21,25,46
,2013,080500014,,,,33,34,67
,2013,080500015,,,,11,7,18
,2013,080500016,,,,33,25,58
,2013,080500017,,,,21,24,45
,2013,080500018,,,,6,8,14
,2013,080500019,,,,16,19,35
,2013,080500019,,,,10,9,19
,2013,080500020,,,,56,51,107
,2013,080500021,,,,27,27,54
,2013,080500022,,,,251,245,496
,2013,080500023,,,,39,86,125
,2013,080500024,,,,7,8,15
,2013,080500025,,,,19,28,47
,2013,080500026,,,,33,22,55
,2013,080500028,,,,12,18,30
,2013,080500029,,,,7,7,14
,2013,080500030,,,,7,5,12
,2013,080500032,,,,4,9,13
,2013,080500034,,,,187,190,377
,2013,080500035,,,,14,18,32
,2013,080500035,,,,3,4,7
,2013,080500040,,,,9,13,22
,2013,080500041,,,,4,7,11
,2013,080500042,,,,11,9,20
,2013,080500044,,,,3,5,8
,2013,080500045,,,,11,9,20
,2013,080500046,,,,13,2,15
,2013,080500047,,,,37,71,108
,2013,080500048,,,,6,7,13
,2013,080500049,,,,9,15,24
,2013,080500050,,,,6,3,9
,2013,080500051,,,,4,13,17
,2013,080500052,,,,4,3,7
,2013,080500053,,,,6,5,11
,2013,080600002,,,,23,23,46
,2013,080600003,,,,27,19,46
,2013,080600003,,,,5,13,18
,2013,080600004,,,,6,8,14
,2013,080600007,,,,487,464,951
,2013,080600008,,,,63,48,111
,2013,080600009,,,,29,35,64
,2013,080600010,,,,6,9,15
,2013,080600011,,,,16,10,26
,2013,080600012,,,,16,16,32
,2013,080600013,,,,16,14,30
,2013,080600014,,,,27,24,51
,2013,080600015,,,,4,4,8
,2013,080600016,,,,27,23,50
,2013,080600016,,,,12,28,40
,2013,080600017,,,,10,13,23
,2013,080600018,,,,25,32,57
,2013,080600019,,,,94,69,163
,2013,080600020,,,,25,31,56
,2013,080600021,,,,8,10,18
,2013,080600022,,,,10,13,23
,2013,080600023,,,,15,18,33
,2013,080600024,,,,14,10,24
,2013,080600025,,,,34,26,60
,2013,080600026,,,,17,20,37
,2013,080600027,,,,16,16,32
,2013,080600028,,,,10,19,29
,2013,080600029,,,,7,7,14
,2013,080600030,,,,12,20,32
,2013,080600031,,,,15,17,32
,2013,080600032,,,,250,264,514
,2013,080600033,,,,25,15,40
,2013,080600034,,,,38,47,85
,2013,080600035,,,,52,39,91
,2013,080600036,,,,13,12,25
,2013,080600037,,,,11,10,21
,2013,080600038,,,,209,218,427
,2013,080600038,,,,28,22,50
,2013,080600039,,,,37,30,67
,2013,080600040,,,,11,10,21
,2013,080600041,,,,6,8,14
,2013,080600042,,,,11,13,24
,2013,080600042,,,,1,2,3
,2013,080600043,,,,18,16,34
,2013,080600044,,,,18,12,30
,2013,080600045,,,,22,9,31
,2013,080600046,,,,23,34,57
,2013,080600046,,,,10,10,20
,2013,080600047,,,,27,20,47
,2013,080600048,,,,10,9,19
,2013,080600050,,,,18,14,32
,2013,080600051,,,,28,22,50
,2013,080600051,,,,13,8,21
,2013,080600052,,,,7,5,12
,2013,080600053,,,,7,9,16
,2013,080600054,,,,35,30,65
,2013,080600055,,,,146,117,263
,2013,080600055,,,,22,16,38
,2013,080600055,,,,36,68,104
,2013,080600056,,,,96,83,179
,2013,080600057,,,,371,389,760
,2013,080600058,,,,432,486,918
,2013,080600060,,,,5,9,14
,2013,080600061,,,,4,9,13
,2013,080600062,,,,28,33,61
,2013,080600063,,,,12,12,24
,2013,080600064,,,,29,20,49
,2013,080600065,,,,40,20,60
,2013,080600066,,,,7,7,14
,2013,080600067,,,,132,119,251
,2013,080600069,,,,9,20,29
,2013,080600069,,,,18,13,31
,2013,080600071,,,,41,29,70
,2013,080600071,,,,43,48,91
,2013,080600075,,,,4,1,5
,2013,080600081,,,,8,13,21
,2013,080600084,,,,10,4,14
,2013,080600086,,,,5,3,8
,2013,080600088,,,,4,0,4
,2013,080600090,,,,8,7,15
,2013,080600091,,,,7,10,17
,2013,080600092,,,,19,9,28
,2013,080600093,,,,24,10,34
,2013,080600094,,,,23,21,44
,2013,080600095,,,,33,24,57
,2013,080600095,,,,13,8,21
,2013,080600096,,,,8,10,18
,2013,080600100,,,,7,2,9
,2013,080600105,,,,14,7,21
,2013,080600105,,,,8,14,22
,2013,080600106,,,,2,4,6
,2013,080600108,,,,2,3,5
,2013,080600109,,,,4,2,6
,2013,080600110,,,,3,2,5
,2013,080600114,,,,3,8,11
,2013,080600115,,,,5,2,7
,2013,080600116,,,,4,4,8
,2013,080600117,,,,9,12,21
,2013,080600117,,,,33,17,50
,2013,080600118,,,,10,8,18
,2013,080600119,,,,54,41,95
,2013,080600120,,,,0,59,59
,2013,080600121,,,,170,171,341
,2013,080600122,,,,9,6,15
,2013,080600122,,,,6,6,12
,2013,080600123,,,,10,14,24
,2013,080600123,,,,11,24,35
,2013,080600124,,,,6,1,7
,2013,080600125,,,,12,3,15
,2013,080600143,,,,6,3,9
,2013,080600144,,,,4,5,9
,2013,080700001,,,,101,102,203
,2013,080700002,,,,35,36,71
,2013,080700003,,,,2,8,10
,2013,080700004,,,,22,17,39
,2013,080700005,,,,16,26,42
,2013,080700006,,,,18,11,29
,2013,080700007,,,,29,31,60
,2013,080700008,,,,32,28,60
,2013,080700009,,,,8,4,12
,2013,080700010,,,,8,12,20
,2013,080700014,,,,9,11,20
,2013,080700015,,,,6,5,11
,2013,080700017,,,,23,28,51
,2013,080700018,,,,8,8,16
,2013,080700019,,,,2,7,9
,2013,080700028,,,,1,3,4
,2013,080700029,,,,5,3,8
,2013,080700030,,,,5,2,7
,2013,080700031,,,,0,5,5
,2013,080800002,,,,69,42,111
,2013,080800004,,,,26,19,45
,2013,080800005,,,,15,13,28
,2013,080800006,,,,25,27,52
,2013,080800007,,,,14,14,28
,2013,080800008,,,,15,22,37
,2013,080800009,,,,34,35,69
,2013,080800010,,,,13,16,29
,2013,080800011,,,,21,14,35
,2013,080800013,,,,49,50,99
,2013,080800014,,,,5,5,10
,2013,080800015,,,,17,15,32
,2013,080800016,,,,16,11,27
,2013,080800017,,,,10,9,19
,2013,080800018,,,,17,13,30
,2013,080800019,,,,18,21,39
,2013,080800020,,,,44,34,78
,2013,080800021,,,,58,45,103
,2013,080800023,,,,3,6,9
,2013,080800024,,,,2,7,9
,2013,080800026,,,,5,3,8
,2013,080800027,,,,34,19,53
,2013,080800028,,,,13,8,21
,2013,080800029,,,,32,29,61
,2013,080800030,,,,3,6,9
,2013,080800031,,,,4,2,6
,2013,080800033,,,,6,6,12
,2013,080800039,,,,6,5,11
,2013,080800044,,,,6,5,11
,2013,080800046,,,,6,7,13
,2013,080800047,,,,102,103,205
,2013,080800059,,,,9,5,14
,2013,080800060,,,,4,3,7
,2013,080800062,,,,2,2,4
,2013,080800064,,,,2,3,5
,2013,080800066,,,,3,0,3
,2013,080800067,,,,4,3,7
,2013,080800068,,,,4,4,8
,2013,080800069,,,,1,4,5
,2013,080900005,,,,225,225,450
,2013,080900006,,,,27,23,50
,2013,080900006,,,,8,6,14
,2013,080900007,,,,7,5,12
,2013,080900007,,,,29,61,90
,2013,080900008,,,,43,35,78
,2013,080900008,,,,6,6,12
,2013,080900009,,,,6,12,18
,2013,080900009,,,,46,44,90
,2013,080900010,,,,15,14,29
,2013,080900011,,,,12,15,27
,2013,080900012,,,,25,12,37
,2013,080900013,,,,12,20,32
,2013,080900014,,,,49,30,79
,2013,080900015,,,,62,43,105
,2013,080900016,,,,53,42,95
,2013,080900017,,,,7,6,13
,2013,080900017,,,,21,32,53
,2013,080900018,,,,2,2,4
,2013,080900018,,,,17,18,35
,2013,080900019,,,,22,17,39
,2013,080900020,,,,102,85,187
,2013,080900021,,,,23,13,36
,2013,080900022,,,,13,20,33
,2013,080900023,,,,12,21,33
,2013,080900024,,,,51,48,99
,2013,080900024,,,,6,5,11
,2013,080900025,,,,18,16,34
,2013,080900026,,,,60,56,116
,2013,080900026,,,,8,18,26
,2013,080900027,,,,32,23,55
,2013,080900028,,,,23,22,45
,2013,080900029,,,,16,13,29
,2013,080900030,,,,10,9,19
,2013,080900031,,,,23,12,35
,2013,080900032,,,,10,8,18
,2013,080900033,,,,14,19,33
,2013,080900034,,,,17,16,33
,2013,080900035,,,,21,14,35
,2013,080900036,,,,7,12,19
,2013,080900037,,,,18,15,33
,2013,080900038,,,,27,20,47
,2013,080900039,,,,17,33,50
,2013,080900040,,,,40,35,75
,2013,080900041,,,,235,261,496
,2013,080900042,,,,11,9,20
,2013,080900043,,,,66,50,116
,2013,080900044,,,,12,12,24
,2013,080900045,,,,30,32,62
,2013,080900046,,,,22,10,32
,2013,080900047,,,,16,7,23
,2013,080900048,,,,23,19,42
,2013,080900049,,,,7,5,12
,2013,080900050,,,,7,4,11
,2013,080900051,,,,10,18,28
,2013,080900051,,,,10,10,20
,2013,080900052,,,,13,14,27
,2013,080900053,,,,24,26,50
,2013,080900055,,,,24,21,45
,2013,080900056,,,,30,20,50
,2013,080900058,,,,14,10,24
,2013,080900059,,,,7,16,23
,2013,080900060,,,,17,15,32
,2013,080900062,,,,13,8,21
,2013,080900064,,,,3,3,6
,2013,080900065,,,,0,3,3
,2013,080900067,,,,2,1,3
,2013,080900068,,,,2,2,4
,2013,080900070,,,,8,8,16
,2013,080900072,,,,3,0,3
,2013,080900074,,,,2,3,5
,2013,080900076,,,,4,3,7
,2013,080900077,,,,0,6,6
,2013,080900090,,,,11,5,16
,2013,080900091,,,,20,17,37
,2013,080900092,,,,2,3,5
,2013,080900094,,,,3,3,6
,2013,080900095,,,,3,2,5
,2013,080900101,,,,39,54,93
,2013,080900102,,,,8,10,18
,2013,080900103,,,,5,16,21
,2013,080900106,,,,6,1,7
,2013,080900107,,,,3,4,7
,2013,080900109,,,,3,2,5
,2013,080900122,,,,1,3,4
,2013,080900127,,,,3,1,4
,2013,080900131,,,,1,3,4
,2013,080900132,,,,3,1,4
,2013,080900133,,,,5,4,9
,2013,080900134,,,,2,3,5
,2013,080900136,,,,24,19,43
,2013,080900137,,,,15,9,24
,2013,080900138,,,,1,2,3
,2013,080900139,,,,8,7,15
,2013,080900140,,,,2,3,5
,2013,080900141,,,,6,1,7
,2013,080900143,,,,4,1,5
,2013,080900144,,,,27,10,37
,2013,080900154,,,,35,33,68
,2013,081000002,,,,25,19,44
,2013,081000003,,,,26,12,38
,2013,081000004,,,,8,13,21
,2013,081000005,,,,28,42,70
,2013,081000006,,,,77,50,127
,2013,081000007,,,,10,6,16
,2013,081000008,,,,3,7,10
,2013,081000009,,,,27,21,48
,2013,081000010,,,,72,51,123
,2013,081000011,,,,13,4,17
,2013,081000012,,,,18,12,30
,2013,081000013,,,,6,6,12
,2013,081000014,,,,10,6,16
,2013,081000015,,,,17,6,23
,2013,081000016,,,,58,59,117
,2013,081000017,,,,17,11,28
,2013,081000018,,,,32,25,57
,2013,081000019,,,,4,12,16
,2013,081000020,,,,16,8,24
,2013,081000021,,,,14,9,23
,2013,081000022,,,,62,79,141
,2013,081000023,,,,6,11,17
,2013,081000024,,,,6,5,11
,2013,081000025,,,,9,5,14
,2013,081000026,,,,2,9,11
,2013,081000027,,,,22,13,35
,2013,081000028,,,,5,6,11
,2013,081000029,,,,6,7,13
,2013,081000030,,,,118,81,199
,2013,081000033,,,,7,10,17
,2013,081000034,,,,3,10,13
,2013,081000035,,,,4,4,8
,2013,081000036,,,,4,5,9
,2013,081000037,,,,8,9,17
,2013,081000038,,,,6,6,12
,2013,081000040,,,,1,6,7
,2013,081000041,,,,4,1,5
,2013,081000042,,,,5,2,7
,2013,081000043,,,,8,1,9
,2013,081000045,,,,3,3,6
,2013,081100001,,,,7,7,14
,2013,081100002,,,,10,5,15
,2013,081100003,,,,11,2,13
,2013,081100004,,,,4,8,12
,2013,081100005,,,,29,20,49
,2013,081100006,,,,89,59,148
,2013,081100007,,,,7,5,12
,2013,081100008,,,,172,115,287
,2013,081100009,,,,14,16,30
,2013,081100010,,,,31,36,67
,2013,081100011,,,,31,15,46
,2013,081100012,,,,18,17,35
,2013,081100013,,,,20,26,46
,2013,081100014,,,,41,34,75
,2013,081100015,,,,21,28,49
,2013,081100016,,,,16,9,25
,2013,081100018,,,,24,11,35
,2013,081100019,,,,9,10,19
,2013,081100020,,,,14,8,22
,2013,081100021,,,,9,7,16
,2013,081100023,,,,18,20,38
,2013,081100024,,,,21,10,31
,2013,081100025,,,,23,19,42
,2013,081100027,,,,25,27,52
,2013,081100030,,,,30,33,63
,2013,081100031,,,,7,9,16
,2013,081100032,,,,94,93,187
,2013,081100033,,,,15,9,24
,2013,081100034,,,,27,27,54
,2013,081100035,,,,50,41,91
,2013,081100036,,,,28,18,46
,2013,081100037,,,,12,6,18
,2013,081100038,,,,19,22,41
,2013,081100039,,,,3,9,12
,2013,081100039,,,,8,3,11
,2013,081100040,,,,25,16,41
,2013,081100041,,,,20,6,26
,2013,081100042,,,,122,169,291
,2013,081100043,,,,31,20,51
,2013,081100044,,,,20,17,37
,2013,081100046,,,,8,11,19
,2013,081100048,,,,15,14,29
,2013,081100049,,,,21,18,39
,2013,081100052,,,,9,13,22
,2013,081100055,,,,28,20,48
,2013,081100055,,,,5,9,14
,2013,081100056,,,,22,29,51
,2013,081100057,,,,7,8,15
,2013,081100058,,,,5,3,8
,2013,081100059,,,,5,3,8
,2013,081100060,,,,2,4,6
,2013,081100063,,,,6,2,8
,2013,081100063,,,,5,3,8
,2013,081100065,,,,5,5,10
,2013,081100066,,,,1,7,8
,2013,081100067,,,,11,3,14
,2013,081100069,,,,7,4,11
,2013,081100070,,,,4,1,5
,2013,081100072,,,,5,5,10
,2013,081100073,,,,4,4,8
,2013,081100074,,,,5,8,13
,2013,081100077,,,,3,6,9
,2013,081100078,,,,5,2,7
,2013,081100079,,,,3,5,8
,2013,081200001,,,,7,7,14
,2013,081200002,,,,65,59,124
,2013,081200003,,,,4,3,7
,2013,081200004,,,,4,1,5
,2013,081200005,,,,15,7,22
,2013,081200006,,,,12,10,22
,2013,081200007,,,,10,7,17
,2013,081200008,,,,14,18,32
,2013,081200009,,,,7,2,9
,2013,081200010,,,,3,5,8
,2013,081200011,,,,13,10,23
,2013,081200012,,,,8,10,18
,2013,081200013,,,,4,6,10
,2013,081200014,,,,5,9,14
,2013,081200015,,,,70,85,155
,2013,081200024,,,,5,2,7
,2013,081200027,,,,4,4,8
,2013,081200028,,,,3,3,6
,2013,081300001,,,,198,197,395
,2013,081300002,,,,298,334,632
,2013,081300003,,,,43,56,99
,2013,081300004,,,,22,18,40
,2013,081300005,,,,19,27,46
,2013,081300006,,,,21,20,41
,2013,081300007,,,,9,5,14
,2013,081300008,,,,24,32,56
,2013,081300009,,,,9,19,28
,2013,081300010,,,,25,9,34
,2013,081300011,,,,17,13,30
,2013,081300012,,,,42,32,74
,2013,081300013,,,,26,19,45
,2013,081300014,,,,91,91,182
,2013,081300015,,,,11,6,17
,2013,081300016,,,,45,56,101
,2013,081300017,,,,26,11,37
,2013,081300018,,,,22,18,40
,2013,081300019,,,,39,40,79
,2013,081300020,,,,5,17,22
,2013,081300021,,,,16,18,34
,2013,081300024,,,,30,15,45
,2013,081300025,,,,6,7,13
,2013,081300026,,,,148,188,336
,2013,081300028,,,,2,5,7
,2013,081300036,,,,14,13,27
,2013,081300037,,,,28,29,57
,2013,081300038,,,,19,27,46
,2013,081300039,,,,12,16,28
,2013,081300040,,,,19,18,37
,2013,081300041,,,,3,7,10
,2013,081300044,,,,4,8,12
,2013,081300045,,,,3,1,4
,2013,081300046,,,,5,5,10
,2013,081300047,,,,3,3,6
,2013,081300048,,,,2,3,5
,2013,081300049,,,,2,1,3
,2013,081300052,,,,2,4,6
,2013,081300054,,,,5,4,9
,2013,081300055,,,,4,5,9
,2013,081300060,,,,3,3,6
,2013,081300061,,,,5,2,7
,2013,081300064,,,,3,5,8
,2013,081300066,,,,5,2,7
,2013,081300070,,,,2,3,5
,2013,081300071,,,,3,2,5
,2013,081400001,,,,7,4,11
,2013,081400002,,,,232,209,441
,2013,081400003,,,,24,17,41
,2013,081400004,,,,125,109,234
,2013,081400005,,,,156,150,306
,2013,081400006,,,,104,86,190
,2013,081400007,,,,12,11,23
,2013,081400008,,,,32,26,58
,2013,081400009,,,,52,50,102
,2013,081400010,,,,31,22,53
,2013,081400011,,,,38,38,76
,2013,081400012,,,,30,29,59
,2013,081400013,,,,61,65,126
,2013,081400014,,,,16,23,39
,2013,081400015,,,,31,26,57
,2013,081400016,,,,9,17,26
,2013,081400017,,,,33,33,66
,2013,081400018,,,,39,31,70
,2013,081400019,,,,9,11,20
,2013,081400020,,,,61,76,137
,2013,081400021,,,,28,22,50
,2013,081400022,,,,15,16,31
,2013,081400023,,,,13,7,20
,2013,081400024,,,,16,22,38
,2013,081400025,,,,23,11,34
,2013,081400026,,,,29,32,61
,2013,081400027,,,,108,115,223
,2013,081400028,,,,81,96,177
,2013,081400029,,,,4,8,12
,2013,081400032,,,,7,11,18
,2013,081400033,,,,13,12,25
,2013,081400034,,,,20,18,38
,2013,081400035,,,,16,32,48
,2013,081400036,,,,11,6,17
,2013,081400037,,,,24,30,54
,2013,081400038,,,,17,16,33
,2013,081400039,,,,20,11,31
,2013,081400040,,,,8,11,19
,2013,081400041,,,,40,54,94
,2013,081400043,,,,17,7,24
,2013,081400044,,,,14,10,24
,2013,081400046,,,,21,10,31
,2013,081400049,,,,30,26,56
,2013,081400050,,,,13,9,22
,2013,081400051,,,,13,9,22
,2013,081400053,,,,10,6,16
,2013,081400054,,,,3,2,5
,2013,081400057,,,,10,8,18
,2013,081400058,,,,7,10,17
,2013,081400068,,,,7,3,10
,2013,081400069,,,,18,5,23
,2013,081400073,,,,20,15,35
,2013,081400080,,,,29,14,43
,2013,081400083,,,,12,5,17
,2013,081400084,,,,15,13,28
,2013,081400086,,,,12,7,19
,2013,081400088,,,,7,7,14
,2013,081400091,,,,1,6,7
,2013,081400093,,,,5,3,8
,2013,081400094,,,,6,7,13
,2013,081400095,,,,7,12,19
,2013,081400096,,,,4,3,7
,2013,081400099,,,,8,4,12
,2013,081400100,,,,10,11,21
,2013,081400101,,,,7,5,12
,2013,081400103,,,,4,1,5
,2013,081400104,,,,3,5,8
,2013,081400105,,,,3,2,5
,2013,081400106,,,,4,2,6
,2013,081400109,,,,7,4,11
,2013,081400110,,,,9,8,17
,2013,081400111,,,,18,24,42
,2013,081400112,,,,5,6,11
,2013,081400113,,,,5,3,8
,2013,081500001,,,,206,185,391
,2013,081500002,,,,11,2,13
,2013,081500003,,,,45,44,89
,2013,081500005,,,,44,32,76
,2013,081500006,,,,20,21,41
,2013,081500008,,,,25,35,60
,2013,081500009,,,,22,13,35
,2013,081500010,,,,46,35,81
,2013,081500011,,,,46,46,92
,2013,081500012,,,,6,7,13
,2013,081500013,,,,23,27,50
,2013,081500014,,,,47,39,86
,2013,081500015,,,,179,157,336
,2013,081500016,,,,21,20,41
,2013,081500017,,,,42,40,82
,2013,081500018,,,,19,26,45
,2013,081500019,,,,20,21,41
,2013,081500020,,,,44,50,94
,2013,081500021,,,,26,22,48
,2013,081500022,,,,18,19,37
,2013,081500023,,,,14,11,25
,2013,081500024,,,,19,24,43
,2013,081500025,,,,63,46,109
,2013,081500026,,,,56,38,94
,2013,081500027,,,,35,31,66
,2013,081500028,,,,14,16,30
,2013,081500029,,,,12,5,17
,2013,081500033,,,,5,4,9
,2013,081500034,,,,18,11,29
,2013,081500035,,,,23,18,41
,2013,081500037,,,,18,12,30
,2013,081500039,,,,36,35,71
,2013,081500040,,,,6,3,9
,2013,081500041,,,,8,8,16
,2013,081500042,,,,5,5,10
,2013,081500043,,,,4,2,6
,2013,081500044,,,,10,10,20
,2013,081500045,,,,3,4,7
,2013,081500046,,,,8,9,17
,2013,081500048,,,,5,1,6
,2013,081500050,,,,4,2,6
,2013,081500051,,,,18,12,30
,2013,081500052,,,,67,58,125
,2013,081500053,,,,7,4,11
,2013,081500054,,,,2,1,3
,2013,081500063,,,,7,2,9
,2013,081500065,,,,4,3,7
,2013,081500066,,,,7,5,12
,2013,081500068,,,,6,3,9
,2013,081500069,,,,4,3,7
,2013,081500071,,,,5,6,11
,2013,081500072,,,,7,3,10
,2013,081500074,,,,2,5,7
,2013,081500075,,,,8,13,21
,2013,081500076,,,,2,3,5
,2013,081600001,,,,395,430,825
,2013,081600002,,,,9,10,19
,2013,081600003,,,,259,276,535
,2013,081600004,,,,57,43,100
,2013,081600005,,,,104,130,234
,2013,081600006,,,,25,25,50
,2013,081600007,,,,11,13,24
,2013,081600008,,,,18,6,24
,2013,081600009,,,,9,7,16
,2013,081600010,,,,24,20,44
,2013,081600011,,,,98,95,193
,2013,081600013,,,,6,15,21
,2013,081600014,,,,34,48,82
,2013,081600015,,,,31,26,57
,2013,081600016,,,,50,30,80
,2013,081600017,,,,15,3,18
,2013,081600018,,,,119,128,247
,2013,081600019,,,,49,38,87
,2013,081600021,,,,72,68,140
,2013,081600022,,,,5,5,10
,2013,081600023,,,,13,11,24
,2013,081600024,,,,15,13,28
,2013,081600025,,,,11,3,14
,2013,081600026,,,,15,15,30
,2013,081600027,,,,19,25,44
,2013,081600028,,,,5,4,9
,2013,081600029,,,,23,19,42
,2013,081600030,,,,39,26,65
,2013,081600031,,,,58,62,120
,2013,081600032,,,,8,10,18
,2013,081600034,,,,8,16,24
,2013,081600035,,,,39,33,72
,2013,081600036,,,,42,46,88
,2013,081600037,,,,45,41,86
,2013,081600038,,,,12,10,22
,2013,081600039,,,,25,37,62
,2013,081600040,,,,20,26,46
,2013,081600041,,,,50,39,89
,2013,081600042,,,,8,10,18
,2013,081600043,,,,17,19,36
,2013,081600044,,,,20,15,35
,2013,081600046,,,,26,30,56
,2013,081600047,,,,12,8,20
,2013,081600049,,,,4,5,9
,2013,081600051,,,,12,6,18
,2013,081600052,,,,7,2,9
,2013,081600053,,,,6,6,12
,2013,081600055,,,,10,10,20
,2013,081600056,,,,46,26,72
,2013,081600057,,,,15,6,21
,2013,081600058,,,,6,8,14
,2013,081600060,,,,6,4,10
,2013,081600061,,,,11,7,18
,2013,081600062,,,,17,16,33
,2013,081600064,,,,213,289,502
,2013,081600064,,,,4,8,12
,2013,081600078,,,,11,7,18
,2013,081600078,,,,48,25,73
,2013,081600081,,,,7,3,10
,2013,081600082,,,,1,3,4
,2013,081600083,,,,5,0,5
,2013,081600084,,,,7,6,13
,2013,081600087,,,,10,7,17
,2013,081600088,,,,1,4,5
,2013,081600089,,,,2,5,7
,2013,081600093,,,,16,13,29
,2013,081600095,,,,39,71,110
,2013,081600096,,,,6,7,13
,2013,081600097,,,,13,9,22
,2013,081600103,,,,10,10,20
,2013,081600104,,,,2,3,5
,2013,081700001,,,,183,168,351
,2013,081700002,,,,51,62,113
,2013,081700003,,,,12,7,19
,2013,081700005,,,,66,44,110
,2013,081700005,,,,27,19,46
,2013,081700006,,,,21,19,40
,2013,081700007,,,,145,106,251
,2013,081700008,,,,18,16,34
,2013,081700009,,,,5,11,16
,2013,081700010,,,,63,53,116
,2013,081700011,,,,20,12,32
,2013,081700012,,,,31,43,74
,2013,081700013,,,,32,25,57
,2013,081700014,,,,17,11,28
,2013,081700015,,,,18,11,29
,2013,081700016,,,,104,81,185
,2013,081700017,,,,347,289,636
,2013,081700017,,,,46,25,71
,2013,081700018,,,,5,11,16
,2013,081700019,,,,32,34,66
,2013,081700020,,,,28,22,50
,2013,081700021,,,,22,16,38
,2013,081700022,,,,41,42,83
,2013,081700024,,,,7,22,29
,2013,081700025,,,,131,79,210
,2013,081700026,,,,17,28,45
,2013,081700026,,,,7,6,13
,2013,081700026,,,,7,10,17
,2013,081700027,,,,25,19,44
,2013,081700028,,,,16,8,24
,2013,081700030,,,,24,13,37
,2013,081700031,,,,10,7,17
,2013,081700032,,,,28,35,63
,2013,081700034,,,,30,22,52
,2013,081700036,,,,8,7,15
,2013,081700037,,,,185,206,391
,2013,081700038,,,,13,9,22
,2013,081700039,,,,5,6,11
,2013,081700047,,,,7,5,12
,2013,081700050,,,,21,9,30
,2013,081700052,,,,34,37,71
,2013,081700054,,,,5,5,10
,2013,081700055,,,,3,3,6
,2013,081700057,,,,4,3,7
,2013,081700059,,,,4,6,10
,2013,081700060,,,,5,4,9
,2013,081700061,,,,1,4,5
,2013,081700062,,,,10,10,20
,2013,081700063,,,,5,5,10
,2013,081700064,,,,4,9,13
,2013,081700065,,,,1,4,5
,2013,081700065,,,,13,18,31
,2013,081700066,,,,8,9,17
,2013,081700067,,,,1,8,9
,2013,081700068,,,,5,5,10
,2013,081700069,,,,3,4,7
,2013,081800003,,,,55,40,95
,2013,081800004,,,,25,26,51
,2013,081800005,,,,15,16,31
,2013,081800006,,,,41,44,85
,2013,081800007,,,,14,14,28
,2013,081800009,,,,17,18,35
,2013,081800011,,,,10,9,19
,2013,081800011,,,,133,147,280
,2013,081800012,,,,8,8,16
,2013,081800013,,,,6,5,11
,2013,081800014,,,,30,14,44
,2013,081800015,,,,7,6,13
,2013,081800016,,,,7,4,11
,2013,081800017,,,,3,4,7
,2013,081800028,,,,16,15,31
,2013,081800028,,,,2,2,4
,2013,081900001,,,,194,197,391
,2013,081900003,,,,105,81,186
,2013,081900004,,,,11,8,19
,2013,081900005,,,,15,15,30
,2013,081900006,,,,211,202,413
,2013,081900007,,,,115,122,237
,2013,081900007,,,,19,29,48
,2013,081900008,,,,81,74,155
,2013,081900009,,,,59,51,110
,2013,081900010,,,,20,15,35
,2013,081900011,,,,22,25,47
,2013,081900012,,,,35,35,70
,2013,081900013,,,,14,5,19
,2013,081900014,,,,16,15,31
,2013,081900015,,,,22,19,41
,2013,081900016,,,,17,16,33
,2013,081900017,,,,4,5,9
,2013,081900018,,,,10,4,14
,2013,081900019,,,,21,25,46
,2013,081900020,,,,32,23,55
,2013,081900021,,,,6,7,13
,2013,081900022,,,,10,14,24
,2013,081900023,,,,9,5,14
,2013,081900024,,,,2,8,10
,2013,081900025,,,,8,13,21
,2013,081900026,,,,15,15,30
,2013,081900027,,,,14,7,21
,2013,081900033,,,,4,1,5
,2013,081900034,,,,4,4,8
,2013,081900036,,,,3,2,5
,2013,081900040,,,,5,2,7
,2013,081900042,,,,34,35,69
,2013,082000001,,,,22,19,41
,2013,082000003,,,,51,56,107
,2013,082000004,,,,270,293,563
,2013,082000005,,,,48,53,101
,2013,082000006,,,,30,10,40
,2013,082000007,,,,13,19,32
,2013,082000008,,,,43,33,76
,2013,082000009,,,,23,10,33
,2013,082000010,,,,30,14,44
,2013,082000011,,,,8,12,20
,2013,082000012,,,,20,15,35
,2013,082000013,,,,25,34,59
,2013,082000014,,,,32,58,90
,2013,082000015,,,,46,35,81
,2013,082000016,,,,54,67,121
,2013,082000017,,,,14,24,38
,2013,082000018,,,,14,14,28
,2013,082000019,,,,51,65,116
,2013,082000021,,,,26,20,46
,2013,082000022,,,,11,9,20
,2013,082000023,,,,13,9,22
,2013,082000024,,,,20,27,47
,2013,082000025,,,,29,30,59
,2013,082000026,,,,24,13,37
,2013,082000028,,,,4,2,6
,2013,082000029,,,,20,13,33
,2013,082000030,,,,26,30,56
,2013,082000031,,,,16,14,30
,2013,082000032,,,,30,23,53
,2013,082000034,,,,21,30,51
,2013,082000035,,,,15,28,43
,2013,082000036,,,,8,6,14
,2013,082000039,,,,8,7,15
,2013,082000040,,,,11,8,19
,2013,082000040,,,,21,28,49
,2013,082000043,,,,10,5,15
,2013,082000044,,,,6,8,14
,2013,082000047,,,,2,2,4
,2013,082000048,,,,8,11,19
,2013,082000049,,,,10,11,21
,2013,082000051,,,,9,5,14
,2013,082000052,,,,106,133,239
,2013,082000053,,,,147,136,283
,2013,082000054,,,,30,37,67
,2013,082000056,,,,21,35,56
,2013,082000057,,,,18,9,27
,2013,082000062,,,,11,12,23
,2013,082000063,,,,5,4,9
,2013,082000065,,,,6,5,11
,2013,082000066,,,,6,3,9
,2013,082000071,,,,9,10,19
,2013,082000072,,,,15,13,28
,2013,082000073,,,,36,18,54
,2013,082000074,,,,9,11,20
,2013,082000076,,,,11,8,19
,2013,082000086,,,,13,9,22
,2013,082000088,,,,30,39,69
,2013,082000088,,,,8,11,19
,2013,082000090,,,,4,5,9
,2013,082000091,,,,2,8,10
,2013,082000092,,,,2,1,3
,2013,082000092,,,,15,11,26
,2013,082000094,,,,22,21,43
,2013,082000095,,,,6,8,14
,2013,082000096,,,,13,12,25
,2013,082000098,,,,7,2,9
,2013,082000100,,,,10,11,21
,2013,082000102,,,,8,12,20
,2013,082100001,,,,78,86,164
,2013,082100002,,,,15,16,31
,2013,082100003,,,,38,36,74
,2013,082100004,,,,12,7,19
,2013,082100005,,,,7,6,13
,2013,082100006,,,,20,30,50
,2013,082100008,,,,8,12,20
,2013,082100009,,,,8,5,13
,2013,082100012,,,,14,11,25
,2013,082100013,,,,35,31,66
,2013,082100015,,,,9,6,15
,2013,082100029,,,,4,11,15
,2013,082100030,,,,0,5,5
,2013,082100031,,,,2,3,5
,2013,082100032,,,,2,4,6
,2013,082100033,,,,2,3,5
,2013,082100034,,,,3,2,5
,2013,082200001,,,,12,14,26
,2013,082200003,,,,45,33,78
,2013,082200004,,,,53,22,75
,2013,082200005,,,,115,95,210
,2013,082200006,,,,62,50,112
,2013,082200007,,,,29,16,45
,2013,082200008,,,,143,115,258
,2013,082200009,,,,20,19,39
,2013,082200010,,,,37,31,68
,2013,082200011,,,,77,88,165
,2013,082200012,,,,43,34,77
,2013,082200012,,,,7,7,14
,2013,082200013,,,,39,33,72
,2013,082200014,,,,117,116,233
,2013,082200015,,,,42,28,70
,2013,082200016,,,,24,30,54
,2013,082200017,,,,391,443,834
,2013,082200018,,,,6,8,14
,2013,082200020,,,,23,10,33
,2013,082200021,,,,14,22,36
,2013,082200022,,,,8,3,11
,2013,082200023,,,,12,10,22
,2013,082200024,,,,2,2,4
,2013,082200025,,,,9,10,19
,2013,082200034,,,,3,6,9
,2013,082200034,,,,32,18,50
,2013,082200035,,,,16,19,35
,2013,082200035,,,,13,9,22
,2013,082200036,,,,6,2,8
,2013,082200037,,,,13,13,26
,2013,082200037,,,,38,55,93
,2013,082200038,,,,32,39,71
,2013,082200039,,,,6,3,9
,2013,082200040,,,,3,6,9
,2013,082200042,,,,3,4,7
,2013,082200044,,,,4,7,11
,2013,082200044,,,,11,19,30
,2013,082200044,,,,4,5,9
,2013,082300001,,,,7,7,14
,2013,082300002,,,,189,180,369
,2013,082300003,,,,34,34,68
,2013,082300004,,,,31,22,53
,2013,082300005,,,,110,130,240
,2013,082300006,,,,117,99,216
,2013,082300007,,,,24,27,51
,2013,082300008,,,,14,12,26
,2013,082300009,,,,28,32,60
,2013,082300010,,,,244,230,474
,2013,082300011,,,,24,26,50
,2013,082300013,,,,17,19,36
,2013,082300014,,,,16,27,43
,2013,082300015,,,,12,16,28
,2013,082300016,,,,7,5,12
,2013,082300020,,,,4,5,9
,2013,082300021,,,,3,5,8
,2013,082300022,,,,2,2,4
,2013,082300023,,,,2,6,8
,2013,082300024,,,,11,7,18
,2013,082300029,,,,2,1,3
,2013,082300030,,,,1,4,5
,2013,082400002,,,,13,16,29
,2013,082400003,,,,376,421,797
,2013,082400003,,,,60,43,103
,2013,082400004,,,,51,48,99
,2013,082400005,,,,19,22,41
,2013,082400006,,,,55,34,89
,2013,082400007,,,,62,53,115
,2013,082400008,,,,28,24,52
,2013,082400009,,,,227,207,434
,2013,082400010,,,,75,61,136
,2013,082400011,,,,10,11,21
,2013,082400012,,,,17,29,46
,2013,082400013,,,,30,41,71
,2013,082400014,,,,30,27,57
,2013,082400014,,,,4,6,10
,2013,082400015,,,,24,19,43
,2013,082400016,,,,23,22,45
,2013,082400017,,,,51,57,108
,2013,082400018,,,,57,52,109
,2013,082400019,,,,17,13,30
,2013,082400020,,,,69,67,136
,2013,082400021,,,,3,2,5
,2013,082400022,,,,30,22,52
,2013,082400023,,,,27,18,45
,2013,082400024,,,,26,19,45
,2013,082400025,,,,16,10,26
,2013,082400026,,,,82,87,169
,2013,082400027,,,,20,19,39
,2013,082400028,,,,24,24,48
,2013,082400029,,,,7,7,14
,2013,082400030,,,,12,8,20
,2013,082400031,,,,18,3,21
,2013,082400032,,,,19,17,36
,2013,082400033,,,,17,17,34
,2013,082400033,,,,46,46,92
,2013,082400034,,,,336,308,644
,2013,082400035,,,,236,224,460
,2013,082400036,,,,8,9,17
,2013,082400037,,,,337,380,717
,2013,082400038,,,,42,43,85
,2013,082400040,,,,47,58,105
,2013,082400041,,,,48,34,82
,2013,082400042,,,,21,23,44
,2013,082400043,,,,16,8,24
,2013,082400044,,,,22,11,33
,2013,082400045,,,,9,16,25
,2013,082400046,,,,4,8,12
,2013,082400046,,,,15,11,26
,2013,082400047,,,,62,62,124
,2013,082400048,,,,11,12,23
,2013,082400049,,,,41,57,98
,2013,082400050,,,,6,14,20
,2013,082400053,,,,32,29,61
,2013,082400054,,,,9,9,18
,2013,082400055,,,,4,2,6
,2013,082400056,,,,163,191,354
,2013,082400058,,,,22,18,40
,2013,082400059,,,,11,20,31
,2013,082400061,,,,7,8,15
,2013,082400062,,,,16,24,40
,2013,082400063,,,,23,19,42
,2013,082400064,,,,14,25,39
,2013,082400065,,,,31,21,52
,2013,082400067,,,,22,29,51
,2013,082400067,,,,4,9,13
,2013,082400068,,,,14,12,26
,2013,082400071,,,,2,7,9
,2013,082400071,,,,37,34,71
,2013,082400085,,,,16,25,41
,2013,082400086,,,,10,7,17
,2013,082400088,,,,453,515,968
,2013,082400089,,,,565,530,1095
,2013,082400095,,,,2,4,6
,2013,082400095,,,,39,41,80
,2013,082400096,,,,38,33,71
,2013,082400098,,,,37,28,65
,2013,082400099,,,,3,4,7
,2013,082400099,,,,24,22,46
,2013,082400100,,,,7,7,14
,2013,082400101,,,,12,8,20
,2013,082400102,,,,2,3,5
,2013,082400102,,,,20,18,38
,2013,082400103,,,,3,8,11
,2013,082400104,,,,14,20,34
,2013,082400105,,,,13,8,21
,2013,082400106,,,,3,2,5
,2013,082400108,,,,5,8,13
,2013,082400110,,,,4,9,13
,2013,082400111,,,,16,5,21
,2013,082400113,,,,2,9,11
,2013,082400113,,,,212,333,545
,2013,082400114,,,,3,3,6
,2013,082400115,,,,7,3,10
,2013,082400116,,,,1,3,4
,2013,082400118,,,,3,9,12
,2013,082400119,,,,10,5,15
,2013,082400121,,,,5,2,7
,2013,082400122,,,,4,4,8
,2013,082400123,,,,2,2,4
,2013,082400124,,,,16,9,25
,2013,082400126,,,,4,2,6
,2013,082400126,,,,17,9,26
,2013,082400127,,,,6,11,17
,2013,082400130,,,,3,5,8
,2013,082400141,,,,227,496,723
,2013,082500004,,,,108,86,194
,2013,082500005,,,,25,22,47
,2013,082500006,,,,74,88,162
,2013,082500007,,,,16,13,29
,2013,082500007,,,,9,2,11
,2013,082500008,,,,25,23,48
,2013,082500009,,,,30,30,60
,2013,082500010,,,,13,15,28
,2013,082500011,,,,49,61,110
,2013,082500012,,,,14,7,21
,2013,082500013,,,,14,18,32
,2013,082500014,,,,18,11,29
,2013,082500015,,,,111,146,257
,2013,082500017,,,,11,7,18
,2013,082500018,,,,22,24,46
,2013,082500019,,,,11,7,18
,2013,082500020,,,,14,21,35
,2013,082500022,,,,9,5,14
,2013,082500023,,,,9,7,16
,2013,082500024,,,,5,2,7
,2013,082500025,,,,3,3,6
,2013,082500026,,,,11,2,13
,2013,082500033,,,,85,76,161
,2013,082500034,,,,4,1,5
,2013,082500035,,,,3,1,4
,2013,082500036,,,,4,2,6
,2013,082500037,,,,7,1,8
,2013,082500038,,,,1,0,1
,2013,082500039,,,,0,2,2
,2013,082600003,,,,80,62,142
,2013,082600004,,,,293,295,588
,2013,082600005,,,,34,36,70
,2013,082600006,,,,20,21,41
,2013,082600007,,,,146,155,301
,2013,082600008,,,,7,8,15
,2013,082600009,,,,12,16,28
,2013,082600010,,,,20,26,46
,2013,082600011,,,,9,2,11
,2013,082600012,,,,21,23,44
,2013,082600013,,,,17,11,28
,2013,082600014,,,,99,85,184
,2013,082600015,,,,19,13,32
,2013,082600015,,,,8,7,15
,2013,082600016,,,,65,74,139
,2013,082600017,,,,33,33,66
,2013,082600019,,,,50,48,98
,2013,082600021,,,,572,519,1091
,2013,082600022,,,,10,10,20
,2013,082600023,,,,23,19,42
,2013,082600024,,,,11,7,18
,2013,082600025,,,,31,28,59
,2013,082600026,,,,12,7,19
,2013,082600031,,,,75,59,134
,2013,082600032,,,,28,19,47
,2013,082600034,,,,12,8,20
,2013,082600035,,,,18,9,27
,2013,082600035,,,,36,24,60
,2013,082600036,,,,67,63,130
,2013,082600036,,,,71,77,148
,2013,082600036,,,,13,12,25
,2013,082600039,,,,73,76,149
,2013,082600040,,,,7,15,22
,2013,082600041,,,,3,5,8
,2013,082600044,,,,4,1,5
,2013,082600045,,,,4,15,19
,2013,082600046,,,,17,24,41
,2013,082600047,,,,8,1,9
,2013,082600048,,,,3,4,7
,2013,082600049,,,,49,66,115
,2013,082600050,,,,8,3,11
,2013,082600052,,,,7,2,9
,2013,082600054,,,,53,44,97
,2013,082600054,,,,22,30,52
,2013,082600055,,,,43,37,80
,2013,082600056,,,,15,19,34
,2013,082600056,,,,29,31,60
,2013,082600057,,,,14,33,47
,2013,082700001,,,,632,527,1159
,2013,082700002,,,,13,5,18
,2013,082700003,,,,16,16,32
,2013,082700004,,,,22,25,47
,2013,082700005,,,,92,59,151
,2013,082700006,,,,40,41,81
,2013,082700007,,,,69,87,156
,2013,082700008,,,,338,402,740
,2013,082700009,,,,19,8,27
,2013,082700010,,,,45,31,76
,2013,082700011,,,,9,7,16
,2013,082700012,,,,15,16,31
,2013,082700014,,,,7,7,14
,2013,082700016,,,,12,18,30
,2013,082700017,,,,7,3,10
,2013,082700018,,,,6,4,10
,2013,082700020,,,,6,4,10
,2013,082700022,,,,9,10,19
,2013,082700022,,,,13,13,26
,2013,082800001,,,,66,106,172
,2013,082800002,,,,40,32,72
,2013,082800003,,,,192,195,387
,2013,082800004,,,,15,11,26
,2013,082800005,,,,63,72,135
,2013,082800006,,,,26,22,48
,2013,082800007,,,,9,4,13
,2013,082800008,,,,21,22,43
,2013,082800009,,,,147,150,297
,2013,082800010,,,,13,16,29
,2013,082800011,,,,6,9,15
,2013,082800012,,,,17,25,42
,2013,082800013,,,,23,18,41
,2013,082800015,,,,10,8,18
,2013,082800016,,,,2,32,34
,2013,082800018,,,,7,14,21
,2013,082800019,,,,15,11,26
,2013,082800020,,,,7,13,20
,2013,082800021,,,,6,12,18
,2013,082800022,,,,10,10,20
,2013,082800032,,,,6,2,8
,2013,082800034,,,,7,14,21
,2013,082800035,,,,10,14,24
,2013,082800045,,,,3,7,10
,2013,082800046,,,,8,2,10
,2013,082800048,,,,8,16,24
,2013,082800050,,,,7,12,19
,2013,082800052,,,,4,2,6
,2013,082800060,,,,38,51,89
,2013,082800061,,,,14,12,26
,2013,082800064,,,,4,4,8
,2013,082800065,,,,29,37,66
,2013,090100001,,,,325,290,615
,2013,090100002,,,,602,565,1167
,2013,090100003,,,,32,41,73
,2013,090100004,,,,77,86,163
,2013,090100005,,,,214,250,464
,2013,090100006,,,,42,60,102
,2013,090100007,,,,40,53,93
,2013,090100008,,,,88,86,174
,2013,090100009,,,,36,25,61
,2013,090100010,,,,23,25,48
,2013,090100011,,,,68,71,139
,2013,090100013,,,,18,27,45
,2013,090100015,,,,100,103,203
,2013,090100016,,,,70,54,124
,2013,090100018,,,,51,57,108
,2013,090100019,,,,15,18,33
,2013,090100019,,,,161,148,309
,2013,090100020,,,,65,69,134
,2013,090100021,,,,72,75,147
,2013,090100022,,,,68,60,128
,2013,090100023,,,,178,222,400
,2013,090100023,,,,7,24,31
,2013,090100024,,,,230,221,451
,2013,090100025,,,,150,170,320
,2013,090100026,,,,201,160,361
,2013,090100027,,,,145,127,272
,2013,090100028,,,,146,119,265
,2013,090100029,,,,217,208,425
,2013,090100030,,,,178,163,341
,2013,090100031,,,,82,109,191
,2013,090100032,,,,40,39,79
,2013,090100033,,,,77,57,134
,2013,090100034,,,,117,127,244
,2013,090100035,,,,178,206,384
,2013,090100036,,,,82,76,158
,2013,090100037,,,,68,59,127
,2013,090100039,,,,27,32,59
,2013,090100040,,,,14,26,40
,2013,090100041,,,,21,17,38
,2013,090100042,,,,35,23,58
,2013,090100043,,,,424,490,914
,2013,090100043,,,,187,242,429
,2013,090100044,,,,102,73,175
,2013,090100045,,,,25,24,49
,2013,090100046,,,,4,5,9
,2013,090100046,,,,36,26,62
,2013,090100047,,,,96,113,209
,2013,090100048,,,,11,18,29
,2013,090100049,,,,11,20,31
,2013,090100050,,,,49,40,89
,2013,090100051,,,,37,39,76
,2013,090100052,,,,48,29,77
,2013,090100053,,,,32,19,51
,2013,090100055,,,,25,25,50
,2013,090100056,,,,78,79,157
,2013,090100057,,,,7,13,20
,2013,090100058,,,,89,83,172
,2013,090100059,,,,17,14,31
,2013,090100060,,,,71,59,130
,2013,090100062,,,,29,30,59
,2013,090100063,,,,214,259,473
,2013,090100064,,,,100,126,226
,2013,090100065,,,,12,7,19
,2013,090100067,,,,19,12,31
,2013,090100068,,,,35,40,75
,2013,090100069,,,,26,17,43
,2013,090100070,,,,25,24,49
,2013,090100071,,,,46,44,90
,2013,090100072,,,,21,24,45
,2013,090100073,,,,30,26,56
,2013,090100074,,,,18,30,48
,2013,090100075,,,,22,35,57
,2013,090100076,,,,10,9,19
,2013,090100077,,,,6,4,10
,2013,090100078,,,,28,23,51
,2013,090100079,,,,9,3,12
,2013,090100080,,,,14,22,36
,2013,090100081,,,,23,24,47
,2013,090100082,,,,11,13,24
,2013,090100083,,,,16,14,30
,2013,090100084,,,,8,13,21
,2013,090100085,,,,6,1,7
,2013,090100086,,,,9,5,14
,2013,090100088,,,,14,10,24
,2013,090100089,,,,12,17,29
,2013,090100090,,,,22,23,45
,2013,090100091,,,,32,45,77
,2013,090100092,,,,5,9,14
,2013,090100092,,,,34,27,61
,2013,090100093,,,,50,50,100
,2013,090100094,,,,37,18,55
,2013,090100096,,,,18,10,28
,2013,090100097,,,,25,25,50
,2013,090100098,,,,13,14,27
,2013,090100099,,,,13,9,22
,2013,090100099,,,,4,13,17
,2013,090100100,,,,2,5,7
,2013,090100101,,,,77,109,186
,2013,090100102,,,,24,19,43
,2013,090100104,,,,16,4,20
,2013,090100104,,,,32,27,59
,2013,090100105,,,,31,28,59
,2013,090100106,,,,2,4,6
,2013,090100106,,,,5,5,10
,2013,090100107,,,,10,21,31
,2013,090100108,,,,152,139,291
,2013,090100109,,,,20,12,32
,2013,090100110,,,,51,45,96
,2013,090100111,,,,10,10,20
,2013,090100112,,,,7,16,23
,2013,090100114,,,,10,16,26
,2013,090100116,,,,177,184,361
,2013,090100117,,,,30,32,62
,2013,090100118,,,,31,43,74
,2013,090100120,,,,9,4,13
,2013,090100121,,,,11,11,22
,2013,090100122,,,,103,89,192
,2013,090100123,,,,4,3,7
,2013,090100124,,,,101,131,232
,2013,090100125,,,,30,37,67
,2013,090100127,,,,22,32,54
,2013,090100129,,,,23,13,36
,2013,090100139,,,,6,10,16
,2013,090100146,,,,8,8,16
,2013,090100149,,,,6,8,14
,2013,090100151,,,,13,17,30
,2013,090100177,,,,21,21,42
,2013,090100181,,,,34,39,73
,2013,090100183,,,,7,10,17
,2013,090100191,,,,6,9,15
,2013,090100193,,,,12,9,21
,2013,090100196,,,,13,11,24
,2013,090100199,,,,6,9,15
,2013,090100206,,,,4,8,12
,2013,090100212,,,,3,9,12
,2013,090100215,,,,9,9,18
,2013,090100216,,,,7,7,14
,2013,090100224,,,,10,11,21
,2013,090100228,,,,7,8,15
,2013,090100229,,,,8,9,17
,2013,090100233,,,,14,19,33
,2013,090100258,,,,10,16,26
,2013,090100265,,,,7,12,19
,2013,090100266,,,,8,6,14
,2013,090100267,,,,8,12,20
,2013,090100268,,,,10,6,16
,2013,090100271,,,,5,3,8
,2013,090100272,,,,4,4,8
,2013,090100273,,,,2,2,4
,2013,090100274,,,,6,6,12
,2013,090100275,,,,2,5,7
,2013,090100276,,,,4,5,9
,2013,090100277,,,,24,28,52
,2013,090100278,,,,41,24,65
,2013,090100278,,,,17,13,30
,2013,090100279,,,,7,6,13
,2013,090100280,,,,5,2,7
,2013,090100281,,,,10,13,23
,2013,090100282,,,,9,10,19
,2013,090100284,,,,10,15,25
,2013,090100285,,,,3,3,6
,2013,090100286,,,,4,5,9
,2013,090100288,,,,10,8,18
,2013,090100289,,,,5,2,7
,2013,090100290,,,,3,3,6
,2013,090100291,,,,4,10,14
,2013,090100292,,,,3,8,11
,2013,090100293,,,,3,3,6
,2013,090100302,,,,16,20,36
,2013,090100303,,,,5,7,12
,2013,090100304,,,,8,7,15
,2013,090100305,,,,12,10,22
,2013,090100306,,,,31,26,57
,2013,090100307,,,,14,11,25
,2013,090100308,,,,7,3,10
,2013,090100309,,,,9,8,17
,2013,090100310,,,,6,5,11
,2013,090100312,,,,9,16,25
,2013,090100313,,,,3,2,5
,2013,090100315,,,,10,3,13
,2013,090100317,,,,3,6,9
,2013,090100318,,,,5,6,11
,2013,090100319,,,,3,5,8
,2013,090100320,,,,2,8,10
,2013,090100322,,,,8,12,20
,2013,090100323,,,,6,4,10
,2013,090100324,,,,8,5,13
,2013,090100325,,,,11,10,21
,2013,090100326,,,,9,8,17
,2013,090100327,,,,8,5,13
,2013,090100328,,,,9,10,19
,2013,090100329,,,,6,10,16
,2013,090100330,,,,10,9,19
,2013,090100331,,,,3,12,15
,2013,090100332,,,,5,10,15
,2013,090100333,,,,16,5,21
,2013,090100334,,,,9,11,20
,2013,090100335,,,,9,11,20
,2013,090100336,,,,9,9,18
,2013,090100337,,,,5,8,13
,2013,090100338,,,,7,6,13
,2013,090100339,,,,48,0,48
,2013,090100368,,,,23,30,53
,2013,090100370,,,,11,26,37
,2013,090200001,,,,19,21,40
,2013,090200002,,,,111,121,232
,2013,090200003,,,,123,127,250
,2013,090200003,,,,375,412,787
,2013,090200004,,,,51,39,90
,2013,090200005,,,,47,35,82
,2013,090200006,,,,384,332,716
,2013,090200007,,,,69,82,151
,2013,090200008,,,,109,112,221
,2013,090200009,,,,78,69,147
,2013,090200010,,,,105,83,188
,2013,090200011,,,,93,87,180
,2013,090200012,,,,38,37,75
,2013,090200013,,,,10,8,18
,2013,090200015,,,,22,16,38
,2013,090200016,,,,21,22,43
,2013,090200017,,,,18,19,37
,2013,090200018,,,,29,23,52
,2013,090200020,,,,28,13,41
,2013,090200022,,,,12,12,24
,2013,090200024,,,,17,11,28
,2013,090200025,,,,57,45,102
,2013,090200028,,,,17,11,28
,2013,090200029,,,,149,196,345
,2013,090200030,,,,37,46,83
,2013,090200030,,,,177,159,336
,2013,090200032,,,,21,28,49
,2013,090200033,,,,7,11,18
,2013,090200035,,,,8,9,17
,2013,090200036,,,,52,27,79
,2013,090200037,,,,5,3,8
,2013,090200038,,,,19,31,50
,2013,090200040,,,,16,15,31
,2013,090200041,,,,28,19,47
,2013,090200044,,,,51,38,89
,2013,090300001,,,,13,11,24
,2013,090300002,,,,26,26,52
,2013,090300003,,,,52,56,108
,2013,090300004,,,,326,289,615
,2013,090300005,,,,43,37,80
,2013,090300006,,,,73,54,127
,2013,090300007,,,,214,217,431
,2013,090300009,,,,264,250,514
,2013,090300010,,,,30,40,70
,2013,090300011,,,,40,53,93
,2013,090300012,,,,13,17,30
,2013,090300013,,,,50,52,102
,2013,090300014,,,,77,85,162
,2013,090300015,,,,228,193,421
,2013,090300016,,,,100,144,244
,2013,090300017,,,,30,44,74
,2013,090300018,,,,36,37,73
,2013,090300020,,,,6,7,13
,2013,090300021,,,,4,9,13
,2013,090300022,,,,9,10,19
,2013,090300024,,,,7,6,13
,2013,090300025,,,,2,7,9
,2013,090300026,,,,6,6,12
,2013,090300027,,,,6,6,12
,2013,090300028,,,,6,6,12
,2013,090300030,,,,5,7,12
,2013,090300031,,,,7,2,9
,2013,090300031,,,,19,8,27
,2013,090300032,,,,16,42,58
,2013,090300033,,,,6,7,13
,2013,090300034,,,,2,8,10
,2013,090300035,,,,2,5,7
,2013,090300036,,,,5,7,12
,2013,090300037,,,,6,4,10
,2013,090300038,,,,9,9,18
,2013,090300039,,,,2,7,9
,2013,090300040,,,,9,7,16
,2013,090300041,,,,8,4,12
,2013,090300042,,,,6,7,13
,2013,090300043,,,,9,5,14
,2013,090300044,,,,10,5,15
,2013,090400001,,,,192,163,355
,2013,090400002,,,,6,4,10
,2013,090400003,,,,71,58,129
,2013,090400005,,,,26,29,55
,2013,090400007,,,,20,11,31
,2013,090400008,,,,7,10,17
,2013,090400009,,,,56,56,112
,2013,090400010,,,,76,69,145
,2013,090400011,,,,86,88,174
,2013,090400012,,,,40,43,83
,2013,090400013,,,,27,32,59
,2013,090400014,,,,10,11,21
,2013,090400015,,,,86,82,168
,2013,090400016,,,,93,92,185
,2013,090400017,,,,22,26,48
,2013,090400018,,,,6,6,12
,2013,090400019,,,,9,8,17
,2013,090400020,,,,11,11,22
,2013,090400021,,,,23,22,45
,2013,090400022,,,,4,10,14
,2013,090400023,,,,12,17,29
,2013,090400024,,,,16,12,28
,2013,090400025,,,,16,10,26
,2013,090400026,,,,24,36,60
,2013,090400027,,,,10,12,22
,2013,090400028,,,,9,7,16
,2013,090400029,,,,10,12,22
,2013,090400030,,,,5,9,14
,2013,090400031,,,,15,2,17
,2013,090500001,,,,41,36,77
,2013,090500002,,,,108,117,225
,2013,090500002,,,,26,27,53
,2013,090500003,,,,27,36,63
,2013,090500006,,,,7,7,14
,2013,090500007,,,,240,229,469
,2013,090500008,,,,70,57,127
,2013,090500009,,,,367,327,694
,2013,090500009,,,,50,27,77
,2013,090500010,,,,104,140,244
,2013,090500011,,,,12,15,27
,2013,090500012,,,,23,31,54
,2013,090500014,,,,7,1,8
,2013,090500015,,,,35,27,62
,2013,090500016,,,,129,103,232
,2013,090500016,,,,18,13,31
,2013,090500017,,,,18,9,27
,2013,090500018,,,,224,185,409
,2013,090500018,,,,25,27,52
,2013,090500019,,,,323,324,647
,2013,090500020,,,,66,43,109
,2013,090500022,,,,62,56,118
,2013,090500023,,,,25,23,48
,2013,090500024,,,,22,15,37
,2013,090500025,,,,8,8,16
,2013,090500026,,,,34,30,64
,2013,090500027,,,,9,8,17
,2013,090500031,,,,4,5,9
,2013,090500032,,,,7,8,15
,2013,090500033,,,,5,3,8
,2013,090500037,,,,15,12,27
,2013,090600001,,,,139,169,308
,2013,090600002,,,,19,11,30
,2013,090600003,,,,207,194,401
,2013,090600004,,,,5,4,9
,2013,090600005,,,,77,60,137
,2013,090600007,,,,71,47,118
,2013,090600008,,,,79,78,157
,2013,090600010,,,,7,5,12
,2013,090600012,,,,20,36,56
,2013,090600013,,,,11,11,22
,2013,090600014,,,,12,4,16
,2013,090600015,,,,44,42,86
,2013,090600016,,,,9,20,29
,2013,090600017,,,,11,15,26
,2013,090600018,,,,4,10,14
,2013,090600019,,,,10,10,20
,2013,090600020,,,,25,30,55
,2013,090600020,,,,49,47,96
,2013,090600021,,,,4,11,15
,2013,090600022,,,,18,19,37
,2013,090600023,,,,41,30,71
,2013,090600024,,,,164,126,290
,2013,090600025,,,,22,28,50
,2013,090600026,,,,29,20,49
,2013,090600027,,,,8,8,16
,2013,090600028,,,,13,12,25
,2013,090600030,,,,11,9,20
,2013,090600031,,,,6,9,15
,2013,090600034,,,,3,10,13
,2013,090600035,,,,8,8,16
,2013,090600036,,,,6,9,15
,2013,090600042,,,,16,18,34
,2013,090600044,,,,11,7,18
,2013,090600046,,,,5,12,17
,2013,090600048,,,,6,9,15
,2013,100100001,,,,34,22,56
,2013,100100002,,,,28,33,61
,2013,100100003,,,,428,383,811
,2013,100100004,,,,120,97,217
,2013,100100005,,,,10,9,19
,2013,100100006,,,,119,110,229
,2013,100100007,,,,308,284,592
,2013,100100008,,,,31,24,55
,2013,100100009,,,,13,14,27
,2013,100100010,,,,110,137,247
,2013,100100011,,,,13,5,18
,2013,100100012,,,,12,15,27
,2013,100100014,,,,46,34,80
,2013,100100015,,,,29,23,52
,2013,100100016,,,,10,5,15
,2013,100100016,,,,27,35,62
,2013,100100016,,,,7,10,17
,2013,100100017,,,,68,74,142
,2013,100100017,,,,34,36,70
,2013,100100017,,,,35,28,63
,2013,100100017,,,,35,28,63
,2013,100100018,,,,29,30,59
,2013,100100019,,,,189,200,389
,2013,100100020,,,,1003,1038,2041
,2013,100100021,,,,25,29,54
,2013,100100022,,,,11,13,24
,2013,100100023,,,,117,117,234
,2013,100100024,,,,4,8,12
,2013,100100025,,,,6,7,13
,2013,100100026,,,,401,730,1131
,2013,100100027,,,,280,268,548
,2013,100100028,,,,59,108,167
,2013,100100029,,,,12,8,20
,2013,100100029,,,,30,27,57
,2013,100100031,,,,5,5,10
,2013,100100034,,,,12,8,20
,2013,100100040,,,,37,36,73
,2013,100100042,,,,3,3,6
,2013,100100052,,,,21,33,54
,2013,100100052,,,,45,52,97
,2013,100100052,,,,7,26,33
,2013,100100053,,,,80,60,140
,2013,100100054,,,,6,4,10
,2013,100100055,,,,8,11,19
,2013,100100056,,,,6,2,8
,2013,100100057,,,,7,2,9
,2013,100100058,,,,8,12,20
,2013,100100059,,,,0,5,5
,2013,100100060,,,,191,166,357
,2013,100100060,,,,3,1,4
,2013,100100062,,,,4,3,7
,2013,100100063,,,,4,3,7
,2013,100100064,,,,9,8,17
,2013,100100064,,,,38,57,95
,2013,100100064,,,,21,13,34
,2013,100100065,,,,4,10,14
,2013,100100066,,,,12,8,20
,2013,100100072,,,,154,242,396
,2013,100200001,,,,68,55,123
,2013,100200002,,,,31,35,66
,2013,100200003,,,,53,43,96
,2013,100200004,,,,77,61,138
,2013,100200005,,,,51,57,108
,2013,100200006,,,,41,61,102
,2013,100200007,,,,37,28,65
,2013,100200008,,,,35,20,55
,2013,100200009,,,,98,117,215
,2013,100200010,,,,25,30,55
,2013,100200011,,,,52,44,96
,2013,100200012,,,,25,25,50
,2013,100200013,,,,29,20,49
,2013,100200014,,,,15,14,29
,2013,100200015,,,,218,200,418
,2013,100200016,,,,11,9,20
,2013,100200018,,,,9,11,20
,2013,100200019,,,,5,11,16
,2013,100200020,,,,12,10,22
,2013,100200021,,,,6,5,11
,2013,100200022,,,,10,12,22
,2013,100200023,,,,6,7,13
,2013,100200024,,,,3,4,7
,2013,100200026,,,,4,6,10
,2013,100200027,,,,9,1,10
,2013,100200028,,,,1,8,9
,2013,100200029,,,,3,4,7
,2013,100200036,,,,5,4,9
,2013,100200038,,,,5,3,8
,2013,100200039,,,,3,5,8
,2013,100200040,,,,6,3,9
,2013,100200042,,,,17,11,28
,2013,100300001,,,,128,100,228
,2013,100300002,,,,18,15,33
,2013,100300003,,,,131,97,228
,2013,100300004,,,,66,57,123
,2013,100300005,,,,29,43,72
,2013,100300005,,,,11,4,15
,2013,100300006,,,,75,66,141
,2013,100300007,,,,50,47,97
,2013,100300008,,,,67,57,124
,2013,100300009,,,,140,167,307
,2013,100300010,,,,156,175,331
,2013,100300011,,,,97,64,161
,2013,100300012,,,,72,69,141
,2013,100300013,,,,148,139,287
,2013,100300014,,,,118,125,243
,2013,100300015,,,,52,60,112
,2013,100300016,,,,34,28,62
,2013,100300017,,,,62,50,112
,2013,100300018,,,,45,43,88
,2013,100300019,,,,47,40,87
,2013,100300020,,,,20,26,46
,2013,100300021,,,,56,56,112
,2013,100300022,,,,17,11,28
,2013,100300022,,,,3,3,6
,2013,100300023,,,,68,49,117
,2013,100300024,,,,20,19,39
,2013,100300025,,,,59,52,111
,2013,100300026,,,,28,19,47
,2013,100300027,,,,31,20,51
,2013,100300028,,,,21,16,37
,2013,100300029,,,,83,72,155
,2013,100300030,,,,41,30,71
,2013,100300031,,,,56,50,106
,2013,100300032,,,,25,37,62
,2013,100300033,,,,16,24,40
,2013,100300034,,,,14,6,20
,2013,100300035,,,,13,7,20
,2013,100300036,,,,13,4,17
,2013,100300037,,,,11,6,17
,2013,100300038,,,,4,7,11
,2013,100300040,,,,257,277,534
,2013,100300041,,,,48,42,90
,2013,100300042,,,,5,9,14
,2013,100300043,,,,8,17,25
,2013,100300044,,,,20,21,41
,2013,100300045,,,,25,18,43
,2013,100300046,,,,10,13,23
,2013,100300047,,,,8,10,18
,2013,100300048,,,,16,11,27
,2013,100300049,,,,3,7,10
,2013,100300050,,,,5,6,11
,2013,100300051,,,,7,11,18
,2013,100300052,,,,19,10,29
,2013,100300053,,,,35,48,83
,2013,100300054,,,,13,9,22
,2013,100300056,,,,6,8,14
,2013,100300060,,,,36,44,80
,2013,100300061,,,,13,13,26
,2013,100300062,,,,4,8,12
,2013,100300063,,,,4,13,17
,2013,100300131,,,,5,5,10
,2013,100300132,,,,11,6,17
,2013,100300136,,,,4,3,7
,2013,100300137,,,,13,4,17
,2013,100300154,,,,7,4,11
,2013,100300155,,,,11,7,18
,2013,100300156,,,,8,7,15
,2013,100300159,,,,5,5,10
,2013,100300160,,,,4,5,9
,2013,100300161,,,,4,8,12
,2013,100300162,,,,10,11,21
,2013,100300164,,,,4,4,8
,2013,100300165,,,,3,2,5
,2013,100300168,,,,7,9,16
,2013,100400001,,,,11,10,21
,2013,100400002,,,,87,94,181
,2013,100400003,,,,26,21,47
,2013,100400004,,,,179,186,365
,2013,100400005,,,,13,15,28
,2013,100400006,,,,45,46,91
,2013,100400007,,,,22,20,42
,2013,100400008,,,,22,19,41
,2013,100400009,,,,11,7,18
,2013,100400010,,,,35,23,58
,2013,100400011,,,,11,19,30
,2013,100400012,,,,46,43,89
,2013,100400013,,,,53,61,114
,2013,100400014,,,,93,95,188
,2013,100400015,,,,36,38,74
,2013,100400016,,,,18,12,30
,2013,100400017,,,,11,19,30
,2013,100400018,,,,23,28,51
,2013,100400019,,,,3,9,12
,2013,100400020,,,,56,71,127
,2013,100400021,,,,15,11,26
,2013,100400022,,,,10,13,23
,2013,100400023,,,,9,14,23
,2013,100400024,,,,42,36,78
,2013,100400025,,,,16,21,37
,2013,100400026,,,,18,19,37
,2013,100400027,,,,13,19,32
,2013,100400028,,,,5,10,15
,2013,100400029,,,,8,6,14
,2013,100400030,,,,16,5,21
,2013,100400031,,,,4,9,13
,2013,100400032,,,,43,33,76
,2013,100400033,,,,138,136,274
,2013,100400035,,,,6,5,11
,2013,100400036,,,,9,11,20
,2013,100400040,,,,6,5,11
,2013,100400041,,,,5,2,7
,2013,100400043,,,,5,4,9
,2013,100400045,,,,8,4,12
,2013,100400047,,,,3,5,8
,2013,100400048,,,,55,52,107
,2013,100400049,,,,5,5,10
,2013,100400051,,,,7,7,14
,2013,100400052,,,,7,5,12
,2013,100400053,,,,12,6,18
,2013,100400061,,,,2,5,7
,2013,100400067,,,,4,2,6
,2013,100400070,,,,5,5,10
,2013,100400072,,,,3,5,8
,2013,100400073,,,,3,5,8
,2013,100400074,,,,2,5,7
,2013,100400076,,,,4,5,9
,2013,100500001,,,,107,119,226
,2013,100500002,,,,64,62,126
,2013,100500003,,,,116,103,219
,2013,100500004,,,,40,59,99
,2013,100500005,,,,46,34,80
,2013,100500006,,,,6,19,25
,2013,100500007,,,,37,30,67
,2013,100500008,,,,21,39,60
,2013,100500009,,,,6,9,15
,2013,100500010,,,,11,4,15
,2013,100500011,,,,7,12,19
,2013,100500013,,,,9,7,16
,2013,100500014,,,,6,10,16
,2013,100500015,,,,10,9,19
,2013,100500016,,,,9,9,18
,2013,100500017,,,,48,48,96
,2013,100500018,,,,22,21,43
,2013,100500019,,,,44,33,77
,2013,100500020,,,,14,6,20
,2013,100500021,,,,11,6,17
,2013,100500022,,,,6,10,16
,2013,100500026,,,,5,2,7
,2013,100500031,,,,11,5,16
,2013,100500048,,,,3,2,5
,2013,100500049,,,,23,17,40
,2013,100500052,,,,4,3,7
,2013,100500053,,,,4,5,9
,2013,100500054,,,,8,3,11
,2013,100500056,,,,4,5,9
,2013,100500058,,,,11,4,15
,2013,100600001,,,,36,29,65
,2013,100600001,,,,10,6,16
,2013,100600002,,,,24,24,48
,2013,100600003,,,,33,34,67
,2013,100600004,,,,31,27,58
,2013,100600005,,,,13,17,30
,2013,100600006,,,,56,42,98
,2013,100600007,,,,22,23,45
,2013,100600008,,,,84,102,186
,2013,100600009,,,,108,86,194
,2013,100600010,,,,49,55,104
,2013,100600011,,,,52,57,109
,2013,100600012,,,,26,15,41
,2013,100600013,,,,504,454,958
,2013,100600014,,,,54,67,121
,2013,100600015,,,,185,147,332
,2013,100600016,,,,25,25,50
,2013,100600017,,,,37,34,71
,2013,100600018,,,,120,100,220
,2013,100600019,,,,22,20,42
,2013,100600020,,,,106,115,221
,2013,100600021,,,,45,44,89
,2013,100600022,,,,204,175,379
,2013,100600023,,,,49,60,109
,2013,100600024,,,,55,38,93
,2013,100600025,,,,25,19,44
,2013,100600026,,,,29,33,62
,2013,100600027,,,,69,57,126
,2013,100600028,,,,121,106,227
,2013,100600028,,,,8,13,21
,2013,100600029,,,,34,23,57
,2013,100600030,,,,129,114,243
,2013,100600031,,,,41,74,115
,2013,100600032,,,,42,33,75
,2013,100600033,,,,15,16,31
,2013,100600034,,,,43,50,93
,2013,100600035,,,,28,44,72
,2013,100600036,,,,54,44,98
,2013,100600037,,,,41,55,96
,2013,100600038,,,,120,87,207
,2013,100600039,,,,62,52,114
,2013,100600040,,,,397,426,823
,2013,100600040,,,,73,55,128
,2013,100600041,,,,68,42,110
,2013,100600042,,,,143,139,282
,2013,100600043,,,,81,83,164
,2013,100600044,,,,102,129,231
,2013,100600045,,,,18,22,40
,2013,100600046,,,,26,29,55
,2013,100600047,,,,52,53,105
,2013,100600048,,,,69,71,140
,2013,100600049,,,,16,12,28
,2013,100600050,,,,20,11,31
,2013,100600051,,,,25,18,43
,2013,100600052,,,,40,33,73
,2013,100600053,,,,17,19,36
,2013,100600054,,,,52,32,84
,2013,100600055,,,,38,26,64
,2013,100600056,,,,37,35,72
,2013,100600057,,,,73,76,149
,2013,100600058,,,,39,32,71
,2013,100600059,,,,63,66,129
,2013,100600060,,,,41,34,75
,2013,100600061,,,,20,30,50
,2013,100600062,,,,27,19,46
,2013,100600063,,,,22,18,40
,2013,100600064,,,,19,19,38
,2013,100600065,,,,23,23,46
,2013,100600066,,,,11,17,28
,2013,100600067,,,,13,11,24
,2013,100600068,,,,19,27,46
,2013,100600069,,,,21,30,51
,2013,100600070,,,,37,30,67
,2013,100600071,,,,30,30,60
,2013,100600072,,,,15,11,26
,2013,100600073,,,,14,9,23
,2013,100600074,,,,51,46,97
,2013,100600075,,,,27,26,53
,2013,100600076,,,,24,14,38
,2013,100600076,,,,9,4,13
,2013,100600077,,,,8,7,15
,2013,100600077,,,,50,28,78
,2013,100600078,,,,46,59,105
,2013,100600079,,,,18,14,32
,2013,100600080,,,,12,8,20
,2013,100600081,,,,13,9,22
,2013,100600082,,,,7,9,16
,2013,100600083,,,,11,10,21
,2013,100600084,,,,10,12,22
,2013,100600085,,,,14,15,29
,2013,100600086,,,,74,81,155
,2013,100600092,,,,45,46,91
,2013,100600092,,,,6,15,21
,2013,100600093,,,,23,30,53
,2013,100600095,,,,221,218,439
,2013,100600108,,,,10,13,23
,2013,100600109,,,,21,20,41
,2013,100600110,,,,31,22,53
,2013,100600111,,,,9,4,13
,2013,100600112,,,,8,14,22
,2013,100600114,,,,9,8,17
,2013,100600115,,,,8,14,22
,2013,100600116,,,,8,10,18
,2013,100600117,,,,8,6,14
,2013,100600119,,,,8,13,21
,2013,100600120,,,,8,6,14
,2013,100600121,,,,6,20,26
,2013,100600122,,,,5,4,9
,2013,100600125,,,,3,6,9
,2013,100600126,,,,7,5,12
,2013,100600127,,,,22,20,42
,2013,100600128,,,,12,11,23
,2013,100600130,,,,6,13,19
,2013,100600137,,,,12,8,20
,2013,100600139,,,,10,6,16
,2013,100600139,,,,26,25,51
,2013,100600151,,,,40,26,66
,2013,100600160,,,,12,22,34
,2013,100600161,,,,50,42,92
,2013,100600174,,,,16,18,34
,2013,100600202,,,,5,4,9
,2013,100600204,,,,2,7,9
,2013,100600205,,,,5,5,10
,2013,100600206,,,,6,5,11
,2013,100600207,,,,5,5,10
,2013,100600211,,,,4,4,8
,2013,100600212,,,,5,3,8
,2013,100600213,,,,13,10,23
,2013,100600214,,,,4,4,8
,2013,100600215,,,,8,7,15
,2013,100600216,,,,6,4,10
,2013,100600218,,,,6,1,7
,2013,100600219,,,,3,4,7
,2013,100600220,,,,6,8,14
,2013,100600221,,,,3,11,14
,2013,100600222,,,,11,9,20
,2013,100600223,,,,13,7,20
,2013,100600225,,,,7,13,20
,2013,100600226,,,,4,3,7
,2013,100600240,,,,7,3,10
,2013,100600244,,,,4,4,8
,2013,100600247,,,,12,3,15
,2013,100600252,,,,10,5,15
,2013,100600253,,,,6,4,10
,2013,100600254,,,,3,6,9
,2013,100600255,,,,8,8,16
,2013,100600256,,,,29,23,52
,2013,100600257,,,,10,12,22
,2013,100600258,,,,6,5,11
,2013,100600259,,,,25,11,36
,2013,100600259,,,,124,101,225
,2013,100600260,,,,39,14,53
,2013,100600262,,,,4,4,8
,2013,100600264,,,,13,20,33
,2013,100600265,,,,9,10,19
,2013,100600266,,,,45,52,97
,2013,100600269,,,,15,10,25
,2013,100600270,,,,3,2,5
,2013,100600271,,,,5,6,11
,2013,100600273,,,,6,3,9
,2013,100600274,,,,8,13,21
,2013,100600277,,,,3,7,10
,2013,100700001,,,,256,267,523
,2013,100700001,,,,17,18,35
,2013,100700002,,,,33,19,52
,2013,100700003,,,,12,13,25
,2013,100700004,,,,26,24,50
,2013,100700005,,,,56,43,99
,2013,100700006,,,,27,29,56
,2013,100700007,,,,42,26,68
,2013,100700008,,,,30,27,57
,2013,100700009,,,,24,8,32
,2013,100700010,,,,25,27,52
,2013,100700011,,,,59,52,111
,2013,100700012,,,,266,283,549
,2013,100700013,,,,19,16,35
,2013,100700014,,,,35,45,80
,2013,100700015,,,,21,16,37
,2013,100700016,,,,56,57,113
,2013,100700017,,,,53,63,116
,2013,100700018,,,,20,21,41
,2013,100700019,,,,40,42,82
,2013,100700020,,,,62,60,122
,2013,100700021,,,,41,32,73
,2013,100700022,,,,48,18,66
,2013,100700023,,,,38,27,65
,2013,100700024,,,,36,20,56
,2013,100700025,,,,32,20,52
,2013,100700026,,,,92,71,163
,2013,100700027,,,,48,34,82
,2013,100700028,,,,149,117,266
,2013,100700029,,,,101,93,194
,2013,100700030,,,,39,30,69
,2013,100700031,,,,68,58,126
,2013,100700032,,,,24,14,38
,2013,100700033,,,,25,27,52
,2013,100700034,,,,37,37,74
,2013,100700035,,,,48,46,94
,2013,100700036,,,,34,34,68
,2013,100700037,,,,29,20,49
,2013,100700038,,,,25,22,47
,2013,100700038,,,,25,31,56
,2013,100700039,,,,25,25,50
,2013,100700040,,,,26,18,44
,2013,100700041,,,,10,7,17
,2013,100700042,,,,19,28,47
,2013,100700042,,,,12,8,20
,2013,100700043,,,,14,16,30
,2013,100700044,,,,16,21,37
,2013,100700044,,,,8,10,18
,2013,100700045,,,,9,6,15
,2013,100700045,,,,21,21,42
,2013,100700046,,,,16,20,36
,2013,100700047,,,,35,29,64
,2013,100700048,,,,24,23,47
,2013,100700049,,,,24,26,50
,2013,100700050,,,,13,19,32
,2013,100700051,,,,35,31,66
,2013,100700052,,,,5,3,8
,2013,100700052,,,,14,15,29
,2013,100700052,,,,25,29,54
,2013,100700053,,,,12,16,28
,2013,100700054,,,,12,10,22
,2013,100700055,,,,9,16,25
,2013,100700056,,,,9,9,18
,2013,100700057,,,,636,537,1173
,2013,100700058,,,,9,12,21
,2013,100700059,,,,14,7,21
,2013,100700061,,,,14,8,22
,2013,100700062,,,,8,9,17
,2013,100700063,,,,11,9,20
,2013,100700064,,,,18,10,28
,2013,100700065,,,,96,162,258
,2013,100700067,,,,12,13,25
,2013,100700068,,,,11,7,18
,2013,100700071,,,,6,6,12
,2013,100700073,,,,5,5,10
,2013,100700074,,,,3,7,10
,2013,100700075,,,,4,6,10
,2013,100700076,,,,7,3,10
,2013,100700077,,,,3,2,5
,2013,100700078,,,,6,3,9
,2013,100700080,,,,54,37,91
,2013,100700080,,,,14,6,20
,2013,100700081,,,,7,14,21
,2013,100700082,,,,1,12,13
,2013,100700083,,,,7,12,19
,2013,100700084,,,,8,7,15
,2013,100700085,,,,3,4,7
,2013,100700096,,,,12,13,25
,2013,100700097,,,,6,19,25
,2013,100700098,,,,8,4,12
,2013,100700099,,,,2,4,6
,2013,100700100,,,,1,4,5
,2013,100700102,,,,1,6,7
,2013,100700104,,,,5,8,13
,2013,100700105,,,,7,7,14
,2013,100700106,,,,3,9,12
,2013,100700108,,,,5,5,10
,2013,100700117,,,,12,11,23
,2013,100700118,,,,3,6,9
,2013,100700120,,,,6,11,17
,2013,100700122,,,,7,11,18
,2013,100700123,,,,9,7,16
,2013,100700123,,,,22,23,45
,2013,100700134,,,,5,5,10
,2013,100700135,,,,4,7,11
,2013,100700136,,,,4,6,10
,2013,100700138,,,,4,5,9
,2013,100700139,,,,5,3,8
,2013,100700139,,,,12,9,21
,2013,100700140,,,,16,9,25
,2013,100700141,,,,9,8,17
,2013,100700142,,,,9,5,14
,2013,100700143,,,,15,10,25
,2013,100700143,,,,24,31,55
,2013,100700143,,,,2,3,5
,2013,100700144,,,,13,10,23
,2013,100700145,,,,12,11,23
,2013,100700148,,,,6,1,7
,2013,100700149,,,,4,2,6
,2013,100700150,,,,9,5,14
,2013,100700151,,,,13,15,28
,2013,100700152,,,,1,2,3
,2013,100700153,,,,3,4,7
,2013,100700154,,,,2,3,5
,2013,100700155,,,,25,20,45
,2013,100700173,,,,8,12,20
,2013,100800001,,,,72,57,129
,2013,100800002,,,,16,20,36
,2013,100800003,,,,63,54,117
,2013,100800004,,,,35,26,61
,2013,100800005,,,,23,17,40
,2013,100800006,,,,73,59,132
,2013,100800007,,,,11,6,17
,2013,100800008,,,,20,18,38
,2013,100800009,,,,2,7,9
,2013,100800010,,,,31,26,57
,2013,100800011,,,,24,19,43
,2013,100800012,,,,12,14,26
,2013,100800013,,,,138,144,282
,2013,100800014,,,,5,9,14
,2013,100800015,,,,9,5,14
,2013,100800016,,,,5,5,10
,2013,100800017,,,,7,8,15
,2013,100800018,,,,4,5,9
,2013,100800019,,,,16,15,31
,2013,100800020,,,,12,9,21
,2013,100800021,,,,2,5,7
,2013,100800022,,,,5,1,6
,2013,100900002,,,,54,69,123
,2013,100900003,,,,25,41,66
,2013,100900004,,,,15,14,29
,2013,100900005,,,,119,138,257
,2013,100900006,,,,69,88,157
,2013,100900007,,,,54,62,116
,2013,100900008,,,,22,22,44
,2013,100900009,,,,54,44,98
,2013,100900010,,,,27,32,59
,2013,100900011,,,,38,31,69
,2013,100900012,,,,28,32,60
,2013,100900013,,,,19,16,35
,2013,100900014,,,,41,31,72
,2013,100900015,,,,54,42,96
,2013,100900016,,,,40,28,68
,2013,100900017,,,,24,24,48
,2013,100900018,,,,17,25,42
,2013,100900019,,,,21,11,32
,2013,100900020,,,,31,22,53
,2013,100900021,,,,22,26,48
,2013,100900022,,,,77,70,147
,2013,100900023,,,,28,21,49
,2013,100900024,,,,47,39,86
,2013,100900024,,,,13,7,20
,2013,100900025,,,,26,18,44
,2013,100900026,,,,22,34,56
,2013,100900026,,,,10,9,19
,2013,100900027,,,,8,8,16
,2013,100900027,,,,25,16,41
,2013,100900028,,,,39,25,64
,2013,100900028,,,,7,9,16
,2013,100900029,,,,22,24,46
,2013,100900030,,,,6,10,16
,2013,100900030,,,,22,30,52
,2013,100900031,,,,35,36,71
,2013,100900032,,,,21,22,43
,2013,100900033,,,,12,19,31
,2013,100900033,,,,9,9,18
,2013,100900034,,,,45,40,85
,2013,100900036,,,,6,8,14
,2013,100900037,,,,11,12,23
,2013,100900038,,,,10,5,15
,2013,100900039,,,,5,10,15
,2013,100900041,,,,18,4,22
,2013,100900043,,,,7,13,20
,2013,100900044,,,,9,10,19
,2013,100900045,,,,13,7,20
,2013,100900046,,,,8,12,20
,2013,100900047,,,,5,4,9
,2013,100900048,,,,10,14,24
,2013,100900049,,,,6,14,20
,2013,100900050,,,,9,3,12
,2013,100900051,,,,7,9,16
,2013,100900051,,,,29,20,49
,2013,100900053,,,,5,6,11
,2013,100900054,,,,8,12,20
,2013,100900055,,,,9,7,16
,2013,100900056,,,,8,4,12
,2013,100900058,,,,4,6,10
,2013,100900059,,,,2,8,10
,2013,100900060,,,,2,3,5
,2013,100900061,,,,3,2,5
,2013,100900062,,,,3,8,11
,2013,100900063,,,,4,11,15
,2013,100900063,,,,28,17,45
,2013,100900064,,,,19,15,34
,2013,100900064,,,,7,7,14
,2013,100900067,,,,21,7,28
,2013,100900067,,,,10,6,16
,2013,100900068,,,,14,14,28
,2013,100900070,,,,6,2,8
,2013,100900072,,,,7,15,22
,2013,100900073,,,,11,11,22
,2013,100900074,,,,10,9,19
,2013,100900075,,,,23,27,50
,2013,100900076,,,,26,16,42
,2013,100900077,,,,11,10,21
,2013,100900079,,,,5,5,10
,2013,100900081,,,,3,1,4
,2013,100900129,,,,4,2,6
,2013,100900130,,,,4,1,5
,2013,100900131,,,,7,1,8
,2013,100900132,,,,16,19,35
,2013,100900133,,,,7,7,14
,2013,100900149,,,,2,2,4
,2013,100900149,,,,16,14,30
,2013,100900152,,,,4,4,8
,2013,100900154,,,,6,2,8
,2013,100900155,,,,8,7,15
,2013,100900156,,,,6,3,9
,2013,100900177,,,,4,4,8
,2013,100900178,,,,9,8,17
,2013,100900180,,,,8,15,23
,2013,100900181,,,,9,6,15
,2013,100900182,,,,4,11,15
,2013,100900183,,,,11,11,22
,2013,100900184,,,,8,8,16
,2013,101000001,,,,46,46,92
,2013,101000002,,,,15,28,43
,2013,101000003,,,,13,4,17
,2013,101000004,,,,32,32,64
,2013,101000005,,,,25,23,48
,2013,101000006,,,,27,21,48
,2013,101000007,,,,7,7,14
,2013,101000008,,,,5,5,10
,2013,101000009,,,,98,66,164
,2013,101000010,,,,10,12,22
,2013,101000011,,,,43,37,80
,2013,101000012,,,,40,40,80
,2013,101000013,,,,21,19,40
,2013,101000014,,,,88,93,181
,2013,101000015,,,,29,19,48
,2013,101000017,,,,35,31,66
,2013,101000019,,,,16,17,33
,2013,101000019,,,,7,4,11
,2013,101000020,,,,9,5,14
,2013,101000021,,,,13,18,31
,2013,101000022,,,,7,8,15
,2013,101000023,,,,102,101,203
,2013,101000024,,,,8,8,16
,2013,101000025,,,,7,8,15
,2013,101000026,,,,8,10,18
,2013,101000027,,,,21,16,37
,2013,101000028,,,,7,9,16
,2013,101000030,,,,6,3,9
,2013,101000031,,,,7,9,16
,2013,101000032,,,,6,4,10
,2013,101000034,,,,3,2,5
,2013,101000036,,,,1,5,6
,2013,101000037,,,,5,3,8
,2013,101000038,,,,2,3,5
,2013,101000039,,,,6,2,8
,2013,101000053,,,,9,5,14
,2013,101000054,,,,1,4,5
,2013,101000055,,,,3,7,10
,2013,101100001,,,,176,168,344
,2013,101100002,,,,49,89,138
,2013,101100003,,,,27,17,44
,2013,101100004,,,,81,66,147
,2013,101100005,,,,63,56,119
,2013,101100006,,,,27,22,49
,2013,101100007,,,,16,10,26
,2013,101100010,,,,39,41,80
,2013,101100011,,,,5,7,12
,2013,101100012,,,,10,9,19
,2013,101100013,,,,21,20,41
,2013,101100015,,,,7,2,9
,2013,101100022,,,,4,9,13
,2013,101100023,,,,15,17,32
,2013,101100024,,,,3,5,8
,2013,101100026,,,,7,9,16
,2013,101200001,,,,15,8,23
,2013,101200002,,,,8,6,14
,2013,101200003,,,,4,2,6
,2013,101200004,,,,13,8,21
,2013,101200005,,,,164,155,319
,2013,101200006,,,,41,39,80
,2013,101200007,,,,26,25,51
,2013,101200008,,,,10,4,14
,2013,101200008,,,,40,23,63
,2013,101200009,,,,39,46,85
,2013,101200010,,,,172,130,302
,2013,101200011,,,,43,53,96
,2013,101200012,,,,38,26,64
,2013,101200013,,,,51,31,82
,2013,101200014,,,,18,21,39
,2013,101200015,,,,66,57,123
,2013,101200016,,,,55,50,105
,2013,101200017,,,,24,18,42
,2013,101200018,,,,10,5,15
,2013,101200019,,,,4,5,9
,2013,101200019,,,,33,34,67
,2013,101200019,,,,4,6,10
,2013,101200020,,,,40,27,67
,2013,101200020,,,,6,6,12
,2013,101200021,,,,21,17,38
,2013,101200021,,,,3,8,11
,2013,101200023,,,,43,36,79
,2013,101200024,,,,30,49,79
,2013,101200025,,,,22,21,43
,2013,101200026,,,,18,15,33
,2013,101200029,,,,24,29,53
,2013,101200030,,,,36,28,64
,2013,101200032,,,,23,31,54
,2013,101200032,,,,23,31,54
,2013,101200033,,,,14,13,27
,2013,101200034,,,,15,30,45
,2013,101200035,,,,11,10,21
,2013,101200036,,,,10,14,24
,2013,101200037,,,,6,5,11
,2013,101200037,,,,27,23,50
,2013,101200038,,,,28,34,62
,2013,101200038,,,,10,13,23
,2013,101200039,,,,68,57,125
,2013,101200041,,,,12,10,22
,2013,101200042,,,,10,13,23
,2013,101200043,,,,9,9,18
,2013,101200043,,,,22,34,56
,2013,101200046,,,,12,6,18
,2013,101200047,,,,5,4,9
,2013,101200047,,,,26,23,49
,2013,101200050,,,,43,27,70
,2013,101200050,,,,13,10,23
,2013,101200052,,,,34,21,55
,2013,101200081,,,,3,7,10
,2013,101200084,,,,7,6,13
,2013,101200091,,,,32,23,55
,2013,101200091,,,,4,4,8
,2013,101200092,,,,9,16,25
,2013,101200092,,,,4,0,4
,2013,101200093,,,,5,8,13
,2013,101200094,,,,9,16,25
,2013,101200095,,,,14,4,18
,2013,101200096,,,,4,4,8
,2013,101200097,,,,8,2,10
,2013,101200098,,,,6,6,12
,2013,101200099,,,,6,4,10
,2013,101200103,,,,3,4,7
,2013,101200104,,,,50,40,90
,2013,101200105,,,,3,6,9
,2013,101200106,,,,5,8,13
,2013,101200107,,,,2,6,8
,2013,101200108,,,,7,5,12
,2013,101200113,,,,13,14,27
,2013,101300001,,,,119,68,187
,2013,101300002,,,,28,32,60
,2013,101300003,,,,5,9,14
,2013,101300004,,,,38,49,87
,2013,101300005,,,,64,50,114
,2013,101300006,,,,93,68,161
,2013,101300007,,,,25,19,44
,2013,101300008,,,,74,46,120
,2013,101300009,,,,27,28,55
,2013,101300010,,,,30,38,68
,2013,101300011,,,,64,53,117
,2013,101300012,,,,44,31,75
,2013,101300013,,,,47,26,73
,2013,101300014,,,,37,19,56
,2013,101300015,,,,35,46,81
,2013,101300016,,,,5,2,7
,2013,101300016,,,,21,22,43
,2013,101300017,,,,44,36,80
,2013,101300018,,,,26,23,49
,2013,101300019,,,,43,48,91
,2013,101300019,,,,10,17,27
,2013,101300020,,,,25,28,53
,2013,101300021,,,,6,8,14
,2013,101300021,,,,7,5,12
,2013,101300022,,,,37,30,67
,2013,101300024,,,,8,9,17
,2013,101300025,,,,8,7,15
,2013,101300027,,,,7,11,18
,2013,101300028,,,,6,5,11
,2013,101300028,,,,15,22,37
,2013,101300029,,,,127,103,230
,2013,101300030,,,,32,21,53
,2013,101300031,,,,7,10,17
,2013,101300032,,,,9,9,18
,2013,101300033,,,,10,4,14
,2013,101300034,,,,10,15,25
,2013,101300035,,,,14,9,23
,2013,101300036,,,,43,44,87
,2013,101300037,,,,4,6,10
,2013,101300038,,,,21,10,31
,2013,101300039,,,,34,37,71
,2013,101300040,,,,8,9,17
,2013,101300041,,,,12,7,19
,2013,101300042,,,,12,6,18
,2013,101300042,,,,31,30,61
,2013,101300043,,,,4,7,11
,2013,101300044,,,,15,7,22
,2013,101300045,,,,8,4,12
,2013,101300047,,,,7,2,9
,2013,101300048,,,,6,3,9
,2013,101300049,,,,6,7,13
,2013,101300050,,,,6,10,16
,2013,101300051,,,,10,5,15
,2013,101300052,,,,8,5,13
,2013,101300054,,,,14,8,22
,2013,101300055,,,,7,7,14
,2013,101300057,,,,5,10,15
,2013,101300062,,,,6,2,8
,2013,101300063,,,,7,1,8
,2013,101300066,,,,6,6,12
,2013,101300067,,,,7,13,20
,2013,101400001,,,,39,32,71
,2013,101400002,,,,68,65,133
,2013,101400003,,,,9,11,20
,2013,101400004,,,,52,50,102
,2013,101400005,,,,24,14,38
,2013,101400006,,,,72,67,139
,2013,101400007,,,,21,27,48
,2013,101400008,,,,39,48,87
,2013,101400009,,,,18,24,42
,2013,101400010,,,,65,55,120
,2013,101400011,,,,56,51,107
,2013,101400012,,,,16,15,31
,2013,101400013,,,,46,27,73
,2013,101400014,,,,5,5,10
,2013,101400014,,,,35,44,79
,2013,101400014,,,,13,11,24
,2013,101400015,,,,14,8,22
,2013,101400016,,,,14,15,29
,2013,101400017,,,,10,7,17
,2013,101400018,,,,8,4,12
,2013,101400019,,,,8,7,15
,2013,101400020,,,,25,30,55
,2013,101400021,,,,9,10,19
,2013,101400022,,,,9,13,22
,2013,101400023,,,,75,78,153
,2013,101400024,,,,12,11,23
,2013,101400024,,,,4,5,9
,2013,101400025,,,,17,25,42
,2013,101400025,,,,5,4,9
,2013,101400026,,,,10,10,20
,2013,101400027,,,,2,3,5
,2013,101400027,,,,19,18,37
,2013,101400028,,,,10,10,20
,2013,101400042,,,,6,6,12
,2013,101400042,,,,24,21,45
,2013,101400043,,,,12,10,22
,2013,101400044,,,,12,13,25
,2013,101400044,,,,6,5,11
,2013,101400045,,,,9,5,14
,2013,101400045,,,,10,10,20
,2013,101400046,,,,3,5,8
,2013,101400046,,,,26,31,57
,2013,101400063,,,,7,3,10
,2013,101400064,,,,19,12,31
,2013,101400064,,,,3,3,6
,2013,101400065,,,,5,4,9
,2013,101400068,,,,5,3,8
,2013,101400070,,,,4,6,10
,2013,101400072,,,,4,10,14
,2013,101400072,,,,6,8,14
,2013,101400108,,,,6,5,11
,2013,101400168,,,,5,5,10
,2013,101400169,,,,7,3,10
,2013,101400169,,,,15,13,28
,2013,101400170,,,,7,6,13
,2013,101400170,,,,7,5,12
,2013,101400174,,,,4,8,12
,2013,101400177,,,,6,6,12
,2013,101400181,,,,3,3,6
,2013,101400182,,,,6,3,9
,2013,101400185,,,,5,5,10
,2013,101400186,,,,5,3,8
,2013,101400187,,,,5,7,12
,2013,101400189,,,,25,24,49
,2013,101400190,,,,3,2,5
,2013,101400193,,,,4,6,10
,2013,101400194,,,,6,7,13
,2013,101500001,,,,42,43,85
,2013,101500002,,,,93,87,180
,2013,101500003,,,,27,17,44
,2013,101500004,,,,34,36,70
,2013,101500005,,,,94,64,158
,2013,101500006,,,,12,14,26
,2013,101500007,,,,27,30,57
,2013,101500008,,,,24,15,39
,2013,101500009,,,,32,25,57
,2013,101500010,,,,11,5,16
,2013,101500011,,,,30,31,61
,2013,101500012,,,,13,19,32
,2013,101500013,,,,14,7,21
,2013,101500014,,,,16,14,30
,2013,101500015,,,,30,36,66
,2013,101500016,,,,14,11,25
,2013,101500017,,,,9,17,26
,2013,101500017,,,,3,7,10
,2013,101500018,,,,9,22,31
,2013,101500019,,,,12,4,16
,2013,101500020,,,,6,5,11
,2013,101500021,,,,9,7,16
,2013,101500022,,,,9,9,18
,2013,101500023,,,,13,10,23
,2013,101500025,,,,107,114,221
,2013,101500026,,,,10,2,12
,2013,101500028,,,,13,6,19
,2013,101500029,,,,2,6,8
,2013,101500030,,,,3,5,8
,2013,101500031,,,,5,4,9
,2013,101500032,,,,6,2,8
,2013,101500056,,,,6,6,12
,2013,101500057,,,,12,7,19
,2013,101500058,,,,2,8,10
,2013,101500059,,,,5,4,9
,2013,101500061,,,,6,6,12
,2013,101500062,,,,8,4,12
,2013,101500063,,,,14,7,21
,2013,101600001,,,,94,83,177
,2013,101600002,,,,148,142,290
,2013,101600003,,,,33,43,76
,2013,101600004,,,,59,51,110
,2013,101600005,,,,64,47,111
,2013,101600006,,,,89,68,157
,2013,101600007,,,,48,34,82
,2013,101600008,,,,64,70,134
,2013,101600009,,,,53,31,84
,2013,101600010,,,,95,69,164
,2013,101600011,,,,137,113,250
,2013,101600012,,,,40,41,81
,2013,101600013,,,,87,110,197
,2013,101600014,,,,42,25,67
,2013,101600015,,,,41,39,80
,2013,101600016,,,,34,28,62
,2013,101600018,,,,68,53,121
,2013,101600019,,,,26,26,52
,2013,101600020,,,,21,12,33
,2013,101600021,,,,26,28,54
,2013,101600022,,,,33,25,58
,2013,101600023,,,,5,5,10
,2013,101600024,,,,20,16,36
,2013,101600025,,,,14,14,28
,2013,101600027,,,,54,55,109
,2013,101600028,,,,26,27,53
,2013,101600029,,,,50,51,101
,2013,101600030,,,,43,41,84
,2013,101600032,,,,24,38,62
,2013,101600033,,,,5,12,17
,2013,101600034,,,,13,16,29
,2013,101600034,,,,2,6,8
,2013,101600035,,,,6,5,11
,2013,101600035,,,,27,32,59
,2013,101600038,,,,13,10,23
,2013,101600038,,,,21,37,58
,2013,101600039,,,,53,57,110
,2013,101600040,,,,10,11,21
,2013,101600041,,,,18,23,41
,2013,101600042,,,,9,12,21
,2013,101600043,,,,7,12,19
,2013,101600043,,,,26,13,39
,2013,101600044,,,,13,23,36
,2013,101600045,,,,9,14,23
,2013,101600046,,,,9,6,15
,2013,101600047,,,,223,223,446
,2013,101600047,,,,72,47,119
,2013,101600048,,,,12,8,20
,2013,101600049,,,,33,30,63
,2013,101600050,,,,24,22,46
,2013,101600050,,,,13,6,19
,2013,101600051,,,,9,1,10
,2013,101600051,,,,19,12,31
,2013,101600052,,,,10,8,18
,2013,101600053,,,,14,15,29
,2013,101600055,,,,28,21,49
,2013,101600056,,,,36,33,69
,2013,101600056,,,,15,8,23
,2013,101600057,,,,30,24,54
,2013,101600058,,,,13,8,21
,2013,101600059,,,,20,17,37
,2013,101600059,,,,15,4,19
,2013,101600060,,,,8,6,14
,2013,101600060,,,,12,18,30
,2013,101600061,,,,18,20,38
,2013,101600061,,,,17,9,26
,2013,101600062,,,,8,12,20
,2013,101600063,,,,12,10,22
,2013,101600064,,,,9,7,16
,2013,101600065,,,,23,28,51
,2013,101600066,,,,15,11,26
,2013,101600067,,,,15,10,25
,2013,101600068,,,,12,8,20
,2013,101600069,,,,57,67,124
,2013,101600070,,,,4,7,11
,2013,101600073,,,,17,10,27
,2013,101600074,,,,3,10,13
,2013,101600079,,,,6,14,20
,2013,101600080,,,,12,5,17
,2013,101600081,,,,26,34,60
,2013,101600083,,,,20,23,43
,2013,101600084,,,,29,27,56
,2013,101600087,,,,6,5,11
,2013,101600123,,,,7,3,10
,2013,101600123,,,,16,19,35
,2013,101600124,,,,8,8,16
,2013,101600125,,,,14,10,24
,2013,101600160,,,,3,9,12
,2013,101600163,,,,9,7,16
,2013,101600165,,,,18,14,32
,2013,101600166,,,,31,24,55
,2013,101600184,,,,9,11,20
,2013,101600185,,,,13,8,21
,2013,101600186,,,,3,4,7
,2013,101600189,,,,3,3,6
,2013,101600194,,,,8,8,16
,2013,101600195,,,,2,5,7
,2013,101600196,,,,4,7,11
,2013,101600197,,,,12,8,20
,2013,101600199,,,,5,5,10
,2013,101600200,,,,11,7,18
,2013,101600204,,,,4,4,8
,2013,101600205,,,,3,6,9
,2013,101600206,,,,1,7,8
,2013,101600207,,,,4,4,8
,2013,101700002,,,,82,94,176
,2013,101700003,,,,33,44,77
,2013,101700004,,,,27,28,55
,2013,101700005,,,,18,21,39
,2013,101700006,,,,59,39,98
,2013,101700007,,,,37,41,78
,2013,101700008,,,,16,22,38
,2013,101700009,,,,27,35,62
,2013,101700010,,,,57,66,123
,2013,101700011,,,,18,17,35
,2013,101700012,,,,45,53,98
,2013,101700013,,,,30,34,64
,2013,101700014,,,,38,30,68
,2013,101700015,,,,13,8,21
,2013,101700017,,,,52,56,108
,2013,101700018,,,,54,45,99
,2013,101700020,,,,78,59,137
,2013,101700021,,,,42,46,88
,2013,101700022,,,,30,24,54
,2013,101700023,,,,121,129,250
,2013,101700024,,,,23,30,53
,2013,101700025,,,,26,14,40
,2013,101700026,,,,25,17,42
,2013,101700027,,,,10,8,18
,2013,101700028,,,,10,8,18
,2013,101700029,,,,31,21,52
,2013,101700030,,,,4,1,5
,2013,101700030,,,,31,28,59
,2013,101700031,,,,17,8,25
,2013,101700032,,,,13,18,31
,2013,101700033,,,,19,11,30
,2013,101700034,,,,15,10,25
,2013,101700035,,,,4,12,16
,2013,101700036,,,,16,24,40
,2013,101700038,,,,14,16,30
,2013,101700039,,,,8,3,11
,2013,101700040,,,,8,11,19
,2013,101700041,,,,7,5,12
,2013,101700042,,,,2,2,4
,2013,101700047,,,,11,13,24
,2013,101700048,,,,89,69,158
,2013,101700049,,,,86,69,155
,2013,101700050,,,,37,27,64
,2013,101700051,,,,14,12,26
,2013,101700052,,,,17,31,48
,2013,101700052,,,,4,10,14
,2013,101700053,,,,12,9,21
,2013,101700054,,,,8,5,13
,2013,101700058,,,,9,6,15
,2013,101700059,,,,7,6,13
,2013,101700060,,,,3,9,12
,2013,101700062,,,,3,3,6
,2013,101700064,,,,6,7,13
,2013,101700065,,,,6,5,11
,2013,101700068,,,,7,3,10
,2013,101700069,,,,11,9,20
,2013,101700072,,,,2,6,8
,2013,101700073,,,,4,4,8
,2013,101700074,,,,9,5,14
,2013,101700076,,,,20,10,30
,2013,101700077,,,,4,8,12
,2013,101700082,,,,9,9,18
,2013,101700092,,,,5,5,10
,2013,101700093,,,,3,2,5
,2013,101700095,,,,3,7,10
,2013,101700096,,,,7,9,16
,2013,101700097,,,,3,3,6
,2013,101700098,,,,3,2,5
,2013,101700100,,,,4,3,7
,2013,101700105,,,,8,10,18
,2013,101700108,,,,10,14,24
,2013,110100001,,,,35,26,61
,2013,110100003,,,,6,12,18
,2013,110100004,,,,19,14,33
,2013,110100004,,,,436,437,873
,2013,110100005,,,,47,40,87
,2013,110100006,,,,180,153,333
,2013,110100007,,,,200,190,390
,2013,110100008,,,,23,15,38
,2013,110100009,,,,37,40,77
,2013,110100010,,,,71,71,142
,2013,110100011,,,,116,123,239
,2013,110100011,,,,29,31,60
,2013,110100013,,,,105,88,193
,2013,110100014,,,,542,580,1122
,2013,110100015,,,,38,25,63
,2013,110100016,,,,17,20,37
,2013,110100018,,,,24,30,54
,2013,110100018,,,,37,30,67
,2013,110100018,,,,7,6,13
,2013,110100020,,,,25,19,44
,2013,110100021,,,,31,30,61
,2013,110100021,,,,100,106,206
,2013,110100021,,,,52,52,104
,2013,110100023,,,,23,21,44
,2013,110100025,,,,72,101,173
,2013,110100025,,,,126,147,273
,2013,110100027,,,,78,46,124
,2013,110100028,,,,28,27,55
,2013,110100029,,,,16,12,28
,2013,110100030,,,,48,57,105
,2013,110100031,,,,14,11,25
,2013,110100033,,,,4,4,8
,2013,110100033,,,,23,41,64
,2013,110100034,,,,347,346,693
,2013,110100036,,,,73,74,147
,2013,110100036,,,,77,80,157
,2013,110100036,,,,89,106,195
,2013,110100036,,,,12,16,28
,2013,110100037,,,,42,20,62
,2013,110100038,,,,539,631,1170
,2013,110100039,,,,43,66,109
,2013,110100042,,,,9,10,19
,2013,110100043,,,,17,27,44
,2013,110100046,,,,18,17,35
,2013,110100049,,,,29,21,50
,2013,110100050,,,,20,8,28
,2013,110100051,,,,29,28,57
,2013,110100052,,,,27,46,73
,2013,110100052,,,,67,74,141
,2013,110100052,,,,5,6,11
,2013,110100054,,,,43,66,109
,2013,110100056,,,,3,3,6
,2013,110100056,,,,41,26,67
,2013,110100057,,,,112,115,227
,2013,110100058,,,,31,31,62
,2013,110100059,,,,9,8,17
,2013,110100060,,,,5,4,9
,2013,110100061,,,,8,3,11
,2013,110100062,,,,5,2,7
,2013,110100065,,,,1,2,3
,2013,110100066,,,,2,2,4
,2013,110100068,,,,317,279,596
,2013,110100070,,,,5,4,9
,2013,110100071,,,,5,4,9
,2013,110100074,,,,4,6,10
,2013,110100075,,,,8,13,21
,2013,110100076,,,,1,1,2
,2013,110100077,,,,5,3,8
,2013,110100079,,,,10,14,24
,2013,110100082,,,,6,2,8
,2013,110100084,,,,180,377,557
,2013,110100085,,,,25,22,47
,2013,110100088,,,,2,10,12
,2013,110100091,,,,20,22,42
,2013,110100091,,,,12,7,19
,2013,110100091,,,,7,9,16
,2013,110100092,,,,50,66,116
,2013,110100093,,,,61,51,112
,2013,110100095,,,,3,2,5
,2013,110100098,,,,43,32,75
,2013,110100099,,,,13,32,45
,2013,110100099,,,,28,17,45
,2013,110100099,,,,3,6,9
,2013,110100101,,,,5,4,9
,2013,110100102,,,,2,8,10
,2013,110100103,,,,3,5,8
,2013,110100107,,,,6,4,10
,2013,110100108,,,,9,6,15
,2013,110200001,,,,108,80,188
,2013,110200002,,,,35,34,69
,2013,110200003,,,,95,115,210
,2013,110200004,,,,61,63,124
,2013,110200005,,,,3,3,6
,2013,110200006,,,,13,11,24
,2013,110200008,,,,22,24,46
,2013,110200008,,,,33,43,76
,2013,110200012,,,,18,23,41
,2013,110200013,,,,20,14,34
,2013,110200014,,,,40,39,79
,2013,110200014,,,,52,41,93
,2013,110200015,,,,7,5,12
,2013,110200016,,,,5,17,22
,2013,110200017,,,,10,8,18
,2013,110200020,,,,74,76,150
,2013,110200022,,,,37,27,64
,2013,110200023,,,,12,2,14
,2013,110200024,,,,1,2,3
,2013,110200025,,,,5,8,13
,2013,110200026,,,,4,3,7
,2013,110200027,,,,1,0,1
,2013,110200028,,,,6,6,12
,2013,110300001,,,,10,12,22
,2013,110300002,,,,39,39,78
,2013,110300003,,,,317,208,525
,2013,110300004,,,,14,17,31
,2013,110300005,,,,50,45,95
,2013,110300006,,,,7,8,15
,2013,110300007,,,,207,174,381
,2013,110300008,,,,21,27,48
,2013,110300008,,,,23,16,39
,2013,110300009,,,,27,26,53
,2013,110300009,,,,5,8,13
,2013,110300010,,,,37,29,66
,2013,110300011,,,,6,7,13
,2013,110300011,,,,63,58,121
,2013,110300012,,,,38,25,63
,2013,110300013,,,,22,20,42
,2013,110300014,,,,114,100,214
,2013,110300015,,,,67,69,136
,2013,110300016,,,,10,6,16
,2013,110300017,,,,7,10,17
,2013,110300020,,,,20,20,40
,2013,110300021,,,,25,23,48
,2013,110300023,,,,8,3,11
,2013,110300024,,,,15,4,19
,2013,110300027,,,,151,172,323
,2013,110300030,,,,20,13,33
,2013,110300031,,,,7,11,18
,2013,110300032,,,,6,12,18
,2013,110300033,,,,37,41,78
,2013,110300036,,,,8,12,20
,2013,110300036,,,,24,25,49
,2013,110300037,,,,9,6,15
,2013,110300040,,,,4,6,10
,2013,110300041,,,,57,54,111
,2013,110300043,,,,2,4,6
,2013,110300044,,,,10,8,18
,2013,110300045,,,,9,9,18
,2013,110300047,,,,8,5,13
,2013,110300048,,,,0,5,5
,2013,110400001,,,,21,25,46
,2013,110400001,,,,153,127,280
,2013,110400002,,,,20,31,51
,2013,110400003,,,,21,42,63
,2013,110400004,,,,20,20,40
,2013,110400004,,,,7,5,12
,2013,110400004,,,,8,7,15
,2013,110400005,,,,21,26,47
,2013,110400006,,,,18,32,50
,2013,110400007,,,,8,8,16
,2013,110400008,,,,9,5,14
,2013,110400011,,,,72,76,148
,2013,110400011,,,,6,5,11
,2013,110400015,,,,15,6,21
,2013,120100001,,,,164,140,304
,2013,120100002,,,,42,47,89
,2013,120100003,,,,14,6,20
,2013,120100004,,,,256,258,514
,2013,120100005,,,,289,214,503
,2013,120100006,,,,275,260,535
,2013,120100007,,,,15,10,25
,2013,120100007,,,,92,101,193
,2013,120100008,,,,44,31,75
,2013,120100009,,,,3,1,4
,2013,120100009,,,,14,8,22
,2013,120100010,,,,3,8,11
,2013,120100010,,,,28,34,62
,2013,120100011,,,,246,229,475
,2013,120100012,,,,26,18,44
,2013,120100013,,,,19,24,43
,2013,120100014,,,,44,41,85
,2013,120100015,,,,120,116,236
,2013,120100016,,,,15,22,37
,2013,120100017,,,,48,44,92
,2013,120100018,,,,146,145,291
,2013,120100019,,,,118,105,223
,2013,120100020,,,,8,3,11
,2013,120100021,,,,36,39,75
,2013,120100022,,,,55,45,100
,2013,120100023,,,,30,32,62
,2013,120100024,,,,0,5,5
,2013,120100024,,,,10,17,27
,2013,120100025,,,,15,8,23
,2013,120100026,,,,24,25,49
,2013,120100028,,,,2,10,12
,2013,120100028,,,,14,13,27
,2013,120100028,,,,4,0,4
,2013,120100029,,,,45,55,100
,2013,120100030,,,,21,23,44
,2013,120100031,,,,8,5,13
,2013,120100031,,,,28,30,58
,2013,120100032,,,,4,3,7
,2013,120100032,,,,11,7,18
,2013,120100033,,,,9,4,13
,2013,120100033,,,,32,26,58
,2013,120100034,,,,19,3,22
,2013,120100035,,,,27,19,46
,2013,120100035,,,,11,11,22
,2013,120100036,,,,473,975,1448
,2013,120100037,,,,10,10,20
,2013,120100039,,,,5,3,8
,2013,120100040,,,,6,11,17
,2013,120100041,,,,6,11,17
,2013,120100042,,,,10,12,22
,2013,120100043,,,,142,174,316
,2013,120100046,,,,21,23,44
,2013,120100047,,,,25,21,46
,2013,120100048,,,,13,11,24
,2013,120100049,,,,66,70,136
,2013,120100050,,,,50,37,87
,2013,120100051,,,,45,41,86
,2013,120100052,,,,43,45,88
,2013,120100053,,,,35,36,71
,2013,120100054,,,,10,12,22
,2013,120100055,,,,43,43,86
,2013,120100056,,,,14,12,26
,2013,120100057,,,,11,3,14
,2013,120100058,,,,845,304,1149
,2013,120100059,,,,71,128,199
,2013,120100060,,,,812,1199,2011
,2013,120100061,,,,27,52,79
,2013,120100063,,,,47,70,117
,2013,120100064,,,,72,54,126
,2013,120100064,,,,16,17,33
,2013,120100065,,,,24,34,58
,2013,120100070,,,,21,23,44
,2013,120100071,,,,11,15,26
,2013,120100072,,,,200,173,373
,2013,120100074,,,,15,8,23
,2013,120100075,,,,19,18,37
,2013,120100076,,,,38,40,78
,2013,120100077,,,,26,14,40
,2013,120100078,,,,14,10,24
,2013,120100079,,,,33,31,64
,2013,120100080,,,,6,10,16
,2013,120100081,,,,7,11,18
,2013,120100082,,,,52,65,117
,2013,120100084,,,,13,7,20
,2013,120100085,,,,6,4,10
,2013,120100086,,,,3,4,7
,2013,120100086,,,,11,8,19
,2013,120100087,,,,12,11,23
,2013,120100088,,,,61,51,112
,2013,120100090,,,,17,28,45
,2013,120100091,,,,6,13,19
,2013,120100092,,,,6,11,17
,2013,120100093,,,,25,29,54
,2013,120100114,,,,6,4,10
,2013,120100114,,,,38,36,74
,2013,120100117,,,,19,23,42
,2013,120100117,,,,14,6,20
,2013,120100118,,,,11,19,30
,2013,120100118,,,,10,13,23
,2013,120100119,,,,11,2,13
,2013,120100120,,,,12,6,18
,2013,120100121,,,,22,24,46
,2013,120100122,,,,3,6,9
,2013,120100123,,,,3,7,10
,2013,120100124,,,,5,2,7
,2013,120100125,,,,5,4,9
,2013,120100126,,,,60,0,60
,2013,120100127,,,,7,8,15
,2013,120100128,,,,5,2,7
,2013,120100129,,,,15,11,26
,2013,120100129,,,,22,16,38
,2013,120100130,,,,19,19,38
,2013,120100130,,,,17,20,37
,2013,120200001,,,,7,2,9
,2013,120200002,,,,38,48,86
,2013,120200003,,,,13,9,22
,2013,120200004,,,,8,7,15
,2013,120200005,,,,16,15,31
,2013,120200006,,,,31,23,54
,2013,120200007,,,,4,8,12
,2013,120200008,,,,20,17,37
,2013,120200009,,,,24,22,46
,2013,120200010,,,,24,21,45
,2013,120200011,,,,22,21,43
,2013,120200012,,,,9,4,13
,2013,120200013,,,,5,4,9
,2013,120200014,,,,20,13,33
,2013,120200015,,,,7,3,10
,2013,120200016,,,,11,3,14
,2013,120200017,,,,13,6,19
,2013,120200018,,,,29,25,54
,2013,120200019,,,,7,9,16
,2013,120200020,,,,8,8,16
,2013,120200021,,,,13,16,29
,2013,120200024,,,,11,13,24
,2013,120200025,,,,49,57,106
,2013,120200026,,,,11,9,20
,2013,120200028,,,,6,4,10
,2013,120200028,,,,4,2,6
,2013,120200030,,,,5,8,13
,2013,120200031,,,,9,3,12
,2013,120200032,,,,7,2,9
,2013,120200033,,,,6,7,13
,2013,120200034,,,,7,4,11
,2013,120200035,,,,7,4,11
,2013,120200054,,,,4,2,6
,2013,120200055,,,,5,2,7
,2013,120200058,,,,2,2,4
,2013,120200059,,,,5,6,11
,2013,120200060,,,,5,6,11
,2013,120200062,,,,3,4,7
,2013,120200063,,,,6,7,13
,2013,120200064,,,,7,8,15
,2013,120200065,,,,2,4,6
,2013,120300001,,,,8,7,15
,2013,120300002,,,,5,5,10
,2013,120300003,,,,20,14,34
,2013,120300004,,,,22,21,43
,2013,120300005,,,,36,35,71
,2013,120300006,,,,29,28,57
,2013,120300007,,,,26,15,41
,2013,120300008,,,,19,13,32
,2013,120300010,,,,14,18,32
,2013,120300011,,,,97,95,192
,2013,120300012,,,,8,2,10
,2013,120300013,,,,5,4,9
,2013,120300014,,,,4,8,12
,2013,120300015,,,,18,19,37
,2013,120300016,,,,3,6,9
,2013,120300017,,,,18,11,29
,2013,120300018,,,,4,3,7
,2013,120300019,,,,1,6,7
,2013,120300020,,,,18,10,28
,2013,120300022,,,,4,3,7
,2013,120300023,,,,4,2,6
,2013,120300025,,,,15,16,31
,2013,120300035,,,,3,6,9
,2013,120300036,,,,7,1,8
,2013,120300037,,,,5,5,10
,2013,120300038,,,,2,2,4
,2013,120300039,,,,8,7,15
,2013,120300040,,,,10,6,16
,2013,120300041,,,,5,2,7
,2013,120300042,,,,5,2,7
,2013,120300043,,,,2,5,7
,2013,120400001,,,,183,153,336
,2013,120400002,,,,4,7,11
,2013,120400002,,,,26,14,40
,2013,120400004,,,,41,48,89
,2013,120400005,,,,366,263,629
,2013,120500002,,,,15,7,22
,2013,120500004,,,,46,70,116
,2013,120500005,,,,138,136,274
,2013,120500006,,,,43,40,83
,2013,120500007,,,,42,27,69
,2013,120500008,,,,35,36,71
,2013,120500009,,,,42,51,93
,2013,120500010,,,,30,30,60
,2013,120500011,,,,15,13,28
,2013,120500012,,,,41,30,71
,2013,120500013,,,,40,45,85
,2013,120500014,,,,43,41,84
,2013,120500015,,,,63,55,118
,2013,120500017,,,,6,9,15
,2013,120500018,,,,42,41,83
,2013,120500021,,,,23,19,42
,2013,120500022,,,,0,23,23
,2013,120500023,,,,12,10,22
,2013,120500024,,,,19,19,38
,2013,120500025,,,,7,9,16
,2013,120500027,,,,32,17,49
,2013,120500028,,,,16,19,35
,2013,120500029,,,,32,17,49
,2013,120500031,,,,4,6,10
,2013,120500033,,,,7,7,14
,2013,120500033,,,,26,22,48
,2013,120500034,,,,16,26,42
,2013,120500035,,,,9,10,19
,2013,120500036,,,,10,13,23
,2013,120500037,,,,9,10,19
,2013,120500038,,,,13,4,17
,2013,120500039,,,,11,7,18
,2013,120500040,,,,8,11,19
,2013,120500042,,,,13,9,22
,2013,120500043,,,,8,8,16
,2013,120500044,,,,8,4,12
,2013,120500044,,,,21,12,33
,2013,120500055,,,,12,7,19
,2013,120500056,,,,8,7,15
,2013,120500062,,,,4,2,6
,2013,120500063,,,,11,8,19
,2013,120600002,,,,6,4,10
,2013,120600003,,,,22,22,44
,2013,120600004,,,,12,8,20
,2013,120600005,,,,190,158,348
,2013,120600006,,,,64,58,122
,2013,120600007,,,,45,42,87
,2013,120600008,,,,30,19,49
,2013,120600009,,,,94,91,185
,2013,120600010,,,,7,7,14
,2013,120600011,,,,15,25,40
,2013,120600012,,,,19,17,36
,2013,120600013,,,,51,28,79
,2013,120600014,,,,36,22,58
,2013,120600015,,,,124,100,224
,2013,120600016,,,,20,20,40
,2013,120600017,,,,8,14,22
,2013,120600018,,,,21,10,31
,2013,120600019,,,,19,16,35
,2013,120600020,,,,38,31,69
,2013,120600021,,,,47,46,93
,2013,120600022,,,,30,33,63
,2013,120600023,,,,4,5,9
,2013,120600024,,,,57,46,103
,2013,120600025,,,,19,21,40
,2013,120600026,,,,33,35,68
,2013,120600027,,,,11,12,23
,2013,120600028,,,,7,5,12
,2013,120600030,,,,27,25,52
,2013,120600031,,,,10,10,20
,2013,120600032,,,,8,10,18
,2013,120600033,,,,43,32,75
,2013,120600034,,,,40,42,82
,2013,120600035,,,,37,24,61
,2013,120600037,,,,3,3,6
,2013,120600038,,,,22,21,43
,2013,120600038,,,,4,1,5
,2013,120600039,,,,2,3,5
,2013,120600039,,,,7,17,24
,2013,120600040,,,,23,15,38
,2013,120600041,,,,18,17,35
,2013,120600042,,,,2,7,9
,2013,120600043,,,,2,3,5
,2013,120600044,,,,8,3,11
,2013,120600045,,,,6,8,14
,2013,120600046,,,,6,5,11
,2013,120600047,,,,109,92,201
,2013,120600051,,,,23,15,38
,2013,120600054,,,,9,12,21
,2013,120600055,,,,3,7,10
,2013,120600056,,,,6,12,18
,2013,120600058,,,,16,2,18
,2013,120600061,,,,1,7,8
,2013,120600062,,,,8,3,11
,2013,120600063,,,,3,4,7
,2013,120600064,,,,3,2,5
,2013,120600065,,,,9,4,13
,2013,120600067,,,,4,5,9
,2013,120600068,,,,1,4,5
,2013,120600069,,,,99,92,191
,2013,120600069,,,,1,4,5
,2013,120600070,,,,64,81,145
,2013,120600071,,,,2,3,5
,2013,120600072,,,,3,7,10
,2013,120600073,,,,5,4,9
,2013,120600074,,,,2,4,6
,2013,120600076,,,,8,0,8
,2013,120600077,,,,5,1,6
,2013,120600078,,,,1,3,4
,2013,120600079,,,,6,8,14
,2013,120600080,,,,5,6,11
,2013,120600081,,,,3,3,6
,2013,120600082,,,,8,2,10
,2013,120600083,,,,9,10,19
,2013,120600084,,,,16,20,36
,2013,120600085,,,,3,1,4
,2013,120600086,,,,4,2,6
,2013,120600087,,,,3,3,6
,2013,120600088,,,,4,3,7
,2013,120600135,,,,5,4,9
,2013,120600136,,,,4,1,5
,2013,120600137,,,,1,4,5
,2013,120600152,,,,9,9,18
,2013,120600153,,,,3,3,6
,2013,120600154,,,,4,3,7
,2013,120700001,,,,81,79,160
,2013,120700002,,,,15,11,26
,2013,120700003,,,,25,21,46
,2013,120700004,,,,16,13,29
,2013,120700005,,,,47,40,87
,2013,120700006,,,,20,20,40
,2013,120700007,,,,9,6,15
,2013,120700008,,,,2,4,6
,2013,120700009,,,,7,6,13
,2013,120700010,,,,5,4,9
,2013,120700011,,,,11,10,21
,2013,120700012,,,,10,13,23
,2013,120700013,,,,3,6,9
,2013,120700027,,,,8,7,15
,2013,120700028,,,,5,4,9
,2013,120700029,,,,2,4,6
,2013,120700030,,,,1,6,7
,2013,120700031,,,,1,3,4
,2013,120800002,,,,28,29,57
,2013,120800002,,,,9,10,19
,2013,120800003,,,,7,5,12
,2013,120800003,,,,40,39,79
,2013,120800004,,,,117,103,220
,2013,120800005,,,,26,29,55
,2013,120800006,,,,308,294,602
,2013,120800007,,,,40,30,70
,2013,120800008,,,,273,270,543
,2013,120800009,,,,43,44,87
,2013,120800010,,,,2,4,6
,2013,120800010,,,,28,17,45
,2013,120800012,,,,17,12,29
,2013,120800012,,,,8,4,12
,2013,120800013,,,,33,39,72
,2013,120800014,,,,5,3,8
,2013,120800014,,,,15,17,32
,2013,120800015,,,,10,8,18
,2013,120800015,,,,23,25,48
,2013,120800016,,,,55,57,112
,2013,120800016,,,,11,10,21
,2013,120800017,,,,64,72,136
,2013,120800018,,,,132,118,250
,2013,120800019,,,,28,22,50
,2013,120800019,,,,5,6,11
,2013,120800020,,,,40,37,77
,2013,120800021,,,,35,34,69
,2013,120800022,,,,34,38,72
,2013,120800023,,,,37,27,64
,2013,120800024,,,,55,47,102
,2013,120800025,,,,29,37,66
,2013,120800026,,,,106,90,196
,2013,120800027,,,,17,17,34
,2013,120800028,,,,19,15,34
,2013,120800029,,,,33,29,62
,2013,120800030,,,,82,87,169
,2013,120800031,,,,32,24,56
,2013,120800032,,,,81,59,140
,2013,120800033,,,,5,6,11
,2013,120800033,,,,32,21,53
,2013,120800034,,,,17,26,43
,2013,120800035,,,,32,27,59
,2013,120800036,,,,22,28,50
,2013,120800037,,,,30,16,46
,2013,120800037,,,,11,6,17
,2013,120800038,,,,22,13,35
,2013,120800039,,,,57,68,125
,2013,120800039,,,,4,4,8
,2013,120800039,,,,46,35,81
,2013,120800040,,,,20,20,40
,2013,120800041,,,,4,3,7
,2013,120800041,,,,11,3,14
,2013,120800042,,,,11,10,21
,2013,120800042,,,,4,1,5
,2013,120800043,,,,29,19,48
,2013,120800043,,,,6,13,19
,2013,120800046,,,,25,19,44
,2013,120800048,,,,63,66,129
,2013,120800049,,,,13,11,24
,2013,120800050,,,,22,30,52
,2013,120800050,,,,9,7,16
,2013,120800052,,,,12,22,34
,2013,120800052,,,,34,51,85
,2013,120800052,,,,19,22,41
,2013,120800052,,,,28,17,45
,2013,120800054,,,,54,38,92
,2013,120800055,,,,8,5,13
,2013,120800056,,,,11,7,18
,2013,120800057,,,,13,12,25
,2013,120800057,,,,40,39,79
,2013,120800058,,,,9,10,19
,2013,120800059,,,,11,6,17
,2013,120800059,,,,10,13,23
,2013,120800060,,,,22,9,31
,2013,120800061,,,,20,13,33
,2013,120800062,,,,23,9,32
,2013,120800063,,,,36,36,72
,2013,120800064,,,,4,3,7
,2013,120800066,,,,32,26,58
,2013,120800066,,,,3,11,14
,2013,120800067,,,,31,32,63
,2013,120800069,,,,8,7,15
,2013,120800072,,,,4,7,11
,2013,120800075,,,,9,3,12
,2013,120800076,,,,6,8,14
,2013,120800077,,,,15,20,35
,2013,120800077,,,,7,7,14
,2013,120800078,,,,2,5,7
,2013,120800079,,,,9,4,13
,2013,120800080,,,,4,6,10
,2013,120800082,,,,3,3,6
,2013,120800083,,,,30,11,41
,2013,120800084,,,,5,8,13
,2013,120800085,,,,8,0,8
,2013,120800086,,,,9,4,13
,2013,120800087,,,,8,5,13
,2013,120800088,,,,5,6,11
,2013,120800089,,,,4,3,7
,2013,120800090,,,,7,4,11
,2013,120800091,,,,4,3,7
,2013,120800092,,,,12,6,18
,2013,120800093,,,,10,6,16
,2013,120800094,,,,5,5,10
,2013,120800096,,,,4,2,6
,2013,120800141,,,,13,12,25
,2013,120800142,,,,7,9,16
,2013,120800144,,,,3,7,10
,2013,120800148,,,,3,6,9
,2013,120800150,,,,23,15,38
,2013,120800150,,,,23,15,38
,2013,120800150,,,,29,22,51
,2013,120800151,,,,4,7,11
,2013,120800152,,,,3,1,4
,2013,120800153,,,,2,3,5
,2013,120800155,,,,9,4,13
,2013,120800156,,,,45,57,102
,2013,120800156,,,,8,11,19
,2013,120800156,,,,1,6,7
,2013,120800157,,,,15,15,30
,2013,120800158,,,,221,216,437
,2013,120800182,,,,234,358,592
,2013,120900001,,,,6,3,9
,2013,120900002,,,,38,41,79
,2013,120900003,,,,7,9,16
,2013,120900004,,,,3,6,9
,2013,120900005,,,,17,21,38
,2013,120900007,,,,8,5,13
,2013,120900008,,,,4,5,9
,2013,120900009,,,,6,6,12
,2013,120900010,,,,16,7,23
,2013,120900011,,,,10,9,19
,2013,120900012,,,,13,12,25
,2013,120900013,,,,6,4,10
,2013,120900014,,,,9,12,21
,2013,120900026,,,,6,7,13
,2013,121000001,,,,103,90,193
,2013,121000002,,,,34,27,61
,2013,121000003,,,,12,7,19
,2013,121000004,,,,94,82,176
,2013,121000005,,,,25,22,47
,2013,121000006,,,,20,25,45
,2013,121000007,,,,21,14,35
,2013,121000008,,,,39,30,69
,2013,121000009,,,,93,93,186
,2013,121000010,,,,23,18,41
,2013,121000011,,,,27,38,65
,2013,121000012,,,,17,24,41
,2013,121000013,,,,16,19,35
,2013,121000014,,,,10,9,19
,2013,121000016,,,,26,21,47
,2013,121000017,,,,13,7,20
,2013,121000018,,,,50,48,98
,2013,121000018,,,,2,4,6
,2013,121000019,,,,10,10,20
,2013,121000020,,,,11,13,24
,2013,121000021,,,,6,9,15
,2013,121000022,,,,28,30,58
,2013,121000023,,,,4,1,5
,2013,121000024,,,,5,6,11
,2013,121000025,,,,12,9,21
,2013,121000026,,,,16,11,27
,2013,121000027,,,,180,117,297
,2013,121000028,,,,7,13,20
,2013,121000029,,,,13,14,27
,2013,121000030,,,,4,7,11
,2013,121000031,,,,8,10,18
,2013,121000032,,,,5,3,8
,2013,121000033,,,,8,4,12
,2013,121000034,,,,3,3,6
,2013,121000035,,,,2,14,16
,2013,121000037,,,,5,5,10
,2013,121000038,,,,5,7,12
,2013,121000038,,,,29,38,67
,2013,121000039,,,,4,6,10
,2013,121000040,,,,4,2,6
,2013,121000041,,,,5,6,11
,2013,121000042,,,,4,2,6
,2013,121000043,,,,5,2,7
,2013,121000045,,,,7,4,11
,2013,121000047,,,,0,4,4
,2013,121000048,,,,5,5,10
,2013,121000049,,,,2,4,6
,2013,121000068,,,,5,2,7
,2013,121000084,,,,5,2,7
,2013,121000085,,,,3,3,6
,2013,121000086,,,,4,3,7
,2013,121000087,,,,4,4,8
,2013,121100001,,,,64,76,140
,2013,121100002,,,,7,3,10
,2013,121100003,,,,6,3,9
,2013,121100004,,,,2,3,5
,2013,121100005,,,,5,6,11
,2013,121100006,,,,9,6,15
,2013,121100007,,,,15,18,33
,2013,121100008,,,,18,10,28
,2013,121100009,,,,16,16,32
,2013,121100010,,,,5,6,11
,2013,121100011,,,,7,8,15
,2013,121100012,,,,6,8,14
,2013,121100013,,,,7,10,17
,2013,121100014,,,,24,21,45
,2013,121100015,,,,97,86,183
,2013,121100028,,,,3,3,6
,2013,121100029,,,,5,3,8
,2013,121100030,,,,3,2,5
,2013,121100031,,,,3,4,7
,2013,121100032,,,,19,21,40
,2013,121200001,,,,31,29,60
,2013,121200002,,,,2,4,6
,2013,121200002,,,,14,14,28
,2013,121200003,,,,53,52,105
,2013,121200003,,,,9,17,26
,2013,121200004,,,,16,15,31
,2013,121200005,,,,163,134,297
,2013,121200006,,,,89,93,182
,2013,121200007,,,,33,45,78
,2013,121200008,,,,27,22,49
,2013,121200009,,,,38,21,59
,2013,121200010,,,,108,98,206
,2013,121200011,,,,39,42,81
,2013,121200012,,,,27,23,50
,2013,121200013,,,,29,28,57
,2013,121200014,,,,14,16,30
,2013,121200015,,,,24,20,44
,2013,121200016,,,,71,42,113
,2013,121200017,,,,42,43,85
,2013,121200017,,,,11,8,19
,2013,121200018,,,,35,33,68
,2013,121200018,,,,6,9,15
,2013,121200019,,,,11,11,22
,2013,121200019,,,,44,36,80
,2013,121200020,,,,11,7,18
,2013,121200021,,,,15,7,22
,2013,121200022,,,,11,12,23
,2013,121200023,,,,17,15,32
,2013,121200024,,,,133,124,257
,2013,121200027,,,,3,5,8
,2013,121200029,,,,8,5,13
,2013,121200030,,,,5,7,12
,2013,121200031,,,,5,6,11
,2013,121200032,,,,5,9,14
,2013,121200033,,,,20,13,33
,2013,121200034,,,,7,2,9
,2013,121200035,,,,4,4,8
,2013,121200036,,,,5,5,10
,2013,121200039,,,,3,8,11
,2013,121200076,,,,217,258,475
,2013,121300001,,,,67,46,113
,2013,121300002,,,,92,90,182
,2013,121300003,,,,39,43,82
,2013,121300004,,,,18,15,33
,2013,121300005,,,,13,22,35
,2013,121300006,,,,14,9,23
,2013,121300007,,,,13,10,23
,2013,121300008,,,,5,6,11
,2013,121300009,,,,9,9,18
,2013,121300010,,,,6,11,17
,2013,121300021,,,,3,8,11
,2013,121300022,,,,2,2,4
,2013,121300023,,,,8,1,9
,2013,121400003,,,,173,132,305
,2013,121400004,,,,41,48,89
,2013,121400005,,,,38,27,65
,2013,121400006,,,,57,37,94
,2013,121400007,,,,46,34,80
,2013,121400008,,,,29,18,47
,2013,121400009,,,,31,24,55
,2013,121400010,,,,31,26,57
,2013,121400011,,,,7,13,20
,2013,121400012,,,,151,82,233
,2013,121400013,,,,6,1,7
,2013,121400014,,,,11,5,16
,2013,121400015,,,,44,26,70
,2013,121400016,,,,6,17,23
,2013,121400018,,,,7,9,16
,2013,121400021,,,,9,7,16
,2013,121400022,,,,63,63,126
,2013,121400023,,,,2,4,6
,2013,121400024,,,,10,10,20
,2013,121400026,,,,3,1,4
,2013,121400047,,,,6,8,14
,2013,121400048,,,,4,4,8
,2013,121400048,,,,14,9,23
,2013,121400051,,,,4,3,7
,2013,121400052,,,,3,3,6
,2013,121400053,,,,8,2,10
,2013,121400054,,,,115,108,223
,2013,121500001,,,,4,5,9
,2013,121500003,,,,3,6,9
,2013,121500004,,,,76,73,149
,2013,121500005,,,,99,115,214
,2013,121500006,,,,15,20,35
,2013,121500007,,,,85,79,164
,2013,121500008,,,,145,138,283
,2013,121500009,,,,94,88,182
,2013,121500010,,,,28,28,56
,2013,121500011,,,,10,24,34
,2013,121500012,,,,35,33,68
,2013,121500013,,,,31,43,74
,2013,121500014,,,,9,10,19
,2013,121500015,,,,82,61,143
,2013,121500016,,,,8,10,18
,2013,121500017,,,,44,27,71
,2013,121500018,,,,64,63,127
,2013,121500019,,,,12,10,22
,2013,121500020,,,,8,9,17
,2013,121500021,,,,19,12,31
,2013,121500022,,,,49,37,86
,2013,121500023,,,,2,3,5
,2013,121500023,,,,5,15,20
,2013,121500024,,,,14,13,27
,2013,121500025,,,,21,22,43
,2013,121500026,,,,16,12,28
,2013,121500027,,,,15,8,23
,2013,121500028,,,,21,12,33
,2013,121500029,,,,29,18,47
,2013,121500030,,,,23,28,51
,2013,121500031,,,,7,12,19
,2013,121500032,,,,15,9,24
,2013,121500034,,,,11,4,15
,2013,121500035,,,,21,20,41
,2013,121500036,,,,6,9,15
,2013,121500037,,,,16,8,24
,2013,121500038,,,,19,11,30
,2013,121500040,,,,6,9,15
,2013,121500041,,,,8,14,22
,2013,121500042,,,,4,15,19
,2013,121500043,,,,19,22,41
,2013,121500044,,,,4,5,9
,2013,121500045,,,,4,1,5
,2013,121500046,,,,5,6,11
,2013,121500047,,,,5,6,11
,2013,121500048,,,,1,5,6
,2013,121500049,,,,15,6,21
,2013,121500051,,,,12,6,18
,2013,121500061,,,,1,8,9
,2013,121500066,,,,5,6,11
,2013,121500067,,,,9,10,19
,2013,121500068,,,,1,4,5
,2013,121500069,,,,3,3,6
,2013,121500070,,,,5,5,10
,2013,121500071,,,,2,4,6
,2013,121500072,,,,7,9,16
,2013,121500073,,,,2,3,5
,2013,121500074,,,,20,18,38
,2013,121500075,,,,0,5,5
,2013,121500076,,,,7,7,14
,2013,121500077,,,,23,25,48
,2013,121500078,,,,1,5,6
,2013,121500079,,,,5,1,6
,2013,121500080,,,,9,7,16
,2013,121500081,,,,9,12,21
,2013,121500082,,,,12,13,25
,2013,121500083,,,,25,35,60
,2013,121500084,,,,41,52,93
,2013,121600001,,,,10,3,13
,2013,121600004,,,,75,75,150
,2013,121600005,,,,31,31,62
,2013,121600006,,,,77,81,158
,2013,121600007,,,,34,28,62
,2013,121600008,,,,37,43,80
,2013,121600009,,,,53,52,105
,2013,121600010,,,,31,17,48
,2013,121600011,,,,61,43,104
,2013,121600012,,,,17,23,40
,2013,121600013,,,,16,12,28
,2013,121600014,,,,37,30,67
,2013,121600015,,,,14,9,23
,2013,121600016,,,,28,28,56
,2013,121600017,,,,22,15,37
,2013,121600018,,,,33,13,46
,2013,121600019,,,,95,116,211
,2013,121600020,,,,45,33,78
,2013,121600021,,,,12,13,25
,2013,121600022,,,,29,24,53
,2013,121600023,,,,29,20,49
,2013,121600024,,,,28,20,48
,2013,121600025,,,,41,40,81
,2013,121600026,,,,18,26,44
,2013,121600027,,,,26,39,65
,2013,121600028,,,,23,20,43
,2013,121600029,,,,20,22,42
,2013,121600030,,,,21,21,42
,2013,121600031,,,,26,19,45
,2013,121600032,,,,10,5,15
,2013,121600033,,,,12,15,27
,2013,121600034,,,,15,6,21
,2013,121600035,,,,12,16,28
,2013,121600036,,,,41,35,76
,2013,121600037,,,,9,5,14
,2013,121600038,,,,3,7,10
,2013,121600039,,,,11,12,23
,2013,121600039,,,,11,12,23
,2013,121600040,,,,17,10,27
,2013,121600041,,,,14,12,26
,2013,121600042,,,,44,43,87
,2013,121600043,,,,10,3,13
,2013,121600044,,,,8,9,17
,2013,121600045,,,,11,10,21
,2013,121600046,,,,12,3,15
,2013,121600048,,,,6,4,10
,2013,121600049,,,,6,5,11
,2013,121600050,,,,22,32,54
,2013,121600051,,,,15,17,32
,2013,121600052,,,,21,18,39
,2013,121600054,,,,5,3,8
,2013,121600055,,,,4,3,7
,2013,121600057,,,,6,5,11
,2013,121600059,,,,3,9,12
,2013,121600060,,,,5,4,9
,2013,121600061,,,,8,3,11
,2013,121600062,,,,3,9,12
,2013,121600065,,,,1,7,8
,2013,121600067,,,,4,4,8
,2013,121600068,,,,6,9,15
,2013,121600069,,,,5,5,10
,2013,121600070,,,,8,8,16
,2013,121600071,,,,5,8,13
,2013,121600073,,,,25,20,45
,2013,121600127,,,,23,22,45
,2013,121600128,,,,8,7,15
,2013,121600129,,,,2,4,6
,2013,121600130,,,,6,2,8
,2013,121600131,,,,2,4,6
,2013,121600132,,,,2,4,6
,2013,121600133,,,,4,5,9
,2013,121600159,,,,98,73,171
,2013,121600160,,,,6,9,15
,2013,121600161,,,,2,2,4
,2013,121600162,,,,5,7,12
,2013,121600164,,,,10,4,14
,2013,121600165,,,,2,6,8
,2013,121600167,,,,5,7,12
,2013,121600168,,,,6,2,8
,2013,121600169,,,,390,272,662
,2013,121600170,,,,9,15,24
,2013,121600171,,,,6,10,16
,2013,121600172,,,,12,14,26
,2013,121600173,,,,6,2,8
,2013,121600174,,,,7,6,13
,2013,121600175,,,,8,3,11
,2013,121700001,,,,7,19,26
,2013,121700002,,,,23,33,56
,2013,121700003,,,,57,55,112
,2013,121700004,,,,26,24,50
,2013,121700005,,,,62,71,133
,2013,121700006,,,,29,21,50
,2013,121700007,,,,47,39,86
,2013,121700008,,,,31,21,52
,2013,121700008,,,,4,6,10
,2013,121700009,,,,204,205,409
,2013,121700010,,,,8,17,25
,2013,121700010,,,,2,2,4
,2013,121700011,,,,124,116,240
,2013,121700012,,,,10,9,19
,2013,121700014,,,,21,20,41
,2013,121700015,,,,75,85,160
,2013,121700016,,,,32,24,56
,2013,121700017,,,,19,36,55
,2013,121700018,,,,42,44,86
,2013,121700018,,,,13,10,23
,2013,121700019,,,,30,24,54
,2013,121700020,,,,35,27,62
,2013,121700021,,,,21,19,40
,2013,121700022,,,,32,25,57
,2013,121700022,,,,18,12,30
,2013,121700023,,,,8,10,18
,2013,121700024,,,,40,45,85
,2013,121700025,,,,10,13,23
,2013,121700026,,,,23,31,54
,2013,121700026,,,,9,0,9
,2013,121700027,,,,45,29,74
,2013,121700028,,,,22,11,33
,2013,121700029,,,,10,12,22
,2013,121700030,,,,12,12,24
,2013,121700035,,,,14,13,27
,2013,121700035,,,,14,13,27
,2013,121700037,,,,12,7,19
,2013,121700038,,,,10,12,22
,2013,121700039,,,,5,6,11
,2013,121700042,,,,7,5,12
,2013,121700044,,,,5,3,8
,2013,121700045,,,,12,7,19
,2013,121700047,,,,26,38,64
,2013,121700049,,,,6,4,10
,2013,121700052,,,,31,15,46
,2013,121700054,,,,13,12,25
,2013,121700054,,,,6,10,16
,2013,121700055,,,,5,4,9
,2013,121700084,,,,42,32,74
,2013,121700085,,,,13,8,21
,2013,121700089,,,,34,29,63
,2013,121700089,,,,8,7,15
,2013,121700091,,,,4,3,7
,2013,121700092,,,,10,1,11
,2013,121700094,,,,4,5,9
,2013,121700095,,,,5,3,8
,2013,121700096,,,,2,7,9
,2013,121700097,,,,3,2,5
,2013,121700106,,,,2,3,5
,2013,121700107,,,,4,0,4
,2013,121700108,,,,2,3,5
,2013,121700109,,,,3,1,4
,2013,121700110,,,,8,5,13
,2013,121700111,,,,16,9,25
,2013,121700113,,,,6,4,10
,2013,121700114,,,,20,23,43
,2013,121700115,,,,2,2,4
,2013,121700117,,,,93,58,151
,2013,121800002,,,,9,10,19
,2013,121800003,,,,14,9,23
,2013,121800004,,,,4,9,13
,2013,121800005,,,,8,4,12
,2013,121800027,,,,10,12,22
,2013,121800037,,,,75,64,139
,2013,121800038,,,,32,17,49
,2013,121800039,,,,18,22,40
,2013,121800040,,,,168,137,305
,2013,121800041,,,,15,15,30
,2013,121800042,,,,60,45,105
,2013,121800044,,,,22,19,41
,2013,121800045,,,,70,62,132
,2013,121800046,,,,123,106,229
,2013,121800047,,,,59,39,98
,2013,121800048,,,,81,86,167
,2013,121800049,,,,44,43,87
,2013,121800050,,,,78,67,145
,2013,121800051,,,,58,84,142
,2013,121800052,,,,54,41,95
,2013,121800053,,,,59,54,113
,2013,121800054,,,,53,40,93
,2013,121800055,,,,23,24,47
,2013,121800056,,,,12,11,23
,2013,121800057,,,,28,25,53
,2013,121800058,,,,35,36,71
,2013,121800059,,,,61,51,112
,2013,121800060,,,,10,7,17
,2013,121800061,,,,24,26,50
,2013,121800063,,,,23,23,46
,2013,121800064,,,,29,21,50
,2013,121800065,,,,5,10,15
,2013,121800066,,,,57,55,112
,2013,121800067,,,,41,35,76
,2013,121800068,,,,18,14,32
,2013,121800069,,,,7,8,15
,2013,121800070,,,,9,9,18
,2013,121800071,,,,185,197,382
,2013,121800071,,,,23,40,63
,2013,121800073,,,,5,5,10
,2013,121800076,,,,27,16,43
,2013,121800080,,,,44,52,96
,2013,121800081,,,,7,8,15
,2013,121800082,,,,9,9,18
,2013,121800083,,,,6,5,11
,2013,121800084,,,,8,11,19
,2013,121800085,,,,17,16,33
,2013,121800086,,,,12,8,20
,2013,121800088,,,,6,4,10
,2013,121800089,,,,5,4,9
,2013,121800090,,,,1,9,10
,2013,121800091,,,,15,12,27
,2013,121800092,,,,10,11,21
,2013,121800094,,,,18,13,31
,2013,121800115,,,,13,6,19
,2013,121800150,,,,6,9,15
,2013,121800161,,,,20,13,33
,2013,121800175,,,,1,4,5
,2013,121800176,,,,3,7,10
,2013,121800177,,,,5,2,7
,2013,121800178,,,,15,9,24
,2013,121800181,,,,1,7,8
,2013,121800182,,,,6,14,20
,2013,121800184,,,,29,35,64
,2013,121800185,,,,10,12,22
,2013,121800186,,,,3,6,9
,2013,121900001,,,,75,57,132
,2013,121900002,,,,102,85,187
,2013,121900003,,,,76,76,152
,2013,121900004,,,,65,64,129
,2013,121900005,,,,92,95,187
,2013,121900006,,,,87,73,160
,2013,121900007,,,,27,29,56
,2013,121900008,,,,57,44,101
,2013,121900008,,,,17,9,26
,2013,121900009,,,,14,11,25
,2013,121900010,,,,24,20,44
,2013,121900011,,,,17,17,34
,2013,121900012,,,,5,5,10
,2013,121900012,,,,31,22,53
,2013,121900013,,,,21,16,37
,2013,121900014,,,,11,10,21
,2013,121900014,,,,2,2,4
,2013,121900015,,,,32,18,50
,2013,121900016,,,,9,7,16
,2013,121900017,,,,20,31,51
,2013,121900018,,,,11,8,19
,2013,121900019,,,,137,121,258
,2013,121900020,,,,10,11,21
,2013,121900021,,,,10,5,15
,2013,121900023,,,,7,4,11
,2013,121900024,,,,4,3,7
,2013,121900025,,,,4,4,8
,2013,121900026,,,,3,1,4
,2013,121900027,,,,2,6,8
,2013,121900028,,,,3,2,5
,2013,121900029,,,,7,8,15
,2013,121900030,,,,2,3,5
,2013,121900030,,,,11,7,18
,2013,121900031,,,,45,32,77
,2013,121900032,,,,22,17,39
,2013,121900033,,,,21,29,50
,2013,121900034,,,,25,17,42
,2013,121900035,,,,20,21,41
,2013,121900036,,,,8,8,16
,2013,121900037,,,,15,11,26
,2013,121900038,,,,7,10,17
,2013,121900042,,,,2,4,6
,2013,121900067,,,,4,5,9
,2013,121900068,,,,5,3,8
,2013,121900070,,,,1,6,7
,2013,121900070,,,,12,9,21
,2013,130100001,,,,48,29,77
,2013,130100002,,,,123,126,249
,2013,130100003,,,,284,352,636
,2013,130100004,,,,106,109,215
,2013,130100005,,,,55,67,122
,2013,130100006,,,,67,77,144
,2013,130100007,,,,68,61,129
,2013,130100008,,,,81,72,153
,2013,130100009,,,,116,120,236
,2013,130100010,,,,94,94,188
,2013,130100011,,,,73,73,146
,2013,130100012,,,,57,40,97
,2013,130100013,,,,34,34,68
,2013,130100014,,,,84,88,172
,2013,130100015,,,,88,71,159
,2013,130100016,,,,35,52,87
,2013,130100017,,,,25,35,60
,2013,130100018,,,,72,48,120
,2013,130100019,,,,57,48,105
,2013,130100020,,,,36,30,66
,2013,130100021,,,,32,33,65
,2013,130100022,,,,62,43,105
,2013,130100023,,,,54,34,88
,2013,130100024,,,,52,57,109
,2013,130100025,,,,42,41,83
,2013,130100026,,,,134,138,272
,2013,130100027,,,,52,22,74
,2013,130100028,,,,25,13,38
,2013,130100029,,,,31,31,62
,2013,130100030,,,,70,71,141
,2013,130100031,,,,46,49,95
,2013,130100032,,,,32,32,64
,2013,130100033,,,,60,54,114
,2013,130100034,,,,48,39,87
,2013,130100035,,,,18,22,40
,2013,130100036,,,,70,66,136
,2013,130100038,,,,12,11,23
,2013,130100039,,,,24,18,42
,2013,130100040,,,,79,62,141
,2013,130100041,,,,33,42,75
,2013,130100041,,,,17,15,32
,2013,130100042,,,,626,624,1250
,2013,130100044,,,,8,5,13
,2013,130100045,,,,52,55,107
,2013,130100047,,,,81,81,162
,2013,130100048,,,,39,23,62
,2013,130100049,,,,104,113,217
,2013,130100051,,,,14,15,29
,2013,130100052,,,,57,52,109
,2013,130100053,,,,37,43,80
,2013,130100055,,,,21,14,35
,2013,130100056,,,,59,49,108
,2013,130100059,,,,26,18,44
,2013,130100060,,,,24,29,53
,2013,130100063,,,,24,22,46
,2013,130100065,,,,33,33,66
,2013,130100066,,,,11,11,22
,2013,130100067,,,,12,10,22
,2013,130100068,,,,17,8,25
,2013,130100069,,,,24,19,43
,2013,130100070,,,,30,34,64
,2013,130100071,,,,13,8,21
,2013,130100072,,,,21,31,52
,2013,130100072,,,,532,454,986
,2013,130100073,,,,17,24,41
,2013,130100074,,,,24,25,49
,2013,130100075,,,,17,13,30
,2013,130100076,,,,9,18,27
,2013,130100077,,,,17,9,26
,2013,130100078,,,,48,51,99
,2013,130100079,,,,9,8,17
,2013,130100080,,,,27,31,58
,2013,130100084,,,,6,4,10
,2013,130100085,,,,3,4,7
,2013,130100085,,,,62,59,121
,2013,130100086,,,,105,94,199
,2013,130100087,,,,436,664,1100
,2013,130100089,,,,67,34,101
,2013,130100090,,,,16,22,38
,2013,130100092,,,,32,20,52
,2013,130100093,,,,6,11,17
,2013,130100094,,,,12,6,18
,2013,130100096,,,,14,8,22
,2013,130100098,,,,9,9,18
,2013,130100099,,,,11,4,15
,2013,130100100,,,,14,13,27
,2013,130100101,,,,9,6,15
,2013,130100102,,,,18,18,36
,2013,130100103,,,,17,21,38
,2013,130100104,,,,31,29,60
,2013,130100106,,,,51,53,104
,2013,130100107,,,,8,8,16
,2013,130100108,,,,18,23,41
,2013,130100110,,,,18,10,28
,2013,130100111,,,,4,8,12
,2013,130100112,,,,10,11,21
,2013,130100113,,,,10,4,14
,2013,130100113,,,,18,30,48
,2013,130100115,,,,8,16,24
,2013,130100116,,,,15,15,30
,2013,130100117,,,,9,16,25
,2013,130100118,,,,12,7,19
,2013,130100119,,,,49,31,80
,2013,130100119,,,,43,59,102
,2013,130100119,,,,81,81,162
,2013,130100120,,,,9,13,22
,2013,130100201,,,,17,15,32
,2013,130100202,,,,13,21,34
,2013,130100204,,,,34,30,64
,2013,130100205,,,,23,20,43
,2013,130100206,,,,23,14,37
,2013,130100207,,,,7,3,10
,2013,130100208,,,,3,3,6
,2013,130100209,,,,8,14,22
,2013,130100211,,,,8,6,14
,2013,130100212,,,,3,2,5
,2013,130100213,,,,6,7,13
,2013,130100214,,,,5,5,10
,2013,130100215,,,,8,13,21
,2013,130100216,,,,5,6,11
,2013,130100218,,,,2,5,7
,2013,130100221,,,,92,101,193
,2013,130100241,,,,20,14,34
,2013,130100243,,,,11,11,22
,2013,130100244,,,,10,4,14
,2013,130100245,,,,7,5,12
,2013,130100246,,,,10,22,32
,2013,130100248,,,,4,4,8
,2013,130100249,,,,4,4,8
,2013,130100250,,,,34,30,64
,2013,130100250,,,,67,78,145
,2013,130100250,,,,70,62,132
,2013,130100251,,,,9,7,16
,2013,130100253,,,,3,3,6
,2013,130100254,,,,5,3,8
,2013,130200002,,,,56,51,107
,2013,130200003,,,,27,40,67
,2013,130200004,,,,38,28,66
,2013,130200005,,,,35,27,62
,2013,130200006,,,,45,33,78
,2013,130200007,,,,29,44,73
,2013,130200009,,,,10,14,24
,2013,130200010,,,,53,48,101
,2013,130200011,,,,28,24,52
,2013,130200012,,,,26,28,54
,2013,130200013,,,,12,16,28
,2013,130200014,,,,9,11,20
,2013,130200026,,,,6,14,20
,2013,130200029,,,,19,17,36
,2013,130200030,,,,25,25,50
,2013,130200031,,,,29,23,52
,2013,130200033,,,,14,11,25
,2013,130200034,,,,7,8,15
,2013,130200035,,,,24,17,41
,2013,130200037,,,,7,7,14
,2013,130200038,,,,25,19,44
,2013,130200043,,,,4,6,10
,2013,130200058,,,,19,23,42
,2013,130200059,,,,14,16,30
,2013,130200060,,,,9,11,20
,2013,130200061,,,,11,9,20
,2013,130200062,,,,5,2,7
,2013,130200065,,,,4,5,9
,2013,130200066,,,,8,8,16
,2013,130200069,,,,7,8,15
,2013,130300001,,,,77,88,165
,2013,130300002,,,,41,56,97
,2013,130300003,,,,63,50,113
,2013,130300004,,,,136,127,263
,2013,130300005,,,,15,20,35
,2013,130300006,,,,29,24,53
,2013,130300007,,,,20,19,39
,2013,130300008,,,,105,89,194
,2013,130300009,,,,30,27,57
,2013,130300010,,,,11,18,29
,2013,130300011,,,,14,14,28
,2013,130300012,,,,14,12,26
,2013,130300013,,,,23,35,58
,2013,130300014,,,,22,31,53
,2013,130300015,,,,17,10,27
,2013,130300016,,,,33,20,53
,2013,130300017,,,,24,34,58
,2013,130300018,,,,129,146,275
,2013,130300019,,,,14,27,41
,2013,130300020,,,,17,11,28
,2013,130300021,,,,12,8,20
,2013,130300022,,,,13,10,23
,2013,130300023,,,,11,10,21
,2013,130300024,,,,12,11,23
,2013,130300025,,,,7,11,18
,2013,130300027,,,,7,5,12
,2013,130300029,,,,6,7,13
,2013,130300030,,,,16,12,28
,2013,130300031,,,,14,10,24
,2013,130300032,,,,11,11,22
,2013,130300033,,,,21,12,33
,2013,130300036,,,,16,18,34
,2013,130300038,,,,8,10,18
,2013,130300046,,,,5,11,16
,2013,130300051,,,,6,4,10
,2013,130300053,,,,1,2,3
,2013,130300065,,,,5,4,9
,2013,130300066,,,,2,3,5
,2013,130300068,,,,2,4,6
,2013,130300069,,,,5,7,12
,2013,130300070,,,,4,2,6
,2013,130300084,,,,15,12,27
,2013,130300085,,,,16,17,33
,2013,130300086,,,,12,5,17
,2013,130300087,,,,2,6,8
,2013,130300088,,,,3,3,6
,2013,130300089,,,,6,3,9
,2013,130300090,,,,7,15,22
,2013,130400001,,,,125,145,270
,2013,130400002,,,,42,37,79
,2013,130400003,,,,30,27,57
,2013,130400004,,,,9,12,21
,2013,130400005,,,,63,65,128
,2013,130400006,,,,35,36,71
,2013,130400007,,,,31,25,56
,2013,130400008,,,,16,23,39
,2013,130400009,,,,16,20,36
,2013,130400010,,,,11,10,21
,2013,130400011,,,,29,28,57
,2013,130400013,,,,3,2,5
,2013,130400016,,,,18,20,38
,2013,130400018,,,,15,16,31
,2013,130400019,,,,22,23,45
,2013,130400019,,,,3,2,5
,2013,130400021,,,,14,6,20
,2013,130400022,,,,6,11,17
,2013,130400023,,,,6,8,14
,2013,130400024,,,,12,19,31
,2013,130400025,,,,8,13,21
,2013,130400026,,,,8,9,17
,2013,130400027,,,,14,17,31
,2013,130400028,,,,14,11,25
,2013,130400029,,,,19,20,39
,2013,130400030,,,,5,3,8
,2013,130400031,,,,1,4,5
,2013,130400032,,,,3,2,5
,2013,130400048,,,,17,15,32
,2013,130400049,,,,7,10,17
,2013,130400050,,,,12,12,24
,2013,130400052,,,,3,6,9
,2013,130400055,,,,5,3,8
,2013,130500001,,,,100,83,183
,2013,130500002,,,,125,110,235
,2013,130500003,,,,55,65,120
,2013,130500004,,,,37,25,62
,2013,130500005,,,,34,30,64
,2013,130500006,,,,74,68,142
,2013,130500007,,,,59,62,121
,2013,130500008,,,,43,30,73
,2013,130500009,,,,117,112,229
,2013,130500010,,,,41,40,81
,2013,130500011,,,,35,35,70
,2013,130500012,,,,17,22,39
,2013,130500013,,,,35,24,59
,2013,130500014,,,,31,37,68
,2013,130500015,,,,50,43,93
,2013,130500016,,,,49,46,95
,2013,130500017,,,,71,71,142
,2013,130500018,,,,48,38,86
,2013,130500019,,,,37,23,60
,2013,130500019,,,,5,5,10
,2013,130500020,,,,10,13,23
,2013,130500021,,,,142,165,307
,2013,130500022,,,,29,22,51
,2013,130500023,,,,13,11,24
,2013,130500024,,,,30,20,50
,2013,130500025,,,,8,11,19
,2013,130500026,,,,12,6,18
,2013,130500027,,,,29,28,57
,2013,130500028,,,,8,13,21
,2013,130500029,,,,57,69,126
,2013,130500030,,,,8,14,22
,2013,130500031,,,,8,8,16
,2013,130500032,,,,8,7,15
,2013,130500034,,,,34,31,65
,2013,130500035,,,,34,15,49
,2013,130500036,,,,19,19,38
,2013,130500037,,,,21,27,48
,2013,130500038,,,,11,4,15
,2013,130500039,,,,12,11,23
,2013,130500040,,,,15,20,35
,2013,130500041,,,,8,11,19
,2013,130500042,,,,39,50,89
,2013,130500043,,,,15,15,30
,2013,130500044,,,,20,22,42
,2013,130500045,,,,40,41,81
,2013,130500047,,,,13,30,43
,2013,130500048,,,,41,44,85
,2013,130500048,,,,8,14,22
,2013,130500049,,,,39,42,81
,2013,130500050,,,,16,14,30
,2013,130500051,,,,6,7,13
,2013,130500052,,,,8,5,13
,2013,130500053,,,,9,8,17
,2013,130500054,,,,58,38,96
,2013,130500055,,,,5,9,14
,2013,130500057,,,,6,8,14
,2013,130500060,,,,3,4,7
,2013,130500062,,,,13,14,27
,2013,130500063,,,,24,18,42
,2013,130500064,,,,6,9,15
,2013,130500065,,,,5,8,13
,2013,130500068,,,,8,1,9
,2013,130500138,,,,24,10,34
,2013,130500139,,,,11,22,33
,2013,130500140,,,,8,4,12
,2013,130500141,,,,9,11,20
,2013,130500142,,,,19,13,32
,2013,130500143,,,,12,3,15
,2013,130500144,,,,6,4,10
,2013,130500146,,,,4,5,9
,2013,130500148,,,,8,4,12
,2013,130500149,,,,4,7,11
,2013,130500150,,,,8,6,14
,2013,130500165,,,,12,18,30
,2013,130500166,,,,6,12,18
,2013,130500167,,,,8,8,16
,2013,130500168,,,,6,6,12
,2013,130500169,,,,17,18,35
,2013,130500170,,,,13,7,20
,2013,130500172,,,,17,11,28
,2013,130500173,,,,16,9,25
,2013,130500174,,,,3,2,5
,2013,130500175,,,,5,6,11
,2013,130500177,,,,5,3,8
,2013,130500178,,,,5,6,11
,2013,130500180,,,,2,9,11
,2013,130500181,,,,5,6,11
,2013,130500183,,,,6,9,15
,2013,130600001,,,,168,181,349
,2013,130600002,,,,85,69,154
,2013,130600003,,,,79,74,153
,2013,130600004,,,,21,22,43
,2013,130600005,,,,58,48,106
,2013,130600006,,,,66,55,121
,2013,130600007,,,,113,130,243
,2013,130600007,,,,13,11,24
,2013,130600008,,,,43,41,84
,2013,130600009,,,,14,11,25
,2013,130600010,,,,41,40,81
,2013,130600011,,,,34,36,70
,2013,130600012,,,,69,67,136
,2013,130600013,,,,23,26,49
,2013,130600014,,,,33,30,63
,2013,130600015,,,,10,14,24
,2013,130600016,,,,15,11,26
,2013,130600017,,,,16,17,33
,2013,130600018,,,,18,26,44
,2013,130600019,,,,48,35,83
,2013,130600020,,,,9,12,21
,2013,130600021,,,,10,13,23
,2013,130600022,,,,39,30,69
,2013,130600023,,,,41,40,81
,2013,130600024,,,,20,13,33
,2013,130600025,,,,17,19,36
,2013,130600026,,,,33,22,55
,2013,130600027,,,,13,14,27
,2013,130600028,,,,8,13,21
,2013,130600029,,,,12,17,29
,2013,130600031,,,,7,12,19
,2013,130600032,,,,6,3,9
,2013,130600038,,,,20,26,46
,2013,130600044,,,,7,6,13
,2013,130600051,,,,10,5,15
,2013,130600051,,,,17,18,35
,2013,130600053,,,,28,22,50
,2013,130600089,,,,8,7,15
,2013,130600092,,,,12,6,18
,2013,130600094,,,,8,9,17
,2013,130600095,,,,4,3,7
,2013,130600096,,,,11,6,17
,2013,130600097,,,,3,5,8
,2013,130600099,,,,5,2,7
,2013,130600100,,,,8,8,16
,2013,130600105,,,,4,4,8
,2013,130600113,,,,23,32,55
,2013,130600114,,,,28,19,47
,2013,130600114,,,,8,8,16
,2013,130600115,,,,13,13,26
,2013,130600116,,,,6,15,21
,2013,130600118,,,,8,16,24
,2013,130600121,,,,7,8,15
,2013,130600122,,,,8,9,17
,2013,130600124,,,,7,6,13
,2013,130600125,,,,2,9,11
,2013,130600125,,,,2,8,10
,2013,130600126,,,,6,6,12
,2013,130600127,,,,3,5,8
,2013,130600128,,,,10,6,16
,2013,130600129,,,,5,3,8
,2013,130600130,,,,8,2,10
,2013,130600131,,,,5,5,10
,2013,130600131,,,,7,9,16
,2013,130600132,,,,5,5,10
,2013,130600134,,,,4,4,8
,2013,130700001,,,,31,35,66
,2013,130700002,,,,20,16,36
,2013,130700003,,,,37,27,64
,2013,130700004,,,,17,11,28
,2013,130700005,,,,16,16,32
,2013,130700006,,,,50,59,109
,2013,130700007,,,,13,18,31
,2013,130700008,,,,95,86,181
,2013,130700009,,,,17,14,31
,2013,130700010,,,,49,46,95
,2013,130700011,,,,15,15,30
,2013,130700012,,,,11,10,21
,2013,130700013,,,,19,30,49
,2013,130700014,,,,13,22,35
,2013,130700015,,,,5,15,20
,2013,130700016,,,,56,57,113
,2013,130700017,,,,6,7,13
,2013,130700018,,,,20,21,41
,2013,130700019,,,,26,11,37
,2013,130700020,,,,36,22,58
,2013,130700021,,,,33,29,62
,2013,130700022,,,,13,15,28
,2013,130700023,,,,16,21,37
,2013,130700024,,,,11,9,20
,2013,130700025,,,,20,15,35
,2013,130700026,,,,18,18,36
,2013,130700027,,,,102,152,254
,2013,130700027,,,,27,17,44
,2013,130700042,,,,26,24,50
,2013,130700045,,,,13,13,26
,2013,130700046,,,,12,6,18
,2013,130700047,,,,9,4,13
,2013,130700048,,,,6,6,12
,2013,130700049,,,,6,9,15
,2013,130700050,,,,9,10,19
,2013,130700052,,,,10,6,16
,2013,130700053,,,,6,13,19
,2013,130700054,,,,15,20,35
,2013,130700056,,,,13,7,20
,2013,130700057,,,,2,1,3
,2013,130700058,,,,1,2,3
,2013,130700059,,,,3,5,8
,2013,130700060,,,,3,1,4
,2013,130700063,,,,3,0,3
,2013,130700065,,,,7,3,10
,2013,130700066,,,,2,1,3
,2013,130700067,,,,3,3,6
,2013,130700070,,,,4,4,8
,2013,130700072,,,,3,2,5
,2013,130700085,,,,2,1,3
,2013,130700087,,,,2,1,3
,2013,130700088,,,,2,5,7
,2013,130700090,,,,2,3,5
,2013,130700091,,,,7,3,10
,2013,130800001,,,,59,62,121
,2013,130800002,,,,58,76,134
,2013,130800003,,,,34,35,69
,2013,130800003,,,,4,4,8
,2013,130800004,,,,60,39,99
,2013,130800005,,,,63,62,125
,2013,130800006,,,,90,69,159
,2013,130800007,,,,39,21,60
,2013,130800008,,,,45,34,79
,2013,130800009,,,,28,40,68
,2013,130800011,,,,21,23,44
,2013,130800012,,,,14,10,24
,2013,130800013,,,,128,105,233
,2013,130800013,,,,67,79,146
,2013,130800016,,,,14,23,37
,2013,130800021,,,,5,10,15
,2013,130800024,,,,10,18,28
,2013,130800025,,,,7,8,15
,2013,130800026,,,,24,22,46
,2013,130800033,,,,33,25,58
,2013,130800034,,,,12,13,25
,2013,130800036,,,,10,7,17
,2013,130800038,,,,8,12,20
,2013,130800038,,,,22,26,48
,2013,130800039,,,,6,10,16
,2013,130800041,,,,11,11,22
,2013,130800042,,,,7,8,15
,2013,130800075,,,,22,20,42
,2013,130800076,,,,6,2,8
,2013,130800096,,,,6,3,9
,2013,130800099,,,,12,8,20
,2013,130800101,,,,4,4,8
,2013,130900001,,,,190,143,333
,2013,130900002,,,,73,69,142
,2013,130900003,,,,65,74,139
,2013,130900004,,,,116,109,225
,2013,130900005,,,,53,63,116
,2013,130900006,,,,150,153,303
,2013,130900007,,,,78,90,168
,2013,130900009,,,,163,125,288
,2013,130900010,,,,34,21,55
,2013,130900011,,,,30,25,55
,2013,130900012,,,,41,42,83
,2013,130900014,,,,30,32,62
,2013,130900015,,,,98,89,187
,2013,130900016,,,,58,39,97
,2013,130900017,,,,67,45,112
,2013,130900018,,,,54,38,92
,2013,130900019,,,,58,72,130
,2013,130900020,,,,20,15,35
,2013,130900021,,,,63,74,137
,2013,130900022,,,,34,49,83
,2013,130900023,,,,88,84,172
,2013,130900024,,,,15,14,29
,2013,130900025,,,,60,46,106
,2013,130900026,,,,19,21,40
,2013,130900027,,,,62,72,134
,2013,130900028,,,,15,17,32
,2013,130900029,,,,53,31,84
,2013,130900030,,,,215,189,404
,2013,130900031,,,,40,37,77
,2013,130900032,,,,25,34,59
,2013,130900033,,,,7,15,22
,2013,130900034,,,,28,20,48
,2013,130900035,,,,11,9,20
,2013,130900037,,,,3,10,13
,2013,130900047,,,,107,96,203
,2013,130900049,,,,3,5,8
,2013,130900050,,,,4,6,10
,2013,130900053,,,,7,3,10
,2013,130900055,,,,28,31,59
,2013,130900057,,,,15,12,27
,2013,130900058,,,,46,60,106
,2013,130900059,,,,29,30,59
,2013,130900060,,,,35,27,62
,2013,130900061,,,,52,47,99
,2013,130900062,,,,40,37,77
,2013,130900063,,,,38,42,80
,2013,130900107,,,,62,69,131
,2013,130900109,,,,9,6,15
,2013,130900110,,,,19,17,36
,2013,130900111,,,,16,9,25
,2013,130900114,,,,10,7,17
,2013,130900115,,,,3,5,8
,2013,130900116,,,,8,2,10
,2013,130900119,,,,6,7,13
,2013,130900141,,,,5,7,12
,2013,130900143,,,,45,32,77
,2013,130900144,,,,42,32,74
,2013,130900145,,,,40,48,88
,2013,130900146,,,,48,46,94
,2013,130900147,,,,8,7,15
,2013,130900148,,,,7,6,13
,2013,130900152,,,,5,3,8
,2013,130900164,,,,6,11,17
,2013,130900165,,,,5,5,10
,2013,130900169,,,,9,8,17
,2013,130900173,,,,11,5,16
,2013,130900208,,,,38,46,84
,2013,130900209,,,,11,8,19
,2013,130900210,,,,16,10,26
,2013,130900211,,,,8,9,17
,2013,130900212,,,,18,15,33
,2013,130900213,,,,12,2,14
,2013,130900214,,,,3,15,18
,2013,130900215,,,,5,2,7
,2013,130900217,,,,3,6,9
,2013,130900219,,,,22,24,46
,2013,130900246,,,,15,25,40
,2013,130900247,,,,20,24,44
,2013,130900248,,,,11,8,19
,2013,130900249,,,,13,12,25
,2013,130900250,,,,12,4,16
,2013,130900251,,,,23,17,40
,2013,130900252,,,,9,11,20
,2013,130900256,,,,4,4,8
,2013,130900257,,,,5,2,7
,2013,130900258,,,,12,13,25
,2013,130900260,,,,4,2,6
,2013,130900261,,,,6,2,8
,2013,131000001,,,,125,121,246
,2013,131000002,,,,89,66,155
,2013,131000003,,,,38,45,83
,2013,131000004,,,,51,64,115
,2013,131000005,,,,56,58,114
,2013,131000006,,,,73,48,121
,2013,131000007,,,,30,15,45
,2013,131000008,,,,51,60,111
,2013,131000009,,,,9,10,19
,2013,131000010,,,,20,14,34
,2013,131000011,,,,15,26,41
,2013,131000012,,,,36,33,69
,2013,131000013,,,,22,19,41
,2013,131000014,,,,34,50,84
,2013,131000015,,,,27,17,44
,2013,131000016,,,,107,136,243
,2013,131000016,,,,37,54,91
,2013,131000018,,,,12,12,24
,2013,131000019,,,,17,9,26
,2013,131000020,,,,27,24,51
,2013,131000021,,,,6,9,15
,2013,131000022,,,,19,13,32
,2013,131000023,,,,28,22,50
,2013,131000024,,,,24,27,51
,2013,131000024,,,,6,9,15
,2013,131000025,,,,12,10,22
,2013,131000026,,,,16,14,30
,2013,131000027,,,,22,22,44
,2013,131000028,,,,30,20,50
,2013,131000029,,,,10,6,16
,2013,131000030,,,,25,24,49
,2013,131000031,,,,5,10,15
,2013,131000032,,,,12,3,15
,2013,131000033,,,,12,19,31
,2013,131000035,,,,5,8,13
,2013,131000037,,,,6,12,18
,2013,131000039,,,,9,6,15
,2013,131000044,,,,8,14,22
,2013,131000045,,,,8,8,16
,2013,131000047,,,,8,7,15
,2013,131000048,,,,10,8,18
,2013,131000061,,,,18,3,21
,2013,131000068,,,,7,9,16
,2013,131000069,,,,12,12,24
,2013,131000070,,,,31,14,45
,2013,131000071,,,,1,5,6
,2013,131000072,,,,6,4,10
,2013,131100001,,,,250,204,454
,2013,131100002,,,,53,34,87
,2013,131100003,,,,61,49,110
,2013,131100004,,,,86,60,146
,2013,131100006,,,,119,111,230
,2013,131100007,,,,15,16,31
,2013,131100008,,,,13,14,27
,2013,131100010,,,,27,32,59
,2013,131100011,,,,33,26,59
,2013,131100012,,,,30,26,56
,2013,131100013,,,,24,27,51
,2013,131100014,,,,14,21,35
,2013,131100015,,,,31,42,73
,2013,131100016,,,,16,14,30
,2013,131100017,,,,50,42,92
,2013,131100018,,,,14,9,23
,2013,131100019,,,,184,147,331
,2013,131100020,,,,8,22,30
,2013,131100021,,,,22,13,35
,2013,131100022,,,,25,17,42
,2013,131100023,,,,12,17,29
,2013,131100036,,,,14,11,25
,2013,131100042,,,,34,30,64
,2013,131100049,,,,8,7,15
,2013,131100050,,,,5,10,15
,2013,131100051,,,,5,13,18
,2013,131100052,,,,14,19,33
,2013,131100053,,,,13,8,21
,2013,131100058,,,,8,3,11
,2013,131100059,,,,4,11,15
,2013,131100060,,,,9,8,17
,2013,131100063,,,,10,15,25
,2013,131100064,,,,39,23,62
,2013,131100065,,,,20,19,39
,2013,131100066,,,,30,16,46
,2013,131100067,,,,10,9,19
,2013,131100068,,,,15,7,22
,2013,131100070,,,,15,17,32
,2013,131100071,,,,9,6,15
,2013,131100072,,,,65,66,131
,2013,131100072,,,,50,44,94
,2013,131100094,,,,9,15,24
,2013,131100096,,,,11,12,23
,2013,131100108,,,,16,20,36
,2013,131100109,,,,21,19,40
,2013,131100110,,,,2,4,6
,2013,131100111,,,,10,6,16
,2013,131100112,,,,10,10,20
,2013,131200001,,,,84,88,172
,2013,131200002,,,,13,12,25
,2013,131200003,,,,26,25,51
,2013,131200004,,,,16,22,38
,2013,131200005,,,,31,31,62
,2013,131200006,,,,63,52,115
,2013,131200007,,,,38,28,66
,2013,131200008,,,,13,13,26
,2013,131200009,,,,11,13,24
,2013,131200010,,,,13,16,29
,2013,131200011,,,,23,23,46
,2013,131200012,,,,18,7,25
,2013,131200013,,,,79,75,154
,2013,131200014,,,,69,59,128
,2013,131200015,,,,12,8,20
,2013,131200016,,,,18,9,27
,2013,131200017,,,,17,16,33
,2013,131200018,,,,32,35,67
,2013,131200019,,,,6,18,24
,2013,131200020,,,,60,71,131
,2013,131200020,,,,33,30,63
,2013,131200021,,,,15,7,22
,2013,131200022,,,,6,8,14
,2013,131200023,,,,16,8,24
,2013,131200024,,,,19,11,30
,2013,131200025,,,,12,10,22
,2013,131200026,,,,16,7,23
,2013,131200028,,,,5,9,14
,2013,131200029,,,,12,11,23
,2013,131200030,,,,11,10,21
,2013,131200032,,,,10,8,18
,2013,131200035,,,,4,6,10
,2013,131200036,,,,15,8,23
,2013,131200038,,,,11,12,23
,2013,131200039,,,,3,4,7
,2013,131200039,,,,13,9,22
,2013,131200040,,,,12,9,21
,2013,131200043,,,,2,1,3
,2013,131200044,,,,3,2,5
,2013,131200046,,,,10,5,15
,2013,131200047,,,,7,8,15
,2013,131200048,,,,7,8,15
,2013,131200050,,,,4,4,8
,2013,131200051,,,,2,3,5
,2013,131200052,,,,5,6,11
,2013,131200053,,,,4,1,5
,2013,131200058,,,,2,4,6
,2013,131200059,,,,3,5,8
,2013,131300001,,,,179,189,368
,2013,131300002,,,,173,151,324
,2013,131300004,,,,174,163,337
,2013,131300005,,,,52,50,102
,2013,131300006,,,,27,14,41
,2013,131300007,,,,45,63,108
,2013,131300008,,,,63,66,129
,2013,131300009,,,,41,49,90
,2013,131300010,,,,63,55,118
,2013,131300011,,,,117,119,236
,2013,131300012,,,,34,50,84
,2013,131300013,,,,61,41,102
,2013,131300014,,,,37,35,72
,2013,131300016,,,,18,23,41
,2013,131300017,,,,20,7,27
,2013,131300018,,,,52,35,87
,2013,131300019,,,,37,42,79
,2013,131300020,,,,58,27,85
,2013,131300021,,,,51,78,129
,2013,131300022,,,,45,48,93
,2013,131300023,,,,34,26,60
,2013,131300024,,,,172,171,343
,2013,131300025,,,,52,49,101
,2013,131300026,,,,76,71,147
,2013,131300027,,,,110,116,226
,2013,131300028,,,,171,167,338
,2013,131300029,,,,160,147,307
,2013,131300030,,,,80,68,148
,2013,131300031,,,,36,36,72
,2013,131300032,,,,24,18,42
,2013,131300033,,,,70,66,136
,2013,131300034,,,,21,16,37
,2013,131300035,,,,43,40,83
,2013,131300036,,,,18,12,30
,2013,131300037,,,,20,17,37
,2013,131300038,,,,95,77,172
,2013,131300039,,,,40,49,89
,2013,131300040,,,,15,15,30
,2013,131300041,,,,66,51,117
,2013,131300042,,,,24,21,45
,2013,131300043,,,,32,29,61
,2013,131300044,,,,36,39,75
,2013,131300045,,,,30,44,74
,2013,131300048,,,,61,46,107
,2013,131300050,,,,32,37,69
,2013,131300051,,,,20,7,27
,2013,131300052,,,,78,65,143
,2013,131300053,,,,48,48,96
,2013,131300054,,,,128,137,265
,2013,131300055,,,,12,18,30
,2013,131300056,,,,250,284,534
,2013,131300070,,,,23,21,44
,2013,131300071,,,,11,12,23
,2013,131300072,,,,16,6,22
,2013,131300073,,,,5,7,12
,2013,131300074,,,,17,9,26
,2013,131300075,,,,16,14,30
,2013,131300078,,,,12,4,16
,2013,131300080,,,,29,18,47
,2013,131300081,,,,26,28,54
,2013,131300082,,,,10,12,22
,2013,131300083,,,,13,9,22
,2013,131300084,,,,16,10,26
,2013,131300085,,,,10,6,16
,2013,131300088,,,,3,2,5
,2013,131300089,,,,11,14,25
,2013,131300091,,,,16,15,31
,2013,131300092,,,,55,53,108
,2013,131300093,,,,7,8,15
,2013,131300093,,,,32,20,52
,2013,131300094,,,,16,7,23
,2013,131300095,,,,73,53,126
,2013,131300096,,,,33,30,63
,2013,131300097,,,,33,32,65
,2013,131300098,,,,9,7,16
,2013,131300099,,,,46,31,77
,2013,131300101,,,,16,9,25
,2013,131300111,,,,42,46,88
,2013,131300139,,,,99,80,179
,2013,131300140,,,,18,33,51
,2013,131300144,,,,7,4,11
,2013,131300145,,,,12,33,45
,2013,131300146,,,,4,9,13
,2013,131300147,,,,2,8,10
,2013,131300148,,,,4,4,8
,2013,131300152,,,,4,9,13
,2013,131300153,,,,6,4,10
,2013,131300159,,,,9,4,13
,2013,131300161,,,,5,0,5
,2013,131300162,,,,4,1,5
,2013,131300163,,,,6,3,9
,2013,131300164,,,,78,89,167
,2013,131300166,,,,6,8,14
,2013,131300167,,,,7,5,12
,2013,131300170,,,,22,13,35
,2013,131300175,,,,5,9,14
,2013,131300176,,,,27,24,51
,2013,131300177,,,,9,16,25
,2013,131300179,,,,10,13,23
,2013,131300180,,,,14,32,46
,2013,131300181,,,,7,12,19
,2013,131300182,,,,5,10,15
,2013,131300183,,,,87,66,153
,2013,131300185,,,,3,8,11
,2013,131300188,,,,32,19,51
,2013,131300189,,,,10,14,24
,2013,131300191,,,,4,3,7
,2013,131300192,,,,6,4,10
,2013,131300194,,,,4,6,10
,2013,131300196,,,,5,8,13
,2013,131300200,,,,3,3,6
,2013,131300201,,,,4,5,9
,2013,131300204,,,,14,5,19
,2013,131300206,,,,12,12,24
,2013,131300208,,,,5,6,11
,2013,131300210,,,,7,3,10
,2013,131300211,,,,9,12,21
,2013,131300212,,,,4,4,8
,2013,131300222,,,,14,12,26
,2013,131300223,,,,18,21,39
,2013,131300224,,,,18,16,34
,2013,131300225,,,,13,15,28
,2013,131300254,,,,2,4,6
,2013,131300255,,,,9,3,12
,2013,131300259,,,,3,1,4
,2013,131400001,,,,66,77,143
,2013,131400002,,,,66,66,132
,2013,131400003,,,,50,33,83
,2013,131400004,,,,93,81,174
,2013,131400005,,,,13,8,21
,2013,131400006,,,,21,18,39
,2013,131400007,,,,26,30,56
,2013,131400008,,,,21,33,54
,2013,131400009,,,,7,20,27
,2013,131400010,,,,11,8,19
,2013,131400011,,,,102,127,229
,2013,131400012,,,,12,7,19
,2013,131400013,,,,10,10,20
,2013,131400020,,,,9,8,17
,2013,131400028,,,,5,9,14
,2013,131400040,,,,17,14,31
,2013,131400041,,,,6,8,14
,2013,131400042,,,,5,14,19
,2013,131400043,,,,2,3,5
,2013,131400044,,,,2,3,5
,2013,131400045,,,,5,0,5
,2013,131500001,,,,37,44,81
,2013,131500003,,,,58,54,112
,2013,131500004,,,,42,74,116
,2013,131500005,,,,54,47,101
,2013,131500006,,,,49,50,99
,2013,131500007,,,,88,90,178
,2013,131500008,,,,41,21,62
,2013,131500009,,,,36,56,92
,2013,131500010,,,,136,130,266
,2013,131500011,,,,128,98,226
,2013,131500012,,,,54,50,104
,2013,131500013,,,,71,54,125
,2013,131500014,,,,12,18,30
,2013,131500015,,,,15,15,30
,2013,131500016,,,,37,24,61
,2013,131500017,,,,41,30,71
,2013,131500019,,,,25,32,57
,2013,131500020,,,,45,34,79
,2013,131500021,,,,41,25,66
,2013,131500022,,,,16,16,32
,2013,131500024,,,,86,78,164
,2013,131500025,,,,40,38,78
,2013,131500026,,,,25,24,49
,2013,131500027,,,,101,137,238
,2013,131500028,,,,16,14,30
,2013,131500029,,,,57,33,90
,2013,131500031,,,,126,133,259
,2013,131500035,,,,66,55,121
,2013,131500036,,,,37,41,78
,2013,131500038,,,,8,11,19
,2013,131500039,,,,14,17,31
,2013,131500045,,,,42,15,57
,2013,131500050,,,,12,10,22
,2013,131500055,,,,68,70,138
,2013,131500056,,,,15,6,21
,2013,131500058,,,,30,20,50
,2013,131500060,,,,10,9,19
,2013,131500061,,,,2,11,13
,2013,131500062,,,,9,15,24
,2013,131500063,,,,2,8,10
,2013,131500064,,,,8,10,18
,2013,131500065,,,,11,11,22
,2013,131500066,,,,9,13,22
,2013,131500067,,,,13,7,20
,2013,131500068,,,,19,12,31
,2013,131500069,,,,18,24,42
,2013,131500070,,,,6,4,10
,2013,131500089,,,,23,16,39
,2013,131500090,,,,57,44,101
,2013,131500093,,,,4,7,11
,2013,131500094,,,,6,4,10
,2013,131500095,,,,6,5,11
,2013,131500096,,,,7,4,11
,2013,131500097,,,,8,8,16
,2013,131500102,,,,4,5,9
,2013,131500103,,,,2,4,6
,2013,131500104,,,,3,6,9
,2013,131500106,,,,3,4,7
,2013,131500108,,,,8,6,14
,2013,131500123,,,,10,8,18
,2013,131500124,,,,31,15,46
,2013,131500129,,,,2,5,7
,2013,131500130,,,,5,2,7
,2013,131500131,,,,7,5,12
,2013,131500132,,,,1,6,7
,2013,131500134,,,,8,4,12
,2013,131500135,,,,6,4,10
,2013,131500136,,,,3,6,9
,2013,131500137,,,,6,6,12
,2013,131600001,,,,40,57,97
,2013,131600002,,,,187,151,338
,2013,131600003,,,,67,78,145
,2013,131600004,,,,65,63,128
,2013,131600005,,,,93,101,194
,2013,131600006,,,,42,38,80
,2013,131600007,,,,52,48,100
,2013,131600008,,,,12,3,15
,2013,131600009,,,,45,42,87
,2013,131600010,,,,39,41,80
,2013,131600011,,,,57,43,100
,2013,131600012,,,,30,42,72
,2013,131600013,,,,22,25,47
,2013,131600014,,,,52,50,102
,2013,131600015,,,,17,18,35
,2013,131600016,,,,31,36,67
,2013,131600017,,,,36,67,103
,2013,131600018,,,,45,55,100
,2013,131600019,,,,41,40,81
,2013,131600020,,,,69,65,134
,2013,131600021,,,,12,8,20
,2013,131600022,,,,19,25,44
,2013,131600023,,,,11,13,24
,2013,131600024,,,,12,13,25
,2013,131600025,,,,6,14,20
,2013,131600026,,,,61,42,103
,2013,131600037,,,,13,8,21
,2013,131600039,,,,5,5,10
,2013,131600040,,,,16,18,34
,2013,131600041,,,,28,36,64
,2013,131600042,,,,25,25,50
,2013,131600043,,,,21,29,50
,2013,131600044,,,,19,33,52
,2013,131600045,,,,25,31,56
,2013,131600046,,,,42,45,87
,2013,131600047,,,,16,25,41
,2013,131600048,,,,19,22,41
,2013,131600049,,,,15,12,27
,2013,131600089,,,,4,9,13
,2013,131600090,,,,2,8,10
,2013,131600091,,,,1,5,6
,2013,131600094,,,,2,5,7
,2013,131600095,,,,4,4,8
,2013,131600098,,,,13,9,22
,2013,131600099,,,,3,11,14
,2013,131600102,,,,7,5,12
,2013,131600104,,,,6,4,10
,2013,131600105,,,,6,6,12
,2013,131600107,,,,4,2,6
,2013,131600108,,,,6,7,13
,2013,131600109,,,,2,6,8
,2013,131600110,,,,6,4,10
,2013,131600111,,,,2,4,6
,2013,131600165,,,,6,4,10
,2013,131600167,,,,15,12,27
,2013,131600168,,,,2,4,6
,2013,131600171,,,,2,5,7
,2013,131600172,,,,3,2,5
,2013,131600173,,,,7,3,10
,2013,131600175,,,,3,5,8
,2013,131600176,,,,5,5,10
,2013,131600198,,,,22,14,36
,2013,131600199,,,,12,13,25
,2013,131600200,,,,18,13,31
,2013,131600201,,,,36,30,66
,2013,131600203,,,,4,4,8
,2013,131600204,,,,8,10,18
,2013,131600205,,,,2,4,6
,2013,131600206,,,,8,0,8
,2013,131600207,,,,3,5,8
,2013,131600208,,,,2,5,7
,2013,131600209,,,,4,6,10
,2013,131600210,,,,2,2,4
,2013,131600211,,,,7,4,11
,2013,131600212,,,,3,5,8
,2013,131600213,,,,3,2,5
,2013,131700002,,,,55,48,103
,2013,131700003,,,,70,63,133
,2013,131700004,,,,46,51,97
,2013,131700005,,,,94,91,185
,2013,131700006,,,,58,75,133
,2013,131700007,,,,23,31,54
,2013,131700008,,,,45,60,105
,2013,131700009,,,,79,76,155
,2013,131700010,,,,45,43,88
,2013,131700011,,,,41,26,67
,2013,131700012,,,,31,33,64
,2013,131700013,,,,10,9,19
,2013,131700014,,,,28,35,63
,2013,131700015,,,,40,44,84
,2013,131700016,,,,7,4,11
,2013,131700017,,,,23,28,51
,2013,131700019,,,,166,140,306
,2013,131700019,,,,33,32,65
,2013,131700020,,,,9,5,14
,2013,131700021,,,,8,12,20
,2013,131700022,,,,19,21,40
,2013,131700023,,,,7,9,16
,2013,131700025,,,,10,10,20
,2013,131700025,,,,4,6,10
,2013,131700026,,,,5,5,10
,2013,131700028,,,,23,21,44
,2013,131700029,,,,39,28,67
,2013,131700030,,,,33,27,60
,2013,131700031,,,,18,21,39
,2013,131700040,,,,12,7,19
,2013,131700041,,,,8,8,16
,2013,131700042,,,,7,8,15
,2013,131700043,,,,27,21,48
,2013,131700046,,,,4,5,9
,2013,131700047,,,,3,0,3
,2013,131700048,,,,6,4,10
,2013,131700052,,,,5,3,8
,2013,131700077,,,,18,10,28
,2013,131700078,,,,6,4,10
,2013,131700079,,,,7,6,13
,2013,131700092,,,,5,8,13
,2013,131700093,,,,4,4,8
,2013,131700094,,,,4,3,7
,2013,131700095,,,,4,2,6
,2013,131700096,,,,6,1,7
,2013,131700097,,,,0,6,6
,2013,131700098,,,,2,6,8
,2013,131700099,,,,5,1,6
,2013,131700100,,,,4,6,10
,2013,131700101,,,,3,0,3
,2013,131700102,,,,5,2,7
,2013,131700103,,,,6,2,8
,2013,131800001,,,,36,27,63
,2013,131800002,,,,13,11,24
,2013,131800003,,,,31,19,50
,2013,131800004,,,,23,18,41
,2013,131800005,,,,52,55,107
,2013,131800006,,,,28,12,40
,2013,131800007,,,,46,42,88
,2013,131800008,,,,11,4,15
,2013,131800009,,,,15,6,21
,2013,131800010,,,,9,9,18
,2013,131800011,,,,10,4,14
,2013,131800012,,,,8,6,14
,2013,131800014,,,,7,7,14
,2013,131800015,,,,15,11,26
,2013,131800016,,,,12,7,19
,2013,131800017,,,,2,6,8
,2013,131800019,,,,2,2,4
,2013,131800025,,,,8,7,15
,2013,131800029,,,,3,1,4
,2013,131900001,,,,122,112,234
,2013,131900003,,,,64,59,123
,2013,131900004,,,,51,49,100
,2013,131900005,,,,64,73,137
,2013,131900006,,,,43,53,96
,2013,131900007,,,,44,28,72
,2013,131900008,,,,28,20,48
,2013,131900009,,,,47,52,99
,2013,131900010,,,,25,19,44
,2013,131900011,,,,33,37,70
,2013,131900012,,,,35,38,73
,2013,131900013,,,,37,43,80
,2013,131900014,,,,29,28,57
,2013,131900016,,,,36,33,69
,2013,131900017,,,,48,42,90
,2013,131900018,,,,40,27,67
,2013,131900019,,,,41,24,65
,2013,131900020,,,,51,26,77
,2013,131900021,,,,45,43,88
,2013,131900022,,,,18,21,39
,2013,131900023,,,,27,16,43
,2013,131900024,,,,38,34,72
,2013,131900026,,,,16,9,25
,2013,131900027,,,,43,36,79
,2013,131900028,,,,14,15,29
,2013,131900030,,,,19,8,27
,2013,131900031,,,,30,28,58
,2013,131900038,,,,32,31,63
,2013,131900040,,,,27,22,49
,2013,131900041,,,,31,26,57
,2013,131900042,,,,51,46,97
,2013,131900043,,,,15,15,30
,2013,131900047,,,,20,28,48
,2013,131900048,,,,4,3,7
,2013,131900065,,,,153,146,299
,2013,131900071,,,,11,23,34
,2013,131900074,,,,17,15,32
,2013,131900075,,,,11,15,26
,2013,131900077,,,,17,14,31
,2013,131900078,,,,11,24,35
,2013,131900079,,,,11,9,20
,2013,131900085,,,,2,3,5
,2013,131900091,,,,6,5,11
,2013,131900094,,,,12,10,22
,2013,131900095,,,,22,25,47
,2013,131900096,,,,10,7,17
,2013,131900097,,,,9,7,16
,2013,131900125,,,,3,5,8
,2013,131900128,,,,3,9,12
,2013,131900129,,,,10,10,20
,2013,131900130,,,,2,3,5
,2013,131900131,,,,3,2,5
,2013,131900134,,,,3,3,6
,2013,131900136,,,,6,3,9
,2013,131900137,,,,4,4,8
,2013,131900138,,,,2,9,11
,2013,131900140,,,,1,4,5
,2013,131900141,,,,6,5,11
,2013,131900142,,,,3,3,6
,2013,131900143,,,,5,5,10
,2013,131900144,,,,4,4,8
,2013,131900198,,,,13,16,29
,2013,131900199,,,,59,37,96
,2013,131900200,,,,3,3,6
,2013,131900203,,,,4,3,7
,2013,131900204,,,,4,4,8
,2013,131900205,,,,4,5,9
,2013,131900206,,,,3,3,6
,2013,131900207,,,,6,2,8
,2013,131900224,,,,10,16,26
,2013,131900225,,,,14,18,32
,2013,131900226,,,,10,3,13
,2013,131900227,,,,7,4,11
,2013,131900228,,,,3,3,6
,2013,131900229,,,,2,3,5
,2013,131900230,,,,2,3,5
,2013,131900233,,,,13,9,22
,2013,131900234,,,,7,8,15
,2013,131900235,,,,3,3,6
,2013,132000001,,,,43,42,85
,2013,132000002,,,,54,38,92
,2013,132000003,,,,53,68,121
,2013,132000004,,,,56,37,93
,2013,132000005,,,,74,78,152
,2013,132000006,,,,115,137,252
,2013,132000007,,,,24,40,64
,2013,132000008,,,,82,83,165
,2013,132000009,,,,20,28,48
,2013,132000010,,,,30,36,66
,2013,132000011,,,,12,20,32
,2013,132000012,,,,28,20,48
,2013,132000013,,,,12,9,21
,2013,132000014,,,,19,16,35
,2013,132000015,,,,36,34,70
,2013,132000016,,,,68,70,138
,2013,132000017,,,,30,25,55
,2013,132000018,,,,46,47,93
,2013,132000020,,,,21,18,39
,2013,132000021,,,,20,19,39
,2013,132000022,,,,24,25,49
,2013,132000023,,,,40,46,86
,2013,132000024,,,,14,17,31
,2013,132000025,,,,13,13,26
,2013,132000026,,,,14,10,24
,2013,132000036,,,,22,13,35
,2013,132000042,,,,20,34,54
,2013,132000043,,,,19,19,38
,2013,132000044,,,,15,14,29
,2013,132000046,,,,2,6,8
,2013,132000047,,,,3,2,5
,2013,132000052,,,,7,5,12
,2013,132000055,,,,3,4,7
,2013,132000057,,,,20,14,34
,2013,132000058,,,,80,69,149
,2013,132000060,,,,4,2,6
,2013,132000063,,,,2,2,4
,2013,132000064,,,,8,5,13
,2013,132000065,,,,6,14,20
,2013,132000068,,,,7,6,13
,2013,132000069,,,,6,10,16
,2013,132000070,,,,6,12,18
,2013,132000071,,,,20,11,31
,2013,132000072,,,,14,17,31
,2013,132000073,,,,3,4,7
,2013,132000074,,,,2,3,5
,2013,132000074,,,,14,17,31
,2013,132000076,,,,2,3,5
,2013,132000077,,,,2,4,6
,2013,132000079,,,,2,2,4
,2013,132000080,,,,6,2,8
,2013,132000081,,,,3,3,6
,2013,132000089,,,,5,4,9
,2013,132000105,,,,15,20,35
,2013,132000107,,,,3,2,5
,2013,132000108,,,,4,2,6
,2013,132000127,,,,26,29,55
,2013,132000128,,,,5,1,6
,2013,132000129,,,,5,1,6
,2013,132000130,,,,2,3,5
,2013,132000131,,,,3,2,5
,2013,132000132,,,,1,3,4
,2013,132100002,,,,47,42,89
,2013,132100003,,,,29,18,47
,2013,132100004,,,,7,5,12
,2013,132100005,,,,36,41,77
,2013,132100006,,,,58,56,114
,2013,132100007,,,,19,18,37
,2013,132100008,,,,69,47,116
,2013,132100009,,,,46,35,81
,2013,132100010,,,,41,20,61
,2013,132100011,,,,34,27,61
,2013,132100012,,,,21,15,36
,2013,132100013,,,,163,183,346
,2013,132100014,,,,38,41,79
,2013,132100015,,,,17,12,29
,2013,132100016,,,,38,41,79
,2013,132100017,,,,32,36,68
,2013,132100018,,,,40,50,90
,2013,132100019,,,,22,19,41
,2013,132100020,,,,43,41,84
,2013,132100022,,,,13,12,25
,2013,132100023,,,,35,28,63
,2013,132100025,,,,10,14,24
,2013,132100026,,,,12,11,23
,2013,132100027,,,,21,20,41
,2013,132100028,,,,16,12,28
,2013,132100029,,,,28,26,54
,2013,132100058,,,,6,9,15
,2013,132100058,,,,23,22,45
,2013,132100059,,,,11,11,22
,2013,132100060,,,,19,19,38
,2013,132100061,,,,19,16,35
,2013,132100062,,,,14,11,25
,2013,132100064,,,,7,12,19
,2013,132100065,,,,26,31,57
,2013,132100066,,,,16,18,34
,2013,132100067,,,,7,13,20
,2013,132100068,,,,25,23,48
,2013,132100071,,,,3,2,5
,2013,132100072,,,,2,4,6
,2013,132100073,,,,7,4,11
,2013,132100074,,,,6,3,9
,2013,132100076,,,,2,5,7
,2013,132100083,,,,2,9,11
,2013,132100084,,,,4,2,6
,2013,132100086,,,,5,9,14
,2013,132100087,,,,4,6,10
,2013,132100089,,,,11,5,16
,2013,132100090,,,,9,6,15
,2013,132100157,,,,3,5,8
,2013,132100158,,,,6,7,13
,2013,132100159,,,,4,3,7
,2013,132100162,,,,1,3,4
,2013,132100184,,,,20,10,30
,2013,132100186,,,,4,1,5
,2013,132100189,,,,9,18,27
,2013,132100190,,,,6,3,9
,2013,132100192,,,,6,6,12
,2013,132100193,,,,25,17,42
,2013,132100194,,,,3,2,5
,2013,132100195,,,,3,5,8
,2013,132100196,,,,6,6,12
,2013,132100197,,,,3,5,8
,2013,132100198,,,,2,4,6
,2013,132100199,,,,2,3,5
,2013,132100200,,,,5,3,8
,2013,132100201,,,,10,3,13
,2013,132200001,,,,71,59,130
,2013,132200002,,,,120,123,243
,2013,132200003,,,,101,99,200
,2013,132200004,,,,70,85,155
,2013,132200006,,,,57,64,121
,2013,132200007,,,,35,30,65
,2013,132200009,,,,14,11,25
,2013,132200017,,,,8,11,19
,2013,132200017,,,,25,23,48
,2013,132200018,,,,38,24,62
,2013,132200018,,,,10,12,22
,2013,132200019,,,,10,6,16
,2013,132200019,,,,43,38,81
,2013,132200024,,,,48,63,111
,2013,132200025,,,,19,25,44
,2013,132200025,,,,9,12,21
,2013,132200026,,,,23,19,42
,2013,132200027,,,,17,15,32
,2013,132200028,,,,24,25,49
,2013,132200029,,,,4,14,18
,2013,132200030,,,,17,27,44
,2013,132200031,,,,8,7,15
,2013,132200032,,,,27,18,45
,2013,132200034,,,,19,13,32
,2013,132200036,,,,6,9,15
,2013,132200037,,,,3,3,6
,2013,132200039,,,,3,4,7
,2013,132200040,,,,6,4,10
,2013,132200041,,,,6,3,9
,2013,132200043,,,,5,15,20
,2013,132200046,,,,3,3,6
,2013,132200077,,,,12,15,27
,2013,132200078,,,,12,13,25
,2013,132200079,,,,11,17,28
,2013,132200080,,,,20,13,33
,2013,132200081,,,,8,3,11
,2013,132200084,,,,2,4,6
,2013,132200085,,,,6,4,10
,2013,132200086,,,,1,2,3
,2013,132200089,,,,4,2,6
,2013,132300001,,,,26,38,64
,2013,132300001,,,,100,103,203
,2013,132300002,,,,31,25,56
,2013,132300003,,,,92,81,173
,2013,132300004,,,,32,37,69
,2013,132300005,,,,47,34,81
,2013,132300006,,,,60,61,121
,2013,132300007,,,,44,42,86
,2013,132300008,,,,58,50,108
,2013,132300009,,,,53,74,127
,2013,132300010,,,,22,29,51
,2013,132300011,,,,42,43,85
,2013,132300012,,,,18,17,35
,2013,132300013,,,,18,15,33
,2013,132300014,,,,30,34,64
,2013,132300015,,,,39,26,65
,2013,132300016,,,,23,17,40
,2013,132300017,,,,13,8,21
,2013,132300018,,,,27,18,45
,2013,132300019,,,,27,15,42
,2013,132300020,,,,17,27,44
,2013,132300021,,,,20,18,38
,2013,132300022,,,,75,109,184
,2013,132300025,,,,9,8,17
,2013,132300026,,,,14,15,29
,2013,132300027,,,,17,12,29
,2013,132300028,,,,14,5,19
,2013,132300029,,,,15,8,23
,2013,132300031,,,,4,12,16
,2013,132300032,,,,8,16,24
,2013,132300034,,,,15,16,31
,2013,132300035,,,,20,16,36
,2013,132300040,,,,0,23,23
,2013,132300042,,,,7,8,15
,2013,132300045,,,,18,17,35
,2013,132300047,,,,5,10,15
,2013,132300048,,,,4,4,8
,2013,132300050,,,,3,6,9
,2013,132300053,,,,14,9,23
,2013,132300071,,,,6,10,16
,2013,132300083,,,,11,10,21
,2013,132300085,,,,8,10,18
,2013,132300102,,,,10,8,18
,2013,132300104,,,,7,9,16
,2013,132300105,,,,7,2,9
,2013,132400001,,,,172,179,351
,2013,132400002,,,,27,36,63
,2013,132400003,,,,34,21,55
,2013,132400004,,,,43,41,84
,2013,132400005,,,,17,14,31
,2013,132400006,,,,24,14,38
,2013,132400007,,,,30,28,58
,2013,132400008,,,,13,16,29
,2013,132400009,,,,15,13,28
,2013,132400017,,,,19,12,31
,2013,132400018,,,,10,7,17
,2013,132400022,,,,8,9,17
,2013,132400023,,,,4,2,6
,2013,132500001,,,,40,51,91
,2013,132500002,,,,22,27,49
,2013,132500003,,,,98,132,230
,2013,132500004,,,,68,60,128
,2013,132500005,,,,76,88,164
,2013,132500006,,,,35,28,63
,2013,132500007,,,,17,11,28
,2013,132500008,,,,38,34,72
,2013,132500009,,,,48,40,88
,2013,132500010,,,,19,17,36
,2013,132500011,,,,17,27,44
,2013,132500012,,,,8,9,17
,2013,132500013,,,,24,18,42
,2013,132500014,,,,25,21,46
,2013,132500015,,,,17,15,32
,2013,132500016,,,,25,23,48
,2013,132500017,,,,24,24,48
,2013,132500018,,,,19,10,29
,2013,132500019,,,,119,98,217
,2013,132500034,,,,13,13,26
,2013,132500035,,,,18,23,41
,2013,132500036,,,,26,41,67
,2013,132500040,,,,22,30,52
,2013,132500043,,,,10,17,27
,2013,132500055,,,,11,12,23
,2013,132500056,,,,8,13,21
,2013,132500057,,,,5,5,10
,2013,132500058,,,,10,13,23
,2013,132500059,,,,7,3,10
,2013,132500071,,,,1,7,8
,2013,132500072,,,,2,6,8
,2013,132500078,,,,3,13,16
,2013,132500079,,,,0,6,6
,2013,132500080,,,,8,10,18
,2013,132500083,,,,1,5,6
,2013,132500084,,,,7,6,13
,2013,132500085,,,,4,8,12
,2013,132500086,,,,5,6,11
,2013,132500087,,,,0,16,16
,2013,132600001,,,,17,15,32
,2013,132600002,,,,113,91,204
,2013,132600003,,,,16,10,26
,2013,132600004,,,,16,19,35
,2013,132600005,,,,49,50,99
,2013,132600006,,,,11,25,36
,2013,132600007,,,,16,5,21
,2013,132600008,,,,17,16,33
,2013,132600009,,,,19,15,34
,2013,132600010,,,,18,33,51
,2013,132600011,,,,5,11,16
,2013,132600012,,,,15,19,34
,2013,132600013,,,,11,8,19
,2013,132600014,,,,10,8,18
,2013,132600016,,,,16,9,25
,2013,132600017,,,,9,5,14
,2013,132600027,,,,11,9,20
,2013,132600028,,,,10,13,23
,2013,132600033,,,,10,16,26
,2013,132600035,,,,6,14,20
,2013,132600037,,,,2,2,4
,2013,132600038,,,,2,3,5
,2013,132600041,,,,5,10,15
,2013,132700001,,,,87,100,187
,2013,132700002,,,,5,11,16
,2013,132700003,,,,46,46,92
,2013,132700004,,,,25,23,48
,2013,132700005,,,,46,42,88
,2013,132700006,,,,39,25,64
,2013,132700007,,,,7,7,14
,2013,132700008,,,,17,13,30
,2013,132700009,,,,7,7,14
,2013,132700010,,,,7,8,15
,2013,132700012,,,,15,10,25
,2013,132700013,,,,8,5,13
,2013,132700031,,,,3,4,7
,2013,132800001,,,,54,51,105
,2013,132800002,,,,35,28,63
,2013,132800003,,,,90,105,195
,2013,132800004,,,,14,12,26
,2013,132800005,,,,30,15,45
,2013,132800006,,,,47,45,92
,2013,132800007,,,,18,14,32
,2013,132800008,,,,49,33,82
,2013,132800009,,,,3,3,6
,2013,132800010,,,,62,57,119
,2013,132800011,,,,49,57,106
,2013,132800015,,,,45,24,69
,2013,132800019,,,,15,10,25
,2013,132800019,,,,11,7,18
,2013,132800020,,,,43,38,81
,2013,132800021,,,,8,5,13
,2013,132800022,,,,8,10,18
,2013,132800046,,,,7,9,16
,2013,132800048,,,,10,8,18
,2013,132800049,,,,6,7,13
,2013,132800050,,,,7,10,17
,2013,132800059,,,,5,2,7
,2013,132800060,,,,4,9,13
,2013,132800061,,,,2,4,6
,2013,132800062,,,,4,10,14
,2013,132800063,,,,6,3,9
,2013,132800064,,,,5,10,15
,2013,132800066,,,,5,9,14
,2013,140100001,,,,241,230,471
,2013,140100002,,,,283,272,555
,2013,140100003,,,,330,300,630
,2013,140100004,,,,7,14,21
,2013,140100005,,,,12,10,22
,2013,140100006,,,,7,5,12
,2013,140100007,,,,48,38,86
,2013,140100008,,,,15,4,19
,2013,140100009,,,,18,14,32
,2013,140100010,,,,31,31,62
,2013,140100011,,,,6,5,11
,2013,140100012,,,,122,109,231
,2013,140100013,,,,17,20,37
,2013,140100014,,,,8,10,18
,2013,140100016,,,,18,16,34
,2013,140100017,,,,27,24,51
,2013,140100018,,,,28,17,45
,2013,140100019,,,,12,9,21
,2013,140100020,,,,3,6,9
,2013,140100021,,,,12,12,24
,2013,140100022,,,,35,28,63
,2013,140100023,,,,19,10,29
,2013,140100024,,,,7,8,15
,2013,140100025,,,,9,7,16
,2013,140100026,,,,6,7,13
,2013,140100027,,,,12,8,20
,2013,140100028,,,,7,8,15
,2013,140100029,,,,13,17,30
,2013,140100031,,,,38,35,73
,2013,140100032,,,,92,73,165
,2013,140100033,,,,5,13,18
,2013,140100034,,,,77,73,150
,2013,140100035,,,,40,46,86
,2013,140100036,,,,9,6,15
,2013,140100037,,,,45,36,81
,2013,140100038,,,,41,33,74
,2013,140100039,,,,8,7,15
,2013,140100040,,,,11,8,19
,2013,140100041,,,,61,55,116
,2013,140100042,,,,9,11,20
,2013,140100043,,,,1,7,8
,2013,140100043,,,,0,5,5
,2013,140100044,,,,21,24,45
,2013,140100045,,,,7,8,15
,2013,140100046,,,,505,835,1340
,2013,140100047,,,,548,712,1260
,2013,140100047,,,,262,312,574
,2013,140100048,,,,19,21,40
,2013,140100049,,,,7,2,9
,2013,140100050,,,,14,10,24
,2013,140100051,,,,9,9,18
,2013,140100052,,,,31,25,56
,2013,140100054,,,,4,0,4
,2013,140100054,,,,6,0,6
,2013,140100054,,,,5,13,18
,2013,140100055,,,,28,27,55
,2013,140100055,,,,29,39,68
,2013,140100055,,,,8,3,11
,2013,140100056,,,,30,19,49
,2013,140100057,,,,9,13,22
,2013,140100057,,,,10,12,22
,2013,140100057,,,,26,20,46
,2013,140100058,,,,23,19,42
,2013,140100070,,,,13,16,29
,2013,140100071,,,,5,4,9
,2013,140100073,,,,2,3,5
,2013,140100079,,,,15,8,23
,2013,140100080,,,,4,4,8
,2013,140100081,,,,3,9,12
,2013,140100086,,,,6,6,12
,2013,140100087,,,,15,7,22
,2013,140100088,,,,13,9,22
,2013,140100088,,,,3,1,4
,2013,140100089,,,,8,14,22
,2013,140100098,,,,5,2,7
,2013,140100099,,,,4,3,7
,2013,140100100,,,,3,3,6
,2013,140100101,,,,9,13,22
,2013,140100104,,,,5,5,10
,2013,140100105,,,,1,6,7
,2013,140100106,,,,2,4,6
,2013,140100108,,,,3,5,8
,2013,140100109,,,,4,6,10
,2013,140100110,,,,5,7,12
,2013,140100111,,,,15,7,22
,2013,140100112,,,,7,8,15
,2013,140100113,,,,9,12,21
,2013,140100113,,,,6,4,10
,2013,140100114,,,,1,5,6
,2013,140100115,,,,3,3,6
,2013,140100116,,,,0,5,5
,2013,140100117,,,,7,18,25
,2013,140200001,,,,4,9,13
,2013,140200002,,,,82,77,159
,2013,140200003,,,,54,55,109
,2013,140200004,,,,146,154,300
,2013,140200005,,,,84,66,150
,2013,140200006,,,,10,8,18
,2013,140200007,,,,65,65,130
,2013,140200008,,,,39,36,75
,2013,140200009,,,,84,79,163
,2013,140200010,,,,52,71,123
,2013,140200011,,,,49,35,84
,2013,140200012,,,,24,26,50
,2013,140200013,,,,70,70,140
,2013,140200014,,,,42,36,78
,2013,140200015,,,,42,58,100
,2013,140200016,,,,27,29,56
,2013,140200017,,,,40,26,66
,2013,140200020,,,,14,21,35
,2013,140200021,,,,40,31,71
,2013,140200022,,,,30,32,62
,2013,140200023,,,,8,4,12
,2013,140200024,,,,31,28,59
,2013,140200025,,,,50,29,79
,2013,140200026,,,,16,16,32
,2013,140200027,,,,18,21,39
,2013,140200028,,,,29,21,50
,2013,140200029,,,,22,18,40
,2013,140200030,,,,24,18,42
,2013,140200031,,,,16,13,29
,2013,140200032,,,,80,73,153
,2013,140200032,,,,121,118,239
,2013,140200033,,,,8,10,18
,2013,140200034,,,,8,11,19
,2013,140200035,,,,7,10,17
,2013,140200040,,,,1,4,5
,2013,140200041,,,,16,19,35
,2013,140200042,,,,13,10,23
,2013,140200043,,,,16,19,35
,2013,140200043,,,,4,5,9
,2013,140200044,,,,7,8,15
,2013,140200051,,,,6,6,12
,2013,140200059,,,,17,20,37
,2013,140200059,,,,1,6,7
,2013,140200061,,,,18,9,27
,2013,140200062,,,,10,8,18
,2013,140200063,,,,5,6,11
,2013,140200064,,,,10,16,26
,2013,140200065,,,,12,10,22
,2013,140200066,,,,9,12,21
,2013,140200069,,,,2,4,6
,2013,140200071,,,,6,8,14
,2013,140200077,,,,12,5,17
,2013,140200078,,,,8,17,25
,2013,140200079,,,,12,7,19
,2013,140200080,,,,9,7,16
,2013,140200081,,,,10,11,21
,2013,140200082,,,,0,5,5
,2013,140200083,,,,9,10,19
,2013,140200085,,,,8,15,23
,2013,140200107,,,,16,12,28
,2013,140200108,,,,54,40,94
,2013,140200108,,,,9,8,17
,2013,140200112,,,,8,4,12
,2013,140200114,,,,2,7,9
,2013,140200115,,,,4,5,9
,2013,140200116,,,,5,8,13
,2013,140200117,,,,9,9,18
,2013,140200118,,,,3,3,6
,2013,140200119,,,,3,1,4
,2013,140200123,,,,5,4,9
,2013,140200124,,,,10,10,20
,2013,140200125,,,,3,3,6
,2013,140200126,,,,5,8,13
,2013,140200127,,,,4,2,6
,2013,140200128,,,,4,3,7
,2013,140200129,,,,12,10,22
,2013,140200130,,,,12,12,24
,2013,140200131,,,,16,22,38
,2013,140200132,,,,6,10,16
,2013,140300001,,,,86,99,185
,2013,140300002,,,,16,15,31
,2013,140300003,,,,67,78,145
,2013,140300004,,,,10,12,22
,2013,140300005,,,,6,3,9
,2013,140300006,,,,5,7,12
,2013,140300007,,,,16,18,34
,2013,140300009,,,,12,21,33
,2013,140300011,,,,4,7,11
,2013,140300012,,,,10,5,15
,2013,140300013,,,,13,8,21
,2013,140300014,,,,31,19,50
,2013,140300015,,,,6,5,11
,2013,140300016,,,,9,11,20
,2013,140300017,,,,4,9,13
,2013,140300018,,,,11,10,21
,2013,140300019,,,,18,11,29
,2013,140300020,,,,24,26,50
,2013,140300021,,,,14,19,33
,2013,140300022,,,,11,6,17
,2013,140300023,,,,1,3,4
,2013,140300030,,,,5,7,12
,2013,140300031,,,,8,5,13
,2013,140300049,,,,12,10,22
,2013,140300050,,,,4,7,11
,2013,140300055,,,,6,4,10
,2013,140300056,,,,7,5,12
,2013,140300062,,,,5,2,7
,2013,140300064,,,,8,3,11
,2013,140300066,,,,2,1,3
,2013,140300067,,,,1,6,7
,2013,140400001,,,,71,36,107
,2013,140400002,,,,64,81,145
,2013,140400002,,,,36,38,74
,2013,140400003,,,,26,14,40
,2013,140400004,,,,26,33,59
,2013,140400005,,,,13,19,32
,2013,140400006,,,,13,13,26
,2013,140400015,,,,20,21,41
,2013,140400016,,,,14,10,24
,2013,140400016,,,,1,4,5
,2013,140400017,,,,18,12,30
,2013,140400018,,,,13,17,30
,2013,140400019,,,,4,6,10
,2013,140400020,,,,10,18,28
,2013,140400021,,,,13,8,21
,2013,140400022,,,,16,6,22
,2013,140400031,,,,7,6,13
,2013,140400032,,,,6,2,8
,2013,140400034,,,,1,5,6
,2013,140400035,,,,4,2,6
,2013,140400036,,,,11,4,15
,2013,140400037,,,,5,5,10
,2013,140400039,,,,3,1,4
,2013,140400040,,,,3,2,5
,2013,140500001,,,,29,39,68
,2013,140500001,,,,80,75,155
,2013,140500002,,,,15,13,28
,2013,140500003,,,,53,56,109
,2013,140500004,,,,14,19,33
,2013,140500005,,,,6,7,13
,2013,140500006,,,,24,24,48
,2013,140500007,,,,15,12,27
,2013,140500011,,,,7,10,17
,2013,140500022,,,,6,8,14
,2013,140500023,,,,15,16,31
,2013,140500024,,,,19,24,43
,2013,140500025,,,,7,12,19
,2013,140500026,,,,20,16,36
,2013,140500027,,,,24,23,47
,2013,140500040,,,,33,22,55
,2013,140500041,,,,12,14,26
,2013,140500042,,,,6,6,12
,2013,140500044,,,,3,6,9
,2013,140500046,,,,4,9,13
,2013,140500047,,,,3,7,10
,2013,140500048,,,,9,7,16
,2013,140500049,,,,3,1,4
,2013,140500050,,,,3,5,8
,2013,140500051,,,,1,1,2
,2013,140500052,,,,3,5,8
,2013,140600001,,,,39,59,98
,2013,140600002,,,,31,34,65
,2013,140600003,,,,14,15,29
,2013,140600003,,,,60,48,108
,2013,140600004,,,,11,9,20
,2013,140600005,,,,12,27,39
,2013,140600006,,,,3,13,16
,2013,140600007,,,,55,58,113
,2013,140600008,,,,14,11,25
,2013,140600009,,,,4,4,8
,2013,140600010,,,,25,30,55
,2013,140600012,,,,24,30,54
,2013,140600013,,,,9,5,14
,2013,140600014,,,,107,130,237
,2013,140600015,,,,7,11,18
,2013,140600018,,,,8,8,16
,2013,140600019,,,,13,14,27
,2013,140600020,,,,7,11,18
,2013,140600051,,,,9,6,15
,2013,140600052,,,,11,26,37
,2013,140700001,,,,8,11,19
,2013,140700002,,,,83,78,161
,2013,140700003,,,,18,23,41
,2013,140700004,,,,45,41,86
,2013,140700005,,,,105,90,195
,2013,140700006,,,,88,72,160
,2013,140700007,,,,22,17,39
,2013,140700008,,,,16,10,26
,2013,140700009,,,,16,17,33
,2013,140700010,,,,28,14,42
,2013,140700011,,,,18,25,43
,2013,140700012,,,,9,8,17
,2013,140700013,,,,26,22,48
,2013,140700014,,,,5,9,14
,2013,140700015,,,,16,10,26
,2013,140700016,,,,25,22,47
,2013,140700017,,,,28,45,73
,2013,140700018,,,,32,35,67
,2013,140700019,,,,25,17,42
,2013,140700020,,,,21,18,39
,2013,140700021,,,,131,228,359
,2013,140700034,,,,10,8,18
,2013,140700035,,,,6,8,14
,2013,140700038,,,,14,13,27
,2013,140700039,,,,14,20,34
,2013,140700040,,,,32,21,53
,2013,140700051,,,,6,6,12
,2013,140700052,,,,6,5,11
,2013,140700052,,,,8,7,15
,2013,140700053,,,,6,14,20
,2013,140700054,,,,6,3,9
,2013,140700055,,,,7,6,13
,2013,140700056,,,,6,6,12
,2013,140700058,,,,12,8,20
,2013,140700060,,,,7,7,14
,2013,140700061,,,,10,8,18
,2013,140700062,,,,1,3,4
,2013,140700063,,,,6,5,11
,2013,140700073,,,,2,2,4
,2013,140700074,,,,97,98,195
,2013,140800001,,,,13,7,20
,2013,140800002,,,,12,16,28
,2013,140800003,,,,105,97,202
,2013,140800004,,,,12,15,27
,2013,140800005,,,,36,39,75
,2013,140800006,,,,7,4,11
,2013,140800007,,,,5,4,9
,2013,140800008,,,,27,19,46
,2013,140800009,,,,11,10,21
,2013,140800010,,,,24,36,60
,2013,140800011,,,,11,13,24
,2013,140800012,,,,19,15,34
,2013,140800013,,,,13,13,26
,2013,140800014,,,,25,31,56
,2013,140800015,,,,11,13,24
,2013,140800016,,,,4,8,12
,2013,140800017,,,,16,15,31
,2013,140800019,,,,22,17,39
,2013,140800020,,,,51,55,106
,2013,140800022,,,,5,6,11
,2013,140800029,,,,2,4,6
,2013,140800051,,,,3,2,5
,2013,140800053,,,,9,5,14
,2013,140800055,,,,3,4,7
,2013,140800056,,,,4,3,7
,2013,140800057,,,,7,6,13
,2013,140800058,,,,6,8,14
,2013,140900002,,,,22,28,50
,2013,140900003,,,,63,61,124
,2013,140900004,,,,28,31,59
,2013,140900004,,,,5,9,14
,2013,140900005,,,,37,38,75
,2013,140900005,,,,8,25,33
,2013,140900006,,,,23,28,51
,2013,140900007,,,,17,13,30
,2013,140900008,,,,33,28,61
,2013,140900009,,,,29,21,50
,2013,140900010,,,,19,18,37
,2013,140900011,,,,23,14,37
,2013,140900012,,,,154,161,315
,2013,140900013,,,,31,28,59
,2013,140900014,,,,11,9,20
,2013,140900015,,,,30,18,48
,2013,140900016,,,,31,21,52
,2013,140900017,,,,57,42,99
,2013,140900018,,,,14,19,33
,2013,140900019,,,,7,12,19
,2013,140900020,,,,9,12,21
,2013,140900021,,,,9,4,13
,2013,140900021,,,,23,26,49
,2013,140900022,,,,16,21,37
,2013,140900022,,,,4,4,8
,2013,140900024,,,,4,8,12
,2013,140900045,,,,10,4,14
,2013,140900046,,,,5,6,11
,2013,140900047,,,,10,7,17
,2013,140900048,,,,12,12,24
,2013,140900049,,,,3,5,8
,2013,140900050,,,,8,4,12
,2013,140900063,,,,2,1,3
,2013,140900065,,,,3,6,9
,2013,140900066,,,,6,4,10
,2013,140900066,,,,6,4,10
,2013,140900068,,,,1,3,4
,2013,140900069,,,,10,12,22
,2013,140900070,,,,14,6,20
,2013,141000001,,,,19,22,41
,2013,141000002,,,,60,46,106
,2013,141000003,,,,17,23,40
,2013,141000004,,,,54,55,109
,2013,141000005,,,,39,21,60
,2013,141000006,,,,8,6,14
,2013,141000007,,,,24,28,52
,2013,141000008,,,,104,124,228
,2013,141000009,,,,22,10,32
,2013,141000010,,,,3,3,6
,2013,141000011,,,,19,13,32
,2013,141000012,,,,24,23,47
,2013,141000013,,,,6,5,11
,2013,141000014,,,,18,20,38
,2013,141000015,,,,29,26,55
,2013,141000016,,,,12,8,20
,2013,141000017,,,,5,14,19
,2013,141000018,,,,11,8,19
,2013,141000021,,,,16,17,33
,2013,141000022,,,,12,19,31
,2013,141000033,,,,5,13,18
,2013,141000037,,,,5,10,15
,2013,141000043,,,,10,10,20
,2013,141000044,,,,7,5,12
,2013,141000066,,,,10,7,17
,2013,141000067,,,,6,5,11
,2013,141000069,,,,6,11,17
,2013,141000071,,,,4,3,7
,2013,141000072,,,,4,3,7
,2013,141100002,,,,31,32,63
,2013,141100003,,,,36,27,63
,2013,141100003,,,,8,5,13
,2013,141100004,,,,79,96,175
,2013,141100005,,,,194,174,368
,2013,141100006,,,,14,8,22
,2013,141100007,,,,7,27,34
,2013,141100008,,,,16,16,32
,2013,141100009,,,,56,75,131
,2013,141100009,,,,27,43,70
,2013,141100010,,,,16,13,29
,2013,141100011,,,,20,15,35
,2013,141100012,,,,22,28,50
,2013,141100013,,,,8,10,18
,2013,141100014,,,,8,10,18
,2013,141100015,,,,4,6,10
,2013,141100016,,,,43,43,86
,2013,141100017,,,,19,22,41
,2013,141100018,,,,18,6,24
,2013,141100019,,,,91,107,198
,2013,141100030,,,,16,15,31
,2013,141100042,,,,10,10,20
,2013,141100043,,,,8,7,15
,2013,141100044,,,,3,7,10
,2013,141100046,,,,9,3,12
,2013,141100061,,,,20,24,44
,2013,141100062,,,,10,6,16
,2013,141100063,,,,2,9,11
,2013,141100064,,,,14,7,21
,2013,141100065,,,,7,6,13
,2013,141100066,,,,5,10,15
,2013,141100069,,,,6,3,9
,2013,141100071,,,,3,8,11
,2013,141100072,,,,12,13,25
,2013,141200001,,,,54,47,101
,2013,141200002,,,,51,38,89
,2013,141200003,,,,24,17,41
,2013,141200004,,,,6,9,15
,2013,141200005,,,,32,32,64
,2013,141200006,,,,29,30,59
,2013,141200006,,,,17,21,38
,2013,141200007,,,,9,14,23
,2013,141200008,,,,13,12,25
,2013,141200009,,,,4,10,14
,2013,141200010,,,,11,4,15
,2013,141200011,,,,20,21,41
,2013,141200012,,,,16,13,29
,2013,141200013,,,,17,9,26
,2013,141200014,,,,9,8,17
,2013,141200015,,,,9,7,16
,2013,141200016,,,,9,13,22
,2013,141200020,,,,9,4,13
,2013,141200022,,,,3,4,7
,2013,141200027,,,,7,5,12
,2013,141200031,,,,1,6,7
,2013,141200032,,,,13,7,20
,2013,141200033,,,,3,4,7
,2013,141200034,,,,12,10,22
,2013,141200035,,,,14,11,25
,2013,141200036,,,,6,7,13
,2013,141200037,,,,5,8,13
,2013,141200039,,,,5,2,7
,2013,141200041,,,,10,9,19
,2013,141200042,,,,7,8,15
,2013,141200044,,,,3,3,6
,2013,141200062,,,,2,5,7
,2013,141200065,,,,10,9,19
,2013,141200067,,,,3,3,6
,2013,141300001,,,,424,375,799
,2013,141300002,,,,46,91,137
,2013,141300003,,,,37,38,75
,2013,141300004,,,,26,20,46
,2013,141300005,,,,110,140,250
,2013,141300006,,,,109,88,197
,2013,141300007,,,,41,19,60
,2013,141300008,,,,50,45,95
,2013,141300009,,,,21,32,53
,2013,141300010,,,,36,53,89
,2013,141300011,,,,7,14,21
,2013,141300012,,,,24,25,49
,2013,141300013,,,,37,35,72
,2013,141300014,,,,31,21,52
,2013,141300015,,,,9,4,13
,2013,141300015,,,,37,20,57
,2013,141300017,,,,15,15,30
,2013,141300018,,,,14,18,32
,2013,141300019,,,,18,9,27
,2013,141300022,,,,9,13,22
,2013,141300023,,,,6,17,23
,2013,141300024,,,,18,11,29
,2013,141300025,,,,18,15,33
,2013,141300026,,,,31,18,49
,2013,141300027,,,,19,21,40
,2013,141300028,,,,15,12,27
,2013,141300029,,,,106,112,218
,2013,141300030,,,,20,22,42
,2013,141300032,,,,13,12,25
,2013,141300034,,,,23,27,50
,2013,141300035,,,,23,28,51
,2013,141300036,,,,19,22,41
,2013,141300037,,,,375,525,900
,2013,141300043,,,,12,11,23
,2013,141300044,,,,25,22,47
,2013,141300048,,,,15,22,37
,2013,141300048,,,,30,34,64
,2013,141300048,,,,10,6,16
,2013,141300054,,,,23,14,37
,2013,141300055,,,,15,15,30
,2013,141300056,,,,8,16,24
,2013,141300057,,,,21,16,37
,2013,141300061,,,,6,9,15
,2013,141300065,,,,19,15,34
,2013,141300066,,,,26,18,44
,2013,141300066,,,,6,1,7
,2013,141300067,,,,17,10,27
,2013,141300067,,,,26,31,57
,2013,141300067,,,,3,4,7
,2013,141300068,,,,8,14,22
,2013,141300069,,,,15,8,23
,2013,141300073,,,,19,9,28
,2013,141300075,,,,37,38,75
,2013,141300076,,,,12,9,21
,2013,141300077,,,,35,35,70
,2013,141300079,,,,9,6,15
,2013,141300081,,,,18,14,32
,2013,141300107,,,,22,12,34
,2013,141300108,,,,7,7,14
,2013,141300109,,,,11,16,27
,2013,141300110,,,,9,9,18
,2013,141300111,,,,4,6,10
,2013,141300112,,,,1,5,6
,2013,141300116,,,,5,6,11
,2013,141300117,,,,3,2,5
,2013,141300119,,,,6,11,17
,2013,141300120,,,,3,4,7
,2013,141300121,,,,2,7,9
,2013,141300122,,,,8,7,15
,2013,141300124,,,,3,1,4
,2013,141300125,,,,3,5,8
,2013,141300126,,,,5,0,5
,2013,141300128,,,,22,17,39
,2013,141300129,,,,39,16,55
,2013,141300131,,,,4,4,8
,2013,141300132,,,,8,1,9
,2013,141300133,,,,10,4,14
,2013,141300135,,,,6,26,32
,2013,141300137,,,,233,288,521
,2013,141400001,,,,40,56,96
,2013,141400002,,,,34,21,55
,2013,141400003,,,,10,10,20
,2013,141400004,,,,14,21,35
,2013,141400005,,,,6,5,11
,2013,141400006,,,,18,19,37
,2013,141400007,,,,58,66,124
,2013,141400008,,,,13,16,29
,2013,141400009,,,,21,25,46
,2013,141400010,,,,29,20,49
,2013,141400011,,,,4,4,8
,2013,141400012,,,,6,5,11
,2013,141400013,,,,31,21,52
,2013,141400014,,,,31,23,54
,2013,141400015,,,,10,16,26
,2013,141400016,,,,25,20,45
,2013,141400017,,,,17,18,35
,2013,141400032,,,,7,3,10
,2013,141400036,,,,3,7,10
,2013,141400037,,,,8,8,16
,2013,141400038,,,,8,4,12
,2013,141400039,,,,8,5,13
,2013,141400040,,,,2,2,4
,2013,141400041,,,,3,4,7
,2013,141400042,,,,4,9,13
,2013,141400046,,,,10,7,17
,2013,141400050,,,,3,3,6
,2013,141400054,,,,1,4,5
,2013,141400055,,,,2,2,4
,2013,141500001,,,,9,2,11
,2013,141500002,,,,143,154,297
,2013,141500003,,,,39,35,74
,2013,141500004,,,,31,37,68
,2013,141500005,,,,29,30,59
,2013,141500006,,,,14,7,21
,2013,141500007,,,,85,68,153
,2013,141500008,,,,141,143,284
,2013,141500009,,,,39,38,77
,2013,141500010,,,,8,5,13
,2013,141500011,,,,17,23,40
,2013,141500013,,,,25,17,42
,2013,141500014,,,,25,53,78
,2013,141500016,,,,21,10,31
,2013,141500017,,,,7,5,12
,2013,141500018,,,,5,7,12
,2013,141500019,,,,6,11,17
,2013,141500020,,,,13,9,22
,2013,141500021,,,,52,44,96
,2013,141500022,,,,20,12,32
,2013,141500023,,,,10,11,21
,2013,141500024,,,,40,27,67
,2013,141500025,,,,10,13,23
,2013,141500026,,,,11,11,22
,2013,141500027,,,,11,9,20
,2013,141500028,,,,68,95,163
,2013,141500030,,,,7,7,14
,2013,141500031,,,,1,5,6
,2013,141500032,,,,18,15,33
,2013,141500067,,,,12,8,20
,2013,141500068,,,,9,12,21
,2013,141500069,,,,3,1,4
,2013,141500070,,,,4,3,7
,2013,141500071,,,,2,5,7
,2013,141500072,,,,6,5,11
,2013,141500073,,,,5,1,6
,2013,141500074,,,,3,1,4
,2013,141500075,,,,172,179,351
,2013,141600001,,,,162,155,317
,2013,141600002,,,,11,6,17
,2013,141600003,,,,8,5,13
,2013,141600004,,,,19,11,30
,2013,141600005,,,,99,78,177
,2013,141600006,,,,15,11,26
,2013,141600007,,,,8,17,25
,2013,141600007,,,,3,3,6
,2013,141600008,,,,20,22,42
,2013,141600009,,,,4,1,5
,2013,141600010,,,,16,11,27
,2013,141600011,,,,17,11,28
,2013,141600012,,,,26,21,47
,2013,141600013,,,,26,17,43
,2013,141600014,,,,2,4,6
,2013,141600015,,,,5,5,10
,2013,141600016,,,,18,16,34
,2013,141600017,,,,13,9,22
,2013,141600018,,,,2,6,8
,2013,141600019,,,,13,11,24
,2013,141600020,,,,7,5,12
,2013,141600021,,,,10,4,14
,2013,141600022,,,,33,14,47
,2013,141600023,,,,50,55,105
,2013,141600024,,,,9,21,30
,2013,141600027,,,,5,10,15
,2013,141600028,,,,8,2,10
,2013,141600029,,,,19,13,32
,2013,141600030,,,,11,12,23
,2013,141600030,,,,46,30,76
,2013,141600030,,,,17,22,39
,2013,141600039,,,,4,7,11
,2013,141600040,,,,8,8,16
,2013,141600041,,,,6,5,11
,2013,141600044,,,,5,6,11
,2013,141600045,,,,9,10,19
,2013,141600054,,,,13,18,31
,2013,141600058,,,,1,8,9
,2013,141600060,,,,4,12,16
,2013,141600061,,,,4,9,13
,2013,141600064,,,,6,9,15
,2013,141600065,,,,2,4,6
,2013,141600066,,,,4,1,5
,2013,141600067,,,,5,2,7
,2013,141600068,,,,4,4,8
,2013,141600069,,,,2,4,6
,2013,150100001,,,,82,93,175
,2013,150100002,,,,349,412,761
,2013,150100003,,,,369,361,730
,2013,150100004,,,,38,20,58
,2013,150100005,,,,46,44,90
,2013,150100006,,,,121,128,249
,2013,150100007,,,,23,8,31
,2013,150100008,,,,12,7,19
,2013,150100009,,,,47,46,93
,2013,150100010,,,,24,30,54
,2013,150100011,,,,101,89,190
,2013,150100012,,,,14,18,32
,2013,150100013,,,,44,56,100
,2013,150100014,,,,59,40,99
,2013,150100015,,,,40,27,67
,2013,150100016,,,,123,128,251
,2013,150100017,,,,35,27,62
,2013,150100018,,,,82,68,150
,2013,150100019,,,,143,177,320
,2013,150100020,,,,319,277,596
,2013,150100021,,,,140,154,294
,2013,150100022,,,,60,49,109
,2013,150100023,,,,155,160,315
,2013,150100024,,,,163,163,326
,2013,150100025,,,,15,9,24
,2013,150100026,,,,204,206,410
,2013,150100027,,,,54,42,96
,2013,150100028,,,,52,55,107
,2013,150100030,,,,12,11,23
,2013,150100031,,,,53,54,107
,2013,150100032,,,,72,81,153
,2013,150100033,,,,96,88,184
,2013,150100034,,,,109,96,205
,2013,150100035,,,,45,43,88
,2013,150100036,,,,162,141,303
,2013,150100037,,,,53,42,95
,2013,150100038,,,,38,25,63
,2013,150100039,,,,32,30,62
,2013,150100040,,,,45,32,77
,2013,150100041,,,,36,25,61
,2013,150100042,,,,40,33,73
,2013,150100043,,,,21,18,39
,2013,150100043,,,,63,40,103
,2013,150100044,,,,91,83,174
,2013,150100045,,,,54,48,102
,2013,150100046,,,,85,103,188
,2013,150100047,,,,53,45,98
,2013,150100048,,,,38,36,74
,2013,150100049,,,,90,50,140
,2013,150100050,,,,16,14,30
,2013,150100051,,,,160,131,291
,2013,150100052,,,,25,19,44
,2013,150100053,,,,27,26,53
,2013,150100054,,,,24,10,34
,2013,150100055,,,,49,43,92
,2013,150100056,,,,8,9,17
,2013,150100057,,,,12,3,15
,2013,150100058,,,,48,32,80
,2013,150100059,,,,284,307,591
,2013,150100060,,,,15,18,33
,2013,150100061,,,,44,39,83
,2013,150100062,,,,10,13,23
,2013,150100063,,,,502,477,979
,2013,150100064,,,,39,43,82
,2013,150100064,,,,4,4,8
,2013,150100065,,,,12,14,26
,2013,150100066,,,,23,16,39
,2013,150100067,,,,44,36,80
,2013,150100068,,,,40,33,73
,2013,150100069,,,,15,6,21
,2013,150100070,,,,17,21,38
,2013,150100071,,,,37,38,75
,2013,150100072,,,,105,122,227
,2013,150100073,,,,37,35,72
,2013,150100074,,,,115,69,184
,2013,150100075,,,,117,81,198
,2013,150100076,,,,49,51,100
,2013,150100077,,,,26,30,56
,2013,150100078,,,,24,17,41
,2013,150100079,,,,12,18,30
,2013,150100080,,,,50,38,88
,2013,150100081,,,,50,42,92
,2013,150100082,,,,20,9,29
,2013,150100083,,,,10,16,26
,2013,150100084,,,,112,110,222
,2013,150100084,,,,8,7,15
,2013,150100085,,,,12,11,23
,2013,150100086,,,,17,20,37
,2013,150100087,,,,53,28,81
,2013,150100088,,,,11,7,18
,2013,150100089,,,,22,26,48
,2013,150100091,,,,41,29,70
,2013,150100092,,,,72,64,136
,2013,150100093,,,,9,8,17
,2013,150100094,,,,29,24,53
,2013,150100095,,,,17,9,26
,2013,150100096,,,,20,22,42
,2013,150100097,,,,97,81,178
,2013,150100098,,,,179,174,353
,2013,150100099,,,,12,14,26
,2013,150100100,,,,10,18,28
,2013,150100101,,,,13,10,23
,2013,150100103,,,,17,19,36
,2013,150100104,,,,24,22,46
,2013,150100105,,,,64,58,122
,2013,150100106,,,,89,80,169
,2013,150100108,,,,8,20,28
,2013,150100109,,,,33,38,71
,2013,150100110,,,,140,141,281
,2013,150100110,,,,11,24,35
,2013,150100110,,,,9,13,22
,2013,150100112,,,,26,17,43
,2013,150100113,,,,12,13,25
,2013,150100114,,,,19,8,27
,2013,150100116,,,,28,38,66
,2013,150100118,,,,2,4,6
,2013,150100118,,,,47,32,79
,2013,150100119,,,,78,58,136
,2013,150100121,,,,14,17,31
,2013,150100122,,,,10,10,20
,2013,150100123,,,,16,24,40
,2013,150100125,,,,12,16,28
,2013,150100126,,,,188,188,376
,2013,150100126,,,,132,145,277
,2013,150100126,,,,69,75,144
,2013,150100127,,,,51,43,94
,2013,150100128,,,,9,12,21
,2013,150100129,,,,11,11,22
,2013,150100130,,,,24,18,42
,2013,150100130,,,,181,185,366
,2013,150100130,,,,79,89,168
,2013,150100131,,,,32,33,65
,2013,150100132,,,,23,22,45
,2013,150100133,,,,27,29,56
,2013,150100134,,,,15,13,28
,2013,150100135,,,,8,13,21
,2013,150100135,,,,52,80,132
,2013,150100135,,,,56,64,120
,2013,150100136,,,,90,95,185
,2013,150100137,,,,13,7,20
,2013,150100138,,,,22,26,48
,2013,150100139,,,,26,22,48
,2013,150100140,,,,7,10,17
,2013,150100142,,,,12,6,18
,2013,150100143,,,,20,16,36
,2013,150100145,,,,11,9,20
,2013,150100146,,,,127,117,244
,2013,150100147,,,,28,22,50
,2013,150100148,,,,36,34,70
,2013,150100149,,,,14,10,24
,2013,150100150,,,,17,17,34
,2013,150100151,,,,10,8,18
,2013,150100152,,,,8,4,12
,2013,150100153,,,,6,6,12
,2013,150100154,,,,6,5,11
,2013,150100155,,,,29,27,56
,2013,150100155,,,,121,93,214
,2013,150100156,,,,9,13,22
,2013,150100157,,,,18,12,30
,2013,150100158,,,,18,26,44
,2013,150100159,,,,6,9,15
,2013,150100160,,,,12,12,24
,2013,150100161,,,,14,11,25
,2013,150100162,,,,7,8,15
,2013,150100164,,,,12,7,19
,2013,150100165,,,,22,24,46
,2013,150100166,,,,9,3,12
,2013,150100166,,,,27,45,72
,2013,150100167,,,,13,12,25
,2013,150100168,,,,134,138,272
,2013,150100169,,,,1170,1374,2544
,2013,150100170,,,,38,39,77
,2013,150100170,,,,37,37,74
,2013,150100170,,,,14,7,21
,2013,150100171,,,,101,152,253
,2013,150100173,,,,105,185,290
,2013,150100174,,,,13,14,27
,2013,150100174,,,,17,13,30
,2013,150100174,,,,56,61,117
,2013,150100175,,,,36,29,65
,2013,150100176,,,,35,15,50
,2013,150100176,,,,3,3,6
,2013,150100178,,,,12,11,23
,2013,150100179,,,,2,12,14
,2013,150100179,,,,109,99,208
,2013,150100180,,,,11,9,20
,2013,150100182,,,,69,45,114
,2013,150100183,,,,49,40,89
,2013,150100184,,,,18,17,35
,2013,150100185,,,,14,5,19
,2013,150100186,,,,8,11,19
,2013,150100187,,,,35,32,67
,2013,150100188,,,,27,20,47
,2013,150100189,,,,210,235,445
,2013,150100192,,,,12,20,32
,2013,150100193,,,,14,8,22
,2013,150100194,,,,3,2,5
,2013,150100195,,,,18,12,30
,2013,150100197,,,,6,6,12
,2013,150100198,,,,12,16,28
,2013,150100199,,,,6,4,10
,2013,150100200,,,,14,3,17
,2013,150100201,,,,16,10,26
,2013,150100202,,,,16,52,68
,2013,150100203,,,,82,87,169
,2013,150100204,,,,13,8,21
,2013,150100206,,,,17,9,26
,2013,150100209,,,,271,281,552
,2013,150100211,,,,55,46,101
,2013,150100212,,,,12,8,20
,2013,150100214,,,,64,51,115
,2013,150100217,,,,31,24,55
,2013,150100218,,,,77,73,150
,2013,150100220,,,,37,56,93
,2013,150100221,,,,45,2,47
,2013,150100223,,,,24,28,52
,2013,150100226,,,,20,21,41
,2013,150100226,,,,4,6,10
,2013,150100227,,,,50,53,103
,2013,150100227,,,,41,68,109
,2013,150100227,,,,3,1,4
,2013,150100228,,,,260,273,533
,2013,150100229,,,,24,16,40
,2013,150100231,,,,26,19,45
,2013,150100233,,,,31,28,59
,2013,150100234,,,,18,16,34
,2013,150100235,,,,26,11,37
,2013,150100236,,,,29,33,62
,2013,150100241,,,,6,6,12
,2013,150100241,,,,8,17,25
,2013,150100241,,,,5,2,7
,2013,150100242,,,,4,17,21
,2013,150100243,,,,22,28,50
,2013,150100243,,,,4,3,7
,2013,150100244,,,,11,12,23
,2013,150100245,,,,9,15,24
,2013,150100246,,,,14,13,27
,2013,150100248,,,,68,176,244
,2013,150100249,,,,29,27,56
,2013,150100252,,,,15,19,34
,2013,150100253,,,,9,6,15
,2013,150100254,,,,6,6,12
,2013,150100255,,,,3,8,11
,2013,150100257,,,,8,2,10
,2013,150100259,,,,7,4,11
,2013,150100264,,,,4,8,12
,2013,150100267,,,,7,1,8
,2013,150100270,,,,5,3,8
,2013,150100271,,,,17,0,17
,2013,150100272,,,,6,4,10
,2013,150100274,,,,4,7,11
,2013,150100275,,,,4,8,12
,2013,150100318,,,,46,34,80
,2013,150100324,,,,81,70,151
,2013,150100324,,,,28,29,57
,2013,150100324,,,,8,4,12
,2013,150100325,,,,16,16,32
,2013,150100326,,,,12,15,27
,2013,150100327,,,,11,3,14
,2013,150100328,,,,12,17,29
,2013,150100329,,,,20,28,48
,2013,150100330,,,,25,25,50
,2013,150100331,,,,16,19,35
,2013,150100332,,,,26,18,44
,2013,150100333,,,,21,20,41
,2013,150100334,,,,18,18,36
,2013,150100335,,,,15,14,29
,2013,150100336,,,,19,28,47
,2013,150100337,,,,4,8,12
,2013,150100338,,,,8,5,13
,2013,150100339,,,,11,13,24
,2013,150100340,,,,7,9,16
,2013,150100341,,,,4,5,9
,2013,150100346,,,,10,10,20
,2013,150100348,,,,6,5,11
,2013,150100349,,,,6,2,8
,2013,150100353,,,,4,5,9
,2013,150100354,,,,8,5,13
,2013,150100355,,,,6,9,15
,2013,150100357,,,,5,4,9
,2013,150100362,,,,10,9,19
,2013,150100367,,,,2,6,8
,2013,150100368,,,,8,6,14
,2013,150100370,,,,13,14,27
,2013,150100371,,,,2,5,7
,2013,150100372,,,,6,4,10
,2013,150100373,,,,4,6,10
,2013,150100375,,,,3,6,9
,2013,150100376,,,,13,21,34
,2013,150100377,,,,15,15,30
,2013,150100378,,,,15,11,26
,2013,150100379,,,,9,5,14
,2013,150100380,,,,16,12,28
,2013,150100381,,,,7,3,10
,2013,150100382,,,,6,1,7
,2013,150100383,,,,8,7,15
,2013,150100385,,,,5,12,17
,2013,150100386,,,,9,7,16
,2013,150100387,,,,7,9,16
,2013,150100389,,,,138,160,298
,2013,150100390,,,,23,14,37
,2013,150100391,,,,16,6,22
,2013,150100392,,,,6,9,15
,2013,150100394,,,,4,3,7
,2013,150100395,,,,5,2,7
,2013,150100398,,,,15,11,26
,2013,150100399,,,,10,13,23
,2013,150100400,,,,8,3,11
,2013,150100401,,,,30,80,110
,2013,150100402,,,,11,21,32
,2013,150100403,,,,10,12,22
,2013,150100405,,,,38,31,69
,2013,150100405,,,,3,12,15
,2013,150100405,,,,68,56,124
,2013,150100406,,,,4,3,7
,2013,150100406,,,,11,8,19
,2013,150100407,,,,3,6,9
,2013,150100408,,,,4,4,8
,2013,150100409,,,,4,3,7
,2013,150100410,,,,2,4,6
,2013,150100411,,,,5,3,8
,2013,150100412,,,,4,10,14
,2013,150100413,,,,3,2,5
,2013,150100414,,,,12,5,17
,2013,150100415,,,,9,9,18
,2013,150100421,,,,15,10,25
,2013,150100423,,,,15,16,31
,2013,150100424,,,,15,17,32
,2013,150100425,,,,15,16,31
,2013,150100427,,,,9,16,25
,2013,150100446,,,,16,26,42
,2013,150200001,,,,22,19,41
,2013,150200002,,,,260,255,515
,2013,150200003,,,,34,33,67
,2013,150200004,,,,9,18,27
,2013,150200005,,,,12,13,25
,2013,150200006,,,,18,12,30
,2013,150200007,,,,34,21,55
,2013,150200008,,,,10,15,25
,2013,150200009,,,,44,42,86
,2013,150200010,,,,103,82,185
,2013,150200012,,,,23,24,47
,2013,150200013,,,,13,14,27
,2013,150200014,,,,271,273,544
,2013,150200015,,,,14,14,28
,2013,150200016,,,,16,19,35
,2013,150200017,,,,2,4,6
,2013,150200017,,,,15,12,27
,2013,150200018,,,,22,20,42
,2013,150200019,,,,41,35,76
,2013,150200020,,,,7,11,18
,2013,150200021,,,,19,31,50
,2013,150200022,,,,43,46,89
,2013,150200023,,,,24,32,56
,2013,150200023,,,,6,3,9
,2013,150200024,,,,20,17,37
,2013,150200025,,,,20,13,33
,2013,150200026,,,,14,16,30
,2013,150200027,,,,26,18,44
,2013,150200028,,,,55,69,124
,2013,150200030,,,,36,52,88
,2013,150200030,,,,7,8,15
,2013,150200031,,,,30,23,53
,2013,150200032,,,,17,34,51
,2013,150200034,,,,8,8,16
,2013,150200036,,,,17,22,39
,2013,150200037,,,,43,39,82
,2013,150200038,,,,22,27,49
,2013,150200042,,,,11,15,26
,2013,150200043,,,,8,8,16
,2013,150200047,,,,20,19,39
,2013,150200048,,,,19,25,44
,2013,150200049,,,,29,22,51
,2013,150200050,,,,33,27,60
,2013,150200051,,,,26,26,52
,2013,150200052,,,,17,9,26
,2013,150200053,,,,12,12,24
,2013,150200054,,,,17,14,31
,2013,150200055,,,,12,12,24
,2013,150200056,,,,37,34,71
,2013,150200057,,,,27,20,47
,2013,150200058,,,,9,9,18
,2013,150200058,,,,23,22,45
,2013,150200059,,,,523,613,1136
,2013,150200060,,,,25,20,45
,2013,150200062,,,,24,25,49
,2013,150200063,,,,10,15,25
,2013,150200064,,,,14,10,24
,2013,150200069,,,,22,15,37
,2013,150200070,,,,29,31,60
,2013,150200071,,,,8,7,15
,2013,150200072,,,,409,498,907
,2013,150200073,,,,3,3,6
,2013,150200074,,,,6,3,9
,2013,150200075,,,,6,1,7
,2013,150200076,,,,5,3,8
,2013,150200077,,,,4,5,9
,2013,150200079,,,,3,2,5
,2013,150200080,,,,6,5,11
,2013,150200081,,,,1,3,4
,2013,150200083,,,,4,3,7
,2013,150200084,,,,8,5,13
,2013,150200085,,,,2,2,4
,2013,150200086,,,,4,3,7
,2013,150200087,,,,10,8,18
,2013,150200088,,,,3,4,7
,2013,150200089,,,,48,30,78
,2013,150200090,,,,50,34,84
,2013,150200091,,,,32,15,47
,2013,150200093,,,,6,1,7
,2013,150200094,,,,5,1,6
,2013,150200095,,,,14,5,19
,2013,150200096,,,,4,4,8
,2013,150200098,,,,2,4,6
,2013,150200099,,,,4,3,7
,2013,150200104,,,,3,2,5
,2013,150200107,,,,4,2,6
,2013,150200108,,,,5,1,6
,2013,150200109,,,,5,5,10
,2013,150200110,,,,27,26,53
,2013,150200111,,,,2,3,5
,2013,150200113,,,,1,2,3
,2013,150200118,,,,5,3,8
,2013,150300001,,,,28,25,53
,2013,150300002,,,,15,12,27
,2013,150300003,,,,21,18,39
,2013,150300004,,,,20,20,40
,2013,150300005,,,,31,28,59
,2013,150300005,,,,1,8,9
,2013,150300007,,,,322,295,617
,2013,150300008,,,,64,65,129
,2013,150300008,,,,12,21,33
,2013,150300009,,,,40,32,72
,2013,150300010,,,,55,57,112
,2013,150300011,,,,44,34,78
,2013,150300012,,,,96,75,171
,2013,150300013,,,,35,40,75
,2013,150300014,,,,13,8,21
,2013,150300015,,,,147,127,274
,2013,150300016,,,,59,71,130
,2013,150300017,,,,32,28,60
,2013,150300018,,,,24,36,60
,2013,150300019,,,,45,34,79
,2013,150300020,,,,53,43,96
,2013,150300021,,,,58,69,127
,2013,150300022,,,,41,58,99
,2013,150300022,,,,94,86,180
,2013,150300023,,,,91,91,182
,2013,150300024,,,,22,23,45
,2013,150300025,,,,66,81,147
,2013,150300026,,,,25,16,41
,2013,150300027,,,,216,219,435
,2013,150300030,,,,11,14,25
,2013,150300031,,,,95,87,182
,2013,150300032,,,,13,23,36
,2013,150300033,,,,23,36,59
,2013,150300034,,,,67,69,136
,2013,150300035,,,,28,18,46
,2013,150300037,,,,86,67,153
,2013,150300038,,,,60,66,126
,2013,150300039,,,,9,23,32
,2013,150300040,,,,144,136,280
,2013,150300041,,,,28,32,60
,2013,150300042,,,,19,14,33
,2013,150300043,,,,123,137,260
,2013,150300044,,,,70,83,153
,2013,150300045,,,,186,172,358
,2013,150300046,,,,21,25,46
,2013,150300047,,,,12,8,20
,2013,150300048,,,,57,66,123
,2013,150300049,,,,48,52,100
,2013,150300050,,,,23,24,47
,2013,150300051,,,,30,28,58
,2013,150300052,,,,36,42,78
,2013,150300053,,,,16,16,32
,2013,150300054,,,,17,9,26
,2013,150300055,,,,28,35,63
,2013,150300056,,,,54,27,81
,2013,150300057,,,,16,10,26
,2013,150300058,,,,14,22,36
,2013,150300059,,,,16,14,30
,2013,150300060,,,,8,8,16
,2013,150300061,,,,19,9,28
,2013,150300062,,,,5,7,12
,2013,150300063,,,,15,7,22
,2013,150300064,,,,20,23,43
,2013,150300065,,,,47,35,82
,2013,150300066,,,,28,24,52
,2013,150300067,,,,304,311,615
,2013,150300068,,,,230,246,476
,2013,150300070,,,,25,32,57
,2013,150300071,,,,40,22,62
,2013,150300072,,,,12,14,26
,2013,150300073,,,,7,14,21
,2013,150300074,,,,25,15,40
,2013,150300075,,,,42,46,88
,2013,150300076,,,,19,19,38
,2013,150300077,,,,209,220,429
,2013,150300078,,,,31,38,69
,2013,150300079,,,,37,26,63
,2013,150300080,,,,9,10,19
,2013,150300081,,,,10,8,18
,2013,150300083,,,,9,14,23
,2013,150300084,,,,12,13,25
,2013,150300085,,,,94,105,199
,2013,150300086,,,,14,18,32
,2013,150300087,,,,15,21,36
,2013,150300088,,,,16,9,25
,2013,150300089,,,,23,19,42
,2013,150300090,,,,18,16,34
,2013,150300091,,,,13,7,20
,2013,150300092,,,,1281,1347,2628
,2013,150300093,,,,12,10,22
,2013,150300094,,,,19,12,31
,2013,150300095,,,,12,12,24
,2013,150300096,,,,16,14,30
,2013,150300097,,,,46,42,88
,2013,150300097,,,,9,8,17
,2013,150300098,,,,18,11,29
,2013,150300099,,,,170,151,321
,2013,150300100,,,,9,13,22
,2013,150300101,,,,14,9,23
,2013,150300102,,,,7,12,19
,2013,150300103,,,,14,15,29
,2013,150300104,,,,21,9,30
,2013,150300105,,,,15,9,24
,2013,150300106,,,,21,12,33
,2013,150300107,,,,6,14,20
,2013,150300108,,,,19,6,25
,2013,150300109,,,,16,24,40
,2013,150300110,,,,14,6,20
,2013,150300111,,,,34,23,57
,2013,150300112,,,,36,40,76
,2013,150300112,,,,42,49,91
,2013,150300112,,,,122,24,146
,2013,150300113,,,,36,28,64
,2013,150300114,,,,27,31,58
,2013,150300114,,,,6,5,11
,2013,150300115,,,,21,11,32
,2013,150300116,,,,45,39,84
,2013,150300118,,,,13,17,30
,2013,150300119,,,,18,5,23
,2013,150300120,,,,33,25,58
,2013,150300122,,,,19,30,49
,2013,150300122,,,,4,6,10
,2013,150300123,,,,10,7,17
,2013,150300124,,,,231,200,431
,2013,150300125,,,,37,33,70
,2013,150300126,,,,26,21,47
,2013,150300128,,,,158,142,300
,2013,150300129,,,,30,27,57
,2013,150300130,,,,11,9,20
,2013,150300131,,,,17,24,41
,2013,150300132,,,,24,27,51
,2013,150300133,,,,14,18,32
,2013,150300134,,,,469,492,961
,2013,150300135,,,,47,33,80
,2013,150300135,,,,7,5,12
,2013,150300136,,,,57,49,106
,2013,150300137,,,,43,28,71
,2013,150300138,,,,123,100,223
,2013,150300139,,,,16,18,34
,2013,150300140,,,,12,14,26
,2013,150300141,,,,34,34,68
,2013,150300142,,,,12,15,27
,2013,150300142,,,,31,31,62
,2013,150300142,,,,31,31,62
,2013,150300143,,,,16,10,26
,2013,150300145,,,,10,18,28
,2013,150300146,,,,28,29,57
,2013,150300147,,,,45,46,91
,2013,150300148,,,,83,73,156
,2013,150300151,,,,22,36,58
,2013,150300152,,,,19,21,40
,2013,150300153,,,,17,10,27
,2013,150300154,,,,20,17,37
,2013,150300155,,,,17,14,31
,2013,150300156,,,,18,11,29
,2013,150300157,,,,46,39,85
,2013,150300158,,,,14,14,28
,2013,150300159,,,,54,51,105
,2013,150300160,,,,8,15,23
,2013,150300161,,,,12,12,24
,2013,150300163,,,,12,15,27
,2013,150300164,,,,15,11,26
,2013,150300166,,,,5,11,16
,2013,150300166,,,,50,49,99
,2013,150300169,,,,47,64,111
,2013,150300170,,,,102,29,131
,2013,150300171,,,,108,152,260
,2013,150300171,,,,120,172,292
,2013,150300172,,,,222,197,419
,2013,150300173,,,,14,11,25
,2013,150300179,,,,8,17,25
,2013,150300180,,,,14,12,26
,2013,150300181,,,,7,6,13
,2013,150300181,,,,29,25,54
,2013,150300182,,,,25,25,50
,2013,150300183,,,,11,9,20
,2013,150300184,,,,14,8,22
,2013,150300185,,,,18,8,26
,2013,150300186,,,,21,20,41
,2013,150300187,,,,23,20,43
,2013,150300188,,,,18,13,31
,2013,150300189,,,,10,7,17
,2013,150300190,,,,11,7,18
,2013,150300191,,,,11,12,23
,2013,150300192,,,,13,9,22
,2013,150300196,,,,6,3,9
,2013,150300197,,,,18,18,36
,2013,150300198,,,,10,7,17
,2013,150300199,,,,18,22,40
,2013,150300201,,,,23,23,46
,2013,150300202,,,,12,4,16
,2013,150300203,,,,28,21,49
,2013,150300204,,,,16,8,24
,2013,150300205,,,,23,19,42
,2013,150300206,,,,26,22,48
,2013,150300207,,,,15,13,28
,2013,150300209,,,,25,23,48
,2013,150300212,,,,28,18,46
,2013,150300216,,,,34,19,53
,2013,150300220,,,,20,19,39
,2013,150300221,,,,14,11,25
,2013,150300222,,,,8,13,21
,2013,150300223,,,,21,25,46
,2013,150300224,,,,24,25,49
,2013,150300225,,,,12,8,20
,2013,150300226,,,,12,7,19
,2013,150300228,,,,14,10,24
,2013,150300229,,,,20,21,41
,2013,150300230,,,,11,12,23
,2013,150300231,,,,50,51,101
,2013,150300234,,,,162,188,350
,2013,150300235,,,,7,14,21
,2013,150300236,,,,21,21,42
,2013,150300237,,,,13,11,24
,2013,150300238,,,,42,35,77
,2013,150300239,,,,17,26,43
,2013,150300240,,,,11,6,17
,2013,150300241,,,,12,8,20
,2013,150300242,,,,17,14,31
,2013,150300243,,,,10,5,15
,2013,150300245,,,,10,7,17
,2013,150300246,,,,9,15,24
,2013,150300247,,,,15,11,26
,2013,150300248,,,,27,15,42
,2013,150300249,,,,10,6,16
,2013,150300250,,,,12,11,23
,2013,150300251,,,,13,10,23
,2013,150300253,,,,74,54,128
,2013,150300255,,,,14,20,34
,2013,150300256,,,,14,9,23
,2013,150300257,,,,57,48,105
,2013,150300258,,,,12,13,25
,2013,150300259,,,,23,28,51
,2013,150300260,,,,15,16,31
,2013,150300261,,,,88,65,153
,2013,150300262,,,,11,13,24
,2013,150300263,,,,18,32,50
,2013,150300264,,,,17,6,23
,2013,150300265,,,,10,14,24
,2013,150300266,,,,314,410,724
,2013,150300268,,,,45,33,78
,2013,150300268,,,,14,8,22
,2013,150300269,,,,537,717,1254
,2013,150300270,,,,24,32,56
,2013,150300271,,,,8,10,18
,2013,150300272,,,,14,15,29
,2013,150300273,,,,7,10,17
,2013,150300274,,,,15,17,32
,2013,150300275,,,,7,12,19
,2013,150300276,,,,11,6,17
,2013,150300277,,,,20,19,39
,2013,150300281,,,,11,11,22
,2013,150300282,,,,12,7,19
,2013,150300283,,,,13,7,20
,2013,150300285,,,,12,6,18
,2013,150300286,,,,34,15,49
,2013,150300287,,,,6,16,22
,2013,150300290,,,,7,6,13
,2013,150300291,,,,6,1,7
,2013,150300294,,,,5,3,8
,2013,150300295,,,,4,3,7
,2013,150300296,,,,9,10,19
,2013,150300297,,,,10,2,12
,2013,150300298,,,,7,3,10
,2013,150300299,,,,7,5,12
,2013,150300300,,,,7,2,9
,2013,150300301,,,,12,13,25
,2013,150300302,,,,4,3,7
,2013,150300303,,,,2,6,8
,2013,150300304,,,,4,3,7
,2013,150300306,,,,9,2,11
,2013,150300307,,,,7,3,10
,2013,150300310,,,,3,6,9
,2013,150300311,,,,2,7,9
,2013,150300312,,,,6,7,13
,2013,150300314,,,,5,7,12
,2013,150300319,,,,6,5,11
,2013,150300372,,,,16,11,27
,2013,150300373,,,,28,18,46
,2013,150300374,,,,29,19,48
,2013,150300384,,,,16,16,32
,2013,150300386,,,,12,11,23
,2013,150300387,,,,21,22,43
,2013,150300388,,,,13,8,21
,2013,150300389,,,,10,12,22
,2013,150300390,,,,14,11,25
,2013,150300391,,,,33,24,57
,2013,150300393,,,,2,6,8
,2013,150300394,,,,5,9,14
,2013,150300395,,,,6,6,12
,2013,150300398,,,,4,10,14
,2013,150300399,,,,5,4,9
,2013,150300402,,,,7,5,12
,2013,150300404,,,,4,4,8
,2013,150300408,,,,6,4,10
,2013,150300409,,,,6,4,10
,2013,150300410,,,,7,2,9
,2013,150300411,,,,9,3,12
,2013,150300412,,,,6,9,15
,2013,150300414,,,,15,13,28
,2013,150300414,,,,7,10,17
,2013,150300414,,,,7,10,17
,2013,150300415,,,,10,16,26
,2013,150300415,,,,21,19,40
,2013,150300417,,,,5,4,9
,2013,150300418,,,,4,3,7
,2013,150300419,,,,2,6,8
,2013,150300420,,,,7,3,10
,2013,150300421,,,,6,5,11
,2013,150300424,,,,6,4,10
,2013,150300430,,,,4,5,9
,2013,150300431,,,,6,6,12
,2013,150300432,,,,16,29,45
,2013,150300432,,,,6,2,8
,2013,150300434,,,,30,38,68
,2013,150300436,,,,7,4,11
,2013,150300438,,,,8,2,10
,2013,150300440,,,,5,2,7
,2013,150300442,,,,3,6,9
,2013,150300444,,,,8,3,11
,2013,150300446,,,,4,2,6
,2013,150300450,,,,27,28,55
,2013,150300450,,,,51,59,110
,2013,150300450,,,,63,67,130
,2013,150300451,,,,14,12,26
,2013,150300452,,,,29,28,57
,2013,150300453,,,,4,5,9
,2013,150300454,,,,7,2,9
,2013,150300455,,,,9,8,17
,2013,150300457,,,,16,26,42
,2013,150300458,,,,12,21,33
,2013,150300459,,,,35,50,85
,2013,150300460,,,,15,6,21
,2013,150300462,,,,9,8,17
,2013,150300463,,,,12,3,15
,2013,150300464,,,,9,1,10
,2013,150300474,,,,20,29,49
,2013,150300475,,,,19,31,50
,2013,150300476,,,,28,47,75
,2013,150300510,,,,295,505,800
,2013,150400001,,,,19,19,38
,2013,150400002,,,,6,12,18
,2013,150400003,,,,56,48,104
,2013,150400004,,,,5,2,7
,2013,150400005,,,,12,10,22
,2013,150400006,,,,20,13,33
,2013,150400007,,,,21,29,50
,2013,150400008,,,,14,8,22
,2013,150400009,,,,27,23,50
,2013,150400010,,,,87,51,138
,2013,150400011,,,,29,35,64
,2013,150400012,,,,68,64,132
,2013,150400013,,,,49,58,107
,2013,150400014,,,,12,8,20
,2013,150400015,,,,29,26,55
,2013,150400017,,,,24,25,49
,2013,150400018,,,,10,13,23
,2013,150400019,,,,12,6,18
,2013,150400020,,,,13,9,22
,2013,150400021,,,,16,16,32
,2013,150400022,,,,13,6,19
,2013,150400023,,,,138,157,295
,2013,150400024,,,,8,10,18
,2013,150400025,,,,21,24,45
,2013,150400027,,,,7,5,12
,2013,150400028,,,,66,51,117
,2013,150400029,,,,20,12,32
,2013,150400040,,,,7,2,9
,2013,150400042,,,,5,4,9
,2013,150400043,,,,9,2,11
,2013,150400044,,,,6,3,9
,2013,150400046,,,,6,9,15
,2013,150500001,,,,39,31,70
,2013,150500002,,,,14,13,27
,2013,150500003,,,,5,12,17
,2013,150500004,,,,172,198,370
,2013,150500005,,,,9,5,14
,2013,150500007,,,,5,7,12
,2013,150500008,,,,30,17,47
,2013,150500009,,,,9,8,17
,2013,150500009,,,,68,76,144
,2013,150500010,,,,21,22,43
,2013,150500011,,,,29,29,58
,2013,150500012,,,,21,10,31
,2013,150500013,,,,15,13,28
,2013,150500014,,,,31,29,60
,2013,150500015,,,,25,24,49
,2013,150500016,,,,68,74,142
,2013,150500017,,,,13,16,29
,2013,150500018,,,,19,15,34
,2013,150500019,,,,38,29,67
,2013,150500020,,,,42,37,79
,2013,150500021,,,,8,10,18
,2013,150500022,,,,162,152,314
,2013,150500023,,,,88,99,187
,2013,150500024,,,,7,9,16
,2013,150500025,,,,40,47,87
,2013,150500026,,,,26,18,44
,2013,150500027,,,,24,19,43
,2013,150500028,,,,34,33,67
,2013,150500029,,,,18,26,44
,2013,150500030,,,,14,9,23
,2013,150500031,,,,23,18,41
,2013,150500032,,,,35,40,75
,2013,150500033,,,,56,51,107
,2013,150500034,,,,9,6,15
,2013,150500035,,,,16,16,32
,2013,150500036,,,,1,7,8
,2013,150500036,,,,32,39,71
,2013,150500037,,,,26,22,48
,2013,150500038,,,,20,23,43
,2013,150500039,,,,13,37,50
,2013,150500040,,,,17,15,32
,2013,150500041,,,,21,14,35
,2013,150500043,,,,16,7,23
,2013,150500045,,,,18,7,25
,2013,150500046,,,,15,17,32
,2013,150500047,,,,23,32,55
,2013,150500048,,,,15,18,33
,2013,150500049,,,,75,50,125
,2013,150500050,,,,26,35,61
,2013,150500051,,,,41,44,85
,2013,150500052,,,,17,11,28
,2013,150500055,,,,41,41,82
,2013,150500056,,,,16,13,29
,2013,150500057,,,,60,30,90
,2013,150500058,,,,11,9,20
,2013,150500059,,,,8,5,13
,2013,150500060,,,,21,21,42
,2013,150500061,,,,8,8,16
,2013,150500063,,,,210,280,490
,2013,150500064,,,,6,10,16
,2013,150500065,,,,10,11,21
,2013,150500066,,,,14,15,29
,2013,150500068,,,,13,7,20
,2013,150500070,,,,8,7,15
,2013,150500072,,,,8,19,27
,2013,150500074,,,,8,12,20
,2013,150500075,,,,27,21,48
,2013,150500076,,,,27,21,48
,2013,150500077,,,,17,21,38
,2013,150500078,,,,8,11,19
,2013,150500079,,,,24,10,34
,2013,150500080,,,,17,14,31
,2013,150500081,,,,17,11,28
,2013,150500082,,,,10,12,22
,2013,150500083,,,,16,16,32
,2013,150500086,,,,22,18,40
,2013,150500088,,,,9,7,16
,2013,150500090,,,,11,7,18
,2013,150500091,,,,9,7,16
,2013,150500092,,,,10,15,25
,2013,150500093,,,,9,6,15
,2013,150500094,,,,18,9,27
,2013,150500098,,,,25,22,47
,2013,150500099,,,,24,25,49
,2013,150500101,,,,9,15,24
,2013,150500102,,,,38,42,80
,2013,150500103,,,,8,12,20
,2013,150500104,,,,54,40,94
,2013,150500105,,,,12,9,21
,2013,150500106,,,,18,15,33
,2013,150500107,,,,186,247,433
,2013,150500107,,,,16,21,37
,2013,150500108,,,,99,113,212
,2013,150500110,,,,19,25,44
,2013,150500111,,,,21,23,44
,2013,150500112,,,,12,7,19
,2013,150500114,,,,10,9,19
,2013,150500115,,,,22,20,42
,2013,150500116,,,,11,11,22
,2013,150500117,,,,14,20,34
,2013,150500118,,,,19,15,34
,2013,150500121,,,,26,25,51
,2013,150500125,,,,32,28,60
,2013,150500127,,,,8,16,24
,2013,150500128,,,,19,19,38
,2013,150500129,,,,10,6,16
,2013,150500130,,,,5,4,9
,2013,150500140,,,,8,5,13
,2013,150500143,,,,4,3,7
,2013,150500144,,,,3,7,10
,2013,150500145,,,,7,17,24
,2013,150500177,,,,39,21,60
,2013,150500178,,,,29,18,47
,2013,150500179,,,,11,9,20
,2013,150500183,,,,23,21,44
,2013,150500184,,,,16,13,29
,2013,150500185,,,,7,7,14
,2013,150500186,,,,4,5,9
,2013,150500187,,,,4,5,9
,2013,150500189,,,,3,3,6
,2013,150500190,,,,7,5,12
,2013,150500192,,,,1,6,7
,2013,150500193,,,,2,9,11
,2013,150500194,,,,11,9,20
,2013,150500195,,,,6,3,9
,2013,150500197,,,,3,10,13
,2013,150500201,,,,14,6,20
,2013,150500202,,,,2,6,8
,2013,150500203,,,,7,7,14
,2013,150500206,,,,6,5,11
,2013,150500207,,,,4,6,10
,2013,150500208,,,,4,4,8
,2013,150500209,,,,5,5,10
,2013,150500211,,,,3,3,6
,2013,150500212,,,,6,7,13
,2013,150500214,,,,3,3,6
,2013,150500215,,,,4,6,10
,2013,150500217,,,,5,2,7
,2013,150500218,,,,4,5,9
,2013,150500219,,,,4,2,6
,2013,150500220,,,,10,17,27
,2013,150500221,,,,8,2,10
,2013,150500222,,,,8,4,12
,2013,150500223,,,,10,13,23
,2013,150500226,,,,7,10,17
,2013,150500227,,,,9,1,10
,2013,150600001,,,,49,33,82
,2013,150600004,,,,85,93,178
,2013,150600007,,,,30,18,48
,2013,150600009,,,,11,16,27
,2013,150600011,,,,14,13,27
,2013,150600012,,,,12,11,23
,2013,150600013,,,,186,189,375
,2013,150600016,,,,4,1,5
,2013,150600036,,,,9,4,13
,2013,150600037,,,,14,13,27
,2013,150600048,,,,3,2,5
,2013,150600050,,,,2,3,5
,2013,150600051,,,,4,2,6
,2013,150600052,,,,3,2,5
,2013,150600053,,,,2,3,5
,2013,150600055,,,,1,4,5
,2013,150600056,,,,2,3,5
,2013,150600057,,,,0,5,5
,2013,150600058,,,,3,2,5
,2013,150600059,,,,1,4,5
,2013,150600060,,,,3,2,5
,2013,150600061,,,,2,3,5
,2013,150600062,,,,2,3,5
,2013,150600063,,,,3,2,5
,2013,150600065,,,,2,2,4
,2013,150600066,,,,2,3,5
,2013,150600067,,,,1,4,5
,2013,150600068,,,,3,2,5
,2013,150600069,,,,14,9,23
,2013,150600070,,,,6,10,16
,2013,150600071,,,,11,15,26
,2013,150600072,,,,8,11,19
,2013,150600074,,,,2,3,5
,2013,150600075,,,,3,2,5
,2013,150600076,,,,2,3,5
,2013,150700001,,,,55,62,117
,2013,150700001,,,,73,64,137
,2013,150700002,,,,75,73,148
,2013,150700003,,,,35,48,83
,2013,150700004,,,,18,18,36
,2013,150700005,,,,31,22,53
,2013,150700006,,,,26,50,76
,2013,150700007,,,,54,59,113
,2013,150700008,,,,67,75,142
,2013,150700009,,,,21,29,50
,2013,150700010,,,,23,24,47
,2013,150700012,,,,72,60,132
,2013,150700013,,,,13,8,21
,2013,150700015,,,,11,9,20
,2013,150700016,,,,25,22,47
,2013,150700017,,,,28,28,56
,2013,150700018,,,,4,7,11
,2013,150700019,,,,12,3,15
,2013,150700020,,,,14,17,31
,2013,150700021,,,,24,21,45
,2013,150700022,,,,73,74,147
,2013,150700023,,,,12,16,28
,2013,150700024,,,,5,8,13
,2013,150700025,,,,12,11,23
,2013,150700026,,,,15,14,29
,2013,150700027,,,,28,19,47
,2013,150700028,,,,9,16,25
,2013,150700029,,,,5,13,18
,2013,150700031,,,,10,7,17
,2013,150700032,,,,12,11,23
,2013,150700033,,,,12,7,19
,2013,150700034,,,,27,28,55
,2013,150700035,,,,40,34,74
,2013,150700036,,,,14,24,38
,2013,150700037,,,,5,9,14
,2013,150700039,,,,2,4,6
,2013,150700040,,,,4,5,9
,2013,150700041,,,,3,2,5
,2013,150700042,,,,1,5,6
,2013,150700043,,,,7,11,18
,2013,150700044,,,,7,4,11
,2013,150700045,,,,46,65,111
,2013,150700076,,,,1,3,4
,2013,150700077,,,,3,3,6
,2013,150700078,,,,2,4,6
,2013,150700079,,,,5,4,9
,2013,150700080,,,,10,10,20
,2013,150700081,,,,11,14,25
,2013,150700082,,,,24,19,43
,2013,150700083,,,,34,27,61
,2013,150700084,,,,18,5,23
,2013,150700085,,,,1,2,3
,2013,150700093,,,,3,4,7
,2013,150800001,,,,146,150,296
,2013,150800003,,,,9,7,16
,2013,150800004,,,,353,356,709
,2013,150800005,,,,11,15,26
,2013,150800006,,,,38,41,79
,2013,150800007,,,,17,18,35
,2013,150800008,,,,12,10,22
,2013,150800009,,,,18,35,53
,2013,150800010,,,,28,31,59
,2013,150800011,,,,9,6,15
,2013,150800012,,,,6,10,16
,2013,150800015,,,,21,29,50
,2013,150800016,,,,94,79,173
,2013,150800017,,,,36,29,65
,2013,150800018,,,,55,52,107
,2013,150800019,,,,23,21,44
,2013,150800021,,,,50,65,115
,2013,150800025,,,,8,12,20
,2013,150800026,,,,25,26,51
,2013,150800027,,,,31,23,54
,2013,150800028,,,,37,31,68
,2013,150800029,,,,17,17,34
,2013,150800030,,,,31,35,66
,2013,150800031,,,,17,11,28
,2013,150800032,,,,20,22,42
,2013,150800034,,,,10,10,20
,2013,150800035,,,,9,10,19
,2013,150800037,,,,8,9,17
,2013,150800038,,,,10,7,17
,2013,150800039,,,,38,40,78
,2013,150800040,,,,15,12,27
,2013,150800041,,,,23,14,37
,2013,150800043,,,,31,28,59
,2013,150800046,,,,9,16,25
,2013,150800047,,,,23,14,37
,2013,150800048,,,,48,52,100
,2013,150800049,,,,6,10,16
,2013,150800050,,,,5,6,11
,2013,150800052,,,,13,10,23
,2013,150800053,,,,7,4,11
,2013,150800054,,,,8,11,19
,2013,150800056,,,,4,7,11
,2013,150800058,,,,328,481,809
,2013,150800059,,,,22,28,50
,2013,150800061,,,,5,8,13
,2013,150800062,,,,35,26,61
,2013,150800063,,,,27,29,56
,2013,150800064,,,,17,11,28
,2013,150800065,,,,8,12,20
,2013,150800066,,,,48,41,89
,2013,150800067,,,,20,22,42
,2013,150800069,,,,11,8,19
,2013,150800071,,,,9,11,20
,2013,150800072,,,,21,15,36
,2013,150800073,,,,8,8,16
,2013,150800077,,,,22,28,50
,2013,150800078,,,,21,26,47
,2013,150800083,,,,16,20,36
,2013,150800084,,,,28,19,47
,2013,150800085,,,,8,9,17
,2013,150800086,,,,36,28,64
,2013,150800087,,,,52,39,91
,2013,150800094,,,,10,8,18
,2013,150800095,,,,21,12,33
,2013,150800096,,,,21,14,35
,2013,150800097,,,,16,10,26
,2013,150800098,,,,29,22,51
,2013,150800099,,,,15,10,25
,2013,150800100,,,,11,24,35
,2013,150800101,,,,61,52,113
,2013,150800103,,,,46,31,77
,2013,150800117,,,,33,30,63
,2013,150800118,,,,11,15,26
,2013,150800119,,,,7,4,11
,2013,150800120,,,,5,2,7
,2013,150800121,,,,7,4,11
,2013,150800122,,,,3,3,6
,2013,150800123,,,,7,2,9
,2013,150800124,,,,6,3,9
,2013,150800125,,,,5,9,14
,2013,150800127,,,,6,7,13
,2013,150800128,,,,4,5,9
,2013,150800129,,,,3,6,9
,2013,150800131,,,,5,5,10
,2013,150800132,,,,3,3,6
,2013,150800133,,,,5,7,12
,2013,150800134,,,,8,7,15
,2013,150800135,,,,16,18,34
,2013,150800140,,,,9,6,15
,2013,150800141,,,,4,6,10
,2013,150800142,,,,3,3,6
,2013,150800143,,,,3,2,5
,2013,150800144,,,,2,2,4
,2013,150800145,,,,4,4,8
,2013,150800146,,,,10,8,18
,2013,150800148,,,,10,5,15
,2013,150800152,,,,36,21,57
,2013,150800153,,,,22,17,39
,2013,150800154,,,,3,2,5
,2013,150800155,,,,7,10,17
,2013,150800156,,,,24,19,43
,2013,150800160,,,,4,4,8
,2013,150800162,,,,2,2,4
,2013,150900001,,,,123,108,231
,2013,150900002,,,,5,4,9
,2013,150900003,,,,9,10,19
,2013,150900004,,,,21,15,36
,2013,150900005,,,,28,26,54
,2013,150900006,,,,23,26,49
,2013,150900007,,,,8,4,12
,2013,150900008,,,,52,64,116
,2013,150900009,,,,10,9,19
,2013,150900010,,,,28,19,47
,2013,150900011,,,,11,18,29
,2013,150900012,,,,18,22,40
,2013,150900013,,,,37,32,69
,2013,150900014,,,,30,25,55
,2013,150900015,,,,21,27,48
,2013,150900016,,,,7,11,18
,2013,150900017,,,,9,10,19
,2013,150900018,,,,22,11,33
,2013,150900019,,,,9,8,17
,2013,150900021,,,,9,5,14
,2013,150900022,,,,16,11,27
,2013,150900023,,,,5,7,12
,2013,150900024,,,,8,7,15
,2013,150900026,,,,76,80,156
,2013,150900027,,,,22,20,42
,2013,150900029,,,,11,6,17
,2013,150900030,,,,3,6,9
,2013,150900031,,,,6,5,11
,2013,150900032,,,,8,3,11
,2013,150900033,,,,135,160,295
,2013,150900034,,,,3,7,10
,2013,150900035,,,,13,9,22
,2013,150900036,,,,19,13,32
,2013,150900037,,,,14,7,21
,2013,150900040,,,,9,6,15
,2013,150900043,,,,5,2,7
,2013,150900045,,,,3,8,11
,2013,150900058,,,,3,2,5
,2013,150900059,,,,2,5,7
,2013,150900061,,,,9,8,17
,2013,150900062,,,,10,11,21
,2013,150900064,,,,5,8,13
,2013,150900065,,,,7,1,8
,2013,150900066,,,,3,5,8
,2013,150900067,,,,1,4,5
,2013,150900068,,,,12,7,19
,2013,150900069,,,,7,6,13
,2013,150900070,,,,2,5,7
,2013,150900071,,,,1,4,5
,2013,151000001,,,,171,177,348
,2013,151000002,,,,29,25,54
,2013,151000019,,,,13,18,31
,2013,151000020,,,,8,14,22
,2013,151000021,,,,24,15,39
,2013,151000022,,,,16,12,28
,2013,151000023,,,,12,13,25
,2013,151000025,,,,8,6,14
,2013,151000026,,,,19,29,48
,2013,151000027,,,,74,54,128
,2013,151000028,,,,25,38,63
,2013,151000029,,,,23,17,40
,2013,151000030,,,,11,12,23
,2013,151000031,,,,21,12,33
,2013,151000032,,,,31,17,48
,2013,151000033,,,,7,17,24
,2013,151000034,,,,14,22,36
,2013,151000035,,,,12,18,30
,2013,151000036,,,,64,63,127
,2013,151000037,,,,28,28,56
,2013,151000038,,,,32,40,72
,2013,151000039,,,,29,25,54
,2013,151000040,,,,75,64,139
,2013,151000040,,,,8,19,27
,2013,151000041,,,,29,14,43
,2013,151000042,,,,34,33,67
,2013,151000043,,,,12,13,25
,2013,151000044,,,,34,25,59
,2013,151000045,,,,14,19,33
,2013,151000046,,,,14,19,33
,2013,151000047,,,,105,93,198
,2013,151000048,,,,37,42,79
,2013,151000059,,,,98,117,215
,2013,151000060,,,,36,40,76
,2013,151000061,,,,13,11,24
,2013,151000062,,,,11,5,16
,2013,151000063,,,,22,21,43
,2013,151000064,,,,14,11,25
,2013,151000065,,,,21,24,45
,2013,151000073,,,,7,12,19
,2013,151000074,,,,5,15,20
,2013,151000075,,,,14,5,19
,2013,151000077,,,,7,1,8
,2013,151000078,,,,4,1,5
,2013,151000079,,,,6,10,16
,2013,151000081,,,,2,6,8
,2013,151000084,,,,11,11,22
,2013,151000086,,,,6,12,18
,2013,151000087,,,,3,3,6
,2013,151000088,,,,1,5,6
,2013,151000090,,,,7,2,9
,2013,151100001,,,,40,40,80
,2013,151100002,,,,335,316,651
,2013,151100003,,,,12,15,27
,2013,151100004,,,,174,145,319
,2013,151100005,,,,10,3,13
,2013,151100006,,,,17,24,41
,2013,151100007,,,,10,5,15
,2013,151100008,,,,36,35,71
,2013,151100009,,,,31,32,63
,2013,151100010,,,,22,20,42
,2013,151100011,,,,68,76,144
,2013,151100012,,,,103,113,216
,2013,151100013,,,,4,11,15
,2013,151100014,,,,21,30,51
,2013,151100015,,,,35,29,64
,2013,151100016,,,,102,60,162
,2013,151100017,,,,7,18,25
,2013,151100019,,,,27,19,46
,2013,151100020,,,,49,57,106
,2013,151100021,,,,21,14,35
,2013,151100023,,,,7,6,13
,2013,151100024,,,,11,9,20
,2013,151100026,,,,47,41,88
,2013,151100028,,,,9,7,16
,2013,151100029,,,,16,15,31
,2013,151100030,,,,16,22,38
,2013,151100031,,,,9,6,15
,2013,151100032,,,,8,5,13
,2013,151100034,,,,17,21,38
,2013,151100035,,,,9,4,13
,2013,151100036,,,,10,10,20
,2013,151100037,,,,5,7,12
,2013,151100038,,,,6,5,11
,2013,151100039,,,,12,18,30
,2013,151100040,,,,21,24,45
,2013,151100041,,,,16,13,29
,2013,151100043,,,,10,5,15
,2013,151100044,,,,5,8,13
,2013,151100045,,,,5,8,13
,2013,151100046,,,,5,8,13
,2013,151100047,,,,33,23,56
,2013,151100048,,,,179,238,417
,2013,151100048,,,,82,89,171
,2013,151100049,,,,4,6,10
,2013,151100050,,,,4,4,8
,2013,151100051,,,,9,7,16
,2013,151100052,,,,11,10,21
,2013,151100056,,,,4,6,10
,2013,151100057,,,,16,13,29
,2013,151100076,,,,11,3,14
,2013,151100078,,,,9,7,16
,2013,151100079,,,,7,5,12
,2013,151100080,,,,8,3,11
,2013,151100081,,,,4,1,5
,2013,151100082,,,,1,5,6
,2013,151100083,,,,6,7,13
,2013,151100084,,,,6,8,14
,2013,151100085,,,,7,5,12
,2013,151100086,,,,3,7,10
,2013,151100089,,,,3,1,4
,2013,151100090,,,,3,3,6
,2013,151100091,,,,9,0,9
,2013,151100092,,,,4,2,6
,2013,151100093,,,,5,5,10
,2013,151100094,,,,7,5,12
,2013,151100095,,,,2,2,4
,2013,151200001,,,,88,66,154
,2013,151200002,,,,121,122,243
,2013,151200002,,,,74,73,147
,2013,151200003,,,,50,56,106
,2013,151200004,,,,19,22,41
,2013,151200005,,,,34,24,58
,2013,151200006,,,,18,22,40
,2013,151200007,,,,19,5,24
,2013,151200008,,,,9,10,19
,2013,151200009,,,,32,23,55
,2013,151200011,,,,8,8,16
,2013,151200013,,,,12,10,22
,2013,151200014,,,,8,13,21
,2013,151200015,,,,14,7,21
,2013,151200016,,,,13,11,24
,2013,151200017,,,,11,5,16
,2013,151200018,,,,12,4,16
,2013,151200019,,,,6,8,14
,2013,151200020,,,,14,13,27
,2013,151200021,,,,17,17,34
,2013,151200022,,,,14,19,33
,2013,151200023,,,,11,7,18
,2013,151200040,,,,42,50,92
,2013,151200043,,,,48,42,90
,2013,151200044,,,,17,20,37
,2013,151200045,,,,10,7,17
,2013,151200051,,,,12,8,20
,2013,151200052,,,,5,12,17
,2013,151200053,,,,3,7,10
,2013,151200054,,,,6,3,9
,2013,151200055,,,,4,8,12
,2013,151200056,,,,6,8,14
,2013,151200057,,,,3,1,4
,2013,151200058,,,,8,3,11
,2013,151200059,,,,5,9,14
,2013,151200060,,,,7,8,15
,2013,151200061,,,,10,10,20
,2013,151200062,,,,7,7,14
,2013,151200063,,,,14,8,22
,2013,151200064,,,,2,6,8
,2013,151200065,,,,7,3,10
,2013,151200066,,,,2,6,8
,2013,151200067,,,,2,9,11
,2013,151300001,,,,329,363,692
,2013,151300002,,,,9,7,16
,2013,151300003,,,,9,6,15
,2013,151300004,,,,35,31,66
,2013,151300005,,,,58,56,114
,2013,151300006,,,,25,21,46
,2013,151300007,,,,18,12,30
,2013,151300009,,,,55,57,112
,2013,151300011,,,,32,24,56
,2013,151300014,,,,259,338,597
,2013,151300016,,,,7,14,21
,2013,151300017,,,,8,11,19
,2013,151300019,,,,13,17,30
,2013,151300020,,,,31,27,58
,2013,151300021,,,,24,12,36
,2013,151300022,,,,29,24,53
,2013,151300023,,,,3,6,9
,2013,151300024,,,,9,11,20
,2013,151300028,,,,7,6,13
,2013,151300029,,,,6,3,9
,2013,151300033,,,,1,4,5
,2013,151300036,,,,72,118,190
,2013,151300054,,,,6,6,12
,2013,151300055,,,,6,5,11
,2013,151300056,,,,11,12,23
,2013,151300057,,,,12,7,19
,2013,151300058,,,,9,7,16
,2013,151300059,,,,0,3,3
,2013,151300060,,,,2,5,7
,2013,151300062,,,,6,9,15
,2013,151300063,,,,6,2,8
,2013,151300064,,,,6,5,11
,2013,151300065,,,,5,8,13
,2013,151300066,,,,4,1,5
,2013,151300067,,,,2,2,4
,2013,151300068,,,,5,2,7
,2013,151300069,,,,11,6,17
,2013,151300070,,,,17,10,27
,2013,151300073,,,,5,2,7
,2013,151300074,,,,13,22,35
,2013,151300075,,,,75,51,126
,2013,151300076,,,,3,5,8
,2013,151300084,,,,15,14,29
,2013,151400001,,,,49,27,76
,2013,151400002,,,,114,120,234
,2013,151400003,,,,14,8,22
,2013,151400004,,,,27,20,47
,2013,151400005,,,,9,7,16
,2013,151400006,,,,16,13,29
,2013,151400007,,,,29,42,71
,2013,151400008,,,,13,8,21
,2013,151400009,,,,61,51,112
,2013,151400010,,,,46,68,114
,2013,151400012,,,,7,13,20
,2013,151400013,,,,7,7,14
,2013,151400014,,,,26,20,46
,2013,151400015,,,,15,16,31
,2013,151400016,,,,33,24,57
,2013,151400017,,,,24,23,47
,2013,151400018,,,,6,11,17
,2013,151400019,,,,7,12,19
,2013,151400020,,,,41,47,88
,2013,151400021,,,,44,26,70
,2013,151400022,,,,22,11,33
,2013,151400023,,,,24,17,41
,2013,151400025,,,,93,119,212
,2013,151400028,,,,33,39,72
,2013,151400029,,,,13,16,29
,2013,151400030,,,,8,14,22
,2013,151400031,,,,20,18,38
,2013,151400033,,,,0,5,5
,2013,151400034,,,,2,6,8
,2013,151400035,,,,3,2,5
,2013,151400036,,,,5,1,6
,2013,151400038,,,,2,2,4
,2013,151400042,,,,6,3,9
,2013,151400061,,,,27,39,66
,2013,151400062,,,,43,24,67
,2013,151400063,,,,34,26,60
,2013,151400066,,,,4,2,6
,2013,151400067,,,,14,4,18
,2013,151400068,,,,6,11,17
,2013,151400069,,,,1,4,5
,2013,151400073,,,,2,3,5
,2013,151400074,,,,10,5,15
,2013,151400076,,,,15,5,20
,2013,151400078,,,,14,16,30
,2013,151400079,,,,22,21,43
,2013,151400080,,,,5,5,10
,2013,151400081,,,,16,7,23
,2013,151400082,,,,2,6,8
,2013,151500001,,,,86,94,180
,2013,151500002,,,,6,7,13
,2013,151500002,,,,17,22,39
,2013,151500003,,,,42,40,82
,2013,151500004,,,,36,19,55
,2013,151500005,,,,28,23,51
,2013,151500006,,,,79,90,169
,2013,151500007,,,,52,57,109
,2013,151500008,,,,26,23,49
,2013,151500009,,,,16,17,33
,2013,151500010,,,,17,11,28
,2013,151500011,,,,27,29,56
,2013,151500012,,,,9,4,13
,2013,151500013,,,,21,14,35
,2013,151500014,,,,77,55,132
,2013,151500015,,,,16,10,26
,2013,151500016,,,,12,10,22
,2013,151500017,,,,42,41,83
,2013,151500018,,,,7,14,21
,2013,151500019,,,,22,14,36
,2013,151500020,,,,10,19,29
,2013,151500021,,,,7,3,10
,2013,151500022,,,,11,8,19
,2013,151500023,,,,27,12,39
,2013,151500024,,,,32,34,66
,2013,151500025,,,,12,16,28
,2013,151500026,,,,26,21,47
,2013,151500027,,,,20,13,33
,2013,151500028,,,,21,16,37
,2013,151500029,,,,8,5,13
,2013,151500030,,,,23,27,50
,2013,151500031,,,,7,6,13
,2013,151500032,,,,26,36,62
,2013,151500033,,,,17,13,30
,2013,151500034,,,,24,11,35
,2013,151500035,,,,11,10,21
,2013,151500036,,,,9,13,22
,2013,151500037,,,,9,6,15
,2013,151500038,,,,152,169,321
,2013,151500039,,,,6,5,11
,2013,151500041,,,,13,8,21
,2013,151500042,,,,8,6,14
,2013,151500043,,,,13,12,25
,2013,151500044,,,,3,8,11
,2013,151500045,,,,6,5,11
,2013,151500047,,,,17,12,29
,2013,151500062,,,,8,4,12
,2013,151500063,,,,23,11,34
,2013,151500064,,,,14,5,19
,2013,151500065,,,,3,7,10
,2013,151500068,,,,4,2,6
,2013,151500069,,,,2,6,8
,2013,151500070,,,,9,7,16
,2013,151500071,,,,4,9,13
,2013,151500072,,,,15,15,30
,2013,151500073,,,,10,7,17
,2013,151500074,,,,4,11,15
,2013,151500076,,,,7,3,10
,2013,151500077,,,,1,5,6
,2013,151500078,,,,4,5,9
,2013,151500079,,,,5,6,11
,2013,151500080,,,,8,3,11
,2013,151500082,,,,7,10,17
,2013,151500083,,,,10,8,18
,2013,151500084,,,,4,0,4
,2013,151500085,,,,0,5,5
,2013,151600001,,,,211,187,398
,2013,151600002,,,,84,64,148
,2013,151600003,,,,19,16,35
,2013,151600004,,,,8,11,19
,2013,151600005,,,,28,30,58
,2013,151600006,,,,17,22,39
,2013,151600007,,,,16,18,34
,2013,151600008,,,,35,38,73
,2013,151600009,,,,11,9,20
,2013,151600010,,,,9,5,14
,2013,151600011,,,,26,34,60
,2013,151600012,,,,7,10,17
,2013,151600013,,,,275,266,541
,2013,151600014,,,,156,162,318
,2013,151600039,,,,5,8,13
,2013,151600041,,,,4,8,12
,2013,151600044,,,,25,20,45
,2013,151600045,,,,0,7,7
,2013,151600046,,,,5,4,9
,2013,151600047,,,,4,2,6
,2013,151600048,,,,3,6,9
,2013,151600049,,,,5,3,8
,2013,151600051,,,,5,4,9
,2013,151600052,,,,2,3,5
,2013,151600053,,,,2,4,6
,2013,151600055,,,,2,3,5
,2013,151600056,,,,5,3,8
,2013,151600057,,,,2,4,6
,2013,151600058,,,,62,78,140
,2013,151700001,,,,208,208,416
,2013,151700002,,,,17,9,26
,2013,151700003,,,,28,17,45
,2013,151700004,,,,45,36,81
,2013,151700005,,,,51,51,102
,2013,151700007,,,,18,9,27
,2013,151700008,,,,39,34,73
,2013,151700009,,,,20,28,48
,2013,151700010,,,,13,12,25
,2013,151700011,,,,19,40,59
,2013,151700012,,,,26,21,47
,2013,151700013,,,,32,22,54
,2013,151700014,,,,144,133,277
,2013,151700015,,,,33,28,61
,2013,151700016,,,,70,53,123
,2013,151700017,,,,41,31,72
,2013,151700018,,,,8,4,12
,2013,151700019,,,,17,30,47
,2013,151700020,,,,42,19,61
,2013,151700021,,,,58,54,112
,2013,151700022,,,,31,38,69
,2013,151700023,,,,26,20,46
,2013,151700024,,,,38,51,89
,2013,151700025,,,,36,28,64
,2013,151700026,,,,31,24,55
,2013,151700027,,,,66,68,134
,2013,151700028,,,,71,47,118
,2013,151700029,,,,22,16,38
,2013,151700030,,,,18,14,32
,2013,151700031,,,,13,10,23
,2013,151700033,,,,19,15,34
,2013,151700034,,,,15,8,23
,2013,151700035,,,,18,9,27
,2013,151700036,,,,31,30,61
,2013,151700037,,,,33,28,61
,2013,151700038,,,,57,56,113
,2013,151700039,,,,79,107,186
,2013,151700040,,,,14,8,22
,2013,151700041,,,,43,28,71
,2013,151700042,,,,6,18,24
,2013,151700044,,,,46,56,102
,2013,151700045,,,,19,20,39
,2013,151700046,,,,36,30,66
,2013,151700047,,,,82,86,168
,2013,151700048,,,,15,17,32
,2013,151700050,,,,27,21,48
,2013,151700051,,,,17,21,38
,2013,151700052,,,,8,8,16
,2013,151700053,,,,22,17,39
,2013,151700054,,,,14,8,22
,2013,151700055,,,,30,18,48
,2013,151700056,,,,22,25,47
,2013,151700057,,,,16,19,35
,2013,151700058,,,,314,372,686
,2013,151700058,,,,46,60,106
,2013,151700060,,,,9,11,20
,2013,151700061,,,,12,14,26
,2013,151700063,,,,3,7,10
,2013,151700066,,,,17,9,26
,2013,151700067,,,,22,16,38
,2013,151700069,,,,9,11,20
,2013,151700070,,,,6,8,14
,2013,151700071,,,,29,37,66
,2013,151700079,,,,16,10,26
,2013,151700082,,,,6,5,11
,2013,151700082,,,,11,17,28
,2013,151700083,,,,4,8,12
,2013,151700084,,,,19,17,36
,2013,151700085,,,,29,22,51
,2013,151700087,,,,15,11,26
,2013,151700088,,,,7,10,17
,2013,151700090,,,,72,75,147
,2013,151700091,,,,180,284,464
,2013,151700092,,,,16,25,41
,2013,151700092,,,,2,2,4
,2013,151700093,,,,44,56,100
,2013,151700094,,,,24,39,63
,2013,151700095,,,,8,10,18
,2013,151700096,,,,9,8,17
,2013,151700100,,,,4,9,13
,2013,151700102,,,,4,6,10
,2013,151700103,,,,9,7,16
,2013,151700105,,,,4,5,9
,2013,151700106,,,,12,9,21
,2013,151700107,,,,11,7,18
,2013,151700108,,,,3,1,4
,2013,151700109,,,,8,10,18
,2013,151700110,,,,8,5,13
,2013,151700121,,,,10,10,20
,2013,151700122,,,,13,8,21
,2013,151700123,,,,12,11,23
,2013,151700126,,,,8,12,20
,2013,151700127,,,,11,4,15
,2013,151700128,,,,10,16,26
,2013,151700129,,,,7,5,12
,2013,151700130,,,,3,5,8
,2013,151700131,,,,2,4,6
,2013,151700132,,,,10,7,17
,2013,151700133,,,,7,4,11
,2013,151700134,,,,3,6,9
,2013,151700135,,,,7,3,10
,2013,151700136,,,,11,9,20
,2013,151700137,,,,8,9,17
,2013,151700138,,,,12,5,17
,2013,151700139,,,,2,7,9
,2013,151700140,,,,5,2,7
,2013,151700142,,,,7,3,10
,2013,151700143,,,,9,8,17
,2013,151700144,,,,4,11,15
,2013,151700145,,,,2,7,9
,2013,151700146,,,,4,6,10
,2013,151700147,,,,5,4,9
,2013,151700148,,,,10,7,17
,2013,151700149,,,,7,4,11
,2013,151700150,,,,16,16,32
,2013,151700151,,,,10,10,20
,2013,151700155,,,,14,9,23
,2013,151700156,,,,6,2,8
,2013,151700157,,,,13,9,22
,2013,151700158,,,,7,8,15
,2013,151700159,,,,11,4,15
,2013,151700161,,,,7,4,11
,2013,151700162,,,,4,3,7
,2013,151700163,,,,7,6,13
,2013,151700164,,,,6,5,11
,2013,151700166,,,,3,5,8
,2013,151700168,,,,5,6,11
,2013,151700169,,,,5,3,8
,2013,151700170,,,,5,4,9
,2013,151700171,,,,9,1,10
,2013,151800001,,,,50,59,109
,2013,151800002,,,,23,25,48
,2013,151800003,,,,6,15,21
,2013,151800004,,,,212,193,405
,2013,151800005,,,,76,74,150
,2013,151800006,,,,44,25,69
,2013,151800007,,,,7,3,10
,2013,151800008,,,,25,16,41
,2013,151800009,,,,15,17,32
,2013,151800010,,,,33,35,68
,2013,151800011,,,,113,113,226
,2013,151800012,,,,9,11,20
,2013,151800013,,,,35,41,76
,2013,151800014,,,,26,23,49
,2013,151800015,,,,6,11,17
,2013,151800016,,,,17,14,31
,2013,151800018,,,,283,343,626
,2013,151800020,,,,8,9,17
,2013,151800021,,,,18,20,38
,2013,151800036,,,,1,6,7
,2013,151800037,,,,6,1,7
,2013,151800039,,,,4,3,7
,2013,151800040,,,,3,3,6
,2013,151800042,,,,6,9,15
,2013,151800044,,,,7,6,13
,2013,151800045,,,,55,53,108
,2013,151800046,,,,2,4,6
,2013,151900001,,,,119,114,233
,2013,151900002,,,,85,70,155
,2013,151900003,,,,46,45,91
,2013,151900003,,,,2,4,6
,2013,151900004,,,,24,18,42
,2013,151900005,,,,11,4,15
,2013,151900006,,,,11,8,19
,2013,151900007,,,,326,301,627
,2013,151900008,,,,40,31,71
,2013,151900009,,,,8,8,16
,2013,151900010,,,,24,15,39
,2013,151900011,,,,53,68,121
,2013,151900012,,,,22,21,43
,2013,151900013,,,,48,39,87
,2013,151900014,,,,28,21,49
,2013,151900015,,,,25,24,49
,2013,151900016,,,,35,27,62
,2013,151900017,,,,19,23,42
,2013,151900018,,,,48,38,86
,2013,151900019,,,,32,26,58
,2013,151900020,,,,4,5,9
,2013,151900021,,,,13,9,22
,2013,151900022,,,,9,6,15
,2013,151900023,,,,36,27,63
,2013,151900024,,,,21,27,48
,2013,151900024,,,,6,9,15
,2013,151900025,,,,23,20,43
,2013,151900026,,,,9,4,13
,2013,151900027,,,,23,20,43
,2013,151900028,,,,26,33,59
,2013,151900029,,,,12,17,29
,2013,151900030,,,,13,11,24
,2013,151900031,,,,24,19,43
,2013,151900032,,,,14,8,22
,2013,151900033,,,,15,6,21
,2013,151900034,,,,8,9,17
,2013,151900035,,,,17,20,37
,2013,151900036,,,,11,11,22
,2013,151900037,,,,9,8,17
,2013,151900038,,,,14,27,41
,2013,151900039,,,,7,8,15
,2013,151900040,,,,11,8,19
,2013,151900041,,,,97,82,179
,2013,151900042,,,,38,57,95
,2013,151900043,,,,14,9,23
,2013,151900044,,,,27,27,54
,2013,151900044,,,,6,6,12
,2013,151900044,,,,25,30,55
,2013,151900045,,,,6,10,16
,2013,151900046,,,,9,5,14
,2013,151900047,,,,23,13,36
,2013,151900049,,,,15,6,21
,2013,151900050,,,,5,9,14
,2013,151900051,,,,10,8,18
,2013,151900052,,,,6,13,19
,2013,151900053,,,,522,550,1072
,2013,151900054,,,,72,112,184
,2013,151900055,,,,19,20,39
,2013,151900056,,,,6,8,14
,2013,151900057,,,,8,12,20
,2013,151900058,,,,9,3,12
,2013,151900070,,,,7,8,15
,2013,151900071,,,,5,5,10
,2013,151900078,,,,9,10,19
,2013,151900081,,,,3,11,14
,2013,151900082,,,,3,4,7
,2013,151900084,,,,19,23,42
,2013,151900086,,,,3,7,10
,2013,151900087,,,,7,4,11
,2013,151900088,,,,6,3,9
,2013,151900090,,,,2,5,7
,2013,151900094,,,,5,2,7
,2013,151900095,,,,5,6,11
,2013,151900098,,,,4,9,13
,2013,151900099,,,,6,5,11
,2013,151900100,,,,203,279,482
,2013,151900101,,,,2,2,4
,2013,151900102,,,,7,2,9
,2013,151900103,,,,6,3,9
,2013,151900104,,,,7,3,10
,2013,152000001,,,,45,56,101
,2013,152000002,,,,84,81,165
,2013,152000003,,,,220,205,425
,2013,152000004,,,,16,16,32
,2013,152000005,,,,24,15,39
,2013,152000006,,,,45,50,95
,2013,152000007,,,,151,141,292
,2013,152000008,,,,94,100,194
,2013,152000009,,,,39,42,81
,2013,152000010,,,,23,25,48
,2013,152000011,,,,15,15,30
,2013,152000012,,,,11,9,20
,2013,152000013,,,,12,11,23
,2013,152000015,,,,242,337,579
,2013,152000016,,,,206,245,451
,2013,152000017,,,,22,7,29
,2013,152000018,,,,16,6,22
,2013,152000019,,,,62,58,120
,2013,152000021,,,,22,11,33
,2013,152000022,,,,4,7,11
,2013,152000025,,,,0,8,8
,2013,152000027,,,,8,10,18
,2013,152100001,,,,81,85,166
,2013,152100002,,,,35,23,58
,2013,152100003,,,,84,90,174
,2013,152100004,,,,17,17,34
,2013,152100005,,,,72,41,113
,2013,152100006,,,,88,68,156
,2013,152100007,,,,60,50,110
,2013,152100008,,,,16,29,45
,2013,152100009,,,,20,16,36
,2013,152100010,,,,11,5,16
,2013,152100011,,,,5,6,11
,2013,152100012,,,,12,9,21
,2013,152100013,,,,10,12,22
,2013,152100014,,,,20,21,41
,2013,152100015,,,,12,11,23
,2013,152100016,,,,18,17,35
,2013,152100017,,,,14,7,21
,2013,152100018,,,,15,6,21
,2013,152100019,,,,17,12,29
,2013,152100020,,,,27,28,55
,2013,152100021,,,,7,15,22
,2013,152100022,,,,13,21,34
,2013,152100024,,,,4,9,13
,2013,152100025,,,,4,4,8
,2013,152100027,,,,7,6,13
,2013,152100028,,,,144,172,316
,2013,152100029,,,,18,16,34
,2013,152100031,,,,6,11,17
,2013,152100033,,,,82,67,149
,2013,152100076,,,,10,3,13
,2013,152100079,,,,1,3,4
,2013,152100080,,,,0,3,3
,2013,152100082,,,,3,3,6
,2013,152100083,,,,2,6,8
,2013,152100084,,,,1,4,5
,2013,152100085,,,,7,1,8
,2013,152100086,,,,3,5,8
,2013,152100088,,,,4,10,14
,2013,152100089,,,,4,4,8
,2013,152200001,,,,81,97,178
,2013,152200002,,,,28,28,56
,2013,152200003,,,,131,169,300
,2013,152200004,,,,29,35,64
,2013,152200005,,,,44,42,86
,2013,152200006,,,,19,12,31
,2013,152200007,,,,44,41,85
,2013,152200008,,,,15,6,21
,2013,152200009,,,,15,7,22
,2013,152200010,,,,30,20,50
,2013,152200011,,,,41,37,78
,2013,152200012,,,,36,25,61
,2013,152200013,,,,55,68,123
,2013,152200014,,,,91,73,164
,2013,152200015,,,,98,105,203
,2013,152200016,,,,70,79,149
,2013,152200017,,,,24,34,58
,2013,152200018,,,,44,63,107
,2013,152200019,,,,47,38,85
,2013,152200020,,,,15,19,34
,2013,152200021,,,,19,16,35
,2013,152200022,,,,23,15,38
,2013,152200023,,,,16,22,38
,2013,152200024,,,,18,13,31
,2013,152200025,,,,12,9,21
,2013,152200026,,,,14,17,31
,2013,152200027,,,,9,9,18
,2013,152200028,,,,9,10,19
,2013,152200029,,,,10,12,22
,2013,152200030,,,,5,9,14
,2013,152200031,,,,80,108,188
,2013,152200032,,,,14,12,26
,2013,152200033,,,,17,17,34
,2013,152200034,,,,17,18,35
,2013,152200035,,,,22,13,35
,2013,152200036,,,,38,18,56
,2013,152200037,,,,18,15,33
,2013,152200038,,,,8,10,18
,2013,152200039,,,,16,23,39
,2013,152200041,,,,37,33,70
,2013,152200042,,,,9,8,17
,2013,152200043,,,,18,6,24
,2013,152200045,,,,9,12,21
,2013,152200047,,,,15,21,36
,2013,152200049,,,,16,15,31
,2013,152200050,,,,23,21,44
,2013,152200052,,,,4,3,7
,2013,152200058,,,,8,3,11
,2013,152200059,,,,5,6,11
,2013,152200079,,,,35,41,76
,2013,152200080,,,,14,11,25
,2013,152200081,,,,9,10,19
,2013,152200081,,,,2,4,6
,2013,152200082,,,,21,17,38
,2013,152200083,,,,5,7,12
,2013,152200084,,,,7,12,19
,2013,152200086,,,,4,4,8
,2013,152200088,,,,7,3,10
,2013,152200089,,,,10,0,10
,2013,152200090,,,,9,8,17
,2013,152200091,,,,6,5,11
,2013,152200092,,,,7,4,11
,2013,152200093,,,,6,4,10
,2013,152200095,,,,4,4,8
,2013,152200098,,,,8,4,12
,2013,152200099,,,,3,3,6
,2013,152200100,,,,8,2,10
,2013,152200101,,,,2,8,10
,2013,152200102,,,,3,8,11
,2013,152200103,,,,5,5,10
,2013,152200104,,,,9,7,16
,2013,152200105,,,,10,1,11
,2013,152200106,,,,2,11,13
,2013,152200107,,,,5,11,16
,2013,152200108,,,,4,7,11
,2013,152200109,,,,6,4,10
,2013,152200110,,,,5,6,11
,2013,152200111,,,,6,13,19
,2013,152200112,,,,4,13,17
,2013,152200113,,,,5,3,8
,2013,152200114,,,,4,6,10
,2013,152200115,,,,2,9,11
,2013,152200116,,,,4,9,13
,2013,152200117,,,,3,5,8
,2013,152200119,,,,2,7,9
,2013,152200121,,,,5,3,8
,2013,152200123,,,,7,7,14
,2013,152200124,,,,5,4,9
,2013,152200125,,,,3,3,6
,2013,152300001,,,,20,31,51
,2013,152300003,,,,25,13,38
,2013,152300004,,,,53,30,83
,2013,152300005,,,,18,8,26
,2013,152300006,,,,17,13,30
,2013,152300007,,,,85,66,151
,2013,152300008,,,,10,11,21
,2013,152300009,,,,112,91,203
,2013,152300010,,,,54,58,112
,2013,152300011,,,,33,35,68
,2013,152300012,,,,11,6,17
,2013,152300013,,,,13,7,20
,2013,152300014,,,,7,3,10
,2013,152300015,,,,49,69,118
,2013,152300015,,,,62,46,108
,2013,152300016,,,,19,20,39
,2013,152300017,,,,19,17,36
,2013,152300018,,,,68,59,127
,2013,152300019,,,,15,16,31
,2013,152300020,,,,21,12,33
,2013,152300021,,,,31,26,57
,2013,152300022,,,,106,106,212
,2013,152300023,,,,32,36,68
,2013,152300024,,,,15,14,29
,2013,152300025,,,,21,25,46
,2013,152300026,,,,47,38,85
,2013,152300027,,,,64,59,123
,2013,152300028,,,,21,17,38
,2013,152300029,,,,35,21,56
,2013,152300031,,,,86,73,159
,2013,152300032,,,,24,39,63
,2013,152300033,,,,29,26,55
,2013,152300034,,,,97,79,176
,2013,152300036,,,,21,22,43
,2013,152300037,,,,40,39,79
,2013,152300038,,,,18,20,38
,2013,152300039,,,,21,27,48
,2013,152300040,,,,30,25,55
,2013,152300041,,,,18,19,37
,2013,152300042,,,,8,15,23
,2013,152300043,,,,6,9,15
,2013,152300044,,,,10,10,20
,2013,152300045,,,,46,38,84
,2013,152300046,,,,18,14,32
,2013,152300047,,,,39,42,81
,2013,152300048,,,,20,21,41
,2013,152300049,,,,251,273,524
,2013,152300050,,,,14,19,33
,2013,152300051,,,,30,21,51
,2013,152300052,,,,125,111,236
,2013,152300053,,,,69,71,140
,2013,152300054,,,,45,55,100
,2013,152300055,,,,10,4,14
,2013,152300056,,,,11,10,21
,2013,152300057,,,,24,17,41
,2013,152300058,,,,16,17,33
,2013,152300059,,,,13,7,20
,2013,152300060,,,,60,59,119
,2013,152300061,,,,16,20,36
,2013,152300062,,,,38,32,70
,2013,152300063,,,,26,23,49
,2013,152300064,,,,21,28,49
,2013,152300065,,,,10,6,16
,2013,152300066,,,,34,30,64
,2013,152300067,,,,11,9,20
,2013,152300068,,,,14,18,32
,2013,152300069,,,,12,4,16
,2013,152300071,,,,24,24,48
,2013,152300072,,,,31,30,61
,2013,152300073,,,,39,47,86
,2013,152300075,,,,11,7,18
,2013,152300076,,,,5,10,15
,2013,152300081,,,,31,16,47
,2013,152300082,,,,25,20,45
,2013,152300084,,,,23,26,49
,2013,152300085,,,,15,24,39
,2013,152300086,,,,27,24,51
,2013,152300087,,,,20,14,34
,2013,152300089,,,,9,11,20
,2013,152300090,,,,27,22,49
,2013,152300091,,,,31,21,52
,2013,152300092,,,,14,17,31
,2013,152300093,,,,26,24,50
,2013,152300094,,,,5,7,12
,2013,152300095,,,,23,27,50
,2013,152300096,,,,7,9,16
,2013,152300097,,,,25,19,44
,2013,152300098,,,,25,20,45
,2013,152300099,,,,27,24,51
,2013,152300100,,,,28,19,47
,2013,152300101,,,,36,39,75
,2013,152300102,,,,36,41,77
,2013,152300103,,,,313,437,750
,2013,152300104,,,,196,177,373
,2013,152300106,,,,32,18,50
,2013,152300107,,,,28,23,51
,2013,152300108,,,,12,6,18
,2013,152300109,,,,31,25,56
,2013,152300120,,,,9,13,22
,2013,152300121,,,,26,22,48
,2013,152300122,,,,28,28,56
,2013,152300136,,,,39,19,58
,2013,152300137,,,,17,7,24
,2013,152300138,,,,26,23,49
,2013,152300139,,,,22,25,47
,2013,152300141,,,,6,15,21
,2013,152300142,,,,15,6,21
,2013,152300143,,,,49,45,94
,2013,152300148,,,,30,26,56
,2013,152300149,,,,29,34,63
,2013,152300151,,,,9,12,21
,2013,152300152,,,,19,18,37
,2013,152300153,,,,38,32,70
,2013,152300158,,,,4,6,10
,2013,152300162,,,,27,21,48
,2013,152300163,,,,22,12,34
,2013,152300164,,,,26,17,43
,2013,152300165,,,,9,13,22
,2013,152300166,,,,22,22,44
,2013,152300168,,,,5,10,15
,2013,152300171,,,,12,17,29
,2013,152300181,,,,14,16,30
,2013,152300182,,,,25,25,50
,2013,152300183,,,,8,10,18
,2013,152300184,,,,54,63,117
,2013,152300190,,,,5,4,9
,2013,152300191,,,,3,4,7
,2013,152300192,,,,4,5,9
,2013,152300193,,,,6,5,11
,2013,152300195,,,,7,5,12
,2013,152300196,,,,4,5,9
,2013,152300197,,,,3,4,7
,2013,152300197,,,,6,13,19
,2013,152300199,,,,3,5,8
,2013,152300201,,,,5,5,10
,2013,152300204,,,,10,9,19
,2013,152300205,,,,21,12,33
,2013,152300206,,,,16,12,28
,2013,152300207,,,,16,10,26
,2013,152300208,,,,16,16,32
,2013,152300209,,,,14,8,22
,2013,152300210,,,,24,27,51
,2013,152300214,,,,4,11,15
,2013,152300215,,,,8,3,11
,2013,152300218,,,,6,8,14
,2013,152300221,,,,2,3,5
,2013,152300221,,,,22,23,45
,2013,152300223,,,,20,7,27
,2013,152300224,,,,12,11,23
,2013,152300225,,,,5,2,7
,2013,152300227,,,,6,4,10
,2013,152300228,,,,3,8,11
,2013,152300229,,,,4,4,8
,2013,152300230,,,,22,15,37
,2013,152300231,,,,20,17,37
,2013,152300232,,,,28,23,51
,2013,152300233,,,,13,13,26
,2013,152300234,,,,6,9,15
,2013,152300235,,,,18,21,39
,2013,152300236,,,,14,6,20
,2013,152300238,,,,16,16,32
,2013,152300239,,,,24,35,59
,2013,152300240,,,,8,8,16
,2013,152300241,,,,20,6,26
,2013,152300242,,,,12,11,23
,2013,152300243,,,,6,8,14
,2013,152300244,,,,11,7,18
,2013,152300245,,,,6,2,8
,2013,152300246,,,,9,9,18
,2013,152300248,,,,3,0,3
,2013,152300249,,,,30,40,70
,2013,152300258,,,,4,4,8
,2013,152300260,,,,2,2,4
,2013,152300262,,,,1,6,7
,2013,152300263,,,,6,6,12
,2013,152300264,,,,6,5,11
,2013,152300265,,,,7,2,9
,2013,152300266,,,,5,3,8
,2013,152300267,,,,38,45,83
,2013,160100001,,,,78,66,144
,2013,160100002,,,,288,278,566
,2013,160100003,,,,17,13,30
,2013,160100004,,,,128,136,264
,2013,160100005,,,,57,53,110
,2013,160100006,,,,62,54,116
,2013,160100007,,,,98,83,181
,2013,160100008,,,,24,26,50
,2013,160100009,,,,29,23,52
,2013,160100010,,,,254,259,513
,2013,160100011,,,,3,0,3
,2013,160100011,,,,44,32,76
,2013,160100012,,,,103,110,213
,2013,160100013,,,,223,204,427
,2013,160100014,,,,41,24,65
,2013,160100015,,,,25,23,48
,2013,160100016,,,,47,41,88
,2013,160100017,,,,30,24,54
,2013,160100018,,,,320,281,601
,2013,160100019,,,,57,68,125
,2013,160100020,,,,35,39,74
,2013,160100021,,,,50,27,77
,2013,160100022,,,,21,14,35
,2013,160100023,,,,127,107,234
,2013,160100024,,,,58,66,124
,2013,160100025,,,,19,25,44
,2013,160100026,,,,50,47,97
,2013,160100027,,,,159,137,296
,2013,160100028,,,,10,10,20
,2013,160100029,,,,13,9,22
,2013,160100031,,,,25,26,51
,2013,160100032,,,,20,14,34
,2013,160100033,,,,27,19,46
,2013,160100034,,,,25,27,52
,2013,160100035,,,,44,36,80
,2013,160100036,,,,21,18,39
,2013,160100036,,,,6,11,17
,2013,160100037,,,,8,7,15
,2013,160100038,,,,19,17,36
,2013,160100039,,,,31,29,60
,2013,160100040,,,,17,7,24
,2013,160100041,,,,23,30,53
,2013,160100044,,,,79,96,175
,2013,160100046,,,,15,29,44
,2013,160100047,,,,32,14,46
,2013,160100048,,,,62,52,114
,2013,160100048,,,,8,7,15
,2013,160100049,,,,42,31,73
,2013,160100050,,,,22,22,44
,2013,160100051,,,,13,8,21
,2013,160100052,,,,13,12,25
,2013,160100053,,,,11,13,24
,2013,160100054,,,,312,705,1017
,2013,160100055,,,,902,493,1395
,2013,160100057,,,,0,7,7
,2013,160100058,,,,11,7,18
,2013,160100060,,,,14,8,22
,2013,160100064,,,,561,543,1104
,2013,160100066,,,,119,145,264
,2013,160100067,,,,7,16,23
,2013,160100068,,,,18,22,40
,2013,160100069,,,,295,382,677
,2013,160100070,,,,5,9,14
,2013,160100071,,,,11,6,17
,2013,160100072,,,,7,3,10
,2013,160100076,,,,10,2,12
,2013,160100077,,,,24,16,40
,2013,160100078,,,,10,8,18
,2013,160100079,,,,3,3,6
,2013,160100080,,,,26,20,46
,2013,160100081,,,,25,22,47
,2013,160100082,,,,10,11,21
,2013,160100083,,,,9,10,19
,2013,160100084,,,,55,68,123
,2013,160100085,,,,75,57,132
,2013,160100086,,,,96,74,170
,2013,160100087,,,,19,21,40
,2013,160100088,,,,10,14,24
,2013,160100088,,,,82,86,168
,2013,160100089,,,,2,5,7
,2013,160100090,,,,2,6,8
,2013,160100091,,,,19,11,30
,2013,160100092,,,,28,30,58
,2013,160100093,,,,10,3,13
,2013,160100095,,,,7,1,8
,2013,160100096,,,,23,13,36
,2013,160100097,,,,14,24,38
,2013,160100097,,,,14,24,38
,2013,160100099,,,,11,5,16
,2013,160100101,,,,39,36,75
,2013,160100101,,,,37,33,70
,2013,160100102,,,,47,55,102
,2013,160100102,,,,21,23,44
,2013,160100103,,,,81,92,173
,2013,160100104,,,,24,17,41
,2013,160100105,,,,44,28,72
,2013,160100107,,,,17,27,44
,2013,160100107,,,,34,48,82
,2013,160100107,,,,18,4,22
,2013,160100108,,,,6,5,11
,2013,160100109,,,,5,4,9
,2013,160100109,,,,18,21,39
,2013,160100110,,,,16,16,32
,2013,160100127,,,,19,21,40
,2013,160100130,,,,10,14,24
,2013,160100132,,,,5,4,9
,2013,160100134,,,,4,1,5
,2013,160100136,,,,5,9,14
,2013,160100137,,,,5,6,11
,2013,160100138,,,,10,10,20
,2013,160100141,,,,8,5,13
,2013,160100144,,,,12,15,27
,2013,160100145,,,,20,21,41
,2013,160100146,,,,11,5,16
,2013,160100147,,,,2,7,9
,2013,160100148,,,,6,5,11
,2013,160100149,,,,12,3,15
,2013,160100151,,,,5,7,12
,2013,160100152,,,,26,19,45
,2013,160100153,,,,39,30,69
,2013,160100154,,,,9,7,16
,2013,160100154,,,,53,34,87
,2013,160100154,,,,18,24,42
,2013,160100155,,,,114,146,260
,2013,160100156,,,,5,8,13
,2013,160100157,,,,7,5,12
,2013,160100158,,,,5,12,17
,2013,160100159,,,,9,16,25
,2013,160100160,,,,5,5,10
,2013,160100161,,,,4,5,9
,2013,160100162,,,,3,5,8
,2013,160100163,,,,1,3,4
,2013,160100163,,,,4,18,22
,2013,160100164,,,,4,9,13
,2013,160100165,,,,4,11,15
,2013,160100167,,,,1,4,5
,2013,160100169,,,,7,7,14
,2013,160100177,,,,2,6,8
,2013,160100178,,,,4,6,10
,2013,160200001,,,,241,233,474
,2013,160200002,,,,44,46,90
,2013,160200003,,,,36,34,70
,2013,160200004,,,,117,97,214
,2013,160200005,,,,63,73,136
,2013,160200006,,,,20,12,32
,2013,160200007,,,,26,32,58
,2013,160200008,,,,63,47,110
,2013,160200009,,,,38,27,65
,2013,160200010,,,,15,9,24
,2013,160200011,,,,71,87,158
,2013,160200012,,,,24,30,54
,2013,160200013,,,,41,29,70
,2013,160200014,,,,20,13,33
,2013,160200015,,,,25,13,38
,2013,160200017,,,,20,30,50
,2013,160200018,,,,125,146,271
,2013,160200019,,,,15,16,31
,2013,160200020,,,,23,20,43
,2013,160200041,,,,9,6,15
,2013,160200042,,,,7,8,15
,2013,160200043,,,,14,5,19
,2013,160200044,,,,12,10,22
,2013,160200046,,,,8,7,15
,2013,160200047,,,,7,5,12
,2013,160200048,,,,11,3,14
,2013,160200050,,,,10,8,18
,2013,160200052,,,,7,6,13
,2013,160200053,,,,3,3,6
,2013,160200054,,,,13,6,19
,2013,160200055,,,,8,7,15
,2013,160200074,,,,4,1,5
,2013,160200096,,,,2,3,5
,2013,160200102,,,,23,27,50
,2013,160200103,,,,6,2,8
,2013,160200104,,,,9,9,18
,2013,160200105,,,,1,3,4
,2013,160200106,,,,2,2,4
,2013,160200108,,,,68,70,138
,2013,160200109,,,,2,4,6
,2013,160200110,,,,4,2,6
,2013,160200111,,,,2,2,4
,2013,160200112,,,,4,4,8
,2013,160200113,,,,1,4,5
,2013,160200114,,,,2,2,4
,2013,160200116,,,,5,1,6
,2013,160300001,,,,46,40,86
,2013,160300002,,,,196,213,409
,2013,160300003,,,,57,40,97
,2013,160300004,,,,28,35,63
,2013,160300005,,,,43,47,90
,2013,160300006,,,,76,61,137
,2013,160300007,,,,42,31,73
,2013,160300008,,,,60,58,118
,2013,160300009,,,,67,77,144
,2013,160300010,,,,39,29,68
,2013,160300011,,,,145,126,271
,2013,160300012,,,,59,46,105
,2013,160300013,,,,85,73,158
,2013,160300014,,,,39,38,77
,2013,160300015,,,,48,42,90
,2013,160300016,,,,10,11,21
,2013,160300017,,,,13,22,35
,2013,160300018,,,,65,62,127
,2013,160300019,,,,28,32,60
,2013,160300020,,,,19,20,39
,2013,160300021,,,,14,16,30
,2013,160300022,,,,62,67,129
,2013,160300023,,,,205,254,459
,2013,160300024,,,,18,31,49
,2013,160300025,,,,4,3,7
,2013,160300026,,,,12,7,19
,2013,160300027,,,,23,15,38
,2013,160300030,,,,21,10,31
,2013,160300031,,,,29,34,63
,2013,160300032,,,,25,23,48
,2013,160300033,,,,8,11,19
,2013,160300034,,,,24,13,37
,2013,160300035,,,,34,32,66
,2013,160300036,,,,14,10,24
,2013,160300037,,,,181,160,341
,2013,160300039,,,,5,5,10
,2013,160300042,,,,15,10,25
,2013,160300044,,,,7,10,17
,2013,160300045,,,,8,2,10
,2013,160300046,,,,10,17,27
,2013,160300047,,,,12,12,24
,2013,160300049,,,,6,10,16
,2013,160300051,,,,8,10,18
,2013,160300052,,,,6,4,10
,2013,160300054,,,,13,4,17
,2013,160300055,,,,9,16,25
,2013,160300057,,,,8,8,16
,2013,160300059,,,,2,8,10
,2013,160300060,,,,5,4,9
,2013,160300062,,,,3,9,12
,2013,160300063,,,,20,36,56
,2013,160300064,,,,9,7,16
,2013,160300065,,,,6,9,15
,2013,160300067,,,,5,1,6
,2013,160300069,,,,6,6,12
,2013,160300071,,,,8,8,16
,2013,160300073,,,,18,17,35
,2013,160300076,,,,8,14,22
,2013,160300089,,,,9,6,15
,2013,160300109,,,,5,5,10
,2013,160300117,,,,11,13,24
,2013,160300118,,,,12,8,20
,2013,160300120,,,,8,11,19
,2013,160300121,,,,5,10,15
,2013,160300123,,,,5,6,11
,2013,160300124,,,,10,11,21
,2013,160300126,,,,15,6,21
,2013,160300128,,,,7,8,15
,2013,160300129,,,,8,8,16
,2013,160300130,,,,15,28,43
,2013,160300131,,,,9,6,15
,2013,160300132,,,,6,9,15
,2013,160300133,,,,4,2,6
,2013,160300134,,,,7,2,9
,2013,160300135,,,,4,7,11
,2013,160300137,,,,6,7,13
,2013,160300138,,,,3,9,12
,2013,160400001,,,,236,263,499
,2013,160400002,,,,12,13,25
,2013,160400003,,,,216,225,441
,2013,160400004,,,,165,156,321
,2013,160400005,,,,31,38,69
,2013,160400006,,,,97,113,210
,2013,160400007,,,,267,289,556
,2013,160400008,,,,51,64,115
,2013,160400009,,,,16,26,42
,2013,160400010,,,,11,8,19
,2013,160400011,,,,29,24,53
,2013,160400011,,,,5,4,9
,2013,160400012,,,,17,30,47
,2013,160400013,,,,5,8,13
,2013,160400014,,,,14,10,24
,2013,160400015,,,,23,26,49
,2013,160400016,,,,18,15,33
,2013,160400017,,,,23,19,42
,2013,160400018,,,,4,8,12
,2013,160400019,,,,12,7,19
,2013,160400020,,,,17,23,40
,2013,160400021,,,,10,1,11
,2013,160400022,,,,7,22,29
,2013,160400023,,,,199,207,406
,2013,160400024,,,,12,16,28
,2013,160400025,,,,29,27,56
,2013,160400026,,,,34,35,69
,2013,160400028,,,,33,31,64
,2013,160400029,,,,17,17,34
,2013,160400030,,,,7,15,22
,2013,160400031,,,,45,37,82
,2013,160400033,,,,273,269,542
,2013,160400034,,,,11,12,23
,2013,160400035,,,,0,2,2
,2013,160400035,,,,7,5,12
,2013,160400035,,,,0,2,2
,2013,160400035,,,,7,5,12
,2013,160400036,,,,5,7,12
,2013,160400037,,,,90,87,177
,2013,160400038,,,,10,19,29
,2013,160400039,,,,5,5,10
,2013,160400040,,,,4,8,12
,2013,160400041,,,,20,15,35
,2013,160400057,,,,17,25,42
,2013,160400058,,,,2,5,7
,2013,160400059,,,,11,13,24
,2013,160400060,,,,27,14,41
,2013,160400069,,,,9,8,17
,2013,160400072,,,,4,10,14
,2013,160400072,,,,1,6,7
,2013,160400077,,,,10,10,20
,2013,160400079,,,,7,9,16
,2013,160400080,,,,7,5,12
,2013,160400081,,,,4,7,11
,2013,160500001,,,,52,41,93
,2013,160500002,,,,130,117,247
,2013,160500004,,,,50,44,94
,2013,160500005,,,,50,62,112
,2013,160500006,,,,49,46,95
,2013,160500007,,,,8,14,22
,2013,160500008,,,,35,20,55
,2013,160500009,,,,5,8,13
,2013,160500010,,,,7,17,24
,2013,160500011,,,,14,16,30
,2013,160500013,,,,45,37,82
,2013,160500014,,,,22,10,32
,2013,160500039,,,,14,12,26
,2013,160500040,,,,1,4,5
,2013,160500041,,,,16,10,26
,2013,160500043,,,,4,6,10
,2013,160600001,,,,201,199,400
,2013,160600002,,,,13,12,25
,2013,160600003,,,,31,28,59
,2013,160600005,,,,57,52,109
,2013,160600006,,,,118,110,228
,2013,160600007,,,,47,43,90
,2013,160600008,,,,38,19,57
,2013,160600009,,,,32,21,53
,2013,160600010,,,,116,76,192
,2013,160600011,,,,18,12,30
,2013,160600012,,,,15,15,30
,2013,160600014,,,,48,45,93
,2013,160600015,,,,102,91,193
,2013,160600016,,,,23,23,46
,2013,160600017,,,,6,12,18
,2013,160600018,,,,19,17,36
,2013,160600019,,,,16,9,25
,2013,160600020,,,,10,10,20
,2013,160600021,,,,29,23,52
,2013,160600022,,,,11,11,22
,2013,160600023,,,,2,3,5
,2013,160600025,,,,4,3,7
,2013,160600026,,,,13,6,19
,2013,160600028,,,,1,2,3
,2013,160600031,,,,15,13,28
,2013,160600033,,,,4,3,7
,2013,160600036,,,,10,11,21
,2013,160600037,,,,10,11,21
,2013,160600038,,,,10,10,20
,2013,160600039,,,,18,14,32
,2013,160600040,,,,12,10,22
,2013,160600041,,,,33,32,65
,2013,160600043,,,,0,3,3
,2013,160600044,,,,10,9,19
,2013,160600045,,,,6,16,22
,2013,160600046,,,,12,12,24
,2013,160600047,,,,2,5,7
,2013,160600072,,,,9,5,14
,2013,160600073,,,,3,4,7
,2013,160600074,,,,3,3,6
,2013,160600075,,,,4,3,7
,2013,160600077,,,,4,2,6
,2013,160600078,,,,1,5,6
,2013,160600079,,,,3,5,8
,2013,160600080,,,,3,9,12
,2013,160600081,,,,3,3,6
,2013,160600082,,,,95,68,163
,2013,160600083,,,,4,0,4
,2013,160600084,,,,2,1,3
,2013,160600085,,,,2,2,4
,2013,160600086,,,,1,2,3
,2013,160600088,,,,2,2,4
,2013,160600089,,,,2,2,4
,2013,160600090,,,,1,2,3
,2013,160600091,,,,11,5,16
,2013,160600092,,,,4,5,9
,2013,160600093,,,,2,5,7
,2013,160700001,,,,12,9,21
,2013,160700002,,,,73,76,149
,2013,160700003,,,,63,49,112
,2013,160700004,,,,42,46,88
,2013,160700005,,,,62,61,123
,2013,160700006,,,,31,26,57
,2013,160700007,,,,15,16,31
,2013,160700009,,,,48,39,87
,2013,160700009,,,,4,6,10
,2013,160700010,,,,34,30,64
,2013,160700011,,,,11,13,24
,2013,160700012,,,,6,10,16
,2013,160700013,,,,9,18,27
,2013,160700014,,,,134,160,294
,2013,160700015,,,,24,26,50
,2013,160700016,,,,9,7,16
,2013,160700017,,,,9,5,14
,2013,160700018,,,,21,12,33
,2013,160700019,,,,7,2,9
,2013,160700020,,,,13,13,26
,2013,160700023,,,,42,34,76
,2013,160700024,,,,24,14,38
,2013,160700025,,,,11,11,22
,2013,160700026,,,,4,8,12
,2013,160700027,,,,16,27,43
,2013,160700029,,,,4,3,7
,2013,160700030,,,,0,5,5
,2013,160700031,,,,7,3,10
,2013,160700032,,,,3,0,3
,2013,160700032,,,,8,5,13
,2013,160700033,,,,9,4,13
,2013,160700049,,,,7,13,20
,2013,160800001,,,,25,12,37
,2013,160800002,,,,89,66,155
,2013,160800003,,,,21,15,36
,2013,160800004,,,,39,26,65
,2013,160800005,,,,29,30,59
,2013,160800006,,,,30,25,55
,2013,160800007,,,,65,61,126
,2013,160800008,,,,75,70,145
,2013,160800009,,,,56,33,89
,2013,160800010,,,,16,8,24
,2013,160800011,,,,9,6,15
,2013,160800013,,,,15,15,30
,2013,160800014,,,,11,9,20
,2013,160800015,,,,3,6,9
,2013,160800016,,,,5,9,14
,2013,160800017,,,,0,6,6
,2013,160800018,,,,12,9,21
,2013,160800019,,,,2,6,8
,2013,160800020,,,,2,6,8
,2013,160800021,,,,7,6,13
,2013,160800022,,,,6,7,13
,2013,160800023,,,,9,21,30
,2013,160800024,,,,5,3,8
,2013,160800048,,,,5,9,14
,2013,160800049,,,,1,7,8
,2013,160800052,,,,5,2,7
,2013,160800053,,,,4,2,6
,2013,160900001,,,,106,111,217
,2013,160900002,,,,187,166,353
,2013,160900003,,,,77,53,130
,2013,160900004,,,,76,39,115
,2013,160900005,,,,85,89,174
,2013,160900007,,,,43,30,73
,2013,160900008,,,,17,10,27
,2013,160900009,,,,19,18,37
,2013,160900010,,,,33,32,65
,2013,160900011,,,,30,23,53
,2013,160900012,,,,20,34,54
,2013,160900013,,,,6,6,12
,2013,160900014,,,,22,18,40
,2013,160900015,,,,60,49,109
,2013,160900016,,,,119,127,246
,2013,160900017,,,,180,171,351
,2013,160900028,,,,13,11,24
,2013,160900034,,,,21,15,36
,2013,160900035,,,,9,13,22
,2013,160900036,,,,14,13,27
,2013,160900038,,,,8,3,11
,2013,160900039,,,,6,7,13
,2013,160900041,,,,4,10,14
,2013,160900042,,,,2,2,4
,2013,160900060,,,,10,5,15
,2013,160900061,,,,4,5,9
,2013,160900063,,,,4,2,6
,2013,161000001,,,,21,9,30
,2013,161000002,,,,86,66,152
,2013,161000003,,,,49,56,105
,2013,161000004,,,,21,25,46
,2013,161000005,,,,29,32,61
,2013,161000006,,,,121,155,276
,2013,161000007,,,,52,31,83
,2013,161000008,,,,8,5,13
,2013,161000009,,,,26,25,51
,2013,161000010,,,,9,17,26
,2013,161000011,,,,15,7,22
,2013,161000012,,,,13,17,30
,2013,161000013,,,,25,20,45
,2013,161000014,,,,5,12,17
,2013,161000015,,,,43,39,82
,2013,161000016,,,,13,10,23
,2013,161000018,,,,9,10,19
,2013,161000019,,,,6,2,8
,2013,161000041,,,,4,5,9
,2013,161000042,,,,4,5,9
,2013,161100001,,,,41,22,63
,2013,161100002,,,,11,7,18
,2013,161100003,,,,24,30,54
,2013,161100004,,,,34,37,71
,2013,161100005,,,,10,15,25
,2013,161100006,,,,44,37,81
,2013,161100007,,,,45,28,73
,2013,161100008,,,,11,10,21
,2013,161100009,,,,13,10,23
,2013,161100010,,,,23,21,44
,2013,161100011,,,,8,15,23
,2013,161100012,,,,187,172,359
,2013,161100013,,,,16,18,34
,2013,161100014,,,,193,191,384
,2013,161100015,,,,23,10,33
,2013,161100016,,,,8,12,20
,2013,161100017,,,,29,21,50
,2013,161100018,,,,30,26,56
,2013,161100019,,,,43,53,96
,2013,161100020,,,,32,18,50
,2013,161100021,,,,116,126,242
,2013,161100023,,,,18,11,29
,2013,161100025,,,,4,4,8
,2013,161100028,,,,19,12,31
,2013,161100029,,,,8,6,14
,2013,161100030,,,,13,15,28
,2013,161100048,,,,1,4,5
,2013,161100063,,,,8,20,28
,2013,161100064,,,,8,7,15
,2013,161100065,,,,7,3,10
,2013,161100066,,,,5,2,7
,2013,161100067,,,,6,6,12
,2013,161100068,,,,5,6,11
,2013,161100070,,,,3,2,5
,2013,161100071,,,,2,8,10
,2013,161100072,,,,3,5,8
,2013,161100074,,,,6,6,12
,2013,161100075,,,,6,4,10
,2013,161100076,,,,1,3,4
,2013,161100077,,,,6,9,15
,2013,161100078,,,,2,4,6
,2013,161100079,,,,5,7,12
,2013,161100080,,,,7,8,15
,2013,161100081,,,,20,16,36
,2013,161100082,,,,7,8,15
,2013,161200001,,,,15,22,37
,2013,161200002,,,,179,176,355
,2013,161200003,,,,25,25,50
,2013,161200004,,,,38,28,66
,2013,161200005,,,,57,47,104
,2013,161200006,,,,34,30,64
,2013,161200007,,,,12,8,20
,2013,161200008,,,,29,22,51
,2013,161200009,,,,16,28,44
,2013,161200010,,,,17,31,48
,2013,161200011,,,,139,128,267
,2013,161200012,,,,33,29,62
,2013,161200013,,,,85,81,166
,2013,161200014,,,,236,235,471
,2013,161200015,,,,110,93,203
,2013,161200016,,,,87,85,172
,2013,161200017,,,,230,226,456
,2013,161200018,,,,273,262,535
,2013,161200019,,,,87,96,183
,2013,161200020,,,,103,129,232
,2013,161200021,,,,28,45,73
,2013,161200022,,,,133,112,245
,2013,161200023,,,,13,11,24
,2013,161200024,,,,32,28,60
,2013,161200025,,,,25,18,43
,2013,161200026,,,,187,193,380
,2013,161200027,,,,40,28,68
,2013,161200028,,,,24,23,47
,2013,161200029,,,,29,22,51
,2013,161200030,,,,12,12,24
,2013,161200031,,,,11,12,23
,2013,161200032,,,,9,7,16
,2013,161200033,,,,40,37,77
,2013,161200034,,,,23,16,39
,2013,161200035,,,,9,12,21
,2013,161200036,,,,22,26,48
,2013,161200037,,,,16,8,24
,2013,161200038,,,,9,17,26
,2013,161200039,,,,16,18,34
,2013,161200040,,,,18,16,34
,2013,161200042,,,,6,9,15
,2013,161200042,,,,14,13,27
,2013,161200043,,,,27,32,59
,2013,161200044,,,,24,20,44
,2013,161200045,,,,27,43,70
,2013,161200046,,,,17,18,35
,2013,161200047,,,,3,3,6
,2013,161200048,,,,6,6,12
,2013,161200049,,,,7,13,20
,2013,161200050,,,,39,38,77
,2013,161200051,,,,291,13,304
,2013,161200052,,,,161,180,341
,2013,161200053,,,,207,240,447
,2013,161200054,,,,35,36,71
,2013,161200055,,,,8,2,10
,2013,161200056,,,,15,10,25
,2013,161200058,,,,11,17,28
,2013,161200059,,,,19,15,34
,2013,161200061,,,,26,13,39
,2013,161200062,,,,93,98,191
,2013,161200063,,,,13,15,28
,2013,161200064,,,,30,34,64
,2013,161200065,,,,7,11,18
,2013,161200067,,,,7,5,12
,2013,161200068,,,,21,16,37
,2013,161200071,,,,23,27,50
,2013,161200081,,,,22,17,39
,2013,161200082,,,,12,3,15
,2013,161200083,,,,8,14,22
,2013,161200084,,,,5,5,10
,2013,161200084,,,,3,1,4
,2013,161200084,,,,8,11,19
,2013,161200084,,,,8,11,19
,2013,161200085,,,,11,23,34
,2013,161200101,,,,15,14,29
,2013,161200102,,,,12,0,12
,2013,161200102,,,,6,9,15
,2013,161200104,,,,13,26,39
,2013,161200106,,,,13,8,21
,2013,161200107,,,,29,23,52
,2013,161200107,,,,3,4,7
,2013,161200108,,,,3,5,8
,2013,161200109,,,,11,8,19
,2013,161200110,,,,20,11,31
,2013,161200111,,,,6,9,15
,2013,161200112,,,,8,5,13
,2013,161200113,,,,8,8,16
,2013,161200114,,,,6,8,14
,2013,161200115,,,,6,2,8
,2013,161200118,,,,4,10,14
,2013,161200119,,,,4,14,18
,2013,161200120,,,,7,3,10
,2013,161200121,,,,4,5,9
,2013,161200122,,,,1,5,6
,2013,161200124,,,,16,6,22
,2013,161200125,,,,19,19,38
,2013,161200126,,,,53,41,94
,2013,161200127,,,,30,34,64
,2013,161200128,,,,8,6,14
,2013,161200129,,,,7,8,15
,2013,161200130,,,,4,5,9
,2013,161200131,,,,5,8,13
,2013,161200132,,,,3,5,8
,2013,161200134,,,,2,3,5
,2013,161200135,,,,5,5,10
,2013,161200136,,,,8,6,14
,2013,161200137,,,,6,3,9
,2013,161200138,,,,3,5,8
,2013,161200139,,,,5,2,7
,2013,161200141,,,,5,10,15
,2013,161200142,,,,4,4,8
,2013,161200144,,,,5,2,7
,2013,161200145,,,,6,5,11
,2013,161200146,,,,3,4,7
,2013,161200147,,,,9,3,12
,2013,161200148,,,,7,8,15
,2013,161200149,,,,6,3,9
,2013,161200151,,,,4,4,8
,2013,161200152,,,,8,7,15
,2013,161200154,,,,4,2,6
,2013,161200155,,,,7,7,14
,2013,161200156,,,,6,9,15
,2013,161200157,,,,4,4,8
,2013,161200158,,,,18,22,40
,2013,161300001,,,,162,127,289
,2013,161300002,,,,18,19,37
,2013,161300003,,,,27,31,58
,2013,161300004,,,,42,53,95
,2013,161300005,,,,48,54,102
,2013,161300006,,,,12,13,25
,2013,161300007,,,,18,17,35
,2013,161300008,,,,33,28,61
,2013,161300009,,,,12,15,27
,2013,161300010,,,,95,154,249
,2013,161300011,,,,48,37,85
,2013,161300012,,,,18,20,38
,2013,161300013,,,,22,21,43
,2013,161300014,,,,5,10,15
,2013,161300015,,,,32,32,64
,2013,161300016,,,,15,12,27
,2013,161300017,,,,15,22,37
,2013,161300018,,,,9,10,19
,2013,161300019,,,,64,65,129
,2013,161300020,,,,8,7,15
,2013,161300021,,,,42,47,89
,2013,161300022,,,,161,198,359
,2013,161300023,,,,7,11,18
,2013,161300024,,,,13,17,30
,2013,161300025,,,,12,10,22
,2013,161300026,,,,14,21,35
,2013,161300027,,,,22,27,49
,2013,161300028,,,,41,25,66
,2013,161300031,,,,16,21,37
,2013,161300032,,,,35,29,64
,2013,161300033,,,,51,50,101
,2013,161300034,,,,11,9,20
,2013,161300036,,,,9,16,25
,2013,161300037,,,,7,6,13
,2013,161300038,,,,12,14,26
,2013,161300039,,,,6,10,16
,2013,161300040,,,,16,8,24
,2013,161300041,,,,25,23,48
,2013,161300042,,,,23,17,40
,2013,161300044,,,,7,6,13
,2013,161300045,,,,11,5,16
,2013,161300046,,,,7,9,16
,2013,161300047,,,,4,6,10
,2013,161300049,,,,8,11,19
,2013,161300049,,,,10,1,11
,2013,161300091,,,,6,8,14
,2013,161300093,,,,4,2,6
,2013,161300095,,,,6,9,15
,2013,161300096,,,,8,2,10
,2013,161300098,,,,17,19,36
,2013,161300100,,,,5,3,8
,2013,161300101,,,,4,4,8
,2013,161300102,,,,6,5,11
,2013,161300103,,,,2,4,6
,2013,161300104,,,,7,4,11
,2013,161300105,,,,7,8,15
,2013,161300106,,,,4,3,7
,2013,161300107,,,,3,5,8
,2013,161300108,,,,3,4,7
,2013,161300109,,,,5,5,10
,2013,161300110,,,,5,9,14
,2013,161300111,,,,5,4,9
,2013,161300112,,,,8,3,11
,2013,161300113,,,,8,7,15
,2013,161300116,,,,9,4,13
,2013,161400002,,,,63,69,132
,2013,161400002,,,,156,149,305
,2013,161400003,,,,66,104,170
,2013,161400004,,,,33,50,83
,2013,161400005,,,,188,183,371
,2013,161400006,,,,12,10,22
,2013,161400007,,,,14,13,27
,2013,161400008,,,,27,34,61
,2013,161400009,,,,36,48,84
,2013,161400010,,,,27,22,49
,2013,161400011,,,,9,10,19
,2013,161400012,,,,12,8,20
,2013,161400013,,,,14,24,38
,2013,161400014,,,,17,7,24
,2013,161400016,,,,14,8,22
,2013,161400017,,,,27,18,45
,2013,161400018,,,,45,29,74
,2013,161400019,,,,3,2,5
,2013,161400021,,,,4,9,13
,2013,161400023,,,,6,7,13
,2013,161400025,,,,7,7,14
,2013,161400026,,,,8,7,15
,2013,161400027,,,,9,13,22
,2013,161400036,,,,10,10,20
,2013,161400037,,,,9,3,12
,2013,161400038,,,,8,12,20
,2013,161400041,,,,5,5,10
,2013,161400043,,,,0,4,4
,2013,161400044,,,,4,1,5
,2013,161400045,,,,3,3,6
,2013,161400046,,,,6,11,17
,2013,161400048,,,,6,3,9
,2013,161400049,,,,4,2,6
,2013,161400050,,,,2,3,5
,2013,161400051,,,,2,4,6
,2013,161400052,,,,10,6,16
,2013,161400053,,,,6,2,8
,2013,161500001,,,,304,322,626
,2013,161500002,,,,4,1,5
,2013,161500003,,,,18,27,45
,2013,161500004,,,,45,30,75
,2013,161500005,,,,44,54,98
,2013,161500006,,,,122,113,235
,2013,161500007,,,,46,40,86
,2013,161500008,,,,64,75,139
,2013,161500009,,,,34,30,64
,2013,161500010,,,,29,22,51
,2013,161500011,,,,25,35,60
,2013,161500012,,,,25,14,39
,2013,161500013,,,,77,69,146
,2013,161500014,,,,73,60,133
,2013,161500015,,,,184,186,370
,2013,161500017,,,,52,40,92
,2013,161500018,,,,15,16,31
,2013,161500019,,,,36,45,81
,2013,161500020,,,,42,24,66
,2013,161500021,,,,25,29,54
,2013,161500022,,,,112,124,236
,2013,161500023,,,,43,29,72
,2013,161500024,,,,30,27,57
,2013,161500025,,,,5,5,10
,2013,161500027,,,,15,7,22
,2013,161500029,,,,19,23,42
,2013,161500030,,,,22,12,34
,2013,161500031,,,,4,8,12
,2013,161500032,,,,11,13,24
,2013,161500035,,,,15,20,35
,2013,161500036,,,,5,7,12
,2013,161500037,,,,12,12,24
,2013,161500038,,,,10,7,17
,2013,161500039,,,,2,4,6
,2013,161500040,,,,12,11,23
,2013,161500041,,,,4,7,11
,2013,161500042,,,,11,6,17
,2013,161500043,,,,7,11,18
,2013,161500044,,,,10,3,13
,2013,161500049,,,,4,4,8
,2013,161500051,,,,5,4,9
,2013,161500052,,,,7,8,15
,2013,161500054,,,,2,3,5
,2013,161500055,,,,6,3,9
,2013,161500056,,,,7,23,30
,2013,161500056,,,,16,14,30
,2013,161500056,,,,7,23,30
,2013,161500057,,,,4,2,6
,2013,161500058,,,,2,6,8
,2013,161500061,,,,4,5,9
,2013,161600001,,,,221,222,443
,2013,161600002,,,,20,27,47
,2013,161600003,,,,28,30,58
,2013,161600004,,,,45,37,82
,2013,161600005,,,,34,16,50
,2013,161600006,,,,76,81,157
,2013,161600007,,,,112,91,203
,2013,161600008,,,,15,10,25
,2013,161600009,,,,35,40,75
,2013,161600010,,,,20,39,59
,2013,161600011,,,,82,72,154
,2013,161600012,,,,45,34,79
,2013,161600013,,,,46,37,83
,2013,161600014,,,,47,36,83
,2013,161600015,,,,102,81,183
,2013,161600016,,,,32,29,61
,2013,161600017,,,,44,48,92
,2013,161600018,,,,48,42,90
,2013,161600019,,,,17,22,39
,2013,161600020,,,,43,20,63
,2013,161600021,,,,17,9,26
,2013,161600022,,,,17,10,27
,2013,161600023,,,,21,30,51
,2013,161600024,,,,55,46,101
,2013,161600025,,,,14,6,20
,2013,161600026,,,,17,17,34
,2013,161600027,,,,75,79,154
,2013,161600028,,,,3,4,7
,2013,161600031,,,,11,13,24
,2013,161600033,,,,8,11,19
,2013,161600034,,,,16,15,31
,2013,161600035,,,,14,13,27
,2013,161600036,,,,6,4,10
,2013,161600038,,,,10,8,18
,2013,161600039,,,,6,7,13
,2013,161600040,,,,12,5,17
,2013,161600041,,,,12,14,26
,2013,161600042,,,,4,8,12
,2013,161600043,,,,88,62,150
,2013,161600044,,,,38,39,77
,2013,161600045,,,,17,18,35
,2013,161600046,,,,33,23,56
,2013,161600047,,,,16,13,29
,2013,161600048,,,,6,6,12
,2013,161600050,,,,18,22,40
,2013,161600053,,,,10,11,21
,2013,161600054,,,,14,25,39
,2013,161600055,,,,8,9,17
,2013,161600057,,,,6,2,8
,2013,161600063,,,,7,8,15
,2013,161600090,,,,4,4,8
,2013,161600099,,,,19,23,42
,2013,161600100,,,,11,8,19
,2013,161600101,,,,7,7,14
,2013,161600102,,,,7,6,13
,2013,161600103,,,,6,6,12
,2013,161600104,,,,9,9,18
,2013,161600105,,,,29,28,57
,2013,161600106,,,,4,4,8
,2013,161600107,,,,8,8,16
,2013,161600108,,,,4,4,8
,2013,161600109,,,,9,8,17
,2013,161600110,,,,3,3,6
,2013,161600111,,,,3,4,7
,2013,161600112,,,,4,3,7
,2013,161600113,,,,16,14,30
,2013,161600114,,,,17,13,30
,2013,161600115,,,,6,5,11
,2013,161600116,,,,10,8,18
,2013,161600117,,,,7,7,14
,2013,161600118,,,,10,12,22
,2013,161600120,,,,7,7,14
,2013,161700001,,,,415,424,839
,2013,161700002,,,,179,145,324
,2013,161700003,,,,412,395,807
,2013,161700004,,,,19,18,37
,2013,161700005,,,,15,17,32
,2013,161700006,,,,18,26,44
,2013,161700008,,,,11,21,32
,2013,161700009,,,,53,61,114
,2013,161700010,,,,101,96,197
,2013,161700012,,,,43,33,76
,2013,161700013,,,,49,37,86
,2013,161700014,,,,36,37,73
,2013,161700015,,,,9,12,21
,2013,161700015,,,,5,10,15
,2013,161700016,,,,26,25,51
,2013,161700017,,,,31,62,93
,2013,161700018,,,,33,28,61
,2013,161700019,,,,129,88,217
,2013,161700020,,,,161,134,295
,2013,161700021,,,,38,31,69
,2013,161700022,,,,107,97,204
,2013,161700023,,,,60,26,86
,2013,161700024,,,,51,50,101
,2013,161700025,,,,41,45,86
,2013,161700026,,,,83,72,155
,2013,161700027,,,,60,66,126
,2013,161700028,,,,64,52,116
,2013,161700029,,,,21,17,38
,2013,161700030,,,,36,47,83
,2013,161700031,,,,26,20,46
,2013,161700032,,,,11,7,18
,2013,161700033,,,,29,21,50
,2013,161700034,,,,47,32,79
,2013,161700035,,,,42,40,82
,2013,161700036,,,,14,10,24
,2013,161700037,,,,98,80,178
,2013,161700038,,,,16,13,29
,2013,161700039,,,,9,12,21
,2013,161700040,,,,30,30,60
,2013,161700041,,,,98,112,210
,2013,161700042,,,,15,15,30
,2013,161700043,,,,12,6,18
,2013,161700044,,,,96,84,180
,2013,161700045,,,,49,33,82
,2013,161700046,,,,16,10,26
,2013,161700047,,,,12,11,23
,2013,161700048,,,,12,12,24
,2013,161700050,,,,287,423,710
,2013,161700051,,,,259,316,575
,2013,161700052,,,,58,58,116
,2013,161700053,,,,4,4,8
,2013,161700054,,,,20,21,41
,2013,161700055,,,,17,23,40
,2013,161700056,,,,15,17,32
,2013,161700057,,,,141,123,264
,2013,161700058,,,,15,16,31
,2013,161700059,,,,27,15,42
,2013,161700060,,,,36,29,65
,2013,161700061,,,,39,56,95
,2013,161700062,,,,95,104,199
,2013,161700063,,,,111,102,213
,2013,161700064,,,,29,15,44
,2013,161700066,,,,11,20,31
,2013,161700067,,,,48,46,94
,2013,161700068,,,,10,13,23
,2013,161700069,,,,4,12,16
,2013,161700071,,,,20,22,42
,2013,161700072,,,,13,8,21
,2013,161700074,,,,18,17,35
,2013,161700075,,,,23,20,43
,2013,161700076,,,,8,17,25
,2013,161700078,,,,21,26,47
,2013,161700080,,,,10,14,24
,2013,161700081,,,,19,14,33
,2013,161700082,,,,37,24,61
,2013,161700083,,,,14,5,19
,2013,161700084,,,,9,8,17
,2013,161700089,,,,12,4,16
,2013,161700090,,,,16,15,31
,2013,161700092,,,,9,7,16
,2013,161700093,,,,42,40,82
,2013,161700094,,,,13,11,24
,2013,161700095,,,,10,17,27
,2013,161700095,,,,12,6,18
,2013,161700097,,,,9,11,20
,2013,161700098,,,,9,15,24
,2013,161700099,,,,22,15,37
,2013,161700100,,,,16,19,35
,2013,161700101,,,,9,4,13
,2013,161700102,,,,22,20,42
,2013,161700103,,,,68,69,137
,2013,161700103,,,,59,49,108
,2013,161700107,,,,13,18,31
,2013,161700107,,,,5,8,13
,2013,161700108,,,,9,10,19
,2013,161700109,,,,16,11,27
,2013,161700126,,,,25,29,54
,2013,161700126,,,,8,13,21
,2013,161700126,,,,8,10,18
,2013,161700128,,,,7,8,15
,2013,161700130,,,,73,82,155
,2013,161700131,,,,20,21,41
,2013,161700136,,,,4,7,11
,2013,161700137,,,,10,5,15
,2013,161700138,,,,8,16,24
,2013,161700139,,,,3,2,5
,2013,161700140,,,,6,8,14
,2013,161700141,,,,12,11,23
,2013,161700143,,,,12,13,25
,2013,161700145,,,,2,4,6
,2013,161700146,,,,5,5,10
,2013,161700147,,,,3,4,7
,2013,161700148,,,,2,4,6
,2013,161700149,,,,1,3,4
,2013,161700150,,,,7,5,12
,2013,161700152,,,,9,11,20
,2013,161700153,,,,16,22,38
,2013,161700154,,,,7,3,10
,2013,161700155,,,,4,3,7
,2013,161700156,,,,4,5,9
,2013,161700157,,,,3,5,8
,2013,161700158,,,,9,14,23
,2013,161700159,,,,9,9,18
,2013,161700160,,,,4,5,9
,2013,161700162,,,,7,6,13
,2013,161700163,,,,6,1,7
,2013,161700164,,,,17,13,30
,2013,161700165,,,,8,7,15
,2013,161700166,,,,4,2,6
,2013,161700167,,,,3,7,10
,2013,161700168,,,,15,20,35
,2013,161700169,,,,3,8,11
,2013,161700170,,,,3,5,8
,2013,161700171,,,,3,3,6
,2013,161700172,,,,19,9,28
,2013,161800001,,,,112,115,227
,2013,161800002,,,,89,52,141
,2013,161800003,,,,27,16,43
,2013,161800004,,,,17,14,31
,2013,161800005,,,,48,55,103
,2013,161800006,,,,11,13,24
,2013,161800007,,,,31,28,59
,2013,161800008,,,,20,8,28
,2013,161800009,,,,20,29,49
,2013,161800010,,,,14,8,22
,2013,161800011,,,,37,24,61
,2013,161800012,,,,71,63,134
,2013,161800012,,,,41,32,73
,2013,161800013,,,,41,29,70
,2013,161800014,,,,2,1,3
,2013,161800015,,,,5,6,11
,2013,161800016,,,,10,8,18
,2013,161800017,,,,6,2,8
,2013,161800018,,,,22,17,39
,2013,161800019,,,,69,56,125
,2013,161800020,,,,25,26,51
,2013,161800021,,,,31,12,43
,2013,161800022,,,,29,19,48
,2013,161800023,,,,2,3,5
,2013,161800024,,,,5,3,8
,2013,161800026,,,,17,14,31
,2013,161800027,,,,8,4,12
,2013,161800028,,,,13,13,26
,2013,161800029,,,,30,22,52
,2013,161800030,,,,12,12,24
,2013,161800033,,,,13,8,21
,2013,161800034,,,,7,14,21
,2013,161800036,,,,5,4,9
,2013,161800037,,,,4,4,8
,2013,161800038,,,,5,5,10
,2013,161800039,,,,11,13,24
,2013,161800040,,,,10,11,21
,2013,161800041,,,,8,4,12
,2013,161800042,,,,9,6,15
,2013,161800043,,,,23,17,40
,2013,161800065,,,,11,10,21
,2013,161800067,,,,33,24,57
,2013,161800068,,,,17,9,26
,2013,161800069,,,,5,3,8
,2013,161800070,,,,2,9,11
,2013,161900001,,,,128,125,253
,2013,161900002,,,,47,35,82
,2013,161900003,,,,11,10,21
,2013,161900004,,,,15,15,30
,2013,161900005,,,,17,13,30
,2013,161900006,,,,40,40,80
,2013,161900007,,,,99,87,186
,2013,161900008,,,,100,106,206
,2013,161900009,,,,59,47,106
,2013,161900010,,,,29,25,54
,2013,161900011,,,,62,61,123
,2013,161900012,,,,58,33,91
,2013,161900013,,,,97,90,187
,2013,161900015,,,,13,7,20
,2013,161900016,,,,16,25,41
,2013,161900017,,,,24,23,47
,2013,161900018,,,,16,7,23
,2013,161900019,,,,16,14,30
,2013,161900019,,,,48,54,102
,2013,161900020,,,,29,20,49
,2013,161900021,,,,24,26,50
,2013,161900022,,,,35,48,83
,2013,161900023,,,,92,74,166
,2013,161900024,,,,49,46,95
,2013,161900025,,,,25,26,51
,2013,161900026,,,,24,23,47
,2013,161900027,,,,21,15,36
,2013,161900028,,,,22,27,49
,2013,161900029,,,,22,28,50
,2013,161900030,,,,99,68,167
,2013,161900031,,,,27,18,45
,2013,161900032,,,,33,26,59
,2013,161900033,,,,5,4,9
,2013,161900034,,,,9,2,11
,2013,161900035,,,,8,3,11
,2013,161900036,,,,19,25,44
,2013,161900037,,,,12,13,25
,2013,161900038,,,,12,12,24
,2013,161900039,,,,14,14,28
,2013,161900041,,,,8,10,18
,2013,161900042,,,,280,269,549
,2013,161900043,,,,27,32,59
,2013,161900044,,,,22,12,34
,2013,161900045,,,,6,5,11
,2013,161900046,,,,4,9,13
,2013,161900047,,,,10,9,19
,2013,161900048,,,,14,10,24
,2013,161900049,,,,5,5,10
,2013,161900050,,,,8,3,11
,2013,161900051,,,,8,11,19
,2013,161900051,,,,11,11,22
,2013,161900052,,,,3,10,13
,2013,161900054,,,,13,7,20
,2013,161900055,,,,7,2,9
,2013,161900056,,,,10,4,14
,2013,161900058,,,,22,25,47
,2013,161900059,,,,5,11,16
,2013,161900060,,,,15,5,20
,2013,161900062,,,,6,4,10
,2013,161900063,,,,13,5,18
,2013,161900065,,,,7,5,12
,2013,161900066,,,,5,5,10
,2013,161900067,,,,12,9,21
,2013,161900068,,,,8,7,15
,2013,161900069,,,,3,7,10
,2013,161900070,,,,26,21,47
,2013,161900071,,,,28,28,56
,2013,161900072,,,,17,11,28
,2013,161900078,,,,5,5,10
,2013,161900102,,,,19,11,30
,2013,161900104,,,,9,4,13
,2013,161900105,,,,6,5,11
,2013,161900106,,,,5,7,12
,2013,161900107,,,,39,44,83
,2013,161900107,,,,3,8,11
,2013,161900108,,,,3,5,8
,2013,161900109,,,,6,12,18
,2013,161900110,,,,5,2,7
,2013,161900111,,,,9,5,14
,2013,161900112,,,,5,5,10
,2013,161900113,,,,7,7,14
,2013,161900114,,,,9,2,11
,2013,161900115,,,,3,5,8
,2013,161900116,,,,9,8,17
,2013,161900118,,,,5,8,13
,2013,162000001,,,,286,268,554
,2013,162000002,,,,15,21,36
,2013,162000003,,,,17,18,35
,2013,162000004,,,,35,32,67
,2013,162000005,,,,45,22,67
,2013,162000006,,,,144,104,248
,2013,162000007,,,,24,25,49
,2013,162000008,,,,64,79,143
,2013,162000009,,,,83,102,185
,2013,162000010,,,,44,24,68
,2013,162000011,,,,64,43,107
,2013,162000012,,,,37,31,68
,2013,162000013,,,,88,72,160
,2013,162000014,,,,60,75,135
,2013,162000015,,,,39,35,74
,2013,162000016,,,,28,41,69
,2013,162000017,,,,40,47,87
,2013,162000018,,,,20,15,35
,2013,162000019,,,,31,24,55
,2013,162000020,,,,19,16,35
,2013,162000021,,,,14,11,25
,2013,162000022,,,,21,22,43
,2013,162000023,,,,31,25,56
,2013,162000024,,,,12,7,19
,2013,162000025,,,,41,52,93
,2013,162000026,,,,30,26,56
,2013,162000027,,,,41,36,77
,2013,162000028,,,,74,56,130
,2013,162000029,,,,8,9,17
,2013,162000030,,,,50,42,92
,2013,162000031,,,,21,12,33
,2013,162000032,,,,31,33,64
,2013,162000033,,,,15,8,23
,2013,162000034,,,,8,12,20
,2013,162000035,,,,9,6,15
,2013,162000036,,,,20,21,41
,2013,162000037,,,,40,31,71
,2013,162000038,,,,38,38,76
,2013,162000039,,,,10,11,21
,2013,162000040,,,,34,40,74
,2013,162000041,,,,10,10,20
,2013,162000042,,,,68,70,138
,2013,162000043,,,,14,9,23
,2013,162000044,,,,292,253,545
,2013,162000045,,,,23,42,65
,2013,162000045,,,,25,22,47
,2013,162000046,,,,21,33,54
,2013,162000047,,,,16,0,16
,2013,162000048,,,,15,12,27
,2013,162000049,,,,4,5,9
,2013,162000050,,,,11,6,17
,2013,162000051,,,,4,6,10
,2013,162000052,,,,22,4,26
,2013,162000053,,,,10,8,18
,2013,162000055,,,,57,76,133
,2013,162000064,,,,5,1,6
,2013,162000065,,,,8,12,20
,2013,162000067,,,,5,5,10
,2013,162000069,,,,1,1,2
,2013,162000072,,,,10,9,19
,2013,162000073,,,,2,1,3
,2013,162000074,,,,7,6,13
,2013,162000075,,,,6,5,11
,2013,162000076,,,,5,3,8
,2013,162000077,,,,6,5,11
,2013,162000079,,,,3,3,6
,2013,162000080,,,,3,7,10
,2013,162000082,,,,7,4,11
,2013,162000084,,,,4,5,9
,2013,162000085,,,,5,9,14
,2013,162000090,,,,30,27,57
,2013,162000091,,,,7,15,22
,2013,162000092,,,,39,36,75
,2013,162000093,,,,23,27,50
,2013,162000094,,,,12,8,20
,2013,162000095,,,,12,7,19
,2013,162000096,,,,36,18,54
,2013,162000098,,,,23,27,50
,2013,162000102,,,,49,34,83
,2013,162000103,,,,9,3,12
,2013,162000105,,,,2,3,5
,2013,162000106,,,,52,14,66
,2013,162000108,,,,5,2,7
,2013,162000109,,,,4,3,7
,2013,162000112,,,,11,21,32
,2013,162000113,,,,8,6,14
,2013,162000114,,,,3,7,10
,2013,162000114,,,,25,22,47
,2013,162000115,,,,6,5,11
,2013,162000117,,,,5,4,9
,2013,162000119,,,,5,0,5
,2013,162000121,,,,6,9,15
,2013,162000122,,,,5,5,10
,2013,162000123,,,,3,6,9
,2013,162000124,,,,2,7,9
,2013,162000125,,,,7,10,17
,2013,162000127,,,,15,8,23
,2013,162000128,,,,7,11,18
,2013,162000130,,,,3,4,7
,2013,162000131,,,,13,15,28
,2013,162000132,,,,7,15,22
,2013,162000137,,,,3,5,8
,2013,162000143,,,,2,3,5
,2013,162000151,,,,4,3,7
,2013,162000160,,,,2,3,5
,2013,162000162,,,,8,2,10
,2013,162000170,,,,13,12,25
,2013,162000181,,,,7,7,14
,2013,162000182,,,,15,11,26
,2013,162000183,,,,10,14,24
,2013,162000184,,,,19,14,33
,2013,162000185,,,,7,3,10
,2013,162000187,,,,58,56,114
,2013,162000190,,,,5,3,8
,2013,162000191,,,,4,5,9
,2013,162000192,,,,4,2,6
,2013,162000193,,,,6,9,15
,2013,162000194,,,,2,2,4
,2013,162000195,,,,2,4,6
,2013,162000196,,,,5,3,8
,2013,162000197,,,,4,3,7
,2013,162000198,,,,4,4,8
,2013,162000199,,,,11,11,22
,2013,162000200,,,,12,10,22
,2013,162000201,,,,2,1,3
,2013,162000202,,,,109,93,202
,2013,162000203,,,,53,80,133
,2013,162000203,,,,7,15,22
,2013,162100001,,,,243,214,457
,2013,162100002,,,,191,144,335
,2013,162100003,,,,171,129,300
,2013,162100004,,,,115,95,210
,2013,162100004,,,,15,28,43
,2013,162100005,,,,18,24,42
,2013,162100006,,,,17,17,34
,2013,162100007,,,,34,16,50
,2013,162100008,,,,33,34,67
,2013,162100009,,,,46,44,90
,2013,162100010,,,,56,50,106
,2013,162100010,,,,6,5,11
,2013,162100011,,,,73,50,123
,2013,162100012,,,,26,28,54
,2013,162100013,,,,66,61,127
,2013,162100014,,,,55,49,104
,2013,162100015,,,,19,15,34
,2013,162100016,,,,36,26,62
,2013,162100017,,,,26,26,52
,2013,162100018,,,,21,18,39
,2013,162100021,,,,28,21,49
,2013,162100022,,,,216,253,469
,2013,162100023,,,,34,26,60
,2013,162100024,,,,16,19,35
,2013,162100025,,,,19,22,41
,2013,162100026,,,,8,4,12
,2013,162100027,,,,31,33,64
,2013,162100028,,,,5,9,14
,2013,162100029,,,,4,4,8
,2013,162100030,,,,9,5,14
,2013,162100031,,,,13,18,31
,2013,162100032,,,,21,27,48
,2013,162100033,,,,10,15,25
,2013,162100048,,,,3,9,12
,2013,162100063,,,,8,2,10
,2013,162100065,,,,4,4,8
,2013,162100065,,,,7,9,16
,2013,162100066,,,,23,24,47
,2013,162100068,,,,3,7,10
,2013,162100069,,,,5,8,13
,2013,162100071,,,,3,2,5
,2013,162100072,,,,6,4,10
,2013,162100074,,,,6,3,9
,2013,162100075,,,,7,4,11
,2013,162100076,,,,4,3,7
,2013,162100077,,,,3,3,6
,2013,162100078,,,,12,10,22
,2013,162100079,,,,6,10,16
,2013,162100080,,,,10,7,17
,2013,162100081,,,,24,25,49
,2013,162100082,,,,12,4,16
,2013,162100083,,,,4,0,4
,2013,162100084,,,,9,11,20
,2013,162100089,,,,6,4,10
,2013,162100090,,,,6,2,8
,2013,162200001,,,,179,173,352
,2013,162200002,,,,10,10,20
,2013,162200003,,,,300,262,562
,2013,162200004,,,,58,41,99
,2013,162200005,,,,102,89,191
,2013,162200006,,,,57,42,99
,2013,162200007,,,,89,81,170
,2013,162200008,,,,43,35,78
,2013,162200009,,,,56,40,96
,2013,162200010,,,,19,15,34
,2013,162200011,,,,17,20,37
,2013,162200012,,,,35,27,62
,2013,162200013,,,,91,88,179
,2013,162200014,,,,26,19,45
,2013,162200015,,,,51,43,94
,2013,162200016,,,,18,22,40
,2013,162200017,,,,43,26,69
,2013,162200018,,,,10,7,17
,2013,162200019,,,,32,33,65
,2013,162200020,,,,396,388,784
,2013,162200022,,,,9,12,21
,2013,162200023,,,,6,7,13
,2013,162200025,,,,11,9,20
,2013,162200027,,,,30,24,54
,2013,162200028,,,,17,12,29
,2013,162200029,,,,9,11,20
,2013,162200030,,,,10,10,20
,2013,162200032,,,,12,12,24
,2013,162200033,,,,14,10,24
,2013,162200034,,,,5,7,12
,2013,162200035,,,,2,5,7
,2013,162200037,,,,8,7,15
,2013,162200038,,,,3,4,7
,2013,162200052,,,,6,8,14
,2013,162200065,,,,6,4,10
,2013,162200068,,,,2,4,6
,2013,162200072,,,,2,5,7
,2013,162200074,,,,5,5,10
,2013,162200108,,,,9,9,18
,2013,162200109,,,,6,11,17
,2013,162200110,,,,4,9,13
,2013,162200111,,,,6,9,15
,2013,162200112,,,,9,16,25
,2013,162200113,,,,7,12,19
,2013,162200114,,,,12,17,29
,2013,162200115,,,,3,1,4
,2013,162200117,,,,14,21,35
,2013,162200119,,,,2,6,8
,2013,162200120,,,,7,2,9
,2013,162200121,,,,5,3,8
,2013,162300001,,,,26,17,43
,2013,162300002,,,,59,60,119
,2013,162300003,,,,210,174,384
,2013,162300004,,,,82,107,189
,2013,162300005,,,,41,41,82
,2013,162300006,,,,42,33,75
,2013,162300007,,,,31,40,71
,2013,162300008,,,,102,113,215
,2013,162300009,,,,35,15,50
,2013,162300010,,,,41,41,82
,2013,162300011,,,,40,54,94
,2013,162300012,,,,79,62,141
,2013,162300013,,,,26,14,40
,2013,162300014,,,,33,14,47
,2013,162300015,,,,33,37,70
,2013,162300016,,,,56,57,113
,2013,162300018,,,,18,16,34
,2013,162300019,,,,18,20,38
,2013,162300020,,,,17,14,31
,2013,162300021,,,,9,22,31
,2013,162300022,,,,11,17,28
,2013,162300023,,,,0,5,5
,2013,162300024,,,,25,20,45
,2013,162300025,,,,23,17,40
,2013,162300026,,,,165,150,315
,2013,162300027,,,,5,9,14
,2013,162300028,,,,8,14,22
,2013,162300029,,,,10,12,22
,2013,162300030,,,,6,8,14
,2013,162300031,,,,22,30,52
,2013,162300032,,,,8,3,11
,2013,162300034,,,,4,4,8
,2013,162300035,,,,4,5,9
,2013,162300036,,,,11,7,18
,2013,162300037,,,,12,14,26
,2013,162300039,,,,22,21,43
,2013,162300040,,,,8,10,18
,2013,162300041,,,,45,59,104
,2013,162300042,,,,17,18,35
,2013,162300043,,,,8,5,13
,2013,162300044,,,,17,20,37
,2013,162300045,,,,3,2,5
,2013,162300046,,,,196,231,427
,2013,162300069,,,,9,10,19
,2013,162300072,,,,1,8,9
,2013,162300075,,,,5,2,7
,2013,162300076,,,,4,5,9
,2013,162300077,,,,4,3,7
,2013,162300079,,,,2,8,10
,2013,162300080,,,,3,4,7
,2013,162400001,,,,316,278,594
,2013,162400004,,,,33,36,69
,2013,162400005,,,,16,16,32
,2013,162400006,,,,5,4,9
,2013,162400008,,,,5,3,8
,2013,162400009,,,,5,5,10
,2013,162400011,,,,9,3,12
,2013,162400012,,,,4,6,10
,2013,162500001,,,,18,19,37
,2013,162500002,,,,201,228,429
,2013,162500003,,,,45,40,85
,2013,162500004,,,,44,43,87
,2013,162500005,,,,37,19,56
,2013,162500006,,,,61,35,96
,2013,162500008,,,,22,26,48
,2013,162500009,,,,0,5,5
,2013,162500011,,,,3,11,14
,2013,162500012,,,,9,6,15
,2013,162500013,,,,9,2,11
,2013,162500014,,,,5,3,8
,2013,162500015,,,,20,26,46
,2013,162500032,,,,4,4,8
,2013,162500033,,,,5,2,7
,2013,162500041,,,,8,6,14
,2013,162500042,,,,4,4,8
,2013,162500043,,,,5,4,9
,2013,162500044,,,,4,5,9
,2013,162500045,,,,3,5,8
,2013,162500046,,,,7,6,13
,2013,162500047,,,,3,10,13
,2013,162600001,,,,161,138,299
,2013,162600002,,,,111,87,198
,2013,162600003,,,,5,9,14
,2013,162600004,,,,31,29,60
,2013,162600005,,,,91,87,178
,2013,162600006,,,,18,16,34
,2013,162600007,,,,9,8,17
,2013,162600008,,,,33,21,54
,2013,162600009,,,,28,39,67
,2013,162600010,,,,35,49,84
,2013,162600011,,,,51,53,104
,2013,162600012,,,,34,46,80
,2013,162600013,,,,68,76,144
,2013,162600014,,,,138,170,308
,2013,162600015,,,,180,161,341
,2013,162600016,,,,9,11,20
,2013,162600017,,,,20,24,44
,2013,162600018,,,,93,50,143
,2013,162600019,,,,13,15,28
,2013,162600020,,,,36,29,65
,2013,162600021,,,,35,22,57
,2013,162600022,,,,24,26,50
,2013,162600023,,,,31,41,72
,2013,162600024,,,,15,17,32
,2013,162600025,,,,16,9,25
,2013,162600026,,,,6,11,17
,2013,162600027,,,,23,23,46
,2013,162600028,,,,25,28,53
,2013,162600029,,,,30,38,68
,2013,162600030,,,,43,38,81
,2013,162600031,,,,65,56,121
,2013,162600032,,,,26,24,50
,2013,162600033,,,,11,10,21
,2013,162600033,,,,84,106,190
,2013,162600034,,,,344,405,749
,2013,162600035,,,,9,6,15
,2013,162600036,,,,14,11,25
,2013,162600037,,,,6,3,9
,2013,162600040,,,,10,6,16
,2013,162600043,,,,9,10,19
,2013,162600044,,,,2,6,8
,2013,162600045,,,,15,7,22
,2013,162600046,,,,11,6,17
,2013,162600048,,,,8,8,16
,2013,162600049,,,,8,13,21
,2013,162600050,,,,8,8,16
,2013,162600053,,,,9,5,14
,2013,162600054,,,,5,8,13
,2013,162600055,,,,9,8,17
,2013,162600057,,,,6,5,11
,2013,162600057,,,,10,12,22
,2013,162600058,,,,19,6,25
,2013,162600058,,,,22,11,33
,2013,162600060,,,,6,3,9
,2013,162600061,,,,7,8,15
,2013,162600062,,,,6,3,9
,2013,162600063,,,,24,21,45
,2013,162600066,,,,3,5,8
,2013,162600067,,,,11,3,14
,2013,162600068,,,,28,13,41
,2013,162600070,,,,11,6,17
,2013,162600070,,,,2,15,17
,2013,162600093,,,,6,3,9
,2013,162600094,,,,21,26,47
,2013,162600094,,,,11,10,21
,2013,162600095,,,,9,5,14
,2013,162600097,,,,5,4,9
,2013,162600098,,,,5,4,9
,2013,162600099,,,,7,6,13
,2013,162600100,,,,6,4,10
,2013,162700001,,,,376,372,748
,2013,162700002,,,,229,214,443
,2013,162700003,,,,15,19,34
,2013,162700004,,,,117,137,254
,2013,162700005,,,,60,69,129
,2013,162700006,,,,20,29,49
,2013,162700007,,,,66,58,124
,2013,162700008,,,,93,83,176
,2013,162700009,,,,33,47,80
,2013,162700011,,,,62,51,113
,2013,162700012,,,,64,50,114
,2013,162700013,,,,19,9,28
,2013,162700014,,,,35,30,65
,2013,162700015,,,,75,57,132
,2013,162700016,,,,24,26,50
,2013,162700017,,,,25,16,41
,2013,162700018,,,,20,25,45
,2013,162700019,,,,110,100,210
,2013,162700020,,,,256,263,519
,2013,162700022,,,,28,24,52
,2013,162700023,,,,13,15,28
,2013,162700024,,,,26,29,55
,2013,162700024,,,,6,11,17
,2013,162700026,,,,40,34,74
,2013,162700027,,,,514,616,1130
,2013,162700028,,,,44,44,88
,2013,162700029,,,,11,13,24
,2013,162700031,,,,41,44,85
,2013,162700032,,,,13,10,23
,2013,162700033,,,,10,3,13
,2013,162700034,,,,6,9,15
,2013,162700035,,,,17,12,29
,2013,162700036,,,,14,11,25
,2013,162700037,,,,11,3,14
,2013,162700039,,,,10,8,18
,2013,162700040,,,,6,7,13
,2013,162700041,,,,16,15,31
,2013,162700042,,,,19,16,35
,2013,162700043,,,,14,20,34
,2013,162700044,,,,10,21,31
,2013,162700045,,,,12,12,24
,2013,162700046,,,,6,7,13
,2013,162700047,,,,8,6,14
,2013,162700048,,,,10,8,18
,2013,162700049,,,,7,13,20
,2013,162700049,,,,22,15,37
,2013,162700051,,,,18,13,31
,2013,162700052,,,,6,6,12
,2013,162700055,,,,9,7,16
,2013,162700094,,,,7,4,11
,2013,162700095,,,,3,9,12
,2013,162700096,,,,4,7,11
,2013,162700097,,,,9,1,10
,2013,162700098,,,,6,5,11
,2013,162700099,,,,1,2,3
,2013,162700099,,,,1,6,7
,2013,162700099,,,,5,2,7
,2013,162700100,,,,60,70,130
,2013,162700101,,,,5,8,13
,2013,162700102,,,,7,4,11
,2013,162700103,,,,3,3,6
,2013,162800001,,,,43,30,73
,2013,162800002,,,,14,12,26
,2013,162800003,,,,255,251,506
,2013,162800004,,,,71,76,147
,2013,162800005,,,,135,122,257
,2013,162800006,,,,51,40,91
,2013,162800007,,,,49,45,94
,2013,162800008,,,,56,62,118
,2013,162800009,,,,17,19,36
,2013,162800010,,,,33,22,55
,2013,162800011,,,,31,26,57
,2013,162800011,,,,8,8,16
,2013,162800012,,,,1,5,6
,2013,162800012,,,,32,25,57
,2013,162800013,,,,17,12,29
,2013,162800014,,,,33,14,47
,2013,162800016,,,,20,14,34
,2013,162800017,,,,20,25,45
,2013,162800018,,,,19,16,35
,2013,162800019,,,,10,11,21
,2013,162800021,,,,32,23,55
,2013,162800022,,,,14,12,26
,2013,162800023,,,,63,58,121
,2013,162800024,,,,37,32,69
,2013,162800025,,,,109,159,268
,2013,162800026,,,,31,47,78
,2013,162800027,,,,10,11,21
,2013,162800028,,,,16,22,38
,2013,162800029,,,,152,170,322
,2013,162800030,,,,45,43,88
,2013,162800031,,,,14,12,26
,2013,162800032,,,,5,11,16
,2013,162800033,,,,15,18,33
,2013,162800034,,,,17,7,24
,2013,162800035,,,,7,9,16
,2013,162800036,,,,7,7,14
,2013,162800037,,,,6,2,8
,2013,162800037,,,,6,3,9
,2013,162800038,,,,8,7,15
,2013,162800039,,,,10,5,15
,2013,162800040,,,,12,5,17
,2013,162800042,,,,17,16,33
,2013,162800043,,,,17,16,33
,2013,162800044,,,,6,14,20
,2013,162800045,,,,15,14,29
,2013,162800047,,,,11,3,14
,2013,162800057,,,,12,5,17
,2013,162800059,,,,9,12,21
,2013,162800062,,,,15,7,22
,2013,162800064,,,,11,8,19
,2013,162800065,,,,22,17,39
,2013,162800066,,,,11,2,13
,2013,162800067,,,,5,5,10
,2013,162800068,,,,3,5,8
,2013,162800069,,,,5,3,8
,2013,162800072,,,,3,10,13
,2013,162800074,,,,7,5,12
,2013,162800075,,,,5,5,10
,2013,162800076,,,,6,7,13
,2013,162800078,,,,7,3,10
,2013,162800079,,,,6,4,10
,2013,162800080,,,,7,7,14
,2013,162800081,,,,3,6,9
,2013,162800082,,,,3,7,10
,2013,162800083,,,,10,5,15
,2013,162800084,,,,12,5,17
,2013,162800085,,,,9,2,11
,2013,162800086,,,,3,3,6
,2013,162800087,,,,2,6,8
,2013,162800089,,,,9,7,16
,2013,162800090,,,,4,5,9
,2013,162800091,,,,6,5,11
,2013,162800092,,,,10,4,14
,2013,162800093,,,,5,6,11
,2013,162800094,,,,5,4,9
,2013,162800095,,,,0,8,8
,2013,162800096,,,,10,9,19
,2013,162800097,,,,4,6,10
,2013,170100001,,,,22,19,41
,2013,170100002,,,,14,13,27
,2013,170100004,,,,26,23,49
,2013,170100005,,,,29,19,48
,2013,170100006,,,,76,95,171
,2013,170100007,,,,10,11,21
,2013,170100007,,,,51,68,119
,2013,170100008,,,,24,17,41
,2013,170100008,,,,1,4,5
,2013,170100009,,,,4,5,9
,2013,170100009,,,,10,7,17
,2013,170100010,,,,66,47,113
,2013,170100011,,,,24,23,47
,2013,170100012,,,,15,17,32
,2013,170100013,,,,4,5,9
,2013,170100014,,,,12,7,19
,2013,170100015,,,,87,58,145
,2013,170100016,,,,204,161,365
,2013,170100017,,,,251,249,500
,2013,170100018,,,,35,54,89
,2013,170100019,,,,253,226,479
,2013,170100020,,,,2,4,6
,2013,170100021,,,,19,18,37
,2013,170100022,,,,12,11,23
,2013,170100023,,,,73,72,145
,2013,170100024,,,,31,28,59
,2013,170100024,,,,5,5,10
,2013,170100025,,,,0,5,5
,2013,170100025,,,,8,5,13
,2013,170100026,,,,53,36,89
,2013,170100026,,,,5,3,8
,2013,170100029,,,,30,29,59
,2013,170100030,,,,211,219,430
,2013,170100031,,,,27,21,48
,2013,170100032,,,,5,1,6
,2013,170100032,,,,4,4,8
,2013,170100033,,,,9,6,15
,2013,170100034,,,,26,21,47
,2013,170100035,,,,48,33,81
,2013,170100036,,,,15,18,33
,2013,170100037,,,,44,29,73
,2013,170100038,,,,35,25,60
,2013,170100039,,,,151,180,331
,2013,170100040,,,,22,19,41
,2013,170100041,,,,198,187,385
,2013,170100042,,,,23,30,53
,2013,170100042,,,,7,2,9
,2013,170100043,,,,21,21,42
,2013,170100044,,,,69,77,146
,2013,170100045,,,,27,38,65
,2013,170100046,,,,9,20,29
,2013,170100047,,,,72,69,141
,2013,170100048,,,,140,137,277
,2013,170100049,,,,29,18,47
,2013,170100050,,,,3,12,15
,2013,170100050,,,,4,5,9
,2013,170100051,,,,54,65,119
,2013,170100052,,,,82,69,151
,2013,170100053,,,,21,17,38
,2013,170100054,,,,75,52,127
,2013,170100055,,,,12,8,20
,2013,170100056,,,,7,9,16
,2013,170100057,,,,26,35,61
,2013,170100058,,,,39,32,71
,2013,170100059,,,,32,29,61
,2013,170100060,,,,13,7,20
,2013,170100060,,,,22,28,50
,2013,170100061,,,,19,12,31
,2013,170100061,,,,99,112,211
,2013,170100062,,,,30,31,61
,2013,170100063,,,,10,13,23
,2013,170100064,,,,20,13,33
,2013,170100065,,,,8,4,12
,2013,170100066,,,,10,8,18
,2013,170100067,,,,43,33,76
,2013,170100068,,,,21,20,41
,2013,170100069,,,,15,17,32
,2013,170100070,,,,23,22,45
,2013,170100071,,,,79,70,149
,2013,170100072,,,,1,5,6
,2013,170100072,,,,28,13,41
,2013,170100073,,,,56,53,109
,2013,170100074,,,,22,22,44
,2013,170100075,,,,26,18,44
,2013,170100076,,,,13,17,30
,2013,170100077,,,,250,250,500
,2013,170100078,,,,18,20,38
,2013,170100078,,,,12,2,14
,2013,170100079,,,,7,9,16
,2013,170100080,,,,13,16,29
,2013,170100080,,,,6,11,17
,2013,170100081,,,,10,7,17
,2013,170100081,,,,40,32,72
,2013,170100082,,,,43,29,72
,2013,170100082,,,,11,9,20
,2013,170100083,,,,4,8,12
,2013,170100083,,,,25,29,54
,2013,170100084,,,,34,17,51
,2013,170100085,,,,208,251,459
,2013,170100086,,,,71,86,157
,2013,170100088,,,,34,25,59
,2013,170100089,,,,81,86,167
,2013,170100091,,,,80,71,151
,2013,170100092,,,,17,13,30
,2013,170100093,,,,17,10,27
,2013,170100094,,,,47,47,94
,2013,170100095,,,,14,10,24
,2013,170100096,,,,18,19,37
,2013,170100098,,,,5,15,20
,2013,170100099,,,,31,25,56
,2013,170100101,,,,5,9,14
,2013,170100102,,,,11,14,25
,2013,170100103,,,,8,7,15
,2013,170100103,,,,54,47,101
,2013,170100104,,,,10,11,21
,2013,170100105,,,,18,15,33
,2013,170100106,,,,13,10,23
,2013,170100107,,,,24,15,39
,2013,170100108,,,,12,21,33
,2013,170100109,,,,13,16,29
,2013,170100110,,,,16,17,33
,2013,170100111,,,,3,7,10
,2013,170100112,,,,9,13,22
,2013,170100113,,,,13,18,31
,2013,170100114,,,,4,7,11
,2013,170100115,,,,4,10,14
,2013,170100116,,,,18,10,28
,2013,170100117,,,,5,6,11
,2013,170100118,,,,6,5,11
,2013,170100119,,,,13,18,31
,2013,170100120,,,,5,7,12
,2013,170100121,,,,14,6,20
,2013,170100122,,,,4,4,8
,2013,170100123,,,,9,3,12
,2013,170100124,,,,10,5,15
,2013,170100125,,,,5,1,6
,2013,170100126,,,,26,17,43
,2013,170100127,,,,14,11,25
,2013,170100128,,,,10,25,35
,2013,170100130,,,,863,895,1758
,2013,170100131,,,,3,10,13
,2013,170100132,,,,341,49,390
,2013,170100133,,,,189,198,387
,2013,170100134,,,,8,10,18
,2013,170100135,,,,24,28,52
,2013,170100138,,,,25,34,59
,2013,170100139,,,,87,117,204
,2013,170100143,,,,1,5,6
,2013,170100144,,,,9,7,16
,2013,170100145,,,,2,2,4
,2013,170100147,,,,6,6,12
,2013,170100148,,,,38,28,66
,2013,170100149,,,,8,7,15
,2013,170100152,,,,28,26,54
,2013,170100152,,,,12,9,21
,2013,170100153,,,,26,60,86
,2013,170100154,,,,4,8,12
,2013,170100161,,,,6,9,15
,2013,170100162,,,,9,9,18
,2013,170100163,,,,6,6,12
,2013,170100164,,,,5,4,9
,2013,170100165,,,,57,48,105
,2013,170100166,,,,7,3,10
,2013,170100170,,,,8,5,13
,2013,170100173,,,,3,0,3
,2013,170100174,,,,7,12,19
,2013,170100175,,,,32,27,59
,2013,170100176,,,,92,149,241
,2013,170100180,,,,27,15,42
,2013,170100181,,,,5,4,9
,2013,170100187,,,,3,4,7
,2013,170100190,,,,1,4,5
,2013,170100191,,,,8,2,10
,2013,170100192,,,,3,0,3
,2013,170100213,,,,1,3,4
,2013,170100214,,,,6,1,7
,2013,170100214,,,,48,49,97
,2013,170100216,,,,4,4,8
,2013,170100220,,,,2,4,6
,2013,170100224,,,,7,4,11
,2013,170100225,,,,16,13,29
,2013,170100226,,,,25,18,43
,2013,170100242,,,,7,13,20
,2013,170100243,,,,2,8,10
,2013,170100244,,,,2,5,7
,2013,170100245,,,,3,5,8
,2013,170100247,,,,3,3,6
,2013,170100249,,,,14,16,30
,2013,170100250,,,,6,3,9
,2013,170100251,,,,3,7,10
,2013,170100252,,,,3,3,6
,2013,170100253,,,,1,4,5
,2013,170100256,,,,3,2,5
,2013,170100258,,,,3,2,5
,2013,170100259,,,,4,4,8
,2013,170100260,,,,5,0,5
,2013,170100261,,,,6,13,19
,2013,170100262,,,,3,5,8
,2013,170100263,,,,3,3,6
,2013,170100264,,,,1,4,5
,2013,170100265,,,,5,4,9
,2013,170100266,,,,3,0,3
,2013,170100269,,,,2,3,5
,2013,170100270,,,,0,4,4
,2013,170100272,,,,15,14,29
,2013,170100272,,,,1,2,3
,2013,170100272,,,,3,6,9
,2013,170100273,,,,4,6,10
,2013,170100274,,,,5,3,8
,2013,170100275,,,,4,2,6
,2013,170100276,,,,4,2,6
,2013,170100279,,,,5,3,8
,2013,170100282,,,,7,5,12
,2013,170100283,,,,6,6,12
,2013,170100283,,,,9,19,28
,2013,170100284,,,,1,2,3
,2013,170100285,,,,2,3,5
,2013,170100286,,,,4,1,5
,2013,170100287,,,,6,6,12
,2013,170100289,,,,123,172,295
,2013,170200001,,,,3,4,7
,2013,170200002,,,,38,49,87
,2013,170200003,,,,14,15,29
,2013,170200004,,,,31,19,50
,2013,170200005,,,,142,161,303
,2013,170200006,,,,20,15,35
,2013,170200007,,,,35,37,72
,2013,170200008,,,,58,43,101
,2013,170200009,,,,10,8,18
,2013,170200010,,,,94,112,206
,2013,170200012,,,,6,6,12
,2013,170200013,,,,9,6,15
,2013,170200013,,,,1,2,3
,2013,170200014,,,,4,2,6
,2013,170200015,,,,8,7,15
,2013,170200016,,,,17,19,36
,2013,170200017,,,,14,10,24
,2013,170200018,,,,15,12,27
,2013,170200019,,,,18,23,41
,2013,170200020,,,,15,14,29
,2013,170200021,,,,4,5,9
,2013,170200022,,,,182,172,354
,2013,170200022,,,,16,27,43
,2013,170200023,,,,11,13,24
,2013,170200024,,,,4,7,11
,2013,170200026,,,,24,20,44
,2013,170200250,,,,4,3,7
,2013,170200251,,,,4,4,8
,2013,170200252,,,,3,2,5
,2013,170200253,,,,3,0,3
,2013,170200254,,,,4,6,10
,2013,170300001,,,,98,95,193
,2013,170300002,,,,15,8,23
,2013,170300003,,,,46,35,81
,2013,170300004,,,,31,27,58
,2013,170300005,,,,21,22,43
,2013,170300006,,,,25,27,52
,2013,170300007,,,,22,24,46
,2013,170300008,,,,54,56,110
,2013,170300009,,,,47,46,93
,2013,170300010,,,,92,93,185
,2013,170300011,,,,14,12,26
,2013,170300012,,,,76,77,153
,2013,170300013,,,,19,13,32
,2013,170300014,,,,60,54,114
,2013,170300015,,,,24,23,47
,2013,170300016,,,,58,74,132
,2013,170300017,,,,77,75,152
,2013,170300017,,,,9,12,21
,2013,170300018,,,,47,39,86
,2013,170300019,,,,33,27,60
,2013,170300020,,,,21,15,36
,2013,170300021,,,,25,39,64
,2013,170300022,,,,17,13,30
,2013,170300023,,,,9,7,16
,2013,170300024,,,,15,15,30
,2013,170300025,,,,10,11,21
,2013,170300026,,,,230,264,494
,2013,170300030,,,,7,13,20
,2013,170300032,,,,39,46,85
,2013,170300033,,,,5,4,9
,2013,170300034,,,,19,7,26
,2013,170300035,,,,15,15,30
,2013,170300038,,,,8,14,22
,2013,170300038,,,,10,5,15
,2013,170300041,,,,11,9,20
,2013,170300042,,,,6,4,10
,2013,170300043,,,,5,5,10
,2013,170300044,,,,2,8,10
,2013,170300045,,,,0,4,4
,2013,170300052,,,,9,1,10
,2013,170300053,,,,7,10,17
,2013,170300054,,,,3,3,6
,2013,170300055,,,,2,5,7
,2013,170300056,,,,7,7,14
,2013,170300058,,,,27,20,47
,2013,170300063,,,,3,7,10
,2013,170300064,,,,4,3,7
,2013,170300065,,,,3,5,8
,2013,170300066,,,,8,4,12
,2013,170300068,,,,1,4,5
,2013,170300069,,,,5,5,10
,2013,170300072,,,,8,2,10
,2013,170300073,,,,3,5,8
,2013,170300074,,,,8,4,12
,2013,170400001,,,,84,84,168
,2013,170400002,,,,24,15,39
,2013,170400003,,,,39,26,65
,2013,170400004,,,,38,55,93
,2013,170400005,,,,28,21,49
,2013,170400006,,,,21,24,45
,2013,170400007,,,,18,13,31
,2013,170400008,,,,33,26,59
,2013,170400009,,,,28,27,55
,2013,170400009,,,,9,11,20
,2013,170400010,,,,4,11,15
,2013,170400011,,,,8,11,19
,2013,170400012,,,,9,16,25
,2013,170400013,,,,21,26,47
,2013,170400014,,,,4,7,11
,2013,170400015,,,,8,11,19
,2013,170400016,,,,7,2,9
,2013,170400017,,,,11,16,27
,2013,170400017,,,,3,3,6
,2013,170400018,,,,17,12,29
,2013,170400019,,,,14,15,29
,2013,170400020,,,,14,11,25
,2013,170400021,,,,10,4,14
,2013,170400022,,,,19,12,31
,2013,170400022,,,,5,5,10
,2013,170400023,,,,21,25,46
,2013,170400024,,,,19,15,34
,2013,170400025,,,,9,9,18
,2013,170400026,,,,140,149,289
,2013,170400027,,,,14,7,21
,2013,170400028,,,,11,12,23
,2013,170400029,,,,8,7,15
,2013,170400034,,,,1,6,7
,2013,170400048,,,,4,3,7
,2013,170400053,,,,2,8,10
,2013,170400054,,,,5,4,9
,2013,170400055,,,,18,13,31
,2013,170400064,,,,3,0,3
,2013,170500001,,,,93,94,187
,2013,170500002,,,,15,13,28
,2013,170500003,,,,8,9,17
,2013,170500004,,,,37,28,65
,2013,170500005,,,,25,13,38
,2013,170500006,,,,36,18,54
,2013,170500007,,,,22,26,48
,2013,170500008,,,,28,22,50
,2013,170500009,,,,13,17,30
,2013,170500010,,,,17,6,23
,2013,170500011,,,,23,28,51
,2013,170500012,,,,27,20,47
,2013,170500013,,,,3,4,7
,2013,170500014,,,,8,11,19
,2013,170500015,,,,7,5,12
,2013,170500016,,,,105,149,254
,2013,170500017,,,,5,2,7
,2013,170500019,,,,9,8,17
,2013,170600001,,,,100,108,208
,2013,170600002,,,,15,11,26
,2013,170600003,,,,7,12,19
,2013,170600004,,,,13,17,30
,2013,170600005,,,,12,23,35
,2013,170600006,,,,44,21,65
,2013,170600007,,,,98,68,166
,2013,170600008,,,,17,22,39
,2013,170600009,,,,56,65,121
,2013,170600010,,,,59,60,119
,2013,170600011,,,,41,35,76
,2013,170600012,,,,9,8,17
,2013,170600013,,,,13,19,32
,2013,170600014,,,,1,1,2
,2013,170600015,,,,18,21,39
,2013,170600016,,,,15,18,33
,2013,170600017,,,,12,12,24
,2013,170600017,,,,2,6,8
,2013,170600018,,,,15,14,29
,2013,170600019,,,,9,14,23
,2013,170600020,,,,87,90,177
,2013,170600021,,,,9,7,16
,2013,170600022,,,,39,49,88
,2013,170600023,,,,96,103,199
,2013,170600024,,,,7,15,22
,2013,170600024,,,,3,4,7
,2013,170600025,,,,75,79,154
,2013,170600026,,,,61,49,110
,2013,170600027,,,,50,53,103
,2013,170600028,,,,15,13,28
,2013,170600029,,,,8,8,16
,2013,170600029,,,,2,1,3
,2013,170600030,,,,50,39,89
,2013,170600031,,,,3,10,13
,2013,170600031,,,,22,20,42
,2013,170600032,,,,28,40,68
,2013,170600033,,,,22,29,51
,2013,170600034,,,,24,19,43
,2013,170600035,,,,17,14,31
,2013,170600036,,,,14,16,30
,2013,170600037,,,,12,8,20
,2013,170600038,,,,18,10,28
,2013,170600039,,,,17,17,34
,2013,170600040,,,,15,10,25
,2013,170600041,,,,7,8,15
,2013,170600042,,,,301,311,612
,2013,170600043,,,,7,9,16
,2013,170600046,,,,2,6,8
,2013,170600047,,,,8,5,13
,2013,170600048,,,,3,2,5
,2013,170600049,,,,4,4,8
,2013,170600050,,,,2,6,8
,2013,170600051,,,,4,5,9
,2013,170600056,,,,3,5,8
,2013,170600059,,,,5,5,10
,2013,170600060,,,,3,2,5
,2013,170600064,,,,5,5,10
,2013,170600071,,,,4,8,12
,2013,170600073,,,,1,7,8
,2013,170600075,,,,3,3,6
,2013,170600076,,,,5,3,8
,2013,170600077,,,,1,1,2
,2013,170600077,,,,40,24,64
,2013,170600078,,,,3,0,3
,2013,170600079,,,,1,3,4
,2013,170600081,,,,4,1,5
,2013,170600082,,,,28,61,89
,2013,170700002,,,,55,34,89
,2013,170700003,,,,4,2,6
,2013,170700003,,,,13,9,22
,2013,170700004,,,,110,108,218
,2013,170700005,,,,48,34,82
,2013,170700006,,,,14,10,24
,2013,170700007,,,,44,43,87
,2013,170700007,,,,4,3,7
,2013,170700008,,,,82,71,153
,2013,170700009,,,,63,55,118
,2013,170700010,,,,3,2,5
,2013,170700010,,,,17,10,27
,2013,170700011,,,,59,47,106
,2013,170700012,,,,56,45,101
,2013,170700013,,,,69,67,136
,2013,170700014,,,,19,18,37
,2013,170700014,,,,3,4,7
,2013,170700015,,,,38,30,68
,2013,170700016,,,,109,107,216
,2013,170700017,,,,33,25,58
,2013,170700017,,,,5,4,9
,2013,170700018,,,,6,12,18
,2013,170700019,,,,52,52,104
,2013,170700020,,,,188,171,359
,2013,170700021,,,,33,38,71
,2013,170700022,,,,73,78,151
,2013,170700023,,,,39,26,65
,2013,170700023,,,,3,2,5
,2013,170700024,,,,3,1,4
,2013,170700024,,,,21,19,40
,2013,170700025,,,,12,16,28
,2013,170700025,,,,2,4,6
,2013,170700026,,,,72,81,153
,2013,170700027,,,,106,98,204
,2013,170700028,,,,17,13,30
,2013,170700029,,,,23,19,42
,2013,170700030,,,,67,55,122
,2013,170700031,,,,15,7,22
,2013,170700031,,,,3,2,5
,2013,170700032,,,,0,4,4
,2013,170700032,,,,8,6,14
,2013,170700033,,,,6,3,9
,2013,170700033,,,,31,17,48
,2013,170700034,,,,22,18,40
,2013,170700035,,,,30,29,59
,2013,170700036,,,,33,29,62
,2013,170700037,,,,19,15,34
,2013,170700037,,,,2,5,7
,2013,170700038,,,,42,31,73
,2013,170700039,,,,42,21,63
,2013,170700039,,,,8,8,16
,2013,170700040,,,,10,8,18
,2013,170700040,,,,26,11,37
,2013,170700041,,,,57,55,112
,2013,170700042,,,,11,7,18
,2013,170700043,,,,6,12,18
,2013,170700044,,,,18,7,25
,2013,170700045,,,,12,11,23
,2013,170700046,,,,5,5,10
,2013,170700047,,,,4,12,16
,2013,170700048,,,,7,11,18
,2013,170700049,,,,7,15,22
,2013,170700050,,,,8,17,25
,2013,170700051,,,,20,13,33
,2013,170700052,,,,4,14,18
,2013,170700053,,,,22,12,34
,2013,170700054,,,,9,6,15
,2013,170700055,,,,12,12,24
,2013,170700056,,,,16,25,41
,2013,170700057,,,,705,616,1321
,2013,170700058,,,,262,245,507
,2013,170700060,,,,10,13,23
,2013,170700061,,,,2,5,7
,2013,170700062,,,,5,12,17
,2013,170700063,,,,10,8,18
,2013,170700064,,,,6,9,15
,2013,170700065,,,,24,20,44
,2013,170700066,,,,39,76,115
,2013,170700068,,,,5,7,12
,2013,170700076,,,,18,17,35
,2013,170700077,,,,1,2,3
,2013,170700079,,,,1,7,8
,2013,170700080,,,,1,3,4
,2013,170700081,,,,2,3,5
,2013,170700082,,,,3,2,5
,2013,170700083,,,,7,5,12
,2013,170700084,,,,1,3,4
,2013,170700085,,,,2,1,3
,2013,170700090,,,,4,5,9
,2013,170700092,,,,5,3,8
,2013,170700093,,,,2,10,12
,2013,170700098,,,,3,3,6
,2013,170700099,,,,4,2,6
,2013,170700100,,,,8,5,13
,2013,170700101,,,,3,5,8
,2013,170700102,,,,5,9,14
,2013,170700103,,,,23,17,40
,2013,170700104,,,,30,26,56
,2013,170700104,,,,14,5,19
,2013,170700104,,,,4,9,13
,2013,170700105,,,,5,5,10
,2013,170800002,,,,25,36,61
,2013,170800003,,,,58,62,120
,2013,170800004,,,,5,8,13
,2013,170800005,,,,112,91,203
,2013,170800006,,,,10,8,18
,2013,170800007,,,,30,22,52
,2013,170800008,,,,5,10,15
,2013,170800009,,,,147,137,284
,2013,170800010,,,,11,12,23
,2013,170800011,,,,23,17,40
,2013,170800012,,,,51,54,105
,2013,170800012,,,,4,5,9
,2013,170800013,,,,34,34,68
,2013,170800014,,,,62,43,105
,2013,170800015,,,,25,12,37
,2013,170800016,,,,21,32,53
,2013,170800017,,,,29,23,52
,2013,170800018,,,,40,20,60
,2013,170800019,,,,22,29,51
,2013,170800020,,,,47,41,88
,2013,170800020,,,,8,15,23
,2013,170800021,,,,6,3,9
,2013,170800025,,,,19,17,36
,2013,170800026,,,,5,4,9
,2013,170800027,,,,6,12,18
,2013,170800028,,,,4,9,13
,2013,170800029,,,,8,8,16
,2013,170800030,,,,135,151,286
,2013,170800034,,,,9,8,17
,2013,170800035,,,,7,12,19
,2013,170800035,,,,57,40,97
,2013,170800036,,,,3,4,7
,2013,170800037,,,,4,4,8
,2013,170800038,,,,7,7,14
,2013,170800038,,,,41,56,97
,2013,170800040,,,,4,1,5
,2013,170800107,,,,4,2,6
,2013,170800112,,,,2,7,9
,2013,170800115,,,,6,1,7
,2013,170800116,,,,25,30,55
,2013,170800119,,,,21,15,36
,2013,170800120,,,,8,9,17
,2013,170800143,,,,1,5,6
,2013,170800145,,,,4,4,8
,2013,170800146,,,,4,9,13
,2013,170800147,,,,6,1,7
,2013,170800148,,,,4,2,6
,2013,170800149,,,,2,4,6
,2013,170800150,,,,4,3,7
,2013,170800151,,,,4,6,10
,2013,170800152,,,,5,2,7
,2013,170800153,,,,2,4,6
,2013,170800154,,,,4,3,7
,2013,170800155,,,,2,5,7
,2013,170800156,,,,6,6,12
,2013,170800157,,,,4,4,8
,2013,170800158,,,,2,6,8
,2013,170800159,,,,3,2,5
,2013,170800160,,,,3,8,11
,2013,170800163,,,,5,6,11
,2013,170800164,,,,5,2,7
,2013,170900001,,,,350,287,637
,2013,170900001,,,,52,60,112
,2013,170900003,,,,351,378,729
,2013,170900005,,,,15,18,33
,2013,170900006,,,,55,48,103
,2013,170900007,,,,12,8,20
,2013,170900008,,,,144,157,301
,2013,170900009,,,,87,87,174
,2013,170900010,,,,121,91,212
,2013,170900010,,,,51,63,114
,2013,170900011,,,,47,37,84
,2013,170900012,,,,52,51,103
,2013,170900013,,,,15,31,46
,2013,170900014,,,,166,186,352
,2013,170900015,,,,128,141,269
,2013,170900016,,,,278,279,557
,2013,170900017,,,,140,121,261
,2013,170900018,,,,77,85,162
,2013,170900019,,,,93,81,174
,2013,170900020,,,,8,5,13
,2013,170900021,,,,76,62,138
,2013,170900022,,,,65,62,127
,2013,170900022,,,,7,9,16
,2013,170900022,,,,19,16,35
,2013,170900023,,,,52,36,88
,2013,170900025,,,,135,126,261
,2013,170900026,,,,88,71,159
,2013,170900027,,,,65,59,124
,2013,170900028,,,,39,30,69
,2013,170900030,,,,3,5,8
,2013,170900031,,,,15,18,33
,2013,170900031,,,,155,166,321
,2013,170900033,,,,87,84,171
,2013,170900034,,,,38,51,89
,2013,170900035,,,,31,9,40
,2013,170900036,,,,15,12,27
,2013,170900038,,,,38,47,85
,2013,170900039,,,,13,16,29
,2013,170900040,,,,18,8,26
,2013,170900041,,,,12,13,25
,2013,170900042,,,,24,22,46
,2013,170900043,,,,12,10,22
,2013,170900044,,,,11,10,21
,2013,170900045,,,,28,26,54
,2013,170900046,,,,6,10,16
,2013,170900047,,,,27,14,41
,2013,170900048,,,,26,24,50
,2013,170900049,,,,23,31,54
,2013,170900050,,,,27,30,57
,2013,170900051,,,,1137,1448,2585
,2013,170900051,,,,128,191,319
,2013,170900052,,,,58,6,64
,2013,170900054,,,,71,40,111
,2013,170900055,,,,230,273,503
,2013,170900056,,,,22,21,43
,2013,170900057,,,,9,11,20
,2013,170900058,,,,13,9,22
,2013,170900059,,,,7,2,9
,2013,170900060,,,,5,5,10
,2013,170900061,,,,2,5,7
,2013,170900062,,,,5,2,7
,2013,170900064,,,,21,17,38
,2013,170900065,,,,18,36,54
,2013,170900068,,,,19,19,38
,2013,170900068,,,,40,50,90
,2013,170900069,,,,121,125,246
,2013,170900070,,,,41,50,91
,2013,170900072,,,,4,3,7
,2013,170900073,,,,6,5,11
,2013,170900074,,,,9,11,20
,2013,170900075,,,,5,5,10
,2013,170900078,,,,34,26,60
,2013,170900079,,,,16,27,43
,2013,170900084,,,,3,6,9
,2013,170900088,,,,5,7,12
,2013,170900089,,,,3,1,4
,2013,170900090,,,,8,4,12
,2013,170900091,,,,5,4,9
,2013,170900096,,,,6,15,21
,2013,170900096,,,,11,8,19
,2013,180100001,,,,25,11,36
,2013,180100002,,,,24,31,55
,2013,180100003,,,,17,11,28
,2013,180100003,,,,4,2,6
,2013,180100004,,,,30,34,64
,2013,180100006,,,,381,347,728
,2013,180100007,,,,72,89,161
,2013,180100008,,,,26,28,54
,2013,180100008,,,,185,223,408
,2013,180100009,,,,92,64,156
,2013,180100010,,,,224,236,460
,2013,180100011,,,,11,18,29
,2013,180100012,,,,24,9,33
,2013,180100012,,,,3,8,11
,2013,180100013,,,,63,55,118
,2013,180100014,,,,11,18,29
,2013,180100014,,,,237,221,458
,2013,180100015,,,,4,4,8
,2013,180100015,,,,34,33,67
,2013,180100016,,,,272,282,554
,2013,180100017,,,,42,40,82
,2013,180100018,,,,30,19,49
,2013,180100019,,,,30,14,44
,2013,180100020,,,,30,40,70
,2013,180100021,,,,28,35,63
,2013,180100022,,,,15,7,22
,2013,180100022,,,,8,3,11
,2013,180100023,,,,6,8,14
,2013,180100024,,,,15,17,32
,2013,180100025,,,,14,14,28
,2013,180100026,,,,27,37,64
,2013,180100027,,,,12,12,24
,2013,180100027,,,,7,4,11
,2013,180100028,,,,4,5,9
,2013,180100028,,,,23,22,45
,2013,180100029,,,,21,22,43
,2013,180100030,,,,25,16,41
,2013,180100031,,,,4,4,8
,2013,180100031,,,,35,30,65
,2013,180100032,,,,14,14,28
,2013,180100033,,,,14,9,23
,2013,180100034,,,,21,31,52
,2013,180100035,,,,28,25,53
,2013,180100036,,,,8,13,21
,2013,180100036,,,,46,41,87
,2013,180100037,,,,3,6,9
,2013,180100037,,,,24,26,50
,2013,180100038,,,,5,10,15
,2013,180100038,,,,26,20,46
,2013,180100039,,,,32,38,70
,2013,180100040,,,,60,45,105
,2013,180100041,,,,55,48,103
,2013,180100041,,,,12,13,25
,2013,180100042,,,,18,16,34
,2013,180100044,,,,12,28,40
,2013,180100044,,,,103,121,224
,2013,180100045,,,,4,6,10
,2013,180100045,,,,5,12,17
,2013,180100046,,,,17,25,42
,2013,180100047,,,,9,10,19
,2013,180100048,,,,46,43,89
,2013,180100049,,,,4,1,5
,2013,180100049,,,,24,22,46
,2013,180100050,,,,35,20,55
,2013,180100051,,,,189,194,383
,2013,180100052,,,,67,52,119
,2013,180100055,,,,20,32,52
,2013,180100056,,,,17,17,34
,2013,180100057,,,,23,19,42
,2013,180100058,,,,26,31,57
,2013,180100059,,,,11,7,18
,2013,180100060,,,,22,16,38
,2013,180100061,,,,12,17,29
,2013,180100062,,,,28,34,62
,2013,180100064,,,,15,12,27
,2013,180100065,,,,43,38,81
,2013,180100066,,,,22,24,46
,2013,180100067,,,,14,11,25
,2013,180100068,,,,8,12,20
,2013,180100068,,,,2,3,5
,2013,180100069,,,,60,37,97
,2013,180100070,,,,44,31,75
,2013,180100071,,,,5,4,9
,2013,180100071,,,,15,9,24
,2013,180100072,,,,42,29,71
,2013,180100073,,,,14,11,25
,2013,180100074,,,,20,15,35
,2013,180100075,,,,13,14,27
,2013,180100076,,,,31,36,67
,2013,180100077,,,,6,6,12
,2013,180100077,,,,8,11,19
,2013,180100078,,,,13,8,21
,2013,180100079,,,,29,14,43
,2013,180100080,,,,37,33,70
,2013,180100081,,,,28,36,64
,2013,180100082,,,,20,33,53
,2013,180100083,,,,52,35,87
,2013,180100084,,,,16,8,24
,2013,180100084,,,,37,42,79
,2013,180100085,,,,3,5,8
,2013,180100085,,,,25,21,46
,2013,180100086,,,,22,16,38
,2013,180100086,,,,4,5,9
,2013,180100087,,,,12,16,28
,2013,180100087,,,,10,10,20
,2013,180100088,,,,15,17,32
,2013,180100089,,,,28,24,52
,2013,180100090,,,,12,8,20
,2013,180100091,,,,17,22,39
,2013,180100092,,,,17,15,32
,2013,180100093,,,,12,11,23
,2013,180100094,,,,9,6,15
,2013,180100096,,,,97,78,175
,2013,180100097,,,,14,8,22
,2013,180100098,,,,37,26,63
,2013,180100099,,,,27,39,66
,2013,180100100,,,,41,36,77
,2013,180100101,,,,298,337,635
,2013,180100101,,,,15,3,18
,2013,180100102,,,,24,21,45
,2013,180100103,,,,270,241,511
,2013,180100103,,,,14,8,22
,2013,180100104,,,,362,339,701
,2013,180100104,,,,48,51,99
,2013,180100105,,,,22,37,59
,2013,180100106,,,,25,28,53
,2013,180100107,,,,33,30,63
,2013,180100108,,,,50,63,113
,2013,180100109,,,,18,3,21
,2013,180100110,,,,12,9,21
,2013,180100110,,,,23,33,56
,2013,180100111,,,,375,519,894
,2013,180100111,,,,2063,2556,4619
,2013,180100111,,,,140,197,337
,2013,180100112,,,,29,26,55
,2013,180100113,,,,10,8,18
,2013,180100115,,,,33,54,87
,2013,180100116,,,,13,11,24
,2013,180100117,,,,15,6,21
,2013,180100118,,,,41,27,68
,2013,180100119,,,,37,21,58
,2013,180100120,,,,16,10,26
,2013,180100123,,,,1,10,11
,2013,180100125,,,,33,31,64
,2013,180100125,,,,6,3,9
,2013,180100126,,,,134,129,263
,2013,180100128,,,,14,5,19
,2013,180100129,,,,19,19,38
,2013,180100129,,,,18,9,27
,2013,180100130,,,,10,11,21
,2013,180100132,,,,22,25,47
,2013,180100133,,,,10,4,14
,2013,180100134,,,,19,21,40
,2013,180100135,,,,13,7,20
,2013,180100136,,,,17,17,34
,2013,180100137,,,,6,10,16
,2013,180100138,,,,25,17,42
,2013,180100139,,,,41,47,88
,2013,180100140,,,,51,49,100
,2013,180100141,,,,8,19,27
,2013,180100143,,,,24,21,45
,2013,180100143,,,,7,8,15
,2013,180100144,,,,9,3,12
,2013,180100145,,,,43,56,99
,2013,180100146,,,,21,14,35
,2013,180100147,,,,25,19,44
,2013,180100148,,,,22,5,27
,2013,180100149,,,,86,86,172
,2013,180100149,,,,33,61,94
,2013,180100150,,,,34,28,62
,2013,180100151,,,,33,16,49
,2013,180100152,,,,27,36,63
,2013,180100153,,,,25,24,49
,2013,180100154,,,,21,9,30
,2013,180100157,,,,10,11,21
,2013,180100158,,,,6,15,21
,2013,180100159,,,,33,18,51
,2013,180100159,,,,6,7,13
,2013,180100160,,,,1,7,8
,2013,180100160,,,,35,32,67
,2013,180100161,,,,13,10,23
,2013,180100162,,,,32,22,54
,2013,180100163,,,,35,22,57
,2013,180100164,,,,20,14,34
,2013,180100165,,,,5,9,14
,2013,180100165,,,,27,18,45
,2013,180100165,,,,4,4,8
,2013,180100166,,,,35,51,86
,2013,180100167,,,,30,25,55
,2013,180100168,,,,35,38,73
,2013,180100169,,,,38,39,77
,2013,180100170,,,,68,65,133
,2013,180100171,,,,27,28,55
,2013,180100171,,,,43,49,92
,2013,180100171,,,,1,9,10
,2013,180100173,,,,13,12,25
,2013,180100174,,,,11,7,18
,2013,180100176,,,,29,32,61
,2013,180100178,,,,18,20,38
,2013,180100181,,,,7,1,8
,2013,180100183,,,,14,15,29
,2013,180100184,,,,5,10,15
,2013,180100184,,,,25,17,42
,2013,180100185,,,,6,6,12
,2013,180100185,,,,11,7,18
,2013,180100186,,,,28,16,44
,2013,180100188,,,,6,5,11
,2013,180100188,,,,18,19,37
,2013,180100189,,,,30,37,67
,2013,180100190,,,,21,18,39
,2013,180100191,,,,16,20,36
,2013,180100192,,,,76,54,130
,2013,180100193,,,,61,43,104
,2013,180100194,,,,20,19,39
,2013,180100195,,,,73,50,123
,2013,180100196,,,,51,33,84
,2013,180100197,,,,13,18,31
,2013,180100204,,,,26,18,44
,2013,180100207,,,,17,25,42
,2013,180100211,,,,39,27,66
,2013,180100214,,,,4,8,12
,2013,180100214,,,,16,16,32
,2013,180100215,,,,21,17,38
,2013,180100215,,,,3,5,8
,2013,180100216,,,,34,27,61
,2013,180100216,,,,7,5,12
,2013,180100217,,,,11,14,25
,2013,180100218,,,,25,32,57
,2013,180100219,,,,10,11,21
,2013,180100220,,,,35,20,55
,2013,180100221,,,,8,16,24
,2013,180100222,,,,10,10,20
,2013,180100222,,,,19,11,30
,2013,180100223,,,,24,34,58
,2013,180100224,,,,23,24,47
,2013,180100225,,,,20,20,40
,2013,180100226,,,,21,23,44
,2013,180100227,,,,37,48,85
,2013,180100229,,,,29,21,50
,2013,180100230,,,,109,98,207
,2013,180100231,,,,18,20,38
,2013,180100232,,,,53,35,88
,2013,180100233,,,,9,7,16
,2013,180100234,,,,18,14,32
,2013,180100235,,,,30,22,52
,2013,180100236,,,,28,13,41
,2013,180100236,,,,4,5,9
,2013,180100237,,,,30,26,56
,2013,180100238,,,,18,27,45
,2013,180100239,,,,34,23,57
,2013,180100240,,,,20,18,38
,2013,180100241,,,,20,14,34
,2013,180100242,,,,24,18,42
,2013,180100242,,,,5,2,7
,2013,180100243,,,,4,8,12
,2013,180100244,,,,9,5,14
,2013,180100245,,,,6,13,19
,2013,180100250,,,,10,6,16
,2013,180100251,,,,5,10,15
,2013,180100252,,,,12,8,20
,2013,180100253,,,,23,15,38
,2013,180100254,,,,27,26,53
,2013,180100255,,,,56,53,109
,2013,180100255,,,,7,9,16
,2013,180100257,,,,21,23,44
,2013,180100258,,,,16,17,33
,2013,180100259,,,,16,18,34
,2013,180100262,,,,23,24,47
,2013,180100264,,,,93,101,194
,2013,180100268,,,,13,12,25
,2013,180100269,,,,34,26,60
,2013,180100270,,,,33,30,63
,2013,180100272,,,,6,2,8
,2013,180100273,,,,4,10,14
,2013,180100274,,,,4,3,7
,2013,180100277,,,,5,5,10
,2013,180100280,,,,12,6,18
,2013,180100281,,,,3,7,10
,2013,180100285,,,,5,3,8
,2013,180100286,,,,8,8,16
,2013,180100289,,,,9,4,13
,2013,180100290,,,,7,7,14
,2013,180100291,,,,100,108,208
,2013,180100292,,,,22,24,46
,2013,180100297,,,,10,6,16
,2013,180100316,,,,7,3,10
,2013,180100322,,,,6,5,11
,2013,180100349,,,,5,4,9
,2013,180100351,,,,2,6,8
,2013,180100352,,,,10,4,14
,2013,180100353,,,,3,5,8
,2013,180100354,,,,4,4,8
,2013,180100355,,,,3,5,8
,2013,180100358,,,,6,1,7
,2013,180100359,,,,5,4,9
,2013,180100360,,,,4,5,9
,2013,180100361,,,,7,7,14
,2013,180100362,,,,5,4,9
,2013,180100364,,,,7,6,13
,2013,180100365,,,,5,8,13
,2013,180100368,,,,7,7,14
,2013,180100369,,,,44,97,141
,2013,180100369,,,,16,15,31
,2013,180100370,,,,35,50,85
,2013,180100370,,,,11,15,26
,2013,180100371,,,,43,43,86
,2013,180100372,,,,31,34,65
,2013,180100373,,,,26,15,41
,2013,180100374,,,,9,5,14
,2013,180100375,,,,14,7,21
,2013,180100378,,,,9,7,16
,2013,180100380,,,,5,6,11
,2013,180100387,,,,8,11,19
,2013,180100388,,,,8,3,11
,2013,180100390,,,,26,22,48
,2013,180100391,,,,11,9,20
,2013,180100392,,,,28,36,64
,2013,180100393,,,,13,7,20
,2013,180100394,,,,3,12,15
,2013,180100396,,,,7,6,13
,2013,180100397,,,,27,24,51
,2013,180100398,,,,58,47,105
,2013,180100399,,,,9,3,12
,2013,180100400,,,,3,5,8
,2013,180100401,,,,6,4,10
,2013,180100402,,,,4,5,9
,2013,180100403,,,,4,4,8
,2013,180100404,,,,8,2,10
,2013,180100405,,,,7,2,9
,2013,180100406,,,,2,3,5
,2013,180100407,,,,4,3,7
,2013,180100409,,,,7,5,12
,2013,180100411,,,,7,4,11
,2013,180100412,,,,8,2,10
,2013,180100413,,,,5,5,10
,2013,180100414,,,,4,3,7
,2013,180100415,,,,4,4,8
,2013,180100416,,,,4,4,8
,2013,180100417,,,,2,7,9
,2013,180100418,,,,3,8,11
,2013,180100419,,,,8,9,17
,2013,180100420,,,,5,4,9
,2013,180100422,,,,8,14,22
,2013,180100423,,,,10,11,21
,2013,180100424,,,,7,7,14
,2013,180100425,,,,7,0,7
,2013,180100426,,,,5,2,7
,2013,180100427,,,,3,8,11
,2013,180100428,,,,6,7,13
,2013,180100430,,,,4,4,8
,2013,180100431,,,,6,9,15
,2013,180100432,,,,7,4,11
,2013,180100434,,,,3,3,6
,2013,180100434,,,,31,42,73
,2013,180100435,,,,75,78,153
,2013,180100438,,,,6,6,12
,2013,180100439,,,,3,3,6
,2013,180100440,,,,15,5,20
,2013,180100441,,,,5,5,10
,2013,180100442,,,,4,3,7
,2013,180100443,,,,4,3,7
,2013,180100444,,,,4,4,8
,2013,180100450,,,,4,4,8
,2013,180100451,,,,10,3,13
,2013,180100452,,,,3,4,7
,2013,180100454,,,,17,19,36
,2013,180100455,,,,60,44,104
,2013,180100456,,,,30,20,50
,2013,180100457,,,,40,33,73
,2013,180100457,,,,6,9,15
,2013,180100458,,,,4,6,10
,2013,180100459,,,,5,3,8
,2013,180100460,,,,6,3,9
,2013,180100461,,,,7,6,13
,2013,180100462,,,,3,7,10
,2013,180100463,,,,4,4,8
,2013,180100464,,,,3,5,8
,2013,180100465,,,,2,6,8
,2013,180100466,,,,2,4,6
,2013,180100467,,,,4,12,16
,2013,180100469,,,,13,13,26
,2013,180100470,,,,4,7,11
,2013,180100471,,,,8,9,17
,2013,180100472,,,,3,7,10
,2013,180100473,,,,2,8,10
,2013,180100474,,,,4,3,7
,2013,180100476,,,,11,2,13
,2013,180100481,,,,9,6,15
,2013,180100482,,,,8,6,14
,2013,180100483,,,,5,10,15
,2013,180100484,,,,8,12,20
,2013,180100485,,,,8,11,19
,2013,180100486,,,,14,4,18
,2013,180100486,,,,11,4,15
,2013,180100487,,,,7,0,7
,2013,180100488,,,,2,5,7
,2013,180100489,,,,7,5,12
,2013,180100490,,,,6,5,11
,2013,180100491,,,,15,12,27
,2013,180100493,,,,7,6,13
,2013,180100494,,,,3,7,10
,2013,180100495,,,,6,5,11
,2013,180100496,,,,8,2,10
,2013,180100497,,,,4,6,10
,2013,180100498,,,,1,4,5
,2013,180100499,,,,2,5,7
,2013,180100500,,,,4,2,6
,2013,180100501,,,,4,5,9
,2013,180100502,,,,3,5,8
,2013,180100503,,,,7,6,13
,2013,180100504,,,,3,3,6
,2013,180100505,,,,6,4,10
,2013,180100506,,,,4,7,11
,2013,180100507,,,,4,6,10
,2013,180100508,,,,5,4,9
,2013,180100509,,,,4,4,8
,2013,180100510,,,,6,6,12
,2013,180100511,,,,3,5,8
,2013,180100512,,,,2,8,10
,2013,180100513,,,,5,3,8
,2013,180100514,,,,4,3,7
,2013,180100515,,,,7,0,7
,2013,180100516,,,,6,3,9
,2013,180100517,,,,6,6,12
,2013,180100518,,,,7,6,13
,2013,180100519,,,,3,5,8
,2013,180100523,,,,2,8,10
,2013,180100526,,,,4,5,9
,2013,180100538,,,,2,5,7
,2013,180100539,,,,7,4,11
,2013,180100545,,,,3,2,5
,2013,180100546,,,,7,5,12
,2013,180100547,,,,8,8,16
,2013,180100548,,,,8,7,15
,2013,180100549,,,,3,5,8
,2013,180100551,,,,3,5,8
,2013,180100556,,,,2,3,5
,2013,180100557,,,,7,5,12
,2013,180200001,,,,39,46,85
,2013,180200002,,,,12,5,17
,2013,180200003,,,,81,80,161
,2013,180200004,,,,135,113,248
,2013,180200005,,,,17,12,29
,2013,180200006,,,,34,18,52
,2013,180200007,,,,15,28,43
,2013,180200008,,,,49,53,102
,2013,180200009,,,,183,154,337
,2013,180200010,,,,16,12,28
,2013,180200011,,,,18,21,39
,2013,180200012,,,,26,13,39
,2013,180200013,,,,181,157,338
,2013,180200014,,,,2,3,5
,2013,180200015,,,,1,5,6
,2013,180200016,,,,1,4,5
,2013,180200017,,,,3,3,6
,2013,180200017,,,,10,15,25
,2013,180200017,,,,14,9,23
,2013,180200032,,,,8,2,10
,2013,180200033,,,,2,4,6
,2013,180200034,,,,3,3,6
,2013,180200035,,,,3,3,6
,2013,180200036,,,,1,4,5
,2013,180200037,,,,4,1,5
,2013,180200038,,,,1,3,4
,2013,180200039,,,,1,5,6
,2013,180200040,,,,4,1,5
,2013,180200041,,,,2,4,6
,2013,180200043,,,,3,1,4
,2013,180200045,,,,1,4,5
,2013,180200046,,,,2,5,7
,2013,180200047,,,,3,4,7
,2013,180200048,,,,4,2,6
,2013,180200049,,,,4,2,6
,2013,180200050,,,,0,5,5
,2013,180200051,,,,1,4,5
,2013,180200052,,,,3,3,6
,2013,180200054,,,,2,3,5
,2013,180200056,,,,2,3,5
,2013,180300001,,,,55,49,104
,2013,180300001,,,,6,4,10
,2013,180300002,,,,47,40,87
,2013,180300003,,,,41,47,88
,2013,180300004,,,,19,12,31
,2013,180300005,,,,10,8,18
,2013,180300005,,,,52,51,103
,2013,180300006,,,,39,30,69
,2013,180300007,,,,78,71,149
,2013,180300008,,,,29,24,53
,2013,180300008,,,,231,235,466
,2013,180300009,,,,93,86,179
,2013,180300010,,,,226,185,411
,2013,180300011,,,,0,385,385
,2013,180300012,,,,19,14,33
,2013,180300013,,,,10,13,23
,2013,180300015,,,,16,15,31
,2013,180300017,,,,15,13,28
,2013,180300018,,,,7,19,26
,2013,180300018,,,,102,76,178
,2013,180300018,,,,4,4,8
,2013,180300019,,,,32,28,60
,2013,180300020,,,,25,15,40
,2013,180300021,,,,55,48,103
,2013,180300023,,,,43,39,82
,2013,180300024,,,,83,74,157
,2013,180300025,,,,4,5,9
,2013,180300025,,,,34,38,72
,2013,180300026,,,,38,26,64
,2013,180300027,,,,16,12,28
,2013,180300028,,,,43,61,104
,2013,180300028,,,,11,10,21
,2013,180300029,,,,76,73,149
,2013,180300030,,,,12,7,19
,2013,180300030,,,,70,76,146
,2013,180300030,,,,15,10,25
,2013,180300031,,,,260,216,476
,2013,180300032,,,,50,45,95
,2013,180300032,,,,6,6,12
,2013,180300032,,,,9,12,21
,2013,180300033,,,,39,36,75
,2013,180300034,,,,3,9,12
,2013,180300034,,,,296,311,607
,2013,180300035,,,,71,75,146
,2013,180300037,,,,198,209,407
,2013,180300038,,,,29,36,65
,2013,180300039,,,,49,35,84
,2013,180300040,,,,28,43,71
,2013,180300041,,,,37,28,65
,2013,180300042,,,,20,30,50
,2013,180300043,,,,162,150,312
,2013,180300044,,,,5,9,14
,2013,180300045,,,,26,13,39
,2013,180300046,,,,104,83,187
,2013,180300046,,,,14,7,21
,2013,180300047,,,,13,3,16
,2013,180300048,,,,21,26,47
,2013,180300049,,,,27,38,65
,2013,180300050,,,,49,40,89
,2013,180300051,,,,20,27,47
,2013,180300052,,,,45,24,69
,2013,180300052,,,,5,4,9
,2013,180300053,,,,13,8,21
,2013,180300054,,,,17,12,29
,2013,180300055,,,,5,7,12
,2013,180300055,,,,32,28,60
,2013,180300056,,,,13,13,26
,2013,180300057,,,,41,29,70
,2013,180300058,,,,197,177,374
,2013,180300059,,,,324,0,324
,2013,180300060,,,,25,28,53
,2013,180300061,,,,17,16,33
,2013,180300062,,,,36,36,72
,2013,180300063,,,,30,45,75
,2013,180300064,,,,14,12,26
,2013,180300065,,,,8,8,16
,2013,180300066,,,,6,11,17
,2013,180300067,,,,18,13,31
,2013,180300068,,,,37,24,61
,2013,180300069,,,,28,27,55
,2013,180300070,,,,7,15,22
,2013,180300071,,,,352,421,773
,2013,180300072,,,,10,11,21
,2013,180300075,,,,20,11,31
,2013,180300077,,,,7,18,25
,2013,180300078,,,,68,93,161
,2013,180300080,,,,14,6,20
,2013,180300081,,,,10,11,21
,2013,180300082,,,,18,15,33
,2013,180300083,,,,8,13,21
,2013,180300084,,,,10,12,22
,2013,180300085,,,,8,5,13
,2013,180300086,,,,34,25,59
,2013,180300086,,,,36,25,61
,2013,180300087,,,,17,5,22
,2013,180300088,,,,11,10,21
,2013,180300089,,,,198,111,309
,2013,180300090,,,,101,109,210
,2013,180300092,,,,20,30,50
,2013,180300095,,,,10,14,24
,2013,180300095,,,,6,8,14
,2013,180300097,,,,25,8,33
,2013,180300098,,,,37,20,57
,2013,180300099,,,,4,1,5
,2013,180300100,,,,8,7,15
,2013,180300102,,,,99,101,200
,2013,180300104,,,,6,8,14
,2013,180300105,,,,14,8,22
,2013,180300120,,,,2,6,8
,2013,180300124,,,,12,5,17
,2013,180300125,,,,6,4,10
,2013,180300126,,,,7,4,11
,2013,180300131,,,,11,17,28
,2013,180300133,,,,0,4,4
,2013,180300133,,,,7,13,20
,2013,180300134,,,,10,10,20
,2013,180300135,,,,28,24,52
,2013,180300136,,,,15,10,25
,2013,180300137,,,,6,5,11
,2013,180300138,,,,8,3,11
,2013,180300140,,,,9,6,15
,2013,180300141,,,,4,4,8
,2013,180300142,,,,3,7,10
,2013,180300144,,,,7,3,10
,2013,180300145,,,,4,6,10
,2013,180300146,,,,5,6,11
,2013,180300154,,,,6,6,12
,2013,180300155,,,,10,3,13
,2013,180300156,,,,10,10,20
,2013,180300157,,,,8,5,13
,2013,180300160,,,,3,4,7
,2013,180400002,,,,108,105,213
,2013,180400003,,,,156,167,323
,2013,180400004,,,,51,47,98
,2013,180400005,,,,206,196,402
,2013,180400006,,,,24,18,42
,2013,180400007,,,,20,15,35
,2013,180400008,,,,85,76,161
,2013,180400008,,,,17,12,29
,2013,180400009,,,,102,75,177
,2013,180400009,,,,13,13,26
,2013,180400010,,,,91,69,160
,2013,180400011,,,,38,24,62
,2013,180400012,,,,37,30,67
,2013,180400012,,,,7,10,17
,2013,180400013,,,,28,24,52
,2013,180400014,,,,54,45,99
,2013,180400015,,,,4,5,9
,2013,180400016,,,,20,17,37
,2013,180400017,,,,78,79,157
,2013,180400018,,,,17,24,41
,2013,180400019,,,,79,59,138
,2013,180400020,,,,27,38,65
,2013,180400021,,,,197,155,352
,2013,180400022,,,,143,148,291
,2013,180400023,,,,46,52,98
,2013,180400024,,,,45,16,61
,2013,180400025,,,,541,474,1015
,2013,180400026,,,,100,89,189
,2013,180400027,,,,42,43,85
,2013,180400028,,,,63,43,106
,2013,180400029,,,,112,97,209
,2013,180400029,,,,28,13,41
,2013,180400029,,,,16,12,28
,2013,180400030,,,,27,18,45
,2013,180400031,,,,194,163,357
,2013,180400032,,,,91,74,165
,2013,180400034,,,,127,115,242
,2013,180400034,,,,5,6,11
,2013,180400035,,,,142,120,262
,2013,180400035,,,,9,7,16
,2013,180400036,,,,103,83,186
,2013,180400037,,,,106,109,215
,2013,180400038,,,,234,225,459
,2013,180400038,,,,34,26,60
,2013,180400039,,,,9,9,18
,2013,180400039,,,,18,17,35
,2013,180400040,,,,376,344,720
,2013,180400042,,,,87,81,168
,2013,180400042,,,,26,21,47
,2013,180400043,,,,9,7,16
,2013,180400043,,,,155,161,316
,2013,180400044,,,,5,8,13
,2013,180400045,,,,341,314,655
,2013,180400046,,,,282,232,514
,2013,180400047,,,,148,108,256
,2013,180400047,,,,236,228,464
,2013,180400047,,,,25,27,52
,2013,180400048,,,,23,20,43
,2013,180400048,,,,230,217,447
,2013,180400049,,,,122,147,269
,2013,180400050,,,,39,40,79
,2013,180400051,,,,76,73,149
,2013,180400052,,,,63,62,125
,2013,180400053,,,,29,21,50
,2013,180400054,,,,16,17,33
,2013,180400055,,,,193,151,344
,2013,180400055,,,,8,8,16
,2013,180400056,,,,36,19,55
,2013,180400056,,,,428,422,850
,2013,180400057,,,,145,127,272
,2013,180400057,,,,9,24,33
,2013,180400058,,,,25,32,57
,2013,180400060,,,,97,106,203
,2013,180400060,,,,84,83,167
,2013,180400060,,,,11,12,23
,2013,180400061,,,,28,20,48
,2013,180400062,,,,217,241,458
,2013,180400063,,,,69,71,140
,2013,180400064,,,,265,256,521
,2013,180400064,,,,7,7,14
,2013,180400065,,,,9,11,20
,2013,180400065,,,,111,94,205
,2013,180400066,,,,225,221,446
,2013,180400067,,,,144,138,282
,2013,180400068,,,,81,65,146
,2013,180400070,,,,33,32,65
,2013,180400071,,,,106,108,214
,2013,180400072,,,,155,140,295
,2013,180400073,,,,117,110,227
,2013,180400074,,,,223,190,413
,2013,180400074,,,,15,12,27
,2013,180400076,,,,50,40,90
,2013,180400077,,,,41,57,98
,2013,180400078,,,,10,18,28
,2013,180400079,,,,20,13,33
,2013,180400080,,,,1756,2289,4045
,2013,180400081,,,,10,6,16
,2013,180400082,,,,15,15,30
,2013,180400083,,,,12,8,20
,2013,180400084,,,,30,25,55
,2013,180400086,,,,9,5,14
,2013,180400089,,,,10,15,25
,2013,180400090,,,,25,25,50
,2013,180400091,,,,4,3,7
,2013,180400093,,,,39,29,68
,2013,180400094,,,,30,25,55
,2013,180400095,,,,11,11,22
,2013,180400096,,,,4,12,16
,2013,180400098,,,,2,1,3
,2013,180400099,,,,15,21,36
,2013,180400101,,,,31,40,71
,2013,180400102,,,,209,177,386
,2013,180400103,,,,4,19,23
,2013,180400104,,,,11,10,21
,2013,180400105,,,,20,17,37
,2013,180400106,,,,13,12,25
,2013,180400108,,,,5,10,15
,2013,180400109,,,,8,6,14
,2013,180400110,,,,63,72,135
,2013,180400111,,,,5,7,12
,2013,180400112,,,,5,6,11
,2013,180400113,,,,5,15,20
,2013,180400114,,,,8,6,14
,2013,180400116,,,,36,21,57
,2013,180400117,,,,9,7,16
,2013,180400118,,,,31,26,57
,2013,180400119,,,,10,5,15
,2013,180400120,,,,5,9,14
,2013,180400121,,,,15,5,20
,2013,180400122,,,,6,4,10
,2013,180400123,,,,10,8,18
,2013,180400124,,,,12,3,15
,2013,180400126,,,,11,13,24
,2013,180400127,,,,3,3,6
,2013,180400128,,,,29,30,59
,2013,180400129,,,,14,13,27
,2013,180400130,,,,19,23,42
,2013,180400131,,,,78,77,155
,2013,180400131,,,,754,665,1419
,2013,180400132,,,,35,47,82
,2013,180400133,,,,26,40,66
,2013,180400135,,,,354,432,786
,2013,180400138,,,,344,364,708
,2013,180400140,,,,414,368,782
,2013,180400141,,,,28,20,48
,2013,180400142,,,,18,24,42
,2013,180400143,,,,7,7,14
,2013,180400143,,,,41,58,99
,2013,180400144,,,,24,10,34
,2013,180400144,,,,7,4,11
,2013,180400144,,,,9,14,23
,2013,180400145,,,,1044,1229,2273
,2013,180400146,,,,7,6,13
,2013,180400147,,,,14,8,22
,2013,180400148,,,,8,11,19
,2013,180400149,,,,9,11,20
,2013,180400149,,,,68,66,134
,2013,180400151,,,,3,5,8
,2013,180400152,,,,2,9,11
,2013,180400153,,,,13,7,20
,2013,180400155,,,,381,428,809
,2013,180400156,,,,11,6,17
,2013,180400157,,,,15,17,32
,2013,180400157,,,,259,290,549
,2013,180400157,,,,68,59,127
,2013,180400158,,,,5,6,11
,2013,180400159,,,,14,18,32
,2013,180400160,,,,9,8,17
,2013,180400161,,,,5,12,17
,2013,180400162,,,,5,5,10
,2013,180400163,,,,29,58,87
,2013,180400164,,,,10,10,20
,2013,180400165,,,,10,10,20
,2013,180400166,,,,117,220,337
,2013,180400167,,,,167,89,256
,2013,180400168,,,,332,398,730
,2013,180400168,,,,72,96,168
,2013,180400170,,,,34,35,69
,2013,180400171,,,,20,26,46
,2013,180400171,,,,73,43,116
,2013,180400171,,,,20,15,35
,2013,180400172,,,,44,34,78
,2013,180400172,,,,52,46,98
,2013,180400172,,,,91,104,195
,2013,180400173,,,,5,4,9
,2013,180400175,,,,22,13,35
,2013,180400175,,,,117,132,249
,2013,180400176,,,,46,57,103
,2013,180400176,,,,44,77,121
,2013,180400176,,,,15,18,33
,2013,180400177,,,,0,15,15
,2013,180400177,,,,218,221,439
,2013,180400178,,,,72,67,139
,2013,180400178,,,,12,10,22
,2013,180400179,,,,27,27,54
,2013,180400180,,,,2,1,3
,2013,180400180,,,,39,43,82
,2013,180400180,,,,9,23,32
,2013,180400181,,,,15,9,24
,2013,180400181,,,,34,31,65
,2013,180400182,,,,7,10,17
,2013,180400183,,,,62,74,136
,2013,180400183,,,,14,15,29
,2013,180400184,,,,10,12,22
,2013,180400184,,,,16,22,38
,2013,180400184,,,,40,37,77
,2013,180400185,,,,77,66,143
,2013,180400186,,,,57,61,118
,2013,180400186,,,,461,371,832
,2013,180400187,,,,8,12,20
,2013,180400187,,,,26,27,53
,2013,180400188,,,,25,37,62
,2013,180400189,,,,19,20,39
,2013,180400192,,,,16,11,27
,2013,180400192,,,,40,42,82
,2013,180400192,,,,38,42,80
,2013,180400193,,,,24,15,39
,2013,180400194,,,,11,13,24
,2013,180400196,,,,25,17,42
,2013,180400201,,,,48,57,105
,2013,180400205,,,,208,203,411
,2013,180400207,,,,12,8,20
,2013,180400208,,,,13,13,26
,2013,180400209,,,,9,15,24
,2013,180400210,,,,12,5,17
,2013,180400211,,,,2,4,6
,2013,180400211,,,,16,21,37
,2013,180400212,,,,90,137,227
,2013,180400212,,,,68,66,134
,2013,180400212,,,,16,14,30
,2013,180400213,,,,67,58,125
,2013,180400214,,,,30,19,49
,2013,180400215,,,,11,3,14
,2013,180400219,,,,9,1,10
,2013,180400220,,,,9,1,10
,2013,180400221,,,,3,6,9
,2013,180400222,,,,11,9,20
,2013,180400230,,,,3,6,9
,2013,180400238,,,,37,52,89
,2013,180400238,,,,7,13,20
,2013,180400243,,,,68,56,124
,2013,180400243,,,,47,38,85
,2013,180400243,,,,18,27,45
,2013,180400247,,,,15,22,37
,2013,180400249,,,,25,25,50
,2013,180400250,,,,8,7,15
,2013,180400251,,,,99,120,219
,2013,180400251,,,,46,37,83
,2013,180400251,,,,18,21,39
,2013,180400252,,,,152,145,297
,2013,180400252,,,,29,38,67
,2013,180400253,,,,4,7,11
,2013,180400253,,,,5,15,20
,2013,180400253,,,,4,2,6
,2013,180400254,,,,44,27,71
,2013,180400255,,,,28,19,47
,2013,180400257,,,,98,92,190
,2013,180400257,,,,7,11,18
,2013,180400257,,,,5,5,10
,2013,180400259,,,,7,8,15
,2013,180400260,,,,14,8,22
,2013,180400263,,,,6,4,10
,2013,180400264,,,,5,4,9
,2013,180400265,,,,11,6,17
,2013,180400266,,,,7,7,14
,2013,180400266,,,,131,111,242
,2013,180400267,,,,29,23,52
,2013,180400268,,,,5,3,8
,2013,180400270,,,,12,8,20
,2013,180400271,,,,3,7,10
,2013,180400273,,,,6,15,21
,2013,180400274,,,,5,10,15
,2013,180400275,,,,9,12,21
,2013,180400276,,,,1,2,3
,2013,180400279,,,,7,5,12
,2013,180400283,,,,7,13,20
,2013,180400284,,,,8,12,20
,2013,180400285,,,,110,70,180
,2013,180400285,,,,16,10,26
,2013,180400286,,,,27,19,46
,2013,180400290,,,,15,15,30
,2013,180400297,,,,14,8,22
,2013,180400298,,,,10,8,18
,2013,180400300,,,,8,2,10
,2013,180400301,,,,5,3,8
,2013,180400302,,,,7,8,15
,2013,180400303,,,,10,8,18
,2013,180400305,,,,15,12,27
,2013,180400305,,,,52,59,111
,2013,180400306,,,,63,54,117
,2013,180400306,,,,70,62,132
,2013,180400306,,,,6,2,8
,2013,180400308,,,,9,12,21
,2013,180400310,,,,454,342,796
,2013,180400312,,,,44,57,101
,2013,180400313,,,,5,8,13
,2013,180400314,,,,10,10,20
,2013,180400315,,,,8,2,10
,2013,180400316,,,,8,2,10
,2013,180400317,,,,6,8,14
,2013,180400318,,,,215,179,394
,2013,180400319,,,,72,77,149
,2013,180400320,,,,14,16,30
,2013,180400321,,,,131,136,267
,2013,180400322,,,,105,93,198
,2013,180400323,,,,2,2,4
,2013,180400323,,,,41,25,66
,2013,180400324,,,,7,7,14
,2013,180400326,,,,6,6,12
,2013,180400327,,,,7,13,20
,2013,180400328,,,,14,5,19
,2013,180400329,,,,35,40,75
,2013,180400331,,,,18,23,41
,2013,180400331,,,,12,7,19
,2013,180400332,,,,44,48,92
,2013,180400333,,,,46,53,99
,2013,180400340,,,,13,14,27
,2013,180400390,,,,494,631,1125
,2013,180500001,,,,13,7,20
,2013,180500001,,,,199,179,378
,2013,180500002,,,,8,9,17
,2013,180500002,,,,40,28,68
,2013,180500003,,,,44,32,76
,2013,180500004,,,,10,14,24
,2013,180500005,,,,41,38,79
,2013,180500006,,,,42,36,78
,2013,180500006,,,,8,5,13
,2013,180500007,,,,21,21,42
,2013,180500008,,,,27,37,64
,2013,180500009,,,,10,12,22
,2013,180500009,,,,17,13,30
,2013,180500010,,,,38,24,62
,2013,180500011,,,,31,59,90
,2013,180500012,,,,18,17,35
,2013,180500013,,,,33,29,62
,2013,180500014,,,,38,19,57
,2013,180500015,,,,18,19,37
,2013,180500015,,,,105,102,207
,2013,180500016,,,,37,36,73
,2013,180500017,,,,39,29,68
,2013,180500018,,,,14,13,27
,2013,180500019,,,,9,7,16
,2013,180500020,,,,29,30,59
,2013,180500021,,,,52,43,95
,2013,180500021,,,,7,9,16
,2013,180500022,,,,34,25,59
,2013,180500023,,,,8,8,16
,2013,180500024,,,,19,13,32
,2013,180500025,,,,81,68,149
,2013,180500025,,,,195,197,392
,2013,180500026,,,,8,8,16
,2013,180500027,,,,12,1,13
,2013,180500029,,,,8,9,17
,2013,180500030,,,,18,19,37
,2013,180500031,,,,7,7,14
,2013,180500031,,,,10,13,23
,2013,180500034,,,,4,4,8
,2013,180500035,,,,16,9,25
,2013,180500035,,,,7,7,14
,2013,180500037,,,,37,23,60
,2013,180500039,,,,5,10,15
,2013,180500040,,,,39,25,64
,2013,180500040,,,,7,6,13
,2013,180500040,,,,5,6,11
,2013,180500041,,,,3,7,10
,2013,180500041,,,,5,9,14
,2013,180500042,,,,23,22,45
,2013,180500043,,,,8,11,19
,2013,180500044,,,,8,7,15
,2013,180500045,,,,7,10,17
,2013,180500047,,,,14,18,32
,2013,180500048,,,,8,5,13
,2013,180500050,,,,7,7,14
,2013,180500062,,,,5,6,11
,2013,180500065,,,,21,20,41
,2013,180500067,,,,6,5,11
,2013,180500070,,,,6,4,10
,2013,180500071,,,,5,7,12
,2013,180500073,,,,10,7,17
,2013,180500074,,,,6,6,12
,2013,180500076,,,,13,12,25
,2013,180500078,,,,7,11,18
,2013,180500081,,,,6,6,12
,2013,180500082,,,,5,10,15
,2013,180500083,,,,3,4,7
,2013,180500084,,,,8,6,14
,2013,180500085,,,,6,7,13
,2013,180500086,,,,7,8,15
,2013,180500087,,,,6,6,12
,2013,180500088,,,,6,6,12
,2013,180500089,,,,16,11,27
,2013,180500090,,,,5,6,11
,2013,180500092,,,,6,4,10
,2013,180500094,,,,7,5,12
,2013,180500096,,,,9,5,14
,2013,180500104,,,,9,11,20
,2013,180500105,,,,4,6,10
,2013,180500106,,,,25,22,47
,2013,180500107,,,,6,6,12
,2013,180500108,,,,5,5,10
,2013,180500109,,,,8,5,13
,2013,180500110,,,,3,6,9
,2013,180500112,,,,6,6,12
,2013,180500114,,,,12,8,20
,2013,180500118,,,,10,11,21
,2013,180600001,,,,36,33,69
,2013,180600002,,,,18,14,32
,2013,180600002,,,,5,2,7
,2013,180600003,,,,58,47,105
,2013,180600004,,,,277,259,536
,2013,180600005,,,,34,49,83
,2013,180600005,,,,4,4,8
,2013,180600006,,,,5,5,10
,2013,180600006,,,,31,30,61
,2013,180600008,,,,40,26,66
,2013,180600008,,,,4,4,8
,2013,180600009,,,,2,2,4
,2013,180600009,,,,29,31,60
,2013,180600010,,,,32,37,69
,2013,180600011,,,,32,17,49
,2013,180600011,,,,9,6,15
,2013,180600012,,,,138,145,283
,2013,180600013,,,,22,34,56
,2013,180600014,,,,44,42,86
,2013,180600016,,,,110,95,205
,2013,180600017,,,,22,17,39
,2013,180600018,,,,25,14,39
,2013,180600018,,,,6,4,10
,2013,180600019,,,,45,40,85
,2013,180600020,,,,36,29,65
,2013,180600021,,,,91,105,196
,2013,180600021,,,,10,10,20
,2013,180600022,,,,62,72,134
,2013,180600023,,,,21,26,47
,2013,180600024,,,,13,9,22
,2013,180600025,,,,4,3,7
,2013,180600025,,,,19,14,33
,2013,180600026,,,,64,58,122
,2013,180600027,,,,8,9,17
,2013,180600028,,,,229,244,473
,2013,180600029,,,,233,244,477
,2013,180600029,,,,29,54,83
,2013,180600030,,,,187,200,387
,2013,180600031,,,,31,23,54
,2013,180600032,,,,48,49,97
,2013,180600033,,,,300,261,561
,2013,180600034,,,,24,22,46
,2013,180600034,,,,7,3,10
,2013,180600035,,,,73,63,136
,2013,180600036,,,,81,75,156
,2013,180600037,,,,187,183,370
,2013,180600038,,,,61,55,116
,2013,180600039,,,,5,2,7
,2013,180600039,,,,24,15,39
,2013,180600040,,,,18,12,30
,2013,180600041,,,,47,32,79
,2013,180600041,,,,0,9,9
,2013,180600044,,,,5,8,13
,2013,180600044,,,,41,24,65
,2013,180600045,,,,7,7,14
,2013,180600045,,,,35,31,66
,2013,180600046,,,,214,187,401
,2013,180600047,,,,12,14,26
,2013,180600047,,,,4,3,7
,2013,180600048,,,,108,120,228
,2013,180600049,,,,10,6,16
,2013,180600050,,,,70,52,122
,2013,180600051,,,,5,4,9
,2013,180600051,,,,18,18,36
,2013,180600052,,,,8,12,20
,2013,180600052,,,,33,22,55
,2013,180600053,,,,23,29,52
,2013,180600054,,,,7,10,17
,2013,180600055,,,,12,12,24
,2013,180600056,,,,20,24,44
,2013,180600057,,,,734,967,1701
,2013,180600058,,,,46,31,77
,2013,180600059,,,,19,7,26
,2013,180600060,,,,24,18,42
,2013,180600062,,,,16,12,28
,2013,180600063,,,,9,10,19
,2013,180600064,,,,82,83,165
,2013,180600065,,,,163,153,316
,2013,180600066,,,,58,65,123
,2013,180600067,,,,593,847,1440
,2013,180600069,,,,49,41,90
,2013,180600070,,,,15,23,38
,2013,180600071,,,,9,9,18
,2013,180600073,,,,0,3,3
,2013,180600073,,,,25,23,48
,2013,180600074,,,,6,9,15
,2013,180600074,,,,48,47,95
,2013,180600074,,,,22,36,58
,2013,180600075,,,,4,6,10
,2013,180600075,,,,29,20,49
,2013,180600076,,,,20,20,40
,2013,180600077,,,,41,40,81
,2013,180600078,,,,30,20,50
,2013,180600079,,,,16,15,31
,2013,180600079,,,,3,1,4
,2013,180600080,,,,40,35,75
,2013,180600081,,,,51,41,92
,2013,180600082,,,,5,7,12
,2013,180600082,,,,39,40,79
,2013,180600083,,,,5,3,8
,2013,180600083,,,,24,20,44
,2013,180600084,,,,10,3,13
,2013,180600085,,,,6,8,14
,2013,180600089,,,,10,10,20
,2013,180600090,,,,17,9,26
,2013,180600091,,,,5,6,11
,2013,180600092,,,,26,18,44
,2013,180600093,,,,14,16,30
,2013,180600094,,,,20,11,31
,2013,180600095,,,,6,1,7
,2013,180600095,,,,1,1,2
,2013,180600097,,,,27,23,50
,2013,180600098,,,,20,19,39
,2013,180600098,,,,6,4,10
,2013,180600099,,,,18,10,28
,2013,180600099,,,,2,3,5
,2013,180600100,,,,10,11,21
,2013,180600100,,,,26,32,58
,2013,180600100,,,,4,8,12
,2013,180600101,,,,3,2,5
,2013,180600101,,,,13,19,32
,2013,180600102,,,,21,19,40
,2013,180600103,,,,2,3,5
,2013,180600103,,,,21,14,35
,2013,180600106,,,,11,15,26
,2013,180600107,,,,72,94,166
,2013,180600109,,,,11,8,19
,2013,180600110,,,,6,5,11
,2013,180600112,,,,0,5,5
,2013,180600113,,,,6,3,9
,2013,180600114,,,,4,5,9
,2013,180600115,,,,4,7,11
,2013,180600126,,,,5,3,8
,2013,180600131,,,,6,4,10
,2013,180600135,,,,3,6,9
,2013,180600138,,,,7,5,12
,2013,180600142,,,,4,5,9
,2013,180600143,,,,13,6,19
,2013,180600144,,,,11,10,21
,2013,180600144,,,,54,41,95
,2013,180600145,,,,2,4,6
,2013,180600146,,,,4,6,10
,2013,180600147,,,,26,41,67
,2013,180600147,,,,6,4,10
,2013,180600148,,,,3,6,9
,2013,180600149,,,,4,6,10
,2013,180600150,,,,11,14,25
,2013,180600151,,,,13,19,32
,2013,180600152,,,,10,15,25
,2013,180600153,,,,5,4,9
,2013,180600154,,,,4,3,7
,2013,180600155,,,,7,9,16
,2013,180600156,,,,6,6,12
,2013,180600157,,,,4,3,7
,2013,180600158,,,,20,7,27
,2013,180600161,,,,15,4,19
,2013,180600162,,,,5,5,10
,2013,180600163,,,,5,5,10
,2013,180600166,,,,10,12,22
,2013,180700001,,,,175,141,316
,2013,180700002,,,,3,3,6
,2013,180700002,,,,16,16,32
,2013,180700003,,,,46,35,81
,2013,180700004,,,,350,47,397
,2013,180700005,,,,13,30,43
,2013,180700006,,,,192,139,331
,2013,180700007,,,,29,21,50
,2013,180700008,,,,23,28,51
,2013,180700008,,,,14,2,16
,2013,180700009,,,,142,137,279
,2013,180700010,,,,121,116,237
,2013,180700011,,,,44,35,79
,2013,180700012,,,,60,56,116
,2013,180700013,,,,35,37,72
,2013,180700014,,,,293,243,536
,2013,180700015,,,,209,186,395
,2013,180700016,,,,79,82,161
,2013,180700017,,,,29,19,48
,2013,180700018,,,,0,440,440
,2013,180700022,,,,22,13,35
,2013,180700023,,,,18,18,36
,2013,180700024,,,,143,111,254
,2013,180700025,,,,34,49,83
,2013,180700026,,,,2,7,9
,2013,180700028,,,,114,112,226
,2013,180700029,,,,142,128,270
,2013,180700030,,,,194,182,376
,2013,180700031,,,,178,153,331
,2013,180700032,,,,19,13,32
,2013,180700033,,,,32,33,65
,2013,180700036,,,,69,52,121
,2013,180700036,,,,29,12,41
,2013,180700037,,,,63,64,127
,2013,180700038,,,,77,65,142
,2013,180700039,,,,14,14,28
,2013,180700040,,,,52,42,94
,2013,180700041,,,,33,27,60
,2013,180700042,,,,170,129,299
,2013,180700044,,,,179,170,349
,2013,180700046,,,,25,26,51
,2013,180700047,,,,40,39,79
,2013,180700048,,,,12,10,22
,2013,180700049,,,,13,5,18
,2013,180700050,,,,150,119,269
,2013,180700051,,,,16,13,29
,2013,180700052,,,,18,6,24
,2013,180700053,,,,11,11,22
,2013,180700055,,,,10,3,13
,2013,180700056,,,,26,23,49
,2013,180700057,,,,27,40,67
,2013,180700057,,,,6,2,8
,2013,180700058,,,,18,12,30
,2013,180700059,,,,62,54,116
,2013,180700060,,,,75,68,143
,2013,180700061,,,,73,62,135
,2013,180700062,,,,45,42,87
,2013,180700063,,,,248,234,482
,2013,180700064,,,,33,37,70
,2013,180700065,,,,64,68,132
,2013,180700066,,,,103,103,206
,2013,180700066,,,,13,12,25
,2013,180700067,,,,31,38,69
,2013,180700068,,,,58,50,108
,2013,180700069,,,,68,59,127
,2013,180700070,,,,11,3,14
,2013,180700071,,,,54,46,100
,2013,180700072,,,,32,27,59
,2013,180700073,,,,306,296,602
,2013,180700074,,,,8,5,13
,2013,180700074,,,,41,36,77
,2013,180700075,,,,16,11,27
,2013,180700075,,,,89,110,199
,2013,180700076,,,,153,141,294
,2013,180700077,,,,71,71,142
,2013,180700078,,,,11,8,19
,2013,180700079,,,,171,154,325
,2013,180700080,,,,20,17,37
,2013,180700081,,,,61,41,102
,2013,180700082,,,,53,54,107
,2013,180700083,,,,16,12,28
,2013,180700084,,,,58,54,112
,2013,180700085,,,,47,51,98
,2013,180700086,,,,30,42,72
,2013,180700088,,,,15,20,35
,2013,180700089,,,,6,11,17
,2013,180700090,,,,14,10,24
,2013,180700090,,,,3,9,12
,2013,180700091,,,,31,20,51
,2013,180700092,,,,31,25,56
,2013,180700095,,,,13,5,18
,2013,180700095,,,,38,43,81
,2013,180700097,,,,14,13,27
,2013,180700098,,,,15,4,19
,2013,180700099,,,,79,84,163
,2013,180700099,,,,77,85,162
,2013,180700099,,,,17,13,30
,2013,180700100,,,,128,113,241
,2013,180700101,,,,64,59,123
,2013,180700102,,,,33,23,56
,2013,180700103,,,,281,250,531
,2013,180700104,,,,477,374,851
,2013,180700105,,,,31,20,51
,2013,180700105,,,,46,67,113
,2013,180700105,,,,17,12,29
,2013,180700106,,,,30,25,55
,2013,180700107,,,,17,21,38
,2013,180700108,,,,151,146,297
,2013,180700109,,,,16,24,40
,2013,180700110,,,,23,24,47
,2013,180700111,,,,22,17,39
,2013,180700112,,,,28,18,46
,2013,180700112,,,,4,4,8
,2013,180700113,,,,16,17,33
,2013,180700114,,,,95,105,200
,2013,180700115,,,,12,9,21
,2013,180700116,,,,94,95,189
,2013,180700118,,,,20,25,45
,2013,180700119,,,,20,36,56
,2013,180700121,,,,28,38,66
,2013,180700122,,,,21,21,42
,2013,180700123,,,,21,25,46
,2013,180700124,,,,29,33,62
,2013,180700125,,,,7,8,15
,2013,180700126,,,,30,16,46
,2013,180700127,,,,7,4,11
,2013,180700129,,,,63,92,155
,2013,180700129,,,,105,111,216
,2013,180700129,,,,25,21,46
,2013,180700131,,,,416,385,801
,2013,180700132,,,,180,214,394
,2013,180700133,,,,119,116,235
,2013,180700135,,,,148,144,292
,2013,180700136,,,,858,954,1812
,2013,180700137,,,,531,388,919
,2013,180700138,,,,157,158,315
,2013,180700141,,,,411,519,930
,2013,180700142,,,,10,11,21
,2013,180700143,,,,30,25,55
,2013,180700144,,,,8,9,17
,2013,180700145,,,,57,27,84
,2013,180700147,,,,9,7,16
,2013,180700148,,,,28,22,50
,2013,180700150,,,,9,12,21
,2013,180700151,,,,5,8,13
,2013,180700154,,,,57,54,111
,2013,180700155,,,,6,17,23
,2013,180700156,,,,27,16,43
,2013,180700158,,,,95,96,191
,2013,180700160,,,,43,28,71
,2013,180700160,,,,4,11,15
,2013,180700163,,,,9,9,18
,2013,180700166,,,,6,6,12
,2013,180700168,,,,2,9,11
,2013,180700169,,,,12,20,32
,2013,180700170,,,,165,150,315
,2013,180700171,,,,20,18,38
,2013,180700173,,,,5,7,12
,2013,180700176,,,,64,35,99
,2013,180700177,,,,13,13,26
,2013,180700178,,,,42,38,80
,2013,180700179,,,,13,17,30
,2013,180700180,,,,18,12,30
,2013,180700181,,,,31,25,56
,2013,180700182,,,,233,217,450
,2013,180700183,,,,145,179,324
,2013,180700184,,,,7,12,19
,2013,180700185,,,,4,7,11
,2013,180700187,,,,8,9,17
,2013,180700188,,,,6,19,25
,2013,180700189,,,,9,14,23
,2013,180700190,,,,11,9,20
,2013,180700191,,,,111,98,209
,2013,180700193,,,,14,12,26
,2013,180700194,,,,7,11,18
,2013,180700195,,,,17,11,28
,2013,180700196,,,,27,17,44
,2013,180700197,,,,20,23,43
,2013,180700197,,,,10,9,19
,2013,180700198,,,,20,26,46
,2013,180700198,,,,5,6,11
,2013,180700199,,,,11,12,23
,2013,180700200,,,,19,22,41
,2013,180700200,,,,10,8,18
,2013,180700201,,,,10,22,32
,2013,180700202,,,,10,17,27
,2013,180700203,,,,20,16,36
,2013,180700204,,,,15,33,48
,2013,180700204,,,,51,50,101
,2013,180700205,,,,24,23,47
,2013,180700207,,,,51,43,94
,2013,180700208,,,,15,10,25
,2013,180700209,,,,11,12,23
,2013,180700213,,,,8,18,26
,2013,180700214,,,,8,6,14
,2013,180700271,,,,4,6,10
,2013,180700273,,,,17,5,22
,2013,180700275,,,,4,6,10
,2013,180700277,,,,3,7,10
,2013,180700278,,,,4,5,9
,2013,180700282,,,,4,6,10
,2013,180700283,,,,7,4,11
,2013,180700286,,,,10,11,21
,2013,180700287,,,,9,7,16
,2013,180700288,,,,2,9,11
,2013,180700289,,,,22,17,39
,2013,180700290,,,,10,13,23
,2013,180700292,,,,4,3,7
,2013,180700293,,,,4,6,10
,2013,180700295,,,,5,6,11
,2013,180700297,,,,15,10,25
,2013,180700297,,,,40,49,89
,2013,180700297,,,,71,70,141
,2013,180700298,,,,38,29,67
,2013,180700298,,,,14,20,34
,2013,180700301,,,,15,10,25
,2013,180700303,,,,7,7,14
,2013,180700304,,,,19,17,36
,2013,180700306,,,,7,7,14
,2013,180700308,,,,74,64,138
,2013,180700309,,,,5,5,10
,2013,180700310,,,,150,82,232
,2013,180700310,,,,4,4,8
,2013,180700312,,,,9,4,13
,2013,180700313,,,,4,4,8
,2013,180700315,,,,10,9,19
,2013,180700319,,,,4,4,8
,2013,180700322,,,,6,5,11
,2013,180700324,,,,30,21,51
,2013,180700325,,,,6,2,8
,2013,180700327,,,,7,1,8
,2013,180700328,,,,9,9,18
,2013,180700329,,,,4,3,7
,2013,180700330,,,,7,3,10
,2013,180700332,,,,4,12,16
,2013,180700333,,,,8,13,21
,2013,180700333,,,,4,4,8
,2013,180700333,,,,22,14,36
,2013,180700334,,,,4,8,12
,2013,180700335,,,,4,7,11
,2013,180700335,,,,43,33,76
,2013,180700337,,,,8,3,11
,2013,180700339,,,,13,10,23
,2013,180700340,,,,7,5,12
,2013,180700341,,,,4,5,9
,2013,180700342,,,,8,3,11
,2013,180700343,,,,5,3,8
,2013,180700344,,,,4,5,9
,2013,180700345,,,,8,2,10
,2013,180700346,,,,7,4,11
,2013,180700348,,,,6,9,15
,2013,180700350,,,,4,4,8
,2013,180700353,,,,6,6,12
,2013,180700354,,,,5,4,9
,2013,180700355,,,,4,4,8
,2013,180700356,,,,4,5,9
,2013,180700357,,,,4,6,10
,2013,180700358,,,,5,4,9
,2013,180700359,,,,5,10,15
,2013,180700360,,,,2,6,8
,2013,180700361,,,,7,5,12
,2013,180700362,,,,9,14,23
,2013,180700362,,,,35,25,60
,2013,180700365,,,,62,81,143
,2013,180700365,,,,62,81,143
,2013,180700366,,,,7,7,14
,2013,180700367,,,,10,7,17
,2013,180700368,,,,6,2,8
,2013,180700370,,,,4,7,11
,2013,180700371,,,,3,6,9
,2013,180700372,,,,7,4,11
,2013,180700373,,,,5,3,8
,2013,180700375,,,,10,9,19
,2013,180700376,,,,26,35,61
,2013,180700377,,,,7,5,12
,2013,180700378,,,,19,22,41
,2013,180700379,,,,12,8,20
,2013,180700379,,,,14,11,25
,2013,180700380,,,,28,22,50
,2013,180700381,,,,29,30,59
,2013,180700381,,,,12,8,20
,2013,180700382,,,,12,11,23
,2013,180700383,,,,15,14,29
,2013,180700385,,,,4,4,8
,2013,180700386,,,,5,8,13
,2013,180700388,,,,5,5,10
,2013,180700389,,,,12,5,17
,2013,180700390,,,,2,6,8
,2013,180700392,,,,5,8,13
,2013,180700393,,,,6,8,14
,2013,180700396,,,,4,5,9
,2013,180700397,,,,6,5,11
,2013,180700398,,,,3,5,8
,2013,180700400,,,,6,8,14
,2013,180700403,,,,8,7,15
,2013,180700404,,,,6,3,9
,2013,180700405,,,,5,5,10
,2013,180700406,,,,3,7,10
,2013,180800001,,,,43,50,93
,2013,180800002,,,,430,0,430
,2013,180800002,,,,40,0,40
,2013,180800003,,,,0,561,561
,2013,180800003,,,,0,45,45
,2013,180800004,,,,100,88,188
,2013,180800005,,,,50,44,94
,2013,180800005,,,,3,7,10
,2013,180800006,,,,14,19,33
,2013,180800007,,,,16,19,35
,2013,180800008,,,,63,64,127
,2013,180800008,,,,9,6,15
,2013,180800009,,,,40,39,79
,2013,180800009,,,,5,8,13
,2013,180800010,,,,9,2,11
,2013,180800010,,,,35,30,65
,2013,180800011,,,,78,77,155
,2013,180800011,,,,5,10,15
,2013,180800012,,,,3,5,8
,2013,180800012,,,,17,19,36
,2013,180800013,,,,216,185,401
,2013,180800013,,,,23,23,46
,2013,180800014,,,,59,76,135
,2013,180800014,,,,9,8,17
,2013,180800015,,,,4,5,9
,2013,180800015,,,,29,28,57
,2013,180800016,,,,20,9,29
,2013,180800016,,,,3,5,8
,2013,180800017,,,,107,110,217
,2013,180800017,,,,11,13,24
,2013,180800018,,,,145,108,253
,2013,180800019,,,,15,12,27
,2013,180800020,,,,9,15,24
,2013,180800021,,,,48,49,97
,2013,180800022,,,,13,13,26
,2013,180800025,,,,39,53,92
,2013,180800027,,,,8,10,18
,2013,180800028,,,,18,21,39
,2013,180800029,,,,5,3,8
,2013,180800030,,,,17,10,27
,2013,180800031,,,,45,37,82
,2013,180800031,,,,15,6,21
,2013,180800035,,,,4,4,8
,2013,180800037,,,,22,20,42
,2013,180800038,,,,14,9,23
,2013,180800039,,,,4,4,8
,2013,180800040,,,,4,10,14
,2013,180800041,,,,3,4,7
,2013,180800041,,,,38,33,71
,2013,180800050,,,,10,14,24
,2013,180800050,,,,42,41,83
,2013,180800051,,,,36,34,70
,2013,180800051,,,,10,14,24
,2013,180800053,,,,19,15,34
,2013,180800054,,,,11,12,23
,2013,180800054,,,,20,28,48
,2013,180800055,,,,8,2,10
,2013,180800058,,,,6,3,9
,2013,180800059,,,,5,5,10
,2013,180800060,,,,4,6,10
,2013,180800064,,,,12,20,32
,2013,180800065,,,,13,10,23
,2013,180800068,,,,8,3,11
,2013,180800069,,,,4,2,6
,2013,180800070,,,,6,3,9
,2013,180800071,,,,1,9,10
,2013,180800072,,,,9,9,18
,2013,180800073,,,,2,4,6
,2013,180900001,,,,200,182,382
,2013,180900002,,,,63,55,118
,2013,180900003,,,,9,24,33
,2013,180900004,,,,190,193,383
,2013,180900005,,,,37,28,65
,2013,180900006,,,,91,84,175
,2013,180900007,,,,75,85,160
,2013,180900008,,,,42,31,73
,2013,180900009,,,,10,13,23
,2013,180900010,,,,16,10,26
,2013,180900011,,,,55,36,91
,2013,180900012,,,,55,49,104
,2013,180900013,,,,27,21,48
,2013,180900014,,,,56,44,100
,2013,180900015,,,,37,32,69
,2013,180900016,,,,40,39,79
,2013,180900017,,,,25,19,44
,2013,180900018,,,,51,53,104
,2013,180900019,,,,11,12,23
,2013,180900020,,,,27,35,62
,2013,180900021,,,,43,22,65
,2013,180900022,,,,136,143,279
,2013,180900023,,,,61,50,111
,2013,180900024,,,,13,6,19
,2013,180900025,,,,41,26,67
,2013,180900026,,,,23,18,41
,2013,180900027,,,,12,18,30
,2013,180900029,,,,25,17,42
,2013,180900030,,,,44,23,67
,2013,180900030,,,,10,8,18
,2013,180900031,,,,18,12,30
,2013,180900032,,,,22,16,38
,2013,180900033,,,,15,18,33
,2013,180900034,,,,18,22,40
,2013,180900035,,,,23,21,44
,2013,180900036,,,,25,19,44
,2013,180900037,,,,17,7,24
,2013,180900038,,,,34,31,65
,2013,180900039,,,,32,25,57
,2013,180900040,,,,346,422,768
,2013,180900041,,,,9,6,15
,2013,180900042,,,,12,11,23
,2013,180900043,,,,8,13,21
,2013,180900044,,,,9,13,22
,2013,180900046,,,,34,35,69
,2013,180900047,,,,13,2,15
,2013,180900048,,,,8,12,20
,2013,180900049,,,,21,22,43
,2013,180900049,,,,2,5,7
,2013,180900050,,,,12,9,21
,2013,180900051,,,,16,12,28
,2013,180900052,,,,5,4,9
,2013,180900052,,,,31,21,52
,2013,180900053,,,,13,14,27
,2013,180900054,,,,18,11,29
,2013,180900056,,,,169,134,303
,2013,180900057,,,,16,9,25
,2013,180900057,,,,31,38,69
,2013,180900058,,,,9,12,21
,2013,180900059,,,,7,5,12
,2013,180900062,,,,3,3,6
,2013,180900094,,,,6,1,7
,2013,180900096,,,,8,3,11
,2013,180900098,,,,3,1,4
,2013,180900099,,,,0,5,5
,2013,180900100,,,,0,5,5
,2013,180900101,,,,7,4,11
,2013,180900104,,,,205,220,425
,2013,180900105,,,,4,5,9
,2013,180900106,,,,5,1,6
,2013,180900108,,,,3,8,11
,2013,180900109,,,,5,9,14
,2013,180900110,,,,5,10,15
,2013,180900111,,,,11,7,18
,2013,180900113,,,,27,37,64
,2013,180900114,,,,4,3,7
,2013,180900115,,,,2,8,10
,2013,180900116,,,,1,5,6
,2013,180900117,,,,13,9,22
,2013,180900118,,,,1,5,6
,2013,180900119,,,,4,5,9
,2013,180900120,,,,6,1,7
,2013,180900121,,,,4,1,5
,2013,180900122,,,,4,4,8
,2013,180900123,,,,1,8,9
,2013,180900124,,,,9,3,12
,2013,180900125,,,,1,6,7
,2013,180900126,,,,8,6,14
,2013,180900127,,,,6,3,9
,2013,181000001,,,,7,6,13
,2013,181000002,,,,8,12,20
,2013,181000004,,,,140,91,231
,2013,181000005,,,,18,6,24
,2013,181000006,,,,49,69,118
,2013,181000007,,,,27,22,49
,2013,181000008,,,,26,16,42
,2013,181000008,,,,7,4,11
,2013,181000009,,,,34,29,63
,2013,181000010,,,,174,141,315
,2013,181000011,,,,42,43,85
,2013,181000012,,,,195,197,392
,2013,181000013,,,,28,24,52
,2013,181000014,,,,49,44,93
,2013,181000015,,,,90,51,141
,2013,181000016,,,,28,32,60
,2013,181000017,,,,6,7,13
,2013,181000017,,,,2,5,7
,2013,181000018,,,,5,7,12
,2013,181000018,,,,40,34,74
,2013,181000019,,,,39,41,80
,2013,181000020,,,,16,11,27
,2013,181000021,,,,16,21,37
,2013,181000022,,,,29,24,53
,2013,181000023,,,,38,36,74
,2013,181000024,,,,14,11,25
,2013,181000025,,,,99,111,210
,2013,181000026,,,,19,21,40
,2013,181000027,,,,212,172,384
,2013,181000028,,,,22,43,65
,2013,181000029,,,,42,32,74
,2013,181000030,,,,15,10,25
,2013,181000031,,,,13,20,33
,2013,181000032,,,,19,13,32
,2013,181000033,,,,20,9,29
,2013,181000034,,,,62,55,117
,2013,181000035,,,,10,17,27
,2013,181000036,,,,46,29,75
,2013,181000037,,,,30,24,54
,2013,181000038,,,,59,49,108
,2013,181000039,,,,26,31,57
,2013,181000040,,,,22,22,44
,2013,181000041,,,,102,64,166
,2013,181000042,,,,19,12,31
,2013,181000043,,,,16,22,38
,2013,181000044,,,,27,27,54
,2013,181000045,,,,34,30,64
,2013,181000046,,,,22,18,40
,2013,181000047,,,,120,128,248
,2013,181000048,,,,25,30,55
,2013,181000049,,,,32,39,71
,2013,181000051,,,,28,29,57
,2013,181000052,,,,27,24,51
,2013,181000055,,,,18,12,30
,2013,181000056,,,,15,19,34
,2013,181000057,,,,18,16,34
,2013,181000058,,,,25,13,38
,2013,181000058,,,,72,62,134
,2013,181000059,,,,24,26,50
,2013,181000059,,,,5,6,11
,2013,181000060,,,,7,10,17
,2013,181000060,,,,13,21,34
,2013,181000061,,,,8,10,18
,2013,181000061,,,,40,36,76
,2013,181000062,,,,14,14,28
,2013,181000063,,,,30,41,71
,2013,181000063,,,,12,11,23
,2013,181000064,,,,15,6,21
,2013,181000065,,,,23,14,37
,2013,181000066,,,,33,25,58
,2013,181000067,,,,26,23,49
,2013,181000068,,,,28,30,58
,2013,181000069,,,,33,33,66
,2013,181000070,,,,20,30,50
,2013,181000071,,,,9,16,25
,2013,181000072,,,,13,6,19
,2013,181000073,,,,13,21,34
,2013,181000073,,,,1,6,7
,2013,181000074,,,,12,10,22
,2013,181000075,,,,34,42,76
,2013,181000076,,,,65,45,110
,2013,181000077,,,,24,11,35
,2013,181000077,,,,34,29,63
,2013,181000078,,,,42,33,75
,2013,181000079,,,,13,10,23
,2013,181000079,,,,5,5,10
,2013,181000080,,,,244,291,535
,2013,181000081,,,,39,26,65
,2013,181000082,,,,17,13,30
,2013,181000084,,,,39,34,73
,2013,181000085,,,,14,15,29
,2013,181000086,,,,5,4,9
,2013,181000087,,,,20,12,32
,2013,181000088,,,,44,26,70
,2013,181000088,,,,8,9,17
,2013,181000089,,,,19,24,43
,2013,181000090,,,,23,15,38
,2013,181000091,,,,24,28,52
,2013,181000092,,,,19,9,28
,2013,181000093,,,,32,38,70
,2013,181000096,,,,7,9,16
,2013,181000097,,,,5,12,17
,2013,181000098,,,,7,8,15
,2013,181000099,,,,20,21,41
,2013,181000100,,,,31,24,55
,2013,181000101,,,,13,17,30
,2013,181000103,,,,13,8,21
,2013,181000103,,,,22,24,46
,2013,181000104,,,,3,8,11
,2013,181000105,,,,6,9,15
,2013,181000106,,,,28,41,69
,2013,181000106,,,,9,7,16
,2013,181000107,,,,25,35,60
,2013,181000107,,,,14,7,21
,2013,181000108,,,,31,20,51
,2013,181000109,,,,21,28,49
,2013,181000111,,,,28,36,64
,2013,181000112,,,,16,21,37
,2013,181000113,,,,17,25,42
,2013,181000114,,,,19,18,37
,2013,181000115,,,,8,16,24
,2013,181000116,,,,21,14,35
,2013,181000117,,,,16,19,35
,2013,181000118,,,,15,5,20
,2013,181000119,,,,14,11,25
,2013,181000120,,,,10,4,14
,2013,181000121,,,,10,11,21
,2013,181000121,,,,3,3,6
,2013,181000126,,,,15,6,21
,2013,181000129,,,,1,4,5
,2013,181000147,,,,6,2,8
,2013,181000158,,,,2,4,6
,2013,181000160,,,,6,5,11
,2013,181000162,,,,4,7,11
,2013,181000164,,,,5,5,10
,2013,181000165,,,,2,4,6
,2013,181000166,,,,6,2,8
,2013,181000167,,,,3,4,7
,2013,181000168,,,,5,7,12
,2013,181000169,,,,6,5,11
,2013,181000171,,,,4,7,11
,2013,181000173,,,,3,7,10
,2013,181000176,,,,3,5,8
,2013,181000178,,,,19,21,40
,2013,181000179,,,,21,10,31
,2013,181000179,,,,5,7,12
,2013,181000180,,,,9,17,26
,2013,181000182,,,,3,5,8
,2013,181000183,,,,7,4,11
,2013,181000187,,,,7,10,17
,2013,181000188,,,,14,13,27
,2013,181000189,,,,7,11,18
,2013,181000190,,,,5,6,11
,2013,181000192,,,,2,1,3
,2013,181000193,,,,3,4,7
,2013,181000194,,,,3,4,7
,2013,181000194,,,,15,15,30
,2013,181000197,,,,1,3,4
,2013,181000198,,,,8,6,14
,2013,181000199,,,,5,6,11
,2013,181000200,,,,1,3,4
,2013,181000201,,,,5,4,9
,2013,181000202,,,,4,3,7
,2013,181000203,,,,11,12,23
,2013,181000204,,,,13,12,25
,2013,181000205,,,,3,8,11
,2013,181000206,,,,12,16,28
,2013,181000207,,,,2,5,7
,2013,181000209,,,,10,8,18
,2013,181000210,,,,12,7,19
,2013,181000211,,,,15,18,33
,2013,181000212,,,,7,5,12
,2013,181000213,,,,1,6,7
,2013,181000214,,,,19,13,32
,2013,181000216,,,,5,3,8
,2013,181000217,,,,2,7,9
,2013,181000218,,,,13,5,18
,2013,181000219,,,,5,2,7
,2013,181000220,,,,10,2,12
,2013,181000221,,,,1,2,3
,2013,181000222,,,,6,9,15
,2013,181000223,,,,5,4,9
,2013,181000224,,,,6,5,11
,2013,181000225,,,,4,4,8
,2013,181000227,,,,3,3,6
,2013,181000229,,,,18,12,30
,2013,181000230,,,,4,2,6
,2013,181000231,,,,3,6,9
,2013,181000232,,,,9,8,17
,2013,181000233,,,,6,4,10
,2013,181000234,,,,5,10,15
,2013,181000235,,,,7,3,10
,2013,181000236,,,,10,6,16
,2013,181000237,,,,5,1,6
,2013,181000238,,,,9,1,10
,2013,181000239,,,,5,8,13
,2013,181000240,,,,2,8,10
,2013,181000241,,,,11,9,20
,2013,181000243,,,,7,10,17
,2013,181000244,,,,3,4,7
,2013,181000245,,,,3,4,7
,2013,181000246,,,,11,9,20
,2013,181000247,,,,5,10,15
,2013,181000249,,,,12,11,23
,2013,181000250,,,,19,11,30
,2013,181000251,,,,14,10,24
,2013,181000252,,,,2,1,3
,2013,181000253,,,,3,5,8
,2013,181000254,,,,2,3,5
,2013,181000255,,,,3,2,5
,2013,181000256,,,,4,2,6
,2013,181000259,,,,1,2,3
,2013,181000263,,,,5,6,11
,2013,181000269,,,,4,2,6
,2013,181000270,,,,1,3,4
,2013,181000274,,,,3,5,8
,2013,181000275,,,,5,3,8
,2013,181000276,,,,4,2,6
,2013,181000279,,,,5,2,7
,2013,181100001,,,,196,178,374
,2013,181100002,,,,133,84,217
,2013,181100003,,,,45,40,85
,2013,181100004,,,,130,103,233
,2013,181100005,,,,9,7,16
,2013,181100005,,,,18,20,38
,2013,181100006,,,,60,68,128
,2013,181100007,,,,75,77,152
,2013,181100008,,,,23,23,46
,2013,181100009,,,,71,72,143
,2013,181100010,,,,34,20,54
,2013,181100011,,,,22,17,39
,2013,181100012,,,,220,241,461
,2013,181100013,,,,5,9,14
,2013,181100014,,,,37,26,63
,2013,181100015,,,,11,6,17
,2013,181100016,,,,36,32,68
,2013,181100017,,,,42,39,81
,2013,181100018,,,,39,32,71
,2013,181100019,,,,19,22,41
,2013,181100020,,,,5,10,15
,2013,181100021,,,,13,11,24
,2013,181100022,,,,29,13,42
,2013,181100023,,,,18,11,29
,2013,181100024,,,,26,13,39
,2013,181100025,,,,9,11,20
,2013,181100026,,,,70,60,130
,2013,181100027,,,,10,16,26
,2013,181100028,,,,5,18,23
,2013,181100028,,,,35,44,79
,2013,181100029,,,,18,9,27
,2013,181100030,,,,28,27,55
,2013,181100031,,,,25,23,48
,2013,181100032,,,,7,11,18
,2013,181100033,,,,31,24,55
,2013,181100034,,,,21,22,43
,2013,181100035,,,,20,16,36
,2013,181100036,,,,219,290,509
,2013,181100037,,,,10,15,25
,2013,181100038,,,,9,8,17
,2013,181100039,,,,27,18,45
,2013,181100040,,,,17,9,26
,2013,181100041,,,,11,11,22
,2013,181100042,,,,23,27,50
,2013,181100043,,,,5,6,11
,2013,181100043,,,,23,25,48
,2013,181100044,,,,29,40,69
,2013,181100044,,,,5,5,10
,2013,181100046,,,,8,12,20
,2013,181100047,,,,2,3,5
,2013,181100048,,,,36,29,65
,2013,181100050,,,,13,15,28
,2013,181100051,,,,25,29,54
,2013,181100051,,,,8,6,14
,2013,181100052,,,,33,49,82
,2013,181100053,,,,11,13,24
,2013,181100054,,,,44,43,87
,2013,181100055,,,,11,20,31
,2013,181100056,,,,11,13,24
,2013,181100057,,,,31,25,56
,2013,181100058,,,,8,4,12
,2013,181100059,,,,10,6,16
,2013,181100060,,,,17,16,33
,2013,181100061,,,,1,6,7
,2013,181100063,,,,5,6,11
,2013,181100094,,,,6,9,15
,2013,181100095,,,,5,6,11
,2013,181100097,,,,1,7,8
,2013,181100098,,,,4,4,8
,2013,181100099,,,,3,6,9
,2013,181100101,,,,15,11,26
,2013,181100102,,,,15,14,29
,2013,181100103,,,,22,7,29
,2013,181100103,,,,2,3,5
,2013,181100104,,,,15,15,30
,2013,181100105,,,,5,12,17
,2013,181100106,,,,17,11,28
,2013,181100107,,,,4,1,5
,2013,181100109,,,,4,5,9
,2013,181100110,,,,7,6,13
,2013,181100111,,,,3,4,7
,2013,181100112,,,,6,6,12
,2013,181100113,,,,9,11,20
,2013,181100114,,,,8,13,21
,2013,181100115,,,,4,3,7
,2013,181100116,,,,1,3,4
,2013,181101624,,,,14,16,30
,2013,181101625,,,,2,3,5
,2013,181101626,,,,3,3,6
,2013,181101628,,,,4,4,8
,2013,181101629,,,,6,6,12
,2013,181101630,,,,7,7,14
,2013,181101631,,,,2,3,5
,2013,181101632,,,,5,0,5
,2013,181101633,,,,7,5,12
,2013,181101634,,,,3,3,6
,2013,181101635,,,,10,3,13
,2013,181101636,,,,7,4,11
,2013,181101637,,,,2,3,5
,2013,181101638,,,,5,5,10
,2013,181101639,,,,3,3,6
,2013,181101642,,,,6,5,11
